CPRO;PROVINCIA;CMUN;NOMBRE;POB;HOMBRES;MUJERES;AÑO
02;Albacete;001;Abengibre;761;366;395;2016
02;Albacete;002;Alatoz;582;325;257;2016
02;Albacete;003;Albacete;172426;84366;88060;2016
02;Albacete;004;Albatana;714;367;347;2016
02;Albacete;005;Alborea;710;365;345;2016
02;Albacete;006;Alcadozo;688;367;321;2016
02;Albacete;007;Alcalá del Júcar;1217;653;564;2016
02;Albacete;008;Alcaraz;1463;741;722;2016
02;Albacete;009;Almansa;24800;12332;12468;2016
02;Albacete;010;Alpera;2289;1177;1112;2016
02;Albacete;011;Ayna;690;368;322;2016
02;Albacete;012;Balazote;2346;1202;1144;2016
02;Albacete;014;Ballestero, El;427;218;209;2016
02;Albacete;013;Balsa de Ves;155;87;68;2016
02;Albacete;015;Barrax;1903;971;932;2016
02;Albacete;016;Bienservida;634;332;302;2016
02;Albacete;017;Bogarra;920;485;435;2016
02;Albacete;018;Bonete;1123;579;544;2016
02;Albacete;019;Bonillo, El;2889;1468;1421;2016
02;Albacete;020;Carcelén;518;278;240;2016
02;Albacete;021;Casas de Juan Núñez;1318;693;625;2016
02;Albacete;022;Casas de Lázaro;380;212;168;2016
02;Albacete;023;Casas de Ves;654;338;316;2016
02;Albacete;024;Casas-Ibáñez;4555;2326;2229;2016
02;Albacete;025;Caudete;10115;5146;4969;2016
02;Albacete;026;Cenizate;1204;617;587;2016
02;Albacete;029;Chinchilla de Monte-Aragón;4172;2176;1996;2016
02;Albacete;027;Corral-Rubio;351;192;159;2016
02;Albacete;028;Cotillas;139;72;67;2016
02;Albacete;030;Elche de la Sierra;3711;1860;1851;2016
02;Albacete;031;Férez;696;349;347;2016
02;Albacete;032;Fuensanta;310;174;136;2016
02;Albacete;033;Fuente-Álamo;2574;1354;1220;2016
02;Albacete;034;Fuentealbilla;1876;949;927;2016
02;Albacete;035;Gineta, La;2509;1292;1217;2016
02;Albacete;036;Golosalvo;111;59;52;2016
02;Albacete;037;Hellín;30419;15184;15235;2016
02;Albacete;038;Herrera, La;340;173;167;2016
02;Albacete;039;Higueruela;1222;630;592;2016
02;Albacete;040;Hoya-Gonzalo;666;360;306;2016
02;Albacete;041;Jorquera;377;198;179;2016
02;Albacete;042;Letur;973;474;499;2016
02;Albacete;043;Lezuza;1458;750;708;2016
02;Albacete;044;Liétor;1279;667;612;2016
02;Albacete;045;Madrigueras;4671;2400;2271;2016
02;Albacete;046;Mahora;1355;691;664;2016
02;Albacete;047;Masegoso;121;63;58;2016
02;Albacete;048;Minaya;1543;798;745;2016
02;Albacete;049;Molinicos;893;459;434;2016
02;Albacete;050;Montalvos;108;57;51;2016
02;Albacete;051;Montealegre del Castillo;2092;1061;1031;2016
02;Albacete;052;Motilleja;550;293;257;2016
02;Albacete;053;Munera;3627;1842;1785;2016
02;Albacete;054;Navas de Jorquera;525;270;255;2016
02;Albacete;055;Nerpio;1311;715;596;2016
02;Albacete;056;Ontur;2111;1054;1057;2016
02;Albacete;057;Ossa de Montiel;2422;1203;1219;2016
02;Albacete;058;Paterna del Madera;375;205;170;2016
02;Albacete;060;Peñas de San Pedro;1428;830;598;2016
02;Albacete;059;Peñascosa;333;176;157;2016
02;Albacete;061;Pétrola;713;371;342;2016
02;Albacete;062;Povedilla;463;248;215;2016
02;Albacete;901;Pozo Cañada;2800;1405;1395;2016
02;Albacete;063;Pozohondo;1698;888;810;2016
02;Albacete;064;Pozo-Lorente;409;208;201;2016
02;Albacete;065;Pozuelo;531;282;249;2016
02;Albacete;066;Recueja, La;279;144;135;2016
02;Albacete;067;Riópar;1410;718;692;2016
02;Albacete;068;Robledo;390;210;180;2016
02;Albacete;069;Roda, La;15748;7966;7782;2016
02;Albacete;070;Salobre;523;270;253;2016
02;Albacete;071;San Pedro;1232;627;605;2016
02;Albacete;072;Socovos;1819;932;887;2016
02;Albacete;073;Tarazona de la Mancha;6460;3277;3183;2016
02;Albacete;074;Tobarra;7822;3979;3843;2016
02;Albacete;075;Valdeganga;1976;1008;968;2016
02;Albacete;076;Vianos;368;189;179;2016
02;Albacete;077;Villa de Ves;63;35;28;2016
02;Albacete;078;Villalgordo del Júcar;1128;590;538;2016
02;Albacete;079;Villamalea;4082;2049;2033;2016
02;Albacete;080;Villapalacios;628;324;304;2016
02;Albacete;081;Villarrobledo;25589;12695;12894;2016
02;Albacete;082;Villatoya;110;66;44;2016
02;Albacete;083;Villavaliente;234;136;98;2016
02;Albacete;084;Villaverde de Guadalimar;359;192;167;2016
02;Albacete;085;Viveros;337;175;162;2016
02;Albacete;086;Yeste;2818;1448;1370;2016
03;Alicante/Alacant;002;Agost;4729;2379;2350;2016
03;Alicante/Alacant;003;Agres;565;306;259;2016
03;Alicante/Alacant;004;Aigües;921;494;427;2016
03;Alicante/Alacant;005;Albatera;11756;5979;5777;2016
03;Alicante/Alacant;006;Alcalalí;1291;647;644;2016
03;Alicante/Alacant;007;Alcocer de Planes;221;115;106;2016
03;Alicante/Alacant;008;Alcoleja;194;101;93;2016
03;Alicante/Alacant;009;Alcoy/Alcoi;59198;28804;30394;2016
03;Alicante/Alacant;010;Alfafara;399;195;204;2016
03;Alicante/Alacant;011;Alfàs del Pi, l';21494;10713;10781;2016
03;Alicante/Alacant;012;Algorfa;3222;1626;1596;2016
03;Alicante/Alacant;013;Algueña;1391;688;703;2016
03;Alicante/Alacant;014;Alicante/Alacant;330525;160456;170069;2016
03;Alicante/Alacant;015;Almoradí;20138;10188;9950;2016
03;Alicante/Alacant;016;Almudaina;119;62;57;2016
03;Alicante/Alacant;017;Alqueria d'Asnar, l';517;240;277;2016
03;Alicante/Alacant;018;Altea;21739;10677;11062;2016
03;Alicante/Alacant;019;Aspe;20482;10319;10163;2016
03;Alicante/Alacant;001;Atzúbia, l';689;356;333;2016
03;Alicante/Alacant;020;Balones;129;66;63;2016
03;Alicante/Alacant;021;Banyeres de Mariola;7108;3554;3554;2016
03;Alicante/Alacant;022;Benasau;158;74;84;2016
03;Alicante/Alacant;023;Beneixama;1712;852;860;2016
03;Alicante/Alacant;024;Benejúzar;5364;2682;2682;2016
03;Alicante/Alacant;025;Benferri;1920;1008;912;2016
03;Alicante/Alacant;026;Beniarbeig;1917;953;964;2016
03;Alicante/Alacant;027;Beniardá;202;101;101;2016
03;Alicante/Alacant;028;Beniarrés;1164;586;578;2016
03;Alicante/Alacant;030;Benidoleig;1117;555;562;2016
03;Alicante/Alacant;031;Benidorm;66642;33131;33511;2016
03;Alicante/Alacant;032;Benifallim;114;64;50;2016
03;Alicante/Alacant;033;Benifato;158;80;78;2016
03;Alicante/Alacant;029;Benigembla;419;212;207;2016
03;Alicante/Alacant;034;Benijófar;3163;1549;1614;2016
03;Alicante/Alacant;035;Benilloba;769;391;378;2016
03;Alicante/Alacant;036;Benillup;100;46;54;2016
03;Alicante/Alacant;037;Benimantell;494;240;254;2016
03;Alicante/Alacant;038;Benimarfull;427;217;210;2016
03;Alicante/Alacant;039;Benimassot;99;55;44;2016
03;Alicante/Alacant;040;Benimeli;384;179;205;2016
03;Alicante/Alacant;041;Benissa;11000;5424;5576;2016
03;Alicante/Alacant;042;Benitachell/Poble Nou de Benitatxell, el;4104;2051;2053;2016
03;Alicante/Alacant;043;Biar;3647;1794;1853;2016
03;Alicante/Alacant;044;Bigastro;6724;3411;3313;2016
03;Alicante/Alacant;045;Bolulla;412;212;200;2016
03;Alicante/Alacant;046;Busot;2975;1517;1458;2016
03;Alicante/Alacant;049;Callosa de Segura;18497;9336;9161;2016
03;Alicante/Alacant;048;Callosa d'en Sarrià;7146;3610;3536;2016
03;Alicante/Alacant;047;Calp;19591;9889;9702;2016
03;Alicante/Alacant;050;Campello, el;27384;13340;14044;2016
03;Alicante/Alacant;051;Campo de Mirra/Camp de Mirra, el;440;230;210;2016
03;Alicante/Alacant;052;Cañada;1245;623;622;2016
03;Alicante/Alacant;053;Castalla;9859;4968;4891;2016
03;Alicante/Alacant;054;Castell de Castells;449;225;224;2016
03;Alicante/Alacant;075;Castell de Guadalest, el;220;113;107;2016
03;Alicante/Alacant;055;Catral;8551;4315;4236;2016
03;Alicante/Alacant;056;Cocentaina;11432;5782;5650;2016
03;Alicante/Alacant;057;Confrides;207;119;88;2016
03;Alicante/Alacant;058;Cox;7193;3687;3506;2016
03;Alicante/Alacant;059;Crevillent;28691;14525;14166;2016
03;Alicante/Alacant;061;Daya Nueva;1750;888;862;2016
03;Alicante/Alacant;062;Daya Vieja;672;348;324;2016
03;Alicante/Alacant;063;Dénia;41465;20237;21228;2016
03;Alicante/Alacant;064;Dolores;7264;3631;3633;2016
03;Alicante/Alacant;065;Elche/Elx;227659;112824;114835;2016
03;Alicante/Alacant;066;Elda;52745;25736;27009;2016
03;Alicante/Alacant;067;Facheca;107;56;51;2016
03;Alicante/Alacant;068;Famorca;58;29;29;2016
03;Alicante/Alacant;069;Finestrat;6090;3126;2964;2016
03;Alicante/Alacant;077;Fondó de les Neus, el/Hondón de las Nieves;2493;1252;1241;2016
03;Alicante/Alacant;070;Formentera del Segura;3995;2024;1971;2016
03;Alicante/Alacant;072;Gaianes;452;234;218;2016
03;Alicante/Alacant;071;Gata de Gorgos;5825;2937;2888;2016
03;Alicante/Alacant;073;Gorga;267;149;118;2016
03;Alicante/Alacant;074;Granja de Rocamora;2461;1286;1175;2016
03;Alicante/Alacant;076;Guardamar del Segura;15386;7577;7809;2016
03;Alicante/Alacant;078;Hondón de los Frailes;1165;605;560;2016
03;Alicante/Alacant;079;Ibi;23365;11718;11647;2016
03;Alicante/Alacant;080;Jacarilla;1939;980;959;2016
03;Alicante/Alacant;082;Jávea/Xàbia;27225;13506;13719;2016
03;Alicante/Alacant;083;Jijona/Xixona;7057;3431;3626;2016
03;Alicante/Alacant;085;Llíber;1110;546;564;2016
03;Alicante/Alacant;084;Lorcha/Orxa, l';627;310;317;2016
03;Alicante/Alacant;086;Millena;221;116;105;2016
03;Alicante/Alacant;088;Monforte del Cid;7500;3924;3576;2016
03;Alicante/Alacant;089;Monóvar/Monòver;12272;6122;6150;2016
03;Alicante/Alacant;903;Montesinos, Los;4912;2496;2416;2016
03;Alicante/Alacant;091;Murla;486;225;261;2016
03;Alicante/Alacant;092;Muro de Alcoy;9307;4615;4692;2016
03;Alicante/Alacant;090;Mutxamel;24487;12203;12284;2016
03;Alicante/Alacant;093;Novelda;26054;12933;13121;2016
03;Alicante/Alacant;094;Nucia, la;19967;10110;9857;2016
03;Alicante/Alacant;095;Ondara;6647;3322;3325;2016
03;Alicante/Alacant;096;Onil;7494;3742;3752;2016
03;Alicante/Alacant;097;Orba;2085;1030;1055;2016
03;Alicante/Alacant;099;Orihuela;80359;40105;40254;2016
03;Alicante/Alacant;098;Orxeta;778;396;382;2016
03;Alicante/Alacant;100;Parcent;985;486;499;2016
03;Alicante/Alacant;101;Pedreguer;7431;3692;3739;2016
03;Alicante/Alacant;102;Pego;10158;5095;5063;2016
03;Alicante/Alacant;103;Penàguila;328;173;155;2016
03;Alicante/Alacant;104;Petrer;34533;17191;17342;2016
03;Alicante/Alacant;902;Pilar de la Horadada;21348;11001;10347;2016
03;Alicante/Alacant;105;Pinós, el/Pinoso;7627;3826;3801;2016
03;Alicante/Alacant;106;Planes;725;383;342;2016
03;Alicante/Alacant;901;Poblets, els;3246;1562;1684;2016
03;Alicante/Alacant;107;Polop;4549;2347;2202;2016
03;Alicante/Alacant;060;Quatretondeta;113;62;51;2016
03;Alicante/Alacant;109;Rafal;4218;2111;2107;2016
03;Alicante/Alacant;110;Ràfol d'Almúnia, el;630;317;313;2016
03;Alicante/Alacant;111;Redován;7765;4025;3740;2016
03;Alicante/Alacant;112;Relleu;1258;623;635;2016
03;Alicante/Alacant;113;Rojales;17622;8932;8690;2016
03;Alicante/Alacant;114;Romana, la;2411;1240;1171;2016
03;Alicante/Alacant;115;Sagra;414;212;202;2016
03;Alicante/Alacant;116;Salinas;1569;797;772;2016
03;Alicante/Alacant;118;San Fulgencio;7384;3772;3612;2016
03;Alicante/Alacant;904;San Isidro;1915;974;941;2016
03;Alicante/Alacant;120;San Miguel de Salinas;6193;3097;3096;2016
03;Alicante/Alacant;122;San Vicente del Raspeig/Sant Vicent del Raspeig;56715;28075;28640;2016
03;Alicante/Alacant;117;Sanet y Negrals;649;327;322;2016
03;Alicante/Alacant;119;Sant Joan d'Alacant;22897;11073;11824;2016
03;Alicante/Alacant;121;Santa Pola;31309;15707;15602;2016
03;Alicante/Alacant;123;Sax;9700;4903;4797;2016
03;Alicante/Alacant;124;Sella;584;311;273;2016
03;Alicante/Alacant;125;Senija;577;295;282;2016
03;Alicante/Alacant;127;Tàrbena;636;329;307;2016
03;Alicante/Alacant;128;Teulada;10654;5301;5353;2016
03;Alicante/Alacant;129;Tibi;1634;862;772;2016
03;Alicante/Alacant;130;Tollos;53;29;24;2016
03;Alicante/Alacant;131;Tormos;323;160;163;2016
03;Alicante/Alacant;132;Torremanzanas/Torre de les Maçanes, la;727;380;347;2016
03;Alicante/Alacant;133;Torrevieja;84213;42302;41911;2016
03;Alicante/Alacant;134;Vall d'Alcalà, la;171;93;78;2016
03;Alicante/Alacant;136;Vall de Gallinera;582;314;268;2016
03;Alicante/Alacant;137;Vall de Laguar, la;801;404;397;2016
03;Alicante/Alacant;135;Vall d'Ebo, la;243;127;116;2016
03;Alicante/Alacant;138;Verger, el;4515;2250;2265;2016
03;Alicante/Alacant;139;Villajoyosa/Vila Joiosa, la;33580;16774;16806;2016
03;Alicante/Alacant;140;Villena;34163;17047;17116;2016
03;Alicante/Alacant;081;Xaló;2648;1312;1336;2016
04;Almería;001;Abla;1294;664;630;2016
04;Almería;002;Abrucena;1208;615;593;2016
04;Almería;003;Adra;24713;12489;12224;2016
04;Almería;004;Albánchez;796;406;390;2016
04;Almería;005;Alboloduy;613;299;314;2016
04;Almería;006;Albox;11144;5664;5480;2016
04;Almería;007;Alcolea;815;428;387;2016
04;Almería;008;Alcóntar;572;316;256;2016
04;Almería;009;Alcudia de Monteagud;158;75;83;2016
04;Almería;010;Alhabia;677;351;326;2016
04;Almería;011;Alhama de Almería;3687;1851;1836;2016
04;Almería;012;Alicún;217;110;107;2016
04;Almería;013;Almería;194515;94530;99985;2016
04;Almería;014;Almócita;172;83;89;2016
04;Almería;015;Alsodux;134;75;59;2016
04;Almería;016;Antas;3159;1576;1583;2016
04;Almería;017;Arboleas;4538;2271;2267;2016
04;Almería;018;Armuña de Almanzora;326;160;166;2016
04;Almería;019;Bacares;272;140;132;2016
04;Almería;904;Balanegra;2678;1380;1298;2016
04;Almería;020;Bayárcal;323;178;145;2016
04;Almería;021;Bayarque;220;112;108;2016
04;Almería;022;Bédar;885;432;453;2016
04;Almería;023;Beires;114;55;59;2016
04;Almería;024;Benahadux;4185;2074;2111;2016
04;Almería;026;Benitagla;69;40;29;2016
04;Almería;027;Benizalón;280;148;132;2016
04;Almería;028;Bentarique;252;144;108;2016
04;Almería;029;Berja;12380;6228;6152;2016
04;Almería;030;Canjáyar;1279;659;620;2016
04;Almería;031;Cantoria;3371;1707;1664;2016
04;Almería;032;Carboneras;7818;4016;3802;2016
04;Almería;033;Castro de Filabres;139;66;73;2016
04;Almería;036;Chercos;267;138;129;2016
04;Almería;037;Chirivel;1601;812;789;2016
04;Almería;034;Cóbdar;169;100;69;2016
04;Almería;035;Cuevas del Almanzora;13362;6923;6439;2016
04;Almería;038;Dalías;3978;1966;2012;2016
04;Almería;902;Ejido, El;88752;47313;41439;2016
04;Almería;041;Enix;433;237;196;2016
04;Almería;043;Felix;658;374;284;2016
04;Almería;044;Fines;2079;1082;997;2016
04;Almería;045;Fiñana;2070;1047;1023;2016
04;Almería;046;Fondón;1017;530;487;2016
04;Almería;047;Gádor;3030;1566;1464;2016
04;Almería;048;Gallardos, Los;2867;1457;1410;2016
04;Almería;049;Garrucha;8655;4481;4174;2016
04;Almería;050;Gérgal;1037;556;481;2016
04;Almería;051;Huécija;513;248;265;2016
04;Almería;052;Huércal de Almería;17068;8721;8347;2016
04;Almería;053;Huércal-Overa;18589;9219;9370;2016
04;Almería;054;Illar;386;205;181;2016
04;Almería;055;Instinción;444;217;227;2016
04;Almería;056;Laroya;176;100;76;2016
04;Almería;057;Láujar de Andarax;1551;774;777;2016
04;Almería;058;Líjar;411;215;196;2016
04;Almería;059;Lubrín;1484;724;760;2016
04;Almería;060;Lucainena de las Torres;569;304;265;2016
04;Almería;061;Lúcar;754;373;381;2016
04;Almería;062;Macael;5628;2884;2744;2016
04;Almería;063;María;1294;662;632;2016
04;Almería;064;Mojácar;6490;3227;3263;2016
04;Almería;903;Mojonera, La;8740;4810;3930;2016
04;Almería;065;Nacimiento;483;241;242;2016
04;Almería;066;Níjar;28579;15469;13110;2016
04;Almería;067;Ohanes;651;320;331;2016
04;Almería;068;Olula de Castro;194;104;90;2016
04;Almería;069;Olula del Río;6216;3203;3013;2016
04;Almería;070;Oria;2330;1218;1112;2016
04;Almería;071;Padules;449;230;219;2016
04;Almería;072;Partaloa;915;449;466;2016
04;Almería;073;Paterna del Río;372;216;156;2016
04;Almería;074;Pechina;3900;1979;1921;2016
04;Almería;075;Pulpí;8909;4593;4316;2016
04;Almería;076;Purchena;1638;847;791;2016
04;Almería;077;Rágol;316;169;147;2016
04;Almería;078;Rioja;1356;683;673;2016
04;Almería;079;Roquetas de Mar;91965;47218;44747;2016
04;Almería;080;Santa Cruz de Marchena;241;125;116;2016
04;Almería;081;Santa Fe de Mondújar;431;215;216;2016
04;Almería;082;Senés;322;170;152;2016
04;Almería;083;Serón;2135;1085;1050;2016
04;Almería;084;Sierro;401;214;187;2016
04;Almería;085;Somontín;477;235;242;2016
04;Almería;086;Sorbas;2541;1329;1212;2016
04;Almería;087;Suflí;235;130;105;2016
04;Almería;088;Tabernas;3654;1882;1772;2016
04;Almería;089;Taberno;972;473;499;2016
04;Almería;090;Tahal;362;187;175;2016
04;Almería;091;Terque;395;197;198;2016
04;Almería;092;Tíjola;3676;1818;1858;2016
04;Almería;901;Tres Villas, Las;625;326;299;2016
04;Almería;093;Turre;3351;1706;1645;2016
04;Almería;094;Turrillas;238;136;102;2016
04;Almería;095;Uleila del Campo;871;432;439;2016
04;Almería;096;Urrácal;327;163;164;2016
04;Almería;097;Velefique;256;138;118;2016
04;Almería;098;Vélez-Blanco;1984;1027;957;2016
04;Almería;099;Vélez-Rubio;6692;3252;3440;2016
04;Almería;100;Vera;15168;7744;7424;2016
04;Almería;101;Viator;5699;2948;2751;2016
04;Almería;102;Vícar;24957;13281;11676;2016
04;Almería;103;Zurgena;2939;1464;1475;2016
01;Araba/Álava;001;Alegría-Dulantzi;2856;1467;1389;2016
01;Araba/Álava;002;Amurrio;10260;5095;5165;2016
01;Araba/Álava;049;Añana;159;88;71;2016
01;Araba/Álava;003;Aramaio;1502;792;710;2016
01;Araba/Álava;006;Armiñón;234;121;113;2016
01;Araba/Álava;037;Arraia-Maeztu;722;409;313;2016
01;Araba/Álava;008;Arratzua-Ubarrundia;979;531;448;2016
01;Araba/Álava;004;Artziniega;1840;911;929;2016
01;Araba/Álava;009;Asparrena;1630;821;809;2016
01;Araba/Álava;010;Ayala/Aiara;2946;1500;1446;2016
01;Araba/Álava;011;Baños de Ebro/Mañueta;308;168;140;2016
01;Araba/Álava;013;Barrundia;903;503;400;2016
01;Araba/Álava;014;Berantevilla;449;231;218;2016
01;Araba/Álava;016;Bernedo;499;299;200;2016
01;Araba/Álava;017;Campezo/Kanpezu;1059;558;501;2016
01;Araba/Álava;021;Elburgo/Burgelu;612;326;286;2016
01;Araba/Álava;022;Elciego;1005;492;513;2016
01;Araba/Álava;023;Elvillar/Bilar;355;176;179;2016
01;Araba/Álava;046;Erriberagoitia/Ribera Alta;745;427;318;2016
01;Araba/Álava;056;Harana/Valle de Arana;237;137;100;2016
01;Araba/Álava;901;Iruña Oka/Iruña de Oca;3270;1686;1584;2016
01;Araba/Álava;027;Iruraiz-Gauna;514;280;234;2016
01;Araba/Álava;019;Kripan;186;100;86;2016
01;Araba/Álava;020;Kuartango;368;212;156;2016
01;Araba/Álava;028;Labastida/Bastida;1460;756;704;2016
01;Araba/Álava;030;Lagrán;168;92;76;2016
01;Araba/Álava;031;Laguardia;1478;766;712;2016
01;Araba/Álava;032;Lanciego/Lantziego;681;347;334;2016
01;Araba/Álava;902;Lantarón;888;498;390;2016
01;Araba/Álava;033;Lapuebla de Labarca;852;449;403;2016
01;Araba/Álava;036;Laudio/Llodio;18212;8996;9216;2016
01;Araba/Álava;058;Legutio;1747;925;822;2016
01;Araba/Álava;034;Leza;212;103;109;2016
01;Araba/Álava;039;Moreda de Álava/Moreda Araba;229;115;114;2016
01;Araba/Álava;041;Navaridas;226;137;89;2016
01;Araba/Álava;042;Okondo;1171;616;555;2016
01;Araba/Álava;043;Oyón-Oion;3326;1680;1646;2016
01;Araba/Álava;044;Peñacerrada-Urizaharra;269;161;108;2016
01;Araba/Álava;047;Ribera Baja/Erribera Beitia;1353;738;615;2016
01;Araba/Álava;051;Salvatierra/Agurain;4985;2474;2511;2016
01;Araba/Álava;052;Samaniego;303;155;148;2016
01;Araba/Álava;053;San Millán/Donemiliaga;717;404;313;2016
01;Araba/Álava;054;Urkabustaiz;1339;707;632;2016
01;Araba/Álava;055;Valdegovía/Gaubea;1015;563;452;2016
01;Araba/Álava;057;Villabuena de Álava/Eskuernaga;292;148;144;2016
01;Araba/Álava;059;Vitoria-Gasteiz;244634;119462;125172;2016
01;Araba/Álava;060;Yécora/Iekora;269;139;130;2016
01;Araba/Álava;061;Zalduondo;188;105;83;2016
01;Araba/Álava;062;Zambrana;398;217;181;2016
01;Araba/Álava;018;Zigoitia;1727;937;790;2016
01;Araba/Álava;063;Zuia;2349;1220;1129;2016
33;Asturias;001;Allande;1766;882;884;2016
33;Asturias;002;Aller;11286;5555;5731;2016
33;Asturias;003;Amieva;712;385;327;2016
33;Asturias;004;Avilés;80114;37921;42193;2016
33;Asturias;005;Belmonte de Miranda;1597;822;775;2016
33;Asturias;006;Bimenes;1745;836;909;2016
33;Asturias;007;Boal;1632;818;814;2016
33;Asturias;008;Cabrales;2033;1028;1005;2016
33;Asturias;009;Cabranes;1052;535;517;2016
33;Asturias;010;Candamo;2049;1011;1038;2016
33;Asturias;012;Cangas de Onís;6368;3103;3265;2016
33;Asturias;011;Cangas del Narcea;13213;6556;6657;2016
33;Asturias;013;Caravia;489;250;239;2016
33;Asturias;014;Carreño;10636;5138;5498;2016
33;Asturias;015;Caso;1624;919;705;2016
33;Asturias;016;Castrillón;22626;10974;11652;2016
33;Asturias;017;Castropol;3575;1741;1834;2016
33;Asturias;018;Coaña;3401;1663;1738;2016
33;Asturias;019;Colunga;3487;1705;1782;2016
33;Asturias;020;Corvera de Asturias;15968;7855;8113;2016
33;Asturias;021;Cudillero;5248;2597;2651;2016
33;Asturias;022;Degaña;1039;542;497;2016
33;Asturias;023;Franco, El;3835;1887;1948;2016
33;Asturias;024;Gijón;273422;128955;144467;2016
33;Asturias;025;Gozón;10534;5129;5405;2016
33;Asturias;026;Grado;10127;4881;5246;2016
33;Asturias;027;Grandas de Salime;899;458;441;2016
33;Asturias;028;Ibias;1412;791;621;2016
33;Asturias;029;Illano;372;187;185;2016
33;Asturias;030;Illas;1026;517;509;2016
33;Asturias;031;Langreo;41199;19588;21611;2016
33;Asturias;032;Laviana;13402;6455;6947;2016
33;Asturias;033;Lena;11430;5508;5922;2016
33;Asturias;035;Llanera;13846;6864;6982;2016
33;Asturias;036;Llanes;13841;6706;7135;2016
33;Asturias;037;Mieres;39505;18764;20741;2016
33;Asturias;038;Morcín;2707;1353;1354;2016
33;Asturias;039;Muros de Nalón;1868;879;989;2016
33;Asturias;040;Nava;5346;2627;2719;2016
33;Asturias;041;Navia;8509;4103;4406;2016
33;Asturias;042;Noreña;5260;2535;2725;2016
33;Asturias;043;Onís;752;401;351;2016
33;Asturias;044;Oviedo;220567;102292;118275;2016
33;Asturias;045;Parres;5479;2685;2794;2016
33;Asturias;046;Peñamellera Alta;533;272;261;2016
33;Asturias;047;Peñamellera Baja;1253;613;640;2016
33;Asturias;048;Pesoz;170;89;81;2016
33;Asturias;049;Piloña;7311;3605;3706;2016
33;Asturias;050;Ponga;643;381;262;2016
33;Asturias;051;Pravia;8502;4112;4390;2016
33;Asturias;052;Proaza;774;442;332;2016
33;Asturias;053;Quirós;1235;701;534;2016
33;Asturias;054;Regueras, Las;1909;979;930;2016
33;Asturias;055;Ribadedeva;1791;860;931;2016
33;Asturias;056;Ribadesella;5848;2798;3050;2016
33;Asturias;057;Ribera de Arriba;1906;971;935;2016
33;Asturias;058;Riosa;2040;1027;1013;2016
33;Asturias;059;Salas;5260;2611;2649;2016
33;Asturias;061;San Martín de Oscos;410;205;205;2016
33;Asturias;060;San Martín del Rey Aurelio;16850;8069;8781;2016
33;Asturias;063;San Tirso de Abres;473;231;242;2016
33;Asturias;062;Santa Eulalia de Oscos;469;246;223;2016
33;Asturias;064;Santo Adriano;270;129;141;2016
33;Asturias;065;Sariego;1260;619;641;2016
33;Asturias;066;Siero;51969;25310;26659;2016
33;Asturias;067;Sobrescobio;859;458;401;2016
33;Asturias;068;Somiedo;1190;693;497;2016
33;Asturias;069;Soto del Barco;3940;1943;1997;2016
33;Asturias;070;Tapia de Casariego;3877;1883;1994;2016
33;Asturias;071;Taramundi;670;321;349;2016
33;Asturias;072;Teverga;1721;910;811;2016
33;Asturias;073;Tineo;9904;4979;4925;2016
33;Asturias;034;Valdés;12243;5977;6266;2016
33;Asturias;074;Vegadeo;3911;1870;2041;2016
33;Asturias;075;Villanueva de Oscos;307;153;154;2016
33;Asturias;076;Villaviciosa;14642;7220;7422;2016
33;Asturias;077;Villayón;1315;686;629;2016
33;Asturias;078;Yernes y Tameza;155;88;67;2016
05;Ávila;001;Adanero;220;117;103;2016
05;Ávila;002;Adrada, La;2619;1354;1265;2016
05;Ávila;005;Albornos;206;110;96;2016
05;Ávila;007;Aldeanueva de Santa Cruz;119;62;57;2016
05;Ávila;008;Aldeaseca;262;129;133;2016
05;Ávila;010;Aldehuela, La;167;84;83;2016
05;Ávila;012;Amavida;144;70;74;2016
05;Ávila;013;Arenal, El;998;507;491;2016
05;Ávila;014;Arenas de San Pedro;6615;3220;3395;2016
05;Ávila;015;Arevalillo;86;43;43;2016
05;Ávila;016;Arévalo;8123;3951;4172;2016
05;Ávila;017;Aveinte;84;46;38;2016
05;Ávila;018;Avellaneda;32;19;13;2016
05;Ávila;019;Ávila;58083;27770;30313;2016
05;Ávila;021;Barco de Ávila, El;2474;1202;1272;2016
05;Ávila;022;Barraco, El;1923;1001;922;2016
05;Ávila;023;Barromán;184;100;84;2016
05;Ávila;024;Becedas;230;122;108;2016
05;Ávila;025;Becedillas;99;54;45;2016
05;Ávila;026;Bercial de Zapardiel;211;115;96;2016
05;Ávila;027;Berlanas, Las;328;169;159;2016
05;Ávila;029;Bernuy-Zapardiel;130;74;56;2016
05;Ávila;030;Berrocalejo de Aragona;48;25;23;2016
05;Ávila;033;Blascomillán;201;104;97;2016
05;Ávila;034;Blasconuño de Matacabras;14;8;6;2016
05;Ávila;035;Blascosancho;109;54;55;2016
05;Ávila;036;Bohodón, El;130;70;60;2016
05;Ávila;037;Bohoyo;283;157;126;2016
05;Ávila;038;Bonilla de la Sierra;123;73;50;2016
05;Ávila;039;Brabos;49;30;19;2016
05;Ávila;040;Bularros;69;44;25;2016
05;Ávila;041;Burgohondo;1208;632;576;2016
05;Ávila;042;Cabezas de Alambre;165;83;82;2016
05;Ávila;043;Cabezas del Pozo;84;47;37;2016
05;Ávila;044;Cabezas del Villar;283;158;125;2016
05;Ávila;045;Cabizuela;96;49;47;2016
05;Ávila;046;Canales;52;29;23;2016
05;Ávila;047;Candeleda;5034;2566;2468;2016
05;Ávila;048;Cantiveros;120;66;54;2016
05;Ávila;049;Cardeñosa;450;237;213;2016
05;Ávila;051;Carrera, La;192;104;88;2016
05;Ávila;052;Casas del Puerto;98;52;46;2016
05;Ávila;053;Casasola;74;38;36;2016
05;Ávila;054;Casavieja;1479;769;710;2016
05;Ávila;055;Casillas;672;363;309;2016
05;Ávila;056;Castellanos de Zapardiel;97;55;42;2016
05;Ávila;057;Cebreros;3188;1638;1550;2016
05;Ávila;058;Cepeda la Mora;82;45;37;2016
05;Ávila;067;Chamartín;88;52;36;2016
05;Ávila;059;Cillán;112;65;47;2016
05;Ávila;060;Cisla;115;60;55;2016
05;Ávila;061;Colilla, La;321;165;156;2016
05;Ávila;062;Collado de Contreras;183;96;87;2016
05;Ávila;063;Collado del Mirón;33;20;13;2016
05;Ávila;064;Constanzana;112;68;44;2016
05;Ávila;065;Crespos;515;276;239;2016
05;Ávila;066;Cuevas del Valle;507;275;232;2016
05;Ávila;903;Diego del Carpio;154;86;68;2016
05;Ávila;069;Donjimeno;80;48;32;2016
05;Ávila;070;Donvidas;36;20;16;2016
05;Ávila;072;Espinosa de los Caballeros;97;53;44;2016
05;Ávila;073;Flores de Ávila;314;172;142;2016
05;Ávila;074;Fontiveros;758;396;362;2016
05;Ávila;075;Fresnedilla;122;51;71;2016
05;Ávila;076;Fresno, El;597;309;288;2016
05;Ávila;077;Fuente el Saúz;173;94;79;2016
05;Ávila;078;Fuentes de Año;117;64;53;2016
05;Ávila;079;Gallegos de Altamiros;69;41;28;2016
05;Ávila;080;Gallegos de Sobrinos;55;24;31;2016
05;Ávila;081;Garganta del Villar;41;30;11;2016
05;Ávila;082;Gavilanes;615;325;290;2016
05;Ávila;083;Gemuño;161;83;78;2016
05;Ávila;085;Gil García;41;20;21;2016
05;Ávila;084;Gilbuena;74;43;31;2016
05;Ávila;086;Gimialcón;82;51;31;2016
05;Ávila;087;Gotarrendura;162;57;105;2016
05;Ávila;088;Grandes y San Martín;28;12;16;2016
05;Ávila;089;Guisando;534;262;272;2016
05;Ávila;090;Gutierre-Muñoz;83;41;42;2016
05;Ávila;092;Hernansancho;171;95;76;2016
05;Ávila;093;Herradón de Pinares;524;297;227;2016
05;Ávila;094;Herreros de Suso;135;75;60;2016
05;Ávila;095;Higuera de las Dueñas;297;162;135;2016
05;Ávila;096;Hija de Dios, La;81;45;36;2016
05;Ávila;097;Horcajada, La;511;262;249;2016
05;Ávila;099;Horcajo de las Torres;541;304;237;2016
05;Ávila;100;Hornillo, El;311;168;143;2016
05;Ávila;102;Hoyo de Pinares, El;2267;1173;1094;2016
05;Ávila;101;Hoyocasero;310;176;134;2016
05;Ávila;103;Hoyorredondo;75;41;34;2016
05;Ávila;106;Hoyos de Miguel Muñoz;34;18;16;2016
05;Ávila;104;Hoyos del Collado;37;22;15;2016
05;Ávila;105;Hoyos del Espino;391;214;177;2016
05;Ávila;107;Hurtumpascual;58;35;23;2016
05;Ávila;108;Junciana;49;25;24;2016
05;Ávila;109;Langa;505;261;244;2016
05;Ávila;110;Lanzahíta;885;458;427;2016
05;Ávila;113;Llanos de Tormes, Los;72;33;39;2016
05;Ávila;112;Losar del Barco, El;109;54;55;2016
05;Ávila;114;Madrigal de las Altas Torres;1503;767;736;2016
05;Ávila;115;Maello;627;329;298;2016
05;Ávila;116;Malpartida de Corneja;113;57;56;2016
05;Ávila;117;Mamblas;215;120;95;2016
05;Ávila;118;Mancera de Arriba;87;49;38;2016
05;Ávila;119;Manjabálago y Ortigosa de Rioalmar;32;20;12;2016
05;Ávila;120;Marlín;39;26;13;2016
05;Ávila;121;Martiherrero;306;160;146;2016
05;Ávila;122;Martínez;132;71;61;2016
05;Ávila;123;Mediana de Voltoya;106;53;53;2016
05;Ávila;124;Medinilla;106;50;56;2016
05;Ávila;125;Mengamuñoz;63;31;32;2016
05;Ávila;126;Mesegar de Corneja;70;39;31;2016
05;Ávila;127;Mijares;755;411;344;2016
05;Ávila;128;Mingorría;400;206;194;2016
05;Ávila;129;Mirón, El;128;78;50;2016
05;Ávila;130;Mironcillo;97;52;45;2016
05;Ávila;131;Mirueña de los Infanzones;100;55;45;2016
05;Ávila;132;Mombeltrán;1111;578;533;2016
05;Ávila;133;Monsalupe;73;37;36;2016
05;Ávila;134;Moraleja de Matacabras;52;30;22;2016
05;Ávila;135;Muñana;426;226;200;2016
05;Ávila;136;Muñico;112;55;57;2016
05;Ávila;138;Muñogalindo;369;188;181;2016
05;Ávila;139;Muñogrande;69;38;31;2016
05;Ávila;140;Muñomer del Peco;128;67;61;2016
05;Ávila;141;Muñopepe;110;63;47;2016
05;Ávila;142;Muñosancho;103;48;55;2016
05;Ávila;143;Muñotello;62;32;30;2016
05;Ávila;144;Narrillos del Álamo;83;44;39;2016
05;Ávila;145;Narrillos del Rebollar;52;28;24;2016
05;Ávila;149;Narros de Saldueña;104;58;46;2016
05;Ávila;147;Narros del Castillo;171;96;75;2016
05;Ávila;148;Narros del Puerto;26;12;14;2016
05;Ávila;152;Nava de Arévalo;775;408;367;2016
05;Ávila;153;Nava del Barco;105;57;48;2016
05;Ávila;151;Navacepedilla de Corneja;104;55;49;2016
05;Ávila;154;Navadijos;41;30;11;2016
05;Ávila;155;Navaescurial;57;34;23;2016
05;Ávila;156;Navahondilla;324;188;136;2016
05;Ávila;157;Navalacruz;251;130;121;2016
05;Ávila;158;Navalmoral;355;185;170;2016
05;Ávila;159;Navalonguilla;256;130;126;2016
05;Ávila;160;Navalosa;332;185;147;2016
05;Ávila;161;Navalperal de Pinares;818;416;402;2016
05;Ávila;162;Navalperal de Tormes;93;49;44;2016
05;Ávila;163;Navaluenga;1967;972;995;2016
05;Ávila;164;Navaquesera;24;10;14;2016
05;Ávila;165;Navarredonda de Gredos;458;226;232;2016
05;Ávila;166;Navarredondilla;195;102;93;2016
05;Ávila;167;Navarrevisca;292;162;130;2016
05;Ávila;168;Navas del Marqués, Las;5272;2666;2606;2016
05;Ávila;169;Navatalgordo;237;128;109;2016
05;Ávila;170;Navatejares;57;27;30;2016
05;Ávila;171;Neila de San Miguel;73;37;36;2016
05;Ávila;172;Niharra;178;95;83;2016
05;Ávila;173;Ojos-Albos;67;41;26;2016
05;Ávila;174;Orbita;78;41;37;2016
05;Ávila;175;Oso, El;173;100;73;2016
05;Ávila;176;Padiernos;291;155;136;2016
05;Ávila;177;Pajares de Adaja;186;95;91;2016
05;Ávila;178;Palacios de Goda;423;220;203;2016
05;Ávila;179;Papatrigo;252;124;128;2016
05;Ávila;180;Parral, El;74;41;33;2016
05;Ávila;181;Pascualcobo;50;30;20;2016
05;Ávila;182;Pedro Bernardo;892;470;422;2016
05;Ávila;183;Pedro-Rodríguez;151;79;72;2016
05;Ávila;184;Peguerinos;308;172;136;2016
05;Ávila;185;Peñalba de Ávila;108;60;48;2016
05;Ávila;186;Piedrahíta;1848;872;976;2016
05;Ávila;187;Piedralaves;2130;1070;1060;2016
05;Ávila;188;Poveda;47;30;17;2016
05;Ávila;189;Poyales del Hoyo;556;299;257;2016
05;Ávila;190;Pozanco;50;29;21;2016
05;Ávila;191;Pradosegar;132;69;63;2016
05;Ávila;192;Puerto Castilla;116;73;43;2016
05;Ávila;193;Rasueros;201;116;85;2016
05;Ávila;194;Riocabado;150;86;64;2016
05;Ávila;195;Riofrío;224;133;91;2016
05;Ávila;196;Rivilla de Barajas;58;25;33;2016
05;Ávila;197;Salobral;107;56;51;2016
05;Ávila;198;Salvadiós;77;38;39;2016
05;Ávila;199;San Bartolomé de Béjar;41;21;20;2016
05;Ávila;200;San Bartolomé de Corneja;48;25;23;2016
05;Ávila;201;San Bartolomé de Pinares;581;313;268;2016
05;Ávila;206;San Esteban de los Patos;36;20;16;2016
05;Ávila;208;San Esteban de Zapardiel;40;24;16;2016
05;Ávila;207;San Esteban del Valle;791;419;372;2016
05;Ávila;209;San García de Ingelmos;85;49;36;2016
05;Ávila;901;San Juan de Gredos;269;144;125;2016
05;Ávila;210;San Juan de la Encinilla;89;44;45;2016
05;Ávila;211;San Juan de la Nava;512;268;244;2016
05;Ávila;212;San Juan del Molinillo;216;123;93;2016
05;Ávila;213;San Juan del Olmo;104;63;41;2016
05;Ávila;214;San Lorenzo de Tormes;41;23;18;2016
05;Ávila;215;San Martín de la Vega del Alberche;177;104;73;2016
05;Ávila;216;San Martín del Pimpollar;177;103;74;2016
05;Ávila;217;San Miguel de Corneja;57;31;26;2016
05;Ávila;218;San Miguel de Serrezuela;132;69;63;2016
05;Ávila;219;San Pascual;43;28;15;2016
05;Ávila;220;San Pedro del Arroyo;441;231;210;2016
05;Ávila;231;San Vicente de Arévalo;185;104;81;2016
05;Ávila;204;Sanchidrián;748;380;368;2016
05;Ávila;205;Sanchorreja;85;42;43;2016
05;Ávila;222;Santa Cruz de Pinares;147;80;67;2016
05;Ávila;221;Santa Cruz del Valle;379;195;184;2016
05;Ávila;226;Santa María de los Caballeros;79;46;33;2016
05;Ávila;224;Santa María del Arroyo;111;58;53;2016
05;Ávila;225;Santa María del Berrocal;382;204;178;2016
05;Ávila;902;Santa María del Cubillo;313;179;134;2016
05;Ávila;227;Santa María del Tiétar;483;251;232;2016
05;Ávila;228;Santiago del Collado;179;110;69;2016
05;Ávila;904;Santiago del Tormes;136;75;61;2016
05;Ávila;229;Santo Domingo de las Posadas;88;48;40;2016
05;Ávila;230;Santo Tomé de Zabarcos;69;38;31;2016
05;Ávila;232;Serrada, La;117;62;55;2016
05;Ávila;233;Serranillos;250;139;111;2016
05;Ávila;234;Sigeres;46;23;23;2016
05;Ávila;235;Sinlabajos;124;66;58;2016
05;Ávila;236;Solana de Ávila;126;71;55;2016
05;Ávila;237;Solana de Rioalmar;174;98;76;2016
05;Ávila;238;Solosancho;885;468;417;2016
05;Ávila;239;Sotalbo;232;121;111;2016
05;Ávila;240;Sotillo de la Adrada;4621;2306;2315;2016
05;Ávila;241;Tiemblo, El;4190;2130;2060;2016
05;Ávila;242;Tiñosillos;797;415;382;2016
05;Ávila;243;Tolbaños;86;47;39;2016
05;Ávila;244;Tormellas;50;29;21;2016
05;Ávila;245;Tornadizos de Ávila;435;217;218;2016
05;Ávila;247;Torre, La;261;143;118;2016
05;Ávila;246;Tórtoles;63;33;30;2016
05;Ávila;249;Umbrías;113;59;54;2016
05;Ávila;251;Vadillo de la Sierra;63;39;24;2016
05;Ávila;252;Valdecasa;72;42;30;2016
05;Ávila;253;Vega de Santa María;89;46;43;2016
05;Ávila;254;Velayos;224;110;114;2016
05;Ávila;256;Villaflor;122;61;61;2016
05;Ávila;257;Villafranca de la Sierra;128;71;57;2016
05;Ávila;905;Villanueva de Ávila;226;113;113;2016
05;Ávila;258;Villanueva de Gómez;140;79;61;2016
05;Ávila;259;Villanueva del Aceral;138;69;69;2016
05;Ávila;260;Villanueva del Campillo;100;59;41;2016
05;Ávila;261;Villar de Corneja;40;24;16;2016
05;Ávila;262;Villarejo del Valle;391;206;185;2016
05;Ávila;263;Villatoro;181;100;81;2016
05;Ávila;264;Viñegra de Moraña;48;26;22;2016
05;Ávila;265;Vita;84;50;34;2016
05;Ávila;266;Zapardiel de la Cañada;98;54;44;2016
05;Ávila;267;Zapardiel de la Ribera;114;60;54;2016
06;Badajoz;001;Acedera;823;425;398;2016
06;Badajoz;002;Aceuchal;5485;2715;2770;2016
06;Badajoz;003;Ahillones;934;466;468;2016
06;Badajoz;004;Alange;1915;967;948;2016
06;Badajoz;005;Albuera, La;2031;1048;983;2016
06;Badajoz;006;Alburquerque;5436;2742;2694;2016
06;Badajoz;007;Alconchel;1750;869;881;2016
06;Badajoz;008;Alconera;756;371;385;2016
06;Badajoz;009;Aljucén;249;137;112;2016
06;Badajoz;010;Almendral;1282;626;656;2016
06;Badajoz;011;Almendralejo;34543;17238;17305;2016
06;Badajoz;012;Arroyo de San Serván;4159;2118;2041;2016
06;Badajoz;013;Atalaya;298;156;142;2016
06;Badajoz;014;Azuaga;8008;3965;4043;2016
06;Badajoz;015;Badajoz;149946;72764;77182;2016
06;Badajoz;016;Barcarrota;3621;1849;1772;2016
06;Badajoz;017;Baterno;310;166;144;2016
06;Badajoz;018;Benquerencia de la Serena;865;426;439;2016
06;Badajoz;019;Berlanga;2412;1210;1202;2016
06;Badajoz;020;Bienvenida;2211;1145;1066;2016
06;Badajoz;021;Bodonal de la Sierra;1070;554;516;2016
06;Badajoz;022;Burguillos del Cerro;3132;1548;1584;2016
06;Badajoz;023;Cabeza del Buey;5065;2516;2549;2016
06;Badajoz;024;Cabeza la Vaca;1366;699;667;2016
06;Badajoz;025;Calamonte;6255;3098;3157;2016
06;Badajoz;026;Calera de León;1003;507;496;2016
06;Badajoz;027;Calzadilla de los Barros;823;414;409;2016
06;Badajoz;028;Campanario;5083;2503;2580;2016
06;Badajoz;029;Campillo de Llerena;1406;710;696;2016
06;Badajoz;030;Capilla;188;96;92;2016
06;Badajoz;031;Carmonita;562;278;284;2016
06;Badajoz;032;Carrascalejo, El;74;36;38;2016
06;Badajoz;033;Casas de Don Pedro;1544;791;753;2016
06;Badajoz;034;Casas de Reina;194;90;104;2016
06;Badajoz;035;Castilblanco;1040;529;511;2016
06;Badajoz;036;Castuera;6115;3026;3089;2016
06;Badajoz;042;Cheles;1227;583;644;2016
06;Badajoz;037;Codosera, La;2186;1153;1033;2016
06;Badajoz;038;Cordobilla de Lácara;945;486;459;2016
06;Badajoz;039;Coronada, La;2200;1083;1117;2016
06;Badajoz;040;Corte de Peleas;1282;628;654;2016
06;Badajoz;041;Cristina;560;287;273;2016
06;Badajoz;043;Don Álvaro;762;392;370;2016
06;Badajoz;044;Don Benito;36975;18250;18725;2016
06;Badajoz;045;Entrín Bajo;583;293;290;2016
06;Badajoz;046;Esparragalejo;1488;732;756;2016
06;Badajoz;047;Esparragosa de la Serena;1043;535;508;2016
06;Badajoz;048;Esparragosa de Lares;954;464;490;2016
06;Badajoz;049;Feria;1197;584;613;2016
06;Badajoz;050;Fregenal de la Sierra;4914;2411;2503;2016
06;Badajoz;051;Fuenlabrada de los Montes;1911;942;969;2016
06;Badajoz;052;Fuente de Cantos;4903;2412;2491;2016
06;Badajoz;053;Fuente del Arco;702;355;347;2016
06;Badajoz;054;Fuente del Maestre;6867;3393;3474;2016
06;Badajoz;055;Fuentes de León;2388;1174;1214;2016
06;Badajoz;056;Garbayuela;530;281;249;2016
06;Badajoz;057;Garlitos;631;330;301;2016
06;Badajoz;058;Garrovilla, La;2410;1217;1193;2016
06;Badajoz;059;Granja de Torrehermosa;2122;1048;1074;2016
06;Badajoz;903;Guadiana del Caudillo;2544;1256;1288;2016
06;Badajoz;060;Guareña;7097;3581;3516;2016
06;Badajoz;061;Haba, La;1275;639;636;2016
06;Badajoz;062;Helechosa de los Montes;684;384;300;2016
06;Badajoz;063;Herrera del Duque;3614;1829;1785;2016
06;Badajoz;064;Higuera de la Serena;943;498;445;2016
06;Badajoz;065;Higuera de Llerena;358;181;177;2016
06;Badajoz;066;Higuera de Vargas;2011;1006;1005;2016
06;Badajoz;067;Higuera la Real;2327;1172;1155;2016
06;Badajoz;068;Hinojosa del Valle;503;251;252;2016
06;Badajoz;069;Hornachos;3709;1858;1851;2016
06;Badajoz;070;Jerez de los Caballeros;9531;4746;4785;2016
06;Badajoz;071;Lapa, La;288;149;139;2016
06;Badajoz;073;Llera;870;449;421;2016
06;Badajoz;074;Llerena;5877;2941;2936;2016
06;Badajoz;072;Lobón;2825;1456;1369;2016
06;Badajoz;075;Magacela;533;279;254;2016
06;Badajoz;076;Maguilla;999;494;505;2016
06;Badajoz;077;Malcocinado;379;209;170;2016
06;Badajoz;078;Malpartida de la Serena;593;305;288;2016
06;Badajoz;079;Manchita;770;394;376;2016
06;Badajoz;080;Medellín;2300;1158;1142;2016
06;Badajoz;081;Medina de las Torres;1256;646;610;2016
06;Badajoz;082;Mengabril;471;251;220;2016
06;Badajoz;083;Mérida;59174;28886;30288;2016
06;Badajoz;084;Mirandilla;1344;682;662;2016
06;Badajoz;085;Monesterio;4292;2189;2103;2016
06;Badajoz;086;Montemolín;1421;686;735;2016
06;Badajoz;087;Monterrubio de la Serena;2472;1196;1276;2016
06;Badajoz;088;Montijo;15674;7767;7907;2016
06;Badajoz;089;Morera, La;727;369;358;2016
06;Badajoz;090;Nava de Santiago, La;997;502;495;2016
06;Badajoz;091;Navalvillar de Pela;4604;2329;2275;2016
06;Badajoz;092;Nogales;699;348;351;2016
06;Badajoz;093;Oliva de la Frontera;5340;2690;2650;2016
06;Badajoz;094;Oliva de Mérida;1786;916;870;2016
06;Badajoz;095;Olivenza;12032;5994;6038;2016
06;Badajoz;096;Orellana de la Sierra;243;132;111;2016
06;Badajoz;097;Orellana la Vieja;2796;1458;1338;2016
06;Badajoz;098;Palomas;700;348;352;2016
06;Badajoz;099;Parra, La;1364;697;667;2016
06;Badajoz;100;Peñalsordo;1024;490;534;2016
06;Badajoz;101;Peraleda del Zaucejo;555;282;273;2016
06;Badajoz;102;Puebla de Alcocer;1239;609;630;2016
06;Badajoz;103;Puebla de la Calzada;5952;2984;2968;2016
06;Badajoz;104;Puebla de la Reina;781;388;393;2016
06;Badajoz;107;Puebla de Obando;1872;941;931;2016
06;Badajoz;108;Puebla de Sancho Pérez;2758;1392;1366;2016
06;Badajoz;105;Puebla del Maestre;731;372;359;2016
06;Badajoz;106;Puebla del Prior;496;257;239;2016
06;Badajoz;902;Pueblonuevo del Guadiana;2036;1035;1001;2016
06;Badajoz;109;Quintana de la Serena;4762;2417;2345;2016
06;Badajoz;110;Reina;166;80;86;2016
06;Badajoz;111;Rena;648;329;319;2016
06;Badajoz;112;Retamal de Llerena;454;235;219;2016
06;Badajoz;113;Ribera del Fresno;3449;1713;1736;2016
06;Badajoz;114;Risco;152;75;77;2016
06;Badajoz;115;Roca de la Sierra, La;1512;740;772;2016
06;Badajoz;116;Salvaleón;1865;933;932;2016
06;Badajoz;117;Salvatierra de los Barros;1701;837;864;2016
06;Badajoz;119;San Pedro de Mérida;860;442;418;2016
06;Badajoz;123;San Vicente de Alcántara;5620;2827;2793;2016
06;Badajoz;118;Sancti-Spíritus;214;119;95;2016
06;Badajoz;120;Santa Amalia;4108;2077;2031;2016
06;Badajoz;121;Santa Marta;4293;2155;2138;2016
06;Badajoz;122;Santos de Maimona, Los;8218;4153;4065;2016
06;Badajoz;124;Segura de León;1991;984;1007;2016
06;Badajoz;125;Siruela;1981;984;997;2016
06;Badajoz;126;Solana de los Barros;2700;1343;1357;2016
06;Badajoz;127;Talarrubias;3529;1759;1770;2016
06;Badajoz;128;Talavera la Real;5453;2742;2711;2016
06;Badajoz;129;Táliga;708;354;354;2016
06;Badajoz;130;Tamurejo;230;119;111;2016
06;Badajoz;131;Torre de Miguel Sesmero;1259;639;620;2016
06;Badajoz;132;Torremayor;1013;486;527;2016
06;Badajoz;133;Torremejía;2261;1164;1097;2016
06;Badajoz;134;Trasierra;656;349;307;2016
06;Badajoz;135;Trujillanos;1418;742;676;2016
06;Badajoz;136;Usagre;1822;895;927;2016
06;Badajoz;137;Valdecaballeros;1116;576;540;2016
06;Badajoz;901;Valdelacalzada;2782;1424;1358;2016
06;Badajoz;138;Valdetorres;1221;606;615;2016
06;Badajoz;139;Valencia de las Torres;623;334;289;2016
06;Badajoz;140;Valencia del Mombuey;756;384;372;2016
06;Badajoz;141;Valencia del Ventoso;2045;1021;1024;2016
06;Badajoz;146;Valle de la Serena;1265;643;622;2016
06;Badajoz;147;Valle de Matamoros;379;191;188;2016
06;Badajoz;148;Valle de Santa Ana;1163;571;592;2016
06;Badajoz;142;Valverde de Burguillos;292;152;140;2016
06;Badajoz;143;Valverde de Leganés;4202;2113;2089;2016
06;Badajoz;144;Valverde de Llerena;642;318;324;2016
06;Badajoz;145;Valverde de Mérida;1078;550;528;2016
06;Badajoz;149;Villafranca de los Barros;13224;6534;6690;2016
06;Badajoz;150;Villagarcía de la Torre;942;491;451;2016
06;Badajoz;151;Villagonzalo;1261;616;645;2016
06;Badajoz;152;Villalba de los Barros;1570;798;772;2016
06;Badajoz;153;Villanueva de la Serena;25992;12739;13253;2016
06;Badajoz;154;Villanueva del Fresno;3464;1731;1733;2016
06;Badajoz;156;Villar de Rena;1411;731;680;2016
06;Badajoz;155;Villar del Rey;2241;1197;1044;2016
06;Badajoz;157;Villarta de los Montes;503;254;249;2016
06;Badajoz;158;Zafra;16855;8158;8697;2016
06;Badajoz;159;Zahínos;2803;1381;1422;2016
06;Badajoz;160;Zalamea de la Serena;3751;1886;1865;2016
06;Badajoz;162;Zarza, La;3542;1790;1752;2016
06;Badajoz;161;Zarza-Capilla;347;171;176;2016
07;Balears, Illes;002;Alaior;8959;4492;4467;2016
07;Balears, Illes;001;Alaró;5282;2577;2705;2016
07;Balears, Illes;003;Alcúdia;19296;9758;9538;2016
07;Balears, Illes;004;Algaida;5394;2751;2643;2016
07;Balears, Illes;005;Andratx;10873;5415;5458;2016
07;Balears, Illes;901;Ariany;859;450;409;2016
07;Balears, Illes;006;Artà;7448;3730;3718;2016
07;Balears, Illes;007;Banyalbufar;522;289;233;2016
07;Balears, Illes;008;Binissalem;7966;3929;4037;2016
07;Balears, Illes;009;Búger;1050;539;511;2016
07;Balears, Illes;010;Bunyola;6669;3284;3385;2016
07;Balears, Illes;011;Calvià;49580;24736;24844;2016
07;Balears, Illes;012;Campanet;2507;1240;1267;2016
07;Balears, Illes;013;Campos;10164;5066;5098;2016
07;Balears, Illes;014;Capdepera;11356;5800;5556;2016
07;Balears, Illes;064;Castell, Es;7455;3779;3676;2016
07;Balears, Illes;015;Ciutadella de Menorca;28641;14230;14411;2016
07;Balears, Illes;016;Consell;3869;1956;1913;2016
07;Balears, Illes;017;Costitx;1246;621;625;2016
07;Balears, Illes;018;Deià;642;311;331;2016
07;Balears, Illes;026;Eivissa;49549;24996;24553;2016
07;Balears, Illes;019;Escorca;230;135;95;2016
07;Balears, Illes;020;Esporles;4959;2456;2503;2016
07;Balears, Illes;021;Estellencs;323;173;150;2016
07;Balears, Illes;022;Felanitx;17319;8710;8609;2016
07;Balears, Illes;023;Ferreries;4617;2318;2299;2016
07;Balears, Illes;024;Formentera;12124;6356;5768;2016
07;Balears, Illes;025;Fornalutx;687;342;345;2016
07;Balears, Illes;027;Inca;30944;15552;15392;2016
07;Balears, Illes;028;Lloret de Vistalegre;1257;643;614;2016
07;Balears, Illes;029;Lloseta;5710;2888;2822;2016
07;Balears, Illes;030;Llubí;2157;1076;1081;2016
07;Balears, Illes;031;Llucmajor;35057;17708;17349;2016
07;Balears, Illes;033;Manacor;40279;20069;20210;2016
07;Balears, Illes;034;Mancor de la Vall;1383;691;692;2016
07;Balears, Illes;032;Maó-Mahón;28099;13769;14330;2016
07;Balears, Illes;035;Maria de la Salut;2073;1067;1006;2016
07;Balears, Illes;036;Marratxí;36001;18124;17877;2016
07;Balears, Illes;037;Mercadal, Es;5098;2570;2528;2016
07;Balears, Illes;902;Migjorn Gran, Es;1419;707;712;2016
07;Balears, Illes;038;Montuïri;2884;1446;1438;2016
07;Balears, Illes;039;Muro;6729;3371;3358;2016
07;Balears, Illes;040;Palma de Mallorca;402949;196220;206729;2016
07;Balears, Illes;041;Petra;2774;1375;1399;2016
07;Balears, Illes;044;Pobla, Sa;12714;6465;6249;2016
07;Balears, Illes;042;Pollença;16222;8083;8139;2016
07;Balears, Illes;043;Porreres;5197;2662;2535;2016
07;Balears, Illes;045;Puigpunyent;2021;1013;1008;2016
07;Balears, Illes;059;Salines, Ses;4895;2470;2425;2016
07;Balears, Illes;046;Sant Antoni de Portmany;24478;12773;11705;2016
07;Balears, Illes;049;Sant Joan;2042;1005;1037;2016
07;Balears, Illes;050;Sant Joan de Labritja;6070;3108;2962;2016
07;Balears, Illes;048;Sant Josep de sa Talaia;25849;13399;12450;2016
07;Balears, Illes;051;Sant Llorenç des Cardassar;8138;4029;4109;2016
07;Balears, Illes;052;Sant Lluís;7313;3684;3629;2016
07;Balears, Illes;053;Santa Eugènia;1636;825;811;2016
07;Balears, Illes;054;Santa Eulària des Riu;36119;18300;17819;2016
07;Balears, Illes;055;Santa Margalida;11632;5902;5730;2016
07;Balears, Illes;056;Santa María del Camí;6832;3403;3429;2016
07;Balears, Illes;057;Santanyí;11220;5584;5636;2016
07;Balears, Illes;058;Selva;3864;1930;1934;2016
07;Balears, Illes;047;Sencelles;3096;1562;1534;2016
07;Balears, Illes;060;Sineu;3629;1813;1816;2016
07;Balears, Illes;061;Sóller;13791;6928;6863;2016
07;Balears, Illes;062;Son Servera;11119;5552;5567;2016
07;Balears, Illes;063;Valldemossa;2003;1010;993;2016
07;Balears, Illes;065;Vilafranca de Bonany;2941;1467;1474;2016
08;Barcelona;001;Abrera;12216;6215;6001;2016
08;Barcelona;002;Aguilar de Segarra;253;133;120;2016
08;Barcelona;014;Aiguafreda;2467;1172;1295;2016
08;Barcelona;003;Alella;9632;4690;4942;2016
08;Barcelona;004;Alpens;294;153;141;2016
08;Barcelona;005;Ametlla del Vallès, L';8337;4199;4138;2016
08;Barcelona;006;Arenys de Mar;15253;7463;7790;2016
08;Barcelona;007;Arenys de Munt;8638;4353;4285;2016
08;Barcelona;008;Argençola;227;120;107;2016
08;Barcelona;009;Argentona;12051;5916;6135;2016
08;Barcelona;010;Artés;5596;2823;2773;2016
08;Barcelona;011;Avià;2257;1113;1144;2016
08;Barcelona;012;Avinyó;2212;1102;1110;2016
08;Barcelona;013;Avinyonet del Penedès;1665;885;780;2016
08;Barcelona;015;Badalona;215634;106301;109333;2016
08;Barcelona;904;Badia del Vallès;13482;6588;6894;2016
08;Barcelona;016;Bagà;2162;1076;1086;2016
08;Barcelona;017;Balenyà;3705;1861;1844;2016
08;Barcelona;018;Balsareny;3285;1629;1656;2016
08;Barcelona;252;Barberà del Vallès;32832;16229;16603;2016
08;Barcelona;019;Barcelona;1608746;761487;847259;2016
08;Barcelona;020;Begues;6736;3324;3412;2016
08;Barcelona;021;Bellprat;75;46;29;2016
08;Barcelona;022;Berga;16175;7950;8225;2016
08;Barcelona;023;Bigues i Riells;8915;4546;4369;2016
08;Barcelona;024;Borredà;495;274;221;2016
08;Barcelona;025;Bruc, El;2014;1081;933;2016
08;Barcelona;026;Brull, El;263;142;121;2016
08;Barcelona;027;Cabanyes, Les;943;483;460;2016
08;Barcelona;028;Cabrera d'Anoia;1351;712;639;2016
08;Barcelona;029;Cabrera de Mar;4553;2299;2254;2016
08;Barcelona;030;Cabrils;7287;3603;3684;2016
08;Barcelona;031;Calaf;3424;1752;1672;2016
08;Barcelona;034;Calders;953;494;459;2016
08;Barcelona;033;Caldes de Montbui;17137;8523;8614;2016
08;Barcelona;032;Caldes d'Estrac;2766;1341;1425;2016
08;Barcelona;035;Calella;18317;8979;9338;2016
08;Barcelona;037;Calldetenes;2418;1233;1185;2016
08;Barcelona;038;Callús;2057;1008;1049;2016
08;Barcelona;036;Calonge de Segarra;191;96;95;2016
08;Barcelona;039;Campins;470;246;224;2016
08;Barcelona;040;Canet de Mar;14284;6936;7348;2016
08;Barcelona;041;Canovelles;15937;8250;7687;2016
08;Barcelona;042;Cànoves i Samalús;2873;1452;1421;2016
08;Barcelona;043;Canyelles;4407;2246;2161;2016
08;Barcelona;044;Capellades;5227;2572;2655;2016
08;Barcelona;045;Capolat;93;45;48;2016
08;Barcelona;046;Cardedeu;18158;8958;9200;2016
08;Barcelona;047;Cardona;4775;2351;2424;2016
08;Barcelona;048;Carme;791;411;380;2016
08;Barcelona;049;Casserres;1528;760;768;2016
08;Barcelona;057;Castell de l'Areny;69;40;29;2016
08;Barcelona;052;Castellar de n'Hug;157;83;74;2016
08;Barcelona;050;Castellar del Riu;176;97;79;2016
08;Barcelona;051;Castellar del Vallès;23633;11639;11994;2016
08;Barcelona;053;Castellbell i el Vilar;3584;1820;1764;2016
08;Barcelona;054;Castellbisbal;12277;6206;6071;2016
08;Barcelona;055;Castellcir;726;367;359;2016
08;Barcelona;056;Castelldefels;64892;32034;32858;2016
08;Barcelona;058;Castellet i la Gornal;2193;1104;1089;2016
08;Barcelona;060;Castellfollit de Riubregós;165;96;69;2016
08;Barcelona;059;Castellfollit del Boix;448;225;223;2016
08;Barcelona;061;Castellgalí;1995;1039;956;2016
08;Barcelona;062;Castellnou de Bages;1287;647;640;2016
08;Barcelona;063;Castellolí;573;277;296;2016
08;Barcelona;064;Castellterçol;2351;1181;1170;2016
08;Barcelona;065;Castellví de la Marca;1545;772;773;2016
08;Barcelona;066;Castellví de Rosanes;1807;882;925;2016
08;Barcelona;067;Centelles;7410;3632;3778;2016
08;Barcelona;268;Cercs;1183;591;592;2016
08;Barcelona;266;Cerdanyola del Vallès;57543;28184;29359;2016
08;Barcelona;068;Cervelló;8861;4453;4408;2016
08;Barcelona;069;Collbató;4396;2259;2137;2016
08;Barcelona;070;Collsuspina;349;185;164;2016
08;Barcelona;071;Copons;300;152;148;2016
08;Barcelona;072;Corbera de Llobregat;14168;7089;7079;2016
08;Barcelona;073;Cornellà de Llobregat;86072;41878;44194;2016
08;Barcelona;074;Cubelles;14608;7390;7218;2016
08;Barcelona;075;Dosrius;5154;2614;2540;2016
08;Barcelona;076;Esparreguera;21766;11021;10745;2016
08;Barcelona;077;Esplugues de Llobregat;45733;21979;23754;2016
08;Barcelona;078;Espunyola, L';247;126;121;2016
08;Barcelona;254;Esquirol, L';2168;1097;1071;2016
08;Barcelona;079;Estany, L';404;200;204;2016
08;Barcelona;134;Figaró-Montmany;1092;538;554;2016
08;Barcelona;080;Fígols;40;23;17;2016
08;Barcelona;082;Fogars de la Selva;1452;752;700;2016
08;Barcelona;081;Fogars de Montclús;462;245;217;2016
08;Barcelona;083;Folgueroles;2298;1158;1140;2016
08;Barcelona;084;Fonollosa;1401;732;669;2016
08;Barcelona;085;Font-rubí;1363;697;666;2016
08;Barcelona;086;Franqueses del Vallès, Les;19417;9855;9562;2016
08;Barcelona;090;Gaià;160;88;72;2016
08;Barcelona;087;Gallifa;187;99;88;2016
08;Barcelona;088;Garriga, La;15912;7728;8184;2016
08;Barcelona;089;Gavà;46266;22757;23509;2016
08;Barcelona;091;Gelida;7238;3640;3598;2016
08;Barcelona;092;Gironella;4829;2361;2468;2016
08;Barcelona;093;Gisclareny;29;17;12;2016
08;Barcelona;094;Granada, La;2091;1065;1026;2016
08;Barcelona;095;Granera;79;53;26;2016
08;Barcelona;096;Granollers;60174;29668;30506;2016
08;Barcelona;097;Gualba;1426;718;708;2016
08;Barcelona;099;Guardiola de Berguedà;897;474;423;2016
08;Barcelona;100;Gurb;2559;1311;1248;2016
08;Barcelona;101;Hospitalet de Llobregat, L';254804;123505;131299;2016
08;Barcelona;162;Hostalets de Pierola, Els;2891;1494;1397;2016
08;Barcelona;102;Igualada;38987;19046;19941;2016
08;Barcelona;103;Jorba;831;406;425;2016
08;Barcelona;104;Llacuna, La;872;474;398;2016
08;Barcelona;105;Llagosta, La;13247;6528;6719;2016
08;Barcelona;107;Lliçà d'Amunt;14759;7557;7202;2016
08;Barcelona;108;Lliçà de Vall;6370;3239;3131;2016
08;Barcelona;106;Llinars del Vallès;9717;4821;4896;2016
08;Barcelona;109;Lluçà;280;135;145;2016
08;Barcelona;110;Malgrat de Mar;18295;9118;9177;2016
08;Barcelona;111;Malla;267;135;132;2016
08;Barcelona;112;Manlleu;20104;10033;10071;2016
08;Barcelona;113;Manresa;74752;36545;38207;2016
08;Barcelona;242;Marganell;277;136;141;2016
08;Barcelona;114;Martorell;27645;14073;13572;2016
08;Barcelona;115;Martorelles;4725;2356;2369;2016
08;Barcelona;116;Masies de Roda, Les;714;360;354;2016
08;Barcelona;117;Masies de Voltregà, Les;3170;1564;1606;2016
08;Barcelona;118;Masnou, El;23119;11131;11988;2016
08;Barcelona;119;Masquefa;8386;4220;4166;2016
08;Barcelona;120;Matadepera;8984;4508;4476;2016
08;Barcelona;121;Mataró;125517;62355;63162;2016
08;Barcelona;122;Mediona;2282;1143;1139;2016
08;Barcelona;138;Moià;5957;2995;2962;2016
08;Barcelona;123;Molins de Rei;25359;12342;13017;2016
08;Barcelona;124;Mollet del Vallès;51491;25498;25993;2016
08;Barcelona;128;Monistrol de Calders;699;363;336;2016
08;Barcelona;127;Monistrol de Montserrat;2867;1456;1411;2016
08;Barcelona;125;Montcada i Reixac;34802;17170;17632;2016
08;Barcelona;130;Montclar;119;58;61;2016
08;Barcelona;131;Montesquiu;931;465;466;2016
08;Barcelona;126;Montgat;11621;5759;5862;2016
08;Barcelona;132;Montmajor;471;234;237;2016
08;Barcelona;133;Montmaneu;151;78;73;2016
08;Barcelona;135;Montmeló;8784;4299;4485;2016
08;Barcelona;136;Montornès del Vallès;16218;8220;7998;2016
08;Barcelona;137;Montseny;320;166;154;2016
08;Barcelona;129;Muntanyola;604;312;292;2016
08;Barcelona;139;Mura;219;118;101;2016
08;Barcelona;140;Navarcles;5988;2915;3073;2016
08;Barcelona;141;Navàs;6045;3017;3028;2016
08;Barcelona;142;Nou de Berguedà, La;151;75;76;2016
08;Barcelona;143;Òdena;3607;1842;1765;2016
08;Barcelona;145;Olèrdola;3529;1824;1705;2016
08;Barcelona;146;Olesa de Bonesvalls;1723;898;825;2016
08;Barcelona;147;Olesa de Montserrat;23645;11844;11801;2016
08;Barcelona;148;Olivella;3569;1897;1672;2016
08;Barcelona;149;Olost;1185;599;586;2016
08;Barcelona;144;Olvan;855;419;436;2016
08;Barcelona;150;Orís;310;157;153;2016
08;Barcelona;151;Oristà;547;267;280;2016
08;Barcelona;152;Orpí;139;76;63;2016
08;Barcelona;153;Òrrius;702;370;332;2016
08;Barcelona;154;Pacs del Penedès;894;457;437;2016
08;Barcelona;155;Palafolls;9133;4605;4528;2016
08;Barcelona;156;Palau-solità i Plegamans;14494;7135;7359;2016
08;Barcelona;157;Pallejà;11348;5656;5692;2016
08;Barcelona;905;Palma de Cervelló, La;3000;1494;1506;2016
08;Barcelona;158;Papiol, El;4075;2021;2054;2016
08;Barcelona;159;Parets del Vallès;18837;9477;9360;2016
08;Barcelona;160;Perafita;411;207;204;2016
08;Barcelona;161;Piera;15001;7648;7353;2016
08;Barcelona;163;Pineda de Mar;26240;13107;13133;2016
08;Barcelona;164;Pla del Penedès, El;1253;623;630;2016
08;Barcelona;165;Pobla de Claramunt, La;2159;1091;1068;2016
08;Barcelona;166;Pobla de Lillet, La;1110;542;568;2016
08;Barcelona;167;Polinyà;8300;4210;4090;2016
08;Barcelona;182;Pont de Vilomara i Rocafort, El;3724;1919;1805;2016
08;Barcelona;168;Pontons;453;259;194;2016
08;Barcelona;169;Prat de Llobregat, El;63457;31163;32294;2016
08;Barcelona;171;Prats de Lluçanès;2565;1286;1279;2016
08;Barcelona;170;Prats de Rei, Els;535;284;251;2016
08;Barcelona;230;Premià de Dalt;10446;5260;5186;2016
08;Barcelona;172;Premià de Mar;27866;13617;14249;2016
08;Barcelona;174;Puigdàlber;512;253;259;2016
08;Barcelona;175;Puig-reig;4123;2001;2122;2016
08;Barcelona;176;Pujalt;198;107;91;2016
08;Barcelona;177;Quar, La;54;28;26;2016
08;Barcelona;178;Rajadell;533;269;264;2016
08;Barcelona;179;Rellinars;723;374;349;2016
08;Barcelona;180;Ripollet;37648;18646;19002;2016
08;Barcelona;181;Roca del Vallès, La;10599;5307;5292;2016
08;Barcelona;183;Roda de Ter;6116;3001;3115;2016
08;Barcelona;184;Rubí;75167;37221;37946;2016
08;Barcelona;185;Rubió;231;126;105;2016
08;Barcelona;901;Rupit i Pruit;277;142;135;2016
08;Barcelona;187;Sabadell;208246;101341;106905;2016
08;Barcelona;188;Sagàs;152;83;69;2016
08;Barcelona;190;Saldes;276;159;117;2016
08;Barcelona;191;Sallent;6592;3170;3422;2016
08;Barcelona;194;Sant Adrià de Besòs;36496;18029;18467;2016
08;Barcelona;195;Sant Agustí de Lluçanès;92;46;46;2016
08;Barcelona;196;Sant Andreu de la Barca;27434;13694;13740;2016
08;Barcelona;197;Sant Andreu de Llavaneres;10663;5274;5389;2016
08;Barcelona;198;Sant Antoni de Vilamajor;5862;2932;2930;2016
08;Barcelona;199;Sant Bartomeu del Grau;850;444;406;2016
08;Barcelona;200;Sant Boi de Llobregat;82402;40369;42033;2016
08;Barcelona;201;Sant Boi de Lluçanès;527;263;264;2016
08;Barcelona;203;Sant Cebrià de Vallalta;3329;1732;1597;2016
08;Barcelona;202;Sant Celoni;17540;8719;8821;2016
08;Barcelona;204;Sant Climent de Llobregat;4024;2022;2002;2016
08;Barcelona;205;Sant Cugat del Vallès;88921;43254;45667;2016
08;Barcelona;206;Sant Cugat Sesgarrigues;973;475;498;2016
08;Barcelona;207;Sant Esteve de Palautordera;2599;1277;1322;2016
08;Barcelona;208;Sant Esteve Sesrovires;7644;3820;3824;2016
08;Barcelona;210;Sant Feliu de Codines;5968;3008;2960;2016
08;Barcelona;211;Sant Feliu de Llobregat;44086;21405;22681;2016
08;Barcelona;212;Sant Feliu Sasserra;612;323;289;2016
08;Barcelona;209;Sant Fost de Campsentelles;8650;4316;4334;2016
08;Barcelona;213;Sant Fruitós de Bages;8387;4161;4226;2016
08;Barcelona;215;Sant Hipòlit de Voltregà;3462;1701;1761;2016
08;Barcelona;193;Sant Iscle de Vallalta;1292;669;623;2016
08;Barcelona;216;Sant Jaume de Frontanyà;27;18;9;2016
08;Barcelona;218;Sant Joan de Vilatorrada;10759;5390;5369;2016
08;Barcelona;217;Sant Joan Despí;33502;16356;17146;2016
08;Barcelona;903;Sant Julià de Cerdanyola;251;139;112;2016
08;Barcelona;220;Sant Julià de Vilatorta;3113;1523;1590;2016
08;Barcelona;221;Sant Just Desvern;16927;8123;8804;2016
08;Barcelona;222;Sant Llorenç d'Hortons;2562;1302;1260;2016
08;Barcelona;223;Sant Llorenç Savall;2375;1208;1167;2016
08;Barcelona;225;Sant Martí d'Albars;108;54;54;2016
08;Barcelona;224;Sant Martí de Centelles;1122;581;541;2016
08;Barcelona;226;Sant Martí de Tous;1190;603;587;2016
08;Barcelona;227;Sant Martí Sarroca;3099;1516;1583;2016
08;Barcelona;228;Sant Martí Sesgueioles;371;190;181;2016
08;Barcelona;229;Sant Mateu de Bages;618;311;307;2016
08;Barcelona;231;Sant Pere de Ribes;29842;14928;14914;2016
08;Barcelona;232;Sant Pere de Riudebitlles;2369;1187;1182;2016
08;Barcelona;233;Sant Pere de Torelló;2427;1246;1181;2016
08;Barcelona;234;Sant Pere de Vilamajor;4257;2133;2124;2016
08;Barcelona;189;Sant Pere Sallavinera;158;86;72;2016
08;Barcelona;235;Sant Pol de Mar;4951;2450;2501;2016
08;Barcelona;236;Sant Quintí de Mediona;2121;1079;1042;2016
08;Barcelona;237;Sant Quirze de Besora;2125;1052;1073;2016
08;Barcelona;238;Sant Quirze del Vallès;19664;9687;9977;2016
08;Barcelona;239;Sant Quirze Safaja;637;339;298;2016
08;Barcelona;240;Sant Sadurní d'Anoia;12654;6221;6433;2016
08;Barcelona;241;Sant Sadurní d'Osormort;80;49;31;2016
08;Barcelona;098;Sant Salvador de Guardiola;3141;1590;1551;2016
08;Barcelona;262;Sant Vicenç de Castellet;9235;4586;4649;2016
08;Barcelona;264;Sant Vicenç de Montalt;6182;3073;3109;2016
08;Barcelona;265;Sant Vicenç de Torelló;1996;982;1014;2016
08;Barcelona;263;Sant Vicenç dels Horts;27961;13936;14025;2016
08;Barcelona;243;Santa Cecília de Voltregà;183;96;87;2016
08;Barcelona;244;Santa Coloma de Cervelló;8073;3960;4113;2016
08;Barcelona;245;Santa Coloma de Gramenet;117153;58288;58865;2016
08;Barcelona;246;Santa Eugènia de Berga;2246;1148;1098;2016
08;Barcelona;247;Santa Eulàlia de Riuprimer;1266;641;625;2016
08;Barcelona;248;Santa Eulàlia de Ronçana;7049;3544;3505;2016
08;Barcelona;249;Santa Fe del Penedès;374;191;183;2016
08;Barcelona;250;Santa Margarida de Montbui;9611;4800;4811;2016
08;Barcelona;251;Santa Margarida i els Monjos;7360;3769;3591;2016
08;Barcelona;253;Santa Maria de Besora;148;75;73;2016
08;Barcelona;256;Santa Maria de Martorelles;861;436;425;2016
08;Barcelona;255;Santa Maria de Merlès;178;87;91;2016
08;Barcelona;257;Santa Maria de Miralles;132;71;61;2016
08;Barcelona;259;Santa Maria de Palautordera;9194;4633;4561;2016
08;Barcelona;258;Santa Maria d'Oló;1054;542;512;2016
08;Barcelona;260;Santa Perpètua de Mogoda;25556;12920;12636;2016
08;Barcelona;261;Santa Susanna;3323;1698;1625;2016
08;Barcelona;192;Santpedor;7520;3732;3788;2016
08;Barcelona;267;Sentmenat;8700;4391;4309;2016
08;Barcelona;269;Seva;3446;1734;1712;2016
08;Barcelona;270;Sitges;28478;14232;14246;2016
08;Barcelona;271;Sobremunt;83;33;50;2016
08;Barcelona;272;Sora;189;106;83;2016
08;Barcelona;273;Subirats;2997;1554;1443;2016
08;Barcelona;274;Súria;5873;2841;3032;2016
08;Barcelona;276;Tagamanent;316;170;146;2016
08;Barcelona;277;Talamanca;186;106;80;2016
08;Barcelona;278;Taradell;6321;3138;3183;2016
08;Barcelona;275;Tavèrnoles;318;161;157;2016
08;Barcelona;280;Tavertet;112;62;50;2016
08;Barcelona;281;Teià;6254;3073;3181;2016
08;Barcelona;279;Terrassa;215121;105879;109242;2016
08;Barcelona;282;Tiana;8553;4082;4471;2016
08;Barcelona;283;Tona;7951;3930;4021;2016
08;Barcelona;284;Tordera;16453;8343;8110;2016
08;Barcelona;285;Torelló;13877;6826;7051;2016
08;Barcelona;286;Torre de Claramunt, La;3722;1898;1824;2016
08;Barcelona;287;Torrelavit;1413;737;676;2016
08;Barcelona;288;Torrelles de Foix;2201;1171;1030;2016
08;Barcelona;289;Torrelles de Llobregat;5933;2934;2999;2016
08;Barcelona;290;Ullastrell;2039;1023;1016;2016
08;Barcelona;291;Vacarisses;6192;3189;3003;2016
08;Barcelona;292;Vallbona d'Anoia;1412;742;670;2016
08;Barcelona;293;Vallcebre;254;143;111;2016
08;Barcelona;294;Vallgorguina;2772;1409;1363;2016
08;Barcelona;295;Vallirana;14676;7331;7345;2016
08;Barcelona;296;Vallromanes;2525;1296;1229;2016
08;Barcelona;297;Veciana;173;95;78;2016
08;Barcelona;298;Vic;43287;21590;21697;2016
08;Barcelona;299;Vilada;430;228;202;2016
08;Barcelona;301;Viladecans;65779;32673;33106;2016
08;Barcelona;300;Viladecavalls;7354;3663;3691;2016
08;Barcelona;305;Vilafranca del Penedès;39365;19255;20110;2016
08;Barcelona;306;Vilalba Sasserra;684;341;343;2016
08;Barcelona;303;Vilanova de Sau;309;153;156;2016
08;Barcelona;302;Vilanova del Camí;12409;6218;6191;2016
08;Barcelona;902;Vilanova del Vallès;5217;2637;2580;2016
08;Barcelona;307;Vilanova i la Geltrú;65972;31973;33999;2016
08;Barcelona;214;Vilassar de Dalt;8953;4411;4542;2016
08;Barcelona;219;Vilassar de Mar;20678;9970;10708;2016
08;Barcelona;304;Vilobí del Penedès;1103;579;524;2016
08;Barcelona;308;Viver i Serrateix;162;86;76;2016
48;Bizkaia;001;Abadiño;7533;3770;3763;2016
48;Bizkaia;002;Abanto y Ciérvana-Abanto Zierbena;9577;4733;4844;2016
48;Bizkaia;911;Ajangiz;469;242;227;2016
48;Bizkaia;912;Alonsotegi;2857;1392;1465;2016
48;Bizkaia;003;Amorebieta-Etxano;18859;9302;9557;2016
48;Bizkaia;004;Amoroto;425;217;208;2016
48;Bizkaia;005;Arakaldo;157;76;81;2016
48;Bizkaia;006;Arantzazu;377;185;192;2016
48;Bizkaia;093;Areatza;1214;583;631;2016
48;Bizkaia;009;Arrankudiaga;986;485;501;2016
48;Bizkaia;914;Arratzu;409;197;212;2016
48;Bizkaia;010;Arrieta;562;290;272;2016
48;Bizkaia;011;Arrigorriaga;12260;5978;6282;2016
48;Bizkaia;023;Artea;747;370;377;2016
48;Bizkaia;008;Artzentales;743;397;346;2016
48;Bizkaia;091;Atxondo;1374;694;680;2016
48;Bizkaia;070;Aulesti;658;328;330;2016
48;Bizkaia;012;Bakio;2604;1320;1284;2016
48;Bizkaia;090;Balmaseda;7655;3753;3902;2016
48;Bizkaia;013;Barakaldo;100025;48277;51748;2016
48;Bizkaia;014;Barrika;1522;752;770;2016
48;Bizkaia;015;Basauri;40983;19903;21080;2016
48;Bizkaia;092;Bedia;1027;490;537;2016
48;Bizkaia;016;Berango;6972;3415;3557;2016
48;Bizkaia;017;Bermeo;16861;8332;8529;2016
48;Bizkaia;018;Berriatua;1214;656;558;2016
48;Bizkaia;019;Berriz;4707;2352;2355;2016
48;Bizkaia;020;Bilbao;345122;162732;182390;2016
48;Bizkaia;021;Busturia;1659;829;830;2016
48;Bizkaia;901;Derio;6154;2999;3155;2016
48;Bizkaia;026;Dima;1458;741;717;2016
48;Bizkaia;027;Durango;29031;14196;14835;2016
48;Bizkaia;028;Ea;845;427;418;2016
48;Bizkaia;031;Elantxobe;373;183;190;2016
48;Bizkaia;032;Elorrio;7303;3631;3672;2016
48;Bizkaia;902;Erandio;24240;11860;12380;2016
48;Bizkaia;033;Ereño;255;140;115;2016
48;Bizkaia;034;Ermua;16028;8021;8007;2016
48;Bizkaia;079;Errigoiti;513;284;229;2016
48;Bizkaia;029;Etxebarri;11017;5502;5515;2016
48;Bizkaia;030;Etxebarria;775;390;385;2016
48;Bizkaia;906;Forua;934;466;468;2016
48;Bizkaia;035;Fruiz;540;274;266;2016
48;Bizkaia;036;Galdakao;29315;14435;14880;2016
48;Bizkaia;037;Galdames;812;425;387;2016
48;Bizkaia;038;Gamiz-Fika;1365;674;691;2016
48;Bizkaia;039;Garai;309;152;157;2016
48;Bizkaia;040;Gatika;1656;827;829;2016
48;Bizkaia;041;Gautegiz Arteaga;851;427;424;2016
48;Bizkaia;046;Gernika-Lumo;16869;8139;8730;2016
48;Bizkaia;044;Getxo;78554;36898;41656;2016
48;Bizkaia;047;Gizaburuaga;208;112;96;2016
48;Bizkaia;042;Gordexola;1698;867;831;2016
48;Bizkaia;043;Gorliz;5669;2800;2869;2016
48;Bizkaia;045;Güeñes;6658;3244;3414;2016
48;Bizkaia;048;Ibarrangelu;641;327;314;2016
48;Bizkaia;094;Igorre;4194;2043;2151;2016
48;Bizkaia;049;Ispaster;721;388;333;2016
48;Bizkaia;910;Iurreta;3724;1852;1872;2016
48;Bizkaia;050;Izurtza;238;138;100;2016
48;Bizkaia;022;Karrantza Harana/Valle de Carranza;2729;1416;1313;2016
48;Bizkaia;907;Kortezubi;449;222;227;2016
48;Bizkaia;051;Lanestosa;266;139;127;2016
48;Bizkaia;052;Larrabetzu;2050;991;1059;2016
48;Bizkaia;053;Laukiz;1180;592;588;2016
48;Bizkaia;054;Leioa;30857;15012;15845;2016
48;Bizkaia;057;Lekeitio;7182;3560;3622;2016
48;Bizkaia;055;Lemoa;3523;1772;1751;2016
48;Bizkaia;056;Lemoiz;1219;651;568;2016
48;Bizkaia;081;Lezama;2394;1194;1200;2016
48;Bizkaia;903;Loiu;2360;1158;1202;2016
48;Bizkaia;058;Mallabia;1173;593;580;2016
48;Bizkaia;059;Mañaria;523;269;254;2016
48;Bizkaia;060;Markina-Xemein;4970;2533;2437;2016
48;Bizkaia;061;Maruri-Jatabe;954;486;468;2016
48;Bizkaia;062;Mendata;390;202;188;2016
48;Bizkaia;063;Mendexa;460;235;225;2016
48;Bizkaia;064;Meñaka;741;384;357;2016
48;Bizkaia;066;Morga;417;215;202;2016
48;Bizkaia;068;Mundaka;1875;897;978;2016
48;Bizkaia;069;Mungia;17298;8422;8876;2016
48;Bizkaia;007;Munitibar-Arbatzegi Gerrikaitz;461;248;213;2016
48;Bizkaia;908;Murueta;309;160;149;2016
48;Bizkaia;071;Muskiz;7582;3760;3822;2016
48;Bizkaia;067;Muxika;1436;730;706;2016
48;Bizkaia;909;Nabarniz;259;132;127;2016
48;Bizkaia;073;Ondarroa;8495;4298;4197;2016
48;Bizkaia;075;Orozko;2606;1284;1322;2016
48;Bizkaia;083;Ortuella;8370;4101;4269;2016
48;Bizkaia;072;Otxandio;1295;653;642;2016
48;Bizkaia;077;Plentzia;4304;2097;2207;2016
48;Bizkaia;078;Portugalete;46375;22207;24168;2016
48;Bizkaia;082;Santurtzi;46043;22254;23789;2016
48;Bizkaia;084;Sestao;27841;13539;14302;2016
48;Bizkaia;904;Sondika;4519;2180;2339;2016
48;Bizkaia;085;Sopela;13407;6594;6813;2016
48;Bizkaia;086;Sopuerta;2595;1300;1295;2016
48;Bizkaia;076;Sukarrieta;368;189;179;2016
48;Bizkaia;087;Trucios-Turtzioz;510;269;241;2016
48;Bizkaia;088;Ubide;178;92;86;2016
48;Bizkaia;065;Ugao-Miraballes;4113;2066;2047;2016
48;Bizkaia;089;Urduliz;4146;2072;2074;2016
48;Bizkaia;074;Urduña/Orduña;4163;2119;2044;2016
48;Bizkaia;080;Valle de Trápaga-Trapagaran;12030;5854;6176;2016
48;Bizkaia;095;Zaldibar;3087;1551;1536;2016
48;Bizkaia;096;Zalla;8440;4147;4293;2016
48;Bizkaia;905;Zamudio;3267;1598;1669;2016
48;Bizkaia;097;Zaratamo;1601;789;812;2016
48;Bizkaia;024;Zeanuri;1252;642;610;2016
48;Bizkaia;025;Zeberio;1087;548;539;2016
48;Bizkaia;913;Zierbena;1489;783;706;2016
48;Bizkaia;915;Ziortza-Bolibar;432;231;201;2016
09;Burgos;001;Abajas;29;19;10;2016
09;Burgos;003;Adrada de Haza;222;114;108;2016
09;Burgos;006;Aguas Cándidas;58;35;23;2016
09;Burgos;007;Aguilar de Bureba;64;35;29;2016
09;Burgos;009;Albillos;213;115;98;2016
09;Burgos;010;Alcocero de Mola;29;21;8;2016
09;Burgos;011;Alfoz de Bricia;72;44;28;2016
09;Burgos;907;Alfoz de Quintanadueñas;1976;1069;907;2016
09;Burgos;012;Alfoz de Santa Gadea;97;56;41;2016
09;Burgos;013;Altable;51;28;23;2016
09;Burgos;014;Altos, Los;202;120;82;2016
09;Burgos;016;Ameyugo;105;61;44;2016
09;Burgos;017;Anguix;137;75;62;2016
09;Burgos;018;Aranda de Duero;32621;15904;16717;2016
09;Burgos;019;Arandilla;167;98;69;2016
09;Burgos;020;Arauzo de Miel;333;175;158;2016
09;Burgos;021;Arauzo de Salce;61;36;25;2016
09;Burgos;022;Arauzo de Torre;76;44;32;2016
09;Burgos;023;Arcos;1594;863;731;2016
09;Burgos;024;Arenillas de Riopisuerga;184;105;79;2016
09;Burgos;025;Arija;138;74;64;2016
09;Burgos;026;Arlanzón;423;255;168;2016
09;Burgos;027;Arraya de Oca;43;26;17;2016
09;Burgos;029;Atapuerca;187;103;84;2016
09;Burgos;030;Ausines, Los;125;77;48;2016
09;Burgos;032;Avellanosa de Muñó;115;60;55;2016
09;Burgos;033;Bahabón de Esgueva;84;53;31;2016
09;Burgos;034;Balbases, Los;308;170;138;2016
09;Burgos;035;Baños de Valdearados;361;213;148;2016
09;Burgos;036;Bañuelos de Bureba;38;23;15;2016
09;Burgos;037;Barbadillo de Herreros;112;69;43;2016
09;Burgos;038;Barbadillo del Mercado;130;72;58;2016
09;Burgos;039;Barbadillo del Pez;69;43;26;2016
09;Burgos;041;Barrio de Muñó;33;18;15;2016
09;Burgos;043;Barrios de Bureba, Los;207;122;85;2016
09;Burgos;044;Barrios de Colina;50;25;25;2016
09;Burgos;045;Basconcillos del Tozo;296;167;129;2016
09;Burgos;046;Bascuñana;30;18;12;2016
09;Burgos;047;Belbimbre;68;35;33;2016
09;Burgos;048;Belorado;1911;980;931;2016
09;Burgos;050;Berberana;66;34;32;2016
09;Burgos;051;Berlangas de Roa;192;99;93;2016
09;Burgos;052;Berzosa de Bureba;30;21;9;2016
09;Burgos;054;Bozoó;105;60;45;2016
09;Burgos;055;Brazacorta;66;35;31;2016
09;Burgos;056;Briviesca;6942;3490;3452;2016
09;Burgos;057;Bugedo;179;116;63;2016
09;Burgos;058;Buniel;554;306;248;2016
09;Burgos;059;Burgos;176608;84097;92511;2016
09;Burgos;060;Busto de Bureba;157;87;70;2016
09;Burgos;061;Cabañes de Esgueva;181;94;87;2016
09;Burgos;062;Cabezón de la Sierra;62;27;35;2016
09;Burgos;064;Caleruega;475;239;236;2016
09;Burgos;065;Campillo de Aranda;173;101;72;2016
09;Burgos;066;Campolara;70;49;21;2016
09;Burgos;067;Canicosa de la Sierra;489;261;228;2016
09;Burgos;068;Cantabrana;31;18;13;2016
09;Burgos;070;Carazo;35;25;10;2016
09;Burgos;071;Carcedo de Bureba;45;26;19;2016
09;Burgos;072;Carcedo de Burgos;398;220;178;2016
09;Burgos;073;Cardeñadijo;1307;720;587;2016
09;Burgos;074;Cardeñajimeno;1037;553;484;2016
09;Burgos;075;Cardeñuela Riopico;128;73;55;2016
09;Burgos;076;Carrias;25;21;4;2016
09;Burgos;077;Cascajares de Bureba;34;17;17;2016
09;Burgos;078;Cascajares de la Sierra;38;20;18;2016
09;Burgos;079;Castellanos de Castro;50;31;19;2016
09;Burgos;083;Castil de Peones;37;20;17;2016
09;Burgos;082;Castildelgado;40;23;17;2016
09;Burgos;084;Castrillo de la Reina;202;128;74;2016
09;Burgos;085;Castrillo de la Vega;637;343;294;2016
09;Burgos;088;Castrillo de Riopisuerga;61;37;24;2016
09;Burgos;086;Castrillo del Val;812;479;333;2016
09;Burgos;090;Castrillo Mota de Judíos;56;32;24;2016
09;Burgos;091;Castrojeriz;819;421;398;2016
09;Burgos;063;Cavia;233;140;93;2016
09;Burgos;093;Cayuela;174;93;81;2016
09;Burgos;094;Cebrecos;48;28;20;2016
09;Burgos;095;Celada del Camino;95;48;47;2016
09;Burgos;098;Cerezo de Río Tirón;588;314;274;2016
09;Burgos;100;Cerratón de Juarros;53;36;17;2016
09;Burgos;101;Ciadoncha;77;45;32;2016
09;Burgos;102;Cillaperlata;35;24;11;2016
09;Burgos;103;Cilleruelo de Abajo;235;129;106;2016
09;Burgos;104;Cilleruelo de Arriba;53;29;24;2016
09;Burgos;105;Ciruelos de Cervera;112;65;47;2016
09;Burgos;108;Cogollos;489;267;222;2016
09;Burgos;109;Condado de Treviño;1338;764;574;2016
09;Burgos;110;Contreras;82;50;32;2016
09;Burgos;112;Coruña del Conde;119;73;46;2016
09;Burgos;113;Covarrubias;578;307;271;2016
09;Burgos;114;Cubillo del Campo;104;55;49;2016
09;Burgos;115;Cubo de Bureba;102;59;43;2016
09;Burgos;117;Cueva de Roa, La;90;47;43;2016
09;Burgos;119;Cuevas de San Clemente;47;15;32;2016
09;Burgos;120;Encío;44;24;20;2016
09;Burgos;122;Espinosa de Cervera;100;61;39;2016
09;Burgos;124;Espinosa de los Monteros;1782;941;841;2016
09;Burgos;123;Espinosa del Camino;43;26;17;2016
09;Burgos;125;Estépar;643;382;261;2016
09;Burgos;127;Fontioso;62;35;27;2016
09;Burgos;128;Frandovínez;92;54;38;2016
09;Burgos;129;Fresneda de la Sierra Tirón;111;74;37;2016
09;Burgos;130;Fresneña;81;45;36;2016
09;Burgos;131;Fresnillo de las Dueñas;637;333;304;2016
09;Burgos;132;Fresno de Río Tirón;189;108;81;2016
09;Burgos;133;Fresno de Rodilla;48;27;21;2016
09;Burgos;134;Frías;258;139;119;2016
09;Burgos;135;Fuentebureba;52;25;27;2016
09;Burgos;136;Fuentecén;236;132;104;2016
09;Burgos;137;Fuentelcésped;222;112;110;2016
09;Burgos;138;Fuentelisendo;90;52;38;2016
09;Burgos;139;Fuentemolinos;105;66;39;2016
09;Burgos;140;Fuentenebro;133;81;52;2016
09;Burgos;141;Fuentespina;778;401;377;2016
09;Burgos;143;Galbarros;31;20;11;2016
09;Burgos;144;Gallega, La;53;32;21;2016
09;Burgos;148;Grijalba;106;54;52;2016
09;Burgos;149;Grisaleña;40;30;10;2016
09;Burgos;151;Gumiel de Izán;557;317;240;2016
09;Burgos;152;Gumiel de Mercado;358;194;164;2016
09;Burgos;154;Hacinas;162;92;70;2016
09;Burgos;155;Haza;27;16;11;2016
09;Burgos;159;Hontanas;66;41;25;2016
09;Burgos;160;Hontangas;101;63;38;2016
09;Burgos;162;Hontoria de la Cantera;158;86;72;2016
09;Burgos;164;Hontoria de Valdearados;195;118;77;2016
09;Burgos;163;Hontoria del Pinar;648;360;288;2016
09;Burgos;166;Hormazas, Las;103;60;43;2016
09;Burgos;167;Hornillos del Camino;56;32;24;2016
09;Burgos;168;Horra, La;357;188;169;2016
09;Burgos;169;Hortigüela;101;63;38;2016
09;Burgos;170;Hoyales de Roa;234;119;115;2016
09;Burgos;172;Huérmeces;135;67;68;2016
09;Burgos;173;Huerta de Arriba;128;73;55;2016
09;Burgos;174;Huerta de Rey;955;512;443;2016
09;Burgos;175;Humada;128;82;46;2016
09;Burgos;176;Hurones;74;45;29;2016
09;Burgos;177;Ibeas de Juarros;1372;766;606;2016
09;Burgos;178;Ibrillos;49;30;19;2016
09;Burgos;179;Iglesiarrubia;42;23;19;2016
09;Burgos;180;Iglesias;143;78;65;2016
09;Burgos;181;Isar;318;166;152;2016
09;Burgos;182;Itero del Castillo;80;44;36;2016
09;Burgos;183;Jaramillo de la Fuente;52;32;20;2016
09;Burgos;184;Jaramillo Quemado;5;3;2;2016
09;Burgos;189;Junta de Traslaloma;133;72;61;2016
09;Burgos;190;Junta de Villalba de Losa;87;47;40;2016
09;Burgos;191;Jurisdicción de Lara;41;22;19;2016
09;Burgos;192;Jurisdicción de San Zadornil;52;28;24;2016
09;Burgos;194;Lerma;2652;1331;1321;2016
09;Burgos;195;Llano de Bureba;61;38;23;2016
09;Burgos;196;Madrigal del Monte;160;96;64;2016
09;Burgos;197;Madrigalejo del Monte;172;108;64;2016
09;Burgos;198;Mahamud;116;67;49;2016
09;Burgos;199;Mambrilla de Castrejón;101;57;44;2016
09;Burgos;200;Mambrillas de Lara;50;29;21;2016
09;Burgos;201;Mamolar;29;21;8;2016
09;Burgos;202;Manciles;19;12;7;2016
09;Burgos;206;Mazuela;64;36;28;2016
09;Burgos;208;Mecerreyes;234;124;110;2016
09;Burgos;209;Medina de Pomar;5865;2971;2894;2016
09;Burgos;211;Melgar de Fernamental;1695;919;776;2016
09;Burgos;213;Merindad de Cuesta-Urria;352;193;159;2016
09;Burgos;214;Merindad de Montija;780;466;314;2016
09;Burgos;906;Merindad de Río Ubierna;1461;801;660;2016
09;Burgos;215;Merindad de Sotoscueva;419;235;184;2016
09;Burgos;216;Merindad de Valdeporres;437;219;218;2016
09;Burgos;217;Merindad de Valdivielso;393;227;166;2016
09;Burgos;218;Milagros;466;249;217;2016
09;Burgos;219;Miranda de Ebro;35922;17674;18248;2016
09;Burgos;220;Miraveche;80;53;27;2016
09;Burgos;221;Modúbar de la Emparedada;621;345;276;2016
09;Burgos;223;Monasterio de la Sierra;46;30;16;2016
09;Burgos;224;Monasterio de Rodilla;177;94;83;2016
09;Burgos;225;Moncalvillo;86;51;35;2016
09;Burgos;226;Monterrubio de la Demanda;64;38;26;2016
09;Burgos;227;Montorio;156;81;75;2016
09;Burgos;228;Moradillo de Roa;188;97;91;2016
09;Burgos;229;Nava de Roa;218;114;104;2016
09;Burgos;230;Navas de Bureba;35;15;20;2016
09;Burgos;231;Nebreda;68;48;20;2016
09;Burgos;232;Neila;171;102;69;2016
09;Burgos;235;Olmedillo de Roa;193;113;80;2016
09;Burgos;236;Olmillos de Muñó;39;22;17;2016
09;Burgos;238;Oña;1075;573;502;2016
09;Burgos;239;Oquillas;59;35;24;2016
09;Burgos;241;Orbaneja Riopico;261;135;126;2016
09;Burgos;242;Padilla de Abajo;86;49;37;2016
09;Burgos;243;Padilla de Arriba;78;49;29;2016
09;Burgos;244;Padrones de Bureba;52;25;27;2016
09;Burgos;246;Palacios de la Sierra;734;372;362;2016
09;Burgos;247;Palacios de Riopisuerga;26;13;13;2016
09;Burgos;248;Palazuelos de la Sierra;81;47;34;2016
09;Burgos;249;Palazuelos de Muñó;52;29;23;2016
09;Burgos;250;Pampliega;312;168;144;2016
09;Burgos;251;Pancorbo;451;249;202;2016
09;Burgos;253;Pardilla;127;73;54;2016
09;Burgos;255;Partido de la Sierra en Tobalina;90;52;38;2016
09;Burgos;256;Pedrosa de Duero;444;253;191;2016
09;Burgos;259;Pedrosa de Río Úrbel;245;147;98;2016
09;Burgos;257;Pedrosa del Páramo;105;61;44;2016
09;Burgos;258;Pedrosa del Príncipe;170;89;81;2016
09;Burgos;261;Peñaranda de Duero;540;270;270;2016
09;Burgos;262;Peral de Arlanza;166;88;78;2016
09;Burgos;265;Piérnigas;40;25;15;2016
09;Burgos;266;Pineda de la Sierra;102;63;39;2016
09;Burgos;267;Pineda Trasmonte;114;70;44;2016
09;Burgos;268;Pinilla de los Barruecos;107;62;45;2016
09;Burgos;269;Pinilla de los Moros;39;25;14;2016
09;Burgos;270;Pinilla Trasmonte;171;100;71;2016
09;Burgos;272;Poza de la Sal;317;169;148;2016
09;Burgos;273;Prádanos de Bureba;58;36;22;2016
09;Burgos;274;Pradoluengo;1233;616;617;2016
09;Burgos;275;Presencio;178;104;74;2016
09;Burgos;276;Puebla de Arganzón, La;489;270;219;2016
09;Burgos;277;Puentedura;130;87;43;2016
09;Burgos;279;Quemada;235;137;98;2016
09;Burgos;281;Quintana del Pidio;157;79;78;2016
09;Burgos;280;Quintanabureba;30;19;11;2016
09;Burgos;283;Quintanaélez;48;25;23;2016
09;Burgos;287;Quintanaortuño;279;157;122;2016
09;Burgos;288;Quintanapalla;105;62;43;2016
09;Burgos;289;Quintanar de la Sierra;1819;955;864;2016
09;Burgos;292;Quintanavides;86;51;35;2016
09;Burgos;294;Quintanilla de la Mata;126;77;49;2016
09;Burgos;901;Quintanilla del Agua y Tordueles;411;212;199;2016
09;Burgos;295;Quintanilla del Coco;60;30;30;2016
09;Burgos;298;Quintanilla San García;90;49;41;2016
09;Burgos;301;Quintanilla Vivar;784;419;365;2016
09;Burgos;297;Quintanillas, Las;391;223;168;2016
09;Burgos;302;Rabanera del Pinar;115;70;45;2016
09;Burgos;303;Rábanos;94;56;38;2016
09;Burgos;304;Rabé de las Calzadas;223;118;105;2016
09;Burgos;306;Rebolledo de la Torre;116;61;55;2016
09;Burgos;307;Redecilla del Camino;121;74;47;2016
09;Burgos;308;Redecilla del Campo;72;43;29;2016
09;Burgos;309;Regumiel de la Sierra;359;188;171;2016
09;Burgos;310;Reinoso;12;9;3;2016
09;Burgos;311;Retuerta;62;40;22;2016
09;Burgos;314;Revilla del Campo;92;61;31;2016
09;Burgos;316;Revilla Vallejera;110;72;38;2016
09;Burgos;312;Revilla y Ahedo, La;112;60;52;2016
09;Burgos;315;Revillarruz;509;261;248;2016
09;Burgos;317;Rezmondo;20;8;12;2016
09;Burgos;318;Riocavado de la Sierra;62;38;24;2016
09;Burgos;321;Roa;2273;1162;1111;2016
09;Burgos;323;Rojas;70;46;24;2016
09;Burgos;325;Royuela de Río Franco;205;122;83;2016
09;Burgos;326;Rubena;164;98;66;2016
09;Burgos;327;Rublacedo de Abajo;29;16;13;2016
09;Burgos;328;Rucandio;73;35;38;2016
09;Burgos;329;Salas de Bureba;138;83;55;2016
09;Burgos;330;Salas de los Infantes;2017;1029;988;2016
09;Burgos;332;Saldaña de Burgos;188;98;90;2016
09;Burgos;334;Salinillas de Bureba;50;41;9;2016
09;Burgos;335;San Adrián de Juarros;90;54;36;2016
09;Burgos;337;San Juan del Monte;136;79;57;2016
09;Burgos;338;San Mamés de Burgos;287;164;123;2016
09;Burgos;339;San Martín de Rubiales;138;77;61;2016
09;Burgos;340;San Millán de Lara;79;55;24;2016
09;Burgos;360;San Vicente del Valle;29;19;10;2016
09;Burgos;343;Santa Cecilia;102;62;40;2016
09;Burgos;345;Santa Cruz de la Salceda;139;80;59;2016
09;Burgos;346;Santa Cruz del Valle Urbión;98;59;39;2016
09;Burgos;347;Santa Gadea del Cid;150;80;70;2016
09;Burgos;348;Santa Inés;154;80;74;2016
09;Burgos;350;Santa María del Campo;584;314;270;2016
09;Burgos;351;Santa María del Invierno;65;45;20;2016
09;Burgos;352;Santa María del Mercadillo;109;66;43;2016
09;Burgos;353;Santa María Rivarredonda;93;58;35;2016
09;Burgos;354;Santa Olalla de Bureba;36;25;11;2016
09;Burgos;355;Santibáñez de Esgueva;93;48;45;2016
09;Burgos;356;Santibáñez del Val;47;28;19;2016
09;Burgos;358;Santo Domingo de Silos;297;182;115;2016
09;Burgos;361;Sargentes de la Lora;118;64;54;2016
09;Burgos;362;Sarracín;234;133;101;2016
09;Burgos;363;Sasamón;1053;594;459;2016
09;Burgos;365;Sequera de Haza, La;35;23;12;2016
09;Burgos;366;Solarana;88;45;43;2016
09;Burgos;368;Sordillos;23;14;9;2016
09;Burgos;369;Sotillo de la Ribera;513;272;241;2016
09;Burgos;372;Sotragero;286;154;132;2016
09;Burgos;373;Sotresgudo;460;262;198;2016
09;Burgos;374;Susinos del Páramo;103;66;37;2016
09;Burgos;375;Tamarón;41;22;19;2016
09;Burgos;377;Tardajos;794;417;377;2016
09;Burgos;378;Tejada;29;21;8;2016
09;Burgos;380;Terradillos de Esgueva;82;37;45;2016
09;Burgos;381;Tinieblas de la Sierra;38;21;17;2016
09;Burgos;382;Tobar;27;16;11;2016
09;Burgos;384;Tordómar;349;193;156;2016
09;Burgos;386;Torrecilla del Monte;64;35;29;2016
09;Burgos;387;Torregalindo;137;85;52;2016
09;Burgos;388;Torrelara;36;19;17;2016
09;Burgos;389;Torrepadre;73;42;31;2016
09;Burgos;390;Torresandino;678;367;311;2016
09;Burgos;391;Tórtoles de Esgueva;472;248;224;2016
09;Burgos;392;Tosantos;56;31;25;2016
09;Burgos;394;Trespaderne;862;450;412;2016
09;Burgos;395;Tubilla del Agua;149;91;58;2016
09;Burgos;396;Tubilla del Lago;157;82;75;2016
09;Burgos;398;Úrbel del Castillo;77;52;25;2016
09;Burgos;400;Vadocondes;371;202;169;2016
09;Burgos;403;Valdeande;96;62;34;2016
09;Burgos;405;Valdezate;142;76;66;2016
09;Burgos;406;Valdorros;327;189;138;2016
09;Burgos;408;Vallarta de Bureba;42;26;16;2016
09;Burgos;904;Valle de las Navas;523;302;221;2016
09;Burgos;908;Valle de Losa;519;305;214;2016
09;Burgos;409;Valle de Manzanedo;124;64;60;2016
09;Burgos;410;Valle de Mena;3806;1960;1846;2016
09;Burgos;411;Valle de Oca;156;97;59;2016
09;Burgos;902;Valle de Santibáñez;494;281;213;2016
09;Burgos;905;Valle de Sedano;453;254;199;2016
09;Burgos;412;Valle de Tobalina;997;543;454;2016
09;Burgos;413;Valle de Valdebezana;511;269;242;2016
09;Burgos;414;Valle de Valdelaguna;199;112;87;2016
09;Burgos;415;Valle de Valdelucio;306;161;145;2016
09;Burgos;416;Valle de Zamanzas;60;32;28;2016
09;Burgos;417;Vallejera;41;24;17;2016
09;Burgos;418;Valles de Palenzuela;87;44;43;2016
09;Burgos;419;Valluércanes;79;53;26;2016
09;Burgos;407;Valmala;29;16;13;2016
09;Burgos;422;Vid de Bureba, La;17;9;8;2016
09;Burgos;421;Vid y Barrios, La;250;147;103;2016
09;Burgos;423;Vileña;27;17;10;2016
09;Burgos;427;Villadiego;1577;868;709;2016
09;Burgos;428;Villaescusa de Roa;110;63;47;2016
09;Burgos;429;Villaescusa la Sombría;72;51;21;2016
09;Burgos;430;Villaespasa;26;15;11;2016
09;Burgos;431;Villafranca Montes de Oca;125;77;48;2016
09;Burgos;432;Villafruela;197;111;86;2016
09;Burgos;433;Villagalijo;65;42;23;2016
09;Burgos;434;Villagonzalo Pedernales;1764;923;841;2016
09;Burgos;437;Villahoz;304;163;141;2016
09;Burgos;438;Villalba de Duero;674;355;319;2016
09;Burgos;439;Villalbilla de Burgos;1332;711;621;2016
09;Burgos;440;Villalbilla de Gumiel;88;53;35;2016
09;Burgos;441;Villaldemiro;73;42;31;2016
09;Burgos;442;Villalmanzo;442;239;203;2016
09;Burgos;443;Villamayor de los Montes;196;100;96;2016
09;Burgos;444;Villamayor de Treviño;72;35;37;2016
09;Burgos;445;Villambistia;44;31;13;2016
09;Burgos;446;Villamedianilla;11;6;5;2016
09;Burgos;447;Villamiel de la Sierra;46;28;18;2016
09;Burgos;448;Villangómez;235;145;90;2016
09;Burgos;449;Villanueva de Argaño;104;61;43;2016
09;Burgos;450;Villanueva de Carazo;31;21;10;2016
09;Burgos;451;Villanueva de Gumiel;287;147;140;2016
09;Burgos;454;Villanueva de Teba;48;29;19;2016
09;Burgos;455;Villaquirán de la Puebla;52;31;21;2016
09;Burgos;456;Villaquirán de los Infantes;144;76;68;2016
09;Burgos;903;Villarcayo de Merindad de Castilla la Vieja;4279;2204;2075;2016
09;Burgos;458;Villariezo;617;345;272;2016
09;Burgos;460;Villasandino;189;113;76;2016
09;Burgos;463;Villasur de Herreros;288;170;118;2016
09;Burgos;464;Villatuelda;40;22;18;2016
09;Burgos;466;Villaverde del Monte;132;74;58;2016
09;Burgos;467;Villaverde-Mogina;80;51;29;2016
09;Burgos;471;Villayerno Morquillas;200;104;96;2016
09;Burgos;472;Villazopeque;59;36;23;2016
09;Burgos;473;Villegas;90;50;40;2016
09;Burgos;476;Villoruebo;81;50;31;2016
09;Burgos;424;Viloria de Rioja;37;22;15;2016
09;Burgos;425;Vilviestre del Pinar;596;327;269;2016
09;Burgos;478;Vizcaínos;44;28;16;2016
09;Burgos;480;Zael;114;58;56;2016
09;Burgos;482;Zarzosa de Río Pisuerga;30;19;11;2016
09;Burgos;483;Zazuar;234;123;111;2016
09;Burgos;485;Zuñeda;56;35;21;2016
10;Cáceres;001;Abadía;334;189;145;2016
10;Cáceres;002;Abertura;423;218;205;2016
10;Cáceres;003;Acebo;590;301;289;2016
10;Cáceres;004;Acehúche;820;405;415;2016
10;Cáceres;005;Aceituna;627;329;298;2016
10;Cáceres;006;Ahigal;1409;733;676;2016
10;Cáceres;903;Alagón del Río;940;475;465;2016
10;Cáceres;007;Albalá;712;356;356;2016
10;Cáceres;008;Alcántara;1518;759;759;2016
10;Cáceres;009;Alcollarín;249;120;129;2016
10;Cáceres;010;Alcuéscar;2727;1412;1315;2016
10;Cáceres;012;Aldea del Cano;651;304;347;2016
10;Cáceres;013;Aldea del Obispo, La;309;163;146;2016
10;Cáceres;011;Aldeacentenera;634;318;316;2016
10;Cáceres;014;Aldeanueva de la Vera;2150;1052;1098;2016
10;Cáceres;015;Aldeanueva del Camino;791;375;416;2016
10;Cáceres;016;Aldehuela de Jerte;374;201;173;2016
10;Cáceres;017;Alía;891;446;445;2016
10;Cáceres;018;Aliseda;1935;975;960;2016
10;Cáceres;019;Almaraz;1685;860;825;2016
10;Cáceres;020;Almoharín;1899;933;966;2016
10;Cáceres;021;Arroyo de la Luz;5966;2971;2995;2016
10;Cáceres;023;Arroyomolinos;808;426;382;2016
10;Cáceres;022;Arroyomolinos de la Vera;464;233;231;2016
10;Cáceres;024;Baños de Montemayor;779;370;409;2016
10;Cáceres;025;Barrado;428;222;206;2016
10;Cáceres;026;Belvís de Monroy;642;336;306;2016
10;Cáceres;027;Benquerencia;79;44;35;2016
10;Cáceres;028;Berrocalejo;113;60;53;2016
10;Cáceres;029;Berzocana;452;236;216;2016
10;Cáceres;030;Bohonal de Ibor;494;250;244;2016
10;Cáceres;031;Botija;185;101;84;2016
10;Cáceres;032;Brozas;1927;967;960;2016
10;Cáceres;033;Cabañas del Castillo;454;247;207;2016
10;Cáceres;034;Cabezabellosa;364;184;180;2016
10;Cáceres;035;Cabezuela del Valle;2335;1191;1144;2016
10;Cáceres;036;Cabrero;359;198;161;2016
10;Cáceres;037;Cáceres;95814;45979;49835;2016
10;Cáceres;038;Cachorrilla;90;49;41;2016
10;Cáceres;039;Cadalso;458;228;230;2016
10;Cáceres;040;Calzadilla;493;252;241;2016
10;Cáceres;041;Caminomorisco;1228;648;580;2016
10;Cáceres;042;Campillo de Deleitosa;51;21;30;2016
10;Cáceres;043;Campo Lugar;906;454;452;2016
10;Cáceres;044;Cañamero;1676;882;794;2016
10;Cáceres;045;Cañaveral;1043;510;533;2016
10;Cáceres;046;Carbajo;217;111;106;2016
10;Cáceres;047;Carcaboso;1123;565;558;2016
10;Cáceres;048;Carrascalejo;254;130;124;2016
10;Cáceres;049;Casar de Cáceres;4604;2279;2325;2016
10;Cáceres;050;Casar de Palomero;1192;602;590;2016
10;Cáceres;051;Casares de las Hurdes;413;211;202;2016
10;Cáceres;052;Casas de Don Antonio;198;98;100;2016
10;Cáceres;053;Casas de Don Gómez;294;156;138;2016
10;Cáceres;056;Casas de Millán;634;317;317;2016
10;Cáceres;057;Casas de Miravete;144;90;54;2016
10;Cáceres;054;Casas del Castañar;602;292;310;2016
10;Cáceres;055;Casas del Monte;827;419;408;2016
10;Cáceres;058;Casatejada;1413;729;684;2016
10;Cáceres;059;Casillas de Coria;400;197;203;2016
10;Cáceres;060;Castañar de Ibor;1094;562;532;2016
10;Cáceres;061;Ceclavín;1897;970;927;2016
10;Cáceres;062;Cedillo;465;244;221;2016
10;Cáceres;063;Cerezo;177;86;91;2016
10;Cáceres;064;Cilleros;1716;872;844;2016
10;Cáceres;065;Collado de la Vera;200;112;88;2016
10;Cáceres;066;Conquista de la Sierra;187;109;78;2016
10;Cáceres;067;Coria;12886;6334;6552;2016
10;Cáceres;068;Cuacos de Yuste;849;438;411;2016
10;Cáceres;069;Cumbre, La;902;451;451;2016
10;Cáceres;070;Deleitosa;762;379;383;2016
10;Cáceres;071;Descargamaría;138;80;58;2016
10;Cáceres;072;Eljas;940;480;460;2016
10;Cáceres;073;Escurial;820;430;390;2016
10;Cáceres;075;Fresnedoso de Ibor;284;149;135;2016
10;Cáceres;076;Galisteo;1009;504;505;2016
10;Cáceres;077;Garciaz;773;398;375;2016
10;Cáceres;079;Garganta la Olla;1010;535;475;2016
10;Cáceres;078;Garganta, La;428;227;201;2016
10;Cáceres;080;Gargantilla;403;208;195;2016
10;Cáceres;081;Gargüera;136;77;59;2016
10;Cáceres;082;Garrovillas de Alconétar;2145;1057;1088;2016
10;Cáceres;083;Garvín;91;51;40;2016
10;Cáceres;084;Gata;1556;807;749;2016
10;Cáceres;085;Gordo, El;388;195;193;2016
10;Cáceres;086;Granja, La;352;187;165;2016
10;Cáceres;087;Guadalupe;1999;990;1009;2016
10;Cáceres;088;Guijo de Coria;214;113;101;2016
10;Cáceres;089;Guijo de Galisteo;1559;789;770;2016
10;Cáceres;090;Guijo de Granadilla;557;295;262;2016
10;Cáceres;091;Guijo de Santa Bárbara;416;217;199;2016
10;Cáceres;092;Herguijuela;322;166;156;2016
10;Cáceres;093;Hernán-Pérez;469;235;234;2016
10;Cáceres;094;Herrera de Alcántara;273;143;130;2016
10;Cáceres;095;Herreruela;369;187;182;2016
10;Cáceres;096;Hervás;4120;2035;2085;2016
10;Cáceres;097;Higuera;106;64;42;2016
10;Cáceres;098;Hinojal;408;207;201;2016
10;Cáceres;099;Holguera;673;331;342;2016
10;Cáceres;100;Hoyos;923;451;472;2016
10;Cáceres;101;Huélaga;223;115;108;2016
10;Cáceres;102;Ibahernando;584;288;296;2016
10;Cáceres;103;Jaraicejo;502;244;258;2016
10;Cáceres;104;Jaraíz de la Vera;6492;3238;3254;2016
10;Cáceres;105;Jarandilla de la Vera;2944;1469;1475;2016
10;Cáceres;106;Jarilla;139;73;66;2016
10;Cáceres;107;Jerte;1269;646;623;2016
10;Cáceres;108;Ladrillar;217;115;102;2016
10;Cáceres;109;Logrosán;2045;1030;1015;2016
10;Cáceres;110;Losar de la Vera;2813;1443;1370;2016
10;Cáceres;111;Madrigal de la Vera;1614;849;765;2016
10;Cáceres;112;Madrigalejo;1842;916;926;2016
10;Cáceres;113;Madroñera;2680;1334;1346;2016
10;Cáceres;114;Majadas;1341;672;669;2016
10;Cáceres;115;Malpartida de Cáceres;4268;2143;2125;2016
10;Cáceres;116;Malpartida de Plasencia;4673;2335;2338;2016
10;Cáceres;117;Marchagaz;213;109;104;2016
10;Cáceres;118;Mata de Alcántara;314;162;152;2016
10;Cáceres;119;Membrío;678;334;344;2016
10;Cáceres;120;Mesas de Ibor;186;98;88;2016
10;Cáceres;121;Miajadas;9879;4916;4963;2016
10;Cáceres;122;Millanes;238;125;113;2016
10;Cáceres;123;Mirabel;681;340;341;2016
10;Cáceres;124;Mohedas de Granadilla;844;418;426;2016
10;Cáceres;125;Monroy;1004;501;503;2016
10;Cáceres;126;Montánchez;1809;904;905;2016
10;Cáceres;127;Montehermoso;5817;2965;2852;2016
10;Cáceres;128;Moraleja;6912;3450;3462;2016
10;Cáceres;129;Morcillo;407;192;215;2016
10;Cáceres;130;Navaconcejo;2003;1019;984;2016
10;Cáceres;131;Navalmoral de la Mata;17247;8317;8930;2016
10;Cáceres;132;Navalvillar de Ibor;443;223;220;2016
10;Cáceres;133;Navas del Madroño;1363;677;686;2016
10;Cáceres;134;Navezuelas;671;347;324;2016
10;Cáceres;135;Nuñomoral;1362;722;640;2016
10;Cáceres;136;Oliva de Plasencia;316;173;143;2016
10;Cáceres;137;Palomero;377;202;175;2016
10;Cáceres;138;Pasarón de la Vera;657;318;339;2016
10;Cáceres;139;Pedroso de Acim;101;54;47;2016
10;Cáceres;140;Peraleda de la Mata;1399;701;698;2016
10;Cáceres;141;Peraleda de San Román;291;148;143;2016
10;Cáceres;142;Perales del Puerto;964;494;470;2016
10;Cáceres;143;Pescueza;160;73;87;2016
10;Cáceres;144;Pesga, La;1108;573;535;2016
10;Cáceres;145;Piedras Albas;161;76;85;2016
10;Cáceres;146;Pinofranqueado;1838;980;858;2016
10;Cáceres;147;Piornal;1547;786;761;2016
10;Cáceres;148;Plasencia;40663;19700;20963;2016
10;Cáceres;149;Plasenzuela;481;238;243;2016
10;Cáceres;150;Portaje;386;196;190;2016
10;Cáceres;151;Portezuelo;232;123;109;2016
10;Cáceres;152;Pozuelo de Zarzón;492;244;248;2016
10;Cáceres;905;Pueblonuevo de Miramontes;830;424;406;2016
10;Cáceres;153;Puerto de Santa Cruz;346;176;170;2016
10;Cáceres;154;Rebollar;214;106;108;2016
10;Cáceres;155;Riolobos;1301;678;623;2016
10;Cáceres;156;Robledillo de Gata;95;50;45;2016
10;Cáceres;157;Robledillo de la Vera;288;151;137;2016
10;Cáceres;158;Robledillo de Trujillo;370;191;179;2016
10;Cáceres;159;Robledollano;324;177;147;2016
10;Cáceres;160;Romangordo;257;124;133;2016
10;Cáceres;901;Rosalejo;1476;786;690;2016
10;Cáceres;161;Ruanes;70;39;31;2016
10;Cáceres;162;Salorino;629;330;299;2016
10;Cáceres;163;Salvatierra de Santiago;236;122;114;2016
10;Cáceres;164;San Martín de Trevejo;827;408;419;2016
10;Cáceres;165;Santa Ana;265;145;120;2016
10;Cáceres;166;Santa Cruz de la Sierra;326;162;164;2016
10;Cáceres;167;Santa Cruz de Paniagua;330;182;148;2016
10;Cáceres;168;Santa Marta de Magasca;300;150;150;2016
10;Cáceres;169;Santiago de Alcántara;563;274;289;2016
10;Cáceres;170;Santiago del Campo;280;144;136;2016
10;Cáceres;171;Santibáñez el Alto;341;178;163;2016
10;Cáceres;172;Santibáñez el Bajo;767;400;367;2016
10;Cáceres;173;Saucedilla;890;469;421;2016
10;Cáceres;174;Segura de Toro;191;89;102;2016
10;Cáceres;175;Serradilla;1634;827;807;2016
10;Cáceres;176;Serrejón;430;217;213;2016
10;Cáceres;177;Sierra de Fuentes;2026;1025;1001;2016
10;Cáceres;178;Talaván;866;442;424;2016
10;Cáceres;179;Talaveruela de la Vera;334;180;154;2016
10;Cáceres;180;Talayuela;7377;4013;3364;2016
10;Cáceres;181;Tejeda de Tiétar;829;446;383;2016
10;Cáceres;904;Tiétar;931;495;436;2016
10;Cáceres;182;Toril;169;106;63;2016
10;Cáceres;183;Tornavacas;1133;587;546;2016
10;Cáceres;184;Torno, El;908;477;431;2016
10;Cáceres;187;Torre de Don Miguel;509;272;237;2016
10;Cáceres;188;Torre de Santa María;566;284;282;2016
10;Cáceres;185;Torrecilla de los Ángeles;640;329;311;2016
10;Cáceres;186;Torrecillas de la Tiesa;1122;561;561;2016
10;Cáceres;190;Torrejón el Rubio;618;316;302;2016
10;Cáceres;189;Torrejoncillo;3116;1525;1591;2016
10;Cáceres;191;Torremenga;624;337;287;2016
10;Cáceres;192;Torremocha;875;429;446;2016
10;Cáceres;193;Torreorgaz;1678;807;871;2016
10;Cáceres;194;Torrequemada;601;287;314;2016
10;Cáceres;195;Trujillo;9436;4573;4863;2016
10;Cáceres;196;Valdastillas;325;166;159;2016
10;Cáceres;197;Valdecañas de Tajo;133;72;61;2016
10;Cáceres;198;Valdefuentes;1277;630;647;2016
10;Cáceres;199;Valdehúncar;182;95;87;2016
10;Cáceres;200;Valdelacasa de Tajo;407;208;199;2016
10;Cáceres;201;Valdemorales;197;98;99;2016
10;Cáceres;202;Valdeobispo;680;335;345;2016
10;Cáceres;203;Valencia de Alcántara;5646;2780;2866;2016
10;Cáceres;204;Valverde de la Vera;503;254;249;2016
10;Cáceres;205;Valverde del Fresno;2391;1211;1180;2016
10;Cáceres;902;Vegaviana;858;439;419;2016
10;Cáceres;206;Viandar de la Vera;246;126;120;2016
10;Cáceres;207;Villa del Campo;527;254;273;2016
10;Cáceres;208;Villa del Rey;130;65;65;2016
10;Cáceres;209;Villamesías;285;141;144;2016
10;Cáceres;210;Villamiel;505;254;251;2016
10;Cáceres;211;Villanueva de la Sierra;449;220;229;2016
10;Cáceres;212;Villanueva de la Vera;2092;1059;1033;2016
10;Cáceres;214;Villar de Plasencia;232;124;108;2016
10;Cáceres;213;Villar del Pedroso;636;329;307;2016
10;Cáceres;215;Villasbuenas de Gata;370;192;178;2016
10;Cáceres;216;Zarza de Granadilla;1827;930;897;2016
10;Cáceres;217;Zarza de Montánchez;580;288;292;2016
10;Cáceres;218;Zarza la Mayor;1306;647;659;2016
10;Cáceres;219;Zorita;1446;726;720;2016
11;Cádiz;001;Alcalá de los Gazules;5316;2736;2580;2016
11;Cádiz;002;Alcalá del Valle;5174;2614;2560;2016
11;Cádiz;003;Algar;1429;731;698;2016
11;Cádiz;004;Algeciras;120601;59592;61009;2016
11;Cádiz;005;Algodonales;5650;2870;2780;2016
11;Cádiz;006;Arcos de la Frontera;31114;15583;15531;2016
11;Cádiz;007;Barbate;22720;11390;11330;2016
11;Cádiz;008;Barrios, Los;23316;11660;11656;2016
11;Cádiz;901;Benalup-Casas Viejas;7003;3560;3443;2016
11;Cádiz;009;Benaocaz;694;367;327;2016
11;Cádiz;010;Bornos;7864;3926;3938;2016
11;Cádiz;011;Bosque, El;2114;1064;1050;2016
11;Cádiz;012;Cádiz;118919;56362;62557;2016
11;Cádiz;013;Castellar de la Frontera;3050;1526;1524;2016
11;Cádiz;015;Chiclana de la Frontera;82645;41549;41096;2016
11;Cádiz;016;Chipiona;19095;9585;9510;2016
11;Cádiz;014;Conil de la Frontera;22297;11253;11044;2016
11;Cádiz;017;Espera;3912;1974;1938;2016
11;Cádiz;018;Gastor, El;1783;931;852;2016
11;Cádiz;019;Grazalema;2144;1068;1076;2016
11;Cádiz;020;Jerez de la Frontera;212830;104197;108633;2016
11;Cádiz;021;Jimena de la Frontera;9756;5021;4735;2016
11;Cádiz;022;Línea de la Concepción, La;63278;31104;32174;2016
11;Cádiz;023;Medina-Sidonia;11756;5997;5759;2016
11;Cádiz;024;Olvera;8233;4067;4166;2016
11;Cádiz;025;Paterna de Rivera;5570;2875;2695;2016
11;Cádiz;026;Prado del Rey;5767;2886;2881;2016
11;Cádiz;027;Puerto de Santa María, El;88184;43332;44852;2016
11;Cádiz;028;Puerto Real;41467;20891;20576;2016
11;Cádiz;029;Puerto Serrano;7111;3606;3505;2016
11;Cádiz;030;Rota;29030;14459;14571;2016
11;Cádiz;031;San Fernando;95949;46989;48960;2016
11;Cádiz;902;San José del Valle;4442;2266;2176;2016
11;Cádiz;033;San Roque;29575;14803;14772;2016
11;Cádiz;032;Sanlúcar de Barrameda;67620;33687;33933;2016
11;Cádiz;034;Setenil de las Bodegas;2809;1431;1378;2016
11;Cádiz;035;Tarifa;18116;9172;8944;2016
11;Cádiz;036;Torre Alháquime;795;399;396;2016
11;Cádiz;037;Trebujena;7056;3527;3529;2016
11;Cádiz;038;Ubrique;16766;8283;8483;2016
11;Cádiz;039;Vejer de la Frontera;12788;6407;6381;2016
11;Cádiz;040;Villaluenga del Rosario;457;243;214;2016
11;Cádiz;041;Villamartín;12267;6151;6116;2016
11;Cádiz;042;Zahara;1427;724;703;2016
39;Cantabria;001;Alfoz de Lloredo;2466;1260;1206;2016
39;Cantabria;002;Ampuero;4181;2150;2031;2016
39;Cantabria;003;Anievas;314;162;152;2016
39;Cantabria;004;Arenas de Iguña;1711;874;837;2016
39;Cantabria;005;Argoños;1720;895;825;2016
39;Cantabria;006;Arnuero;2091;1055;1036;2016
39;Cantabria;007;Arredondo;480;275;205;2016
39;Cantabria;008;Astillero, El;18134;8827;9307;2016
39;Cantabria;009;Bárcena de Cicero;4124;2136;1988;2016
39;Cantabria;010;Bárcena de Pie de Concha;710;354;356;2016
39;Cantabria;011;Bareyo;1999;1016;983;2016
39;Cantabria;012;Cabezón de la Sal;8345;4039;4306;2016
39;Cantabria;013;Cabezón de Liébana;601;354;247;2016
39;Cantabria;014;Cabuérniga;1012;556;456;2016
39;Cantabria;015;Camaleño;977;533;444;2016
39;Cantabria;016;Camargo;30611;15019;15592;2016
39;Cantabria;027;Campoo de Enmedio;3778;1934;1844;2016
39;Cantabria;017;Campoo de Yuso;696;368;328;2016
39;Cantabria;018;Cartes;5733;2882;2851;2016
39;Cantabria;019;Castañeda;2687;1378;1309;2016
39;Cantabria;020;Castro-Urdiales;31901;15876;16025;2016
39;Cantabria;021;Cieza;556;284;272;2016
39;Cantabria;022;Cillorigo de Liébana;1310;704;606;2016
39;Cantabria;023;Colindres;8331;4105;4226;2016
39;Cantabria;024;Comillas;2228;1052;1176;2016
39;Cantabria;025;Corrales de Buelna, Los;11003;5399;5604;2016
39;Cantabria;026;Corvera de Toranzo;2074;1055;1019;2016
39;Cantabria;028;Entrambasaguas;4943;2507;2436;2016
39;Cantabria;029;Escalante;747;384;363;2016
39;Cantabria;030;Guriezo;2359;1210;1149;2016
39;Cantabria;031;Hazas de Cesto;1522;768;754;2016
39;Cantabria;032;Hermandad de Campoo de Suso;1643;895;748;2016
39;Cantabria;033;Herrerías;641;358;283;2016
39;Cantabria;034;Lamasón;298;189;109;2016
39;Cantabria;035;Laredo;11446;5471;5975;2016
39;Cantabria;036;Liendo;1227;635;592;2016
39;Cantabria;037;Liérganes;2372;1169;1203;2016
39;Cantabria;038;Limpias;1813;898;915;2016
39;Cantabria;039;Luena;615;335;280;2016
39;Cantabria;040;Marina de Cudeyo;5174;2587;2587;2016
39;Cantabria;041;Mazcuerras;2119;1085;1034;2016
39;Cantabria;042;Medio Cudeyo;7482;3663;3819;2016
39;Cantabria;043;Meruelo;1965;1004;961;2016
39;Cantabria;044;Miengo;4741;2408;2333;2016
39;Cantabria;045;Miera;395;213;182;2016
39;Cantabria;046;Molledo;1589;788;801;2016
39;Cantabria;047;Noja;2562;1272;1290;2016
39;Cantabria;048;Penagos;2060;1056;1004;2016
39;Cantabria;049;Peñarrubia;349;193;156;2016
39;Cantabria;050;Pesaguero;311;181;130;2016
39;Cantabria;051;Pesquera;71;43;28;2016
39;Cantabria;052;Piélagos;24574;12193;12381;2016
39;Cantabria;053;Polaciones;237;151;86;2016
39;Cantabria;054;Polanco;5794;2923;2871;2016
39;Cantabria;055;Potes;1360;668;692;2016
39;Cantabria;056;Puente Viesgo;2877;1457;1420;2016
39;Cantabria;057;Ramales de la Victoria;2827;1426;1401;2016
39;Cantabria;058;Rasines;959;507;452;2016
39;Cantabria;059;Reinosa;9496;4474;5022;2016
39;Cantabria;060;Reocín;8318;4091;4227;2016
39;Cantabria;061;Ribamontán al Mar;4422;2230;2192;2016
39;Cantabria;062;Ribamontán al Monte;2231;1161;1070;2016
39;Cantabria;063;Rionansa;1058;596;462;2016
39;Cantabria;064;Riotuerto;1610;771;839;2016
39;Cantabria;065;Rozas de Valdearroyo, Las;275;156;119;2016
39;Cantabria;066;Ruente;1044;560;484;2016
39;Cantabria;067;Ruesga;870;471;399;2016
39;Cantabria;068;Ruiloba;765;399;366;2016
39;Cantabria;069;San Felices de Buelna;2381;1193;1188;2016
39;Cantabria;070;San Miguel de Aguayo;160;82;78;2016
39;Cantabria;071;San Pedro del Romeral;453;250;203;2016
39;Cantabria;072;San Roque de Riomiera;386;227;159;2016
39;Cantabria;080;San Vicente de la Barquera;4196;2097;2099;2016
39;Cantabria;073;Santa Cruz de Bezana;12679;6225;6454;2016
39;Cantabria;074;Santa María de Cayón;9078;4573;4505;2016
39;Cantabria;075;Santander;172656;79618;93038;2016
39;Cantabria;076;Santillana del Mar;4184;2039;2145;2016
39;Cantabria;077;Santiurde de Reinosa;265;153;112;2016
39;Cantabria;078;Santiurde de Toranzo;1602;821;781;2016
39;Cantabria;079;Santoña;11085;5414;5671;2016
39;Cantabria;081;Saro;512;268;244;2016
39;Cantabria;082;Selaya;1931;961;970;2016
39;Cantabria;083;Soba;1249;681;568;2016
39;Cantabria;084;Solórzano;1012;544;468;2016
39;Cantabria;085;Suances;8579;4247;4332;2016
39;Cantabria;086;Tojos, Los;399;236;163;2016
39;Cantabria;087;Torrelavega;52819;25018;27801;2016
39;Cantabria;088;Tresviso;71;48;23;2016
39;Cantabria;089;Tudanca;147;106;41;2016
39;Cantabria;090;Udías;903;459;444;2016
39;Cantabria;095;Val de San Vicente;2763;1432;1331;2016
39;Cantabria;091;Valdáliga;2272;1175;1097;2016
39;Cantabria;092;Valdeolea;987;524;463;2016
39;Cantabria;093;Valdeprado del Río;331;188;143;2016
39;Cantabria;094;Valderredible;1001;566;435;2016
39;Cantabria;101;Valle de Villaverde;327;166;161;2016
39;Cantabria;096;Vega de Liébana;788;412;376;2016
39;Cantabria;097;Vega de Pas;795;410;385;2016
39;Cantabria;098;Villacarriedo;1636;859;777;2016
39;Cantabria;099;Villaescusa;3883;1930;1953;2016
39;Cantabria;100;Villafufre;1017;530;487;2016
39;Cantabria;102;Voto;2725;1448;1277;2016
12;Castellón/Castelló;002;Aín;122;66;56;2016
12;Castellón/Castelló;003;Albocàsser;1303;638;665;2016
12;Castellón/Castelló;004;Alcalà de Xivert;6893;3512;3381;2016
12;Castellón/Castelló;005;Alcora, l';10535;5342;5193;2016
12;Castellón/Castelló;006;Alcudia de Veo;201;107;94;2016
12;Castellón/Castelló;007;Alfondeguilla;894;449;445;2016
12;Castellón/Castelló;008;Algimia de Almonacid;265;150;115;2016
12;Castellón/Castelló;009;Almazora/Almassora;25632;12875;12757;2016
12;Castellón/Castelló;010;Almedíjar;281;146;135;2016
12;Castellón/Castelló;011;Almenara;5949;2965;2984;2016
12;Castellón/Castelló;901;Alqueries, les/Alquerías del Niño Perdido;4528;2240;2288;2016
12;Castellón/Castelló;012;Altura;3621;1857;1764;2016
12;Castellón/Castelló;013;Arañuel;160;80;80;2016
12;Castellón/Castelló;014;Ares del Maestrat;202;114;88;2016
12;Castellón/Castelló;015;Argelita;97;54;43;2016
12;Castellón/Castelló;016;Artana;1979;1012;967;2016
12;Castellón/Castelló;001;Atzeneta del Maestrat;1286;659;627;2016
12;Castellón/Castelló;017;Ayódar;172;94;78;2016
12;Castellón/Castelló;018;Azuébar;322;169;153;2016
12;Castellón/Castelló;020;Barracas;179;96;83;2016
12;Castellón/Castelló;022;Bejís;404;231;173;2016
12;Castellón/Castelló;024;Benafer;164;87;77;2016
12;Castellón/Castelló;025;Benafigos;160;90;70;2016
12;Castellón/Castelló;026;Benassal;1130;576;554;2016
12;Castellón/Castelló;027;Benicarló;26486;13202;13284;2016
12;Castellón/Castelló;028;Benicasim/Benicàssim;17957;8976;8981;2016
12;Castellón/Castelló;029;Benlloch;1095;548;547;2016
12;Castellón/Castelló;021;Betxí;5780;2853;2927;2016
12;Castellón/Castelló;032;Borriana/Burriana;34643;17140;17503;2016
12;Castellón/Castelló;031;Borriol;5187;2623;2564;2016
12;Castellón/Castelló;033;Cabanes;2966;1502;1464;2016
12;Castellón/Castelló;034;Càlig;2020;1023;997;2016
12;Castellón/Castelló;036;Canet lo Roig;724;353;371;2016
12;Castellón/Castelló;037;Castell de Cabres;17;10;7;2016
12;Castellón/Castelló;038;Castellfort;205;105;100;2016
12;Castellón/Castelló;039;Castellnovo;981;498;483;2016
12;Castellón/Castelló;040;Castellón de la Plana/Castelló de la Plana;170990;82982;88008;2016
12;Castellón/Castelló;041;Castillo de Villamalefa;103;65;38;2016
12;Castellón/Castelló;042;Catí;779;390;389;2016
12;Castellón/Castelló;043;Caudiel;673;352;321;2016
12;Castellón/Castelló;044;Cervera del Maestre;642;307;335;2016
12;Castellón/Castelló;053;Chilches/Xilxes;2677;1407;1270;2016
12;Castellón/Castelló;055;Chodos/Xodos;117;66;51;2016
12;Castellón/Castelló;056;Chóvar;327;170;157;2016
12;Castellón/Castelló;045;Cinctorres;418;201;217;2016
12;Castellón/Castelló;046;Cirat;220;121;99;2016
12;Castellón/Castelló;048;Cortes de Arenoso;300;164;136;2016
12;Castellón/Castelló;049;Costur;543;285;258;2016
12;Castellón/Castelló;050;Coves de Vinromà, les;1870;924;946;2016
12;Castellón/Castelló;051;Culla;524;272;252;2016
12;Castellón/Castelló;057;Eslida;805;405;400;2016
12;Castellón/Castelló;058;Espadilla;83;46;37;2016
12;Castellón/Castelló;059;Fanzara;281;144;137;2016
12;Castellón/Castelló;060;Figueroles;542;277;265;2016
12;Castellón/Castelló;061;Forcall;461;223;238;2016
12;Castellón/Castelló;063;Fuente la Reina;46;28;18;2016
12;Castellón/Castelló;064;Fuentes de Ayódar;114;59;55;2016
12;Castellón/Castelló;065;Gaibiel;205;110;95;2016
12;Castellón/Castelló;067;Geldo;646;328;318;2016
12;Castellón/Castelló;068;Herbés;49;27;22;2016
12;Castellón/Castelló;069;Higueras;76;42;34;2016
12;Castellón/Castelló;070;Jana, la;700;350;350;2016
12;Castellón/Castelló;071;Jérica;1574;811;763;2016
12;Castellón/Castelló;074;Llosa, la;969;481;488;2016
12;Castellón/Castelló;072;Lucena del Cid;1372;686;686;2016
12;Castellón/Castelló;073;Ludiente;170;98;72;2016
12;Castellón/Castelló;075;Mata de Morella, la;173;88;85;2016
12;Castellón/Castelló;076;Matet;87;45;42;2016
12;Castellón/Castelló;077;Moncofa;6181;3208;2973;2016
12;Castellón/Castelló;078;Montán;383;185;198;2016
12;Castellón/Castelló;079;Montanejos;539;273;266;2016
12;Castellón/Castelló;080;Morella;2504;1245;1259;2016
12;Castellón/Castelló;081;Navajas;745;389;356;2016
12;Castellón/Castelló;082;Nules;13305;6618;6687;2016
12;Castellón/Castelló;083;Olocau del Rey;118;66;52;2016
12;Castellón/Castelló;084;Onda;24856;12505;12351;2016
12;Castellón/Castelló;085;Oropesa del Mar/Orpesa;9245;4813;4432;2016
12;Castellón/Castelló;087;Palanques;35;19;16;2016
12;Castellón/Castelló;088;Pavías;69;41;28;2016
12;Castellón/Castelló;089;Peníscola/Peñíscola;7421;3751;3670;2016
12;Castellón/Castelló;090;Pina de Montalgrao;127;64;63;2016
12;Castellón/Castelló;093;Pobla de Benifassà, la;209;113;96;2016
12;Castellón/Castelló;094;Pobla Tornesa, la;1200;624;576;2016
12;Castellón/Castelló;091;Portell de Morella;200;100;100;2016
12;Castellón/Castelló;092;Puebla de Arenoso;143;74;69;2016
12;Castellón/Castelló;095;Ribesalbes;1223;623;600;2016
12;Castellón/Castelló;096;Rossell;1002;528;474;2016
12;Castellón/Castelló;097;Sacañet;67;41;26;2016
12;Castellón/Castelló;098;Salzadella, la;751;380;371;2016
12;Castellón/Castelló;101;San Rafael del Río;483;239;244;2016
12;Castellón/Castelló;902;Sant Joan de Moró;3043;1585;1458;2016
12;Castellón/Castelló;099;Sant Jordi/San Jorge;970;498;472;2016
12;Castellón/Castelló;100;Sant Mateu;1979;977;1002;2016
12;Castellón/Castelló;102;Santa Magdalena de Pulpis;791;429;362;2016
12;Castellón/Castelló;104;Segorbe;9005;4460;4545;2016
12;Castellón/Castelló;103;Serratella, la;99;55;44;2016
12;Castellón/Castelló;105;Sierra Engarcerán;1019;539;480;2016
12;Castellón/Castelló;106;Soneja;1463;713;750;2016
12;Castellón/Castelló;107;Sot de Ferrer;418;213;205;2016
12;Castellón/Castelló;108;Sueras/Suera;551;283;268;2016
12;Castellón/Castelló;109;Tales;812;405;407;2016
12;Castellón/Castelló;110;Teresa;266;135;131;2016
12;Castellón/Castelló;111;Tírig;465;239;226;2016
12;Castellón/Castelló;112;Todolella;147;85;62;2016
12;Castellón/Castelló;113;Toga;98;49;49;2016
12;Castellón/Castelló;114;Torás;228;120;108;2016
12;Castellón/Castelló;115;Toro, El;252;140;112;2016
12;Castellón/Castelló;116;Torralba del Pinar;66;32;34;2016
12;Castellón/Castelló;119;Torre d'En Besora, la;166;93;73;2016
12;Castellón/Castelló;120;Torre d'en Doménec, la;212;107;105;2016
12;Castellón/Castelló;117;Torreblanca;5398;2740;2658;2016
12;Castellón/Castelló;118;Torrechiva;75;44;31;2016
12;Castellón/Castelló;121;Traiguera;1502;751;751;2016
12;Castellón/Castelló;122;Useras/Useres, les;994;519;475;2016
12;Castellón/Castelló;124;Vall d'Alba;2809;1463;1346;2016
12;Castellón/Castelló;125;Vall de Almonacid;261;136;125;2016
12;Castellón/Castelló;126;Vall d'Uixó, la;31819;15756;16063;2016
12;Castellón/Castelló;123;Vallat;54;25;29;2016
12;Castellón/Castelló;127;Vallibona;81;45;36;2016
12;Castellón/Castelló;128;Vilafamés;1851;979;872;2016
12;Castellón/Castelló;132;Vilanova d'Alcolea;595;311;284;2016
12;Castellón/Castelló;134;Vilar de Canes;179;95;84;2016
12;Castellón/Castelló;135;Vila-real;50252;24866;25386;2016
12;Castellón/Castelló;136;Vilavella, la;3243;1623;1620;2016
12;Castellón/Castelló;129;Villafranca del Cid/Vilafranca;2289;1126;1163;2016
12;Castellón/Castelló;130;Villahermosa del Río;487;269;218;2016
12;Castellón/Castelló;131;Villamalur;68;40;28;2016
12;Castellón/Castelló;133;Villanueva de Viver;60;33;27;2016
12;Castellón/Castelló;137;Villores;38;20;18;2016
12;Castellón/Castelló;138;Vinaròs;28290;13989;14301;2016
12;Castellón/Castelló;139;Vistabella del Maestrat;364;197;167;2016
12;Castellón/Castelló;140;Viver;1536;792;744;2016
12;Castellón/Castelló;052;Xert;754;363;391;2016
12;Castellón/Castelló;141;Zorita del Maestrazgo;124;63;61;2016
12;Castellón/Castelló;142;Zucaina;190;105;85;2016
13;Ciudad Real;001;Abenójar;1460;749;711;2016
13;Ciudad Real;002;Agudo;1760;894;866;2016
13;Ciudad Real;003;Alamillo;528;270;258;2016
13;Ciudad Real;004;Albaladejo;1235;633;602;2016
13;Ciudad Real;005;Alcázar de San Juan;30967;15074;15893;2016
13;Ciudad Real;006;Alcoba;614;305;309;2016
13;Ciudad Real;007;Alcolea de Calatrava;1443;732;711;2016
13;Ciudad Real;008;Alcubillas;510;266;244;2016
13;Ciudad Real;009;Aldea del Rey;1721;876;845;2016
13;Ciudad Real;010;Alhambra;1022;524;498;2016
13;Ciudad Real;011;Almadén;5657;2701;2956;2016
13;Ciudad Real;012;Almadenejos;460;233;227;2016
13;Ciudad Real;013;Almagro;8967;4416;4551;2016
13;Ciudad Real;014;Almedina;555;290;265;2016
13;Ciudad Real;015;Almodóvar del Campo;6360;3209;3151;2016
13;Ciudad Real;016;Almuradiel;830;413;417;2016
13;Ciudad Real;017;Anchuras;331;171;160;2016
13;Ciudad Real;903;Arenales de San Gregorio;647;336;311;2016
13;Ciudad Real;018;Arenas de San Juan;1045;525;520;2016
13;Ciudad Real;019;Argamasilla de Alba;6972;3492;3480;2016
13;Ciudad Real;020;Argamasilla de Calatrava;5987;3042;2945;2016
13;Ciudad Real;021;Arroba de los Montes;467;246;221;2016
13;Ciudad Real;022;Ballesteros de Calatrava;387;193;194;2016
13;Ciudad Real;023;Bolaños de Calatrava;11994;6103;5891;2016
13;Ciudad Real;024;Brazatortas;1033;541;492;2016
13;Ciudad Real;025;Cabezarados;325;173;152;2016
13;Ciudad Real;026;Cabezarrubias del Puerto;505;267;238;2016
13;Ciudad Real;027;Calzada de Calatrava;4053;2023;2030;2016
13;Ciudad Real;028;Campo de Criptana;13949;6991;6958;2016
13;Ciudad Real;029;Cañada de Calatrava;99;56;43;2016
13;Ciudad Real;030;Caracuel de Calatrava;160;93;67;2016
13;Ciudad Real;031;Carrión de Calatrava;3068;1546;1522;2016
13;Ciudad Real;032;Carrizosa;1299;655;644;2016
13;Ciudad Real;033;Castellar de Santiago;2006;1010;996;2016
13;Ciudad Real;038;Chillón;1901;927;974;2016
13;Ciudad Real;034;Ciudad Real;74054;35052;39002;2016
13;Ciudad Real;035;Corral de Calatrava;1134;557;577;2016
13;Ciudad Real;036;Cortijos, Los;934;487;447;2016
13;Ciudad Real;037;Cózar;1062;522;540;2016
13;Ciudad Real;039;Daimiel;18396;9170;9226;2016
13;Ciudad Real;040;Fernán Caballero;1057;531;526;2016
13;Ciudad Real;041;Fontanarejo;263;146;117;2016
13;Ciudad Real;042;Fuencaliente;1055;553;502;2016
13;Ciudad Real;043;Fuenllana;253;132;121;2016
13;Ciudad Real;044;Fuente el Fresno;3346;1737;1609;2016
13;Ciudad Real;045;Granátula de Calatrava;794;389;405;2016
13;Ciudad Real;046;Guadalmez;794;398;396;2016
13;Ciudad Real;047;Herencia;8580;4365;4215;2016
13;Ciudad Real;048;Hinojosas de Calatrava;500;257;243;2016
13;Ciudad Real;049;Horcajo de los Montes;958;481;477;2016
13;Ciudad Real;050;Labores, Las;613;308;305;2016
13;Ciudad Real;904;Llanos del Caudillo;727;365;362;2016
13;Ciudad Real;051;Luciana;394;208;186;2016
13;Ciudad Real;052;Malagón;8153;4051;4102;2016
13;Ciudad Real;053;Manzanares;18475;9173;9302;2016
13;Ciudad Real;054;Membrilla;6134;3090;3044;2016
13;Ciudad Real;055;Mestanza;730;359;371;2016
13;Ciudad Real;056;Miguelturra;15133;7635;7498;2016
13;Ciudad Real;057;Montiel;1400;738;662;2016
13;Ciudad Real;058;Moral de Calatrava;5325;2682;2643;2016
13;Ciudad Real;059;Navalpino;233;119;114;2016
13;Ciudad Real;060;Navas de Estena;254;136;118;2016
13;Ciudad Real;061;Pedro Muñoz;7576;3854;3722;2016
13;Ciudad Real;062;Picón;685;360;325;2016
13;Ciudad Real;063;Piedrabuena;4542;2311;2231;2016
13;Ciudad Real;064;Poblete;2366;1232;1134;2016
13;Ciudad Real;065;Porzuna;3661;1883;1778;2016
13;Ciudad Real;066;Pozuelo de Calatrava;3362;1719;1643;2016
13;Ciudad Real;067;Pozuelos de Calatrava, Los;400;210;190;2016
13;Ciudad Real;068;Puebla de Don Rodrigo;1228;670;558;2016
13;Ciudad Real;069;Puebla del Príncipe;752;381;371;2016
13;Ciudad Real;070;Puerto Lápice;947;473;474;2016
13;Ciudad Real;071;Puertollano;49166;23808;25358;2016
13;Ciudad Real;072;Retuerta del Bullaque;1006;550;456;2016
13;Ciudad Real;901;Robledo, El;1142;602;540;2016
13;Ciudad Real;902;Ruidera;580;293;287;2016
13;Ciudad Real;073;Saceruela;607;323;284;2016
13;Ciudad Real;074;San Carlos del Valle;1170;610;560;2016
13;Ciudad Real;075;San Lorenzo de Calatrava;219;116;103;2016
13;Ciudad Real;076;Santa Cruz de los Cáñamos;550;274;276;2016
13;Ciudad Real;077;Santa Cruz de Mudela;4239;2114;2125;2016
13;Ciudad Real;078;Socuéllamos;12628;6425;6203;2016
13;Ciudad Real;080;Solana del Pino;342;181;161;2016
13;Ciudad Real;079;Solana, La;15792;7978;7814;2016
13;Ciudad Real;081;Terrinches;748;387;361;2016
13;Ciudad Real;082;Tomelloso;36746;18251;18495;2016
13;Ciudad Real;083;Torralba de Calatrava;3025;1497;1528;2016
13;Ciudad Real;084;Torre de Juan Abad;1081;532;549;2016
13;Ciudad Real;085;Torrenueva;2820;1422;1398;2016
13;Ciudad Real;086;Valdemanco del Esteras;196;102;94;2016
13;Ciudad Real;087;Valdepeñas;30277;14834;15443;2016
13;Ciudad Real;088;Valenzuela de Calatrava;708;331;377;2016
13;Ciudad Real;089;Villahermosa;1961;937;1024;2016
13;Ciudad Real;090;Villamanrique;1239;611;628;2016
13;Ciudad Real;091;Villamayor de Calatrava;640;316;324;2016
13;Ciudad Real;092;Villanueva de la Fuente;2267;1163;1104;2016
13;Ciudad Real;093;Villanueva de los Infantes;5243;2570;2673;2016
13;Ciudad Real;094;Villanueva de San Carlos;306;160;146;2016
13;Ciudad Real;095;Villar del Pozo;93;50;43;2016
13;Ciudad Real;096;Villarrubia de los Ojos;10156;5059;5097;2016
13;Ciudad Real;097;Villarta de San Juan;2907;1456;1451;2016
13;Ciudad Real;098;Viso del Marqués;2447;1186;1261;2016
14;Córdoba;001;Adamuz;4270;2188;2082;2016
14;Córdoba;002;Aguilar de la Frontera;13511;6811;6700;2016
14;Córdoba;003;Alcaracejos;1495;718;777;2016
14;Córdoba;004;Almedinilla;2431;1214;1217;2016
14;Córdoba;005;Almodóvar del Río;7948;3983;3965;2016
14;Córdoba;006;Añora;1558;769;789;2016
14;Córdoba;007;Baena;19782;10117;9665;2016
14;Córdoba;008;Belalcázar;3391;1639;1752;2016
14;Córdoba;009;Belmez;3062;1487;1575;2016
14;Córdoba;010;Benamejí;5035;2510;2525;2016
14;Córdoba;011;Blázquez, Los;695;363;332;2016
14;Córdoba;012;Bujalance;7638;3820;3818;2016
14;Córdoba;013;Cabra;20704;10120;10584;2016
14;Córdoba;014;Cañete de las Torres;2992;1534;1458;2016
14;Córdoba;015;Carcabuey;2529;1286;1243;2016
14;Córdoba;016;Cardeña;1552;779;773;2016
14;Córdoba;017;Carlota, La;13936;7001;6935;2016
14;Córdoba;018;Carpio, El;4500;2244;2256;2016
14;Córdoba;019;Castro del Río;7917;3928;3989;2016
14;Córdoba;020;Conquista;430;215;215;2016
14;Córdoba;021;Córdoba;326609;156914;169695;2016
14;Córdoba;022;Doña Mencía;4789;2331;2458;2016
14;Córdoba;023;Dos Torres;2453;1216;1237;2016
14;Córdoba;024;Encinas Reales;2324;1154;1170;2016
14;Córdoba;025;Espejo;3410;1727;1683;2016
14;Córdoba;026;Espiel;2487;1236;1251;2016
14;Córdoba;027;Fernán-Núñez;9712;4866;4846;2016
14;Córdoba;028;Fuente la Lancha;355;183;172;2016
14;Córdoba;029;Fuente Obejuna;4796;2458;2338;2016
14;Córdoba;030;Fuente Palmera;10893;5458;5435;2016
14;Córdoba;031;Fuente-Tójar;711;338;373;2016
14;Córdoba;032;Granjuela, La;486;245;241;2016
14;Córdoba;033;Guadalcázar;1591;793;798;2016
14;Córdoba;034;Guijo, El;365;191;174;2016
14;Córdoba;035;Hinojosa del Duque;6989;3418;3571;2016
14;Córdoba;036;Hornachuelos;4598;2308;2290;2016
14;Córdoba;037;Iznájar;4461;2241;2220;2016
14;Córdoba;038;Lucena;42615;21256;21359;2016
14;Córdoba;039;Luque;3071;1543;1528;2016
14;Córdoba;040;Montalbán de Córdoba;4473;2241;2232;2016
14;Córdoba;041;Montemayor;3924;1971;1953;2016
14;Córdoba;042;Montilla;23365;11573;11792;2016
14;Córdoba;043;Montoro;9635;4725;4910;2016
14;Córdoba;044;Monturque;1981;983;998;2016
14;Córdoba;045;Moriles;3819;1907;1912;2016
14;Córdoba;046;Nueva Carteya;5435;2751;2684;2016
14;Córdoba;047;Obejo;2009;1051;958;2016
14;Córdoba;048;Palenciana;1506;759;747;2016
14;Córdoba;049;Palma del Río;21241;10584;10657;2016
14;Córdoba;050;Pedro Abad;2903;1472;1431;2016
14;Córdoba;051;Pedroche;1603;775;828;2016
14;Córdoba;052;Peñarroya-Pueblonuevo;11160;5412;5748;2016
14;Córdoba;053;Posadas;7468;3736;3732;2016
14;Córdoba;054;Pozoblanco;17292;8463;8829;2016
14;Córdoba;055;Priego de Córdoba;22855;11151;11704;2016
14;Córdoba;056;Puente Genil;30072;14944;15128;2016
14;Córdoba;057;Rambla, La;7576;3772;3804;2016
14;Córdoba;058;Rute;10042;4979;5063;2016
14;Córdoba;059;San Sebastián de los Ballesteros;811;406;405;2016
14;Córdoba;061;Santa Eufemia;822;413;409;2016
14;Córdoba;060;Santaella;6079;3082;2997;2016
14;Córdoba;062;Torrecampo;1150;565;585;2016
14;Córdoba;063;Valenzuela;1208;599;609;2016
14;Córdoba;064;Valsequillo;373;178;195;2016
14;Córdoba;065;Victoria, La;2353;1167;1186;2016
14;Córdoba;066;Villa del Río;7301;3654;3647;2016
14;Córdoba;067;Villafranca de Córdoba;4918;2514;2404;2016
14;Córdoba;068;Villaharta;669;325;344;2016
14;Córdoba;069;Villanueva de Córdoba;9005;4447;4558;2016
14;Córdoba;070;Villanueva del Duque;1520;763;757;2016
14;Córdoba;071;Villanueva del Rey;1088;540;548;2016
14;Córdoba;072;Villaralto;1196;591;605;2016
14;Córdoba;073;Villaviciosa de Córdoba;3374;1730;1644;2016
14;Córdoba;074;Viso, El;2636;1308;1328;2016
14;Córdoba;075;Zuheros;657;337;320;2016
15;Coruña, A;001;Abegondo;5533;2735;2798;2016
15;Coruña, A;002;Ames;30544;14710;15834;2016
15;Coruña, A;003;Aranga;1982;1002;980;2016
15;Coruña, A;004;Ares;5672;2788;2884;2016
15;Coruña, A;005;Arteixo;31239;15593;15646;2016
15;Coruña, A;006;Arzúa;6211;3092;3119;2016
15;Coruña, A;007;Baña, A;3645;1749;1896;2016
15;Coruña, A;008;Bergondo;6656;3249;3407;2016
15;Coruña, A;009;Betanzos;12966;6148;6818;2016
15;Coruña, A;010;Boimorto;2111;1082;1029;2016
15;Coruña, A;011;Boiro;18871;9206;9665;2016
15;Coruña, A;012;Boqueixón;4291;2113;2178;2016
15;Coruña, A;013;Brión;7590;3670;3920;2016
15;Coruña, A;014;Cabana de Bergantiños;4446;2172;2274;2016
15;Coruña, A;015;Cabanas;3259;1608;1651;2016
15;Coruña, A;016;Camariñas;5486;2651;2835;2016
15;Coruña, A;017;Cambre;24141;11853;12288;2016
15;Coruña, A;018;Capela, A;1318;652;666;2016
15;Coruña, A;019;Carballo;31256;15289;15967;2016
15;Coruña, A;901;Cariño;4072;2013;2059;2016
15;Coruña, A;020;Carnota;4170;2007;2163;2016
15;Coruña, A;021;Carral;6172;3039;3133;2016
15;Coruña, A;022;Cedeira;6997;3502;3495;2016
15;Coruña, A;023;Cee;7631;3663;3968;2016
15;Coruña, A;024;Cerceda;5031;2470;2561;2016
15;Coruña, A;025;Cerdido;1191;580;611;2016
15;Coruña, A;027;Coirós;1789;890;899;2016
15;Coruña, A;028;Corcubión;1606;774;832;2016
15;Coruña, A;029;Coristanco;6426;3086;3340;2016
15;Coruña, A;030;Coruña, A;243978;113248;130730;2016
15;Coruña, A;031;Culleredo;29638;14421;15217;2016
15;Coruña, A;032;Curtis;3980;1992;1988;2016
15;Coruña, A;033;Dodro;2853;1383;1470;2016
15;Coruña, A;034;Dumbría;3085;1468;1617;2016
15;Coruña, A;035;Fene;13250;6340;6910;2016
15;Coruña, A;036;Ferrol;68308;32070;36238;2016
15;Coruña, A;037;Fisterra;4737;2399;2338;2016
15;Coruña, A;038;Frades;2428;1212;1216;2016
15;Coruña, A;039;Irixoa;1369;694;675;2016
15;Coruña, A;041;Laracha, A;11295;5565;5730;2016
15;Coruña, A;040;Laxe;3148;1583;1565;2016
15;Coruña, A;042;Lousame;3429;1669;1760;2016
15;Coruña, A;043;Malpica de Bergantiños;5616;2747;2869;2016
15;Coruña, A;044;Mañón;1420;686;734;2016
15;Coruña, A;045;Mazaricos;4087;1952;2135;2016
15;Coruña, A;046;Melide;7488;3678;3810;2016
15;Coruña, A;047;Mesía;2700;1342;1358;2016
15;Coruña, A;048;Miño;5832;2901;2931;2016
15;Coruña, A;049;Moeche;1220;565;655;2016
15;Coruña, A;050;Monfero;2019;1030;989;2016
15;Coruña, A;051;Mugardos;5335;2605;2730;2016
15;Coruña, A;053;Muros;8834;4280;4554;2016
15;Coruña, A;052;Muxía;4941;2404;2537;2016
15;Coruña, A;054;Narón;39426;19093;20333;2016
15;Coruña, A;055;Neda;5197;2538;2659;2016
15;Coruña, A;056;Negreira;6911;3339;3572;2016
15;Coruña, A;057;Noia;14337;6869;7468;2016
15;Coruña, A;058;Oleiros;35013;16984;18029;2016
15;Coruña, A;059;Ordes;12669;6183;6486;2016
15;Coruña, A;060;Oroso;7420;3662;3758;2016
15;Coruña, A;061;Ortigueira;6093;2938;3155;2016
15;Coruña, A;062;Outes;6606;3156;3450;2016
15;Coruña, A;902;Oza-Cesuras;5181;2623;2558;2016
15;Coruña, A;064;Paderne;2445;1197;1248;2016
15;Coruña, A;065;Padrón;8581;4131;4450;2016
15;Coruña, A;066;Pino, O;4653;2329;2324;2016
15;Coruña, A;067;Pobra do Caramiñal, A;9525;4646;4879;2016
15;Coruña, A;068;Ponteceso;5703;2841;2862;2016
15;Coruña, A;069;Pontedeume;8005;3839;4166;2016
15;Coruña, A;070;Pontes de García Rodríguez, As;10399;5091;5308;2016
15;Coruña, A;071;Porto do Son;9386;4672;4714;2016
15;Coruña, A;072;Rianxo;11295;5516;5779;2016
15;Coruña, A;073;Ribeira;27249;13444;13805;2016
15;Coruña, A;074;Rois;4657;2216;2441;2016
15;Coruña, A;075;Sada;15150;7444;7706;2016
15;Coruña, A;076;San Sadurniño;2944;1461;1483;2016
15;Coruña, A;077;Santa Comba;9556;4610;4946;2016
15;Coruña, A;078;Santiago de Compostela;95966;44477;51489;2016
15;Coruña, A;079;Santiso;1672;867;805;2016
15;Coruña, A;080;Sobrado;1882;971;911;2016
15;Coruña, A;081;Somozas, As;1160;589;571;2016
15;Coruña, A;082;Teo;18510;9076;9434;2016
15;Coruña, A;083;Toques;1196;625;571;2016
15;Coruña, A;084;Tordoia;3522;1659;1863;2016
15;Coruña, A;085;Touro;3703;1840;1863;2016
15;Coruña, A;086;Trazo;3190;1569;1621;2016
15;Coruña, A;088;Val do Dubra;3974;1904;2070;2016
15;Coruña, A;087;Valdoviño;6650;3244;3406;2016
15;Coruña, A;089;Vedra;5012;2462;2550;2016
15;Coruña, A;091;Vilarmaior;1260;643;617;2016
15;Coruña, A;090;Vilasantar;1275;675;600;2016
15;Coruña, A;092;Vimianzo;7378;3542;3836;2016
15;Coruña, A;093;Zas;4756;2293;2463;2016
16;Cuenca;001;Abia de la Obispalía;77;48;29;2016
16;Cuenca;002;Acebrón, El;236;114;122;2016
16;Cuenca;003;Alarcón;148;66;82;2016
16;Cuenca;004;Albaladejo del Cuende;276;139;137;2016
16;Cuenca;005;Albalate de las Nogueras;276;145;131;2016
16;Cuenca;006;Albendea;134;63;71;2016
16;Cuenca;007;Alberca de Záncara, La;1651;845;806;2016
16;Cuenca;008;Alcalá de la Vega;97;51;46;2016
16;Cuenca;009;Alcantud;65;35;30;2016
16;Cuenca;010;Alcázar del Rey;159;77;82;2016
16;Cuenca;011;Alcohujate;32;18;14;2016
16;Cuenca;012;Alconchel de la Estrella;106;60;46;2016
16;Cuenca;013;Algarra;29;19;10;2016
16;Cuenca;014;Aliaguilla;692;359;333;2016
16;Cuenca;015;Almarcha, La;393;220;173;2016
16;Cuenca;016;Almendros;262;152;110;2016
16;Cuenca;017;Almodóvar del Pinar;430;232;198;2016
16;Cuenca;018;Almonacid del Marquesado;451;233;218;2016
16;Cuenca;019;Altarejos;226;118;108;2016
16;Cuenca;020;Arandilla del Arroyo;14;7;7;2016
16;Cuenca;905;Arcas;1643;826;817;2016
16;Cuenca;022;Arcos de la Sierra;82;49;33;2016
16;Cuenca;024;Arguisuelas;141;75;66;2016
16;Cuenca;025;Arrancacepas;28;15;13;2016
16;Cuenca;026;Atalaya del Cañavate;103;50;53;2016
16;Cuenca;027;Barajas de Melo;926;491;435;2016
16;Cuenca;029;Barchín del Hoyo;86;52;34;2016
16;Cuenca;030;Bascuñana de San Pedro;22;14;8;2016
16;Cuenca;031;Beamud;51;24;27;2016
16;Cuenca;032;Belinchón;337;175;162;2016
16;Cuenca;033;Belmonte;2009;995;1014;2016
16;Cuenca;034;Belmontejo;188;105;83;2016
16;Cuenca;035;Beteta;281;138;143;2016
16;Cuenca;036;Boniches;148;68;80;2016
16;Cuenca;038;Buciegas;48;29;19;2016
16;Cuenca;039;Buenache de Alarcón;491;262;229;2016
16;Cuenca;040;Buenache de la Sierra;98;58;40;2016
16;Cuenca;041;Buendía;419;225;194;2016
16;Cuenca;042;Campillo de Altobuey;1405;692;713;2016
16;Cuenca;043;Campillos-Paravientos;118;62;56;2016
16;Cuenca;044;Campillos-Sierra;33;13;20;2016
16;Cuenca;901;Campos del Paraíso;807;411;396;2016
16;Cuenca;045;Canalejas del Arroyo;261;142;119;2016
16;Cuenca;046;Cañada del Hoyo;268;135;133;2016
16;Cuenca;047;Cañada Juncosa;264;144;120;2016
16;Cuenca;048;Cañamares;485;261;224;2016
16;Cuenca;049;Cañavate, El;155;83;72;2016
16;Cuenca;050;Cañaveras;299;145;154;2016
16;Cuenca;051;Cañaveruelas;143;74;69;2016
16;Cuenca;052;Cañete;759;399;360;2016
16;Cuenca;053;Cañizares;488;266;222;2016
16;Cuenca;055;Carboneras de Guadazaón;827;428;399;2016
16;Cuenca;056;Cardenete;517;277;240;2016
16;Cuenca;057;Carrascosa;80;50;30;2016
16;Cuenca;058;Carrascosa de Haro;117;59;58;2016
16;Cuenca;060;Casas de Benítez;883;430;453;2016
16;Cuenca;061;Casas de Fernando Alonso;1258;661;597;2016
16;Cuenca;062;Casas de Garcimolina;30;20;10;2016
16;Cuenca;063;Casas de Guijarro;112;60;52;2016
16;Cuenca;064;Casas de Haro;875;467;408;2016
16;Cuenca;065;Casas de los Pinos;441;219;222;2016
16;Cuenca;066;Casasimarro;3113;1627;1486;2016
16;Cuenca;067;Castejón;140;76;64;2016
16;Cuenca;068;Castillejo de Iniesta;175;98;77;2016
16;Cuenca;070;Castillejo-Sierra;31;16;15;2016
16;Cuenca;072;Castillo de Garcimuñoz;152;86;66;2016
16;Cuenca;071;Castillo-Albaráñez;22;10;12;2016
16;Cuenca;073;Cervera del Llano;226;115;111;2016
16;Cuenca;023;Chillarón de Cuenca;557;306;251;2016
16;Cuenca;081;Chumillas;58;31;27;2016
16;Cuenca;074;Cierva, La;39;24;15;2016
16;Cuenca;078;Cuenca;55102;26341;28761;2016
16;Cuenca;079;Cueva del Hierro;32;22;10;2016
16;Cuenca;082;Enguídanos;337;181;156;2016
16;Cuenca;083;Fresneda de Altarejos;52;26;26;2016
16;Cuenca;084;Fresneda de la Sierra;53;29;24;2016
16;Cuenca;085;Frontera, La;158;81;77;2016
16;Cuenca;086;Fuente de Pedro Naharro;1258;646;612;2016
16;Cuenca;087;Fuentelespino de Haro;258;134;124;2016
16;Cuenca;088;Fuentelespino de Moya;118;62;56;2016
16;Cuenca;904;Fuentenava de Jábaga;561;300;261;2016
16;Cuenca;089;Fuentes;453;239;214;2016
16;Cuenca;091;Fuertescusa;74;39;35;2016
16;Cuenca;092;Gabaldón;189;110;79;2016
16;Cuenca;093;Garaballa;72;38;34;2016
16;Cuenca;094;Gascueña;177;98;79;2016
16;Cuenca;095;Graja de Campalbo;93;50;43;2016
16;Cuenca;096;Graja de Iniesta;363;194;169;2016
16;Cuenca;097;Henarejos;159;79;80;2016
16;Cuenca;098;Herrumblar, El;708;363;345;2016
16;Cuenca;099;Hinojosa, La;211;107;104;2016
16;Cuenca;100;Hinojosos, Los;856;420;436;2016
16;Cuenca;101;Hito, El;163;88;75;2016
16;Cuenca;102;Honrubia;1623;812;811;2016
16;Cuenca;103;Hontanaya;297;160;137;2016
16;Cuenca;104;Hontecillas;52;28;24;2016
16;Cuenca;106;Horcajo de Santiago;3597;1836;1761;2016
16;Cuenca;107;Huélamo;105;62;43;2016
16;Cuenca;108;Huelves;57;29;28;2016
16;Cuenca;109;Huérguina;56;30;26;2016
16;Cuenca;110;Huerta de la Obispalía;128;76;52;2016
16;Cuenca;111;Huerta del Marquesado;211;124;87;2016
16;Cuenca;112;Huete;1817;930;887;2016
16;Cuenca;113;Iniesta;4330;2122;2208;2016
16;Cuenca;115;Laguna del Marquesado;43;24;19;2016
16;Cuenca;116;Lagunaseca;80;45;35;2016
16;Cuenca;117;Landete;1271;642;629;2016
16;Cuenca;118;Ledaña;1664;818;846;2016
16;Cuenca;119;Leganiel;186;98;88;2016
16;Cuenca;121;Majadas, Las;277;142;135;2016
16;Cuenca;122;Mariana;288;147;141;2016
16;Cuenca;123;Masegosa;78;46;32;2016
16;Cuenca;124;Mesas, Las;2326;1197;1129;2016
16;Cuenca;125;Minglanilla;2263;1157;1106;2016
16;Cuenca;126;Mira;972;488;484;2016
16;Cuenca;128;Monreal del Llano;69;36;33;2016
16;Cuenca;129;Montalbanejo;109;60;49;2016
16;Cuenca;130;Montalbo;671;360;311;2016
16;Cuenca;131;Monteagudo de las Salinas;133;75;58;2016
16;Cuenca;132;Mota de Altarejos;35;22;13;2016
16;Cuenca;133;Mota del Cuervo;6045;3010;3035;2016
16;Cuenca;134;Motilla del Palancar;5902;2945;2957;2016
16;Cuenca;135;Moya;163;92;71;2016
16;Cuenca;137;Narboneta;58;29;29;2016
16;Cuenca;139;Olivares de Júcar;349;185;164;2016
16;Cuenca;140;Olmeda de la Cuesta;34;19;15;2016
16;Cuenca;141;Olmeda del Rey;138;68;70;2016
16;Cuenca;142;Olmedilla de Alarcón;164;95;69;2016
16;Cuenca;143;Olmedilla de Eliz;16;11;5;2016
16;Cuenca;145;Osa de la Vega;522;274;248;2016
16;Cuenca;146;Pajarón;84;41;43;2016
16;Cuenca;147;Pajaroncillo;74;43;31;2016
16;Cuenca;148;Palomares del Campo;654;333;321;2016
16;Cuenca;149;Palomera;167;86;81;2016
16;Cuenca;150;Paracuellos;100;49;51;2016
16;Cuenca;151;Paredes;65;36;29;2016
16;Cuenca;152;Parra de las Vegas, La;45;26;19;2016
16;Cuenca;153;Pedernoso, El;1176;597;579;2016
16;Cuenca;154;Pedroñeras, Las;6716;3436;3280;2016
16;Cuenca;155;Peral, El;634;349;285;2016
16;Cuenca;156;Peraleja, La;104;57;47;2016
16;Cuenca;157;Pesquera, La;236;130;106;2016
16;Cuenca;158;Picazo, El;688;346;342;2016
16;Cuenca;159;Pinarejo;238;122;116;2016
16;Cuenca;160;Pineda de Gigüela;61;32;29;2016
16;Cuenca;161;Piqueras del Castillo;61;31;30;2016
16;Cuenca;162;Portalrubio de Guadamejud;28;13;15;2016
16;Cuenca;163;Portilla;74;39;35;2016
16;Cuenca;165;Poyatos;63;32;31;2016
16;Cuenca;166;Pozoamargo;316;168;148;2016
16;Cuenca;908;Pozorrubielos de la Mancha;204;97;107;2016
16;Cuenca;167;Pozorrubio de Santiago;341;163;178;2016
16;Cuenca;169;Pozuelo, El;57;35;22;2016
16;Cuenca;170;Priego;973;489;484;2016
16;Cuenca;171;Provencio, El;2505;1236;1269;2016
16;Cuenca;172;Puebla de Almenara;373;195;178;2016
16;Cuenca;174;Puebla del Salvador;204;112;92;2016
16;Cuenca;175;Quintanar del Rey;7447;3857;3590;2016
16;Cuenca;176;Rada de Haro;47;22;25;2016
16;Cuenca;177;Reíllo;95;53;42;2016
16;Cuenca;181;Rozalén del Monte;71;33;38;2016
16;Cuenca;185;Saceda-Trasierra;45;32;13;2016
16;Cuenca;186;Saelices;547;281;266;2016
16;Cuenca;187;Salinas del Manzano;90;49;41;2016
16;Cuenca;188;Salmeroncillos;117;67;50;2016
16;Cuenca;189;Salvacañete;313;164;149;2016
16;Cuenca;190;San Clemente;7220;3687;3533;2016
16;Cuenca;191;San Lorenzo de la Parrilla;1105;546;559;2016
16;Cuenca;192;San Martín de Boniches;51;27;24;2016
16;Cuenca;193;San Pedro Palmiches;65;38;27;2016
16;Cuenca;194;Santa Cruz de Moya;248;130;118;2016
16;Cuenca;196;Santa María de los Llanos;719;374;345;2016
16;Cuenca;195;Santa María del Campo Rus;625;311;314;2016
16;Cuenca;197;Santa María del Val;61;35;26;2016
16;Cuenca;198;Sisante;1698;854;844;2016
16;Cuenca;199;Solera de Gabaldón;28;12;16;2016
16;Cuenca;909;Sotorribas;791;400;391;2016
16;Cuenca;202;Talayuelas;910;483;427;2016
16;Cuenca;203;Tarancón;14750;7326;7424;2016
16;Cuenca;204;Tébar;306;162;144;2016
16;Cuenca;205;Tejadillos;131;65;66;2016
16;Cuenca;206;Tinajas;207;106;101;2016
16;Cuenca;209;Torralba;121;71;50;2016
16;Cuenca;211;Torrejoncillo del Rey;412;210;202;2016
16;Cuenca;212;Torrubia del Campo;275;135;140;2016
16;Cuenca;213;Torrubia del Castillo;38;24;14;2016
16;Cuenca;215;Tragacete;267;148;119;2016
16;Cuenca;216;Tresjuncos;332;178;154;2016
16;Cuenca;217;Tribaldos;91;47;44;2016
16;Cuenca;218;Uclés;225;117;108;2016
16;Cuenca;219;Uña;97;47;50;2016
16;Cuenca;906;Valdecolmenas, Los;82;50;32;2016
16;Cuenca;224;Valdemeca;91;49;42;2016
16;Cuenca;225;Valdemorillo de la Sierra;77;47;30;2016
16;Cuenca;227;Valdemoro-Sierra;120;71;49;2016
16;Cuenca;228;Valdeolivas;199;121;78;2016
16;Cuenca;902;Valdetórtola;142;79;63;2016
16;Cuenca;903;Valeras, Las;1590;835;755;2016
16;Cuenca;231;Valhermoso de la Fuente;49;26;23;2016
16;Cuenca;173;Valle de Altomira, El;232;128;104;2016
16;Cuenca;234;Valsalobre;29;16;13;2016
16;Cuenca;236;Valverde de Júcar;1173;588;585;2016
16;Cuenca;237;Valverdejo;97;54;43;2016
16;Cuenca;238;Vara de Rey;556;292;264;2016
16;Cuenca;239;Vega del Codorno;151;91;60;2016
16;Cuenca;240;Vellisca;108;58;50;2016
16;Cuenca;242;Villaconejos de Trabaque;366;182;184;2016
16;Cuenca;243;Villaescusa de Haro;508;254;254;2016
16;Cuenca;244;Villagarcía del Llano;774;393;381;2016
16;Cuenca;245;Villalba de la Sierra;505;243;262;2016
16;Cuenca;246;Villalba del Rey;560;306;254;2016
16;Cuenca;247;Villalgordo del Marquesado;87;47;40;2016
16;Cuenca;248;Villalpardo;972;481;491;2016
16;Cuenca;249;Villamayor de Santiago;2628;1334;1294;2016
16;Cuenca;250;Villanueva de Guadamejud;75;46;29;2016
16;Cuenca;251;Villanueva de la Jara;2269;1131;1138;2016
16;Cuenca;253;Villar de Cañas;426;222;204;2016
16;Cuenca;254;Villar de Domingo García;230;125;105;2016
16;Cuenca;255;Villar de la Encina;164;88;76;2016
16;Cuenca;263;Villar de Olalla;1234;665;569;2016
16;Cuenca;258;Villar del Humo;218;126;92;2016
16;Cuenca;259;Villar del Infantado;39;25;14;2016
16;Cuenca;910;Villar y Velasco;92;51;41;2016
16;Cuenca;264;Villarejo de Fuentes;485;249;236;2016
16;Cuenca;265;Villarejo de la Peñuela;19;6;13;2016
16;Cuenca;266;Villarejo-Periesteban;370;186;184;2016
16;Cuenca;269;Villares del Saz;503;246;257;2016
16;Cuenca;270;Villarrubio;202;109;93;2016
16;Cuenca;271;Villarta;858;427;431;2016
16;Cuenca;272;Villas de la Ventosa;249;142;107;2016
16;Cuenca;273;Villaverde y Pasaconsol;351;188;163;2016
16;Cuenca;274;Víllora;138;71;67;2016
16;Cuenca;275;Vindel;11;6;5;2016
16;Cuenca;276;Yémeda;22;16;6;2016
16;Cuenca;277;Zafra de Záncara;133;73;60;2016
16;Cuenca;278;Zafrilla;67;34;33;2016
16;Cuenca;279;Zarza de Tajo;261;147;114;2016
16;Cuenca;280;Zarzuela;204;109;95;2016
20;Gipuzkoa;001;Abaltzisketa;324;177;147;2016
20;Gipuzkoa;002;Aduna;470;257;213;2016
20;Gipuzkoa;016;Aia;2046;1094;952;2016
20;Gipuzkoa;003;Aizarnazabal;775;393;382;2016
20;Gipuzkoa;004;Albiztur;330;174;156;2016
20;Gipuzkoa;005;Alegia;1730;882;848;2016
20;Gipuzkoa;006;Alkiza;358;180;178;2016
20;Gipuzkoa;906;Altzaga;171;84;87;2016
20;Gipuzkoa;007;Altzo;413;213;200;2016
20;Gipuzkoa;008;Amezketa;938;507;431;2016
20;Gipuzkoa;009;Andoain;14613;7240;7373;2016
20;Gipuzkoa;010;Anoeta;1997;1040;957;2016
20;Gipuzkoa;011;Antzuola;2176;1099;1077;2016
20;Gipuzkoa;012;Arama;206;106;100;2016
20;Gipuzkoa;013;Aretxabaleta;6993;3513;3480;2016
20;Gipuzkoa;055;Arrasate/Mondragón;21987;10864;11123;2016
20;Gipuzkoa;014;Asteasu;1505;783;722;2016
20;Gipuzkoa;903;Astigarraga;5880;3007;2873;2016
20;Gipuzkoa;015;Ataun;1701;891;810;2016
20;Gipuzkoa;017;Azkoitia;11587;5780;5807;2016
20;Gipuzkoa;018;Azpeitia;14666;7357;7309;2016
20;Gipuzkoa;904;Baliarrain;145;80;65;2016
20;Gipuzkoa;019;Beasain;13949;7037;6912;2016
20;Gipuzkoa;020;Beizama;166;103;63;2016
20;Gipuzkoa;021;Belauntza;241;127;114;2016
20;Gipuzkoa;022;Berastegi;1078;561;517;2016
20;Gipuzkoa;074;Bergara;14743;7308;7435;2016
20;Gipuzkoa;023;Berrobi;575;303;272;2016
20;Gipuzkoa;024;Bidania-Goiatz;515;278;237;2016
20;Gipuzkoa;029;Deba;5480;2745;2735;2016
20;Gipuzkoa;069;Donostia/San Sebastián;186064;87553;98511;2016
20;Gipuzkoa;030;Eibar;27380;13262;14118;2016
20;Gipuzkoa;031;Elduain;242;124;118;2016
20;Gipuzkoa;033;Elgeta;1113;566;547;2016
20;Gipuzkoa;032;Elgoibar;11594;5788;5806;2016
20;Gipuzkoa;067;Errenteria;39381;19133;20248;2016
20;Gipuzkoa;066;Errezil;599;317;282;2016
20;Gipuzkoa;034;Eskoriatza;4080;2062;2018;2016
20;Gipuzkoa;035;Ezkio-Itsaso;613;317;296;2016
20;Gipuzkoa;038;Gabiria;487;258;229;2016
20;Gipuzkoa;037;Gaintza;121;71;50;2016
20;Gipuzkoa;907;Gaztelu;160;92;68;2016
20;Gipuzkoa;039;Getaria;2818;1431;1387;2016
20;Gipuzkoa;040;Hernani;19712;9623;10089;2016
20;Gipuzkoa;041;Hernialde;321;164;157;2016
20;Gipuzkoa;036;Hondarribia;16950;8439;8511;2016
20;Gipuzkoa;042;Ibarra;4237;2108;2129;2016
20;Gipuzkoa;043;Idiazabal;2304;1153;1151;2016
20;Gipuzkoa;044;Ikaztegieta;487;250;237;2016
20;Gipuzkoa;045;Irun;61608;30109;31499;2016
20;Gipuzkoa;046;Irura;1785;930;855;2016
20;Gipuzkoa;047;Itsasondo;658;328;330;2016
20;Gipuzkoa;048;Larraul;245;135;110;2016
20;Gipuzkoa;902;Lasarte-Oria;18152;8861;9291;2016
20;Gipuzkoa;049;Lazkao;5539;2795;2744;2016
20;Gipuzkoa;050;Leaburu;364;190;174;2016
20;Gipuzkoa;051;Legazpi;8485;4321;4164;2016
20;Gipuzkoa;052;Legorreta;1443;722;721;2016
20;Gipuzkoa;068;Leintz-Gatzaga;235;127;108;2016
20;Gipuzkoa;053;Lezo;5960;2956;3004;2016
20;Gipuzkoa;054;Lizartza;602;316;286;2016
20;Gipuzkoa;901;Mendaro;2031;1032;999;2016
20;Gipuzkoa;057;Mutiloa;256;140;116;2016
20;Gipuzkoa;056;Mutriku;5329;2682;2647;2016
20;Gipuzkoa;063;Oiartzun;10175;5018;5157;2016
20;Gipuzkoa;058;Olaberria;941;481;460;2016
20;Gipuzkoa;059;Oñati;11348;5618;5730;2016
20;Gipuzkoa;076;Ordizia;9875;4921;4954;2016
20;Gipuzkoa;905;Orendain;200;105;95;2016
20;Gipuzkoa;060;Orexa;125;67;58;2016
20;Gipuzkoa;061;Orio;5851;2948;2903;2016
20;Gipuzkoa;062;Ormaiztegi;1316;665;651;2016
20;Gipuzkoa;064;Pasaia;16207;7809;8398;2016
20;Gipuzkoa;070;Segura;1472;752;720;2016
20;Gipuzkoa;065;Soraluze-Placencia de las Armas;3944;1988;1956;2016
20;Gipuzkoa;071;Tolosa;19175;9241;9934;2016
20;Gipuzkoa;072;Urnieta;6247;3128;3119;2016
20;Gipuzkoa;077;Urretxu;6805;3384;3421;2016
20;Gipuzkoa;073;Usurbil;6197;3139;3058;2016
20;Gipuzkoa;075;Villabona;5891;2965;2926;2016
20;Gipuzkoa;078;Zaldibia;1575;824;751;2016
20;Gipuzkoa;079;Zarautz;23117;11296;11821;2016
20;Gipuzkoa;025;Zegama;1514;783;731;2016
20;Gipuzkoa;026;Zerain;255;117;138;2016
20;Gipuzkoa;027;Zestoa;3734;1966;1768;2016
20;Gipuzkoa;028;Zizurkil;2997;1499;1498;2016
20;Gipuzkoa;081;Zumaia;9840;4873;4967;2016
20;Gipuzkoa;080;Zumarraga;9918;4873;5045;2016
17;Girona;001;Agullana;841;419;422;2016
17;Girona;002;Aiguaviva;763;391;372;2016
17;Girona;003;Albanyà;147;82;65;2016
17;Girona;004;Albons;765;387;378;2016
17;Girona;006;Alp;1536;800;736;2016
17;Girona;007;Amer;2260;1107;1153;2016
17;Girona;008;Anglès;5473;2709;2764;2016
17;Girona;009;Arbúcies;6380;3298;3082;2016
17;Girona;010;Argelaguer;415;218;197;2016
17;Girona;011;Armentera, L';935;471;464;2016
17;Girona;012;Avinyonet de Puigventós;1587;803;784;2016
17;Girona;015;Banyoles;19239;9608;9631;2016
17;Girona;016;Bàscara;980;514;466;2016
17;Girona;013;Begur;3957;2000;1957;2016
17;Girona;018;Bellcaire d'Empordà;647;317;330;2016
17;Girona;019;Besalú;2438;1146;1292;2016
17;Girona;020;Bescanó;4854;2432;2422;2016
17;Girona;021;Beuda;199;112;87;2016
17;Girona;022;Bisbal d'Empordà, La;10742;5346;5396;2016
17;Girona;234;Biure;233;122;111;2016
17;Girona;023;Blanes;39060;19491;19569;2016
17;Girona;029;Boadella i les Escaules;266;138;128;2016
17;Girona;024;Bolvir;375;198;177;2016
17;Girona;025;Bordils;1680;836;844;2016
17;Girona;026;Borrassà;711;369;342;2016
17;Girona;027;Breda;3722;1849;1873;2016
17;Girona;028;Brunyola;375;196;179;2016
17;Girona;031;Cabanelles;257;146;111;2016
17;Girona;030;Cabanes;915;494;421;2016
17;Girona;032;Cadaqués;2837;1379;1458;2016
17;Girona;033;Caldes de Malavella;7220;3611;3609;2016
17;Girona;034;Calonge;10709;5368;5341;2016
17;Girona;035;Camós;683;340;343;2016
17;Girona;036;Campdevànol;3314;1630;1684;2016
17;Girona;037;Campelles;137;70;67;2016
17;Girona;038;Campllong;516;258;258;2016
17;Girona;039;Camprodon;2221;1097;1124;2016
17;Girona;040;Canet d'Adri;702;353;349;2016
17;Girona;041;Cantallops;317;160;157;2016
17;Girona;042;Capmany;596;306;290;2016
17;Girona;044;Cassà de la Selva;10025;5101;4924;2016
17;Girona;046;Castellfollit de la Roca;970;494;476;2016
17;Girona;047;Castelló d'Empúries;10784;5441;5343;2016
17;Girona;048;Castell-Platja d'Aro;10567;5215;5352;2016
17;Girona;189;Cellera de Ter, La;2054;1023;1031;2016
17;Girona;049;Celrà;5303;2665;2638;2016
17;Girona;050;Cervià de Ter;916;462;454;2016
17;Girona;051;Cistella;293;140;153;2016
17;Girona;054;Colera;522;262;260;2016
17;Girona;055;Colomers;188;94;94;2016
17;Girona;057;Corçà;1249;631;618;2016
17;Girona;056;Cornellà del Terri;2279;1171;1108;2016
17;Girona;058;Crespià;267;136;131;2016
17;Girona;901;Cruïlles, Monells i Sant Sadurní de l'Heura;1292;653;639;2016
17;Girona;060;Darnius;550;279;271;2016
17;Girona;061;Das;215;117;98;2016
17;Girona;062;Escala, L';10400;5291;5109;2016
17;Girona;063;Espinelves;201;93;108;2016
17;Girona;064;Espolla;421;209;212;2016
17;Girona;065;Esponellà;456;226;230;2016
17;Girona;005;Far d'Empordà, El;553;277;276;2016
17;Girona;066;Figueres;45726;22652;23074;2016
17;Girona;067;Flaçà;1018;491;527;2016
17;Girona;068;Foixà;309;159;150;2016
17;Girona;069;Fontanals de Cerdanya;446;232;214;2016
17;Girona;070;Fontanilles;140;77;63;2016
17;Girona;071;Fontcoberta;1471;729;742;2016
17;Girona;902;Forallac;1723;859;864;2016
17;Girona;073;Fornells de la Selva;2547;1267;1280;2016
17;Girona;074;Fortià;721;346;375;2016
17;Girona;075;Garrigàs;435;228;207;2016
17;Girona;076;Garrigoles;163;89;74;2016
17;Girona;077;Garriguella;854;428;426;2016
17;Girona;078;Ger;436;230;206;2016
17;Girona;079;Girona;98255;47149;51106;2016
17;Girona;080;Gombrèn;184;93;91;2016
17;Girona;081;Gualta;376;201;175;2016
17;Girona;082;Guils de Cerdanya;531;281;250;2016
17;Girona;083;Hostalric;4058;2051;2007;2016
17;Girona;084;Isòvol;276;153;123;2016
17;Girona;085;Jafre;386;207;179;2016
17;Girona;086;Jonquera, La;3231;1632;1599;2016
17;Girona;087;Juià;327;170;157;2016
17;Girona;088;Lladó;752;373;379;2016
17;Girona;089;Llagostera;8266;4228;4038;2016
17;Girona;090;Llambilles;723;366;357;2016
17;Girona;091;Llanars;514;270;244;2016
17;Girona;092;Llançà;4934;2453;2481;2016
17;Girona;093;Llers;1210;605;605;2016
17;Girona;094;Llívia;1467;792;675;2016
17;Girona;095;Lloret de Mar;37042;18952;18090;2016
17;Girona;096;Llosses, Les;213;119;94;2016
17;Girona;102;Maçanet de Cabrenys;740;375;365;2016
17;Girona;103;Maçanet de la Selva;6819;3507;3312;2016
17;Girona;097;Madremanya;280;141;139;2016
17;Girona;098;Maià de Montcal;433;228;205;2016
17;Girona;100;Masarac;289;151;138;2016
17;Girona;101;Massanes;742;400;342;2016
17;Girona;099;Meranges;99;59;40;2016
17;Girona;105;Mieres;317;161;156;2016
17;Girona;106;Mollet de Peralada;180;98;82;2016
17;Girona;107;Molló;335;163;172;2016
17;Girona;109;Montagut i Oix;929;485;444;2016
17;Girona;110;Mont-ras;1690;853;837;2016
17;Girona;111;Navata;1329;652;677;2016
17;Girona;112;Ogassa;225;132;93;2016
17;Girona;114;Olot;34000;16892;17108;2016
17;Girona;115;Ordis;377;200;177;2016
17;Girona;116;Osor;434;221;213;2016
17;Girona;117;Palafrugell;22868;11342;11526;2016
17;Girona;118;Palamós;17677;8633;9044;2016
17;Girona;119;Palau de Santa Eulàlia;90;54;36;2016
17;Girona;121;Palau-sator;297;156;141;2016
17;Girona;120;Palau-saverdera;1471;732;739;2016
17;Girona;123;Palol de Revardit;470;236;234;2016
17;Girona;124;Pals;2423;1227;1196;2016
17;Girona;125;Pardines;158;85;73;2016
17;Girona;126;Parlavà;392;208;184;2016
17;Girona;128;Pau;551;280;271;2016
17;Girona;129;Pedret i Marzà;180;98;82;2016
17;Girona;130;Pera, La;441;208;233;2016
17;Girona;132;Peralada;1835;916;919;2016
17;Girona;133;Planes d'Hostoles, Les;1662;834;828;2016
17;Girona;134;Planoles;299;163;136;2016
17;Girona;135;Pont de Molins;517;255;262;2016
17;Girona;136;Pontós;234;131;103;2016
17;Girona;137;Porqueres;4530;2238;2292;2016
17;Girona;140;Port de la Selva, El;994;522;472;2016
17;Girona;138;Portbou;1170;576;594;2016
17;Girona;139;Preses, Les;1781;889;892;2016
17;Girona;141;Puigcerdà;8810;4407;4403;2016
17;Girona;142;Quart;3478;1744;1734;2016
17;Girona;043;Queralbs;174;99;75;2016
17;Girona;143;Rabós;188;92;96;2016
17;Girona;144;Regencós;279;143;136;2016
17;Girona;145;Ribes de Freser;1785;882;903;2016
17;Girona;146;Riells i Viabrea;3927;2023;1904;2016
17;Girona;147;Ripoll;10583;5194;5389;2016
17;Girona;148;Riudarenes;2120;1090;1030;2016
17;Girona;149;Riudaura;466;222;244;2016
17;Girona;150;Riudellots de la Selva;2024;1023;1001;2016
17;Girona;151;Riumors;255;128;127;2016
17;Girona;152;Roses;19438;9722;9716;2016
17;Girona;153;Rupià;253;129;124;2016
17;Girona;154;Sales de Llierca;137;71;66;2016
17;Girona;155;Salt;29404;15438;13966;2016
17;Girona;157;Sant Andreu Salou;155;82;73;2016
17;Girona;183;Sant Aniol de Finestres;371;197;174;2016
17;Girona;158;Sant Climent Sescebes;641;375;266;2016
17;Girona;159;Sant Feliu de Buixalleu;799;417;382;2016
17;Girona;160;Sant Feliu de Guíxols;21760;10763;10997;2016
17;Girona;161;Sant Feliu de Pallerols;1317;645;672;2016
17;Girona;162;Sant Ferriol;231;131;100;2016
17;Girona;163;Sant Gregori;3553;1787;1766;2016
17;Girona;164;Sant Hilari Sacalm;5570;2811;2759;2016
17;Girona;165;Sant Jaume de Llierca;873;424;449;2016
17;Girona;167;Sant Joan de les Abadesses;3342;1660;1682;2016
17;Girona;168;Sant Joan de Mollet;495;237;258;2016
17;Girona;185;Sant Joan les Fonts;2906;1454;1452;2016
17;Girona;166;Sant Jordi Desvalls;700;347;353;2016
17;Girona;169;Sant Julià de Ramis;3455;1747;1708;2016
17;Girona;903;Sant Julià del Llor i Bonmatí;1282;663;619;2016
17;Girona;171;Sant Llorenç de la Muga;247;126;121;2016
17;Girona;172;Sant Martí de Llémena;618;324;294;2016
17;Girona;173;Sant Martí Vell;250;128;122;2016
17;Girona;174;Sant Miquel de Campmajor;226;119;107;2016
17;Girona;175;Sant Miquel de Fluvià;742;387;355;2016
17;Girona;176;Sant Mori;176;98;78;2016
17;Girona;177;Sant Pau de Segúries;670;327;343;2016
17;Girona;178;Sant Pere Pescador;2134;1153;981;2016
17;Girona;180;Santa Coloma de Farners;12583;6361;6222;2016
17;Girona;181;Santa Cristina d'Aro;5128;2571;2557;2016
17;Girona;182;Santa Llogaia d'Àlguema;343;179;164;2016
17;Girona;184;Santa Pau;1524;769;755;2016
17;Girona;186;Sarrià de Ter;5035;2498;2537;2016
17;Girona;187;Saus, Camallera i Llampaies;842;419;423;2016
17;Girona;188;Selva de Mar, La;188;106;82;2016
17;Girona;190;Serinyà;1132;580;552;2016
17;Girona;191;Serra de Daró;209;116;93;2016
17;Girona;192;Setcases;181;98;83;2016
17;Girona;193;Sils;5910;3000;2910;2016
17;Girona;052;Siurana;155;72;83;2016
17;Girona;194;Susqueda;95;57;38;2016
17;Girona;195;Tallada d'Empordà, La;451;233;218;2016
17;Girona;196;Terrades;285;140;145;2016
17;Girona;197;Torrent;163;91;72;2016
17;Girona;198;Torroella de Fluvià;711;379;332;2016
17;Girona;199;Torroella de Montgrí;11506;5823;5683;2016
17;Girona;200;Tortellà;781;383;398;2016
17;Girona;201;Toses;166;100;66;2016
17;Girona;202;Tossa de Mar;5498;2788;2710;2016
17;Girona;204;Ullà;1077;597;480;2016
17;Girona;205;Ullastret;288;144;144;2016
17;Girona;203;Ultramort;210;118;92;2016
17;Girona;206;Urús;181;84;97;2016
17;Girona;014;Vajol, La;83;48;35;2016
17;Girona;208;Vall de Bianya, La;1266;635;631;2016
17;Girona;207;Vall d'en Bas, La;2983;1505;1478;2016
17;Girona;170;Vallfogona de Ripollès;200;111;89;2016
17;Girona;209;Vall-llobrega;922;457;465;2016
17;Girona;210;Ventalló;802;403;399;2016
17;Girona;211;Verges;1150;559;591;2016
17;Girona;212;Vidrà;176;91;85;2016
17;Girona;213;Vidreres;7632;3949;3683;2016
17;Girona;214;Vilabertran;919;467;452;2016
17;Girona;215;Vilablareix;2636;1302;1334;2016
17;Girona;217;Viladamat;466;238;228;2016
17;Girona;216;Viladasens;224;114;110;2016
17;Girona;218;Vilademuls;808;426;382;2016
17;Girona;220;Viladrau;1030;518;512;2016
17;Girona;221;Vilafant;5466;2689;2777;2016
17;Girona;223;Vilajuïga;1155;570;585;2016
17;Girona;224;Vilallonga de Ter;400;204;196;2016
17;Girona;225;Vilamacolum;320;163;157;2016
17;Girona;226;Vilamalla;1121;567;554;2016
17;Girona;227;Vilamaniscle;202;109;93;2016
17;Girona;228;Vilanant;405;206;199;2016
17;Girona;230;Vila-sacra;713;341;372;2016
17;Girona;222;Vilaür;156;79;77;2016
17;Girona;233;Vilobí d'Onyar;3163;1635;1528;2016
17;Girona;232;Vilopriu;201;108;93;2016
18;Granada;001;Agrón;297;149;148;2016
18;Granada;002;Alamedilla;611;314;297;2016
18;Granada;003;Albolote;18497;9219;9278;2016
18;Granada;004;Albondón;762;419;343;2016
18;Granada;005;Albuñán;421;221;200;2016
18;Granada;006;Albuñol;6971;3698;3273;2016
18;Granada;007;Albuñuelas;876;442;434;2016
18;Granada;010;Aldeire;639;343;296;2016
18;Granada;011;Alfacar;5429;2779;2650;2016
18;Granada;012;Algarinejo;2734;1405;1329;2016
18;Granada;013;Alhama de Granada;6044;3238;2806;2016
18;Granada;014;Alhendín;8740;4417;4323;2016
18;Granada;015;Alicún de Ortega;511;261;250;2016
18;Granada;016;Almegíjar;377;208;169;2016
18;Granada;017;Almuñécar;27397;13589;13808;2016
18;Granada;904;Alpujarra de la Sierra;1038;566;472;2016
18;Granada;018;Alquife;703;351;352;2016
18;Granada;020;Arenas del Rey;1231;627;604;2016
18;Granada;021;Armilla;23901;12016;11885;2016
18;Granada;022;Atarfe;18092;9011;9081;2016
18;Granada;023;Baza;20656;10284;10372;2016
18;Granada;024;Beas de Granada;1004;542;462;2016
18;Granada;025;Beas de Guadix;354;177;177;2016
18;Granada;027;Benalúa;3277;1631;1646;2016
18;Granada;028;Benalúa de las Villas;1107;581;526;2016
18;Granada;029;Benamaurel;2359;1203;1156;2016
18;Granada;030;Bérchules;727;387;340;2016
18;Granada;032;Bubión;294;148;146;2016
18;Granada;033;Busquístar;276;146;130;2016
18;Granada;034;Cacín;594;299;295;2016
18;Granada;035;Cádiar;1528;803;725;2016
18;Granada;036;Cájar;5025;2420;2605;2016
18;Granada;114;Calahorra, La;700;350;350;2016
18;Granada;037;Calicasas;619;308;311;2016
18;Granada;038;Campotéjar;1286;665;621;2016
18;Granada;039;Caniles;4279;2185;2094;2016
18;Granada;040;Cáñar;379;205;174;2016
18;Granada;042;Capileira;520;258;262;2016
18;Granada;043;Carataunas;178;97;81;2016
18;Granada;044;Cástaras;244;148;96;2016
18;Granada;045;Castilléjar;1389;731;658;2016
18;Granada;046;Castril;2236;1140;1096;2016
18;Granada;047;Cenes de la Vega;7866;3968;3898;2016
18;Granada;059;Chauchina;5421;2694;2727;2016
18;Granada;061;Chimeneas;1355;714;641;2016
18;Granada;062;Churriana de la Vega;14215;7048;7167;2016
18;Granada;048;Cijuela;3201;1620;1581;2016
18;Granada;049;Cogollos de Guadix;674;372;302;2016
18;Granada;050;Cogollos de la Vega;2096;1042;1054;2016
18;Granada;051;Colomera;1395;730;665;2016
18;Granada;053;Cortes de Baza;1993;1001;992;2016
18;Granada;054;Cortes y Graena;1020;524;496;2016
18;Granada;912;Cuevas del Campo;1873;942;931;2016
18;Granada;056;Cúllar;4296;2157;2139;2016
18;Granada;057;Cúllar Vega;7198;3637;3561;2016
18;Granada;063;Darro;1557;786;771;2016
18;Granada;064;Dehesas de Guadix;426;218;208;2016
18;Granada;065;Dehesas Viejas;727;374;353;2016
18;Granada;066;Deifontes;2622;1317;1305;2016
18;Granada;067;Diezma;785;403;382;2016
18;Granada;068;Dílar;1910;960;950;2016
18;Granada;069;Dólar;631;335;296;2016
18;Granada;915;Domingo Pérez de Granada;907;475;432;2016
18;Granada;070;Dúdar;347;187;160;2016
18;Granada;071;Dúrcal;7050;3483;3567;2016
18;Granada;072;Escúzar;787;403;384;2016
18;Granada;074;Ferreira;303;155;148;2016
18;Granada;076;Fonelas;1016;534;482;2016
18;Granada;078;Freila;894;459;435;2016
18;Granada;079;Fuente Vaqueros;4395;2209;2186;2016
18;Granada;905;Gabias, Las;20012;10235;9777;2016
18;Granada;082;Galera;1133;565;568;2016
18;Granada;083;Gobernador;262;120;142;2016
18;Granada;084;Gójar;5539;2823;2716;2016
18;Granada;085;Gor;767;391;376;2016
18;Granada;086;Gorafe;405;209;196;2016
18;Granada;087;Granada;234758;108889;125869;2016
18;Granada;088;Guadahortuna;1957;1001;956;2016
18;Granada;089;Guadix;18796;9282;9514;2016
18;Granada;906;Guájares, Los;1052;563;489;2016
18;Granada;093;Gualchos;4943;2511;2432;2016
18;Granada;094;Güéjar Sierra;2909;1545;1364;2016
18;Granada;095;Güevéjar;2540;1344;1196;2016
18;Granada;096;Huélago;406;209;197;2016
18;Granada;097;Huéneja;1156;607;549;2016
18;Granada;098;Huéscar;7609;3759;3850;2016
18;Granada;099;Huétor de Santillán;1901;968;933;2016
18;Granada;100;Huétor Tájar;10162;5119;5043;2016
18;Granada;101;Huétor Vega;11777;5917;5860;2016
18;Granada;102;Illora;10286;5144;5142;2016
18;Granada;103;Ítrabo;1010;512;498;2016
18;Granada;105;Iznalloz;5045;2574;2471;2016
18;Granada;106;Játar;646;359;287;2016
18;Granada;107;Jayena;1119;569;550;2016
18;Granada;108;Jerez del Marquesado;1009;530;479;2016
18;Granada;109;Jete;904;463;441;2016
18;Granada;111;Jun;3692;1862;1830;2016
18;Granada;112;Juviles;148;72;76;2016
18;Granada;115;Láchar;3303;1701;1602;2016
18;Granada;116;Lanjarón;3587;1788;1799;2016
18;Granada;117;Lanteira;552;284;268;2016
18;Granada;119;Lecrín;2098;1062;1036;2016
18;Granada;120;Lentegí;338;180;158;2016
18;Granada;121;Lobras;159;83;76;2016
18;Granada;122;Loja;20641;10308;10333;2016
18;Granada;123;Lugros;327;178;149;2016
18;Granada;124;Lújar;487;264;223;2016
18;Granada;126;Malahá, La;1821;907;914;2016
18;Granada;127;Maracena;22059;10877;11182;2016
18;Granada;128;Marchal;424;200;224;2016
18;Granada;132;Moclín;3884;1930;1954;2016
18;Granada;133;Molvízar;2881;1470;1411;2016
18;Granada;134;Monachil;7681;3952;3729;2016
18;Granada;135;Montefrío;5601;2814;2787;2016
18;Granada;136;Montejícar;2204;1127;1077;2016
18;Granada;137;Montillana;1272;669;603;2016
18;Granada;138;Moraleda de Zafayona;3187;1619;1568;2016
18;Granada;909;Morelábor;660;359;301;2016
18;Granada;140;Motril;60368;29699;30669;2016
18;Granada;141;Murtas;495;282;213;2016
18;Granada;903;Nevada;1106;564;542;2016
18;Granada;143;Nigüelas;1218;620;598;2016
18;Granada;144;Nívar;930;474;456;2016
18;Granada;145;Ogíjares;13718;6773;6945;2016
18;Granada;146;Orce;1220;630;590;2016
18;Granada;147;Órgiva;5543;2787;2756;2016
18;Granada;148;Otívar;1082;540;542;2016
18;Granada;150;Padul;8442;4267;4175;2016
18;Granada;151;Pampaneira;318;160;158;2016
18;Granada;152;Pedro Martínez;1150;562;588;2016
18;Granada;153;Peligros;11242;5578;5664;2016
18;Granada;154;Peza, La;1241;640;601;2016
18;Granada;910;Pinar, El;962;505;457;2016
18;Granada;157;Pinos Genil;1430;746;684;2016
18;Granada;158;Pinos Puente;10519;5287;5232;2016
18;Granada;159;Píñar;1154;630;524;2016
18;Granada;161;Polícar;234;124;110;2016
18;Granada;162;Polopos;1680;888;792;2016
18;Granada;163;Pórtugos;401;208;193;2016
18;Granada;164;Puebla de Don Fadrique;2306;1188;1118;2016
18;Granada;165;Pulianas;5339;2656;2683;2016
18;Granada;167;Purullena;2356;1187;1169;2016
18;Granada;168;Quéntar;954;489;465;2016
18;Granada;170;Rubite;377;216;161;2016
18;Granada;171;Salar;2698;1364;1334;2016
18;Granada;173;Salobreña;12399;6186;6213;2016
18;Granada;174;Santa Cruz del Comercio;544;283;261;2016
18;Granada;175;Santa Fe;15079;7450;7629;2016
18;Granada;176;Soportújar;277;153;124;2016
18;Granada;177;Sorvilán;555;288;267;2016
18;Granada;901;Taha, La;655;338;317;2016
18;Granada;178;Torre-Cardela;813;419;394;2016
18;Granada;179;Torvizcón;682;359;323;2016
18;Granada;180;Trevélez;776;403;373;2016
18;Granada;181;Turón;254;151;103;2016
18;Granada;182;Ugíjar;2512;1237;1275;2016
18;Granada;914;Valderrubio;2094;1034;1060;2016
18;Granada;907;Valle del Zalabí;2163;1107;1056;2016
18;Granada;902;Valle, El;964;479;485;2016
18;Granada;183;Válor;671;344;327;2016
18;Granada;911;Vegas del Genil;10518;5358;5160;2016
18;Granada;184;Vélez de Benaudalla;2875;1445;1430;2016
18;Granada;185;Ventas de Huelma;640;345;295;2016
18;Granada;149;Villa de Otura;6835;3468;3367;2016
18;Granada;908;Villamena;989;493;496;2016
18;Granada;187;Villanueva de las Torres;650;343;307;2016
18;Granada;188;Villanueva Mesía;2030;1004;1026;2016
18;Granada;189;Víznar;995;513;482;2016
18;Granada;192;Zafarraya;2063;1104;959;2016
18;Granada;913;Zagra;882;449;433;2016
18;Granada;193;Zubia, La;18945;9317;9628;2016
18;Granada;194;Zújar;2678;1372;1306;2016
19;Guadalajara;001;Abánades;59;34;25;2016
19;Guadalajara;002;Ablanque;73;43;30;2016
19;Guadalajara;003;Adobes;42;23;19;2016
19;Guadalajara;004;Alaminos;67;30;37;2016
19;Guadalajara;005;Alarilla;115;71;44;2016
19;Guadalajara;006;Albalate de Zorita;957;536;421;2016
19;Guadalajara;007;Albares;559;292;267;2016
19;Guadalajara;008;Albendiego;44;28;16;2016
19;Guadalajara;009;Alcocer;337;177;160;2016
19;Guadalajara;010;Alcolea de las Peñas;11;8;3;2016
19;Guadalajara;011;Alcolea del Pinar;336;183;153;2016
19;Guadalajara;013;Alcoroches;138;81;57;2016
19;Guadalajara;015;Aldeanueva de Guadalajara;84;49;35;2016
19;Guadalajara;016;Algar de Mesa;62;43;19;2016
19;Guadalajara;017;Algora;78;48;30;2016
19;Guadalajara;018;Alhóndiga;172;97;75;2016
19;Guadalajara;019;Alique;20;8;12;2016
19;Guadalajara;020;Almadrones;63;39;24;2016
19;Guadalajara;021;Almoguera;1353;711;642;2016
19;Guadalajara;022;Almonacid de Zorita;751;350;401;2016
19;Guadalajara;023;Alocén;176;91;85;2016
19;Guadalajara;024;Alovera;12407;6311;6096;2016
19;Guadalajara;027;Alustante;157;91;66;2016
19;Guadalajara;031;Angón;15;12;3;2016
19;Guadalajara;032;Anguita;186;101;85;2016
19;Guadalajara;033;Anquela del Ducado;64;35;29;2016
19;Guadalajara;034;Anquela del Pedregal;22;17;5;2016
19;Guadalajara;036;Aranzueque;415;214;201;2016
19;Guadalajara;037;Arbancón;160;90;70;2016
19;Guadalajara;038;Arbeteta;27;19;8;2016
19;Guadalajara;039;Argecilla;66;44;22;2016
19;Guadalajara;040;Armallones;51;32;19;2016
19;Guadalajara;041;Armuña de Tajuña;251;131;120;2016
19;Guadalajara;042;Arroyo de las Fraguas;26;16;10;2016
19;Guadalajara;043;Atanzón;83;51;32;2016
19;Guadalajara;044;Atienza;444;249;195;2016
19;Guadalajara;045;Auñón;157;87;70;2016
19;Guadalajara;046;Azuqueca de Henares;34703;17633;17070;2016
19;Guadalajara;047;Baides;63;31;32;2016
19;Guadalajara;048;Baños de Tajo;19;14;5;2016
19;Guadalajara;049;Bañuelos;16;13;3;2016
19;Guadalajara;050;Barriopedro;18;11;7;2016
19;Guadalajara;051;Berninches;58;35;23;2016
19;Guadalajara;052;Bodera, La;26;16;10;2016
19;Guadalajara;053;Brihuega;2476;1300;1176;2016
19;Guadalajara;054;Budia;223;125;98;2016
19;Guadalajara;055;Bujalaro;64;35;29;2016
19;Guadalajara;057;Bustares;85;51;34;2016
19;Guadalajara;058;Cabanillas del Campo;9794;4956;4838;2016
19;Guadalajara;059;Campillo de Dueñas;80;46;34;2016
19;Guadalajara;060;Campillo de Ranas;163;104;59;2016
19;Guadalajara;061;Campisábalos;68;48;20;2016
19;Guadalajara;064;Canredondo;76;42;34;2016
19;Guadalajara;065;Cantalojas;167;105;62;2016
19;Guadalajara;066;Cañizar;63;35;28;2016
19;Guadalajara;067;Cardoso de la Sierra, El;63;41;22;2016
19;Guadalajara;070;Casa de Uceda;96;52;44;2016
19;Guadalajara;071;Casar, El;11601;5935;5666;2016
19;Guadalajara;073;Casas de San Galindo;23;16;7;2016
19;Guadalajara;074;Caspueñas;96;55;41;2016
19;Guadalajara;075;Castejón de Henares;67;40;27;2016
19;Guadalajara;076;Castellar de la Muela;37;17;20;2016
19;Guadalajara;078;Castilforte;59;38;21;2016
19;Guadalajara;079;Castilnuevo;8;5;3;2016
19;Guadalajara;080;Cendejas de Enmedio;75;38;37;2016
19;Guadalajara;081;Cendejas de la Torre;27;16;11;2016
19;Guadalajara;082;Centenera;101;56;45;2016
19;Guadalajara;103;Checa;287;171;116;2016
19;Guadalajara;104;Chequilla;16;9;7;2016
19;Guadalajara;106;Chillarón del Rey;110;64;46;2016
19;Guadalajara;105;Chiloeches;3305;1707;1598;2016
19;Guadalajara;086;Cifuentes;1830;945;885;2016
19;Guadalajara;087;Cincovillas;22;11;11;2016
19;Guadalajara;088;Ciruelas;97;58;39;2016
19;Guadalajara;089;Ciruelos del Pinar;31;18;13;2016
19;Guadalajara;090;Cobeta;118;59;59;2016
19;Guadalajara;091;Cogollor;27;16;11;2016
19;Guadalajara;092;Cogolludo;595;340;255;2016
19;Guadalajara;095;Condemios de Abajo;16;11;5;2016
19;Guadalajara;096;Condemios de Arriba;126;68;58;2016
19;Guadalajara;097;Congostrina;19;14;5;2016
19;Guadalajara;098;Copernal;30;21;9;2016
19;Guadalajara;099;Corduente;364;203;161;2016
19;Guadalajara;102;Cubillo de Uceda, El;135;66;69;2016
19;Guadalajara;107;Driebes;352;187;165;2016
19;Guadalajara;108;Durón;120;61;59;2016
19;Guadalajara;109;Embid;40;22;18;2016
19;Guadalajara;110;Escamilla;67;33;34;2016
19;Guadalajara;111;Escariche;176;107;69;2016
19;Guadalajara;112;Escopete;69;31;38;2016
19;Guadalajara;113;Espinosa de Henares;685;352;333;2016
19;Guadalajara;114;Esplegares;43;28;15;2016
19;Guadalajara;115;Establés;27;19;8;2016
19;Guadalajara;116;Estriégana;17;12;5;2016
19;Guadalajara;117;Fontanar;2328;1226;1102;2016
19;Guadalajara;118;Fuembellida;10;6;4;2016
19;Guadalajara;119;Fuencemillán;100;60;40;2016
19;Guadalajara;120;Fuentelahiguera de Albatages;123;68;55;2016
19;Guadalajara;121;Fuentelencina;303;171;132;2016
19;Guadalajara;122;Fuentelsaz;104;56;48;2016
19;Guadalajara;123;Fuentelviejo;57;29;28;2016
19;Guadalajara;124;Fuentenovilla;533;295;238;2016
19;Guadalajara;125;Gajanejos;45;29;16;2016
19;Guadalajara;126;Galápagos;2395;1269;1126;2016
19;Guadalajara;127;Galve de Sorbe;103;55;48;2016
19;Guadalajara;129;Gascueña de Bornova;35;22;13;2016
19;Guadalajara;130;Guadalajara;83633;40258;43375;2016
19;Guadalajara;132;Henche;97;53;44;2016
19;Guadalajara;133;Heras de Ayuso;231;134;97;2016
19;Guadalajara;134;Herrería;24;15;9;2016
19;Guadalajara;135;Hiendelaencina;121;70;51;2016
19;Guadalajara;136;Hijes;22;13;9;2016
19;Guadalajara;138;Hita;339;187;152;2016
19;Guadalajara;139;Hombrados;36;19;17;2016
19;Guadalajara;142;Hontoba;321;188;133;2016
19;Guadalajara;143;Horche;2540;1299;1241;2016
19;Guadalajara;145;Hortezuela de Océn;50;31;19;2016
19;Guadalajara;146;Huerce, La;43;26;17;2016
19;Guadalajara;147;Huérmeces del Cerro;39;25;14;2016
19;Guadalajara;148;Huertahernando;60;37;23;2016
19;Guadalajara;150;Hueva;149;89;60;2016
19;Guadalajara;151;Humanes;1466;731;735;2016
19;Guadalajara;152;Illana;702;399;303;2016
19;Guadalajara;153;Iniéstola;24;15;9;2016
19;Guadalajara;154;Inviernas, Las;68;46;22;2016
19;Guadalajara;155;Irueste;72;47;25;2016
19;Guadalajara;156;Jadraque;1497;759;738;2016
19;Guadalajara;157;Jirueque;62;39;23;2016
19;Guadalajara;159;Ledanca;110;56;54;2016
19;Guadalajara;160;Loranca de Tajuña;1254;692;562;2016
19;Guadalajara;161;Lupiana;257;127;130;2016
19;Guadalajara;162;Luzaga;69;39;30;2016
19;Guadalajara;163;Luzón;66;34;32;2016
19;Guadalajara;165;Majaelrayo;60;33;27;2016
19;Guadalajara;166;Málaga del Fresno;178;100;78;2016
19;Guadalajara;167;Malaguilla;148;82;66;2016
19;Guadalajara;168;Mandayona;326;168;158;2016
19;Guadalajara;169;Mantiel;42;25;17;2016
19;Guadalajara;170;Maranchón;246;133;113;2016
19;Guadalajara;171;Marchamalo;6969;3513;3456;2016
19;Guadalajara;172;Masegoso de Tajuña;60;34;26;2016
19;Guadalajara;173;Matarrubia;49;33;16;2016
19;Guadalajara;174;Matillas;134;66;68;2016
19;Guadalajara;175;Mazarete;38;18;20;2016
19;Guadalajara;176;Mazuecos;289;149;140;2016
19;Guadalajara;177;Medranda;83;43;40;2016
19;Guadalajara;178;Megina;39;26;13;2016
19;Guadalajara;179;Membrillera;92;49;43;2016
19;Guadalajara;181;Miedes de Atienza;64;36;28;2016
19;Guadalajara;182;Mierla, La;39;27;12;2016
19;Guadalajara;184;Millana;120;69;51;2016
19;Guadalajara;183;Milmarcos;85;50;35;2016
19;Guadalajara;185;Miñosa, La;33;22;11;2016
19;Guadalajara;186;Mirabueno;85;50;35;2016
19;Guadalajara;187;Miralrío;64;38;26;2016
19;Guadalajara;188;Mochales;50;28;22;2016
19;Guadalajara;189;Mohernando;175;97;78;2016
19;Guadalajara;190;Molina de Aragón;3403;1702;1701;2016
19;Guadalajara;191;Monasterio;13;4;9;2016
19;Guadalajara;192;Mondéjar;2599;1336;1263;2016
19;Guadalajara;193;Montarrón;26;14;12;2016
19;Guadalajara;194;Moratilla de los Meleros;111;60;51;2016
19;Guadalajara;195;Morenilla;44;27;17;2016
19;Guadalajara;196;Muduex;112;59;53;2016
19;Guadalajara;197;Navas de Jadraque, Las;28;19;9;2016
19;Guadalajara;198;Negredo;15;8;7;2016
19;Guadalajara;199;Ocentejo;19;14;5;2016
19;Guadalajara;200;Olivar, El;77;46;31;2016
19;Guadalajara;201;Olmeda de Cobeta;71;41;30;2016
19;Guadalajara;202;Olmeda de Jadraque, La;12;7;5;2016
19;Guadalajara;203;Ordial, El;29;17;12;2016
19;Guadalajara;204;Orea;189;113;76;2016
19;Guadalajara;208;Pálmaces de Jadraque;45;26;19;2016
19;Guadalajara;209;Pardos;45;26;19;2016
19;Guadalajara;210;Paredes de Sigüenza;21;12;9;2016
19;Guadalajara;211;Pareja;422;247;175;2016
19;Guadalajara;212;Pastrana;915;465;450;2016
19;Guadalajara;213;Pedregal, El;78;48;30;2016
19;Guadalajara;214;Peñalén;75;42;33;2016
19;Guadalajara;215;Peñalver;178;115;63;2016
19;Guadalajara;216;Peralejos de las Truchas;155;85;70;2016
19;Guadalajara;217;Peralveche;60;41;19;2016
19;Guadalajara;218;Pinilla de Jadraque;53;29;24;2016
19;Guadalajara;219;Pinilla de Molina;16;11;5;2016
19;Guadalajara;220;Pioz;3471;1840;1631;2016
19;Guadalajara;221;Piqueras;65;43;22;2016
19;Guadalajara;222;Pobo de Dueñas, El;126;66;60;2016
19;Guadalajara;223;Poveda de la Sierra;130;68;62;2016
19;Guadalajara;224;Pozo de Almoguera;97;52;45;2016
19;Guadalajara;225;Pozo de Guadalajara;1249;661;588;2016
19;Guadalajara;226;Prádena de Atienza;51;36;15;2016
19;Guadalajara;227;Prados Redondos;70;43;27;2016
19;Guadalajara;228;Puebla de Beleña;47;26;21;2016
19;Guadalajara;229;Puebla de Valles;67;38;29;2016
19;Guadalajara;230;Quer;748;402;346;2016
19;Guadalajara;231;Rebollosa de Jadraque;12;9;3;2016
19;Guadalajara;232;Recuenco, El;73;45;28;2016
19;Guadalajara;233;Renera;97;54;43;2016
19;Guadalajara;234;Retiendas;47;29;18;2016
19;Guadalajara;235;Riba de Saelices;103;57;46;2016
19;Guadalajara;237;Rillo de Gallo;52;29;23;2016
19;Guadalajara;238;Riofrío del Llano;46;27;19;2016
19;Guadalajara;239;Robledillo de Mohernando;115;60;55;2016
19;Guadalajara;240;Robledo de Corpes;51;28;23;2016
19;Guadalajara;241;Romanillos de Atienza;49;30;19;2016
19;Guadalajara;242;Romanones;120;63;57;2016
19;Guadalajara;243;Rueda de la Sierra;50;31;19;2016
19;Guadalajara;244;Sacecorbo;100;56;44;2016
19;Guadalajara;245;Sacedón;1572;835;737;2016
19;Guadalajara;246;Saelices de la Sal;55;30;25;2016
19;Guadalajara;247;Salmerón;171;93;78;2016
19;Guadalajara;248;San Andrés del Congosto;82;49;33;2016
19;Guadalajara;249;San Andrés del Rey;32;16;16;2016
19;Guadalajara;250;Santiuste;20;12;8;2016
19;Guadalajara;251;Saúca;59;30;29;2016
19;Guadalajara;252;Sayatón;86;48;38;2016
19;Guadalajara;254;Selas;61;29;32;2016
19;Guadalajara;901;Semillas;40;24;16;2016
19;Guadalajara;255;Setiles;83;50;33;2016
19;Guadalajara;256;Sienes;54;32;22;2016
19;Guadalajara;257;Sigüenza;4551;2266;2285;2016
19;Guadalajara;258;Solanillos del Extremo;96;55;41;2016
19;Guadalajara;259;Somolinos;33;16;17;2016
19;Guadalajara;260;Sotillo, El;47;26;21;2016
19;Guadalajara;261;Sotodosos;38;19;19;2016
19;Guadalajara;262;Tamajón;131;69;62;2016
19;Guadalajara;263;Taragudo;51;24;27;2016
19;Guadalajara;264;Taravilla;34;22;12;2016
19;Guadalajara;265;Tartanedo;140;80;60;2016
19;Guadalajara;266;Tendilla;331;182;149;2016
19;Guadalajara;267;Terzaga;19;11;8;2016
19;Guadalajara;268;Tierzo;38;25;13;2016
19;Guadalajara;269;Toba, La;108;59;49;2016
19;Guadalajara;271;Tordellego;54;29;25;2016
19;Guadalajara;270;Tordelrábano;20;12;8;2016
19;Guadalajara;272;Tordesilos;102;56;46;2016
19;Guadalajara;274;Torija;1373;711;662;2016
19;Guadalajara;279;Torre del Burgo;281;150;131;2016
19;Guadalajara;277;Torrecuadrada de Molina;21;13;8;2016
19;Guadalajara;278;Torrecuadradilla;29;18;11;2016
19;Guadalajara;280;Torrejón del Rey;5160;2662;2498;2016
19;Guadalajara;281;Torremocha de Jadraque;25;17;8;2016
19;Guadalajara;282;Torremocha del Campo;200;113;87;2016
19;Guadalajara;283;Torremocha del Pinar;37;16;21;2016
19;Guadalajara;284;Torremochuela;10;7;3;2016
19;Guadalajara;285;Torrubia;23;13;10;2016
19;Guadalajara;286;Tórtola de Henares;986;537;449;2016
19;Guadalajara;287;Tortuera;213;112;101;2016
19;Guadalajara;288;Tortuero;18;11;7;2016
19;Guadalajara;289;Traíd;27;18;9;2016
19;Guadalajara;290;Trijueque;1211;631;580;2016
19;Guadalajara;291;Trillo;1392;733;659;2016
19;Guadalajara;293;Uceda;2597;1345;1252;2016
19;Guadalajara;294;Ujados;33;19;14;2016
19;Guadalajara;296;Utande;34;23;11;2016
19;Guadalajara;297;Valdarachas;34;18;16;2016
19;Guadalajara;298;Valdearenas;87;56;31;2016
19;Guadalajara;299;Valdeavellano;106;55;51;2016
19;Guadalajara;300;Valdeaveruelo;1066;551;515;2016
19;Guadalajara;301;Valdeconcha;40;22;18;2016
19;Guadalajara;302;Valdegrudas;65;40;25;2016
19;Guadalajara;303;Valdelcubo;55;33;22;2016
19;Guadalajara;304;Valdenuño Fernández;272;155;117;2016
19;Guadalajara;305;Valdepeñas de la Sierra;182;106;76;2016
19;Guadalajara;306;Valderrebollo;28;15;13;2016
19;Guadalajara;307;Valdesotos;26;16;10;2016
19;Guadalajara;308;Valfermoso de Tajuña;58;38;20;2016
19;Guadalajara;309;Valhermoso;30;16;14;2016
19;Guadalajara;310;Valtablado del Río;9;6;3;2016
19;Guadalajara;311;Valverde de los Arroyos;84;44;40;2016
19;Guadalajara;314;Viana de Jadraque;53;35;18;2016
19;Guadalajara;317;Villanueva de Alcorón;182;96;86;2016
19;Guadalajara;318;Villanueva de Argecilla;29;20;9;2016
19;Guadalajara;319;Villanueva de la Torre;6554;3318;3236;2016
19;Guadalajara;321;Villares de Jadraque;53;34;19;2016
19;Guadalajara;322;Villaseca de Henares;34;18;16;2016
19;Guadalajara;323;Villaseca de Uceda;44;24;20;2016
19;Guadalajara;324;Villel de Mesa;198;110;88;2016
19;Guadalajara;325;Viñuelas;143;78;65;2016
19;Guadalajara;326;Yebes;2881;1502;1379;2016
19;Guadalajara;327;Yebra;492;255;237;2016
19;Guadalajara;329;Yélamos de Abajo;64;35;29;2016
19;Guadalajara;330;Yélamos de Arriba;93;55;38;2016
19;Guadalajara;331;Yunquera de Henares;3835;1974;1861;2016
19;Guadalajara;332;Yunta, La;101;56;45;2016
19;Guadalajara;333;Zaorejas;131;88;43;2016
19;Guadalajara;334;Zarzuela de Jadraque;37;21;16;2016
19;Guadalajara;335;Zorita de los Canes;68;33;35;2016
21;Huelva;001;Alájar;814;415;399;2016
21;Huelva;002;Aljaraque;20745;10307;10438;2016
21;Huelva;003;Almendro, El;838;440;398;2016
21;Huelva;004;Almonaster la Real;1891;993;898;2016
21;Huelva;005;Almonte;23223;11610;11613;2016
21;Huelva;006;Alosno;3995;1955;2040;2016
21;Huelva;007;Aracena;7929;3907;4022;2016
21;Huelva;008;Aroche;3157;1586;1571;2016
21;Huelva;009;Arroyomolinos de León;983;512;471;2016
21;Huelva;010;Ayamonte;20629;10317;10312;2016
21;Huelva;011;Beas;4272;2165;2107;2016
21;Huelva;012;Berrocal;331;164;167;2016
21;Huelva;013;Bollullos Par del Condado;14177;7067;7110;2016
21;Huelva;014;Bonares;6021;3002;3019;2016
21;Huelva;015;Cabezas Rubias;731;379;352;2016
21;Huelva;016;Cala;1236;621;615;2016
21;Huelva;017;Calañas;4225;2151;2074;2016
21;Huelva;018;Campillo, El;2072;1018;1054;2016
21;Huelva;019;Campofrío;708;354;354;2016
21;Huelva;020;Cañaveral de León;410;203;207;2016
21;Huelva;021;Cartaya;19094;9812;9282;2016
21;Huelva;022;Castaño del Robledo;206;123;83;2016
21;Huelva;023;Cerro de Andévalo, El;2454;1228;1226;2016
21;Huelva;030;Chucena;2142;1086;1056;2016
21;Huelva;024;Corteconcepción;547;267;280;2016
21;Huelva;025;Cortegana;4853;2455;2398;2016
21;Huelva;026;Cortelazor;302;151;151;2016
21;Huelva;027;Cumbres de Enmedio;50;30;20;2016
21;Huelva;028;Cumbres de San Bartolomé;404;198;206;2016
21;Huelva;029;Cumbres Mayores;1827;910;917;2016
21;Huelva;031;Encinasola;1365;697;668;2016
21;Huelva;032;Escacena del Campo;2241;1103;1138;2016
21;Huelva;033;Fuenteheridos;648;333;315;2016
21;Huelva;034;Galaroza;1431;701;730;2016
21;Huelva;035;Gibraleón;12523;6208;6315;2016
21;Huelva;036;Granada de Río-Tinto, La;191;96;95;2016
21;Huelva;037;Granado, El;525;276;249;2016
21;Huelva;038;Higuera de la Sierra;1317;677;640;2016
21;Huelva;039;Hinojales;317;158;159;2016
21;Huelva;040;Hinojos;3893;1961;1932;2016
21;Huelva;041;Huelva;145468;69868;75600;2016
21;Huelva;042;Isla Cristina;21165;10540;10625;2016
21;Huelva;043;Jabugo;2260;1137;1123;2016
21;Huelva;044;Lepe;27409;13984;13425;2016
21;Huelva;045;Linares de la Sierra;266;132;134;2016
21;Huelva;046;Lucena del Puerto;3146;1635;1511;2016
21;Huelva;047;Manzanilla;2094;1058;1036;2016
21;Huelva;048;Marines, Los;384;206;178;2016
21;Huelva;049;Minas de Riotinto;3974;1928;2046;2016
21;Huelva;050;Moguer;21401;10704;10697;2016
21;Huelva;051;Nava, La;292;144;148;2016
21;Huelva;052;Nerva;5474;2657;2817;2016
21;Huelva;053;Niebla;4098;2081;2017;2016
21;Huelva;054;Palma del Condado, La;10624;5308;5316;2016
21;Huelva;055;Palos de la Frontera;10785;5390;5395;2016
21;Huelva;056;Paterna del Campo;3486;1762;1724;2016
21;Huelva;057;Paymogo;1221;613;608;2016
21;Huelva;058;Puebla de Guzmán;3138;1614;1524;2016
21;Huelva;059;Puerto Moral;286;141;145;2016
21;Huelva;060;Punta Umbría;15053;7663;7390;2016
21;Huelva;061;Rociana del Condado;7735;3901;3834;2016
21;Huelva;062;Rosal de la Frontera;1728;868;860;2016
21;Huelva;063;San Bartolomé de la Torre;3618;1816;1802;2016
21;Huelva;064;San Juan del Puerto;8949;4494;4455;2016
21;Huelva;066;San Silvestre de Guzmán;604;322;282;2016
21;Huelva;065;Sanlúcar de Guadiana;431;218;213;2016
21;Huelva;067;Santa Ana la Real;498;235;263;2016
21;Huelva;068;Santa Bárbara de Casa;1087;532;555;2016
21;Huelva;069;Santa Olalla del Cala;2042;1047;995;2016
21;Huelva;070;Trigueros;7628;3766;3862;2016
21;Huelva;071;Valdelarco;233;111;122;2016
21;Huelva;072;Valverde del Camino;12857;6318;6539;2016
21;Huelva;073;Villablanca;2801;1398;1403;2016
21;Huelva;074;Villalba del Alcor;3308;1632;1676;2016
21;Huelva;075;Villanueva de las Cruces;385;187;198;2016
21;Huelva;076;Villanueva de los Castillejos;2746;1377;1369;2016
21;Huelva;077;Villarrasa;2167;1105;1062;2016
21;Huelva;078;Zalamea la Real;3178;1604;1574;2016
21;Huelva;079;Zufre;860;439;421;2016
22;Huesca;001;Abiego;247;132;115;2016
22;Huesca;002;Abizanda;142;73;69;2016
22;Huesca;003;Adahuesca;166;81;85;2016
22;Huesca;004;Agüero;141;83;58;2016
22;Huesca;907;Aínsa-Sobrarbe;2173;1113;1060;2016
22;Huesca;006;Aisa;345;187;158;2016
22;Huesca;007;Albalate de Cinca;1147;608;539;2016
22;Huesca;008;Albalatillo;196;109;87;2016
22;Huesca;009;Albelda;735;381;354;2016
22;Huesca;011;Albero Alto;114;68;46;2016
22;Huesca;012;Albero Bajo;137;73;64;2016
22;Huesca;013;Alberuela de Tubo;315;163;152;2016
22;Huesca;014;Alcalá de Gurrea;266;139;127;2016
22;Huesca;015;Alcalá del Obispo;340;187;153;2016
22;Huesca;016;Alcampell;678;337;341;2016
22;Huesca;017;Alcolea de Cinca;1158;612;546;2016
22;Huesca;018;Alcubierre;385;207;178;2016
22;Huesca;019;Alerre;205;106;99;2016
22;Huesca;020;Alfántega;131;66;65;2016
22;Huesca;021;Almudévar;2472;1269;1203;2016
22;Huesca;022;Almunia de San Juan;672;349;323;2016
22;Huesca;023;Almuniente;501;245;256;2016
22;Huesca;024;Alquézar;299;165;134;2016
22;Huesca;025;Altorricón;1466;780;686;2016
22;Huesca;027;Angüés;390;206;184;2016
22;Huesca;028;Ansó;412;210;202;2016
22;Huesca;029;Antillón;155;80;75;2016
22;Huesca;032;Aragüés del Puerto;115;63;52;2016
22;Huesca;035;Arén;321;173;148;2016
22;Huesca;036;Argavieso;101;58;43;2016
22;Huesca;037;Arguis;122;69;53;2016
22;Huesca;039;Ayerbe;1100;544;556;2016
22;Huesca;040;Azanuy-Alins;168;85;83;2016
22;Huesca;041;Azara;187;95;92;2016
22;Huesca;042;Azlor;137;66;71;2016
22;Huesca;043;Baélls;105;61;44;2016
22;Huesca;044;Bailo;287;173;114;2016
22;Huesca;045;Baldellou;91;53;38;2016
22;Huesca;046;Ballobar;825;419;406;2016
22;Huesca;047;Banastás;297;160;137;2016
22;Huesca;048;Barbastro;16961;8253;8708;2016
22;Huesca;049;Barbués;83;47;36;2016
22;Huesca;050;Barbuñales;95;48;47;2016
22;Huesca;051;Bárcabo;113;65;48;2016
22;Huesca;052;Belver de Cinca;1294;732;562;2016
22;Huesca;053;Benabarre;1111;569;542;2016
22;Huesca;054;Benasque;2047;1096;951;2016
22;Huesca;246;Beranuy;88;50;38;2016
22;Huesca;055;Berbegal;363;191;172;2016
22;Huesca;057;Bielsa;483;248;235;2016
22;Huesca;058;Bierge;251;142;109;2016
22;Huesca;059;Biescas;1470;774;696;2016
22;Huesca;060;Binaced;1528;808;720;2016
22;Huesca;061;Binéfar;9394;4880;4514;2016
22;Huesca;062;Bisaurri;185;103;82;2016
22;Huesca;063;Biscarrués;195;106;89;2016
22;Huesca;064;Blecua y Torres;202;115;87;2016
22;Huesca;066;Boltaña;959;517;442;2016
22;Huesca;067;Bonansa;80;44;36;2016
22;Huesca;068;Borau;91;57;34;2016
22;Huesca;069;Broto;532;292;240;2016
22;Huesca;072;Caldearenas;216;121;95;2016
22;Huesca;074;Campo;365;193;172;2016
22;Huesca;075;Camporrélls;138;74;64;2016
22;Huesca;076;Canal de Berdún;361;196;165;2016
22;Huesca;077;Candasnos;318;165;153;2016
22;Huesca;078;Canfranc;543;301;242;2016
22;Huesca;079;Capdesaso;168;72;96;2016
22;Huesca;080;Capella;364;194;170;2016
22;Huesca;081;Casbas de Huesca;293;155;138;2016
22;Huesca;083;Castejón de Monegros;543;289;254;2016
22;Huesca;084;Castejón de Sos;740;380;360;2016
22;Huesca;082;Castejón del Puente;325;172;153;2016
22;Huesca;085;Castelflorite;114;61;53;2016
22;Huesca;086;Castiello de Jaca;255;140;115;2016
22;Huesca;087;Castigaleu;89;51;38;2016
22;Huesca;088;Castillazuelo;176;86;90;2016
22;Huesca;089;Castillonroy;334;175;159;2016
22;Huesca;094;Chalamera;108;56;52;2016
22;Huesca;095;Chía;85;52;33;2016
22;Huesca;096;Chimillas;371;189;182;2016
22;Huesca;090;Colungo;128;70;58;2016
22;Huesca;099;Esplús;612;304;308;2016
22;Huesca;102;Estada;205;114;91;2016
22;Huesca;103;Estadilla;808;394;414;2016
22;Huesca;105;Estopiñán del Castillo;142;77;65;2016
22;Huesca;106;Fago;22;13;9;2016
22;Huesca;107;Fanlo;107;67;40;2016
22;Huesca;109;Fiscal;338;179;159;2016
22;Huesca;110;Fonz;918;458;460;2016
22;Huesca;111;Foradada del Toscar;183;96;87;2016
22;Huesca;112;Fraga;14925;7604;7321;2016
22;Huesca;113;Fueva, La;611;321;290;2016
22;Huesca;114;Gistaín;137;77;60;2016
22;Huesca;115;Grado, El;423;225;198;2016
22;Huesca;116;Grañén;1804;942;862;2016
22;Huesca;117;Graus;3329;1666;1663;2016
22;Huesca;119;Gurrea de Gállego;1513;783;730;2016
22;Huesca;122;Hoz de Jaca;72;37;35;2016
22;Huesca;908;Hoz y Costean;217;121;96;2016
22;Huesca;124;Huerto;230;126;104;2016
22;Huesca;125;Huesca;52282;24984;27298;2016
22;Huesca;126;Ibieca;100;54;46;2016
22;Huesca;127;Igriés;711;374;337;2016
22;Huesca;128;Ilche;211;108;103;2016
22;Huesca;129;Isábena;266;144;122;2016
22;Huesca;130;Jaca;12929;6391;6538;2016
22;Huesca;131;Jasa;98;57;41;2016
22;Huesca;133;Labuerda;158;85;73;2016
22;Huesca;135;Laluenga;211;111;100;2016
22;Huesca;136;Lalueza;974;507;467;2016
22;Huesca;137;Lanaja;1231;657;574;2016
22;Huesca;139;Laperdiguera;92;49;43;2016
22;Huesca;141;Lascellas-Ponzano;133;83;50;2016
22;Huesca;142;Lascuarre;136;69;67;2016
22;Huesca;143;Laspaúles;266;154;112;2016
22;Huesca;144;Laspuña;274;151;123;2016
22;Huesca;149;Loarre;337;190;147;2016
22;Huesca;150;Loporzano;536;302;234;2016
22;Huesca;151;Loscorrales;102;51;51;2016
22;Huesca;905;Lupiñén-Ortilla;340;169;171;2016
22;Huesca;155;Monesma y Cajigar;84;43;41;2016
22;Huesca;156;Monflorite-Lascasas;360;192;168;2016
22;Huesca;157;Montanuy;223;128;95;2016
22;Huesca;158;Monzón;17237;8719;8518;2016
22;Huesca;160;Naval;264;137;127;2016
22;Huesca;162;Novales;177;90;87;2016
22;Huesca;163;Nueno;553;302;251;2016
22;Huesca;164;Olvena;45;22;23;2016
22;Huesca;165;Ontiñena;560;282;278;2016
22;Huesca;167;Osso de Cinca;729;391;338;2016
22;Huesca;168;Palo;24;12;12;2016
22;Huesca;170;Panticosa;774;396;378;2016
22;Huesca;172;Peñalba;688;341;347;2016
22;Huesca;173;Peñas de Riglos, Las;258;163;95;2016
22;Huesca;174;Peralta de Alcofea;587;310;277;2016
22;Huesca;175;Peralta de Calasanz;228;130;98;2016
22;Huesca;176;Peraltilla;197;103;94;2016
22;Huesca;177;Perarrúa;113;60;53;2016
22;Huesca;178;Pertusa;115;69;46;2016
22;Huesca;181;Piracés;103;57;46;2016
22;Huesca;182;Plan;299;157;142;2016
22;Huesca;184;Poleñino;209;111;98;2016
22;Huesca;186;Pozán de Vero;204;98;106;2016
22;Huesca;187;Puebla de Castro, La;379;193;186;2016
22;Huesca;188;Puente de Montañana;103;48;55;2016
22;Huesca;902;Puente la Reina de Jaca;272;136;136;2016
22;Huesca;189;Puértolas;213;123;90;2016
22;Huesca;190;Pueyo de Araguás, El;156;90;66;2016
22;Huesca;193;Pueyo de Santa Cruz;317;163;154;2016
22;Huesca;195;Quicena;286;144;142;2016
22;Huesca;197;Robres;569;288;281;2016
22;Huesca;199;Sabiñánigo;9349;4668;4681;2016
22;Huesca;200;Sahún;303;160;143;2016
22;Huesca;201;Salas Altas;310;153;157;2016
22;Huesca;202;Salas Bajas;169;82;87;2016
22;Huesca;203;Salillas;98;53;45;2016
22;Huesca;204;Sallent de Gállego;1461;733;728;2016
22;Huesca;205;San Esteban de Litera;498;252;246;2016
22;Huesca;207;San Juan de Plan;144;81;63;2016
22;Huesca;903;San Miguel del Cinca;826;421;405;2016
22;Huesca;206;Sangarrén;222;116;106;2016
22;Huesca;208;Santa Cilia;219;117;102;2016
22;Huesca;209;Santa Cruz de la Serós;186;107;79;2016
22;Huesca;906;Santa María de Dulcis;226;120;106;2016
22;Huesca;212;Santaliestra y San Quílez;95;48;47;2016
22;Huesca;213;Sariñena;4188;2158;2030;2016
22;Huesca;214;Secastilla;146;68;78;2016
22;Huesca;215;Seira;145;81;64;2016
22;Huesca;217;Sena;507;276;231;2016
22;Huesca;218;Senés de Alcubierre;45;20;25;2016
22;Huesca;220;Sesa;180;102;78;2016
22;Huesca;221;Sesué;103;54;49;2016
22;Huesca;222;Siétamo;680;374;306;2016
22;Huesca;223;Sopeira;95;52;43;2016
22;Huesca;904;Sotonera, La;955;494;461;2016
22;Huesca;225;Tamarite de Litera;3507;1796;1711;2016
22;Huesca;226;Tardienta;965;490;475;2016
22;Huesca;227;Tella-Sin;243;133;110;2016
22;Huesca;228;Tierz;743;367;376;2016
22;Huesca;229;Tolva;134;75;59;2016
22;Huesca;230;Torla-Ordesa;305;159;146;2016
22;Huesca;232;Torralba de Aragón;107;55;52;2016
22;Huesca;233;Torre la Ribera;103;56;47;2016
22;Huesca;234;Torrente de Cinca;1157;585;572;2016
22;Huesca;235;Torres de Alcanadre;98;57;41;2016
22;Huesca;236;Torres de Barbués;281;136;145;2016
22;Huesca;239;Tramaced;113;69;44;2016
22;Huesca;242;Valfarta;70;41;29;2016
22;Huesca;243;Valle de Bardají;34;20;14;2016
22;Huesca;901;Valle de Hecho;879;459;420;2016
22;Huesca;244;Valle de Lierp;52;27;25;2016
22;Huesca;245;Velilla de Cinca;442;230;212;2016
22;Huesca;909;Vencillón;414;217;197;2016
22;Huesca;247;Viacamp y Litera;44;25;19;2016
22;Huesca;248;Vicién;121;71;50;2016
22;Huesca;249;Villanova;162;83;79;2016
22;Huesca;250;Villanúa;441;238;203;2016
22;Huesca;251;Villanueva de Sigena;422;212;210;2016
22;Huesca;252;Yebra de Basa;140;82;58;2016
22;Huesca;253;Yésero;57;34;23;2016
22;Huesca;254;Zaidín;1783;921;862;2016
23;Jaén;001;Albanchez de Mágina;1072;556;516;2016
23;Jaén;002;Alcalá la Real;21758;10692;11066;2016
23;Jaén;003;Alcaudete;10698;5274;5424;2016
23;Jaén;004;Aldeaquemada;516;281;235;2016
23;Jaén;005;Andújar;37975;18686;19289;2016
23;Jaén;006;Arjona;5691;2812;2879;2016
23;Jaén;007;Arjonilla;3695;1843;1852;2016
23;Jaén;008;Arquillos;1836;917;919;2016
23;Jaén;905;Arroyo del Ojanco;2354;1193;1161;2016
23;Jaén;009;Baeza;16100;7995;8105;2016
23;Jaén;010;Bailén;18085;9000;9085;2016
23;Jaén;011;Baños de la Encina;2634;1350;1284;2016
23;Jaén;012;Beas de Segura;5380;2794;2586;2016
23;Jaén;902;Bedmar y Garcíez;2823;1401;1422;2016
23;Jaén;014;Begíjar;3102;1561;1541;2016
23;Jaén;015;Bélmez de la Moraleda;1646;830;816;2016
23;Jaén;016;Benatae;463;242;221;2016
23;Jaén;017;Cabra del Santo Cristo;1908;1003;905;2016
23;Jaén;018;Cambil;2802;1450;1352;2016
23;Jaén;019;Campillo de Arenas;1897;990;907;2016
23;Jaén;020;Canena;1943;996;947;2016
23;Jaén;021;Carboneros;630;327;303;2016
23;Jaén;901;Cárcheles;1387;724;663;2016
23;Jaén;024;Carolina, La;15579;7712;7867;2016
23;Jaén;025;Castellar;3411;1705;1706;2016
23;Jaén;026;Castillo de Locubín;4212;2072;2140;2016
23;Jaén;027;Cazalilla;846;407;439;2016
23;Jaén;028;Cazorla;7673;3729;3944;2016
23;Jaén;029;Chiclana de Segura;1002;495;507;2016
23;Jaén;030;Chilluévar;1499;729;770;2016
23;Jaén;031;Escañuela;947;475;472;2016
23;Jaén;032;Espelúy;687;338;349;2016
23;Jaén;033;Frailes;1637;811;826;2016
23;Jaén;034;Fuensanta de Martos;3115;1541;1574;2016
23;Jaén;035;Fuerte del Rey;1399;725;674;2016
23;Jaén;037;Génave;608;327;281;2016
23;Jaén;038;Guardia de Jaén, La;4895;2488;2407;2016
23;Jaén;039;Guarromán;2861;1440;1421;2016
23;Jaén;041;Higuera de Calatrava;632;333;299;2016
23;Jaén;042;Hinojares;338;173;165;2016
23;Jaén;043;Hornos;649;327;322;2016
23;Jaén;044;Huelma;6021;2993;3028;2016
23;Jaén;045;Huesa;2553;1294;1259;2016
23;Jaén;046;Ibros;2956;1477;1479;2016
23;Jaén;047;Iruela, La;1989;977;1012;2016
23;Jaén;048;Iznatoraf;1031;539;492;2016
23;Jaén;049;Jabalquinto;2152;1070;1082;2016
23;Jaén;050;Jaén;114658;55159;59499;2016
23;Jaén;051;Jamilena;3376;1706;1670;2016
23;Jaén;052;Jimena;1323;637;686;2016
23;Jaén;053;Jódar;11994;5944;6050;2016
23;Jaén;040;Lahiguera;1771;872;899;2016
23;Jaén;054;Larva;483;248;235;2016
23;Jaén;055;Linares;58829;28822;30007;2016
23;Jaén;056;Lopera;3743;1868;1875;2016
23;Jaén;057;Lupión;883;432;451;2016
23;Jaén;058;Mancha Real;11194;5560;5634;2016
23;Jaén;059;Marmolejo;7053;3532;3521;2016
23;Jaén;060;Martos;24240;12032;12208;2016
23;Jaén;061;Mengíbar;9921;4938;4983;2016
23;Jaén;062;Montizón;1768;915;853;2016
23;Jaén;063;Navas de San Juan;4597;2304;2293;2016
23;Jaén;064;Noalejo;1977;997;980;2016
23;Jaén;065;Orcera;1894;954;940;2016
23;Jaén;066;Peal de Becerro;5325;2651;2674;2016
23;Jaén;067;Pegalajar;2966;1482;1484;2016
23;Jaén;069;Porcuna;6532;3329;3203;2016
23;Jaén;070;Pozo Alcón;4857;2480;2377;2016
23;Jaén;071;Puente de Génave;2216;1118;1098;2016
23;Jaén;072;Puerta de Segura, La;2435;1214;1221;2016
23;Jaén;073;Quesada;5483;2777;2706;2016
23;Jaén;074;Rus;3668;1874;1794;2016
23;Jaén;075;Sabiote;4042;2016;2026;2016
23;Jaén;076;Santa Elena;966;514;452;2016
23;Jaén;077;Santiago de Calatrava;727;373;354;2016
23;Jaén;904;Santiago-Pontones;3229;1663;1566;2016
23;Jaén;079;Santisteban del Puerto;4621;2377;2244;2016
23;Jaén;080;Santo Tomé;2249;1132;1117;2016
23;Jaén;081;Segura de la Sierra;1845;907;938;2016
23;Jaén;082;Siles;2336;1185;1151;2016
23;Jaén;084;Sorihuela del Guadalimar;1196;632;564;2016
23;Jaén;085;Torreblascopedro;2669;1339;1330;2016
23;Jaén;086;Torredelcampo;14538;7300;7238;2016
23;Jaén;087;Torredonjimeno;13874;6813;7061;2016
23;Jaén;088;Torreperogil;7468;3634;3834;2016
23;Jaén;090;Torres;1513;768;745;2016
23;Jaén;091;Torres de Albánchez;860;447;413;2016
23;Jaén;092;Úbeda;34835;17095;17740;2016
23;Jaén;093;Valdepeñas de Jaén;3910;1937;1973;2016
23;Jaén;094;Vilches;4646;2336;2310;2016
23;Jaén;095;Villacarrillo;11000;5553;5447;2016
23;Jaén;096;Villanueva de la Reina;3152;1590;1562;2016
23;Jaén;097;Villanueva del Arzobispo;8447;4352;4095;2016
23;Jaén;098;Villardompardo;1017;508;509;2016
23;Jaén;099;Villares, Los;6019;3009;3010;2016
23;Jaén;101;Villarrodrigo;441;227;214;2016
23;Jaén;903;Villatorres;4377;2216;2161;2016
24;León;001;Acebedo;215;126;89;2016
24;León;002;Algadefe;279;143;136;2016
24;León;003;Alija del Infantado;696;351;345;2016
24;León;004;Almanza;563;323;240;2016
24;León;005;Antigua, La;403;232;171;2016
24;León;006;Ardón;563;303;260;2016
24;León;007;Arganza;858;430;428;2016
24;León;008;Astorga;11264;5347;5917;2016
24;León;009;Balboa;322;174;148;2016
24;León;010;Bañeza, La;10450;5042;5408;2016
24;León;011;Barjas;198;105;93;2016
24;León;012;Barrios de Luna, Los;315;178;137;2016
24;León;014;Bembibre;9356;4594;4762;2016
24;León;015;Benavides;2587;1274;1313;2016
24;León;016;Benuza;503;288;215;2016
24;León;017;Bercianos del Páramo;605;308;297;2016
24;León;018;Bercianos del Real Camino;196;101;95;2016
24;León;019;Berlanga del Bierzo;378;174;204;2016
24;León;020;Boca de Huérgano;485;283;202;2016
24;León;021;Boñar;1918;978;940;2016
24;León;022;Borrenes;345;178;167;2016
24;León;023;Brazuelo;300;163;137;2016
24;León;024;Burgo Ranero, El;764;407;357;2016
24;León;025;Burón;320;188;132;2016
24;León;026;Bustillo del Páramo;1274;654;620;2016
24;León;027;Cabañas Raras;1344;684;660;2016
24;León;028;Cabreros del Río;429;234;195;2016
24;León;029;Cabrillanes;804;416;388;2016
24;León;030;Cacabelos;5264;2611;2653;2016
24;León;031;Calzada del Coto;244;140;104;2016
24;León;032;Campazas;122;58;64;2016
24;León;033;Campo de Villavidel;208;111;97;2016
24;León;034;Camponaraya;4096;2041;2055;2016
24;León;036;Candín;290;152;138;2016
24;León;037;Cármenes;378;206;172;2016
24;León;038;Carracedelo;3523;1749;1774;2016
24;León;039;Carrizo;2335;1175;1160;2016
24;León;040;Carrocera;501;264;237;2016
24;León;041;Carucedo;574;293;281;2016
24;León;042;Castilfalé;72;41;31;2016
24;León;043;Castrillo de Cabrera;134;72;62;2016
24;León;044;Castrillo de la Valduerna;180;80;100;2016
24;León;046;Castrocalbón;1021;535;486;2016
24;León;047;Castrocontrigo;823;438;385;2016
24;León;049;Castropodame;1714;875;839;2016
24;León;050;Castrotierra de Valmadrigal;111;59;52;2016
24;León;051;Cea;449;233;216;2016
24;León;052;Cebanico;171;104;67;2016
24;León;053;Cebrones del Río;490;265;225;2016
24;León;065;Chozas de Abajo;2528;1317;1211;2016
24;León;054;Cimanes de la Vega;482;249;233;2016
24;León;055;Cimanes del Tejar;755;408;347;2016
24;León;056;Cistierna;3290;1623;1667;2016
24;León;057;Congosto;1559;775;784;2016
24;León;058;Corbillos de los Oteros;215;122;93;2016
24;León;059;Corullón;937;477;460;2016
24;León;060;Crémenes;584;318;266;2016
24;León;061;Cuadros;2000;1025;975;2016
24;León;062;Cubillas de los Oteros;152;87;65;2016
24;León;063;Cubillas de Rueda;435;222;213;2016
24;León;064;Cubillos del Sil;1813;965;848;2016
24;León;066;Destriana;523;253;270;2016
24;León;067;Encinedo;752;400;352;2016
24;León;068;Ercina, La;478;248;230;2016
24;León;069;Escobar de Campos;42;26;16;2016
24;León;070;Fabero;4746;2305;2441;2016
24;León;071;Folgoso de la Ribera;1142;558;584;2016
24;León;073;Fresno de la Vega;547;273;274;2016
24;León;074;Fuentes de Carbajal;92;51;41;2016
24;León;076;Garrafe de Torío;1480;811;669;2016
24;León;077;Gordaliza del Pino;268;131;137;2016
24;León;078;Gordoncillo;449;229;220;2016
24;León;079;Gradefes;987;526;461;2016
24;León;080;Grajal de Campos;231;118;113;2016
24;León;081;Gusendos de los Oteros;147;82;65;2016
24;León;082;Hospital de Órbigo;993;500;493;2016
24;León;083;Igüeña;1213;645;568;2016
24;León;084;Izagre;174;90;84;2016
24;León;086;Joarilla de las Matas;303;165;138;2016
24;León;087;Laguna Dalga;697;376;321;2016
24;León;088;Laguna de Negrillos;1089;563;526;2016
24;León;089;León;126192;57244;68948;2016
24;León;092;Llamas de la Ribera;869;454;415;2016
24;León;090;Lucillo;399;206;193;2016
24;León;091;Luyego;692;360;332;2016
24;León;093;Magaz de Cepeda;370;191;179;2016
24;León;094;Mansilla de las Mulas;1798;920;878;2016
24;León;095;Mansilla Mayor;341;182;159;2016
24;León;096;Maraña;128;78;50;2016
24;León;097;Matadeón de los Oteros;241;126;115;2016
24;León;098;Matallana de Torío;1342;702;640;2016
24;León;099;Matanza;185;101;84;2016
24;León;100;Molinaseca;888;478;410;2016
24;León;101;Murias de Paredes;412;207;205;2016
24;León;102;Noceda del Bierzo;723;362;361;2016
24;León;103;Oencia;295;171;124;2016
24;León;104;Omañas, Las;288;155;133;2016
24;León;105;Onzonilla;1790;928;862;2016
24;León;106;Oseja de Sajambre;257;153;104;2016
24;León;107;Pajares de los Oteros;283;173;110;2016
24;León;108;Palacios de la Valduerna;407;195;212;2016
24;León;109;Palacios del Sil;1062;569;493;2016
24;León;110;Páramo del Sil;1381;700;681;2016
24;León;112;Peranzanes;320;185;135;2016
24;León;113;Pobladura de Pelayo García;385;196;189;2016
24;León;114;Pola de Gordón, La;3488;1752;1736;2016
24;León;115;Ponferrada;66447;31702;34745;2016
24;León;116;Posada de Valdeón;457;271;186;2016
24;León;117;Pozuelo del Páramo;465;237;228;2016
24;León;118;Prado de la Guzpeña;135;76;59;2016
24;León;119;Priaranza del Bierzo;785;398;387;2016
24;León;120;Prioro;369;209;160;2016
24;León;121;Puebla de Lillo;699;390;309;2016
24;León;122;Puente de Domingo Flórez;1542;804;738;2016
24;León;123;Quintana del Castillo;786;434;352;2016
24;León;124;Quintana del Marco;390;213;177;2016
24;León;125;Quintana y Congosto;358;180;178;2016
24;León;127;Regueras de Arriba;310;169;141;2016
24;León;129;Reyero;128;67;61;2016
24;León;130;Riaño;484;277;207;2016
24;León;131;Riego de la Vega;816;431;385;2016
24;León;132;Riello;648;364;284;2016
24;León;133;Rioseco de Tapia;378;210;168;2016
24;León;134;Robla, La;4142;2086;2056;2016
24;León;136;Roperuelos del Páramo;582;292;290;2016
24;León;137;Sabero;1212;607;605;2016
24;León;139;Sahagún;2645;1307;1338;2016
24;León;141;San Adrián del Valle;109;57;52;2016
24;León;142;San Andrés del Rabanedo;31470;15119;16351;2016
24;León;144;San Cristóbal de la Polantera;767;376;391;2016
24;León;145;San Emiliano;687;377;310;2016
24;León;146;San Esteban de Nogales;272;144;128;2016
24;León;148;San Justo de la Vega;1908;970;938;2016
24;León;149;San Millán de los Caballeros;186;95;91;2016
24;León;150;San Pedro Bercianos;253;136;117;2016
24;León;143;Sancedo;573;287;286;2016
24;León;151;Santa Colomba de Curueño;529;280;249;2016
24;León;152;Santa Colomba de Somoza;522;282;240;2016
24;León;153;Santa Cristina de Valmadrigal;267;135;132;2016
24;León;154;Santa Elena de Jamuz;1133;585;548;2016
24;León;155;Santa María de la Isla;512;268;244;2016
24;León;158;Santa María de Ordás;338;175;163;2016
24;León;156;Santa María del Monte de Cea;249;133;116;2016
24;León;157;Santa María del Páramo;3141;1540;1601;2016
24;León;159;Santa Marina del Rey;1992;992;1000;2016
24;León;160;Santas Martas;770;403;367;2016
24;León;161;Santiago Millas;327;184;143;2016
24;León;162;Santovenia de la Valdoncina;2014;1036;978;2016
24;León;163;Sariegos;4904;2475;2429;2016
24;León;164;Sena de Luna;395;198;197;2016
24;León;165;Sobrado;353;176;177;2016
24;León;166;Soto de la Vega;1600;830;770;2016
24;León;167;Soto y Amío;830;417;413;2016
24;León;168;Toral de los Guzmanes;519;271;248;2016
24;León;206;Toral de los Vados;1941;962;979;2016
24;León;169;Toreno;3304;1658;1646;2016
24;León;170;Torre del Bierzo;2248;1148;1100;2016
24;León;171;Trabadelo;366;204;162;2016
24;León;172;Truchas;444;232;212;2016
24;León;173;Turcia;1039;532;507;2016
24;León;174;Urdiales del Páramo;508;274;234;2016
24;León;185;Val de San Lorenzo;529;262;267;2016
24;León;175;Valdefresno;2158;1113;1045;2016
24;León;176;Valdefuentes del Páramo;347;181;166;2016
24;León;177;Valdelugueros;520;297;223;2016
24;León;178;Valdemora;77;35;42;2016
24;León;179;Valdepiélago;332;188;144;2016
24;León;180;Valdepolo;1248;657;591;2016
24;León;181;Valderas;1777;898;879;2016
24;León;182;Valderrey;454;217;237;2016
24;León;183;Valderrueda;909;466;443;2016
24;León;184;Valdesamario;213;117;96;2016
24;León;187;Valdevimbre;1016;530;486;2016
24;León;188;Valencia de Don Juan;5190;2553;2637;2016
24;León;191;Vallecillo;122;70;52;2016
24;León;189;Valverde de la Virgen;7358;3813;3545;2016
24;León;190;Valverde-Enrique;174;92;82;2016
24;León;193;Vecilla, La;409;213;196;2016
24;León;196;Vega de Espinareda;2232;1122;1110;2016
24;León;197;Vega de Infanzones;883;443;440;2016
24;León;198;Vega de Valcarce;652;333;319;2016
24;León;194;Vegacervera;312;165;147;2016
24;León;199;Vegaquemada;457;245;212;2016
24;León;201;Vegas del Condado;1158;658;500;2016
24;León;202;Villablino;9342;4592;4750;2016
24;León;203;Villabraz;107;61;46;2016
24;León;205;Villadangos del Páramo;1096;561;535;2016
24;León;207;Villademor de la Vega;352;191;161;2016
24;León;209;Villafranca del Bierzo;3153;1525;1628;2016
24;León;210;Villagatón;610;327;283;2016
24;León;211;Villamandos;308;169;139;2016
24;León;901;Villamanín;1001;517;484;2016
24;León;212;Villamañán;1178;569;609;2016
24;León;213;Villamartín de Don Sancho;155;86;69;2016
24;León;214;Villamejil;709;371;338;2016
24;León;215;Villamol;169;85;84;2016
24;León;216;Villamontán de la Valduerna;777;404;373;2016
24;León;217;Villamoratiel de las Matas;155;87;68;2016
24;León;218;Villanueva de las Manzanas;505;266;239;2016
24;León;219;Villaobispo de Otero;590;320;270;2016
24;León;902;Villaornate y Castro;369;185;184;2016
24;León;221;Villaquejida;914;461;453;2016
24;León;222;Villaquilambre;18583;9200;9383;2016
24;León;223;Villarejo de Órbigo;3061;1498;1563;2016
24;León;224;Villares de Órbigo;672;355;317;2016
24;León;225;Villasabariego;1156;614;542;2016
24;León;226;Villaselán;209;120;89;2016
24;León;227;Villaturiel;1942;1012;930;2016
24;León;228;Villazala;726;381;345;2016
24;León;229;Villazanzo de Valderaduey;461;264;197;2016
24;León;230;Zotes del Páramo;456;257;199;2016
25;Lleida;001;Abella de la Conca;181;100;81;2016
25;Lleida;002;Àger;602;322;280;2016
25;Lleida;003;Agramunt;5390;2714;2676;2016
25;Lleida;038;Aitona;2523;1300;1223;2016
25;Lleida;004;Alamús, Els;799;419;380;2016
25;Lleida;005;Alàs i Cerc;350;176;174;2016
25;Lleida;006;Albagés, L';403;212;191;2016
25;Lleida;007;Albatàrrec;2291;1193;1098;2016
25;Lleida;008;Albesa;1596;861;735;2016
25;Lleida;009;Albi, L';803;418;385;2016
25;Lleida;010;Alcanó;249;123;126;2016
25;Lleida;011;Alcarràs;9297;4814;4483;2016
25;Lleida;012;Alcoletge;3375;1745;1630;2016
25;Lleida;013;Alfarràs;2923;1544;1379;2016
25;Lleida;014;Alfés;326;169;157;2016
25;Lleida;015;Algerri;423;229;194;2016
25;Lleida;016;Alguaire;3006;1576;1430;2016
25;Lleida;017;Alins;287;152;135;2016
25;Lleida;019;Almacelles;6800;3569;3231;2016
25;Lleida;020;Almatret;327;181;146;2016
25;Lleida;021;Almenar;3502;1870;1632;2016
25;Lleida;022;Alòs de Balaguer;125;69;56;2016
25;Lleida;023;Alpicat;6233;3108;3125;2016
25;Lleida;024;Alt Àneu;402;226;176;2016
25;Lleida;027;Anglesola;1335;668;667;2016
25;Lleida;029;Arbeca;2240;1137;1103;2016
25;Lleida;031;Arres;64;41;23;2016
25;Lleida;032;Arsèguel;83;50;33;2016
25;Lleida;033;Artesa de Lleida;1512;786;726;2016
25;Lleida;034;Artesa de Segre;3556;1808;1748;2016
25;Lleida;036;Aspa;217;108;109;2016
25;Lleida;037;Avellanes i Santa Linya, Les;465;267;198;2016
25;Lleida;039;Baix Pallars;342;181;161;2016
25;Lleida;040;Balaguer;16530;8363;8167;2016
25;Lleida;041;Barbens;943;500;443;2016
25;Lleida;042;Baronia de Rialb, La;240;129;111;2016
25;Lleida;044;Bassella;235;112;123;2016
25;Lleida;045;Bausen;64;33;31;2016
25;Lleida;046;Belianes;539;269;270;2016
25;Lleida;170;Bellaguarda;307;159;148;2016
25;Lleida;047;Bellcaire d'Urgell;1263;639;624;2016
25;Lleida;048;Bell-lloc d'Urgell;2349;1162;1187;2016
25;Lleida;049;Bellmunt d'Urgell;188;90;98;2016
25;Lleida;050;Bellpuig;5005;2600;2405;2016
25;Lleida;051;Bellver de Cerdanya;1995;1034;961;2016
25;Lleida;052;Bellvís;2264;1150;1114;2016
25;Lleida;053;Benavent de Segrià;1482;772;710;2016
25;Lleida;055;Biosca;187;99;88;2016
25;Lleida;057;Bòrdes, Es;250;138;112;2016
25;Lleida;058;Borges Blanques, Les;6000;3062;2938;2016
25;Lleida;059;Bossòst;1123;555;568;2016
25;Lleida;056;Bovera;267;147;120;2016
25;Lleida;060;Cabanabona;77;36;41;2016
25;Lleida;061;Cabó;92;48;44;2016
25;Lleida;062;Camarasa;879;448;431;2016
25;Lleida;063;Canejan;97;54;43;2016
25;Lleida;904;Castell de Mur;175;94;81;2016
25;Lleida;064;Castellar de la Ribera;142;71;71;2016
25;Lleida;067;Castelldans;958;524;434;2016
25;Lleida;068;Castellnou de Seana;736;393;343;2016
25;Lleida;069;Castelló de Farfanya;556;300;256;2016
25;Lleida;070;Castellserà;1030;519;511;2016
25;Lleida;071;Cava;57;35;22;2016
25;Lleida;072;Cervera;9013;4544;4469;2016
25;Lleida;073;Cervià de les Garrigues;686;357;329;2016
25;Lleida;074;Ciutadilla;204;110;94;2016
25;Lleida;075;Clariana de Cardener;141;71;70;2016
25;Lleida;076;Cogul, El;174;93;81;2016
25;Lleida;077;Coll de Nargó;574;292;282;2016
25;Lleida;163;Coma i la Pedra, La;261;156;105;2016
25;Lleida;161;Conca de Dalt;439;228;211;2016
25;Lleida;078;Corbins;1401;751;650;2016
25;Lleida;079;Cubells;373;196;177;2016
25;Lleida;081;Espluga Calba, L';375;189;186;2016
25;Lleida;082;Espot;361;195;166;2016
25;Lleida;088;Estamariu;119;67;52;2016
25;Lleida;085;Estaràs;163;86;77;2016
25;Lleida;086;Esterri d'Àneu;789;375;414;2016
25;Lleida;087;Esterri de Cardós;69;34;35;2016
25;Lleida;089;Farrera;126;75;51;2016
25;Lleida;908;Fígols i Alinyà;254;147;107;2016
25;Lleida;092;Floresta, La;155;86;69;2016
25;Lleida;093;Fondarella;794;396;398;2016
25;Lleida;094;Foradada;172;98;74;2016
25;Lleida;096;Fuliola, La;1260;630;630;2016
25;Lleida;097;Fulleda;87;46;41;2016
25;Lleida;098;Gavet de la Conca;297;142;155;2016
25;Lleida;912;Gimenells i el Pla de la Font;1111;570;541;2016
25;Lleida;099;Golmés;1835;905;930;2016
25;Lleida;100;Gósol;228;130;98;2016
25;Lleida;101;Granadella, La;723;379;344;2016
25;Lleida;102;Granja d'Escarp, La;977;519;458;2016
25;Lleida;103;Granyanella;153;85;68;2016
25;Lleida;105;Granyena de les Garrigues;158;93;65;2016
25;Lleida;104;Granyena de Segarra;147;77;70;2016
25;Lleida;109;Guimerà;275;147;128;2016
25;Lleida;903;Guingueta d'Àneu, La;308;164;144;2016
25;Lleida;110;Guissona;6892;3639;3253;2016
25;Lleida;111;Guixers;146;94;52;2016
25;Lleida;115;Isona i Conca Dellà;1046;552;494;2016
25;Lleida;112;Ivars de Noguera;351;181;170;2016
25;Lleida;113;Ivars d'Urgell;1578;826;752;2016
25;Lleida;114;Ivorra;114;61;53;2016
25;Lleida;910;Josa i Tuixén;122;71;51;2016
25;Lleida;118;Juncosa;418;226;192;2016
25;Lleida;119;Juneda;3343;1730;1613;2016
25;Lleida;121;Les;958;469;489;2016
25;Lleida;122;Linyola;2650;1330;1320;2016
25;Lleida;123;Lladorre;226;107;119;2016
25;Lleida;124;Lladurs;187;100;87;2016
25;Lleida;125;Llardecans;476;248;228;2016
25;Lleida;126;Llavorsí;355;175;180;2016
25;Lleida;120;Lleida;138144;68284;69860;2016
25;Lleida;127;Lles de Cerdanya;247;144;103;2016
25;Lleida;128;Llimiana;150;88;62;2016
25;Lleida;129;Llobera;203;110;93;2016
25;Lleida;133;Maials;950;513;437;2016
25;Lleida;130;Maldà;230;116;114;2016
25;Lleida;131;Massalcoreig;571;313;258;2016
25;Lleida;132;Massoteres;203;110;93;2016
25;Lleida;134;Menàrguens;847;473;374;2016
25;Lleida;135;Miralcamp;1369;686;683;2016
25;Lleida;137;Mollerussa;14585;7465;7120;2016
25;Lleida;136;Molsosa, La;111;54;57;2016
25;Lleida;139;Montellà i Martinet;547;302;245;2016
25;Lleida;140;Montferrer i Castellbò;1050;566;484;2016
25;Lleida;138;Montgai;651;335;316;2016
25;Lleida;142;Montoliu de Lleida;495;251;244;2016
25;Lleida;141;Montoliu de Segarra;188;105;83;2016
25;Lleida;143;Montornès de Segarra;100;50;50;2016
25;Lleida;145;Nalec;100;52;48;2016
25;Lleida;025;Naut Aran;1764;899;865;2016
25;Lleida;146;Navès;283;137;146;2016
25;Lleida;148;Odèn;259;150;109;2016
25;Lleida;149;Oliana;1844;929;915;2016
25;Lleida;150;Oliola;220;123;97;2016
25;Lleida;151;Olius;929;488;441;2016
25;Lleida;152;Oluges, Les;152;81;71;2016
25;Lleida;153;Omellons, Els;217;116;101;2016
25;Lleida;154;Omells de na Gaia, Els;137;74;63;2016
25;Lleida;155;Organyà;804;399;405;2016
25;Lleida;156;Os de Balaguer;1022;514;508;2016
25;Lleida;157;Ossó de Sió;214;105;109;2016
25;Lleida;158;Palau d'Anglesola, El;2153;1053;1100;2016
25;Lleida;164;Penelles;474;271;203;2016
25;Lleida;165;Peramola;344;172;172;2016
25;Lleida;166;Pinell de Solsonès;213;125;88;2016
25;Lleida;167;Pinós;297;160;137;2016
25;Lleida;911;Plans de Sió, Els;523;280;243;2016
25;Lleida;168;Poal, El;655;343;312;2016
25;Lleida;169;Pobla de Cérvoles, La;206;115;91;2016
25;Lleida;171;Pobla de Segur, La;2973;1475;1498;2016
25;Lleida;030;Pont de Bar, El;165;92;73;2016
25;Lleida;173;Pont de Suert, El;2293;1156;1137;2016
25;Lleida;172;Ponts;2638;1310;1328;2016
25;Lleida;174;Portella, La;741;409;332;2016
25;Lleida;175;Prats i Sansor;238;123;115;2016
25;Lleida;176;Preixana;382;197;185;2016
25;Lleida;177;Preixens;448;229;219;2016
25;Lleida;179;Prullans;208;103;105;2016
25;Lleida;180;Puiggròs;287;145;142;2016
25;Lleida;181;Puigverd d'Agramunt;237;133;104;2016
25;Lleida;182;Puigverd de Lleida;1373;707;666;2016
25;Lleida;183;Rialp;669;347;322;2016
25;Lleida;905;Ribera d'Ondara;446;227;219;2016
25;Lleida;185;Ribera d'Urgellet;962;504;458;2016
25;Lleida;186;Riner;261;128;133;2016
25;Lleida;913;Riu de Cerdanya;97;55;42;2016
25;Lleida;189;Rosselló;3029;1516;1513;2016
25;Lleida;190;Salàs de Pallars;340;183;157;2016
25;Lleida;191;Sanaüja;425;216;209;2016
25;Lleida;196;Sant Esteve de la Sarga;139;87;52;2016
25;Lleida;192;Sant Guim de Freixenet;1059;553;506;2016
25;Lleida;197;Sant Guim de la Plana;170;94;76;2016
25;Lleida;193;Sant Llorenç de Morunys;966;474;492;2016
25;Lleida;902;Sant Martí de Riucorb;674;353;321;2016
25;Lleida;194;Sant Ramon;509;275;234;2016
25;Lleida;201;Sarroca de Bellera;117;69;48;2016
25;Lleida;200;Sarroca de Lleida;374;204;170;2016
25;Lleida;202;Senterada;133;80;53;2016
25;Lleida;035;Sentiu de Sió, La;462;239;223;2016
25;Lleida;204;Seròs;1912;1035;877;2016
25;Lleida;203;Seu d'Urgell, La;12185;5864;6321;2016
25;Lleida;205;Sidamon;734;383;351;2016
25;Lleida;206;Soleràs, El;350;181;169;2016
25;Lleida;207;Solsona;8914;4425;4489;2016
25;Lleida;208;Soriguera;408;221;187;2016
25;Lleida;209;Sort;2145;1068;1077;2016
25;Lleida;210;Soses;1698;880;818;2016
25;Lleida;211;Sudanell;867;481;386;2016
25;Lleida;212;Sunyer;350;200;150;2016
25;Lleida;215;Talarn;689;462;227;2016
25;Lleida;216;Talavera;257;141;116;2016
25;Lleida;217;Tàrrega;16481;8192;8289;2016
25;Lleida;218;Tarrés;100;57;43;2016
25;Lleida;219;Tarroja de Segarra;182;101;81;2016
25;Lleida;220;Térmens;1526;760;766;2016
25;Lleida;221;Tírvia;143;68;75;2016
25;Lleida;222;Tiurana;73;35;38;2016
25;Lleida;223;Torà;1215;610;605;2016
25;Lleida;224;Torms, Els;149;84;65;2016
25;Lleida;225;Tornabous;882;473;409;2016
25;Lleida;227;Torre de Cabdella, La;748;379;369;2016
25;Lleida;226;Torrebesses;293;155;138;2016
25;Lleida;228;Torrefarrera;4630;2361;2269;2016
25;Lleida;907;Torrefeta i Florejacs;590;310;280;2016
25;Lleida;230;Torregrossa;2166;1097;1069;2016
25;Lleida;231;Torrelameu;703;401;302;2016
25;Lleida;232;Torres de Segre;2253;1155;1098;2016
25;Lleida;233;Torre-serona;379;198;181;2016
25;Lleida;234;Tremp;6026;2976;3050;2016
25;Lleida;043;Vall de Boí, La;1022;549;473;2016
25;Lleida;901;Vall de Cardós;356;194;162;2016
25;Lleida;238;Vallbona de les Monges;241;127;114;2016
25;Lleida;240;Vallfogona de Balaguer;1868;924;944;2016
25;Lleida;906;Valls d'Aguilar, Les;291;163;128;2016
25;Lleida;239;Valls de Valira, Les;817;418;399;2016
25;Lleida;909;Vansa i Fórnols, La;200;103;97;2016
25;Lleida;242;Verdú;933;443;490;2016
25;Lleida;243;Vielha e Mijaran;5459;2772;2687;2016
25;Lleida;244;Vilagrassa;510;264;246;2016
25;Lleida;245;Vilaller;552;295;257;2016
25;Lleida;247;Vilamòs;151;81;70;2016
25;Lleida;248;Vilanova de Bellpuig;1168;602;566;2016
25;Lleida;254;Vilanova de la Barca;1054;535;519;2016
25;Lleida;249;Vilanova de l'Aguda;213;105;108;2016
25;Lleida;250;Vilanova de Meià;414;232;182;2016
25;Lleida;251;Vilanova de Segrià;941;498;443;2016
25;Lleida;252;Vila-sana;732;364;368;2016
25;Lleida;253;Vilosell, El;185;91;94;2016
25;Lleida;255;Vinaixa;499;257;242;2016
27;Lugo;001;Abadín;2559;1260;1299;2016
27;Lugo;002;Alfoz;1818;873;945;2016
27;Lugo;003;Antas de Ulla;2080;1027;1053;2016
27;Lugo;004;Baleira;1333;703;630;2016
27;Lugo;901;Baralla;2660;1378;1282;2016
27;Lugo;005;Barreiros;2970;1414;1556;2016
27;Lugo;006;Becerreá;2921;1465;1456;2016
27;Lugo;007;Begonte;3115;1559;1556;2016
27;Lugo;008;Bóveda;1537;791;746;2016
27;Lugo;902;Burela;9552;4723;4829;2016
27;Lugo;009;Carballedo;2280;1150;1130;2016
27;Lugo;010;Castro de Rei;5057;2476;2581;2016
27;Lugo;011;Castroverde;2726;1402;1324;2016
27;Lugo;012;Cervantes;1458;826;632;2016
27;Lugo;013;Cervo;4295;2106;2189;2016
27;Lugo;016;Chantada;8431;4089;4342;2016
27;Lugo;014;Corgo, O;3581;1816;1765;2016
27;Lugo;015;Cospeito;4754;2306;2448;2016
27;Lugo;017;Folgoso do Courel;1060;556;504;2016
27;Lugo;018;Fonsagrada, A;3768;1957;1811;2016
27;Lugo;019;Foz;9908;4844;5064;2016
27;Lugo;020;Friol;3894;1954;1940;2016
27;Lugo;022;Guitiriz;5495;2735;2760;2016
27;Lugo;023;Guntín;2833;1456;1377;2016
27;Lugo;024;Incio, O;1740;868;872;2016
27;Lugo;026;Láncara;2702;1372;1330;2016
27;Lugo;027;Lourenzá;2259;1098;1161;2016
27;Lugo;028;Lugo;98268;45623;52645;2016
27;Lugo;029;Meira;1747;880;867;2016
27;Lugo;030;Mondoñedo;3820;1790;2030;2016
27;Lugo;031;Monforte de Lemos;18922;8957;9965;2016
27;Lugo;032;Monterroso;3741;1868;1873;2016
27;Lugo;033;Muras;668;342;326;2016
27;Lugo;034;Navia de Suarna;1186;666;520;2016
27;Lugo;035;Negueira de Muñiz;215;115;100;2016
27;Lugo;037;Nogais, As;1161;608;553;2016
27;Lugo;038;Ourol;1034;523;511;2016
27;Lugo;039;Outeiro de Rei;5043;2587;2456;2016
27;Lugo;040;Palas de Rei;3554;1784;1770;2016
27;Lugo;041;Pantón;2620;1254;1366;2016
27;Lugo;042;Paradela;1887;946;941;2016
27;Lugo;043;Páramo, O;1456;740;716;2016
27;Lugo;044;Pastoriza, A;3212;1618;1594;2016
27;Lugo;045;Pedrafita do Cebreiro;1088;585;503;2016
27;Lugo;047;Pobra do Brollón, A;1752;862;890;2016
27;Lugo;046;Pol;1696;836;860;2016
27;Lugo;048;Pontenova, A;2402;1160;1242;2016
27;Lugo;049;Portomarín;1528;785;743;2016
27;Lugo;050;Quiroga;3354;1608;1746;2016
27;Lugo;056;Rábade;1521;758;763;2016
27;Lugo;051;Ribadeo;9972;4766;5206;2016
27;Lugo;052;Ribas de Sil;992;498;494;2016
27;Lugo;053;Ribeira de Piquín;570;289;281;2016
27;Lugo;054;Riotorto;1322;656;666;2016
27;Lugo;055;Samos;1392;733;659;2016
27;Lugo;057;Sarria;13337;6527;6810;2016
27;Lugo;058;Saviñao, O;3926;1979;1947;2016
27;Lugo;059;Sober;2375;1163;1212;2016
27;Lugo;060;Taboada;2928;1397;1531;2016
27;Lugo;061;Trabada;1133;544;589;2016
27;Lugo;062;Triacastela;680;340;340;2016
27;Lugo;063;Valadouro, O;2016;972;1044;2016
27;Lugo;064;Vicedo, O;1802;883;919;2016
27;Lugo;065;Vilalba;14487;7050;7437;2016
27;Lugo;066;Viveiro;15615;7633;7982;2016
27;Lugo;021;Xermade;1943;945;998;2016
27;Lugo;025;Xove;3376;1680;1696;2016
28;Madrid;001;Acebeda, La;66;36;30;2016
28;Madrid;002;Ajalvir;4440;2318;2122;2016
28;Madrid;003;Alameda del Valle;208;123;85;2016
28;Madrid;004;Álamo, El;9017;4488;4529;2016
28;Madrid;005;Alcalá de Henares;195907;96008;99899;2016
28;Madrid;006;Alcobendas;113340;54631;58709;2016
28;Madrid;007;Alcorcón;167354;81016;86338;2016
28;Madrid;008;Aldea del Fresno;2584;1370;1214;2016
28;Madrid;009;Algete;20311;10082;10229;2016
28;Madrid;010;Alpedrete;14417;7098;7319;2016
28;Madrid;011;Ambite;595;303;292;2016
28;Madrid;012;Anchuelo;1215;643;572;2016
28;Madrid;013;Aranjuez;57932;28256;29676;2016
28;Madrid;014;Arganda del Rey;54256;27357;26899;2016
28;Madrid;015;Arroyomolinos;28177;14160;14017;2016
28;Madrid;016;Atazar, El;95;55;40;2016
28;Madrid;017;Batres;1582;803;779;2016
28;Madrid;018;Becerril de la Sierra;5439;2685;2754;2016
28;Madrid;019;Belmonte de Tajo;1605;838;767;2016
28;Madrid;021;Berrueco, El;752;382;370;2016
28;Madrid;020;Berzosa del Lozoya;198;115;83;2016
28;Madrid;022;Boadilla del Monte;49762;24332;25430;2016
28;Madrid;023;Boalo, El;7225;3677;3548;2016
28;Madrid;024;Braojos;201;117;84;2016
28;Madrid;025;Brea de Tajo;560;325;235;2016
28;Madrid;026;Brunete;10374;5120;5254;2016
28;Madrid;027;Buitrago del Lozoya;1861;895;966;2016
28;Madrid;028;Bustarviejo;2370;1191;1179;2016
28;Madrid;029;Cabanillas de la Sierra;719;372;347;2016
28;Madrid;030;Cabrera, La;2560;1269;1291;2016
28;Madrid;031;Cadalso de los Vidrios;2788;1453;1335;2016
28;Madrid;032;Camarma de Esteruelas;7050;3576;3474;2016
28;Madrid;033;Campo Real;5888;2988;2900;2016
28;Madrid;034;Canencia;451;243;208;2016
28;Madrid;035;Carabaña;1948;959;989;2016
28;Madrid;036;Casarrubuelos;3589;1834;1755;2016
28;Madrid;037;Cenicientos;1986;977;1009;2016
28;Madrid;038;Cercedilla;6751;3301;3450;2016
28;Madrid;039;Cervera de Buitrago;157;91;66;2016
28;Madrid;051;Chapinería;2214;1135;1079;2016
28;Madrid;052;Chinchón;5294;2675;2619;2016
28;Madrid;040;Ciempozuelos;23773;12042;11731;2016
28;Madrid;041;Cobeña;7009;3458;3551;2016
28;Madrid;046;Collado Mediano;6583;3288;3295;2016
28;Madrid;047;Collado Villalba;61597;30056;31541;2016
28;Madrid;043;Colmenar de Oreja;7946;4036;3910;2016
28;Madrid;042;Colmenar del Arroyo;1632;838;794;2016
28;Madrid;045;Colmenar Viejo;48020;23767;24253;2016
28;Madrid;044;Colmenarejo;8945;4401;4544;2016
28;Madrid;048;Corpa;672;350;322;2016
28;Madrid;049;Coslada;84533;41562;42971;2016
28;Madrid;050;Cubas de la Sagra;5971;2957;3014;2016
28;Madrid;053;Daganzo de Arriba;9981;4999;4982;2016
28;Madrid;054;Escorial, El;15364;7577;7787;2016
28;Madrid;055;Estremera;1319;671;648;2016
28;Madrid;056;Fresnedillas de la Oliva;1547;790;757;2016
28;Madrid;057;Fresno de Torote;2044;1070;974;2016
28;Madrid;058;Fuenlabrada;194171;96249;97922;2016
28;Madrid;059;Fuente el Saz de Jarama;6403;3260;3143;2016
28;Madrid;060;Fuentidueña de Tajo;1936;963;973;2016
28;Madrid;061;Galapagar;32404;15963;16441;2016
28;Madrid;062;Garganta de los Montes;351;187;164;2016
28;Madrid;063;Gargantilla del Lozoya y Pinilla de Buitrago;325;180;145;2016
28;Madrid;064;Gascones;171;99;72;2016
28;Madrid;065;Getafe;176659;86629;90030;2016
28;Madrid;066;Griñón;9938;4923;5015;2016
28;Madrid;067;Guadalix de la Sierra;5982;3000;2982;2016
28;Madrid;068;Guadarrama;15488;7639;7849;2016
28;Madrid;069;Hiruela, La;54;36;18;2016
28;Madrid;070;Horcajo de la Sierra-Aoslos;143;78;65;2016
28;Madrid;071;Horcajuelo de la Sierra;86;43;43;2016
28;Madrid;072;Hoyo de Manzanares;7965;4022;3943;2016
28;Madrid;073;Humanes de Madrid;19563;9837;9726;2016
28;Madrid;074;Leganés;187173;91241;95932;2016
28;Madrid;075;Loeches;8388;4227;4161;2016
28;Madrid;076;Lozoya;576;298;278;2016
28;Madrid;901;Lozoyuela-Navas-Sieteiglesias;1210;637;573;2016
28;Madrid;078;Madarcos;47;30;17;2016
28;Madrid;079;Madrid;3165541;1472172;1693369;2016
28;Madrid;080;Majadahonda;70755;33619;37136;2016
28;Madrid;082;Manzanares el Real;8387;4236;4151;2016
28;Madrid;083;Meco;13426;6763;6663;2016
28;Madrid;084;Mejorada del Campo;22900;11441;11459;2016
28;Madrid;085;Miraflores de la Sierra;5754;2959;2795;2016
28;Madrid;086;Molar, El;8263;4168;4095;2016
28;Madrid;087;Molinos, Los;4373;2166;2207;2016
28;Madrid;088;Montejo de la Sierra;359;183;176;2016
28;Madrid;089;Moraleja de Enmedio;4984;2481;2503;2016
28;Madrid;090;Moralzarzal;12372;6200;6172;2016
28;Madrid;091;Morata de Tajuña;7548;3752;3796;2016
28;Madrid;092;Móstoles;205614;100518;105096;2016
28;Madrid;093;Navacerrada;2885;1433;1452;2016
28;Madrid;094;Navalafuente;1266;653;613;2016
28;Madrid;095;Navalagamella;2423;1263;1160;2016
28;Madrid;096;Navalcarnero;26954;13455;13499;2016
28;Madrid;097;Navarredonda y San Mamés;132;84;48;2016
28;Madrid;099;Navas del Rey;2659;1419;1240;2016
28;Madrid;100;Nuevo Baztán;6018;3042;2976;2016
28;Madrid;101;Olmeda de las Fuentes;326;171;155;2016
28;Madrid;102;Orusco de Tajuña;1225;622;603;2016
28;Madrid;104;Paracuellos de Jarama;23104;11718;11386;2016
28;Madrid;106;Parla;124661;62293;62368;2016
28;Madrid;107;Patones;537;257;280;2016
28;Madrid;108;Pedrezuela;5456;2726;2730;2016
28;Madrid;109;Pelayos de la Presa;2471;1243;1228;2016
28;Madrid;110;Perales de Tajuña;2799;1401;1398;2016
28;Madrid;111;Pezuela de las Torres;793;412;381;2016
28;Madrid;112;Pinilla del Valle;192;108;84;2016
28;Madrid;113;Pinto;49522;24563;24959;2016
28;Madrid;114;Piñuécar-Gandullas;185;101;84;2016
28;Madrid;115;Pozuelo de Alarcón;84989;40722;44267;2016
28;Madrid;116;Pozuelo del Rey;1073;563;510;2016
28;Madrid;117;Prádena del Rincón;134;75;59;2016
28;Madrid;118;Puebla de la Sierra;66;40;26;2016
28;Madrid;902;Puentes Viejas;627;351;276;2016
28;Madrid;119;Quijorna;3239;1650;1589;2016
28;Madrid;120;Rascafría;1692;916;776;2016
28;Madrid;121;Redueña;261;142;119;2016
28;Madrid;122;Ribatejada;689;351;338;2016
28;Madrid;123;Rivas-Vaciamadrid;82715;41221;41494;2016
28;Madrid;124;Robledillo de la Jara;99;47;52;2016
28;Madrid;125;Robledo de Chavela;4001;2090;1911;2016
28;Madrid;126;Robregordo;45;29;16;2016
28;Madrid;127;Rozas de Madrid, Las;94471;45782;48689;2016
28;Madrid;128;Rozas de Puerto Real;533;309;224;2016
28;Madrid;129;San Agustín del Guadalix;12862;6308;6554;2016
28;Madrid;130;San Fernando de Henares;40095;19667;20428;2016
28;Madrid;131;San Lorenzo de El Escorial;18038;8643;9395;2016
28;Madrid;132;San Martín de la Vega;18734;9580;9154;2016
28;Madrid;133;San Martín de Valdeiglesias;8344;4176;4168;2016
28;Madrid;134;San Sebastián de los Reyes;86206;42221;43985;2016
28;Madrid;135;Santa María de la Alameda;1177;623;554;2016
28;Madrid;136;Santorcaz;851;439;412;2016
28;Madrid;137;Santos de la Humosa, Los;2435;1243;1192;2016
28;Madrid;138;Serna del Monte, La;77;40;37;2016
28;Madrid;140;Serranillos del Valle;3990;1970;2020;2016
28;Madrid;141;Sevilla la Nueva;8905;4417;4488;2016
28;Madrid;143;Somosierra;77;43;34;2016
28;Madrid;144;Soto del Real;8483;4150;4333;2016
28;Madrid;145;Talamanca de Jarama;3451;1718;1733;2016
28;Madrid;146;Tielmes;2620;1333;1287;2016
28;Madrid;147;Titulcia;1258;644;614;2016
28;Madrid;148;Torrejón de Ardoz;126981;62757;64224;2016
28;Madrid;149;Torrejón de la Calzada;8171;4039;4132;2016
28;Madrid;150;Torrejón de Velasco;4243;2125;2118;2016
28;Madrid;151;Torrelaguna;4697;2382;2315;2016
28;Madrid;152;Torrelodones;23123;11142;11981;2016
28;Madrid;153;Torremocha de Jarama;906;457;449;2016
28;Madrid;154;Torres de la Alameda;7769;3956;3813;2016
28;Madrid;903;Tres Cantos;44764;21764;23000;2016
28;Madrid;155;Valdaracete;641;330;311;2016
28;Madrid;156;Valdeavero;1407;739;668;2016
28;Madrid;157;Valdelaguna;841;422;419;2016
28;Madrid;158;Valdemanco;911;481;430;2016
28;Madrid;159;Valdemaqueda;779;388;391;2016
28;Madrid;160;Valdemorillo;12168;6205;5963;2016
28;Madrid;161;Valdemoro;72988;36244;36744;2016
28;Madrid;162;Valdeolmos-Alalpardo;3880;1965;1915;2016
28;Madrid;163;Valdepiélagos;574;303;271;2016
28;Madrid;164;Valdetorres de Jarama;4260;2145;2115;2016
28;Madrid;165;Valdilecha;2749;1415;1334;2016
28;Madrid;166;Valverde de Alcalá;430;230;200;2016
28;Madrid;167;Velilla de San Antonio;12222;6159;6063;2016
28;Madrid;168;Vellón, El;1846;968;878;2016
28;Madrid;169;Venturada;2014;1067;947;2016
28;Madrid;171;Villa del Prado;6295;3198;3097;2016
28;Madrid;170;Villaconejos;3350;1703;1647;2016
28;Madrid;172;Villalbilla;12719;6442;6277;2016
28;Madrid;173;Villamanrique de Tajo;705;360;345;2016
28;Madrid;174;Villamanta;2497;1267;1230;2016
28;Madrid;175;Villamantilla;1334;670;664;2016
28;Madrid;176;Villanueva de la Cañada;19611;9553;10058;2016
28;Madrid;178;Villanueva de Perales;1486;755;731;2016
28;Madrid;177;Villanueva del Pardillo;16950;8302;8648;2016
28;Madrid;179;Villar del Olmo;1981;1014;967;2016
28;Madrid;180;Villarejo de Salvanés;7265;3665;3600;2016
28;Madrid;181;Villaviciosa de Odón;27276;13224;14052;2016
28;Madrid;182;Villavieja del Lozoya;270;148;122;2016
28;Madrid;183;Zarzalejo;1565;822;743;2016
29;Málaga;001;Alameda;5390;2730;2660;2016
29;Málaga;002;Alcaucín;2272;1166;1106;2016
29;Málaga;003;Alfarnate;1135;584;551;2016
29;Málaga;004;Alfarnatejo;405;207;198;2016
29;Málaga;005;Algarrobo;6232;3136;3096;2016
29;Málaga;006;Algatocín;795;409;386;2016
29;Málaga;007;Alhaurín de la Torre;38794;19309;19485;2016
29;Málaga;008;Alhaurín el Grande;24315;12157;12158;2016
29;Málaga;009;Almáchar;1835;945;890;2016
29;Málaga;010;Almargen;2046;1046;1000;2016
29;Málaga;011;Almogía;3786;1940;1846;2016
29;Málaga;012;Álora;12941;6528;6413;2016
29;Málaga;013;Alozaina;2030;1023;1007;2016
29;Málaga;014;Alpandeire;246;125;121;2016
29;Málaga;015;Antequera;41065;20192;20873;2016
29;Málaga;016;Árchez;428;215;213;2016
29;Málaga;017;Archidona;8499;4330;4169;2016
29;Málaga;018;Ardales;2507;1271;1236;2016
29;Málaga;019;Arenas;1205;627;578;2016
29;Málaga;020;Arriate;4114;2029;2085;2016
29;Málaga;021;Atajate;171;90;81;2016
29;Málaga;022;Benadalid;232;117;115;2016
29;Málaga;023;Benahavís;7342;3686;3656;2016
29;Málaga;024;Benalauría;456;241;215;2016
29;Málaga;025;Benalmádena;67245;33273;33972;2016
29;Málaga;026;Benamargosa;1558;802;756;2016
29;Málaga;027;Benamocarra;2999;1514;1485;2016
29;Málaga;028;Benaoján;1491;777;714;2016
29;Málaga;029;Benarrabá;493;248;245;2016
29;Málaga;030;Borge, El;960;498;462;2016
29;Málaga;031;Burgo, El;1871;950;921;2016
29;Málaga;032;Campillos;8511;4268;4243;2016
29;Málaga;033;Canillas de Aceituno;1710;908;802;2016
29;Málaga;034;Canillas de Albaida;773;387;386;2016
29;Málaga;035;Cañete la Real;1710;862;848;2016
29;Málaga;036;Carratraca;750;383;367;2016
29;Málaga;037;Cartajima;241;126;115;2016
29;Málaga;038;Cártama;24824;12568;12256;2016
29;Málaga;039;Casabermeja;3443;1818;1625;2016
29;Málaga;040;Casarabonela;2573;1363;1210;2016
29;Málaga;041;Casares;5795;2977;2818;2016
29;Málaga;042;Coín;21456;10790;10666;2016
29;Málaga;043;Colmenar;3385;1743;1642;2016
29;Málaga;044;Comares;1348;730;618;2016
29;Málaga;045;Cómpeta;3705;1872;1833;2016
29;Málaga;046;Cortes de la Frontera;3277;1684;1593;2016
29;Málaga;047;Cuevas Bajas;1430;711;719;2016
29;Málaga;049;Cuevas de San Marcos;3776;1902;1874;2016
29;Málaga;048;Cuevas del Becerro;1618;798;820;2016
29;Málaga;050;Cútar;598;302;296;2016
29;Málaga;051;Estepona;66683;32955;33728;2016
29;Málaga;052;Faraján;265;131;134;2016
29;Málaga;053;Frigiliana;3039;1530;1509;2016
29;Málaga;054;Fuengirola;77486;38004;39482;2016
29;Málaga;055;Fuente de Piedra;2525;1300;1225;2016
29;Málaga;056;Gaucín;1620;847;773;2016
29;Málaga;057;Genalguacil;424;219;205;2016
29;Málaga;058;Guaro;2047;1041;1006;2016
29;Málaga;059;Humilladero;3311;1658;1653;2016
29;Málaga;060;Igualeja;793;407;386;2016
29;Málaga;061;Istán;1399;705;694;2016
29;Málaga;062;Iznate;874;448;426;2016
29;Málaga;063;Jimera de Líbar;409;212;197;2016
29;Málaga;064;Jubrique;634;320;314;2016
29;Málaga;065;Júzcar;228;131;97;2016
29;Málaga;066;Macharaviaya;461;248;213;2016
29;Málaga;067;Málaga;569009;273715;295294;2016
29;Málaga;068;Manilva;14750;7560;7190;2016
29;Málaga;069;Marbella;140744;68050;72694;2016
29;Málaga;070;Mijas;77769;38923;38846;2016
29;Málaga;071;Moclinejo;1217;634;583;2016
29;Málaga;072;Mollina;4913;2461;2452;2016
29;Málaga;073;Monda;2400;1221;1179;2016
29;Málaga;903;Montecorto;640;331;309;2016
29;Málaga;074;Montejaque;1011;497;514;2016
29;Málaga;075;Nerja;21204;10488;10716;2016
29;Málaga;076;Ojén;3385;1716;1669;2016
29;Málaga;077;Parauta;230;112;118;2016
29;Málaga;079;Periana;3149;1647;1502;2016
29;Málaga;080;Pizarra;9106;4608;4498;2016
29;Málaga;081;Pujerra;305;157;148;2016
29;Málaga;082;Rincón de la Victoria;44003;21614;22389;2016
29;Málaga;083;Riogordo;2812;1469;1343;2016
29;Málaga;084;Ronda;34381;16762;17619;2016
29;Málaga;085;Salares;181;93;88;2016
29;Málaga;086;Sayalonga;1628;841;787;2016
29;Málaga;087;Sedella;625;354;271;2016
29;Málaga;904;Serrato;503;253;250;2016
29;Málaga;088;Sierra de Yeguas;3370;1693;1677;2016
29;Málaga;089;Teba;3912;1973;1939;2016
29;Málaga;090;Tolox;2093;1054;1039;2016
29;Málaga;901;Torremolinos;67786;33870;33916;2016
29;Málaga;091;Torrox;15098;7708;7390;2016
29;Málaga;092;Totalán;707;370;337;2016
29;Málaga;093;Valle de Abdalajís;2603;1320;1283;2016
29;Málaga;094;Vélez-Málaga;78890;39114;39776;2016
29;Málaga;095;Villanueva de Algaidas;4325;2233;2092;2016
29;Málaga;902;Villanueva de la Concepción;3304;1610;1694;2016
29;Málaga;098;Villanueva de Tapia;1531;776;755;2016
29;Málaga;096;Villanueva del Rosario;3465;1692;1773;2016
29;Málaga;097;Villanueva del Trabuco;5313;2657;2656;2016
29;Málaga;099;Viñuela;2009;1035;974;2016
29;Málaga;100;Yunquera;2948;1506;1442;2016
30;Murcia;001;Abanilla;6184;3143;3041;2016
30;Murcia;002;Abarán;13183;6640;6543;2016
30;Murcia;003;Águilas;34706;17348;17358;2016
30;Murcia;004;Albudeite;1378;697;681;2016
30;Murcia;005;Alcantarilla;41155;20305;20850;2016
30;Murcia;902;Alcázares, Los;15289;7725;7564;2016
30;Murcia;006;Aledo;941;466;475;2016
30;Murcia;007;Alguazas;9613;4986;4627;2016
30;Murcia;008;Alhama de Murcia;21308;10786;10522;2016
30;Murcia;009;Archena;18734;9758;8976;2016
30;Murcia;010;Beniel;11114;5707;5407;2016
30;Murcia;011;Blanca;6521;3322;3199;2016
30;Murcia;012;Bullas;11714;5907;5807;2016
30;Murcia;013;Calasparra;10268;5231;5037;2016
30;Murcia;014;Campos del Río;2003;957;1046;2016
30;Murcia;015;Caravaca de la Cruz;25591;12803;12788;2016
30;Murcia;016;Cartagena;214759;107344;107415;2016
30;Murcia;017;Cehegín;15321;7685;7636;2016
30;Murcia;018;Ceutí;11321;5682;5639;2016
30;Murcia;019;Cieza;35134;17689;17445;2016
30;Murcia;020;Fortuna;9960;5325;4635;2016
30;Murcia;021;Fuente Álamo de Murcia;16205;8427;7778;2016
30;Murcia;022;Jumilla;25362;13174;12188;2016
30;Murcia;023;Librilla;5107;2607;2500;2016
30;Murcia;024;Lorca;91730;46949;44781;2016
30;Murcia;025;Lorquí;6969;3536;3433;2016
30;Murcia;026;Mazarrón;30704;15835;14869;2016
30;Murcia;027;Molina de Segura;69614;34700;34914;2016
30;Murcia;028;Moratalla;8145;4153;3992;2016
30;Murcia;029;Mula;16689;8526;8163;2016
30;Murcia;030;Murcia;441003;215535;225468;2016
30;Murcia;031;Ojós;497;266;231;2016
30;Murcia;032;Pliego;3933;2031;1902;2016
30;Murcia;033;Puerto Lumbreras;14874;7457;7417;2016
30;Murcia;034;Ricote;1332;701;631;2016
30;Murcia;035;San Javier;31782;16030;15752;2016
30;Murcia;036;San Pedro del Pinatar;24660;12441;12219;2016
30;Murcia;901;Santomera;15952;8081;7871;2016
30;Murcia;037;Torre-Pacheco;34630;18039;16591;2016
30;Murcia;038;Torres de Cotillas, Las;21341;10809;10532;2016
30;Murcia;039;Totana;30981;15962;15019;2016
30;Murcia;040;Ulea;913;476;437;2016
30;Murcia;041;Unión, La;19630;9966;9664;2016
30;Murcia;042;Villanueva del Río Segura;2560;1284;1276;2016
30;Murcia;043;Yecla;34037;17064;16973;2016
31;Navarra;001;Abáigar;90;50;40;2016
31;Navarra;002;Abárzuza/Abartzuza;532;266;266;2016
31;Navarra;003;Abaurregaina/Abaurrea Alta;127;78;49;2016
31;Navarra;004;Abaurrepea/Abaurrea Baja;35;22;13;2016
31;Navarra;005;Aberin;376;203;173;2016
31;Navarra;006;Ablitas;2494;1270;1224;2016
31;Navarra;007;Adiós;155;86;69;2016
31;Navarra;008;Aguilar de Codés;78;42;36;2016
31;Navarra;009;Aibar/Oibar;802;427;375;2016
31;Navarra;011;Allín/Allin;854;461;393;2016
31;Navarra;012;Allo;1003;505;498;2016
31;Navarra;010;Altsasu/Alsasua;7471;3773;3698;2016
31;Navarra;013;Améscoa Baja;764;403;361;2016
31;Navarra;014;Ancín/Antzin;362;199;163;2016
31;Navarra;015;Andosilla;2772;1417;1355;2016
31;Navarra;016;Ansoáin/Antsoain;10817;5346;5471;2016
31;Navarra;017;Anue;473;256;217;2016
31;Navarra;018;Añorbe;537;292;245;2016
31;Navarra;019;Aoiz/Agoitz;2564;1284;1280;2016
31;Navarra;020;Araitz;529;296;233;2016
31;Navarra;025;Arakil;952;490;462;2016
31;Navarra;021;Aranarache/Aranaratxe;71;41;30;2016
31;Navarra;023;Aranguren;9801;4949;4852;2016
31;Navarra;024;Arano;109;61;48;2016
31;Navarra;022;Arantza;631;339;292;2016
31;Navarra;026;Aras;168;91;77;2016
31;Navarra;027;Arbizu;1117;569;548;2016
31;Navarra;028;Arce/Artzi;260;138;122;2016
31;Navarra;029;Arcos, Los;1119;555;564;2016
31;Navarra;030;Arellano;163;89;74;2016
31;Navarra;031;Areso;263;136;127;2016
31;Navarra;032;Arguedas;2277;1171;1106;2016
31;Navarra;033;Aria;52;31;21;2016
31;Navarra;034;Aribe;42;21;21;2016
31;Navarra;035;Armañanzas;64;37;27;2016
31;Navarra;036;Arróniz;1045;551;494;2016
31;Navarra;037;Arruazu;106;57;49;2016
31;Navarra;038;Artajona;1670;860;810;2016
31;Navarra;039;Artazu;105;54;51;2016
31;Navarra;040;Atez/Atetz;235;134;101;2016
31;Navarra;058;Auritz/Burguete;243;124;119;2016
31;Navarra;041;Ayegui/Aiegi;2241;1171;1070;2016
31;Navarra;042;Azagra;3818;1952;1866;2016
31;Navarra;043;Azuelo;37;15;22;2016
31;Navarra;044;Bakaiku;349;183;166;2016
31;Navarra;901;Barañain;20325;9859;10466;2016
31;Navarra;045;Barásoain;660;349;311;2016
31;Navarra;046;Barbarin;62;30;32;2016
31;Navarra;047;Bargota;284;140;144;2016
31;Navarra;048;Barillas;221;122;99;2016
31;Navarra;049;Basaburua;850;489;361;2016
31;Navarra;050;Baztan;7719;3906;3813;2016
31;Navarra;137;Beintza-Labaien;235;136;99;2016
31;Navarra;051;Beire;301;153;148;2016
31;Navarra;052;Belascoáin;124;65;59;2016
31;Navarra;250;Bera;3765;1880;1885;2016
31;Navarra;053;Berbinzana;629;325;304;2016
31;Navarra;905;Beriáin;3890;1898;1992;2016
31;Navarra;902;Berrioplano/Berriobeiti;6731;3414;3317;2016
31;Navarra;903;Berriozar;9756;4973;4783;2016
31;Navarra;054;Bertizarana;600;305;295;2016
31;Navarra;055;Betelu;345;182;163;2016
31;Navarra;253;Bidaurreta;166;91;75;2016
31;Navarra;056;Biurrun-Olcoz;216;121;95;2016
31;Navarra;057;Buñuel;2258;1098;1160;2016
31;Navarra;059;Burgui/Burgi;216;125;91;2016
31;Navarra;060;Burlada/Burlata;18338;8905;9433;2016
31;Navarra;061;Busto, El;63;32;31;2016
31;Navarra;062;Cabanillas;1393;731;662;2016
31;Navarra;063;Cabredo;107;60;47;2016
31;Navarra;064;Cadreita;2066;1095;971;2016
31;Navarra;065;Caparroso;2677;1385;1292;2016
31;Navarra;066;Cárcar;1049;534;515;2016
31;Navarra;067;Carcastillo;2476;1251;1225;2016
31;Navarra;068;Cascante;3772;1861;1911;2016
31;Navarra;069;Cáseda;969;475;494;2016
31;Navarra;070;Castejón;4093;2043;2050;2016
31;Navarra;071;Castillonuevo;17;13;4;2016
31;Navarra;193;Cendea de Olza/Oltza Zendea;1833;919;914;2016
31;Navarra;072;Cintruénigo;7779;3993;3786;2016
31;Navarra;074;Cirauqui/Zirauki;476;256;220;2016
31;Navarra;075;Ciriza/Ziritza;137;64;73;2016
31;Navarra;076;Cizur;3761;1922;1839;2016
31;Navarra;077;Corella;7642;3882;3760;2016
31;Navarra;078;Cortes;3163;1601;1562;2016
31;Navarra;079;Desojo;80;44;36;2016
31;Navarra;080;Dicastillo;624;327;297;2016
31;Navarra;081;Donamaria;453;226;227;2016
31;Navarra;221;Doneztebe/Santesteban;1700;870;830;2016
31;Navarra;083;Echarri;77;39;38;2016
31;Navarra;087;Elgorriaga;212;103;109;2016
31;Navarra;089;Enériz/Eneritz;318;159;159;2016
31;Navarra;090;Eratsun;151;91;60;2016
31;Navarra;091;Ergoiena;399;216;183;2016
31;Navarra;092;Erro;789;443;346;2016
31;Navarra;094;Eslava;120;61;59;2016
31;Navarra;095;Esparza de Salazar/Espartza Zaraitzu;82;44;38;2016
31;Navarra;096;Espronceda;117;68;49;2016
31;Navarra;097;Estella-Lizarra;13668;6571;7097;2016
31;Navarra;098;Esteribar;2590;1344;1246;2016
31;Navarra;099;Etayo;76;41;35;2016
31;Navarra;082;Etxalar;804;434;370;2016
31;Navarra;084;Etxarri Aranatz;2456;1277;1179;2016
31;Navarra;085;Etxauri;603;318;285;2016
31;Navarra;100;Eulate;297;164;133;2016
31;Navarra;101;Ezcabarte;1815;953;862;2016
31;Navarra;093;Ezcároz/Ezkaroze;319;173;146;2016
31;Navarra;102;Ezkurra;149;98;51;2016
31;Navarra;103;Ezprogui;48;24;24;2016
31;Navarra;104;Falces;2335;1174;1161;2016
31;Navarra;105;Fitero;1996;1002;994;2016
31;Navarra;106;Fontellas;973;494;479;2016
31;Navarra;107;Funes;2461;1318;1143;2016
31;Navarra;108;Fustiñana;2501;1239;1262;2016
31;Navarra;109;Galar;2146;1129;1017;2016
31;Navarra;110;Gallipienzo/Galipentzu;104;59;45;2016
31;Navarra;111;Gallués/Galoze;107;67;40;2016
31;Navarra;112;Garaioa;94;52;42;2016
31;Navarra;113;Garde;150;92;58;2016
31;Navarra;114;Garínoain;479;259;220;2016
31;Navarra;115;Garralda;181;96;85;2016
31;Navarra;116;Genevilla;73;43;30;2016
31;Navarra;117;Goizueta;720;389;331;2016
31;Navarra;118;Goñi;164;105;59;2016
31;Navarra;119;Güesa/Gorza;43;24;19;2016
31;Navarra;120;Guesálaz/Gesalatz;444;260;184;2016
31;Navarra;121;Guirguillano;75;39;36;2016
31;Navarra;256;Hiriberri/Villanueva de Aezkoa;115;62;53;2016
31;Navarra;122;Huarte/Uharte;6895;3472;3423;2016
31;Navarra;124;Ibargoiti;248;147;101;2016
31;Navarra;259;Igantzi;606;318;288;2016
31;Navarra;125;Igúzquiza;333;171;162;2016
31;Navarra;126;Imotz;433;230;203;2016
31;Navarra;127;Irañeta;176;97;79;2016
31;Navarra;904;Irurtzun;2187;1125;1062;2016
31;Navarra;128;Isaba/Izaba;439;214;225;2016
31;Navarra;129;Ituren;525;271;254;2016
31;Navarra;130;Iturmendi;398;206;192;2016
31;Navarra;131;Iza/Itza;1213;642;571;2016
31;Navarra;132;Izagaondoa;176;114;62;2016
31;Navarra;133;Izalzu/Itzaltzu;50;30;20;2016
31;Navarra;134;Jaurrieta;196;109;87;2016
31;Navarra;135;Javier;107;37;70;2016
31;Navarra;136;Juslapeña;561;298;263;2016
31;Navarra;138;Lakuntza;1263;658;605;2016
31;Navarra;139;Lana;174;100;74;2016
31;Navarra;140;Lantz;153;89;64;2016
31;Navarra;141;Lapoblación;125;70;55;2016
31;Navarra;142;Larraga;2068;1105;963;2016
31;Navarra;143;Larraona;110;54;56;2016
31;Navarra;144;Larraun;985;536;449;2016
31;Navarra;145;Lazagurría;204;102;102;2016
31;Navarra;146;Leache/Leatxe;40;25;15;2016
31;Navarra;147;Legarda;110;60;50;2016
31;Navarra;148;Legaria;103;43;60;2016
31;Navarra;149;Leitza;2857;1496;1361;2016
31;Navarra;908;Lekunberri;1452;721;731;2016
31;Navarra;150;Leoz/Leotz;243;153;90;2016
31;Navarra;151;Lerga;73;42;31;2016
31;Navarra;152;Lerín;1673;853;820;2016
31;Navarra;153;Lesaka;2733;1407;1326;2016
31;Navarra;154;Lezáun;262;152;110;2016
31;Navarra;155;Liédena;303;157;146;2016
31;Navarra;156;Lizoáin-Arriasgoiti;305;181;124;2016
31;Navarra;157;Lodosa;4738;2392;2346;2016
31;Navarra;158;Lónguida/Longida;309;164;145;2016
31;Navarra;159;Lumbier;1318;702;616;2016
31;Navarra;160;Luquin;130;69;61;2016
31;Navarra;248;Luzaide/Valcarlos;390;231;159;2016
31;Navarra;161;Mañeru;419;221;198;2016
31;Navarra;162;Marañón;53;26;27;2016
31;Navarra;163;Marcilla;2821;1411;1410;2016
31;Navarra;164;Mélida;728;379;349;2016
31;Navarra;165;Mendavia;3612;1853;1759;2016
31;Navarra;166;Mendaza;308;160;148;2016
31;Navarra;167;Mendigorría;1053;549;504;2016
31;Navarra;168;Metauten;300;168;132;2016
31;Navarra;169;Milagro;3289;1725;1564;2016
31;Navarra;170;Mirafuentes;56;25;31;2016
31;Navarra;171;Miranda de Arga;845;446;399;2016
31;Navarra;172;Monreal/Elo;480;257;223;2016
31;Navarra;173;Monteagudo;1073;538;535;2016
31;Navarra;174;Morentin;133;68;65;2016
31;Navarra;175;Mues;84;44;40;2016
31;Navarra;176;Murchante;3906;1947;1959;2016
31;Navarra;177;Murieta;335;181;154;2016
31;Navarra;178;Murillo el Cuende;670;347;323;2016
31;Navarra;179;Murillo el Fruto;614;314;300;2016
31;Navarra;180;Muruzábal;257;112;145;2016
31;Navarra;181;Navascués/Nabaskoze;147;85;62;2016
31;Navarra;182;Nazar;43;25;18;2016
31;Navarra;088;Noáin (Valle de Elorz)/Noain (Elortzibar);8012;4029;3983;2016
31;Navarra;183;Obanos;923;458;465;2016
31;Navarra;185;Ochagavía/Otsagabia;543;282;261;2016
31;Navarra;184;Oco;76;39;37;2016
31;Navarra;186;Odieta;368;202;166;2016
31;Navarra;187;Oiz;146;86;60;2016
31;Navarra;188;Olaibar;334;189;145;2016
31;Navarra;189;Olazti/Olazagutía;1522;786;736;2016
31;Navarra;190;Olejua;52;29;23;2016
31;Navarra;191;Olite/Erriberri;3915;1967;1948;2016
31;Navarra;194;Ollo;406;218;188;2016
31;Navarra;192;Olóriz/Oloritz;200;113;87;2016
31;Navarra;195;Orbaizeta;205;102;103;2016
31;Navarra;196;Orbara;40;21;19;2016
31;Navarra;197;Orísoain;90;48;42;2016
31;Navarra;906;Orkoien;3802;1904;1898;2016
31;Navarra;198;Oronz/Orontze;46;25;21;2016
31;Navarra;199;Oroz-Betelu/Orotz-Betelu;153;88;65;2016
31;Navarra;211;Orreaga/Roncesvalles;34;18;16;2016
31;Navarra;200;Oteiza;939;497;442;2016
31;Navarra;201;Pamplona/Iruña;195650;92949;102701;2016
31;Navarra;202;Peralta/Azkoien;5837;2926;2911;2016
31;Navarra;203;Petilla de Aragón;35;20;15;2016
31;Navarra;204;Piedramillera;37;24;13;2016
31;Navarra;205;Pitillas;494;246;248;2016
31;Navarra;206;Puente la Reina/Gares;2807;1436;1371;2016
31;Navarra;207;Pueyo;339;183;156;2016
31;Navarra;208;Ribaforada;3704;1905;1799;2016
31;Navarra;209;Romanzado;184;100;84;2016
31;Navarra;210;Roncal/Erronkari;210;113;97;2016
31;Navarra;212;Sada;155;84;71;2016
31;Navarra;213;Saldías;115;68;47;2016
31;Navarra;214;Salinas de Oro/Jaitz;117;65;52;2016
31;Navarra;215;San Adrián;6225;3086;3139;2016
31;Navarra;217;San Martín de Unx;370;191;179;2016
31;Navarra;216;Sangüesa/Zangoza;5002;2543;2459;2016
31;Navarra;219;Sansol;103;55;48;2016
31;Navarra;220;Santacara;895;465;430;2016
31;Navarra;222;Sarriés/Sartze;63;40;23;2016
31;Navarra;223;Sartaguda;1362;699;663;2016
31;Navarra;224;Sesma;1164;592;572;2016
31;Navarra;225;Sorlada;54;30;24;2016
31;Navarra;226;Sunbilla;670;346;324;2016
31;Navarra;227;Tafalla;10660;5260;5400;2016
31;Navarra;228;Tiebas-Muruarte de Reta;609;310;299;2016
31;Navarra;229;Tirapu;51;31;20;2016
31;Navarra;230;Torralba del Río;115;61;54;2016
31;Navarra;231;Torres del Río;131;63;68;2016
31;Navarra;232;Tudela;35170;17297;17873;2016
31;Navarra;233;Tulebras;126;58;68;2016
31;Navarra;234;Ucar;175;98;77;2016
31;Navarra;123;Uharte Arakil;834;438;396;2016
31;Navarra;235;Ujué;178;104;74;2016
31;Navarra;236;Ultzama;1667;868;799;2016
31;Navarra;237;Unciti;220;128;92;2016
31;Navarra;238;Unzué/Untzue;129;72;57;2016
31;Navarra;239;Urdazubi/Urdax;399;194;205;2016
31;Navarra;240;Urdiain;671;356;315;2016
31;Navarra;241;Urraul Alto;156;97;59;2016
31;Navarra;242;Urraul Bajo;303;135;168;2016
31;Navarra;244;Urroz;188;105;83;2016
31;Navarra;243;Urroz-Villa;389;204;185;2016
31;Navarra;245;Urzainqui/Urzainki;92;54;38;2016
31;Navarra;246;Uterga;163;95;68;2016
31;Navarra;247;Uztárroz/Uztarroze;148;72;76;2016
31;Navarra;086;Valle de Egüés/Eguesibar;20046;10123;9923;2016
31;Navarra;260;Valle de Yerri/Deierri;1510;776;734;2016
31;Navarra;249;Valtierra;2414;1192;1222;2016
31;Navarra;251;Viana;4025;2047;1978;2016
31;Navarra;252;Vidángoz/Bidankoze;93;50;43;2016
31;Navarra;254;Villafranca;2849;1424;1425;2016
31;Navarra;255;Villamayor de Monjardín;121;64;57;2016
31;Navarra;257;Villatuerta;1154;579;575;2016
31;Navarra;258;Villava/Atarrabia;10317;5056;5261;2016
31;Navarra;261;Yesa;298;170;128;2016
31;Navarra;262;Zabalza/Zabaltza;289;155;134;2016
31;Navarra;073;Ziordia;354;184;170;2016
31;Navarra;907;Zizur Mayor/Zizur Nagusia;14612;7207;7405;2016
31;Navarra;263;Zubieta;311;163;148;2016
31;Navarra;264;Zugarramurdi;237;121;116;2016
31;Navarra;265;Zúñiga;110;69;41;2016
32;Ourense;001;Allariz;5982;2976;3006;2016
32;Ourense;002;Amoeiro;2264;1121;1143;2016
32;Ourense;003;Arnoia, A;1002;499;503;2016
32;Ourense;004;Avión;1910;886;1024;2016
32;Ourense;005;Baltar;986;520;466;2016
32;Ourense;006;Bande;1668;813;855;2016
32;Ourense;007;Baños de Molgas;1648;816;832;2016
32;Ourense;008;Barbadás;10638;5184;5454;2016
32;Ourense;009;Barco de Valdeorras, O;13761;6692;7069;2016
32;Ourense;010;Beade;427;229;198;2016
32;Ourense;011;Beariz;1003;440;563;2016
32;Ourense;012;Blancos, Os;850;466;384;2016
32;Ourense;013;Boborás;2443;1136;1307;2016
32;Ourense;014;Bola, A;1270;601;669;2016
32;Ourense;015;Bolo, O;963;486;477;2016
32;Ourense;016;Calvos de Randín;856;413;443;2016
32;Ourense;018;Carballeda de Avia;1381;675;706;2016
32;Ourense;017;Carballeda de Valdeorras;1664;858;806;2016
32;Ourense;019;Carballiño, O;13913;6531;7382;2016
32;Ourense;020;Cartelle;2757;1341;1416;2016
32;Ourense;022;Castrelo de Miño;1490;752;738;2016
32;Ourense;021;Castrelo do Val;1067;547;520;2016
32;Ourense;023;Castro Caldelas;1313;664;649;2016
32;Ourense;024;Celanova;5508;2626;2882;2016
32;Ourense;025;Cenlle;1196;576;620;2016
32;Ourense;029;Chandrexa de Queixa;506;283;223;2016
32;Ourense;026;Coles;3126;1570;1556;2016
32;Ourense;027;Cortegada;1151;561;590;2016
32;Ourense;028;Cualedro;1792;911;881;2016
32;Ourense;030;Entrimo;1209;574;635;2016
32;Ourense;031;Esgos;1194;600;594;2016
32;Ourense;033;Gomesende;798;381;417;2016
32;Ourense;034;Gudiña, A;1345;699;646;2016
32;Ourense;035;Irixo, O;1546;738;808;2016
32;Ourense;038;Larouco;487;229;258;2016
32;Ourense;039;Laza;1377;713;664;2016
32;Ourense;040;Leiro;1642;800;842;2016
32;Ourense;041;Lobeira;809;392;417;2016
32;Ourense;042;Lobios;1868;940;928;2016
32;Ourense;043;Maceda;2938;1444;1494;2016
32;Ourense;044;Manzaneda;947;467;480;2016
32;Ourense;045;Maside;2818;1373;1445;2016
32;Ourense;046;Melón;1280;613;667;2016
32;Ourense;047;Merca, A;1976;966;1010;2016
32;Ourense;048;Mezquita, A;1070;557;513;2016
32;Ourense;049;Montederramo;791;402;389;2016
32;Ourense;050;Monterrei;2713;1383;1330;2016
32;Ourense;051;Muíños;1572;794;778;2016
32;Ourense;052;Nogueira de Ramuín;2075;1045;1030;2016
32;Ourense;053;Oímbra;1894;1040;854;2016
32;Ourense;054;Ourense;105893;48295;57598;2016
32;Ourense;055;Paderne de Allariz;1439;703;736;2016
32;Ourense;056;Padrenda;1893;910;983;2016
32;Ourense;057;Parada de Sil;592;321;271;2016
32;Ourense;058;Pereiro de Aguiar, O;6255;3220;3035;2016
32;Ourense;059;Peroxa, A;1948;961;987;2016
32;Ourense;060;Petín;957;473;484;2016
32;Ourense;061;Piñor;1212;605;607;2016
32;Ourense;063;Pobra de Trives, A;2191;1094;1097;2016
32;Ourense;064;Pontedeva;588;291;297;2016
32;Ourense;062;Porqueira;859;419;440;2016
32;Ourense;065;Punxín;729;354;375;2016
32;Ourense;066;Quintela de Leirado;616;275;341;2016
32;Ourense;067;Rairiz de Veiga;1394;710;684;2016
32;Ourense;068;Ramirás;1571;718;853;2016
32;Ourense;069;Ribadavia;5068;2454;2614;2016
32;Ourense;071;Riós;1646;826;820;2016
32;Ourense;072;Rúa, A;4530;2228;2302;2016
32;Ourense;073;Rubiá;1448;709;739;2016
32;Ourense;074;San Amaro;1141;551;590;2016
32;Ourense;075;San Cibrao das Viñas;5113;2596;2517;2016
32;Ourense;076;San Cristovo de Cea;2303;1136;1167;2016
32;Ourense;070;San Xoán de Río;583;276;307;2016
32;Ourense;077;Sandiás;1286;595;691;2016
32;Ourense;078;Sarreaus;1259;636;623;2016
32;Ourense;079;Taboadela;1475;757;718;2016
32;Ourense;080;Teixeira, A;368;185;183;2016
32;Ourense;081;Toén;2395;1228;1167;2016
32;Ourense;082;Trasmiras;1365;685;680;2016
32;Ourense;083;Veiga, A;923;466;457;2016
32;Ourense;084;Verea;983;476;507;2016
32;Ourense;085;Verín;14031;6775;7256;2016
32;Ourense;086;Viana do Bolo;2982;1497;1485;2016
32;Ourense;087;Vilamarín;1996;1010;986;2016
32;Ourense;088;Vilamartín de Valdeorras;1798;928;870;2016
32;Ourense;089;Vilar de Barrio;1394;709;685;2016
32;Ourense;090;Vilar de Santos;858;417;441;2016
32;Ourense;091;Vilardevós;2036;1060;976;2016
32;Ourense;092;Vilariño de Conso;586;333;253;2016
32;Ourense;032;Xinzo de Limia;10004;4882;5122;2016
32;Ourense;036;Xunqueira de Ambía;1461;743;718;2016
32;Ourense;037;Xunqueira de Espadanedo;800;396;404;2016
34;Palencia;001;Abarca de Campos;36;23;13;2016
34;Palencia;003;Abia de las Torres;181;100;81;2016
34;Palencia;004;Aguilar de Campoo;6979;3394;3585;2016
34;Palencia;005;Alar del Rey;982;484;498;2016
34;Palencia;006;Alba de Cerrato;83;46;37;2016
34;Palencia;009;Amayuelas de Arriba;39;25;14;2016
34;Palencia;010;Ampudia;651;339;312;2016
34;Palencia;011;Amusco;439;240;199;2016
34;Palencia;012;Antigüedad;384;206;178;2016
34;Palencia;015;Arconada;44;25;19;2016
34;Palencia;017;Astudillo;1004;508;496;2016
34;Palencia;018;Autilla del Pino;231;125;106;2016
34;Palencia;019;Autillo de Campos;146;72;74;2016
34;Palencia;020;Ayuela;54;33;21;2016
34;Palencia;022;Baltanás;1248;656;592;2016
34;Palencia;024;Baquerín de Campos;40;28;12;2016
34;Palencia;025;Bárcena de Campos;62;29;33;2016
34;Palencia;027;Barruelo de Santullán;1235;610;625;2016
34;Palencia;028;Báscones de Ojeda;147;80;67;2016
34;Palencia;029;Becerril de Campos;792;410;382;2016
34;Palencia;031;Belmonte de Campos;32;17;15;2016
34;Palencia;032;Berzosilla;43;23;20;2016
34;Palencia;033;Boada de Campos;18;12;6;2016
34;Palencia;035;Boadilla de Rioseco;122;68;54;2016
34;Palencia;034;Boadilla del Camino;123;68;55;2016
34;Palencia;036;Brañosera;245;141;104;2016
34;Palencia;037;Buenavista de Valdavia;296;163;133;2016
34;Palencia;038;Bustillo de la Vega;313;171;142;2016
34;Palencia;039;Bustillo del Páramo de Carrión;63;37;26;2016
34;Palencia;041;Calahorra de Boedo;94;47;47;2016
34;Palencia;042;Calzada de los Molinos;340;188;152;2016
34;Palencia;045;Capillas;78;40;38;2016
34;Palencia;046;Cardeñosa de Volpejera;44;24;20;2016
34;Palencia;047;Carrión de los Condes;2150;1029;1121;2016
34;Palencia;048;Castil de Vela;69;36;33;2016
34;Palencia;049;Castrejón de la Peña;387;212;175;2016
34;Palencia;050;Castrillo de Don Juan;235;129;106;2016
34;Palencia;051;Castrillo de Onielo;109;58;51;2016
34;Palencia;052;Castrillo de Villavega;192;105;87;2016
34;Palencia;053;Castromocho;226;123;103;2016
34;Palencia;055;Cervatos de la Cueza;287;164;123;2016
34;Palencia;056;Cervera de Pisuerga;2399;1194;1205;2016
34;Palencia;057;Cevico de la Torre;503;252;251;2016
34;Palencia;058;Cevico Navero;202;112;90;2016
34;Palencia;059;Cisneros;459;228;231;2016
34;Palencia;060;Cobos de Cerrato;142;79;63;2016
34;Palencia;061;Collazos de Boedo;112;60;52;2016
34;Palencia;062;Congosto de Valdavia;180;110;70;2016
34;Palencia;063;Cordovilla la Real;99;59;40;2016
34;Palencia;066;Cubillas de Cerrato;62;35;27;2016
34;Palencia;067;Dehesa de Montejo;136;78;58;2016
34;Palencia;068;Dehesa de Romanos;40;25;15;2016
34;Palencia;069;Dueñas;2697;1370;1327;2016
34;Palencia;070;Espinosa de Cerrato;171;85;86;2016
34;Palencia;071;Espinosa de Villagonzalo;195;103;92;2016
34;Palencia;072;Frechilla;162;79;83;2016
34;Palencia;073;Fresno del Río;194;95;99;2016
34;Palencia;074;Frómista;804;411;393;2016
34;Palencia;076;Fuentes de Nava;676;347;329;2016
34;Palencia;077;Fuentes de Valdepero;423;219;204;2016
34;Palencia;079;Grijota;2177;1125;1052;2016
34;Palencia;080;Guardo;6413;3200;3213;2016
34;Palencia;081;Guaza de Campos;61;36;25;2016
34;Palencia;082;Hérmedes de Cerrato;84;46;38;2016
34;Palencia;083;Herrera de Pisuerga;2118;1040;1078;2016
34;Palencia;084;Herrera de Valdecañas;145;79;66;2016
34;Palencia;086;Hontoria de Cerrato;107;55;52;2016
34;Palencia;087;Hornillos de Cerrato;137;72;65;2016
34;Palencia;088;Husillos;286;154;132;2016
34;Palencia;089;Itero de la Vega;171;95;76;2016
34;Palencia;091;Lagartos;137;78;59;2016
34;Palencia;092;Lantadilla;319;173;146;2016
34;Palencia;094;Ledigos;66;37;29;2016
34;Palencia;903;Loma de Ucieza;226;132;94;2016
34;Palencia;096;Lomas;55;35;20;2016
34;Palencia;098;Magaz de Pisuerga;966;507;459;2016
34;Palencia;099;Manquillos;75;39;36;2016
34;Palencia;100;Mantinos;159;87;72;2016
34;Palencia;101;Marcilla de Campos;40;19;21;2016
34;Palencia;102;Mazariegos;214;123;91;2016
34;Palencia;103;Mazuecos de Valdeginate;101;59;42;2016
34;Palencia;104;Melgar de Yuso;265;155;110;2016
34;Palencia;106;Meneses de Campos;116;61;55;2016
34;Palencia;107;Micieces de Ojeda;84;48;36;2016
34;Palencia;108;Monzón de Campos;630;325;305;2016
34;Palencia;109;Moratinos;61;37;24;2016
34;Palencia;110;Mudá;99;51;48;2016
34;Palencia;112;Nogal de las Huertas;50;30;20;2016
34;Palencia;113;Olea de Boedo;38;14;24;2016
34;Palencia;114;Olmos de Ojeda;203;124;79;2016
34;Palencia;116;Osornillo;60;30;30;2016
34;Palencia;901;Osorno la Mayor;1266;662;604;2016
34;Palencia;120;Palencia;79137;37350;41787;2016
34;Palencia;121;Palenzuela;207;112;95;2016
34;Palencia;122;Páramo de Boedo;99;53;46;2016
34;Palencia;123;Paredes de Nava;1932;990;942;2016
34;Palencia;124;Payo de Ojeda;62;38;24;2016
34;Palencia;125;Pedraza de Campos;92;47;45;2016
34;Palencia;126;Pedrosa de la Vega;342;186;156;2016
34;Palencia;127;Perales;97;51;46;2016
34;Palencia;904;Pernía, La;340;196;144;2016
34;Palencia;129;Pino del Río;189;118;71;2016
34;Palencia;130;Piña de Campos;228;117;111;2016
34;Palencia;131;Población de Arroyo;61;33;28;2016
34;Palencia;132;Población de Campos;137;78;59;2016
34;Palencia;133;Población de Cerrato;120;66;54;2016
34;Palencia;134;Polentinos;54;30;24;2016
34;Palencia;135;Pomar de Valdivia;463;259;204;2016
34;Palencia;136;Poza de la Vega;215;121;94;2016
34;Palencia;137;Pozo de Urama;28;18;10;2016
34;Palencia;139;Prádanos de Ojeda;191;104;87;2016
34;Palencia;140;Puebla de Valdavia, La;108;55;53;2016
34;Palencia;141;Quintana del Puente;270;148;122;2016
34;Palencia;143;Quintanilla de Onsoña;185;106;79;2016
34;Palencia;146;Reinoso de Cerrato;51;33;18;2016
34;Palencia;147;Renedo de la Vega;201;107;94;2016
34;Palencia;149;Requena de Campos;21;12;9;2016
34;Palencia;151;Respenda de la Peña;171;99;72;2016
34;Palencia;152;Revenga de Campos;161;85;76;2016
34;Palencia;154;Revilla de Collazos;76;41;35;2016
34;Palencia;155;Ribas de Campos;154;80;74;2016
34;Palencia;156;Riberos de la Cueza;57;37;20;2016
34;Palencia;157;Saldaña;3104;1569;1535;2016
34;Palencia;158;Salinas de Pisuerga;335;178;157;2016
34;Palencia;159;San Cebrián de Campos;449;247;202;2016
34;Palencia;160;San Cebrián de Mudá;156;84;72;2016
34;Palencia;161;San Cristóbal de Boedo;23;14;9;2016
34;Palencia;163;San Mamés de Campos;50;26;24;2016
34;Palencia;165;San Román de la Cuba;68;40;28;2016
34;Palencia;167;Santa Cecilia del Alcor;123;71;52;2016
34;Palencia;168;Santa Cruz de Boedo;56;33;23;2016
34;Palencia;169;Santervás de la Vega;480;270;210;2016
34;Palencia;170;Santibáñez de Ecla;65;33;32;2016
34;Palencia;171;Santibáñez de la Peña;1082;539;543;2016
34;Palencia;174;Santoyo;218;116;102;2016
34;Palencia;175;Serna, La;99;61;38;2016
34;Palencia;177;Soto de Cerrato;193;112;81;2016
34;Palencia;176;Sotobañado y Priorato;162;97;65;2016
34;Palencia;178;Tabanera de Cerrato;128;70;58;2016
34;Palencia;179;Tabanera de Valdavia;28;16;12;2016
34;Palencia;180;Támara de Campos;72;38;34;2016
34;Palencia;181;Tariego de Cerrato;515;276;239;2016
34;Palencia;182;Torquemada;1006;547;459;2016
34;Palencia;184;Torremormojón;57;31;26;2016
34;Palencia;185;Triollo;61;35;26;2016
34;Palencia;186;Valbuena de Pisuerga;50;28;22;2016
34;Palencia;189;Valdeolmillos;67;36;31;2016
34;Palencia;190;Valderrábano;55;27;28;2016
34;Palencia;192;Valde-Ucieza;103;61;42;2016
34;Palencia;196;Valle de Cerrato;91;54;37;2016
34;Palencia;902;Valle del Retortillo;188;108;80;2016
34;Palencia;199;Velilla del Río Carrión;1369;701;668;2016
34;Palencia;023;Venta de Baños;6453;3240;3213;2016
34;Palencia;201;Vertavillo;203;107;96;2016
34;Palencia;093;Vid de Ojeda, La;105;63;42;2016
34;Palencia;202;Villabasta de Valdavia;31;16;15;2016
34;Palencia;204;Villacidaler;48;29;19;2016
34;Palencia;205;Villaconancio;61;36;25;2016
34;Palencia;206;Villada;1008;501;507;2016
34;Palencia;208;Villaeles de Valdavia;54;32;22;2016
34;Palencia;210;Villahán;108;56;52;2016
34;Palencia;211;Villaherreros;199;99;100;2016
34;Palencia;213;Villalaco;61;33;28;2016
34;Palencia;214;Villalba de Guardo;198;105;93;2016
34;Palencia;215;Villalcázar de Sirga;172;92;80;2016
34;Palencia;216;Villalcón;69;40;29;2016
34;Palencia;217;Villalobón;1613;810;803;2016
34;Palencia;218;Villaluenga de la Vega;562;319;243;2016
34;Palencia;220;Villamartín de Campos;176;98;78;2016
34;Palencia;221;Villamediana;183;99;84;2016
34;Palencia;222;Villameriel;126;73;53;2016
34;Palencia;223;Villamoronta;252;146;106;2016
34;Palencia;224;Villamuera de la Cueza;47;29;18;2016
34;Palencia;225;Villamuriel de Cerrato;6427;3323;3104;2016
34;Palencia;227;Villanueva del Rebollar;79;38;41;2016
34;Palencia;228;Villanuño de Valdavia;94;55;39;2016
34;Palencia;229;Villaprovedo;69;44;25;2016
34;Palencia;230;Villarmentero de Campos;20;12;8;2016
34;Palencia;231;Villarrabé;211;112;99;2016
34;Palencia;232;Villarramiel;840;453;387;2016
34;Palencia;233;Villasarracino;135;76;59;2016
34;Palencia;234;Villasila de Valdavia;75;52;23;2016
34;Palencia;236;Villaturde;164;85;79;2016
34;Palencia;237;Villaumbrales;681;347;334;2016
34;Palencia;238;Villaviudas;387;187;200;2016
34;Palencia;240;Villerías de Campos;93;51;42;2016
34;Palencia;241;Villodre;18;10;8;2016
34;Palencia;242;Villodrigo;118;67;51;2016
34;Palencia;243;Villoldo;365;198;167;2016
34;Palencia;245;Villota del Páramo;335;191;144;2016
34;Palencia;246;Villovieco;74;40;34;2016
35;Palmas, Las;001;Agaete;5558;2766;2792;2016
35;Palmas, Las;002;Agüimes;30742;15574;15168;2016
35;Palmas, Las;020;Aldea de San Nicolás, La;7741;3946;3795;2016
35;Palmas, Las;003;Antigua;10834;5795;5039;2016
35;Palmas, Las;004;Arrecife;58537;29291;29246;2016
35;Palmas, Las;005;Artenara;1136;620;516;2016
35;Palmas, Las;006;Arucas;37299;18556;18743;2016
35;Palmas, Las;007;Betancuria;714;369;345;2016
35;Palmas, Las;008;Firgas;7465;3761;3704;2016
35;Palmas, Las;009;Gáldar;24296;12193;12103;2016
35;Palmas, Las;010;Haría;4767;2453;2314;2016
35;Palmas, Las;011;Ingenio;30340;15313;15027;2016
35;Palmas, Las;012;Mogán;21049;10914;10135;2016
35;Palmas, Las;013;Moya;7821;3969;3852;2016
35;Palmas, Las;014;Oliva, La;24508;12895;11613;2016
35;Palmas, Las;015;Pájara;19394;10093;9301;2016
35;Palmas, Las;016;Palmas de Gran Canaria, Las;378998;183816;195182;2016
35;Palmas, Las;017;Puerto del Rosario;38126;19399;18727;2016
35;Palmas, Las;018;San Bartolomé;18151;9159;8992;2016
35;Palmas, Las;019;San Bartolomé de Tirajana;53829;27991;25838;2016
35;Palmas, Las;021;Santa Brígida;18437;9166;9271;2016
35;Palmas, Las;022;Santa Lucía de Tirajana;69178;34553;34625;2016
35;Palmas, Las;023;Santa María de Guía de Gran Canaria;13970;6940;7030;2016
35;Palmas, Las;024;Teguise;21724;11031;10693;2016
35;Palmas, Las;025;Tejeda;1967;1060;907;2016
35;Palmas, Las;026;Telde;102164;50467;51697;2016
35;Palmas, Las;027;Teror;12489;6419;6070;2016
35;Palmas, Las;028;Tías;20037;10267;9770;2016
35;Palmas, Las;029;Tinajo;5924;3070;2854;2016
35;Palmas, Las;030;Tuineje;13945;7172;6773;2016
35;Palmas, Las;032;Valleseco;3861;2028;1833;2016
35;Palmas, Las;031;Valsequillo de Gran Canaria;9227;4644;4583;2016
35;Palmas, Las;033;Vega de San Mateo;7628;3903;3725;2016
35;Palmas, Las;034;Yaiza;15944;8335;7609;2016
36;Pontevedra;020;Agolada;2507;1243;1264;2016
36;Pontevedra;001;Arbo;2770;1412;1358;2016
36;Pontevedra;003;Baiona;12119;6003;6116;2016
36;Pontevedra;002;Barro;3746;1862;1884;2016
36;Pontevedra;004;Bueu;12189;5983;6206;2016
36;Pontevedra;005;Caldas de Reis;9830;4751;5079;2016
36;Pontevedra;006;Cambados;13977;6769;7208;2016
36;Pontevedra;007;Campo Lameiro;1894;902;992;2016
36;Pontevedra;008;Cangas;26584;13127;13457;2016
36;Pontevedra;009;Cañiza, A;5234;2561;2673;2016
36;Pontevedra;010;Catoira;3376;1644;1732;2016
36;Pontevedra;011;Cerdedo;1781;834;947;2016
36;Pontevedra;012;Cotobade;4290;2072;2218;2016
36;Pontevedra;013;Covelo;2528;1257;1271;2016
36;Pontevedra;014;Crecente;2131;1012;1119;2016
36;Pontevedra;015;Cuntis;4794;2262;2532;2016
36;Pontevedra;016;Dozón;1107;576;531;2016
36;Pontevedra;017;Estrada, A;20891;10048;10843;2016
36;Pontevedra;018;Forcarei;3621;1715;1906;2016
36;Pontevedra;019;Fornelos de Montes;1748;827;921;2016
36;Pontevedra;021;Gondomar;14192;7043;7149;2016
36;Pontevedra;022;Grove, O;10758;5301;5457;2016
36;Pontevedra;023;Guarda, A;10133;4937;5196;2016
36;Pontevedra;901;Illa de Arousa, A;4909;2432;2477;2016
36;Pontevedra;024;Lalín;20044;9738;10306;2016
36;Pontevedra;025;Lama, A;2587;1268;1319;2016
36;Pontevedra;026;Marín;24878;12482;12396;2016
36;Pontevedra;027;Meaño;5341;2606;2735;2016
36;Pontevedra;028;Meis;4844;2313;2531;2016
36;Pontevedra;029;Moaña;19458;9488;9970;2016
36;Pontevedra;030;Mondariz;4647;2265;2382;2016
36;Pontevedra;031;Mondariz-Balneario;614;316;298;2016
36;Pontevedra;032;Moraña;4313;2081;2232;2016
36;Pontevedra;033;Mos;15240;7546;7694;2016
36;Pontevedra;034;Neves, As;4038;1945;2093;2016
36;Pontevedra;035;Nigrán;17593;8622;8971;2016
36;Pontevedra;036;Oia;3002;1513;1489;2016
36;Pontevedra;037;Pazos de Borbén;3004;1450;1554;2016
36;Pontevedra;041;Poio;16901;8355;8546;2016
36;Pontevedra;043;Ponte Caldelas;5573;2705;2868;2016
36;Pontevedra;042;Ponteareas;22963;11186;11777;2016
36;Pontevedra;044;Pontecesures;3040;1515;1525;2016
36;Pontevedra;038;Pontevedra;82549;39080;43469;2016
36;Pontevedra;039;Porriño, O;19567;9641;9926;2016
36;Pontevedra;040;Portas;3056;1461;1595;2016
36;Pontevedra;045;Redondela;29563;14424;15139;2016
36;Pontevedra;046;Ribadumia;5105;2484;2621;2016
36;Pontevedra;047;Rodeiro;2644;1330;1314;2016
36;Pontevedra;048;Rosal, O;6349;3123;3226;2016
36;Pontevedra;049;Salceda de Caselas;8914;4452;4462;2016
36;Pontevedra;050;Salvaterra de Miño;9566;4764;4802;2016
36;Pontevedra;051;Sanxenxo;17314;8542;8772;2016
36;Pontevedra;052;Silleda;8734;4247;4487;2016
36;Pontevedra;053;Soutomaior;7251;3608;3643;2016
36;Pontevedra;054;Tomiño;13548;6813;6735;2016
36;Pontevedra;055;Tui;16966;8157;8809;2016
36;Pontevedra;056;Valga;6047;2952;3095;2016
36;Pontevedra;057;Vigo;292817;138911;153906;2016
36;Pontevedra;059;Vila de Cruces;5435;2656;2779;2016
36;Pontevedra;058;Vilaboa;6043;2943;3100;2016
36;Pontevedra;060;Vilagarcía de Arousa;37283;17894;19389;2016
36;Pontevedra;061;Vilanova de Arousa;10406;5102;5304;2016
26;Rioja, La;001;Ábalos;249;149;100;2016
26;Rioja, La;002;Agoncillo;1103;608;495;2016
26;Rioja, La;003;Aguilar del Río Alhama;498;251;247;2016
26;Rioja, La;004;Ajamil de Cameros;65;45;20;2016
26;Rioja, La;005;Albelda de Iregua;3319;1689;1630;2016
26;Rioja, La;006;Alberite;2426;1229;1197;2016
26;Rioja, La;007;Alcanadre;695;367;328;2016
26;Rioja, La;008;Aldeanueva de Ebro;2744;1435;1309;2016
26;Rioja, La;009;Alesanco;507;269;238;2016
26;Rioja, La;010;Alesón;115;67;48;2016
26;Rioja, La;011;Alfaro;9553;4808;4745;2016
26;Rioja, La;012;Almarza de Cameros;26;16;10;2016
26;Rioja, La;013;Anguciana;456;253;203;2016
26;Rioja, La;014;Anguiano;537;297;240;2016
26;Rioja, La;015;Arenzana de Abajo;244;123;121;2016
26;Rioja, La;016;Arenzana de Arriba;29;20;9;2016
26;Rioja, La;017;Arnedillo;467;232;235;2016
26;Rioja, La;018;Arnedo;14609;7251;7358;2016
26;Rioja, La;019;Arrúbal;484;257;227;2016
26;Rioja, La;020;Ausejo;815;434;381;2016
26;Rioja, La;021;Autol;4473;2227;2246;2016
26;Rioja, La;022;Azofra;200;108;92;2016
26;Rioja, La;023;Badarán;532;265;267;2016
26;Rioja, La;024;Bañares;268;137;131;2016
26;Rioja, La;026;Baños de Río Tobía;1620;812;808;2016
26;Rioja, La;025;Baños de Rioja;91;53;38;2016
26;Rioja, La;027;Berceo;170;110;60;2016
26;Rioja, La;028;Bergasa;149;81;68;2016
26;Rioja, La;029;Bergasillas Bajera;38;19;19;2016
26;Rioja, La;030;Bezares;22;11;11;2016
26;Rioja, La;031;Bobadilla;116;61;55;2016
26;Rioja, La;032;Brieva de Cameros;52;34;18;2016
26;Rioja, La;033;Briñas;203;93;110;2016
26;Rioja, La;034;Briones;807;431;376;2016
26;Rioja, La;035;Cabezón de Cameros;16;12;4;2016
26;Rioja, La;036;Calahorra;23827;11698;12129;2016
26;Rioja, La;037;Camprovín;155;87;68;2016
26;Rioja, La;038;Canales de la Sierra;91;59;32;2016
26;Rioja, La;039;Canillas de Río Tuerto;41;20;21;2016
26;Rioja, La;040;Cañas;102;58;44;2016
26;Rioja, La;041;Cárdenas;161;85;76;2016
26;Rioja, La;042;Casalarreina;1193;611;582;2016
26;Rioja, La;043;Castañares de Rioja;448;223;225;2016
26;Rioja, La;044;Castroviejo;59;36;23;2016
26;Rioja, La;045;Cellorigo;12;5;7;2016
26;Rioja, La;046;Cenicero;2013;1015;998;2016
26;Rioja, La;047;Cervera del Río Alhama;2406;1227;1179;2016
26;Rioja, La;048;Cidamón;25;13;12;2016
26;Rioja, La;049;Cihuri;207;107;100;2016
26;Rioja, La;050;Cirueña;131;85;46;2016
26;Rioja, La;051;Clavijo;294;174;120;2016
26;Rioja, La;052;Cordovín;162;79;83;2016
26;Rioja, La;053;Corera;249;133;116;2016
26;Rioja, La;054;Cornago;349;201;148;2016
26;Rioja, La;055;Corporales;43;23;20;2016
26;Rioja, La;056;Cuzcurrita de Río Tirón;506;278;228;2016
26;Rioja, La;057;Daroca de Rioja;50;34;16;2016
26;Rioja, La;058;Enciso;178;108;70;2016
26;Rioja, La;059;Entrena;1501;783;718;2016
26;Rioja, La;060;Estollo;90;59;31;2016
26;Rioja, La;061;Ezcaray;2069;1075;994;2016
26;Rioja, La;062;Foncea;96;51;45;2016
26;Rioja, La;063;Fonzaleche;146;93;53;2016
26;Rioja, La;064;Fuenmayor;3108;1574;1534;2016
26;Rioja, La;065;Galbárruli;47;31;16;2016
26;Rioja, La;066;Galilea;340;172;168;2016
26;Rioja, La;067;Gallinero de Cameros;24;16;8;2016
26;Rioja, La;068;Gimileo;114;62;52;2016
26;Rioja, La;069;Grañón;275;154;121;2016
26;Rioja, La;070;Grávalos;201;105;96;2016
26;Rioja, La;071;Haro;11324;5583;5741;2016
26;Rioja, La;072;Herce;321;173;148;2016
26;Rioja, La;073;Herramélluri;110;59;51;2016
26;Rioja, La;074;Hervías;119;59;60;2016
26;Rioja, La;075;Hormilla;443;237;206;2016
26;Rioja, La;076;Hormilleja;147;73;74;2016
26;Rioja, La;077;Hornillos de Cameros;23;12;11;2016
26;Rioja, La;078;Hornos de Moncalvillo;91;55;36;2016
26;Rioja, La;079;Huércanos;845;458;387;2016
26;Rioja, La;080;Igea;603;333;270;2016
26;Rioja, La;081;Jalón de Cameros;17;9;8;2016
26;Rioja, La;082;Laguna de Cameros;125;74;51;2016
26;Rioja, La;083;Lagunilla del Jubera;309;169;140;2016
26;Rioja, La;084;Lardero;9620;4866;4754;2016
26;Rioja, La;086;Ledesma de la Cogolla;16;12;4;2016
26;Rioja, La;087;Leiva;257;130;127;2016
26;Rioja, La;088;Leza de Río Leza;39;23;16;2016
26;Rioja, La;089;Logroño;150876;71766;79110;2016
26;Rioja, La;091;Lumbreras;169;110;59;2016
26;Rioja, La;092;Manjarrés;115;70;45;2016
26;Rioja, La;093;Mansilla de la Sierra;66;45;21;2016
26;Rioja, La;094;Manzanares de Rioja;83;50;33;2016
26;Rioja, La;095;Matute;101;50;51;2016
26;Rioja, La;096;Medrano;309;164;145;2016
26;Rioja, La;098;Munilla;105;55;50;2016
26;Rioja, La;099;Murillo de Río Leza;1683;856;827;2016
26;Rioja, La;100;Muro de Aguas;51;28;23;2016
26;Rioja, La;101;Muro en Cameros;45;27;18;2016
26;Rioja, La;102;Nájera;8144;4015;4129;2016
26;Rioja, La;103;Nalda;960;517;443;2016
26;Rioja, La;104;Navajún;14;10;4;2016
26;Rioja, La;105;Navarrete;2919;1472;1447;2016
26;Rioja, La;106;Nestares;96;53;43;2016
26;Rioja, La;107;Nieva de Cameros;92;57;35;2016
26;Rioja, La;109;Ochánduri;92;56;36;2016
26;Rioja, La;108;Ocón;280;173;107;2016
26;Rioja, La;110;Ojacastro;168;102;66;2016
26;Rioja, La;111;Ollauri;279;151;128;2016
26;Rioja, La;112;Ortigosa de Cameros;245;143;102;2016
26;Rioja, La;113;Pazuengos;35;26;9;2016
26;Rioja, La;114;Pedroso;81;55;26;2016
26;Rioja, La;115;Pinillos;19;11;8;2016
26;Rioja, La;117;Pradejón;3919;2008;1911;2016
26;Rioja, La;118;Pradillo;60;31;29;2016
26;Rioja, La;119;Préjano;234;133;101;2016
26;Rioja, La;120;Quel;1992;1049;943;2016
26;Rioja, La;121;Rabanera;28;20;8;2016
26;Rioja, La;122;Rasillo de Cameros, El;143;78;65;2016
26;Rioja, La;123;Redal, El;140;79;61;2016
26;Rioja, La;124;Ribafrecha;1003;532;471;2016
26;Rioja, La;125;Rincón de Soto;3763;1904;1859;2016
26;Rioja, La;126;Robres del Castillo;31;20;11;2016
26;Rioja, La;127;Rodezno;250;142;108;2016
26;Rioja, La;128;Sajazarra;126;64;62;2016
26;Rioja, La;129;San Asensio;1166;623;543;2016
26;Rioja, La;130;San Millán de la Cogolla;240;157;83;2016
26;Rioja, La;131;San Millán de Yécora;36;25;11;2016
26;Rioja, La;132;San Román de Cameros;139;80;59;2016
26;Rioja, La;139;San Torcuato;59;29;30;2016
26;Rioja, La;142;San Vicente de la Sonsierra;1008;525;483;2016
26;Rioja, La;134;Santa Coloma;101;61;40;2016
26;Rioja, La;135;Santa Engracia del Jubera;169;106;63;2016
26;Rioja, La;136;Santa Eulalia Bajera;115;60;55;2016
26;Rioja, La;138;Santo Domingo de la Calzada;6369;3214;3155;2016
26;Rioja, La;140;Santurde de Rioja;290;158;132;2016
26;Rioja, La;141;Santurdejo;118;74;44;2016
26;Rioja, La;143;Sojuela;278;164;114;2016
26;Rioja, La;144;Sorzano;226;128;98;2016
26;Rioja, La;145;Sotés;297;169;128;2016
26;Rioja, La;146;Soto en Cameros;101;57;44;2016
26;Rioja, La;147;Terroba;34;18;16;2016
26;Rioja, La;148;Tirgo;201;101;100;2016
26;Rioja, La;149;Tobía;57;34;23;2016
26;Rioja, La;150;Tormantos;145;84;61;2016
26;Rioja, La;153;Torre en Cameros;13;11;2;2016
26;Rioja, La;151;Torrecilla en Cameros;519;278;241;2016
26;Rioja, La;152;Torrecilla sobre Alesanco;36;22;14;2016
26;Rioja, La;154;Torremontalbo;12;7;5;2016
26;Rioja, La;155;Treviana;176;92;84;2016
26;Rioja, La;157;Tricio;374;182;192;2016
26;Rioja, La;158;Tudelilla;336;186;150;2016
26;Rioja, La;160;Uruñuela;962;485;477;2016
26;Rioja, La;161;Valdemadera;7;4;3;2016
26;Rioja, La;162;Valgañón;137;86;51;2016
26;Rioja, La;163;Ventosa;176;90;86;2016
26;Rioja, La;164;Ventrosa;59;36;23;2016
26;Rioja, La;165;Viguera;430;242;188;2016
26;Rioja, La;166;Villalba de Rioja;119;73;46;2016
26;Rioja, La;167;Villalobar de Rioja;63;46;17;2016
26;Rioja, La;168;Villamediana de Iregua;7696;3891;3805;2016
26;Rioja, La;169;Villanueva de Cameros;69;40;29;2016
26;Rioja, La;170;Villar de Arnedo, El;623;323;300;2016
26;Rioja, La;171;Villar de Torre;184;109;75;2016
26;Rioja, La;172;Villarejo;31;24;7;2016
26;Rioja, La;173;Villarroya;5;3;2;2016
26;Rioja, La;174;Villarta-Quintana;151;87;64;2016
26;Rioja, La;175;Villavelayo;52;34;18;2016
26;Rioja, La;176;Villaverde de Rioja;57;33;24;2016
26;Rioja, La;177;Villoslada de Cameros;333;206;127;2016
26;Rioja, La;178;Viniegra de Abajo;82;50;32;2016
26;Rioja, La;179;Viniegra de Arriba;42;27;15;2016
26;Rioja, La;180;Zarratón;261;146;115;2016
26;Rioja, La;181;Zarzosa;14;10;4;2016
26;Rioja, La;183;Zorraquín;90;44;46;2016
37;Salamanca;001;Abusejo;202;106;96;2016
37;Salamanca;002;Agallas;152;76;76;2016
37;Salamanca;003;Ahigal de los Aceiteros;126;68;58;2016
37;Salamanca;004;Ahigal de Villarino;40;22;18;2016
37;Salamanca;005;Alameda de Gardón, La;83;44;39;2016
37;Salamanca;006;Alamedilla, La;143;72;71;2016
37;Salamanca;007;Alaraz;495;257;238;2016
37;Salamanca;008;Alba de Tormes;5229;2590;2639;2016
37;Salamanca;009;Alba de Yeltes;233;123;110;2016
37;Salamanca;010;Alberca, La;1125;556;569;2016
37;Salamanca;011;Alberguería de Argañán, La;134;67;67;2016
37;Salamanca;012;Alconada;163;87;76;2016
37;Salamanca;015;Aldea del Obispo;301;162;139;2016
37;Salamanca;013;Aldeacipreste;121;66;55;2016
37;Salamanca;014;Aldeadávila de la Ribera;1256;641;615;2016
37;Salamanca;016;Aldealengua;696;351;345;2016
37;Salamanca;017;Aldeanueva de Figueroa;284;148;136;2016
37;Salamanca;018;Aldeanueva de la Sierra;110;61;49;2016
37;Salamanca;019;Aldearrodrigo;152;78;74;2016
37;Salamanca;020;Aldearrubia;487;261;226;2016
37;Salamanca;021;Aldeaseca de Alba;82;37;45;2016
37;Salamanca;022;Aldeaseca de la Frontera;292;150;142;2016
37;Salamanca;023;Aldeatejada;1828;922;906;2016
37;Salamanca;024;Aldeavieja de Tormes;104;56;48;2016
37;Salamanca;025;Aldehuela de la Bóveda;284;152;132;2016
37;Salamanca;026;Aldehuela de Yeltes;208;110;98;2016
37;Salamanca;027;Almenara de Tormes;249;144;105;2016
37;Salamanca;028;Almendra;166;97;69;2016
37;Salamanca;029;Anaya de Alba;222;130;92;2016
37;Salamanca;030;Añover de Tormes;93;49;44;2016
37;Salamanca;031;Arabayona de Mógica;392;213;179;2016
37;Salamanca;032;Arapiles;645;344;301;2016
37;Salamanca;033;Arcediano;113;60;53;2016
37;Salamanca;034;Arco, El;93;47;46;2016
37;Salamanca;035;Armenteros;238;133;105;2016
37;Salamanca;037;Atalaya, La;120;68;52;2016
37;Salamanca;038;Babilafuente;869;453;416;2016
37;Salamanca;039;Bañobárez;316;164;152;2016
37;Salamanca;040;Barbadillo;407;212;195;2016
37;Salamanca;041;Barbalos;78;42;36;2016
37;Salamanca;042;Barceo;48;28;20;2016
37;Salamanca;044;Barruecopardo;483;268;215;2016
37;Salamanca;045;Bastida, La;24;14;10;2016
37;Salamanca;046;Béjar;13403;6365;7038;2016
37;Salamanca;047;Beleña;223;113;110;2016
37;Salamanca;049;Bermellar;143;70;73;2016
37;Salamanca;050;Berrocal de Huebra;68;39;29;2016
37;Salamanca;051;Berrocal de Salvatierra;91;47;44;2016
37;Salamanca;052;Boada;297;152;145;2016
37;Salamanca;054;Bodón, El;293;155;138;2016
37;Salamanca;055;Bogajo;141;76;65;2016
37;Salamanca;056;Bouza, La;55;23;32;2016
37;Salamanca;057;Bóveda del Río Almar;245;132;113;2016
37;Salamanca;058;Brincones;58;29;29;2016
37;Salamanca;059;Buenamadre;133;71;62;2016
37;Salamanca;060;Buenavista;270;150;120;2016
37;Salamanca;061;Cabaco, El;248;127;121;2016
37;Salamanca;063;Cabeza de Béjar, La;70;41;29;2016
37;Salamanca;065;Cabeza del Caballo;338;187;151;2016
37;Salamanca;062;Cabezabellosa de la Calzada;87;48;39;2016
37;Salamanca;067;Cabrerizos;4205;2112;2093;2016
37;Salamanca;068;Cabrillas;398;202;196;2016
37;Salamanca;069;Calvarrasa de Abajo;1143;597;546;2016
37;Salamanca;070;Calvarrasa de Arriba;604;323;281;2016
37;Salamanca;071;Calzada de Béjar, La;86;49;37;2016
37;Salamanca;072;Calzada de Don Diego;174;93;81;2016
37;Salamanca;073;Calzada de Valdunciel;660;335;325;2016
37;Salamanca;074;Campillo de Azaba;169;96;73;2016
37;Salamanca;077;Campo de Peñaranda, El;274;155;119;2016
37;Salamanca;078;Candelario;934;463;471;2016
37;Salamanca;079;Canillas de Abajo;77;54;23;2016
37;Salamanca;080;Cantagallo;263;141;122;2016
37;Salamanca;081;Cantalapiedra;1019;529;490;2016
37;Salamanca;082;Cantalpino;927;507;420;2016
37;Salamanca;083;Cantaracillo;204;110;94;2016
37;Salamanca;085;Carbajosa de la Sagrada;6790;3405;3385;2016
37;Salamanca;086;Carpio de Azaba;101;59;42;2016
37;Salamanca;087;Carrascal de Barregas;1117;591;526;2016
37;Salamanca;088;Carrascal del Obispo;222;120;102;2016
37;Salamanca;089;Casafranca;69;40;29;2016
37;Salamanca;090;Casas del Conde, Las;55;28;27;2016
37;Salamanca;091;Casillas de Flores;183;90;93;2016
37;Salamanca;092;Castellanos de Moriscos;2419;1253;1166;2016
37;Salamanca;185;Castellanos de Villiquera;675;361;314;2016
37;Salamanca;096;Castillejo de Martín Viejo;227;130;97;2016
37;Salamanca;097;Castraz;39;24;15;2016
37;Salamanca;098;Cepeda;349;175;174;2016
37;Salamanca;099;Cereceda de la Sierra;75;39;36;2016
37;Salamanca;100;Cerezal de Peñahorcada;80;47;33;2016
37;Salamanca;101;Cerralbo;170;93;77;2016
37;Salamanca;102;Cerro, El;442;220;222;2016
37;Salamanca;103;Cespedosa de Tormes;518;276;242;2016
37;Salamanca;114;Chagarcía Medianero;84;45;39;2016
37;Salamanca;104;Cilleros de la Bastida;25;13;12;2016
37;Salamanca;106;Cipérez;278;142;136;2016
37;Salamanca;107;Ciudad Rodrigo;12896;6260;6636;2016
37;Salamanca;108;Coca de Alba;99;46;53;2016
37;Salamanca;109;Colmenar de Montemayor;193;108;85;2016
37;Salamanca;110;Cordovilla;129;73;56;2016
37;Salamanca;112;Cristóbal;170;97;73;2016
37;Salamanca;113;Cubo de Don Sancho, El;463;249;214;2016
37;Salamanca;115;Dios le Guarde;139;73;66;2016
37;Salamanca;116;Doñinos de Ledesma;68;35;33;2016
37;Salamanca;117;Doñinos de Salamanca;1996;1046;950;2016
37;Salamanca;118;Ejeme;134;76;58;2016
37;Salamanca;120;Encina de San Silvestre;111;57;54;2016
37;Salamanca;119;Encina, La;112;70;42;2016
37;Salamanca;121;Encinas de Abajo;666;346;320;2016
37;Salamanca;122;Encinas de Arriba;242;124;118;2016
37;Salamanca;123;Encinasola de los Comendadores;184;101;83;2016
37;Salamanca;124;Endrinal;233;129;104;2016
37;Salamanca;125;Escurial de la Sierra;246;139;107;2016
37;Salamanca;126;Espadaña;32;19;13;2016
37;Salamanca;127;Espeja;245;127;118;2016
37;Salamanca;128;Espino de la Orbada;284;151;133;2016
37;Salamanca;129;Florida de Liébana;282;153;129;2016
37;Salamanca;130;Forfoleda;189;103;86;2016
37;Salamanca;131;Frades de la Sierra;208;110;98;2016
37;Salamanca;132;Fregeneda, La;377;182;195;2016
37;Salamanca;133;Fresnedoso;107;63;44;2016
37;Salamanca;134;Fresno Alhándiga;245;131;114;2016
37;Salamanca;135;Fuente de San Esteban, La;1358;675;683;2016
37;Salamanca;136;Fuenteguinaldo;687;343;344;2016
37;Salamanca;137;Fuenteliante;108;54;54;2016
37;Salamanca;138;Fuenterroble de Salvatierra;243;125;118;2016
37;Salamanca;139;Fuentes de Béjar;250;125;125;2016
37;Salamanca;140;Fuentes de Oñoro;1058;544;514;2016
37;Salamanca;141;Gajates;166;79;87;2016
37;Salamanca;142;Galindo y Perahuy;693;403;290;2016
37;Salamanca;143;Galinduste;443;220;223;2016
37;Salamanca;144;Galisancho;405;224;181;2016
37;Salamanca;145;Gallegos de Argañán;293;154;139;2016
37;Salamanca;146;Gallegos de Solmirón;131;71;60;2016
37;Salamanca;147;Garcibuey;196;111;85;2016
37;Salamanca;148;Garcihernández;480;250;230;2016
37;Salamanca;149;Garcirrey;69;40;29;2016
37;Salamanca;150;Gejuelo del Barro;41;23;18;2016
37;Salamanca;151;Golpejas;155;82;73;2016
37;Salamanca;152;Gomecello;458;243;215;2016
37;Salamanca;154;Guadramiro;150;85;65;2016
37;Salamanca;155;Guijo de Ávila;77;42;35;2016
37;Salamanca;156;Guijuelo;5630;2798;2832;2016
37;Salamanca;157;Herguijuela de Ciudad Rodrigo;82;48;34;2016
37;Salamanca;158;Herguijuela de la Sierra;272;152;120;2016
37;Salamanca;159;Herguijuela del Campo;91;43;48;2016
37;Salamanca;160;Hinojosa de Duero;699;350;349;2016
37;Salamanca;161;Horcajo de Montemayor;154;82;72;2016
37;Salamanca;162;Horcajo Medianero;207;109;98;2016
37;Salamanca;163;Hoya, La;42;25;17;2016
37;Salamanca;164;Huerta;305;168;137;2016
37;Salamanca;165;Iruelos;36;14;22;2016
37;Salamanca;166;Ituero de Azaba;235;119;116;2016
37;Salamanca;167;Juzbado;174;92;82;2016
37;Salamanca;168;Lagunilla;496;268;228;2016
37;Salamanca;169;Larrodrigo;190;108;82;2016
37;Salamanca;170;Ledesma;1767;880;887;2016
37;Salamanca;171;Ledrada;510;254;256;2016
37;Salamanca;172;Linares de Riofrío;990;551;439;2016
37;Salamanca;173;Lumbrales;1697;854;843;2016
37;Salamanca;175;Machacón;453;236;217;2016
37;Salamanca;174;Macotera;1149;606;543;2016
37;Salamanca;176;Madroñal;153;88;65;2016
37;Salamanca;177;Maíllo, El;287;159;128;2016
37;Salamanca;178;Malpartida;99;57;42;2016
37;Salamanca;179;Mancera de Abajo;225;117;108;2016
37;Salamanca;180;Manzano, El;74;39;35;2016
37;Salamanca;181;Martiago;302;157;145;2016
37;Salamanca;183;Martín de Yeltes;436;226;210;2016
37;Salamanca;182;Martinamor;82;50;32;2016
37;Salamanca;184;Masueco;325;169;156;2016
37;Salamanca;186;Mata de Ledesma, La;110;61;49;2016
37;Salamanca;187;Matilla de los Caños del Río;654;328;326;2016
37;Salamanca;188;Maya, La;190;112;78;2016
37;Salamanca;189;Membribe de la Sierra;124;74;50;2016
37;Salamanca;190;Mieza;226;113;113;2016
37;Salamanca;191;Milano, El;123;73;50;2016
37;Salamanca;192;Miranda de Azán;419;226;193;2016
37;Salamanca;193;Miranda del Castañar;426;222;204;2016
37;Salamanca;194;Mogarraz;309;164;145;2016
37;Salamanca;195;Molinillo;52;28;24;2016
37;Salamanca;196;Monforte de la Sierra;81;42;39;2016
37;Salamanca;197;Monleón;90;51;39;2016
37;Salamanca;198;Monleras;236;111;125;2016
37;Salamanca;199;Monsagro;148;80;68;2016
37;Salamanca;200;Montejo;207;113;94;2016
37;Salamanca;201;Montemayor del Río;296;155;141;2016
37;Salamanca;202;Monterrubio de Armuña;1353;714;639;2016
37;Salamanca;203;Monterrubio de la Sierra;169;92;77;2016
37;Salamanca;204;Morasverdes;274;143;131;2016
37;Salamanca;205;Morille;254;136;118;2016
37;Salamanca;206;Moríñigo;102;55;47;2016
37;Salamanca;207;Moriscos;358;204;154;2016
37;Salamanca;208;Moronta;80;48;32;2016
37;Salamanca;209;Mozárbez;502;262;240;2016
37;Salamanca;211;Narros de Matalayegua;238;129;109;2016
37;Salamanca;213;Nava de Béjar;99;53;46;2016
37;Salamanca;214;Nava de Francia;142;78;64;2016
37;Salamanca;215;Nava de Sotrobal;163;89;74;2016
37;Salamanca;212;Navacarros;106;59;47;2016
37;Salamanca;216;Navales;336;182;154;2016
37;Salamanca;217;Navalmoral de Béjar;66;29;37;2016
37;Salamanca;218;Navamorales;70;44;26;2016
37;Salamanca;219;Navarredonda de la Rinconada;185;96;89;2016
37;Salamanca;221;Navasfrías;470;253;217;2016
37;Salamanca;222;Negrilla de Palencia;97;55;42;2016
37;Salamanca;223;Olmedo de Camaces;111;61;50;2016
37;Salamanca;224;Orbada, La;224;120;104;2016
37;Salamanca;225;Pajares de la Laguna;116;61;55;2016
37;Salamanca;226;Palacios del Arzobispo;163;80;83;2016
37;Salamanca;228;Palaciosrubios;382;204;178;2016
37;Salamanca;229;Palencia de Negrilla;156;87;69;2016
37;Salamanca;230;Parada de Arriba;268;137;131;2016
37;Salamanca;231;Parada de Rubiales;270;136;134;2016
37;Salamanca;232;Paradinas de San Juan;410;234;176;2016
37;Salamanca;233;Pastores;64;35;29;2016
37;Salamanca;234;Payo, El;375;183;192;2016
37;Salamanca;235;Pedraza de Alba;248;129;119;2016
37;Salamanca;236;Pedrosillo de Alba;142;79;63;2016
37;Salamanca;237;Pedrosillo de los Aires;384;215;169;2016
37;Salamanca;238;Pedrosillo el Ralo;136;70;66;2016
37;Salamanca;239;Pedroso de la Armuña, El;238;122;116;2016
37;Salamanca;240;Pelabravo;1151;610;541;2016
37;Salamanca;241;Pelarrodríguez;165;100;65;2016
37;Salamanca;242;Pelayos;98;58;40;2016
37;Salamanca;243;Peña, La;103;48;55;2016
37;Salamanca;244;Peñacaballera;149;75;74;2016
37;Salamanca;245;Peñaparda;370;187;183;2016
37;Salamanca;246;Peñaranda de Bracamonte;6471;3177;3294;2016
37;Salamanca;247;Peñarandilla;210;110;100;2016
37;Salamanca;248;Peralejos de Abajo;165;88;77;2016
37;Salamanca;249;Peralejos de Arriba;43;25;18;2016
37;Salamanca;250;Pereña de la Ribera;377;193;184;2016
37;Salamanca;251;Peromingo;131;62;69;2016
37;Salamanca;252;Pinedas;107;58;49;2016
37;Salamanca;253;Pino de Tormes, El;157;86;71;2016
37;Salamanca;254;Pitiegua;196;111;85;2016
37;Salamanca;255;Pizarral;50;28;22;2016
37;Salamanca;256;Poveda de las Cintas;242;137;105;2016
37;Salamanca;257;Pozos de Hinojo;51;29;22;2016
37;Salamanca;258;Puebla de Azaba;201;109;92;2016
37;Salamanca;259;Puebla de San Medel;44;26;18;2016
37;Salamanca;260;Puebla de Yeltes;151;81;70;2016
37;Salamanca;261;Puente del Congosto;236;132;104;2016
37;Salamanca;262;Puertas;84;45;39;2016
37;Salamanca;263;Puerto de Béjar;380;190;190;2016
37;Salamanca;264;Puerto Seguro;64;32;32;2016
37;Salamanca;265;Rágama;238;122;116;2016
37;Salamanca;266;Redonda, La;94;54;40;2016
37;Salamanca;267;Retortillo;216;117;99;2016
37;Salamanca;268;Rinconada de la Sierra, La;120;66;54;2016
37;Salamanca;269;Robleda;513;275;238;2016
37;Salamanca;270;Robliza de Cojos;209;105;104;2016
37;Salamanca;271;Rollán;388;209;179;2016
37;Salamanca;272;Saelices el Chico;152;80;72;2016
37;Salamanca;273;Sagrada, La;112;62;50;2016
37;Salamanca;303;Sahugo, El;196;108;88;2016
37;Salamanca;274;Salamanca;144949;66017;78932;2016
37;Salamanca;275;Saldeana;119;65;54;2016
37;Salamanca;276;Salmoral;147;92;55;2016
37;Salamanca;277;Salvatierra de Tormes;78;38;40;2016
37;Salamanca;278;San Cristóbal de la Cuesta;958;511;447;2016
37;Salamanca;284;San Esteban de la Sierra;340;188;152;2016
37;Salamanca;285;San Felices de los Gallegos;442;224;218;2016
37;Salamanca;286;San Martín del Castañar;228;123;105;2016
37;Salamanca;287;San Miguel de Valero;338;173;165;2016
37;Salamanca;036;San Miguel del Robledo;62;32;30;2016
37;Salamanca;288;San Morales;306;169;137;2016
37;Salamanca;289;San Muñoz;253;128;125;2016
37;Salamanca;291;San Pedro de Rozados;307;165;142;2016
37;Salamanca;290;San Pedro del Valle;147;82;65;2016
37;Salamanca;292;San Pelayo de Guareña;99;52;47;2016
37;Salamanca;280;Sanchón de la Ribera;78;44;34;2016
37;Salamanca;281;Sanchón de la Sagrada;40;24;16;2016
37;Salamanca;282;Sanchotello;227;118;109;2016
37;Salamanca;279;Sancti-Spíritus;854;457;397;2016
37;Salamanca;283;Sando;132;79;53;2016
37;Salamanca;293;Santa María de Sando;119;60;59;2016
37;Salamanca;294;Santa Marta de Tormes;14939;7358;7581;2016
37;Salamanca;296;Santiago de la Puebla;353;185;168;2016
37;Salamanca;297;Santibáñez de Béjar;493;251;242;2016
37;Salamanca;298;Santibáñez de la Sierra;184;100;84;2016
37;Salamanca;299;Santiz;250;128;122;2016
37;Salamanca;300;Santos, Los;639;325;314;2016
37;Salamanca;301;Sardón de los Frailes;82;49;33;2016
37;Salamanca;302;Saucelle;308;160;148;2016
37;Salamanca;304;Sepulcro-Hilario;181;103;78;2016
37;Salamanca;305;Sequeros;237;118;119;2016
37;Salamanca;306;Serradilla del Arroyo;275;153;122;2016
37;Salamanca;307;Serradilla del Llano;172;85;87;2016
37;Salamanca;309;Sierpe, La;48;24;24;2016
37;Salamanca;310;Sieteiglesias de Tormes;204;104;100;2016
37;Salamanca;311;Sobradillo;242;122;120;2016
37;Salamanca;312;Sorihuela;263;133;130;2016
37;Salamanca;313;Sotoserrano;596;318;278;2016
37;Salamanca;314;Tabera de Abajo;111;64;47;2016
37;Salamanca;315;Tala, La;96;53;43;2016
37;Salamanca;316;Tamames;826;423;403;2016
37;Salamanca;317;Tarazona de Guareña;330;174;156;2016
37;Salamanca;318;Tardáguila;221;130;91;2016
37;Salamanca;319;Tejado, El;120;65;55;2016
37;Salamanca;320;Tejeda y Segoyuela;99;55;44;2016
37;Salamanca;321;Tenebrón;160;77;83;2016
37;Salamanca;322;Terradillos;3089;1583;1506;2016
37;Salamanca;323;Topas;554;297;257;2016
37;Salamanca;324;Tordillos;377;208;169;2016
37;Salamanca;325;Tornadizo, El;88;47;41;2016
37;Salamanca;327;Torresmenudas;196;97;99;2016
37;Salamanca;328;Trabanca;220;108;112;2016
37;Salamanca;329;Tremedal de Tormes;44;21;23;2016
37;Salamanca;330;Valdecarros;363;188;175;2016
37;Salamanca;331;Valdefuentes de Sangusín;229;127;102;2016
37;Salamanca;332;Valdehijaderos;83;46;37;2016
37;Salamanca;333;Valdelacasa;242;143;99;2016
37;Salamanca;334;Valdelageve;81;41;40;2016
37;Salamanca;335;Valdelosa;443;215;228;2016
37;Salamanca;336;Valdemierque;61;38;23;2016
37;Salamanca;337;Valderrodrigo;151;73;78;2016
37;Salamanca;338;Valdunciel;95;48;47;2016
37;Salamanca;339;Valero;317;170;147;2016
37;Salamanca;343;Vallejera de Riofrío;67;33;34;2016
37;Salamanca;340;Valsalabroso;146;84;62;2016
37;Salamanca;341;Valverde de Valdelacasa;76;43;33;2016
37;Salamanca;342;Valverdón;290;150;140;2016
37;Salamanca;344;Vecinos;264;133;131;2016
37;Salamanca;345;Vega de Tirados;180;95;85;2016
37;Salamanca;346;Veguillas, Las;297;137;160;2016
37;Salamanca;347;Vellés, La;557;301;256;2016
37;Salamanca;348;Ventosa del Río Almar;121;68;53;2016
37;Salamanca;349;Vídola, La;117;53;64;2016
37;Salamanca;351;Villaflores;293;153;140;2016
37;Salamanca;352;Villagonzalo de Tormes;222;126;96;2016
37;Salamanca;353;Villalba de los Llanos;138;78;60;2016
37;Salamanca;354;Villamayor;7047;3540;3507;2016
37;Salamanca;355;Villanueva del Conde;177;88;89;2016
37;Salamanca;356;Villar de Argañán;89;47;42;2016
37;Salamanca;357;Villar de Ciervo;289;151;138;2016
37;Salamanca;358;Villar de Gallimazo;202;129;73;2016
37;Salamanca;359;Villar de la Yegua;198;104;94;2016
37;Salamanca;360;Villar de Peralonso;249;123;126;2016
37;Salamanca;361;Villar de Samaniego;88;51;37;2016
37;Salamanca;362;Villares de la Reina;6266;3137;3129;2016
37;Salamanca;363;Villares de Yeltes;128;61;67;2016
37;Salamanca;364;Villarino de los Aires;869;449;420;2016
37;Salamanca;365;Villarmayor;195;107;88;2016
37;Salamanca;366;Villarmuerto;41;27;14;2016
37;Salamanca;367;Villasbuenas;208;113;95;2016
37;Salamanca;368;Villasdardo;17;6;11;2016
37;Salamanca;369;Villaseco de los Gamitos;143;82;61;2016
37;Salamanca;370;Villaseco de los Reyes;350;201;149;2016
37;Salamanca;371;Villasrubias;289;158;131;2016
37;Salamanca;372;Villaverde de Guareña;149;81;68;2016
37;Salamanca;373;Villavieja de Yeltes;838;435;403;2016
37;Salamanca;374;Villoria;1389;697;692;2016
37;Salamanca;375;Villoruela;819;417;402;2016
37;Salamanca;350;Vilvestre;444;219;225;2016
37;Salamanca;376;Vitigudino;2634;1291;1343;2016
37;Salamanca;377;Yecla de Yeltes;261;135;126;2016
37;Salamanca;378;Zamarra;105;59;46;2016
37;Salamanca;379;Zamayón;201;116;85;2016
37;Salamanca;380;Zarapicos;55;30;25;2016
37;Salamanca;381;Zarza de Pumareda, La;156;87;69;2016
37;Salamanca;382;Zorita de la Frontera;183;97;86;2016
38;Santa Cruz de Tenerife;001;Adeje;47316;23944;23372;2016
38;Santa Cruz de Tenerife;002;Agulo;1074;552;522;2016
38;Santa Cruz de Tenerife;003;Alajeró;1971;1050;921;2016
38;Santa Cruz de Tenerife;004;Arafo;5458;2683;2775;2016
38;Santa Cruz de Tenerife;005;Arico;7423;3848;3575;2016
38;Santa Cruz de Tenerife;006;Arona;79172;40470;38702;2016
38;Santa Cruz de Tenerife;007;Barlovento;1886;957;929;2016
38;Santa Cruz de Tenerife;008;Breña Alta;7086;3493;3593;2016
38;Santa Cruz de Tenerife;009;Breña Baja;5377;2688;2689;2016
38;Santa Cruz de Tenerife;010;Buenavista del Norte;4832;2444;2388;2016
38;Santa Cruz de Tenerife;011;Candelaria;26746;13018;13728;2016
38;Santa Cruz de Tenerife;012;Fasnia;2783;1456;1327;2016
38;Santa Cruz de Tenerife;013;Frontera;3959;2008;1951;2016
38;Santa Cruz de Tenerife;014;Fuencaliente de la Palma;1705;864;841;2016
38;Santa Cruz de Tenerife;015;Garachico;4916;2466;2450;2016
38;Santa Cruz de Tenerife;016;Garafía;1607;841;766;2016
38;Santa Cruz de Tenerife;017;Granadilla de Abona;45332;22708;22624;2016
38;Santa Cruz de Tenerife;018;Guancha, La;5423;2641;2782;2016
38;Santa Cruz de Tenerife;019;Guía de Isora;20460;10205;10255;2016
38;Santa Cruz de Tenerife;020;Güímar;19000;9361;9639;2016
38;Santa Cruz de Tenerife;021;Hermigua;1924;976;948;2016
38;Santa Cruz de Tenerife;022;Icod de los Vinos;22606;11185;11421;2016
38;Santa Cruz de Tenerife;024;Llanos de Aridane, Los;20043;9718;10325;2016
38;Santa Cruz de Tenerife;025;Matanza de Acentejo, La;8772;4409;4363;2016
38;Santa Cruz de Tenerife;026;Orotava, La;41294;20332;20962;2016
38;Santa Cruz de Tenerife;027;Paso, El;7457;3711;3746;2016
38;Santa Cruz de Tenerife;901;Pinar de El Hierro, El;1743;904;839;2016
38;Santa Cruz de Tenerife;028;Puerto de la Cruz;29497;14401;15096;2016
38;Santa Cruz de Tenerife;029;Puntagorda;2025;1022;1003;2016
38;Santa Cruz de Tenerife;030;Puntallana;2387;1195;1192;2016
38;Santa Cruz de Tenerife;031;Realejos, Los;36149;17810;18339;2016
38;Santa Cruz de Tenerife;032;Rosario, El;17191;8717;8474;2016
38;Santa Cruz de Tenerife;033;San Andrés y Sauces;4171;2097;2074;2016
38;Santa Cruz de Tenerife;023;San Cristóbal de La Laguna;153111;74324;78787;2016
38;Santa Cruz de Tenerife;034;San Juan de la Rambla;4910;2450;2460;2016
38;Santa Cruz de Tenerife;035;San Miguel de Abona;17870;8994;8876;2016
38;Santa Cruz de Tenerife;036;San Sebastián de la Gomera;8707;4371;4336;2016
38;Santa Cruz de Tenerife;037;Santa Cruz de la Palma;15711;7636;8075;2016
38;Santa Cruz de Tenerife;038;Santa Cruz de Tenerife;203585;97229;106356;2016
38;Santa Cruz de Tenerife;039;Santa Úrsula;14125;7056;7069;2016
38;Santa Cruz de Tenerife;040;Santiago del Teide;11338;5667;5671;2016
38;Santa Cruz de Tenerife;041;Sauzal, El;8873;4386;4487;2016
38;Santa Cruz de Tenerife;042;Silos, Los;4786;2387;2399;2016
38;Santa Cruz de Tenerife;043;Tacoronte;23772;11836;11936;2016
38;Santa Cruz de Tenerife;044;Tanque, El;2658;1296;1362;2016
38;Santa Cruz de Tenerife;045;Tazacorte;4633;2363;2270;2016
38;Santa Cruz de Tenerife;046;Tegueste;11114;5496;5618;2016
38;Santa Cruz de Tenerife;047;Tijarafe;2577;1301;1276;2016
38;Santa Cruz de Tenerife;049;Valle Gran Rey;4285;2175;2110;2016
38;Santa Cruz de Tenerife;050;Vallehermoso;2979;1524;1455;2016
38;Santa Cruz de Tenerife;048;Valverde;4885;2479;2406;2016
38;Santa Cruz de Tenerife;051;Victoria de Acentejo, La;8969;4513;4456;2016
38;Santa Cruz de Tenerife;052;Vilaflor de Chasna;1630;841;789;2016
38;Santa Cruz de Tenerife;053;Villa de Mazo;4821;2412;2409;2016
40;Segovia;001;Abades;862;431;431;2016
40;Segovia;002;Adrada de Pirón;39;19;20;2016
40;Segovia;003;Adrados;149;82;67;2016
40;Segovia;004;Aguilafuente;579;278;301;2016
40;Segovia;005;Alconada de Maderuelo;35;23;12;2016
40;Segovia;012;Aldea Real;322;170;152;2016
40;Segovia;006;Aldealcorvo;24;14;10;2016
40;Segovia;007;Aldealengua de Pedraza;82;51;31;2016
40;Segovia;008;Aldealengua de Santa María;62;32;30;2016
40;Segovia;009;Aldeanueva de la Serrezuela;55;38;17;2016
40;Segovia;010;Aldeanueva del Codonal;136;72;64;2016
40;Segovia;013;Aldeasoña;63;37;26;2016
40;Segovia;014;Aldehorno;57;33;24;2016
40;Segovia;015;Aldehuela del Codonal;31;16;15;2016
40;Segovia;016;Aldeonte;58;27;31;2016
40;Segovia;017;Anaya;126;62;64;2016
40;Segovia;018;Añe;98;54;44;2016
40;Segovia;019;Arahuetes;40;27;13;2016
40;Segovia;020;Arcones;183;89;94;2016
40;Segovia;021;Arevalillo de Cega;29;18;11;2016
40;Segovia;022;Armuña;247;143;104;2016
40;Segovia;024;Ayllón;1253;647;606;2016
40;Segovia;025;Barbolla;186;99;87;2016
40;Segovia;026;Basardilla;143;65;78;2016
40;Segovia;028;Bercial;117;61;56;2016
40;Segovia;029;Bercimuel;31;16;15;2016
40;Segovia;030;Bernardos;534;293;241;2016
40;Segovia;031;Bernuy de Porreros;716;382;334;2016
40;Segovia;032;Boceguillas;754;385;369;2016
40;Segovia;033;Brieva;85;47;38;2016
40;Segovia;034;Caballar;91;49;42;2016
40;Segovia;035;Cabañas de Polendos;178;100;78;2016
40;Segovia;036;Cabezuela;685;353;332;2016
40;Segovia;037;Calabazas de Fuentidueña;38;21;17;2016
40;Segovia;039;Campo de San Pedro;284;156;128;2016
40;Segovia;040;Cantalejo;3628;1808;1820;2016
40;Segovia;041;Cantimpalos;1344;703;641;2016
40;Segovia;043;Carbonero el Mayor;2529;1307;1222;2016
40;Segovia;044;Carrascal del Río;154;84;70;2016
40;Segovia;045;Casla;148;84;64;2016
40;Segovia;046;Castillejo de Mesleón;130;78;52;2016
40;Segovia;047;Castro de Fuentidueña;31;20;11;2016
40;Segovia;048;Castrojimeno;37;19;18;2016
40;Segovia;049;Castroserna de Abajo;51;29;22;2016
40;Segovia;051;Castroserracín;52;29;23;2016
40;Segovia;052;Cedillo de la Torre;103;54;49;2016
40;Segovia;053;Cerezo de Abajo;131;67;64;2016
40;Segovia;054;Cerezo de Arriba;143;80;63;2016
40;Segovia;065;Chañe;850;401;449;2016
40;Segovia;055;Cilleruelo de San Mamés;39;25;14;2016
40;Segovia;056;Cobos de Fuentidueña;32;16;16;2016
40;Segovia;057;Coca;1863;939;924;2016
40;Segovia;058;Codorniz;348;177;171;2016
40;Segovia;059;Collado Hermoso;136;65;71;2016
40;Segovia;060;Condado de Castilnovo;107;60;47;2016
40;Segovia;061;Corral de Ayllón;84;48;36;2016
40;Segovia;902;Cozuelos de Fuentidueña;132;74;58;2016
40;Segovia;062;Cubillo;74;44;30;2016
40;Segovia;063;Cuéllar;9501;4786;4715;2016
40;Segovia;905;Cuevas de Provanco;142;78;64;2016
40;Segovia;068;Domingo García;30;17;13;2016
40;Segovia;069;Donhierro;99;52;47;2016
40;Segovia;070;Duruelo;170;100;70;2016
40;Segovia;071;Encinas;45;23;22;2016
40;Segovia;072;Encinillas;257;146;111;2016
40;Segovia;073;Escalona del Prado;533;282;251;2016
40;Segovia;074;Escarabajosa de Cabezas;313;170;143;2016
40;Segovia;075;Escobar de Polendos;181;96;85;2016
40;Segovia;076;Espinar, El;9212;4727;4485;2016
40;Segovia;077;Espirdo;1189;644;545;2016
40;Segovia;078;Fresneda de Cuéllar;176;99;77;2016
40;Segovia;079;Fresno de Cantespino;272;147;125;2016
40;Segovia;080;Fresno de la Fuente;87;49;38;2016
40;Segovia;081;Frumales;119;61;58;2016
40;Segovia;082;Fuente de Santa Cruz;120;62;58;2016
40;Segovia;083;Fuente el Olmo de Fuentidueña;178;71;107;2016
40;Segovia;084;Fuente el Olmo de Íscar;66;38;28;2016
40;Segovia;086;Fuentepelayo;893;472;421;2016
40;Segovia;087;Fuentepiñel;97;51;46;2016
40;Segovia;088;Fuenterrebollo;358;184;174;2016
40;Segovia;089;Fuentesaúco de Fuentidueña;242;128;114;2016
40;Segovia;091;Fuentesoto;115;60;55;2016
40;Segovia;092;Fuentidueña;148;86;62;2016
40;Segovia;093;Gallegos;94;51;43;2016
40;Segovia;094;Garcillán;447;231;216;2016
40;Segovia;095;Gomezserracín;700;365;335;2016
40;Segovia;097;Grajera;233;128;105;2016
40;Segovia;099;Honrubia de la Cuesta;56;32;24;2016
40;Segovia;100;Hontalbilla;304;162;142;2016
40;Segovia;101;Hontanares de Eresma;1322;696;626;2016
40;Segovia;103;Huertos, Los;183;107;76;2016
40;Segovia;104;Ituero y Lama;358;189;169;2016
40;Segovia;105;Juarros de Riomoros;56;31;25;2016
40;Segovia;106;Juarros de Voltoya;235;117;118;2016
40;Segovia;107;Labajos;136;76;60;2016
40;Segovia;108;Laguna de Contreras;121;69;52;2016
40;Segovia;109;Languilla;82;46;36;2016
40;Segovia;110;Lastras de Cuéllar;403;207;196;2016
40;Segovia;111;Lastras del Pozo;78;37;41;2016
40;Segovia;112;Lastrilla, La;3647;1842;1805;2016
40;Segovia;113;Losa, La;533;294;239;2016
40;Segovia;115;Maderuelo;110;60;50;2016
40;Segovia;903;Marazoleja;109;70;39;2016
40;Segovia;118;Marazuela;54;32;22;2016
40;Segovia;119;Martín Miguel;218;126;92;2016
40;Segovia;120;Martín Muñoz de la Dehesa;227;119;108;2016
40;Segovia;121;Martín Muñoz de las Posadas;315;162;153;2016
40;Segovia;122;Marugán;624;336;288;2016
40;Segovia;124;Mata de Cuéllar;266;138;128;2016
40;Segovia;123;Matabuena;186;109;77;2016
40;Segovia;125;Matilla, La;106;58;48;2016
40;Segovia;126;Melque de Cercos;84;42;42;2016
40;Segovia;127;Membibre de la Hoz;31;17;14;2016
40;Segovia;128;Migueláñez;150;81;69;2016
40;Segovia;129;Montejo de Arévalo;190;104;86;2016
40;Segovia;130;Montejo de la Vega de la Serrezuela;148;88;60;2016
40;Segovia;131;Monterrubio;63;35;28;2016
40;Segovia;132;Moral de Hornuez;64;34;30;2016
40;Segovia;134;Mozoncillo;918;487;431;2016
40;Segovia;135;Muñopedro;325;173;152;2016
40;Segovia;136;Muñoveros;161;79;82;2016
40;Segovia;138;Nava de la Asunción;2849;1440;1409;2016
40;Segovia;139;Navafría;321;170;151;2016
40;Segovia;140;Navalilla;119;61;58;2016
40;Segovia;141;Navalmanzano;1091;574;517;2016
40;Segovia;142;Navares de Ayuso;55;27;28;2016
40;Segovia;143;Navares de Enmedio;96;57;39;2016
40;Segovia;144;Navares de las Cuevas;27;16;11;2016
40;Segovia;145;Navas de Oro;1360;695;665;2016
40;Segovia;904;Navas de Riofrío;423;206;217;2016
40;Segovia;146;Navas de San Antonio;358;186;172;2016
40;Segovia;148;Nieva;299;157;142;2016
40;Segovia;149;Olombrada;599;317;282;2016
40;Segovia;150;Orejana;69;39;30;2016
40;Segovia;151;Ortigosa de Pestaño;67;34;33;2016
40;Segovia;901;Ortigosa del Monte;552;294;258;2016
40;Segovia;152;Otero de Herreros;971;487;484;2016
40;Segovia;154;Pajarejos;19;11;8;2016
40;Segovia;155;Palazuelos de Eresma;5052;2609;2443;2016
40;Segovia;156;Pedraza;414;233;181;2016
40;Segovia;157;Pelayos del Arroyo;51;31;20;2016
40;Segovia;158;Perosillo;17;13;4;2016
40;Segovia;159;Pinarejos;184;105;79;2016
40;Segovia;160;Pinarnegrillo;105;57;48;2016
40;Segovia;161;Pradales;46;26;20;2016
40;Segovia;162;Prádena;540;287;253;2016
40;Segovia;163;Puebla de Pedraza;61;31;30;2016
40;Segovia;164;Rapariegos;197;103;94;2016
40;Segovia;181;Real Sitio de San Ildefonso;5352;2638;2714;2016
40;Segovia;165;Rebollo;84;43;41;2016
40;Segovia;166;Remondo;277;141;136;2016
40;Segovia;168;Riaguas de San Bartolomé;37;22;15;2016
40;Segovia;170;Riaza;2187;1163;1024;2016
40;Segovia;171;Ribota;41;33;8;2016
40;Segovia;172;Riofrío de Riaza;38;24;14;2016
40;Segovia;173;Roda de Eresma;186;102;84;2016
40;Segovia;174;Sacramenia;422;222;200;2016
40;Segovia;176;Samboal;472;257;215;2016
40;Segovia;177;San Cristóbal de Cuéllar;160;85;75;2016
40;Segovia;178;San Cristóbal de la Vega;113;60;53;2016
40;Segovia;906;San Cristóbal de Segovia;2991;1508;1483;2016
40;Segovia;182;San Martín y Mudrián;244;118;126;2016
40;Segovia;183;San Miguel de Bernuy;148;75;73;2016
40;Segovia;184;San Pedro de Gaíllos;308;167;141;2016
40;Segovia;179;Sanchonuño;946;463;483;2016
40;Segovia;180;Sangarcía;328;180;148;2016
40;Segovia;185;Santa María la Real de Nieva;1013;539;474;2016
40;Segovia;186;Santa Marta del Cerro;43;23;20;2016
40;Segovia;188;Santiuste de Pedraza;104;63;41;2016
40;Segovia;189;Santiuste de San Juan Bautista;579;320;259;2016
40;Segovia;190;Santo Domingo de Pirón;62;39;23;2016
40;Segovia;191;Santo Tomé del Puerto;288;162;126;2016
40;Segovia;192;Sauquillo de Cabezas;183;98;85;2016
40;Segovia;193;Sebúlcor;280;149;131;2016
40;Segovia;194;Segovia;52257;24713;27544;2016
40;Segovia;195;Sepúlveda;1122;588;534;2016
40;Segovia;196;Sequera de Fresno;40;24;16;2016
40;Segovia;198;Sotillo;25;15;10;2016
40;Segovia;199;Sotosalbos;115;58;57;2016
40;Segovia;200;Tabanera la Luenga;51;24;27;2016
40;Segovia;201;Tolocirio;56;27;29;2016
40;Segovia;206;Torre Val de San Pedro;190;97;93;2016
40;Segovia;202;Torreadrada;65;30;35;2016
40;Segovia;203;Torrecaballeros;1299;646;653;2016
40;Segovia;204;Torrecilla del Pinar;216;114;102;2016
40;Segovia;205;Torreiglesias;293;152;141;2016
40;Segovia;207;Trescasas;1055;535;520;2016
40;Segovia;208;Turégano;1031;519;512;2016
40;Segovia;210;Urueñas;108;64;44;2016
40;Segovia;211;Valdeprados;80;44;36;2016
40;Segovia;212;Valdevacas de Montejo;30;14;16;2016
40;Segovia;213;Valdevacas y Guijar;94;49;45;2016
40;Segovia;218;Valle de Tabladillo;99;57;42;2016
40;Segovia;219;Vallelado;707;378;329;2016
40;Segovia;220;Valleruela de Pedraza;73;37;36;2016
40;Segovia;221;Valleruela de Sepúlveda;53;27;26;2016
40;Segovia;214;Valseca;255;145;110;2016
40;Segovia;215;Valtiendas;91;53;38;2016
40;Segovia;216;Valverde del Majano;1070;544;526;2016
40;Segovia;222;Veganzones;246;134;112;2016
40;Segovia;223;Vegas de Matute;272;167;105;2016
40;Segovia;224;Ventosilla y Tejadilla;22;15;7;2016
40;Segovia;225;Villacastín;1521;788;733;2016
40;Segovia;228;Villaverde de Íscar;615;326;289;2016
40;Segovia;229;Villaverde de Montejo;35;19;16;2016
40;Segovia;230;Villeguillo;110;68;42;2016
40;Segovia;231;Yanguas de Eresma;138;68;70;2016
40;Segovia;233;Zarzuela del Monte;529;270;259;2016
40;Segovia;234;Zarzuela del Pinar;463;242;221;2016
41;Sevilla;001;Aguadulce;2073;1024;1049;2016
41;Sevilla;002;Alanís;1811;906;905;2016
41;Sevilla;003;Albaida del Aljarafe;3135;1564;1571;2016
41;Sevilla;004;Alcalá de Guadaíra;75080;37297;37783;2016
41;Sevilla;005;Alcalá del Río;11813;5986;5827;2016
41;Sevilla;006;Alcolea del Río;3397;1704;1693;2016
41;Sevilla;007;Algaba, La;16203;8037;8166;2016
41;Sevilla;008;Algámitas;1283;663;620;2016
41;Sevilla;009;Almadén de la Plata;1461;754;707;2016
41;Sevilla;010;Almensilla;5919;2961;2958;2016
41;Sevilla;011;Arahal;19594;9700;9894;2016
41;Sevilla;012;Aznalcázar;4470;2268;2202;2016
41;Sevilla;013;Aznalcóllar;6148;3158;2990;2016
41;Sevilla;014;Badolatosa;3147;1619;1528;2016
41;Sevilla;015;Benacazón;7134;3568;3566;2016
41;Sevilla;016;Bollullos de la Mitación;10330;5208;5122;2016
41;Sevilla;017;Bormujos;21476;10642;10834;2016
41;Sevilla;018;Brenes;12683;6355;6328;2016
41;Sevilla;019;Burguillos;6449;3240;3209;2016
41;Sevilla;020;Cabezas de San Juan, Las;16516;8333;8183;2016
41;Sevilla;021;Camas;27258;13341;13917;2016
41;Sevilla;022;Campana, La;5399;2703;2696;2016
41;Sevilla;023;Cantillana;10645;5440;5205;2016
41;Sevilla;901;Cañada Rosal;3302;1635;1667;2016
41;Sevilla;024;Carmona;28595;14379;14216;2016
41;Sevilla;025;Carrión de los Céspedes;2548;1220;1328;2016
41;Sevilla;026;Casariche;5593;2860;2733;2016
41;Sevilla;027;Castilblanco de los Arroyos;4868;2458;2410;2016
41;Sevilla;028;Castilleja de Guzmán;2857;1478;1379;2016
41;Sevilla;029;Castilleja de la Cuesta;17532;8530;9002;2016
41;Sevilla;030;Castilleja del Campo;635;326;309;2016
41;Sevilla;031;Castillo de las Guardas, El;1480;751;729;2016
41;Sevilla;032;Cazalla de la Sierra;4933;2425;2508;2016
41;Sevilla;033;Constantina;6119;3044;3075;2016
41;Sevilla;034;Coria del Río;30418;15184;15234;2016
41;Sevilla;035;Coripe;1337;669;668;2016
41;Sevilla;036;Coronil, El;4855;2421;2434;2016
41;Sevilla;037;Corrales, Los;3987;2032;1955;2016
41;Sevilla;903;Cuervo de Sevilla, El;8681;4411;4270;2016
41;Sevilla;038;Dos Hermanas;131855;64985;66870;2016
41;Sevilla;039;Écija;40270;19819;20451;2016
41;Sevilla;040;Espartinas;15198;7600;7598;2016
41;Sevilla;041;Estepa;12615;6279;6336;2016
41;Sevilla;042;Fuentes de Andalucía;7166;3562;3604;2016
41;Sevilla;043;Garrobo, El;770;385;385;2016
41;Sevilla;044;Gelves;9951;4936;5015;2016
41;Sevilla;045;Gerena;7444;3751;3693;2016
41;Sevilla;046;Gilena;3825;1935;1890;2016
41;Sevilla;047;Gines;13261;6504;6757;2016
41;Sevilla;048;Guadalcanal;2706;1341;1365;2016
41;Sevilla;049;Guillena;12570;6366;6204;2016
41;Sevilla;050;Herrera;6503;3225;3278;2016
41;Sevilla;051;Huévar del Aljarafe;2836;1452;1384;2016
41;Sevilla;902;Isla Mayor;5911;2950;2961;2016
41;Sevilla;052;Lantejuela;3858;1974;1884;2016
41;Sevilla;053;Lebrija;27398;13683;13715;2016
41;Sevilla;054;Lora de Estepa;848;430;418;2016
41;Sevilla;055;Lora del Río;19124;9486;9638;2016
41;Sevilla;056;Luisiana, La;4604;2321;2283;2016
41;Sevilla;057;Madroño, El;296;144;152;2016
41;Sevilla;058;Mairena del Alcor;23047;11558;11489;2016
41;Sevilla;059;Mairena del Aljarafe;45040;22075;22965;2016
41;Sevilla;060;Marchena;19773;9873;9900;2016
41;Sevilla;061;Marinaleda;2711;1380;1331;2016
41;Sevilla;062;Martín de la Jara;2733;1415;1318;2016
41;Sevilla;063;Molares, Los;3470;1777;1693;2016
41;Sevilla;064;Montellano;7050;3528;3522;2016
41;Sevilla;065;Morón de la Frontera;28073;13888;14185;2016
41;Sevilla;066;Navas de la Concepción, Las;1629;807;822;2016
41;Sevilla;067;Olivares;9415;4724;4691;2016
41;Sevilla;068;Osuna;17738;8811;8927;2016
41;Sevilla;069;Palacios y Villafranca, Los;38173;19240;18933;2016
41;Sevilla;070;Palomares del Río;8315;4179;4136;2016
41;Sevilla;071;Paradas;6991;3490;3501;2016
41;Sevilla;072;Pedrera;5295;2619;2676;2016
41;Sevilla;073;Pedroso, El;2074;1025;1049;2016
41;Sevilla;074;Peñaflor;3697;1861;1836;2016
41;Sevilla;075;Pilas;13999;7073;6926;2016
41;Sevilla;076;Pruna;2664;1357;1307;2016
41;Sevilla;077;Puebla de Cazalla, La;11190;5583;5607;2016
41;Sevilla;078;Puebla de los Infantes, La;3071;1523;1548;2016
41;Sevilla;079;Puebla del Río, La;11995;5945;6050;2016
41;Sevilla;080;Real de la Jara, El;1575;769;806;2016
41;Sevilla;081;Rinconada, La;38277;19019;19258;2016
41;Sevilla;082;Roda de Andalucía, La;4278;2128;2150;2016
41;Sevilla;083;Ronquillo, El;1397;722;675;2016
41;Sevilla;084;Rubio, El;3497;1702;1795;2016
41;Sevilla;085;Salteras;5498;2676;2822;2016
41;Sevilla;086;San Juan de Aznalfarache;21556;10455;11101;2016
41;Sevilla;088;San Nicolás del Puerto;590;303;287;2016
41;Sevilla;087;Sanlúcar la Mayor;13539;6706;6833;2016
41;Sevilla;089;Santiponce;8442;4208;4234;2016
41;Sevilla;090;Saucejo, El;4350;2154;2196;2016
41;Sevilla;091;Sevilla;690566;327866;362700;2016
41;Sevilla;092;Tocina;9689;4805;4884;2016
41;Sevilla;093;Tomares;24851;12307;12544;2016
41;Sevilla;094;Umbrete;8663;4344;4319;2016
41;Sevilla;095;Utrera;52674;26252;26422;2016
41;Sevilla;096;Valencina de la Concepción;7949;3923;4026;2016
41;Sevilla;097;Villamanrique de la Condesa;4462;2191;2271;2016
41;Sevilla;100;Villanueva de San Juan;1202;571;631;2016
41;Sevilla;098;Villanueva del Ariscal;6490;3155;3335;2016
41;Sevilla;099;Villanueva del Río y Minas;4906;2456;2450;2016
41;Sevilla;101;Villaverde del Río;7840;3981;3859;2016
41;Sevilla;102;Viso del Alcor, El;19168;9586;9582;2016
42;Soria;001;Abejar;327;182;145;2016
42;Soria;003;Adradas;48;27;21;2016
42;Soria;004;Ágreda;3008;1536;1472;2016
42;Soria;006;Alconaba;191;122;69;2016
42;Soria;007;Alcubilla de Avellaneda;127;66;61;2016
42;Soria;008;Alcubilla de las Peñas;60;36;24;2016
42;Soria;009;Aldealafuente;87;48;39;2016
42;Soria;010;Aldealices;29;17;12;2016
42;Soria;011;Aldealpozo;19;9;10;2016
42;Soria;012;Aldealseñor;38;21;17;2016
42;Soria;013;Aldehuela de Periáñez;37;21;16;2016
42;Soria;014;Aldehuelas, Las;68;35;33;2016
42;Soria;015;Alentisque;32;18;14;2016
42;Soria;016;Aliud;16;12;4;2016
42;Soria;017;Almajano;181;93;88;2016
42;Soria;018;Almaluez;157;93;64;2016
42;Soria;019;Almarza;590;333;257;2016
42;Soria;020;Almazán;5648;2862;2786;2016
42;Soria;021;Almazul;76;44;32;2016
42;Soria;022;Almenar de Soria;235;140;95;2016
42;Soria;023;Alpanseque;66;36;30;2016
42;Soria;024;Arancón;89;59;30;2016
42;Soria;025;Arcos de Jalón;1573;848;725;2016
42;Soria;026;Arenillas;27;13;14;2016
42;Soria;027;Arévalo de la Sierra;77;50;27;2016
42;Soria;028;Ausejo de la Sierra;89;49;40;2016
42;Soria;029;Baraona;154;93;61;2016
42;Soria;030;Barca;106;66;40;2016
42;Soria;031;Barcones;23;15;8;2016
42;Soria;032;Bayubas de Abajo;152;81;71;2016
42;Soria;033;Bayubas de Arriba;51;30;21;2016
42;Soria;034;Beratón;33;20;13;2016
42;Soria;035;Berlanga de Duero;923;463;460;2016
42;Soria;036;Blacos;50;27;23;2016
42;Soria;037;Bliecos;37;21;16;2016
42;Soria;038;Borjabad;35;21;14;2016
42;Soria;039;Borobia;252;131;121;2016
42;Soria;041;Buberos;34;19;15;2016
42;Soria;042;Buitrago;58;32;26;2016
42;Soria;043;Burgo de Osma-Ciudad de Osma;5005;2489;2516;2016
42;Soria;044;Cabrejas del Campo;57;35;22;2016
42;Soria;045;Cabrejas del Pinar;362;208;154;2016
42;Soria;046;Calatañazor;56;31;25;2016
42;Soria;048;Caltojar;63;39;24;2016
42;Soria;049;Candilichera;122;72;50;2016
42;Soria;050;Cañamaque;34;25;9;2016
42;Soria;051;Carabantes;21;9;12;2016
42;Soria;052;Caracena;16;11;5;2016
42;Soria;053;Carrascosa de Abajo;27;18;9;2016
42;Soria;054;Carrascosa de la Sierra;18;12;6;2016
42;Soria;055;Casarejos;177;93;84;2016
42;Soria;056;Castilfrío de la Sierra;29;19;10;2016
42;Soria;058;Castillejo de Robledo;116;67;49;2016
42;Soria;057;Castilruiz;180;98;82;2016
42;Soria;059;Centenera de Andaluz;21;9;12;2016
42;Soria;060;Cerbón;38;24;14;2016
42;Soria;061;Cidones;334;196;138;2016
42;Soria;062;Cigudosa;22;14;8;2016
42;Soria;063;Cihuela;52;27;25;2016
42;Soria;064;Ciria;90;49;41;2016
42;Soria;065;Cirujales del Río;21;14;7;2016
42;Soria;068;Coscurita;87;52;35;2016
42;Soria;069;Covaleda;1757;905;852;2016
42;Soria;070;Cubilla;35;21;14;2016
42;Soria;071;Cubo de la Solana;184;100;84;2016
42;Soria;073;Cueva de Ágreda;76;46;30;2016
42;Soria;075;Dévanos;90;49;41;2016
42;Soria;076;Deza;239;124;115;2016
42;Soria;078;Duruelo de la Sierra;1146;588;558;2016
42;Soria;079;Escobosa de Almazán;27;19;8;2016
42;Soria;080;Espeja de San Marcelino;174;100;74;2016
42;Soria;081;Espejón;184;93;91;2016
42;Soria;082;Estepa de San Juan;8;6;2;2016
42;Soria;083;Frechilla de Almazán;25;13;12;2016
42;Soria;084;Fresno de Caracena;25;15;10;2016
42;Soria;085;Fuentearmegil;189;105;84;2016
42;Soria;086;Fuentecambrón;39;21;18;2016
42;Soria;087;Fuentecantos;57;28;29;2016
42;Soria;088;Fuentelmonge;72;41;31;2016
42;Soria;089;Fuentelsaz de Soria;59;29;30;2016
42;Soria;090;Fuentepinilla;94;59;35;2016
42;Soria;092;Fuentes de Magaña;65;36;29;2016
42;Soria;093;Fuentestrún;41;27;14;2016
42;Soria;094;Garray;742;399;343;2016
42;Soria;095;Golmayo;2519;1329;1190;2016
42;Soria;096;Gómara;322;177;145;2016
42;Soria;097;Gormaz;26;18;8;2016
42;Soria;098;Herrera de Soria;10;7;3;2016
42;Soria;100;Hinojosa del Campo;32;21;11;2016
42;Soria;103;Langa de Duero;733;399;334;2016
42;Soria;105;Liceras;54;28;26;2016
42;Soria;106;Losilla, La;14;9;5;2016
42;Soria;107;Magaña;79;43;36;2016
42;Soria;108;Maján;13;7;6;2016
42;Soria;110;Matalebreras;66;39;27;2016
42;Soria;111;Matamala de Almazán;326;174;152;2016
42;Soria;113;Medinaceli;741;358;383;2016
42;Soria;115;Miño de Medinaceli;71;46;25;2016
42;Soria;116;Miño de San Esteban;52;33;19;2016
42;Soria;117;Molinos de Duero;171;90;81;2016
42;Soria;118;Momblona;23;16;7;2016
42;Soria;119;Monteagudo de las Vicarías;212;111;101;2016
42;Soria;120;Montejo de Tiermes;172;113;59;2016
42;Soria;121;Montenegro de Cameros;66;42;24;2016
42;Soria;123;Morón de Almazán;213;112;101;2016
42;Soria;124;Muriel de la Fuente;66;38;28;2016
42;Soria;125;Muriel Viejo;86;53;33;2016
42;Soria;127;Nafría de Ucero;35;21;14;2016
42;Soria;128;Narros;44;25;19;2016
42;Soria;129;Navaleno;808;432;376;2016
42;Soria;130;Nepas;59;39;20;2016
42;Soria;131;Nolay;56;30;26;2016
42;Soria;132;Noviercas;155;80;75;2016
42;Soria;134;Ólvega;3661;1890;1771;2016
42;Soria;135;Oncala;75;44;31;2016
42;Soria;139;Pinilla del Campo;24;14;10;2016
42;Soria;140;Portillo de Soria;16;11;5;2016
42;Soria;141;Póveda de Soria, La;114;67;47;2016
42;Soria;142;Pozalmuro;66;29;37;2016
42;Soria;144;Quintana Redonda;515;296;219;2016
42;Soria;145;Quintanas de Gormaz;152;89;63;2016
42;Soria;148;Quiñonería;10;5;5;2016
42;Soria;149;Rábanos, Los;492;280;212;2016
42;Soria;151;Rebollar;39;18;21;2016
42;Soria;152;Recuerda;90;50;40;2016
42;Soria;153;Rello;17;11;6;2016
42;Soria;154;Renieblas;108;65;43;2016
42;Soria;155;Retortillo de Soria;186;109;77;2016
42;Soria;156;Reznos;31;21;10;2016
42;Soria;157;Riba de Escalote, La;15;10;5;2016
42;Soria;158;Rioseco de Soria;129;74;55;2016
42;Soria;159;Rollamienta;39;25;14;2016
42;Soria;160;Royo, El;281;153;128;2016
42;Soria;161;Salduero;144;80;64;2016
42;Soria;162;San Esteban de Gormaz;3043;1606;1437;2016
42;Soria;163;San Felices;58;34;24;2016
42;Soria;164;San Leonardo de Yagüe;2112;1060;1052;2016
42;Soria;165;San Pedro Manrique;593;335;258;2016
42;Soria;166;Santa Cruz de Yanguas;67;43;24;2016
42;Soria;167;Santa María de Huerta;300;167;133;2016
42;Soria;168;Santa María de las Hoyas;113;64;49;2016
42;Soria;171;Serón de Nágima;129;69;60;2016
42;Soria;172;Soliedra;36;20;16;2016
42;Soria;173;Soria;39171;18534;20637;2016
42;Soria;174;Sotillo del Rincón;188;100;88;2016
42;Soria;175;Suellacabras;24;14;10;2016
42;Soria;176;Tajahuerce;31;18;13;2016
42;Soria;177;Tajueco;72;40;32;2016
42;Soria;178;Talveila;127;69;58;2016
42;Soria;181;Tardelcuende;439;231;208;2016
42;Soria;182;Taroda;48;25;23;2016
42;Soria;183;Tejado;124;72;52;2016
42;Soria;184;Torlengua;61;32;29;2016
42;Soria;185;Torreblacos;26;14;12;2016
42;Soria;187;Torrubia de Soria;74;50;24;2016
42;Soria;188;Trévago;50;23;27;2016
42;Soria;189;Ucero;55;28;27;2016
42;Soria;190;Vadillo;100;55;45;2016
42;Soria;191;Valdeavellano de Tera;204;119;85;2016
42;Soria;192;Valdegeña;43;29;14;2016
42;Soria;193;Valdelagua del Cerro;20;14;6;2016
42;Soria;194;Valdemaluque;177;81;96;2016
42;Soria;195;Valdenebro;116;67;49;2016
42;Soria;196;Valdeprado;11;8;3;2016
42;Soria;197;Valderrodilla;77;43;34;2016
42;Soria;198;Valtajeros;25;14;11;2016
42;Soria;200;Velamazán;82;52;30;2016
42;Soria;201;Velilla de la Sierra;23;14;9;2016
42;Soria;202;Velilla de los Ajos;20;11;9;2016
42;Soria;204;Viana de Duero;57;43;14;2016
42;Soria;205;Villaciervos;92;60;32;2016
42;Soria;206;Villanueva de Gormaz;8;5;3;2016
42;Soria;207;Villar del Ala;49;25;24;2016
42;Soria;208;Villar del Campo;22;14;8;2016
42;Soria;209;Villar del Río;141;90;51;2016
42;Soria;211;Villares de Soria, Los;91;52;39;2016
42;Soria;212;Villasayas;75;49;26;2016
42;Soria;213;Villaseca de Arciel;36;19;17;2016
42;Soria;215;Vinuesa;911;492;419;2016
42;Soria;216;Vizmanos;27;19;8;2016
42;Soria;217;Vozmediano;37;24;13;2016
42;Soria;218;Yanguas;104;67;37;2016
42;Soria;219;Yelo;44;26;18;2016
43;Tarragona;001;Aiguamúrcia;903;476;427;2016
43;Tarragona;002;Albinyana;2303;1167;1136;2016
43;Tarragona;003;Albiol, L';459;235;224;2016
43;Tarragona;004;Alcanar;9494;4785;4709;2016
43;Tarragona;005;Alcover;5095;2538;2557;2016
43;Tarragona;904;Aldea, L';4250;2236;2014;2016
43;Tarragona;006;Aldover;863;436;427;2016
43;Tarragona;007;Aleixar, L';887;456;431;2016
43;Tarragona;008;Alfara de Carles;371;199;172;2016
43;Tarragona;009;Alforja;1844;936;908;2016
43;Tarragona;010;Alió;405;193;212;2016
43;Tarragona;011;Almoster;1401;701;700;2016
43;Tarragona;012;Altafulla;5034;2472;2562;2016
43;Tarragona;013;Ametlla de Mar, L';7102;3593;3509;2016
43;Tarragona;906;Ampolla, L';3322;1680;1642;2016
43;Tarragona;014;Amposta;20654;10389;10265;2016
43;Tarragona;016;Arboç, L';5520;2842;2678;2016
43;Tarragona;015;Arbolí;125;72;53;2016
43;Tarragona;017;Argentera, L';136;77;59;2016
43;Tarragona;018;Arnes;472;238;234;2016
43;Tarragona;019;Ascó;1695;881;814;2016
43;Tarragona;020;Banyeres del Penedès;3091;1563;1528;2016
43;Tarragona;021;Barberà de la Conca;478;255;223;2016
43;Tarragona;022;Batea;1967;982;985;2016
43;Tarragona;023;Bellmunt del Priorat;296;145;151;2016
43;Tarragona;024;Bellvei;2190;1136;1054;2016
43;Tarragona;025;Benifallet;708;348;360;2016
43;Tarragona;026;Benissanet;1218;653;565;2016
43;Tarragona;027;Bisbal de Falset, La;208;115;93;2016
43;Tarragona;028;Bisbal del Penedès, La;3466;1831;1635;2016
43;Tarragona;029;Blancafort;393;205;188;2016
43;Tarragona;030;Bonastre;639;327;312;2016
43;Tarragona;031;Borges del Camp, Les;2070;1042;1028;2016
43;Tarragona;032;Bot;615;312;303;2016
43;Tarragona;033;Botarell;1120;587;533;2016
43;Tarragona;034;Bràfim;668;337;331;2016
43;Tarragona;035;Cabacés;326;166;160;2016
43;Tarragona;036;Cabra del Camp;1113;581;532;2016
43;Tarragona;037;Calafell;24289;12192;12097;2016
43;Tarragona;903;Camarles;3349;1707;1642;2016
43;Tarragona;038;Cambrils;33273;16317;16956;2016
43;Tarragona;907;Canonja, La;5846;2886;2960;2016
43;Tarragona;039;Capafonts;112;58;54;2016
43;Tarragona;040;Capçanes;392;192;200;2016
43;Tarragona;041;Caseres;253;127;126;2016
43;Tarragona;042;Castellvell del Camp;2851;1436;1415;2016
43;Tarragona;043;Catllar, El;4211;2170;2041;2016
43;Tarragona;045;Colldejou;171;92;79;2016
43;Tarragona;046;Conesa;116;60;56;2016
43;Tarragona;047;Constantí;6439;3340;3099;2016
43;Tarragona;048;Corbera d'Ebre;1080;568;512;2016
43;Tarragona;049;Cornudella de Montsant;966;524;442;2016
43;Tarragona;050;Creixell;3467;1759;1708;2016
43;Tarragona;051;Cunit;11808;5837;5971;2016
43;Tarragona;901;Deltebre;11544;5841;5703;2016
43;Tarragona;053;Duesaigües;242;136;106;2016
43;Tarragona;054;Espluga de Francolí, L';3791;1824;1967;2016
43;Tarragona;055;Falset;2834;1411;1423;2016
43;Tarragona;056;Fatarella, La;1004;496;508;2016
43;Tarragona;057;Febró, La;40;26;14;2016
43;Tarragona;058;Figuera, La;105;63;42;2016
43;Tarragona;059;Figuerola del Camp;341;165;176;2016
43;Tarragona;060;Flix;3677;1843;1834;2016
43;Tarragona;061;Forès;47;26;21;2016
43;Tarragona;062;Freginals;396;211;185;2016
43;Tarragona;063;Galera, La;748;389;359;2016
43;Tarragona;064;Gandesa;2999;1526;1473;2016
43;Tarragona;065;Garcia;601;306;295;2016
43;Tarragona;066;Garidells, Els;193;94;99;2016
43;Tarragona;067;Ginestar;778;407;371;2016
43;Tarragona;068;Godall;631;318;313;2016
43;Tarragona;069;Gratallops;237;129;108;2016
43;Tarragona;070;Guiamets, Els;273;128;145;2016
43;Tarragona;071;Horta de Sant Joan;1189;621;568;2016
43;Tarragona;072;Lloar, El;123;64;59;2016
43;Tarragona;073;Llorac;96;56;40;2016
43;Tarragona;074;Llorenç del Penedès;2323;1155;1168;2016
43;Tarragona;076;Marçà;586;309;277;2016
43;Tarragona;075;Margalef;97;59;38;2016
43;Tarragona;077;Mas de Barberans;605;296;309;2016
43;Tarragona;078;Masdenverge;1088;555;533;2016
43;Tarragona;079;Masllorenç;502;272;230;2016
43;Tarragona;080;Masó, La;290;155;135;2016
43;Tarragona;081;Maspujols;774;400;374;2016
43;Tarragona;082;Masroig, El;494;273;221;2016
43;Tarragona;083;Milà, El;178;89;89;2016
43;Tarragona;084;Miravet;737;398;339;2016
43;Tarragona;085;Molar, El;282;148;134;2016
43;Tarragona;086;Montblanc;7290;3682;3608;2016
43;Tarragona;088;Montbrió del Camp;2779;1428;1351;2016
43;Tarragona;089;Montferri;400;217;183;2016
43;Tarragona;090;Montmell, El;1397;747;650;2016
43;Tarragona;091;Mont-ral;166;94;72;2016
43;Tarragona;092;Mont-roig del Camp;11521;5970;5551;2016
43;Tarragona;093;Móra d'Ebre;5574;2765;2809;2016
43;Tarragona;094;Móra la Nova;3104;1564;1540;2016
43;Tarragona;095;Morell, El;3550;1808;1742;2016
43;Tarragona;096;Morera de Montsant, La;153;89;64;2016
43;Tarragona;097;Nou de Gaià, La;546;268;278;2016
43;Tarragona;098;Nulles;453;237;216;2016
43;Tarragona;100;Pallaresos, Els;4597;2322;2275;2016
43;Tarragona;099;Palma d'Ebre, La;363;172;191;2016
43;Tarragona;101;Passanant i Belltall;161;93;68;2016
43;Tarragona;102;Paüls;580;280;300;2016
43;Tarragona;103;Perafort;1282;679;603;2016
43;Tarragona;104;Perelló, El;2903;1502;1401;2016
43;Tarragona;105;Piles, Les;207;112;95;2016
43;Tarragona;106;Pinell de Brai, El;1014;510;504;2016
43;Tarragona;107;Pira;500;268;232;2016
43;Tarragona;108;Pla de Santa Maria, El;2294;1191;1103;2016
43;Tarragona;109;Pobla de Mafumet, La;3771;1939;1832;2016
43;Tarragona;110;Pobla de Massaluca, La;333;179;154;2016
43;Tarragona;111;Pobla de Montornès, La;2806;1473;1333;2016
43;Tarragona;112;Poboleda;374;204;170;2016
43;Tarragona;113;Pont d'Armentera, El;515;264;251;2016
43;Tarragona;141;Pontils;120;65;55;2016
43;Tarragona;114;Porrera;445;238;207;2016
43;Tarragona;115;Pradell de la Teixeta;174;76;98;2016
43;Tarragona;116;Prades;587;307;280;2016
43;Tarragona;117;Prat de Comte;177;94;83;2016
43;Tarragona;118;Pratdip;691;366;325;2016
43;Tarragona;119;Puigpelat;1121;572;549;2016
43;Tarragona;120;Querol;543;306;237;2016
43;Tarragona;121;Rasquera;819;399;420;2016
43;Tarragona;122;Renau;148;77;71;2016
43;Tarragona;123;Reus;103615;50188;53427;2016
43;Tarragona;124;Riba, La;594;324;270;2016
43;Tarragona;125;Riba-roja d'Ebre;1156;611;545;2016
43;Tarragona;126;Riera de Gaià, La;1694;846;848;2016
43;Tarragona;127;Riudecanyes;1116;587;529;2016
43;Tarragona;128;Riudecols;1169;614;555;2016
43;Tarragona;129;Riudoms;6591;3397;3194;2016
43;Tarragona;130;Rocafort de Queralt;251;133;118;2016
43;Tarragona;131;Roda de Berà;6391;3309;3082;2016
43;Tarragona;132;Rodonyà;492;254;238;2016
43;Tarragona;133;Roquetes;8165;4241;3924;2016
43;Tarragona;134;Rourell, El;398;203;195;2016
43;Tarragona;135;Salomó;540;277;263;2016
43;Tarragona;905;Salou;26386;13738;12648;2016
43;Tarragona;136;Sant Carles de la Ràpita;14718;7220;7498;2016
43;Tarragona;137;Sant Jaume dels Domenys;2543;1312;1231;2016
43;Tarragona;902;Sant Jaume d'Enveja;3516;1761;1755;2016
43;Tarragona;138;Santa Bàrbara;3774;1926;1848;2016
43;Tarragona;139;Santa Coloma de Queralt;2726;1347;1379;2016
43;Tarragona;140;Santa Oliva;3260;1657;1603;2016
43;Tarragona;142;Sarral;1587;811;776;2016
43;Tarragona;143;Savallà del Comtat;59;29;30;2016
43;Tarragona;144;Secuita, La;1692;850;842;2016
43;Tarragona;145;Selva del Camp, La;5591;2813;2778;2016
43;Tarragona;146;Senan;51;33;18;2016
43;Tarragona;044;Sénia, La;5654;2835;2819;2016
43;Tarragona;147;Solivella;619;314;305;2016
43;Tarragona;148;Tarragona;131094;63798;67296;2016
43;Tarragona;149;Tivenys;887;451;436;2016
43;Tarragona;150;Tivissa;1684;847;837;2016
43;Tarragona;151;Torre de Fontaubella, La;134;69;65;2016
43;Tarragona;152;Torre de l'Espanyol, La;635;331;304;2016
43;Tarragona;153;Torredembarra;15460;7557;7903;2016
43;Tarragona;154;Torroja del Priorat;153;85;68;2016
43;Tarragona;155;Tortosa;33743;16837;16906;2016
43;Tarragona;156;Ulldecona;6368;3271;3097;2016
43;Tarragona;157;Ulldemolins;401;227;174;2016
43;Tarragona;158;Vallclara;110;62;48;2016
43;Tarragona;159;Vallfogona de Riucorb;94;57;37;2016
43;Tarragona;160;Vallmoll;1645;824;821;2016
43;Tarragona;161;Valls;24285;12101;12184;2016
43;Tarragona;162;Vandellòs i l'Hospitalet de l'Infant;6143;3074;3069;2016
43;Tarragona;163;Vendrell, El;36482;18162;18320;2016
43;Tarragona;164;Vespella de Gaià;421;231;190;2016
43;Tarragona;165;Vilabella;760;393;367;2016
43;Tarragona;175;Vilalba dels Arcs;658;331;327;2016
43;Tarragona;166;Vilallonga del Camp;2255;1158;1097;2016
43;Tarragona;168;Vilanova de Prades;118;62;56;2016
43;Tarragona;167;Vilanova d'Escornalbou;542;286;256;2016
43;Tarragona;169;Vilaplana;590;302;288;2016
43;Tarragona;170;Vila-rodona;1255;647;608;2016
43;Tarragona;171;Vila-seca;21935;11021;10914;2016
43;Tarragona;172;Vilaverd;452;235;217;2016
43;Tarragona;173;Vilella Alta, La;135;73;62;2016
43;Tarragona;174;Vilella Baixa, La;193;106;87;2016
43;Tarragona;176;Vimbodí i Poblet;954;528;426;2016
43;Tarragona;177;Vinebre;430;215;215;2016
43;Tarragona;178;Vinyols i els Arcs;1918;994;924;2016
43;Tarragona;052;Xerta;1190;574;616;2016
44;Teruel;001;Ababuj;76;47;29;2016
44;Teruel;002;Abejuela;56;34;22;2016
44;Teruel;003;Aguatón;19;7;12;2016
44;Teruel;004;Aguaviva;550;267;283;2016
44;Teruel;005;Aguilar del Alfambra;64;43;21;2016
44;Teruel;006;Alacón;279;142;137;2016
44;Teruel;007;Alba;196;107;89;2016
44;Teruel;008;Albalate del Arzobispo;2003;1013;990;2016
44;Teruel;009;Albarracín;1054;542;512;2016
44;Teruel;010;Albentosa;267;136;131;2016
44;Teruel;011;Alcaine;70;44;26;2016
44;Teruel;012;Alcalá de la Selva;398;218;180;2016
44;Teruel;013;Alcañiz;16043;7972;8071;2016
44;Teruel;014;Alcorisa;3326;1688;1638;2016
44;Teruel;016;Alfambra;568;300;268;2016
44;Teruel;017;Aliaga;348;191;157;2016
44;Teruel;021;Allepuz;128;63;65;2016
44;Teruel;022;Alloza;602;300;302;2016
44;Teruel;023;Allueva;29;15;14;2016
44;Teruel;018;Almohaja;19;14;5;2016
44;Teruel;019;Alobras;63;37;26;2016
44;Teruel;020;Alpeñés;23;14;9;2016
44;Teruel;024;Anadón;27;17;10;2016
44;Teruel;025;Andorra;7875;3987;3888;2016
44;Teruel;026;Arcos de las Salinas;106;58;48;2016
44;Teruel;027;Arens de Lledó;212;101;111;2016
44;Teruel;028;Argente;207;101;106;2016
44;Teruel;029;Ariño;738;371;367;2016
44;Teruel;031;Azaila;106;52;54;2016
44;Teruel;032;Bádenas;19;11;8;2016
44;Teruel;033;Báguena;316;173;143;2016
44;Teruel;034;Bañón;158;86;72;2016
44;Teruel;035;Barrachina;129;69;60;2016
44;Teruel;036;Bea;35;21;14;2016
44;Teruel;037;Beceite;561;287;274;2016
44;Teruel;039;Bello;245;115;130;2016
44;Teruel;038;Belmonte de San José;119;61;58;2016
44;Teruel;040;Berge;248;128;120;2016
44;Teruel;041;Bezas;65;40;25;2016
44;Teruel;042;Blancas;147;83;64;2016
44;Teruel;043;Blesa;101;64;37;2016
44;Teruel;044;Bordón;114;65;49;2016
44;Teruel;045;Bronchales;417;243;174;2016
44;Teruel;046;Bueña;53;26;27;2016
44;Teruel;047;Burbáguena;254;133;121;2016
44;Teruel;048;Cabra de Mora;68;39;29;2016
44;Teruel;049;Calaceite;1039;520;519;2016
44;Teruel;050;Calamocha;4368;2147;2221;2016
44;Teruel;051;Calanda;3846;1902;1944;2016
44;Teruel;052;Calomarde;80;49;31;2016
44;Teruel;053;Camañas;130;71;59;2016
44;Teruel;054;Camarena de la Sierra;127;78;49;2016
44;Teruel;055;Camarillas;94;56;38;2016
44;Teruel;056;Caminreal;637;330;307;2016
44;Teruel;059;Cantavieja;712;381;331;2016
44;Teruel;060;Cañada de Benatanduz;41;27;14;2016
44;Teruel;061;Cañada de Verich, La;94;58;36;2016
44;Teruel;062;Cañada Vellida;35;25;10;2016
44;Teruel;063;Cañizar del Olivar;94;50;44;2016
44;Teruel;064;Cascante del Río;74;46;28;2016
44;Teruel;065;Castejón de Tornos;62;37;25;2016
44;Teruel;066;Castel de Cabra;120;65;55;2016
44;Teruel;070;Castellar, El;56;36;20;2016
44;Teruel;071;Castellote;706;366;340;2016
44;Teruel;067;Castelnou;137;71;66;2016
44;Teruel;068;Castelserás;827;431;396;2016
44;Teruel;074;Cedrillas;619;318;301;2016
44;Teruel;075;Celadas;403;226;177;2016
44;Teruel;076;Cella;2673;1403;1270;2016
44;Teruel;077;Cerollera, La;96;61;35;2016
44;Teruel;080;Codoñera, La;368;195;173;2016
44;Teruel;082;Corbalán;109;59;50;2016
44;Teruel;084;Cortes de Aragón;63;28;35;2016
44;Teruel;085;Cosa;55;31;24;2016
44;Teruel;086;Cretas;554;277;277;2016
44;Teruel;087;Crivillén;71;35;36;2016
44;Teruel;088;Cuba, La;38;20;18;2016
44;Teruel;089;Cubla;52;35;17;2016
44;Teruel;090;Cucalón;96;57;39;2016
44;Teruel;092;Cuervo, El;89;49;40;2016
44;Teruel;093;Cuevas de Almudén;141;81;60;2016
44;Teruel;094;Cuevas Labradas;127;70;57;2016
44;Teruel;096;Ejulve;189;97;92;2016
44;Teruel;097;Escorihuela;152;75;77;2016
44;Teruel;099;Escucha;954;522;432;2016
44;Teruel;100;Estercuel;237;135;102;2016
44;Teruel;101;Ferreruela de Huerva;67;36;31;2016
44;Teruel;102;Fonfría;31;18;13;2016
44;Teruel;103;Formiche Alto;164;87;77;2016
44;Teruel;105;Fórnoles;86;45;41;2016
44;Teruel;106;Fortanete;204;114;90;2016
44;Teruel;107;Foz-Calanda;264;137;127;2016
44;Teruel;108;Fresneda, La;470;267;203;2016
44;Teruel;109;Frías de Albarracín;130;73;57;2016
44;Teruel;110;Fuenferrada;56;32;24;2016
44;Teruel;111;Fuentes Calientes;105;58;47;2016
44;Teruel;112;Fuentes Claras;494;269;225;2016
44;Teruel;113;Fuentes de Rubielos;114;62;52;2016
44;Teruel;114;Fuentespalda;291;146;145;2016
44;Teruel;115;Galve;159;80;79;2016
44;Teruel;116;Gargallo;102;53;49;2016
44;Teruel;117;Gea de Albarracín;374;198;176;2016
44;Teruel;118;Ginebrosa, La;199;110;89;2016
44;Teruel;119;Griegos;160;94;66;2016
44;Teruel;120;Guadalaviar;245;141;104;2016
44;Teruel;121;Gúdar;73;42;31;2016
44;Teruel;122;Híjar;1724;869;855;2016
44;Teruel;123;Hinojosa de Jarque;131;75;56;2016
44;Teruel;124;Hoz de la Vieja, La;79;41;38;2016
44;Teruel;125;Huesa del Común;69;42;27;2016
44;Teruel;126;Iglesuela del Cid, La;424;222;202;2016
44;Teruel;127;Jabaloyas;77;43;34;2016
44;Teruel;128;Jarque de la Val;74;38;36;2016
44;Teruel;129;Jatiel;42;24;18;2016
44;Teruel;130;Jorcas;38;24;14;2016
44;Teruel;131;Josa;34;20;14;2016
44;Teruel;132;Lagueruela;79;42;37;2016
44;Teruel;133;Lanzuela;27;21;6;2016
44;Teruel;135;Libros;113;70;43;2016
44;Teruel;136;Lidón;55;27;28;2016
44;Teruel;137;Linares de Mora;267;155;112;2016
44;Teruel;141;Lledó;163;86;77;2016
44;Teruel;138;Loscos;138;84;54;2016
44;Teruel;142;Maicas;35;19;16;2016
44;Teruel;143;Manzanera;502;267;235;2016
44;Teruel;144;Martín del Río;429;216;213;2016
44;Teruel;145;Mas de las Matas;1302;684;618;2016
44;Teruel;146;Mata de los Olmos, La;263;130;133;2016
44;Teruel;147;Mazaleón;540;292;248;2016
44;Teruel;148;Mezquita de Jarque;109;63;46;2016
44;Teruel;149;Mirambel;122;69;53;2016
44;Teruel;150;Miravete de la Sierra;28;19;9;2016
44;Teruel;151;Molinos;251;132;119;2016
44;Teruel;152;Monforte de Moyuela;66;47;19;2016
44;Teruel;153;Monreal del Campo;2526;1265;1261;2016
44;Teruel;154;Monroyo;338;205;133;2016
44;Teruel;155;Montalbán;1281;649;632;2016
44;Teruel;156;Monteagudo del Castillo;52;28;24;2016
44;Teruel;157;Monterde de Albarracín;66;36;30;2016
44;Teruel;158;Mora de Rubielos;1574;798;776;2016
44;Teruel;159;Moscardón;56;29;27;2016
44;Teruel;160;Mosqueruela;581;322;259;2016
44;Teruel;161;Muniesa;629;333;296;2016
44;Teruel;163;Noguera de Albarracín;146;79;67;2016
44;Teruel;164;Nogueras;29;20;9;2016
44;Teruel;165;Nogueruelas;214;117;97;2016
44;Teruel;167;Obón;44;24;20;2016
44;Teruel;168;Odón;225;122;103;2016
44;Teruel;169;Ojos Negros;405;218;187;2016
44;Teruel;171;Olba;230;133;97;2016
44;Teruel;172;Oliete;365;187;178;2016
44;Teruel;173;Olmos, Los;127;68;59;2016
44;Teruel;174;Orihuela del Tremedal;504;273;231;2016
44;Teruel;175;Orrios;133;69;64;2016
44;Teruel;176;Palomar de Arroyos;174;104;70;2016
44;Teruel;177;Pancrudo;116;72;44;2016
44;Teruel;178;Parras de Castellote, Las;57;33;24;2016
44;Teruel;179;Peñarroya de Tastavins;465;252;213;2016
44;Teruel;180;Peracense;75;43;32;2016
44;Teruel;181;Peralejos;86;44;42;2016
44;Teruel;182;Perales del Alfambra;227;119;108;2016
44;Teruel;183;Pitarque;91;46;45;2016
44;Teruel;184;Plou;49;31;18;2016
44;Teruel;185;Pobo, El;132;84;48;2016
44;Teruel;187;Portellada, La;240;119;121;2016
44;Teruel;189;Pozondón;60;33;27;2016
44;Teruel;190;Pozuel del Campo;72;39;33;2016
44;Teruel;191;Puebla de Híjar, La;930;466;464;2016
44;Teruel;192;Puebla de Valverde, La;460;253;207;2016
44;Teruel;193;Puertomingalvo;112;64;48;2016
44;Teruel;194;Ráfales;138;75;63;2016
44;Teruel;195;Rillo;92;52;40;2016
44;Teruel;196;Riodeva;151;73;78;2016
44;Teruel;197;Ródenas;64;36;28;2016
44;Teruel;198;Royuela;215;117;98;2016
44;Teruel;199;Rubiales;50;29;21;2016
44;Teruel;200;Rubielos de la Cérida;39;22;17;2016
44;Teruel;201;Rubielos de Mora;658;342;316;2016
44;Teruel;203;Salcedillo;17;14;3;2016
44;Teruel;204;Saldón;26;16;10;2016
44;Teruel;205;Samper de Calanda;845;422;423;2016
44;Teruel;206;San Agustín;132;84;48;2016
44;Teruel;207;San Martín del Río;163;84;79;2016
44;Teruel;208;Santa Cruz de Nogueras;40;20;20;2016
44;Teruel;209;Santa Eulalia;1059;532;527;2016
44;Teruel;210;Sarrión;1125;596;529;2016
44;Teruel;211;Segura de los Baños;44;28;16;2016
44;Teruel;212;Seno;41;19;22;2016
44;Teruel;213;Singra;80;46;34;2016
44;Teruel;215;Terriente;173;99;74;2016
44;Teruel;216;Teruel;35564;17008;18556;2016
44;Teruel;217;Toril y Masegoso;30;25;5;2016
44;Teruel;218;Tormón;34;20;14;2016
44;Teruel;219;Tornos;228;122;106;2016
44;Teruel;220;Torralba de los Sisones;163;91;72;2016
44;Teruel;223;Torre de Arcas;81;38;43;2016
44;Teruel;224;Torre de las Arcas;29;14;15;2016
44;Teruel;225;Torre del Compte;129;63;66;2016
44;Teruel;227;Torre los Negros;87;46;41;2016
44;Teruel;221;Torrecilla de Alcañiz;424;225;199;2016
44;Teruel;222;Torrecilla del Rebollar;137;87;50;2016
44;Teruel;226;Torrelacárcel;176;90;86;2016
44;Teruel;228;Torremocha de Jiloca;110;63;47;2016
44;Teruel;229;Torres de Albarracín;179;100;79;2016
44;Teruel;230;Torrevelilla;203;95;108;2016
44;Teruel;231;Torrijas;45;21;24;2016
44;Teruel;232;Torrijo del Campo;462;243;219;2016
44;Teruel;234;Tramacastiel;66;37;29;2016
44;Teruel;235;Tramacastilla;108;51;57;2016
44;Teruel;236;Tronchón;67;36;31;2016
44;Teruel;237;Urrea de Gaén;475;237;238;2016
44;Teruel;238;Utrillas;3056;1574;1482;2016
44;Teruel;239;Valacloche;23;13;10;2016
44;Teruel;240;Valbona;186;102;84;2016
44;Teruel;241;Valdealgorfa;645;325;320;2016
44;Teruel;243;Valdecuenca;34;23;11;2016
44;Teruel;244;Valdelinares;90;55;35;2016
44;Teruel;245;Valdeltormo;296;146;150;2016
44;Teruel;246;Valderrobres;2311;1171;1140;2016
44;Teruel;247;Valjunquera;363;187;176;2016
44;Teruel;249;Vallecillo, El;59;35;24;2016
44;Teruel;250;Veguillas de la Sierra;19;11;8;2016
44;Teruel;251;Villafranca del Campo;300;158;142;2016
44;Teruel;252;Villahermosa del Campo;99;67;32;2016
44;Teruel;256;Villanueva del Rebollar de la Sierra;49;28;21;2016
44;Teruel;257;Villar del Cobo;188;105;83;2016
44;Teruel;258;Villar del Salz;70;42;28;2016
44;Teruel;260;Villarluengo;176;106;70;2016
44;Teruel;261;Villarquemado;863;452;411;2016
44;Teruel;262;Villarroya de los Pinares;160;84;76;2016
44;Teruel;263;Villastar;503;256;247;2016
44;Teruel;264;Villel;338;196;142;2016
44;Teruel;265;Vinaceite;262;134;128;2016
44;Teruel;266;Visiedo;138;64;74;2016
44;Teruel;267;Vivel del Río Martín;78;42;36;2016
44;Teruel;268;Zoma, La;16;5;11;2016
45;Toledo;001;Ajofrín;2267;1133;1134;2016
45;Toledo;002;Alameda de la Sagra;3561;1864;1697;2016
45;Toledo;003;Albarreal de Tajo;701;365;336;2016
45;Toledo;004;Alcabón;705;369;336;2016
45;Toledo;005;Alcañizo;281;142;139;2016
45;Toledo;006;Alcaudete de la Jara;1832;937;895;2016
45;Toledo;007;Alcolea de Tajo;835;417;418;2016
45;Toledo;008;Aldea en Cabo;172;89;83;2016
45;Toledo;009;Aldeanueva de Barbarroya;594;294;300;2016
45;Toledo;010;Aldeanueva de San Bartolomé;449;228;221;2016
45;Toledo;011;Almendral de la Cañada;320;173;147;2016
45;Toledo;012;Almonacid de Toledo;851;417;434;2016
45;Toledo;013;Almorox;2240;1177;1063;2016
45;Toledo;014;Añover de Tajo;5160;2654;2506;2016
45;Toledo;015;Arcicóllar;784;393;391;2016
45;Toledo;016;Argés;6093;3061;3032;2016
45;Toledo;017;Azután;289;143;146;2016
45;Toledo;018;Barcience;783;421;362;2016
45;Toledo;019;Bargas;10021;4976;5045;2016
45;Toledo;020;Belvís de la Jara;1611;810;801;2016
45;Toledo;021;Borox;3614;1878;1736;2016
45;Toledo;022;Buenaventura;430;226;204;2016
45;Toledo;023;Burguillos de Toledo;3092;1580;1512;2016
45;Toledo;024;Burujón;1379;725;654;2016
45;Toledo;025;Cabañas de la Sagra;1781;932;849;2016
45;Toledo;026;Cabañas de Yepes;251;130;121;2016
45;Toledo;027;Cabezamesada;385;209;176;2016
45;Toledo;028;Calera y Chozas;4633;2362;2271;2016
45;Toledo;029;Caleruela;225;114;111;2016
45;Toledo;030;Calzada de Oropesa;541;296;245;2016
45;Toledo;031;Camarena;3723;1931;1792;2016
45;Toledo;032;Camarenilla;565;291;274;2016
45;Toledo;033;Campillo de la Jara, El;390;206;184;2016
45;Toledo;034;Camuñas;1812;927;885;2016
45;Toledo;035;Cardiel de los Montes;353;186;167;2016
45;Toledo;036;Carmena;771;402;369;2016
45;Toledo;037;Carpio de Tajo, El;1963;982;981;2016
45;Toledo;038;Carranque;4612;2378;2234;2016
45;Toledo;039;Carriches;282;145;137;2016
45;Toledo;040;Casar de Escalona, El;1933;1024;909;2016
45;Toledo;041;Casarrubios del Monte;5309;2787;2522;2016
45;Toledo;042;Casasbuenas;210;107;103;2016
45;Toledo;043;Castillo de Bayuela;946;480;466;2016
45;Toledo;045;Cazalegas;1764;886;878;2016
45;Toledo;046;Cebolla;3445;1742;1703;2016
45;Toledo;047;Cedillo del Condado;3680;1909;1771;2016
45;Toledo;048;Cerralbos, Los;415;225;190;2016
45;Toledo;049;Cervera de los Montes;539;275;264;2016
45;Toledo;056;Chozas de Canales;3710;1955;1755;2016
45;Toledo;057;Chueca;268;142;126;2016
45;Toledo;050;Ciruelos;556;299;257;2016
45;Toledo;051;Cobeja;2201;1152;1049;2016
45;Toledo;052;Cobisa;4186;2096;2090;2016
45;Toledo;053;Consuegra;10328;5217;5111;2016
45;Toledo;054;Corral de Almaguer;5536;2823;2713;2016
45;Toledo;055;Cuerva;1385;725;660;2016
45;Toledo;058;Domingo Pérez;436;219;217;2016
45;Toledo;059;Dosbarrios;2241;1149;1092;2016
45;Toledo;060;Erustes;222;115;107;2016
45;Toledo;061;Escalona;3203;1638;1565;2016
45;Toledo;062;Escalonilla;1462;728;734;2016
45;Toledo;063;Espinoso del Rey;497;271;226;2016
45;Toledo;064;Esquivias;5386;2724;2662;2016
45;Toledo;065;Estrella, La;250;128;122;2016
45;Toledo;066;Fuensalida;11001;5561;5440;2016
45;Toledo;067;Gálvez;3136;1572;1564;2016
45;Toledo;068;Garciotum;181;91;90;2016
45;Toledo;069;Gerindote;2384;1226;1158;2016
45;Toledo;070;Guadamur;1833;921;912;2016
45;Toledo;071;Guardia, La;2286;1159;1127;2016
45;Toledo;072;Herencias, Las;815;432;383;2016
45;Toledo;073;Herreruela de Oropesa;365;181;184;2016
45;Toledo;074;Hinojosa de San Vicente;413;225;188;2016
45;Toledo;075;Hontanar;158;95;63;2016
45;Toledo;076;Hormigos;722;387;335;2016
45;Toledo;077;Huecas;657;338;319;2016
45;Toledo;078;Huerta de Valdecarábanos;1770;876;894;2016
45;Toledo;079;Iglesuela, La;433;227;206;2016
45;Toledo;080;Illán de Vacas;6;4;2;2016
45;Toledo;081;Illescas;26672;13560;13112;2016
45;Toledo;082;Lagartera;1468;727;741;2016
45;Toledo;083;Layos;625;310;315;2016
45;Toledo;084;Lillo;2754;1428;1326;2016
45;Toledo;085;Lominchar;2365;1240;1125;2016
45;Toledo;086;Lucillos;602;316;286;2016
45;Toledo;087;Madridejos;10793;5436;5357;2016
45;Toledo;088;Magán;3225;1653;1572;2016
45;Toledo;089;Malpica de Tajo;1842;939;903;2016
45;Toledo;090;Manzaneque;406;198;208;2016
45;Toledo;091;Maqueda;480;242;238;2016
45;Toledo;092;Marjaliza;288;142;146;2016
45;Toledo;093;Marrupe;163;85;78;2016
45;Toledo;094;Mascaraque;446;223;223;2016
45;Toledo;095;Mata, La;908;458;450;2016
45;Toledo;096;Mazarambroz;1278;657;621;2016
45;Toledo;097;Mejorada;1268;657;611;2016
45;Toledo;098;Menasalbas;2785;1459;1326;2016
45;Toledo;099;Méntrida;4909;2515;2394;2016
45;Toledo;100;Mesegar de Tajo;224;118;106;2016
45;Toledo;101;Miguel Esteban;5042;2516;2526;2016
45;Toledo;102;Mocejón;4844;2458;2386;2016
45;Toledo;103;Mohedas de la Jara;436;241;195;2016
45;Toledo;104;Montearagón;522;275;247;2016
45;Toledo;105;Montesclaros;426;228;198;2016
45;Toledo;106;Mora;9897;4968;4929;2016
45;Toledo;107;Nambroca;4524;2320;2204;2016
45;Toledo;108;Nava de Ricomalillo, La;570;292;278;2016
45;Toledo;109;Navahermosa;3818;1973;1845;2016
45;Toledo;110;Navalcán;2137;1139;998;2016
45;Toledo;111;Navalmoralejo;70;38;32;2016
45;Toledo;112;Navalmorales, Los;2673;1400;1273;2016
45;Toledo;113;Navalucillos, Los;2309;1190;1119;2016
45;Toledo;114;Navamorcuende;655;334;321;2016
45;Toledo;115;Noblejas;3533;1796;1737;2016
45;Toledo;116;Noez;899;453;446;2016
45;Toledo;117;Nombela;920;482;438;2016
45;Toledo;118;Novés;2707;1413;1294;2016
45;Toledo;119;Numancia de la Sagra;4734;2483;2251;2016
45;Toledo;120;Nuño Gómez;143;77;66;2016
45;Toledo;121;Ocaña;10489;5315;5174;2016
45;Toledo;122;Olías del Rey;7357;3737;3620;2016
45;Toledo;123;Ontígola;4250;2266;1984;2016
45;Toledo;124;Orgaz;2706;1349;1357;2016
45;Toledo;125;Oropesa;2744;1347;1397;2016
45;Toledo;126;Otero;356;183;173;2016
45;Toledo;127;Palomeque;876;477;399;2016
45;Toledo;128;Pantoja;3335;1678;1657;2016
45;Toledo;129;Paredes de Escalona;137;65;72;2016
45;Toledo;130;Parrillas;365;192;173;2016
45;Toledo;131;Pelahustán;333;181;152;2016
45;Toledo;132;Pepino;2801;1462;1339;2016
45;Toledo;133;Polán;3833;1925;1908;2016
45;Toledo;134;Portillo de Toledo;2153;1073;1080;2016
45;Toledo;135;Puebla de Almoradiel, La;5454;2764;2690;2016
45;Toledo;136;Puebla de Montalbán, La;7959;4038;3921;2016
45;Toledo;137;Pueblanueva, La;2244;1122;1122;2016
45;Toledo;138;Puente del Arzobispo, El;1296;636;660;2016
45;Toledo;139;Puerto de San Vicente;174;92;82;2016
45;Toledo;140;Pulgar;1558;794;764;2016
45;Toledo;141;Quero;1065;544;521;2016
45;Toledo;142;Quintanar de la Orden;11130;5562;5568;2016
45;Toledo;143;Quismondo;1525;778;747;2016
45;Toledo;144;Real de San Vicente, El;998;526;472;2016
45;Toledo;145;Recas;4309;2395;1914;2016
45;Toledo;146;Retamoso de la Jara;110;54;56;2016
45;Toledo;147;Rielves;746;376;370;2016
45;Toledo;148;Robledo del Mazo;310;171;139;2016
45;Toledo;149;Romeral, El;641;321;320;2016
45;Toledo;150;San Bartolomé de las Abiertas;495;263;232;2016
45;Toledo;151;San Martín de Montalbán;786;391;395;2016
45;Toledo;152;San Martín de Pusa;712;371;341;2016
45;Toledo;153;San Pablo de los Montes;1900;961;939;2016
45;Toledo;154;San Román de los Montes;1869;993;876;2016
45;Toledo;155;Santa Ana de Pusa;413;236;177;2016
45;Toledo;156;Santa Cruz de la Zarza;4328;2185;2143;2016
45;Toledo;157;Santa Cruz del Retamar;2857;1476;1381;2016
45;Toledo;158;Santa Olalla;3220;1640;1580;2016
45;Toledo;901;Santo Domingo-Caudilla;1014;535;479;2016
45;Toledo;159;Sartajada;102;59;43;2016
45;Toledo;160;Segurilla;1317;672;645;2016
45;Toledo;161;Seseña;22027;11440;10587;2016
45;Toledo;162;Sevilleja de la Jara;729;395;334;2016
45;Toledo;163;Sonseca;11198;5679;5519;2016
45;Toledo;164;Sotillo de las Palomas;204;111;93;2016
45;Toledo;165;Talavera de la Reina;84119;40543;43576;2016
45;Toledo;166;Tembleque;2091;1069;1022;2016
45;Toledo;167;Toboso, El;1887;948;939;2016
45;Toledo;168;Toledo;83459;39986;43473;2016
45;Toledo;169;Torralba de Oropesa;215;113;102;2016
45;Toledo;171;Torre de Esteban Hambrán, La;1729;886;843;2016
45;Toledo;170;Torrecilla de la Jara;251;130;121;2016
45;Toledo;172;Torrico;781;401;380;2016
45;Toledo;173;Torrijos;13257;6522;6735;2016
45;Toledo;174;Totanés;362;185;177;2016
45;Toledo;175;Turleque;813;419;394;2016
45;Toledo;176;Ugena;5294;2724;2570;2016
45;Toledo;177;Urda;2705;1337;1368;2016
45;Toledo;179;Valdeverdeja;613;303;310;2016
45;Toledo;180;Valmojado;4113;2087;2026;2016
45;Toledo;181;Velada;2890;1494;1396;2016
45;Toledo;182;Ventas con Peña Aguilera, Las;1183;601;582;2016
45;Toledo;183;Ventas de Retamosa, Las;3275;1718;1557;2016
45;Toledo;184;Ventas de San Julián, Las;235;112;123;2016
45;Toledo;186;Villa de Don Fadrique, La;3854;1920;1934;2016
45;Toledo;185;Villacañas;9935;4930;5005;2016
45;Toledo;187;Villafranca de los Caballeros;5098;2532;2566;2016
45;Toledo;188;Villaluenga de la Sagra;3828;1903;1925;2016
45;Toledo;189;Villamiel de Toledo;857;451;406;2016
45;Toledo;190;Villaminaya;567;288;279;2016
45;Toledo;191;Villamuelas;651;341;310;2016
45;Toledo;192;Villanueva de Alcardete;3451;1801;1650;2016
45;Toledo;193;Villanueva de Bogas;755;392;363;2016
45;Toledo;194;Villarejo de Montalbán;77;42;35;2016
45;Toledo;195;Villarrubia de Santiago;2611;1315;1296;2016
45;Toledo;196;Villaseca de la Sagra;1831;912;919;2016
45;Toledo;197;Villasequilla;2503;1280;1223;2016
45;Toledo;198;Villatobas;2433;1248;1185;2016
45;Toledo;199;Viso de San Juan, El;4207;2252;1955;2016
45;Toledo;200;Yébenes, Los;6095;3128;2967;2016
45;Toledo;201;Yeles;5052;2660;2392;2016
45;Toledo;202;Yepes;5066;2589;2477;2016
45;Toledo;203;Yuncler;3648;1848;1800;2016
45;Toledo;204;Yunclillos;864;448;416;2016
45;Toledo;205;Yuncos;10613;5471;5142;2016
46;Valencia/València;001;Ademuz;1137;605;532;2016
46;Valencia/València;002;Ador;1437;757;680;2016
46;Valencia/València;004;Agullent;2395;1188;1207;2016
46;Valencia/València;042;Aielo de Malferit;4724;2356;2368;2016
46;Valencia/València;043;Aielo de Rugat;168;89;79;2016
46;Valencia/València;005;Alaquàs;29660;14582;15078;2016
46;Valencia/València;006;Albaida;5933;2923;3010;2016
46;Valencia/València;007;Albal;16136;8072;8064;2016
46;Valencia/València;008;Albalat de la Ribera;3431;1742;1689;2016
46;Valencia/València;009;Albalat dels Sorells;3889;1885;2004;2016
46;Valencia/València;010;Albalat dels Tarongers;1185;627;558;2016
46;Valencia/València;011;Alberic;10537;5299;5238;2016
46;Valencia/València;012;Alborache;1147;596;551;2016
46;Valencia/València;013;Alboraya;23837;11678;12159;2016
46;Valencia/València;014;Albuixech;3919;1955;1964;2016
46;Valencia/València;016;Alcàntera de Xúquer;1319;650;669;2016
46;Valencia/València;015;Alcàsser;9692;4905;4787;2016
46;Valencia/València;018;Alcublas;691;357;334;2016
46;Valencia/València;020;Alcúdia de Crespins, l';5181;2584;2597;2016
46;Valencia/València;019;Alcúdia, l';11820;5794;6026;2016
46;Valencia/València;021;Aldaia;31246;15612;15634;2016
46;Valencia/València;022;Alfafar;20777;10186;10591;2016
46;Valencia/València;024;Alfara de la Baronia;522;264;258;2016
46;Valencia/València;025;Alfara del Patriarca;3323;1627;1696;2016
46;Valencia/València;026;Alfarp;1510;781;729;2016
46;Valencia/València;027;Alfarrasí;1274;634;640;2016
46;Valencia/València;023;Alfauir;451;229;222;2016
46;Valencia/València;028;Algar de Palancia;484;246;238;2016
46;Valencia/València;029;Algemesí;27607;13706;13901;2016
46;Valencia/València;030;Algimia de Alfara;1047;532;515;2016
46;Valencia/València;031;Alginet;13283;6760;6523;2016
46;Valencia/València;032;Almàssera;7297;3553;3744;2016
46;Valencia/València;033;Almiserà;273;136;137;2016
46;Valencia/València;034;Almoines;2322;1176;1146;2016
46;Valencia/València;035;Almussafes;8869;4448;4421;2016
46;Valencia/València;036;Alpuente;641;353;288;2016
46;Valencia/València;037;Alqueria de la Comtessa, l';1451;713;738;2016
46;Valencia/València;017;Alzira;44488;21659;22829;2016
46;Valencia/València;038;Andilla;349;222;127;2016
46;Valencia/València;039;Anna;2678;1348;1330;2016
46;Valencia/València;040;Antella;1271;622;649;2016
46;Valencia/València;041;Aras de los Olmos;381;213;168;2016
46;Valencia/València;003;Atzeneta d'Albaida;1153;593;560;2016
46;Valencia/València;044;Ayora;5320;2675;2645;2016
46;Valencia/València;046;Barx;1280;662;618;2016
46;Valencia/València;045;Barxeta;1607;826;781;2016
46;Valencia/València;047;Bèlgida;689;337;352;2016
46;Valencia/València;048;Bellreguard;4582;2280;2302;2016
46;Valencia/València;049;Bellús;319;160;159;2016
46;Valencia/València;050;Benagéber;207;115;92;2016
46;Valencia/València;051;Benaguasil;10967;5582;5385;2016
46;Valencia/València;052;Benavites;613;289;324;2016
46;Valencia/València;053;Beneixida;674;324;350;2016
46;Valencia/València;054;Benetússer;14505;7048;7457;2016
46;Valencia/València;055;Beniarjó;1756;874;882;2016
46;Valencia/València;056;Beniatjar;226;115;111;2016
46;Valencia/València;057;Benicolet;610;306;304;2016
46;Valencia/València;904;Benicull de Xúquer;972;497;475;2016
46;Valencia/València;060;Benifaió;11903;5904;5999;2016
46;Valencia/València;059;Benifairó de la Valldigna;1600;791;809;2016
46;Valencia/València;058;Benifairó de les Valls;2218;1113;1105;2016
46;Valencia/València;061;Beniflá;453;229;224;2016
46;Valencia/València;062;Benigànim;5912;2997;2915;2016
46;Valencia/València;063;Benimodo;2237;1156;1081;2016
46;Valencia/València;064;Benimuslem;644;332;312;2016
46;Valencia/València;065;Beniparrell;1948;1003;945;2016
46;Valencia/València;066;Benirredrà;1596;769;827;2016
46;Valencia/València;067;Benisanó;2226;1109;1117;2016
46;Valencia/València;068;Benissoda;429;234;195;2016
46;Valencia/València;069;Benisuera;187;93;94;2016
46;Valencia/València;070;Bétera;22696;11368;11328;2016
46;Valencia/València;071;Bicorp;527;272;255;2016
46;Valencia/València;072;Bocairent;4288;2157;2131;2016
46;Valencia/València;073;Bolbaite;1369;690;679;2016
46;Valencia/València;074;Bonrepòs i Mirambell;3614;1768;1846;2016
46;Valencia/València;075;Bufali;168;93;75;2016
46;Valencia/València;076;Bugarra;728;363;365;2016
46;Valencia/València;077;Buñol;9618;4820;4798;2016
46;Valencia/València;078;Burjassot;37324;18026;19298;2016
46;Valencia/València;079;Calles;364;207;157;2016
46;Valencia/València;080;Camporrobles;1255;642;613;2016
46;Valencia/València;081;Canals;13775;6906;6869;2016
46;Valencia/València;082;Canet d'En Berenguer;6513;3332;3181;2016
46;Valencia/València;083;Carcaixent;20520;10162;10358;2016
46;Valencia/València;084;Càrcer;1949;940;1009;2016
46;Valencia/València;085;Carlet;15384;7662;7722;2016
46;Valencia/València;086;Carrícola;95;48;47;2016
46;Valencia/València;087;Casas Altas;148;78;70;2016
46;Valencia/València;088;Casas Bajas;179;92;87;2016
46;Valencia/València;089;Casinos;2783;1430;1353;2016
46;Valencia/València;090;Castelló de Rugat;2277;1167;1110;2016
46;Valencia/València;091;Castellonet de la Conquesta;141;76;65;2016
46;Valencia/València;092;Castielfabib;330;168;162;2016
46;Valencia/València;093;Catadau;2737;1362;1375;2016
46;Valencia/València;094;Catarroja;27728;13736;13992;2016
46;Valencia/València;095;Caudete de las Fuentes;743;394;349;2016
46;Valencia/València;096;Cerdà;363;190;173;2016
46;Valencia/València;107;Chella;2530;1242;1288;2016
46;Valencia/València;106;Chelva;1466;757;709;2016
46;Valencia/València;108;Chera;510;272;238;2016
46;Valencia/València;109;Cheste;8471;4338;4133;2016
46;Valencia/València;111;Chiva;14758;7583;7175;2016
46;Valencia/València;112;Chulilla;632;333;299;2016
46;Valencia/València;097;Cofrentes;1114;570;544;2016
46;Valencia/València;098;Corbera;3207;1598;1609;2016
46;Valencia/València;099;Cortes de Pallás;968;524;444;2016
46;Valencia/València;100;Cotes;354;172;182;2016
46;Valencia/València;105;Cullera;22139;11001;11138;2016
46;Valencia/València;113;Daimús;3058;1537;1521;2016
46;Valencia/València;114;Domeño;686;353;333;2016
46;Valencia/València;115;Dos Aguas;394;223;171;2016
46;Valencia/València;116;Eliana, l';17591;8637;8954;2016
46;Valencia/València;117;Emperador;676;357;319;2016
46;Valencia/València;118;Enguera;5027;2497;2530;2016
46;Valencia/València;119;Ènova, l';936;477;459;2016
46;Valencia/València;120;Estivella;1374;678;696;2016
46;Valencia/València;121;Estubeny;118;59;59;2016
46;Valencia/València;122;Faura;3493;1763;1730;2016
46;Valencia/València;123;Favara;2467;1250;1217;2016
46;Valencia/València;126;Foios;7208;3546;3662;2016
46;Valencia/València;128;Font de la Figuera, la;2109;1054;1055;2016
46;Valencia/València;127;Font d'En Carròs, la;3764;1877;1887;2016
46;Valencia/València;124;Fontanars dels Alforins;973;497;476;2016
46;Valencia/València;125;Fortaleny;1021;509;512;2016
46;Valencia/València;129;Fuenterrobles;690;379;311;2016
46;Valencia/València;131;Gandia;74814;37046;37768;2016
46;Valencia/València;902;Gátova;366;172;194;2016
46;Valencia/València;130;Gavarda;1089;519;570;2016
46;Valencia/València;132;Genovés;2809;1425;1384;2016
46;Valencia/València;133;Gestalgar;634;330;304;2016
46;Valencia/València;134;Gilet;3304;1704;1600;2016
46;Valencia/València;135;Godella;13029;6325;6704;2016
46;Valencia/València;136;Godelleta;3396;1730;1666;2016
46;Valencia/València;137;Granja de la Costera, la;333;173;160;2016
46;Valencia/València;138;Guadasséquies;456;243;213;2016
46;Valencia/València;139;Guadassuar;5898;2887;3011;2016
46;Valencia/València;140;Guardamar de la Safor;490;265;225;2016
46;Valencia/València;141;Higueruelas;511;269;242;2016
46;Valencia/València;142;Jalance;885;462;423;2016
46;Valencia/València;144;Jarafuel;785;403;382;2016
46;Valencia/València;154;Llanera de Ranes;1046;525;521;2016
46;Valencia/València;155;Llaurí;1212;613;599;2016
46;Valencia/València;147;Llíria;22796;11555;11241;2016
46;Valencia/València;152;Llocnou de la Corona;137;71;66;2016
46;Valencia/València;153;Llocnou de Sant Jeroni;543;275;268;2016
46;Valencia/València;151;Llocnou d'En Fenollet;907;472;435;2016
46;Valencia/València;156;Llombai;2753;1388;1365;2016
46;Valencia/València;157;Llosa de Ranes, la;3511;1808;1703;2016
46;Valencia/València;150;Llutxent;2402;1232;1170;2016
46;Valencia/València;148;Loriguilla;1998;1044;954;2016
46;Valencia/València;149;Losa del Obispo;514;265;249;2016
46;Valencia/València;158;Macastre;1237;651;586;2016
46;Valencia/València;159;Manises;30704;15144;15560;2016
46;Valencia/València;160;Manuel;2459;1204;1255;2016
46;Valencia/València;161;Marines;1869;961;908;2016
46;Valencia/València;162;Massalavés;1571;819;752;2016
46;Valencia/València;163;Massalfassar;2472;1231;1241;2016
46;Valencia/València;164;Massamagrell;15574;7713;7861;2016
46;Valencia/València;165;Massanassa;9341;4638;4703;2016
46;Valencia/València;166;Meliana;10619;5239;5380;2016
46;Valencia/València;167;Millares;369;186;183;2016
46;Valencia/València;168;Miramar;2609;1349;1260;2016
46;Valencia/València;169;Mislata;42988;20833;22155;2016
46;Valencia/València;170;Mogente/Moixent;4378;2204;2174;2016
46;Valencia/València;171;Moncada;21700;10665;11035;2016
46;Valencia/València;173;Montaverner;1691;846;845;2016
46;Valencia/València;174;Montesa;1227;620;607;2016
46;Valencia/València;175;Montitxelvo/Montichelvo;644;321;323;2016
46;Valencia/València;176;Montroi/Montroy;2907;1558;1349;2016
46;Valencia/València;172;Montserrat;7295;3792;3503;2016
46;Valencia/València;177;Museros;6252;3137;3115;2016
46;Valencia/València;178;Náquera;6087;3187;2900;2016
46;Valencia/València;179;Navarrés;3056;1540;1516;2016
46;Valencia/València;180;Novelé/Novetlè;854;422;432;2016
46;Valencia/València;181;Oliva;25789;12764;13025;2016
46;Valencia/València;183;Olleria, l';8311;4186;4125;2016
46;Valencia/València;182;Olocau;1685;890;795;2016
46;Valencia/València;184;Ontinyent;35534;17610;17924;2016
46;Valencia/València;185;Otos;448;228;220;2016
46;Valencia/València;186;Paiporta;25084;12521;12563;2016
46;Valencia/València;187;Palma de Gandía;1561;798;763;2016
46;Valencia/València;188;Palmera;1011;534;477;2016
46;Valencia/València;189;Palomar, el;581;294;287;2016
46;Valencia/València;190;Paterna;67854;33627;34227;2016
46;Valencia/València;191;Pedralba;2813;1484;1329;2016
46;Valencia/València;192;Petrés;959;468;491;2016
46;Valencia/València;193;Picanya;11281;5539;5742;2016
46;Valencia/València;194;Picassent;20498;10364;10134;2016
46;Valencia/València;195;Piles;2757;1381;1376;2016
46;Valencia/València;196;Pinet;163;81;82;2016
46;Valencia/València;199;Pobla de Farnals, la;7698;3872;3826;2016
46;Valencia/València;202;Pobla de Vallbona, la;23403;11811;11592;2016
46;Valencia/València;200;Pobla del Duc, la;2564;1256;1308;2016
46;Valencia/València;203;Pobla Llarga, la;4546;2268;2278;2016
46;Valencia/València;197;Polinyà de Xúquer;2464;1252;1212;2016
46;Valencia/València;198;Potries;1017;512;505;2016
46;Valencia/València;205;Puçol;19438;9607;9831;2016
46;Valencia/València;201;Puebla de San Miguel;64;39;25;2016
46;Valencia/València;204;Puig de Santa Maria, el;8735;4231;4504;2016
46;Valencia/València;101;Quart de les Valls;1039;500;539;2016
46;Valencia/València;102;Quart de Poblet;24776;12168;12608;2016
46;Valencia/València;103;Quartell;1538;743;795;2016
46;Valencia/València;104;Quatretonda;2338;1175;1163;2016
46;Valencia/València;206;Quesa;680;352;328;2016
46;Valencia/València;207;Rafelbunyol;8907;4418;4489;2016
46;Valencia/València;208;Rafelcofer;1374;663;711;2016
46;Valencia/València;209;Rafelguaraf;2403;1191;1212;2016
46;Valencia/València;210;Ráfol de Salem;423;207;216;2016
46;Valencia/València;212;Real;2263;1170;1093;2016
46;Valencia/València;211;Real de Gandía;2286;1120;1166;2016
46;Valencia/València;213;Requena;20510;10234;10276;2016
46;Valencia/València;214;Riba-roja de Túria;21521;10926;10595;2016
46;Valencia/València;215;Riola;1832;929;903;2016
46;Valencia/València;216;Rocafort;6940;3425;3515;2016
46;Valencia/València;217;Rotglà i Corberà;1123;558;565;2016
46;Valencia/València;218;Rótova;1276;663;613;2016
46;Valencia/València;219;Rugat;179;95;84;2016
46;Valencia/València;220;Sagunto/Sagunt;64439;31551;32888;2016
46;Valencia/València;221;Salem;437;218;219;2016
46;Valencia/València;903;San Antonio de Benagéber;8463;4171;4292;2016
46;Valencia/València;222;Sant Joanet;480;238;242;2016
46;Valencia/València;223;Sedaví;10172;4954;5218;2016
46;Valencia/València;224;Segart;159;80;79;2016
46;Valencia/València;225;Sellent;382;196;186;2016
46;Valencia/València;226;Sempere;48;25;23;2016
46;Valencia/València;227;Senyera;1172;577;595;2016
46;Valencia/València;228;Serra;3070;1596;1474;2016
46;Valencia/València;229;Siete Aguas;1223;666;557;2016
46;Valencia/València;230;Silla;18462;9181;9281;2016
46;Valencia/València;231;Simat de la Valldigna;3341;1687;1654;2016
46;Valencia/València;232;Sinarcas;1148;593;555;2016
46;Valencia/València;233;Sollana;4919;2410;2509;2016
46;Valencia/València;234;Sot de Chera;396;204;192;2016
46;Valencia/València;235;Sueca;28090;13916;14174;2016
46;Valencia/València;236;Sumacàrcer;1140;564;576;2016
46;Valencia/València;237;Tavernes Blanques;9181;4498;4683;2016
46;Valencia/València;238;Tavernes de la Valldigna;17485;8784;8701;2016
46;Valencia/València;239;Teresa de Cofrentes;651;334;317;2016
46;Valencia/València;240;Terrateig;296;154;142;2016
46;Valencia/València;241;Titaguas;471;245;226;2016
46;Valencia/València;242;Torrebaja;412;213;199;2016
46;Valencia/València;243;Torrella;154;87;67;2016
46;Valencia/València;244;Torrent;80762;39958;40804;2016
46;Valencia/València;245;Torres Torres;644;346;298;2016
46;Valencia/València;246;Tous;1270;646;624;2016
46;Valencia/València;247;Tuéjar;1193;634;559;2016
46;Valencia/València;248;Turís;6609;3452;3157;2016
46;Valencia/València;249;Utiel;11748;5890;5858;2016
46;Valencia/València;250;Valencia;790201;377233;412968;2016
46;Valencia/València;251;Vallada;3089;1578;1511;2016
46;Valencia/València;252;Vallanca;133;70;63;2016
46;Valencia/València;253;Vallés;161;81;80;2016
46;Valencia/València;254;Venta del Moro;1299;693;606;2016
46;Valencia/València;255;Vilallonga/Villalonga;4375;2173;2202;2016
46;Valencia/València;256;Vilamarxant;9223;4779;4444;2016
46;Valencia/València;257;Villanueva de Castellón;7266;3603;3663;2016
46;Valencia/València;258;Villar del Arzobispo;3565;1818;1747;2016
46;Valencia/València;259;Villargordo del Cabriel;639;338;301;2016
46;Valencia/València;260;Vinalesa;3310;1619;1691;2016
46;Valencia/València;145;Xàtiva;28973;14140;14833;2016
46;Valencia/València;143;Xeraco;5732;2909;2823;2016
46;Valencia/València;146;Xeresa;2197;1128;1069;2016
46;Valencia/València;110;Xirivella;28771;14176;14595;2016
46;Valencia/València;261;Yátova;2079;1072;1007;2016
46;Valencia/València;262;Yesa, La;242;132;110;2016
46;Valencia/València;263;Zarra;440;239;201;2016
47;Valladolid;001;Adalia;59;36;23;2016
47;Valladolid;002;Aguasal;24;19;5;2016
47;Valladolid;003;Aguilar de Campos;266;150;116;2016
47;Valladolid;004;Alaejos;1400;741;659;2016
47;Valladolid;005;Alcazarén;692;375;317;2016
47;Valladolid;006;Aldea de San Miguel;226;118;108;2016
47;Valladolid;007;Aldeamayor de San Martín;5077;2621;2456;2016
47;Valladolid;008;Almenara de Adaja;26;12;14;2016
47;Valladolid;009;Amusquillo;106;68;38;2016
47;Valladolid;010;Arroyo de la Encomienda;19042;9630;9412;2016
47;Valladolid;011;Ataquines;584;320;264;2016
47;Valladolid;012;Bahabón;123;56;67;2016
47;Valladolid;013;Barcial de la Loma;104;56;48;2016
47;Valladolid;014;Barruelo del Valle;66;41;25;2016
47;Valladolid;015;Becilla de Valderaduey;249;141;108;2016
47;Valladolid;016;Benafarces;75;40;35;2016
47;Valladolid;017;Bercero;215;119;96;2016
47;Valladolid;018;Berceruelo;37;22;15;2016
47;Valladolid;019;Berrueces;98;55;43;2016
47;Valladolid;020;Bobadilla del Campo;303;171;132;2016
47;Valladolid;021;Bocigas;86;47;39;2016
47;Valladolid;022;Bocos de Duero;54;25;29;2016
47;Valladolid;023;Boecillo;4083;2084;1999;2016
47;Valladolid;024;Bolaños de Campos;337;184;153;2016
47;Valladolid;025;Brahojos de Medina;130;69;61;2016
47;Valladolid;026;Bustillo de Chaves;80;41;39;2016
47;Valladolid;027;Cabezón de Pisuerga;3657;1869;1788;2016
47;Valladolid;028;Cabezón de Valderaduey;37;19;18;2016
47;Valladolid;029;Cabreros del Monte;73;40;33;2016
47;Valladolid;030;Campaspero;1101;596;505;2016
47;Valladolid;031;Campillo, El;217;126;91;2016
47;Valladolid;032;Camporredondo;161;93;68;2016
47;Valladolid;033;Canalejas de Peñafiel;242;133;109;2016
47;Valladolid;034;Canillas de Esgueva;79;45;34;2016
47;Valladolid;035;Carpio;1047;561;486;2016
47;Valladolid;036;Casasola de Arión;267;151;116;2016
47;Valladolid;037;Castrejón de Trabancos;181;90;91;2016
47;Valladolid;038;Castrillo de Duero;124;70;54;2016
47;Valladolid;039;Castrillo-Tejeriego;189;105;84;2016
47;Valladolid;040;Castrobol;65;34;31;2016
47;Valladolid;041;Castrodeza;160;97;63;2016
47;Valladolid;042;Castromembibre;64;39;25;2016
47;Valladolid;043;Castromonte;314;182;132;2016
47;Valladolid;044;Castronuevo de Esgueva;391;214;177;2016
47;Valladolid;045;Castronuño;888;440;448;2016
47;Valladolid;046;Castroponce;146;79;67;2016
47;Valladolid;047;Castroverde de Cerrato;227;139;88;2016
47;Valladolid;048;Ceinos de Campos;237;132;105;2016
47;Valladolid;049;Cervillego de la Cruz;98;56;42;2016
47;Valladolid;050;Cigales;5032;2572;2460;2016
47;Valladolid;051;Ciguñuela;384;201;183;2016
47;Valladolid;052;Cistérniga;8895;4510;4385;2016
47;Valladolid;053;Cogeces de Íscar;140;71;69;2016
47;Valladolid;054;Cogeces del Monte;716;388;328;2016
47;Valladolid;055;Corcos;214;112;102;2016
47;Valladolid;056;Corrales de Duero;81;47;34;2016
47;Valladolid;057;Cubillas de Santa Marta;307;178;129;2016
47;Valladolid;058;Cuenca de Campos;228;120;108;2016
47;Valladolid;059;Curiel de Duero;102;68;34;2016
47;Valladolid;060;Encinas de Esgueva;282;163;119;2016
47;Valladolid;061;Esguevillas de Esgueva;277;146;131;2016
47;Valladolid;062;Fombellida;179;104;75;2016
47;Valladolid;063;Fompedraza;113;59;54;2016
47;Valladolid;064;Fontihoyuelo;34;20;14;2016
47;Valladolid;065;Fresno el Viejo;946;502;444;2016
47;Valladolid;066;Fuensaldaña;1563;800;763;2016
47;Valladolid;067;Fuente el Sol;181;97;84;2016
47;Valladolid;068;Fuente-Olmedo;38;19;19;2016
47;Valladolid;069;Gallegos de Hornija;131;66;65;2016
47;Valladolid;070;Gatón de Campos;37;19;18;2016
47;Valladolid;071;Geria;507;249;258;2016
47;Valladolid;073;Herrín de Campos;130;65;65;2016
47;Valladolid;074;Hornillos de Eresma;170;93;77;2016
47;Valladolid;075;Íscar;6516;3287;3229;2016
47;Valladolid;076;Laguna de Duero;22696;11355;11341;2016
47;Valladolid;077;Langayo;260;164;96;2016
47;Valladolid;079;Llano de Olmedo;61;33;28;2016
47;Valladolid;078;Lomoviejo;183;96;87;2016
47;Valladolid;080;Manzanillo;47;24;23;2016
47;Valladolid;081;Marzales;49;23;26;2016
47;Valladolid;082;Matapozuelos;1040;526;514;2016
47;Valladolid;083;Matilla de los Caños;108;60;48;2016
47;Valladolid;084;Mayorga;1649;810;839;2016
47;Valladolid;086;Medina de Rioseco;4803;2368;2435;2016
47;Valladolid;085;Medina del Campo;20774;10043;10731;2016
47;Valladolid;087;Megeces;444;234;210;2016
47;Valladolid;088;Melgar de Abajo;107;59;48;2016
47;Valladolid;089;Melgar de Arriba;177;95;82;2016
47;Valladolid;090;Mojados;3232;1694;1538;2016
47;Valladolid;091;Monasterio de Vega;85;46;39;2016
47;Valladolid;092;Montealegre de Campos;122;70;52;2016
47;Valladolid;093;Montemayor de Pililla;910;483;427;2016
47;Valladolid;094;Moral de la Reina;180;99;81;2016
47;Valladolid;095;Moraleja de las Panaderas;39;27;12;2016
47;Valladolid;096;Morales de Campos;149;79;70;2016
47;Valladolid;097;Mota del Marqués;375;194;181;2016
47;Valladolid;098;Mucientes;692;350;342;2016
47;Valladolid;099;Mudarra, La;160;81;79;2016
47;Valladolid;100;Muriel;143;77;66;2016
47;Valladolid;101;Nava del Rey;2094;1077;1017;2016
47;Valladolid;102;Nueva Villa de las Torres;311;176;135;2016
47;Valladolid;103;Olivares de Duero;306;171;135;2016
47;Valladolid;104;Olmedo;3674;1811;1863;2016
47;Valladolid;105;Olmos de Esgueva;211;114;97;2016
47;Valladolid;106;Olmos de Peñafiel;62;34;28;2016
47;Valladolid;109;Palazuelo de Vedija;208;108;100;2016
47;Valladolid;110;Parrilla, La;496;250;246;2016
47;Valladolid;111;Pedraja de Portillo, La;1151;589;562;2016
47;Valladolid;112;Pedrajas de San Esteban;3337;1728;1609;2016
47;Valladolid;113;Pedrosa del Rey;196;108;88;2016
47;Valladolid;114;Peñafiel;5327;2660;2667;2016
47;Valladolid;115;Peñaflor de Hornija;310;177;133;2016
47;Valladolid;116;Pesquera de Duero;474;259;215;2016
47;Valladolid;117;Piña de Esgueva;342;179;163;2016
47;Valladolid;118;Piñel de Abajo;186;101;85;2016
47;Valladolid;119;Piñel de Arriba;99;52;47;2016
47;Valladolid;121;Pollos;606;318;288;2016
47;Valladolid;122;Portillo;2455;1285;1170;2016
47;Valladolid;123;Pozal de Gallinas;555;300;255;2016
47;Valladolid;124;Pozaldez;484;259;225;2016
47;Valladolid;125;Pozuelo de la Orden;60;36;24;2016
47;Valladolid;126;Puras;58;29;29;2016
47;Valladolid;127;Quintanilla de Arriba;153;82;71;2016
47;Valladolid;129;Quintanilla de Onésimo;1059;548;511;2016
47;Valladolid;130;Quintanilla de Trigueros;107;54;53;2016
47;Valladolid;128;Quintanilla del Molar;64;28;36;2016
47;Valladolid;131;Rábano;187;101;86;2016
47;Valladolid;132;Ramiro;51;28;23;2016
47;Valladolid;133;Renedo de Esgueva;3697;1885;1812;2016
47;Valladolid;134;Roales de Campos;169;96;73;2016
47;Valladolid;135;Robladillo;95;55;40;2016
47;Valladolid;137;Roturas;32;19;13;2016
47;Valladolid;138;Rubí de Bracamonte;234;130;104;2016
47;Valladolid;139;Rueda;1294;663;631;2016
47;Valladolid;140;Saelices de Mayorga;117;73;44;2016
47;Valladolid;141;Salvador de Zapardiel;136;78;58;2016
47;Valladolid;142;San Cebrián de Mazote;159;93;66;2016
47;Valladolid;143;San Llorente;124;72;52;2016
47;Valladolid;144;San Martín de Valvení;87;48;39;2016
47;Valladolid;145;San Miguel del Arroyo;693;372;321;2016
47;Valladolid;146;San Miguel del Pino;323;172;151;2016
47;Valladolid;147;San Pablo de la Moraleja;121;63;58;2016
47;Valladolid;148;San Pedro de Latarce;522;283;239;2016
47;Valladolid;149;San Pelayo;45;21;24;2016
47;Valladolid;150;San Román de Hornija;331;155;176;2016
47;Valladolid;151;San Salvador;31;16;15;2016
47;Valladolid;156;San Vicente del Palacio;176;95;81;2016
47;Valladolid;152;Santa Eufemia del Arroyo;99;53;46;2016
47;Valladolid;153;Santervás de Campos;122;67;55;2016
47;Valladolid;154;Santibáñez de Valcorba;163;94;69;2016
47;Valladolid;155;Santovenia de Pisuerga;4241;2183;2058;2016
47;Valladolid;157;Sardón de Duero;610;313;297;2016
47;Valladolid;158;Seca, La;1105;566;539;2016
47;Valladolid;159;Serrada;1139;600;539;2016
47;Valladolid;160;Siete Iglesias de Trabancos;474;256;218;2016
47;Valladolid;161;Simancas;5254;2662;2592;2016
47;Valladolid;162;Tamariz de Campos;61;33;28;2016
47;Valladolid;163;Tiedra;311;153;158;2016
47;Valladolid;164;Tordehumos;439;223;216;2016
47;Valladolid;165;Tordesillas;8905;4484;4421;2016
47;Valladolid;169;Torre de Esgueva;72;36;36;2016
47;Valladolid;170;Torre de Peñafiel;41;24;17;2016
47;Valladolid;166;Torrecilla de la Abadesa;291;141;150;2016
47;Valladolid;167;Torrecilla de la Orden;260;133;127;2016
47;Valladolid;168;Torrecilla de la Torre;30;19;11;2016
47;Valladolid;171;Torrelobatón;436;226;210;2016
47;Valladolid;172;Torrescárcela;161;85;76;2016
47;Valladolid;173;Traspinedo;1089;593;496;2016
47;Valladolid;174;Trigueros del Valle;303;164;139;2016
47;Valladolid;175;Tudela de Duero;8582;4391;4191;2016
47;Valladolid;176;Unión de Campos, La;254;123;131;2016
47;Valladolid;177;Urones de Castroponce;114;66;48;2016
47;Valladolid;178;Urueña;189;102;87;2016
47;Valladolid;179;Valbuena de Duero;478;248;230;2016
47;Valladolid;180;Valdearcos de la Vega;84;44;40;2016
47;Valladolid;181;Valdenebro de los Valles;206;104;102;2016
47;Valladolid;182;Valdestillas;1675;868;807;2016
47;Valladolid;183;Valdunquillo;147;73;74;2016
47;Valladolid;186;Valladolid;301876;142105;159771;2016
47;Valladolid;184;Valoria la Buena;658;345;313;2016
47;Valladolid;185;Valverde de Campos;103;62;41;2016
47;Valladolid;187;Vega de Ruiponce;100;60;40;2016
47;Valladolid;188;Vega de Valdetronco;115;65;50;2016
47;Valladolid;189;Velascálvaro;172;94;78;2016
47;Valladolid;190;Velilla;114;55;59;2016
47;Valladolid;191;Velliza;106;68;38;2016
47;Valladolid;192;Ventosa de la Cuesta;121;67;54;2016
47;Valladolid;193;Viana de Cega;2009;1058;951;2016
47;Valladolid;195;Villabáñez;544;304;240;2016
47;Valladolid;196;Villabaruz de Campos;37;16;21;2016
47;Valladolid;197;Villabrágima;1045;551;494;2016
47;Valladolid;198;Villacarralón;84;50;34;2016
47;Valladolid;199;Villacid de Campos;83;52;31;2016
47;Valladolid;200;Villaco;91;58;33;2016
47;Valladolid;203;Villafrades de Campos;67;35;32;2016
47;Valladolid;204;Villafranca de Duero;289;152;137;2016
47;Valladolid;205;Villafrechós;492;265;227;2016
47;Valladolid;206;Villafuerte;94;55;39;2016
47;Valladolid;207;Villagarcía de Campos;330;197;133;2016
47;Valladolid;208;Villagómez la Nueva;69;37;32;2016
47;Valladolid;209;Villalán de Campos;44;28;16;2016
47;Valladolid;210;Villalar de los Comuneros;440;218;222;2016
47;Valladolid;211;Villalba de la Loma;59;29;30;2016
47;Valladolid;212;Villalba de los Alcores;422;230;192;2016
47;Valladolid;213;Villalbarba;118;62;56;2016
47;Valladolid;214;Villalón de Campos;1689;831;858;2016
47;Valladolid;215;Villamuriel de Campos;59;29;30;2016
47;Valladolid;216;Villán de Tordesillas;122;71;51;2016
47;Valladolid;217;Villanubla;2615;1371;1244;2016
47;Valladolid;218;Villanueva de Duero;1196;623;573;2016
47;Valladolid;219;Villanueva de la Condesa;62;32;30;2016
47;Valladolid;220;Villanueva de los Caballeros;176;90;86;2016
47;Valladolid;221;Villanueva de los Infantes;112;67;45;2016
47;Valladolid;222;Villanueva de San Mancio;83;46;37;2016
47;Valladolid;223;Villardefrades;172;97;75;2016
47;Valladolid;224;Villarmentero de Esgueva;98;53;45;2016
47;Valladolid;225;Villasexmir;83;49;34;2016
47;Valladolid;226;Villavaquerín;170;97;73;2016
47;Valladolid;227;Villavellid;63;36;27;2016
47;Valladolid;228;Villaverde de Medina;514;274;240;2016
47;Valladolid;229;Villavicencio de los Caballeros;235;119;116;2016
47;Valladolid;194;Viloria;352;182;170;2016
47;Valladolid;230;Wamba;343;182;161;2016
47;Valladolid;231;Zaratán;6201;3187;3014;2016
47;Valladolid;232;Zarza, La;113;62;51;2016
49;Zamora;002;Abezames;65;33;32;2016
49;Zamora;003;Alcañices;1111;560;551;2016
49;Zamora;004;Alcubilla de Nogales;134;72;62;2016
49;Zamora;005;Alfaraz de Sayago;149;84;65;2016
49;Zamora;006;Algodre;159;89;70;2016
49;Zamora;007;Almaraz de Duero;405;203;202;2016
49;Zamora;008;Almeida de Sayago;492;264;228;2016
49;Zamora;009;Andavías;444;230;214;2016
49;Zamora;010;Arcenillas;404;204;200;2016
49;Zamora;011;Arcos de la Polvorosa;251;132;119;2016
49;Zamora;012;Argañín;77;38;39;2016
49;Zamora;013;Argujillo;271;134;137;2016
49;Zamora;014;Arquillinos;119;63;56;2016
49;Zamora;015;Arrabalde;247;122;125;2016
49;Zamora;016;Aspariegos;279;127;152;2016
49;Zamora;017;Asturianos;264;133;131;2016
49;Zamora;018;Ayoó de Vidriales;349;177;172;2016
49;Zamora;019;Barcial del Barco;267;144;123;2016
49;Zamora;020;Belver de los Montes;307;162;145;2016
49;Zamora;021;Benavente;18315;8870;9445;2016
49;Zamora;022;Benegiles;324;171;153;2016
49;Zamora;023;Bermillo de Sayago;1085;570;515;2016
49;Zamora;024;Bóveda de Toro, La;760;380;380;2016
49;Zamora;025;Bretó;182;108;74;2016
49;Zamora;026;Bretocino;238;126;112;2016
49;Zamora;027;Brime de Sog;147;72;75;2016
49;Zamora;028;Brime de Urz;120;70;50;2016
49;Zamora;029;Burganes de Valverde;682;355;327;2016
49;Zamora;030;Bustillo del Oro;87;45;42;2016
49;Zamora;031;Cabañas de Sayago;153;81;72;2016
49;Zamora;032;Calzadilla de Tera;341;157;184;2016
49;Zamora;033;Camarzana de Tera;871;435;436;2016
49;Zamora;034;Cañizal;466;244;222;2016
49;Zamora;035;Cañizo;243;130;113;2016
49;Zamora;036;Carbajales de Alba;553;279;274;2016
49;Zamora;037;Carbellino;204;109;95;2016
49;Zamora;038;Casaseca de Campeán;100;56;44;2016
49;Zamora;039;Casaseca de las Chanas;394;213;181;2016
49;Zamora;040;Castrillo de la Guareña;126;66;60;2016
49;Zamora;041;Castrogonzalo;495;267;228;2016
49;Zamora;042;Castronuevo;243;116;127;2016
49;Zamora;043;Castroverde de Campos;334;170;164;2016
49;Zamora;044;Cazurra;82;45;37;2016
49;Zamora;046;Cerecinos de Campos;297;161;136;2016
49;Zamora;047;Cerecinos del Carrizal;116;65;51;2016
49;Zamora;048;Cernadilla;128;64;64;2016
49;Zamora;050;Cobreros;588;325;263;2016
49;Zamora;052;Coomonte;202;110;92;2016
49;Zamora;053;Coreses;1050;540;510;2016
49;Zamora;054;Corrales del Vino;1022;505;517;2016
49;Zamora;055;Cotanes del Monte;113;61;52;2016
49;Zamora;056;Cubillos;328;164;164;2016
49;Zamora;057;Cubo de Benavente;119;65;54;2016
49;Zamora;058;Cubo de Tierra del Vino, El;347;188;159;2016
49;Zamora;059;Cuelgamures;90;55;35;2016
49;Zamora;061;Entrala;168;88;80;2016
49;Zamora;062;Espadañedo;123;60;63;2016
49;Zamora;063;Faramontanos de Tábara;365;189;176;2016
49;Zamora;064;Fariza;548;285;263;2016
49;Zamora;065;Fermoselle;1277;650;627;2016
49;Zamora;066;Ferreras de Abajo;555;283;272;2016
49;Zamora;067;Ferreras de Arriba;405;217;188;2016
49;Zamora;068;Ferreruela;504;273;231;2016
49;Zamora;069;Figueruela de Arriba;378;180;198;2016
49;Zamora;071;Fonfría;823;419;404;2016
49;Zamora;075;Fresno de la Polvorosa;149;79;70;2016
49;Zamora;076;Fresno de la Ribera;371;205;166;2016
49;Zamora;077;Fresno de Sayago;199;107;92;2016
49;Zamora;078;Friera de Valverde;177;95;82;2016
49;Zamora;079;Fuente Encalada;114;65;49;2016
49;Zamora;080;Fuentelapeña;761;412;349;2016
49;Zamora;082;Fuentes de Ropel;409;210;199;2016
49;Zamora;081;Fuentesaúco;1606;794;812;2016
49;Zamora;083;Fuentesecas;58;27;31;2016
49;Zamora;084;Fuentespreadas;322;175;147;2016
49;Zamora;085;Galende;1141;589;552;2016
49;Zamora;086;Gallegos del Pan;125;73;52;2016
49;Zamora;087;Gallegos del Río;544;299;245;2016
49;Zamora;088;Gamones;99;56;43;2016
49;Zamora;090;Gema;229;119;110;2016
49;Zamora;091;Granja de Moreruela;292;153;139;2016
49;Zamora;092;Granucillo;138;68;70;2016
49;Zamora;093;Guarrate;343;175;168;2016
49;Zamora;094;Hermisende;251;132;119;2016
49;Zamora;095;Hiniesta, La;330;170;160;2016
49;Zamora;096;Jambrina;174;92;82;2016
49;Zamora;097;Justel;88;53;35;2016
49;Zamora;098;Losacino;230;127;103;2016
49;Zamora;099;Losacio;125;64;61;2016
49;Zamora;100;Lubián;326;174;152;2016
49;Zamora;101;Luelmo;164;86;78;2016
49;Zamora;102;Maderal, El;206;107;99;2016
49;Zamora;103;Madridanos;481;253;228;2016
49;Zamora;104;Mahide;353;193;160;2016
49;Zamora;105;Maire de Castroponce;161;85;76;2016
49;Zamora;107;Malva;132;64;68;2016
49;Zamora;108;Manganeses de la Lampreana;499;249;250;2016
49;Zamora;109;Manganeses de la Polvorosa;707;347;360;2016
49;Zamora;110;Manzanal de Arriba;373;198;175;2016
49;Zamora;112;Manzanal de los Infantes;138;77;61;2016
49;Zamora;111;Manzanal del Barco;136;72;64;2016
49;Zamora;113;Matilla de Arzón;174;101;73;2016
49;Zamora;114;Matilla la Seca;45;24;21;2016
49;Zamora;115;Mayalde;202;108;94;2016
49;Zamora;116;Melgar de Tera;409;214;195;2016
49;Zamora;117;Micereces de Tera;488;241;247;2016
49;Zamora;118;Milles de la Polvorosa;228;123;105;2016
49;Zamora;119;Molacillos;268;147;121;2016
49;Zamora;120;Molezuelas de la Carballeda;82;42;40;2016
49;Zamora;121;Mombuey;425;227;198;2016
49;Zamora;122;Monfarracinos;986;505;481;2016
49;Zamora;123;Montamarta;587;310;277;2016
49;Zamora;124;Moral de Sayago;271;152;119;2016
49;Zamora;126;Moraleja de Sayago;249;130;119;2016
49;Zamora;125;Moraleja del Vino;1692;875;817;2016
49;Zamora;128;Morales de Rey;599;305;294;2016
49;Zamora;129;Morales de Toro;1008;527;481;2016
49;Zamora;130;Morales de Valverde;187;96;91;2016
49;Zamora;127;Morales del Vino;2966;1551;1415;2016
49;Zamora;131;Moralina;282;145;137;2016
49;Zamora;132;Moreruela de los Infanzones;362;187;175;2016
49;Zamora;133;Moreruela de Tábara;332;166;166;2016
49;Zamora;134;Muelas de los Caballeros;188;103;85;2016
49;Zamora;135;Muelas del Pan;677;344;333;2016
49;Zamora;136;Muga de Sayago;368;179;189;2016
49;Zamora;137;Navianos de Valverde;203;112;91;2016
49;Zamora;138;Olmillos de Castro;248;133;115;2016
49;Zamora;139;Otero de Bodas;178;94;84;2016
49;Zamora;141;Pajares de la Lampreana;365;179;186;2016
49;Zamora;143;Palacios de Sanabria;260;133;127;2016
49;Zamora;142;Palacios del Pan;261;136;125;2016
49;Zamora;145;Pedralba de la Pradería;292;155;137;2016
49;Zamora;146;Pego, El;314;157;157;2016
49;Zamora;147;Peleagonzalo;258;129;129;2016
49;Zamora;148;Peleas de Abajo;259;132;127;2016
49;Zamora;149;Peñausende;415;206;209;2016
49;Zamora;150;Peque;147;63;84;2016
49;Zamora;151;Perdigón, El;720;389;331;2016
49;Zamora;152;Pereruela;578;312;266;2016
49;Zamora;153;Perilla de Castro;181;91;90;2016
49;Zamora;154;Pías;138;75;63;2016
49;Zamora;155;Piedrahita de Castro;88;47;41;2016
49;Zamora;156;Pinilla de Toro;247;132;115;2016
49;Zamora;157;Pino del Oro;215;118;97;2016
49;Zamora;158;Piñero, El;242;129;113;2016
49;Zamora;160;Pobladura de Valderaduey;44;23;21;2016
49;Zamora;159;Pobladura del Valle;310;161;149;2016
49;Zamora;162;Porto;188;104;84;2016
49;Zamora;163;Pozoantiguo;242;125;117;2016
49;Zamora;164;Pozuelo de Tábara;172;88;84;2016
49;Zamora;165;Prado;59;34;25;2016
49;Zamora;166;Puebla de Sanabria;1460;704;756;2016
49;Zamora;167;Pueblica de Valverde;214;114;100;2016
49;Zamora;170;Quintanilla de Urz;106;53;53;2016
49;Zamora;168;Quintanilla del Monte;102;49;53;2016
49;Zamora;169;Quintanilla del Olmo;32;16;16;2016
49;Zamora;171;Quiruelas de Vidriales;706;359;347;2016
49;Zamora;172;Rabanales;562;292;270;2016
49;Zamora;173;Rábano de Aliste;405;198;207;2016
49;Zamora;174;Requejo;149;76;73;2016
49;Zamora;175;Revellinos;269;144;125;2016
49;Zamora;176;Riofrío de Aliste;739;395;344;2016
49;Zamora;177;Rionegro del Puente;297;152;145;2016
49;Zamora;178;Roales;856;459;397;2016
49;Zamora;179;Robleda-Cervantes;448;237;211;2016
49;Zamora;180;Roelos de Sayago;171;80;91;2016
49;Zamora;181;Rosinos de la Requejada;387;208;179;2016
49;Zamora;183;Salce;103;46;57;2016
49;Zamora;184;Samir de los Caños;182;101;81;2016
49;Zamora;185;San Agustín del Pozo;188;102;86;2016
49;Zamora;186;San Cebrián de Castro;269;131;138;2016
49;Zamora;187;San Cristóbal de Entreviñas;1454;761;693;2016
49;Zamora;188;San Esteban del Molar;125;73;52;2016
49;Zamora;189;San Justo;234;124;110;2016
49;Zamora;190;San Martín de Valderaduey;63;33;30;2016
49;Zamora;191;San Miguel de la Ribera;303;150;153;2016
49;Zamora;192;San Miguel del Valle;145;70;75;2016
49;Zamora;193;San Pedro de Ceque;503;261;242;2016
49;Zamora;194;San Pedro de la Nave-Almendra;370;188;182;2016
49;Zamora;208;San Vicente de la Cabeza;417;219;198;2016
49;Zamora;209;San Vitero;543;301;242;2016
49;Zamora;197;Santa Clara de Avedillo;180;93;87;2016
49;Zamora;199;Santa Colomba de las Monjas;276;139;137;2016
49;Zamora;200;Santa Cristina de la Polvorosa;1088;554;534;2016
49;Zamora;201;Santa Croya de Tera;322;162;160;2016
49;Zamora;202;Santa Eufemia del Barco;189;109;80;2016
49;Zamora;203;Santa María de la Vega;342;172;170;2016
49;Zamora;204;Santa María de Valverde;60;25;35;2016
49;Zamora;205;Santibáñez de Tera;400;205;195;2016
49;Zamora;206;Santibáñez de Vidriales;1021;521;500;2016
49;Zamora;207;Santovenia;268;131;137;2016
49;Zamora;210;Sanzoles;539;272;267;2016
49;Zamora;214;Tábara;797;412;385;2016
49;Zamora;216;Tapioles;164;96;68;2016
49;Zamora;219;Toro;9115;4428;4687;2016
49;Zamora;220;Torre del Valle, La;148;77;71;2016
49;Zamora;221;Torregamones;294;156;138;2016
49;Zamora;222;Torres del Carrizal;430;213;217;2016
49;Zamora;223;Trabazos;967;508;459;2016
49;Zamora;224;Trefacio;186;96;90;2016
49;Zamora;225;Uña de Quintana;150;76;74;2016
49;Zamora;226;Vadillo de la Guareña;279;148;131;2016
49;Zamora;227;Valcabado;359;183;176;2016
49;Zamora;228;Valdefinjas;54;32;22;2016
49;Zamora;229;Valdescorriel;141;69;72;2016
49;Zamora;230;Vallesa de la Guareña;99;53;46;2016
49;Zamora;231;Vega de Tera;371;182;189;2016
49;Zamora;232;Vega de Villalobos;117;56;61;2016
49;Zamora;233;Vegalatrave;92;50;42;2016
49;Zamora;234;Venialbo;473;256;217;2016
49;Zamora;235;Vezdemarbán;417;212;205;2016
49;Zamora;236;Vidayanes;88;45;43;2016
49;Zamora;237;Videmala;172;90;82;2016
49;Zamora;238;Villabrázaro;226;121;105;2016
49;Zamora;239;Villabuena del Puente;734;378;356;2016
49;Zamora;240;Villadepera;221;121;100;2016
49;Zamora;241;Villaescusa;261;142;119;2016
49;Zamora;242;Villafáfila;478;245;233;2016
49;Zamora;243;Villaferrueña;115;57;58;2016
49;Zamora;244;Villageriz;49;29;20;2016
49;Zamora;245;Villalazán;284;139;145;2016
49;Zamora;246;Villalba de la Lampreana;246;136;110;2016
49;Zamora;247;Villalcampo;471;234;237;2016
49;Zamora;248;Villalobos;255;129;126;2016
49;Zamora;249;Villalonso;96;54;42;2016
49;Zamora;250;Villalpando;1528;756;772;2016
49;Zamora;251;Villalube;169;88;81;2016
49;Zamora;252;Villamayor de Campos;322;165;157;2016
49;Zamora;255;Villamor de los Escuderos;418;220;198;2016
49;Zamora;256;Villanázar;289;148;141;2016
49;Zamora;257;Villanueva de Azoague;331;171;160;2016
49;Zamora;258;Villanueva de Campeán;122;70;52;2016
49;Zamora;259;Villanueva de las Peras;88;49;39;2016
49;Zamora;260;Villanueva del Campo;900;448;452;2016
49;Zamora;263;Villar de Fallaves;46;25;21;2016
49;Zamora;264;Villar del Buey;620;322;298;2016
49;Zamora;261;Villaralbo;1880;961;919;2016
49;Zamora;262;Villardeciervos;450;218;232;2016
49;Zamora;265;Villardiegua de la Ribera;133;67;66;2016
49;Zamora;266;Villárdiga;84;46;38;2016
49;Zamora;267;Villardondiego;97;53;44;2016
49;Zamora;268;Villarrín de Campos;425;230;195;2016
49;Zamora;269;Villaseco del Pan;249;119;130;2016
49;Zamora;270;Villavendimio;170;103;67;2016
49;Zamora;272;Villaveza de Valverde;89;44;45;2016
49;Zamora;271;Villaveza del Agua;209;114;95;2016
49;Zamora;273;Viñas;199;104;95;2016
49;Zamora;275;Zamora;63217;29542;33675;2016
50;Zaragoza;001;Abanto;106;59;47;2016
50;Zaragoza;002;Acered;223;134;89;2016
50;Zaragoza;003;Agón;155;87;68;2016
50;Zaragoza;004;Aguarón;686;358;328;2016
50;Zaragoza;005;Aguilón;247;134;113;2016
50;Zaragoza;006;Ainzón;1136;582;554;2016
50;Zaragoza;007;Aladrén;48;32;16;2016
50;Zaragoza;008;Alagón;7045;3491;3554;2016
50;Zaragoza;009;Alarba;137;82;55;2016
50;Zaragoza;010;Alberite de San Juan;80;46;34;2016
50;Zaragoza;011;Albeta;139;67;72;2016
50;Zaragoza;012;Alborge;111;58;53;2016
50;Zaragoza;013;Alcalá de Ebro;263;124;139;2016
50;Zaragoza;014;Alcalá de Moncayo;175;100;75;2016
50;Zaragoza;015;Alconchel de Ariza;76;43;33;2016
50;Zaragoza;016;Aldehuela de Liestos;53;38;15;2016
50;Zaragoza;017;Alfajarín;2298;1188;1110;2016
50;Zaragoza;018;Alfamén;1466;776;690;2016
50;Zaragoza;019;Alforque;58;33;25;2016
50;Zaragoza;020;Alhama de Aragón;1034;534;500;2016
50;Zaragoza;021;Almochuel;31;14;17;2016
50;Zaragoza;022;Almolda, La;581;291;290;2016
50;Zaragoza;023;Almonacid de la Cuba;261;132;129;2016
50;Zaragoza;024;Almonacid de la Sierra;703;387;316;2016
50;Zaragoza;025;Almunia de Doña Godina, La;7692;3896;3796;2016
50;Zaragoza;026;Alpartir;547;278;269;2016
50;Zaragoza;027;Ambel;256;125;131;2016
50;Zaragoza;028;Anento;101;65;36;2016
50;Zaragoza;029;Aniñón;740;401;339;2016
50;Zaragoza;030;Añón de Moncayo;197;118;79;2016
50;Zaragoza;031;Aranda de Moncayo;186;118;68;2016
50;Zaragoza;032;Arándiga;317;163;154;2016
50;Zaragoza;033;Ardisa;72;46;26;2016
50;Zaragoza;034;Ariza;1139;575;564;2016
50;Zaragoza;035;Artieda;79;46;33;2016
50;Zaragoza;036;Asín;106;53;53;2016
50;Zaragoza;037;Atea;131;80;51;2016
50;Zaragoza;038;Ateca;1856;956;900;2016
50;Zaragoza;039;Azuara;576;320;256;2016
50;Zaragoza;040;Badules;88;51;37;2016
50;Zaragoza;041;Bagüés;12;8;4;2016
50;Zaragoza;042;Balconchán;14;5;9;2016
50;Zaragoza;043;Bárboles;326;175;151;2016
50;Zaragoza;044;Bardallur;272;132;140;2016
50;Zaragoza;045;Belchite;1559;787;772;2016
50;Zaragoza;046;Belmonte de Gracián;211;118;93;2016
50;Zaragoza;047;Berdejo;52;33;19;2016
50;Zaragoza;048;Berrueco;35;19;16;2016
50;Zaragoza;901;Biel;143;84;59;2016
50;Zaragoza;050;Bijuesca;99;63;36;2016
50;Zaragoza;051;Biota;971;493;478;2016
50;Zaragoza;052;Bisimbre;102;58;44;2016
50;Zaragoza;053;Boquiñeni;852;430;422;2016
50;Zaragoza;054;Bordalba;59;38;21;2016
50;Zaragoza;055;Borja;4955;2485;2470;2016
50;Zaragoza;056;Botorrita;489;268;221;2016
50;Zaragoza;057;Brea de Aragón;1694;860;834;2016
50;Zaragoza;058;Bubierca;69;35;34;2016
50;Zaragoza;059;Bujaraloz;996;518;478;2016
50;Zaragoza;060;Bulbuente;227;122;105;2016
50;Zaragoza;061;Bureta;237;126;111;2016
50;Zaragoza;062;Burgo de Ebro, El;2383;1199;1184;2016
50;Zaragoza;063;Buste, El;64;35;29;2016
50;Zaragoza;064;Cabañas de Ebro;508;269;239;2016
50;Zaragoza;065;Cabolafuente;35;20;15;2016
50;Zaragoza;066;Cadrete;3655;1934;1721;2016
50;Zaragoza;067;Calatayud;20191;9981;10210;2016
50;Zaragoza;068;Calatorao;2829;1487;1342;2016
50;Zaragoza;069;Calcena;72;43;29;2016
50;Zaragoza;070;Calmarza;71;41;30;2016
50;Zaragoza;071;Campillo de Aragón;142;80;62;2016
50;Zaragoza;072;Carenas;172;89;83;2016
50;Zaragoza;073;Cariñena;3384;1709;1675;2016
50;Zaragoza;074;Caspe;9538;4925;4613;2016
50;Zaragoza;075;Castejón de Alarba;85;51;34;2016
50;Zaragoza;076;Castejón de las Armas;91;49;42;2016
50;Zaragoza;077;Castejón de Valdejasa;226;115;111;2016
50;Zaragoza;078;Castiliscar;264;136;128;2016
50;Zaragoza;079;Cervera de la Cañada;305;169;136;2016
50;Zaragoza;080;Cerveruela;34;21;13;2016
50;Zaragoza;081;Cetina;615;318;297;2016
50;Zaragoza;092;Chiprana;483;253;230;2016
50;Zaragoza;093;Chodes;125;69;56;2016
50;Zaragoza;082;Cimballa;109;54;55;2016
50;Zaragoza;083;Cinco Olivas;110;52;58;2016
50;Zaragoza;084;Clarés de Ribota;80;49;31;2016
50;Zaragoza;085;Codo;182;92;90;2016
50;Zaragoza;086;Codos;226;141;85;2016
50;Zaragoza;087;Contamina;35;20;15;2016
50;Zaragoza;088;Cosuenda;384;203;181;2016
50;Zaragoza;089;Cuarte de Huerva;12581;6496;6085;2016
50;Zaragoza;090;Cubel;175;84;91;2016
50;Zaragoza;091;Cuerlas, Las;44;24;20;2016
50;Zaragoza;094;Daroca;2087;1029;1058;2016
50;Zaragoza;095;Ejea de los Caballeros;16541;8428;8113;2016
50;Zaragoza;096;Embid de Ariza;41;20;21;2016
50;Zaragoza;098;Encinacorba;205;102;103;2016
50;Zaragoza;099;Épila;4452;2322;2130;2016
50;Zaragoza;100;Erla;364;182;182;2016
50;Zaragoza;101;Escatrón;1069;530;539;2016
50;Zaragoza;102;Fabara;1184;635;549;2016
50;Zaragoza;104;Farlete;404;201;203;2016
50;Zaragoza;105;Fayón;354;183;171;2016
50;Zaragoza;106;Fayos, Los;147;79;68;2016
50;Zaragoza;107;Figueruelas;1218;608;610;2016
50;Zaragoza;108;Fombuena;54;33;21;2016
50;Zaragoza;109;Frago, El;101;62;39;2016
50;Zaragoza;110;Frasno, El;399;218;181;2016
50;Zaragoza;111;Fréscano;201;107;94;2016
50;Zaragoza;113;Fuendejalón;786;420;366;2016
50;Zaragoza;114;Fuendetodos;126;67;59;2016
50;Zaragoza;115;Fuentes de Ebro;4566;2382;2184;2016
50;Zaragoza;116;Fuentes de Jiloca;269;147;122;2016
50;Zaragoza;117;Gallocanta;152;84;68;2016
50;Zaragoza;118;Gallur;2630;1329;1301;2016
50;Zaragoza;119;Gelsa;1098;572;526;2016
50;Zaragoza;120;Godojos;53;27;26;2016
50;Zaragoza;121;Gotor;326;170;156;2016
50;Zaragoza;122;Grisel;71;42;29;2016
50;Zaragoza;123;Grisén;622;315;307;2016
50;Zaragoza;124;Herrera de los Navarros;536;281;255;2016
50;Zaragoza;125;Ibdes;429;225;204;2016
50;Zaragoza;126;Illueca;3109;1540;1569;2016
50;Zaragoza;128;Isuerre;32;21;11;2016
50;Zaragoza;129;Jaraba;315;159;156;2016
50;Zaragoza;130;Jarque;457;251;206;2016
50;Zaragoza;131;Jaulín;254;129;125;2016
50;Zaragoza;132;Joyosa, La;1032;530;502;2016
50;Zaragoza;133;Lagata;126;71;55;2016
50;Zaragoza;134;Langa del Castillo;134;66;68;2016
50;Zaragoza;135;Layana;101;56;45;2016
50;Zaragoza;136;Lécera;726;395;331;2016
50;Zaragoza;138;Lechón;51;29;22;2016
50;Zaragoza;137;Leciñena;1215;619;596;2016
50;Zaragoza;139;Letux;350;195;155;2016
50;Zaragoza;140;Litago;171;95;76;2016
50;Zaragoza;141;Lituénigo;118;62;56;2016
50;Zaragoza;142;Lobera de Onsella;32;18;14;2016
50;Zaragoza;143;Longares;789;449;340;2016
50;Zaragoza;144;Longás;35;23;12;2016
50;Zaragoza;146;Lucena de Jalón;229;125;104;2016
50;Zaragoza;147;Luceni;989;510;479;2016
50;Zaragoza;148;Luesia;322;175;147;2016
50;Zaragoza;149;Luesma;35;22;13;2016
50;Zaragoza;150;Lumpiaque;867;448;419;2016
50;Zaragoza;151;Luna;733;385;348;2016
50;Zaragoza;152;Maella;1970;1066;904;2016
50;Zaragoza;153;Magallón;1157;599;558;2016
50;Zaragoza;154;Mainar;147;79;68;2016
50;Zaragoza;155;Malanquilla;107;66;41;2016
50;Zaragoza;156;Maleján;254;129;125;2016
50;Zaragoza;160;Mallén;3187;1668;1519;2016
50;Zaragoza;157;Malón;351;176;175;2016
50;Zaragoza;159;Maluenda;989;483;506;2016
50;Zaragoza;161;Manchones;120;71;49;2016
50;Zaragoza;162;Mara;191;96;95;2016
50;Zaragoza;163;María de Huerva;5550;2866;2684;2016
50;Zaragoza;902;Marracos;91;51;40;2016
50;Zaragoza;164;Mediana de Aragón;443;212;231;2016
50;Zaragoza;165;Mequinenza;2316;1179;1137;2016
50;Zaragoza;166;Mesones de Isuela;286;142;144;2016
50;Zaragoza;167;Mezalocha;254;149;105;2016
50;Zaragoza;168;Mianos;28;17;11;2016
50;Zaragoza;169;Miedes de Aragón;467;256;211;2016
50;Zaragoza;170;Monegrillo;418;236;182;2016
50;Zaragoza;171;Moneva;111;65;46;2016
50;Zaragoza;172;Monreal de Ariza;214;122;92;2016
50;Zaragoza;173;Monterde;198;115;83;2016
50;Zaragoza;174;Montón;103;63;40;2016
50;Zaragoza;175;Morata de Jalón;1177;576;601;2016
50;Zaragoza;176;Morata de Jiloca;272;160;112;2016
50;Zaragoza;177;Morés;349;187;162;2016
50;Zaragoza;178;Moros;383;197;186;2016
50;Zaragoza;179;Moyuela;265;145;120;2016
50;Zaragoza;180;Mozota;124;60;64;2016
50;Zaragoza;181;Muel;1312;667;645;2016
50;Zaragoza;182;Muela, La;5090;2657;2433;2016
50;Zaragoza;183;Munébrega;410;224;186;2016
50;Zaragoza;184;Murero;129;74;55;2016
50;Zaragoza;185;Murillo de Gállego;168;100;68;2016
50;Zaragoza;186;Navardún;42;26;16;2016
50;Zaragoza;187;Nigüella;76;44;32;2016
50;Zaragoza;188;Nombrevilla;32;18;14;2016
50;Zaragoza;189;Nonaspe;992;529;463;2016
50;Zaragoza;190;Novallas;871;471;400;2016
50;Zaragoza;191;Novillas;560;277;283;2016
50;Zaragoza;192;Nuévalos;335;179;156;2016
50;Zaragoza;193;Nuez de Ebro;840;429;411;2016
50;Zaragoza;194;Olvés;120;69;51;2016
50;Zaragoza;195;Orcajo;58;39;19;2016
50;Zaragoza;196;Orera;122;63;59;2016
50;Zaragoza;197;Orés;108;65;43;2016
50;Zaragoza;198;Oseja;60;36;24;2016
50;Zaragoza;199;Osera de Ebro;403;201;202;2016
50;Zaragoza;200;Paniza;673;356;317;2016
50;Zaragoza;201;Paracuellos de Jiloca;591;307;284;2016
50;Zaragoza;202;Paracuellos de la Ribera;162;83;79;2016
50;Zaragoza;203;Pastriz;1302;612;690;2016
50;Zaragoza;204;Pedrola;3450;1795;1655;2016
50;Zaragoza;205;Pedrosas, Las;107;53;54;2016
50;Zaragoza;206;Perdiguera;603;316;287;2016
50;Zaragoza;207;Piedratajada;112;59;53;2016
50;Zaragoza;208;Pina de Ebro;2443;1262;1181;2016
50;Zaragoza;209;Pinseque;3726;1945;1781;2016
50;Zaragoza;210;Pintanos, Los;43;25;18;2016
50;Zaragoza;211;Plasencia de Jalón;320;174;146;2016
50;Zaragoza;212;Pleitas;44;19;25;2016
50;Zaragoza;213;Plenas;105;59;46;2016
50;Zaragoza;214;Pomer;33;23;10;2016
50;Zaragoza;215;Pozuel de Ariza;24;16;8;2016
50;Zaragoza;216;Pozuelo de Aragón;282;150;132;2016
50;Zaragoza;217;Pradilla de Ebro;548;290;258;2016
50;Zaragoza;218;Puebla de Albortón;118;73;45;2016
50;Zaragoza;219;Puebla de Alfindén, La;6028;3086;2942;2016
50;Zaragoza;220;Puendeluna;44;24;20;2016
50;Zaragoza;221;Purujosa;38;26;12;2016
50;Zaragoza;222;Quinto;1996;1016;980;2016
50;Zaragoza;223;Remolinos;1113;575;538;2016
50;Zaragoza;224;Retascón;76;46;30;2016
50;Zaragoza;225;Ricla;3027;1580;1447;2016
50;Zaragoza;227;Romanos;127;69;58;2016
50;Zaragoza;228;Rueda de Jalón;328;178;150;2016
50;Zaragoza;229;Ruesca;73;36;37;2016
50;Zaragoza;241;Sabiñán;722;383;339;2016
50;Zaragoza;230;Sádaba;1366;697;669;2016
50;Zaragoza;231;Salillas de Jalón;304;153;151;2016
50;Zaragoza;232;Salvatierra de Esca;208;102;106;2016
50;Zaragoza;233;Samper del Salz;117;69;48;2016
50;Zaragoza;234;San Martín de la Virgen de Moncayo;286;162;124;2016
50;Zaragoza;235;San Mateo de Gállego;3060;1575;1485;2016
50;Zaragoza;236;Santa Cruz de Grío;123;72;51;2016
50;Zaragoza;237;Santa Cruz de Moncayo;130;69;61;2016
50;Zaragoza;238;Santa Eulalia de Gállego;102;55;47;2016
50;Zaragoza;239;Santed;62;40;22;2016
50;Zaragoza;240;Sástago;1183;597;586;2016
50;Zaragoza;242;Sediles;102;63;39;2016
50;Zaragoza;243;Sestrica;391;226;165;2016
50;Zaragoza;244;Sierra de Luna;262;140;122;2016
50;Zaragoza;245;Sigüés;93;51;42;2016
50;Zaragoza;246;Sisamón;35;24;11;2016
50;Zaragoza;247;Sobradiel;1079;514;565;2016
50;Zaragoza;248;Sos del Rey Católico;605;313;292;2016
50;Zaragoza;249;Tabuenca;343;197;146;2016
50;Zaragoza;250;Talamantes;55;27;28;2016
50;Zaragoza;251;Tarazona;10713;5307;5406;2016
50;Zaragoza;252;Tauste;6933;3444;3489;2016
50;Zaragoza;253;Terrer;497;271;226;2016
50;Zaragoza;254;Tierga;197;108;89;2016
50;Zaragoza;255;Tobed;225;120;105;2016
50;Zaragoza;256;Torralba de los Frailes;87;46;41;2016
50;Zaragoza;257;Torralba de Ribota;188;109;79;2016
50;Zaragoza;258;Torralbilla;58;32;26;2016
50;Zaragoza;259;Torrehermosa;67;38;29;2016
50;Zaragoza;260;Torrelapaja;33;20;13;2016
50;Zaragoza;261;Torrellas;248;131;117;2016
50;Zaragoza;262;Torres de Berrellén;1477;775;702;2016
50;Zaragoza;263;Torrijo de la Cañada;231;128;103;2016
50;Zaragoza;264;Tosos;195;108;87;2016
50;Zaragoza;265;Trasmoz;96;54;42;2016
50;Zaragoza;266;Trasobares;126;77;49;2016
50;Zaragoza;267;Uncastillo;668;317;351;2016
50;Zaragoza;268;Undués de Lerda;58;34;24;2016
50;Zaragoza;269;Urrea de Jalón;404;215;189;2016
50;Zaragoza;270;Urriés;40;21;19;2016
50;Zaragoza;271;Used;267;148;119;2016
50;Zaragoza;272;Utebo;18466;9197;9269;2016
50;Zaragoza;274;Val de San Martín;70;40;30;2016
50;Zaragoza;273;Valdehorna;28;13;15;2016
50;Zaragoza;275;Valmadrid;122;77;45;2016
50;Zaragoza;276;Valpalmas;147;70;77;2016
50;Zaragoza;277;Valtorres;73;34;39;2016
50;Zaragoza;278;Velilla de Ebro;231;121;110;2016
50;Zaragoza;279;Velilla de Jiloca;114;55;59;2016
50;Zaragoza;280;Vera de Moncayo;383;198;185;2016
50;Zaragoza;281;Vierlas;85;46;39;2016
50;Zaragoza;283;Villadoz;82;47;35;2016
50;Zaragoza;284;Villafeliche;184;95;89;2016
50;Zaragoza;285;Villafranca de Ebro;829;405;424;2016
50;Zaragoza;286;Villalba de Perejil;99;49;50;2016
50;Zaragoza;287;Villalengua;336;181;155;2016
50;Zaragoza;903;Villamayor de Gállego;2753;1392;1361;2016
50;Zaragoza;288;Villanueva de Gállego;4678;2360;2318;2016
50;Zaragoza;290;Villanueva de Huerva;473;246;227;2016
50;Zaragoza;289;Villanueva de Jiloca;57;27;30;2016
50;Zaragoza;291;Villar de los Navarros;110;62;48;2016
50;Zaragoza;292;Villarreal de Huerva;242;132;110;2016
50;Zaragoza;293;Villarroya de la Sierra;478;258;220;2016
50;Zaragoza;294;Villarroya del Campo;76;41;35;2016
50;Zaragoza;282;Vilueña, La;100;52;48;2016
50;Zaragoza;295;Vistabella;48;30;18;2016
50;Zaragoza;296;Zaida, La;461;226;235;2016
50;Zaragoza;297;Zaragoza;661108;317555;343553;2016
50;Zaragoza;298;Zuera;7978;4093;3885;2016
51;Ceuta;001;Ceuta;84519;42846;41673;2016
52;Melilla;001;Melilla;86026;43768;42258;2016
02;Albacete;001;Abengibre;748;359;389;2017
02;Albacete;002;Alatoz;555;309;246;2017
02;Albacete;003;Albacete;172816;84507;88309;2017
02;Albacete;004;Albatana;698;362;336;2017
02;Albacete;005;Alborea;697;357;340;2017
02;Albacete;006;Alcadozo;662;361;301;2017
02;Albacete;007;Alcalá del Júcar;1202;642;560;2017
02;Albacete;008;Alcaraz;1414;721;693;2017
02;Albacete;009;Almansa;24566;12226;12340;2017
02;Albacete;010;Alpera;2290;1189;1101;2017
02;Albacete;011;Ayna;672;360;312;2017
02;Albacete;012;Balazote;2350;1205;1145;2017
02;Albacete;014;Ballestero, El;414;213;201;2017
02;Albacete;013;Balsa de Ves;136;80;56;2017
02;Albacete;015;Barrax;1872;950;922;2017
02;Albacete;016;Bienservida;615;322;293;2017
02;Albacete;017;Bogarra;908;478;430;2017
02;Albacete;018;Bonete;1103;562;541;2017
02;Albacete;019;Bonillo, El;2852;1464;1388;2017
02;Albacete;020;Carcelén;521;286;235;2017
02;Albacete;021;Casas de Juan Núñez;1291;679;612;2017
02;Albacete;022;Casas de Lázaro;358;203;155;2017
02;Albacete;023;Casas de Ves;628;328;300;2017
02;Albacete;024;Casas-Ibáñez;4558;2323;2235;2017
02;Albacete;025;Caudete;10010;5091;4919;2017
02;Albacete;026;Cenizate;1192;603;589;2017
02;Albacete;029;Chinchilla de Monte-Aragón;4213;2193;2020;2017
02;Albacete;027;Corral-Rubio;342;184;158;2017
02;Albacete;028;Cotillas;130;66;64;2017
02;Albacete;030;Elche de la Sierra;3666;1840;1826;2017
02;Albacete;031;Férez;678;338;340;2017
02;Albacete;032;Fuensanta;313;174;139;2017
02;Albacete;033;Fuente-Álamo;2531;1331;1200;2017
02;Albacete;034;Fuentealbilla;1843;925;918;2017
02;Albacete;035;Gineta, La;2457;1258;1199;2017
02;Albacete;036;Golosalvo;110;59;51;2017
02;Albacete;037;Hellín;30184;15061;15123;2017
02;Albacete;038;Herrera, La;341;177;164;2017
02;Albacete;039;Higueruela;1196;619;577;2017
02;Albacete;040;Hoya-Gonzalo;643;344;299;2017
02;Albacete;041;Jorquera;378;205;173;2017
02;Albacete;042;Letur;948;461;487;2017
02;Albacete;043;Lezuza;1412;729;683;2017
02;Albacete;044;Liétor;1240;646;594;2017
02;Albacete;045;Madrigueras;4647;2391;2256;2017
02;Albacete;046;Mahora;1360;698;662;2017
02;Albacete;047;Masegoso;115;63;52;2017
02;Albacete;048;Minaya;1538;809;729;2017
02;Albacete;049;Molinicos;863;442;421;2017
02;Albacete;050;Montalvos;102;56;46;2017
02;Albacete;051;Montealegre del Castillo;2057;1043;1014;2017
02;Albacete;052;Motilleja;549;293;256;2017
02;Albacete;053;Munera;3572;1817;1755;2017
02;Albacete;054;Navas de Jorquera;523;270;253;2017
02;Albacete;055;Nerpio;1277;700;577;2017
02;Albacete;056;Ontur;2072;1037;1035;2017
02;Albacete;057;Ossa de Montiel;2411;1191;1220;2017
02;Albacete;058;Paterna del Madera;359;192;167;2017
02;Albacete;060;Peñas de San Pedro;1436;836;600;2017
02;Albacete;059;Peñascosa;328;177;151;2017
02;Albacete;061;Pétrola;719;368;351;2017
02;Albacete;062;Povedilla;452;243;209;2017
02;Albacete;901;Pozo Cañada;2800;1409;1391;2017
02;Albacete;063;Pozohondo;1653;865;788;2017
02;Albacete;064;Pozo-Lorente;414;215;199;2017
02;Albacete;065;Pozuelo;514;271;243;2017
02;Albacete;066;Recueja, La;260;135;125;2017
02;Albacete;067;Riópar;1391;712;679;2017
02;Albacete;068;Robledo;366;200;166;2017
02;Albacete;069;Roda, La;15603;7887;7716;2017
02;Albacete;070;Salobre;523;277;246;2017
02;Albacete;071;San Pedro;1179;600;579;2017
02;Albacete;072;Socovos;1788;915;873;2017
02;Albacete;073;Tarazona de la Mancha;6363;3221;3142;2017
02;Albacete;074;Tobarra;7754;3941;3813;2017
02;Albacete;075;Valdeganga;1958;999;959;2017
02;Albacete;076;Vianos;359;185;174;2017
02;Albacete;077;Villa de Ves;59;33;26;2017
02;Albacete;078;Villalgordo del Júcar;1125;592;533;2017
02;Albacete;079;Villamalea;4124;2068;2056;2017
02;Albacete;080;Villapalacios;594;309;285;2017
02;Albacete;081;Villarrobledo;25317;12541;12776;2017
02;Albacete;082;Villatoya;107;63;44;2017
02;Albacete;083;Villavaliente;219;129;90;2017
02;Albacete;084;Villaverde de Guadalimar;349;183;166;2017
02;Albacete;085;Viveros;338;175;163;2017
02;Albacete;086;Yeste;2742;1402;1340;2017
03;Alicante/Alacant;002;Agost;4703;2343;2360;2017
03;Alicante/Alacant;003;Agres;549;292;257;2017
03;Alicante/Alacant;004;Aigües;913;478;435;2017
03;Alicante/Alacant;005;Albatera;11850;6062;5788;2017
03;Alicante/Alacant;006;Alcalalí;1276;631;645;2017
03;Alicante/Alacant;007;Alcocer de Planes;230;118;112;2017
03;Alicante/Alacant;008;Alcoleja;185;95;90;2017
03;Alicante/Alacant;009;Alcoy/Alcoi;59106;28836;30270;2017
03;Alicante/Alacant;010;Alfafara;405;196;209;2017
03;Alicante/Alacant;011;Alfàs del Pi, l';18394;9084;9310;2017
03;Alicante/Alacant;012;Algorfa;2761;1380;1381;2017
03;Alicante/Alacant;013;Algueña;1372;683;689;2017
03;Alicante/Alacant;014;Alicante/Alacant;329988;160062;169926;2017
03;Alicante/Alacant;015;Almoradí;20332;10306;10026;2017
03;Alicante/Alacant;016;Almudaina;113;57;56;2017
03;Alicante/Alacant;017;Alqueria d'Asnar, l';496;231;265;2017
03;Alicante/Alacant;018;Altea;21813;10702;11111;2017
03;Alicante/Alacant;019;Aspe;20425;10271;10154;2017
03;Alicante/Alacant;001;Atzúbia, l';664;349;315;2017
03;Alicante/Alacant;020;Balones;128;65;63;2017
03;Alicante/Alacant;021;Banyeres de Mariola;7102;3551;3551;2017
03;Alicante/Alacant;022;Benasau;157;75;82;2017
03;Alicante/Alacant;023;Beneixama;1710;860;850;2017
03;Alicante/Alacant;024;Benejúzar;5372;2689;2683;2017
03;Alicante/Alacant;025;Benferri;1923;1011;912;2017
03;Alicante/Alacant;026;Beniarbeig;1919;978;941;2017
03;Alicante/Alacant;027;Beniardá;183;91;92;2017
03;Alicante/Alacant;028;Beniarrés;1137;576;561;2017
03;Alicante/Alacant;030;Benidoleig;1080;544;536;2017
03;Alicante/Alacant;031;Benidorm;66831;33195;33636;2017
03;Alicante/Alacant;032;Benifallim;111;62;49;2017
03;Alicante/Alacant;033;Benifato;148;72;76;2017
03;Alicante/Alacant;029;Benigembla;433;219;214;2017
03;Alicante/Alacant;034;Benijófar;3290;1614;1676;2017
03;Alicante/Alacant;035;Benilloba;755;390;365;2017
03;Alicante/Alacant;036;Benillup;102;45;57;2017
03;Alicante/Alacant;037;Benimantell;495;240;255;2017
03;Alicante/Alacant;038;Benimarfull;418;211;207;2017
03;Alicante/Alacant;039;Benimassot;99;57;42;2017
03;Alicante/Alacant;040;Benimeli;391;188;203;2017
03;Alicante/Alacant;041;Benissa;10879;5340;5539;2017
03;Alicante/Alacant;042;Benitachell/Poble Nou de Benitatxell, el;4020;2002;2018;2017
03;Alicante/Alacant;043;Biar;3650;1791;1859;2017
03;Alicante/Alacant;044;Bigastro;6656;3353;3303;2017
03;Alicante/Alacant;045;Bolulla;414;215;199;2017
03;Alicante/Alacant;046;Busot;2904;1483;1421;2017
03;Alicante/Alacant;049;Callosa de Segura;18625;9430;9195;2017
03;Alicante/Alacant;048;Callosa d'en Sarrià;7223;3682;3541;2017
03;Alicante/Alacant;047;Calp;20804;10491;10313;2017
03;Alicante/Alacant;050;Campello, el;27604;13456;14148;2017
03;Alicante/Alacant;051;Campo de Mirra/Camp de Mirra, el;436;228;208;2017
03;Alicante/Alacant;052;Cañada;1242;618;624;2017
03;Alicante/Alacant;053;Castalla;9876;4988;4888;2017
03;Alicante/Alacant;054;Castell de Castells;436;218;218;2017
03;Alicante/Alacant;075;Castell de Guadalest, el;205;103;102;2017
03;Alicante/Alacant;055;Catral;8620;4353;4267;2017
03;Alicante/Alacant;056;Cocentaina;11461;5799;5662;2017
03;Alicante/Alacant;057;Confrides;221;127;94;2017
03;Alicante/Alacant;058;Cox;7192;3698;3494;2017
03;Alicante/Alacant;059;Crevillent;28836;14572;14264;2017
03;Alicante/Alacant;061;Daya Nueva;1684;843;841;2017
03;Alicante/Alacant;062;Daya Vieja;713;369;344;2017
03;Alicante/Alacant;063;Dénia;41568;20185;21383;2017
03;Alicante/Alacant;064;Dolores;7302;3649;3653;2017
03;Alicante/Alacant;065;Elche/Elx;228675;113345;115330;2017
03;Alicante/Alacant;066;Elda;52620;25697;26923;2017
03;Alicante/Alacant;067;Facheca;101;52;49;2017
03;Alicante/Alacant;068;Famorca;57;30;27;2017
03;Alicante/Alacant;069;Finestrat;6292;3191;3101;2017
03;Alicante/Alacant;077;Fondó de les Neus, el/Hondón de las Nieves;2436;1224;1212;2017
03;Alicante/Alacant;070;Formentera del Segura;4064;2058;2006;2017
03;Alicante/Alacant;072;Gaianes;448;235;213;2017
03;Alicante/Alacant;071;Gata de Gorgos;5804;2926;2878;2017
03;Alicante/Alacant;073;Gorga;273;152;121;2017
03;Alicante/Alacant;074;Granja de Rocamora;2469;1287;1182;2017
03;Alicante/Alacant;076;Guardamar del Segura;14716;7202;7514;2017
03;Alicante/Alacant;078;Hondón de los Frailes;1102;567;535;2017
03;Alicante/Alacant;079;Ibi;23423;11747;11676;2017
03;Alicante/Alacant;080;Jacarilla;1953;997;956;2017
03;Alicante/Alacant;082;Jávea/Xàbia;27060;13441;13619;2017
03;Alicante/Alacant;083;Jijona/Xixona;6895;3349;3546;2017
03;Alicante/Alacant;085;Llíber;951;468;483;2017
03;Alicante/Alacant;084;Lorcha/Orxa, l';606;299;307;2017
03;Alicante/Alacant;086;Millena;230;125;105;2017
03;Alicante/Alacant;088;Monforte del Cid;7592;3967;3625;2017
03;Alicante/Alacant;089;Monóvar/Monòver;12177;6073;6104;2017
03;Alicante/Alacant;903;Montesinos, Los;4862;2457;2405;2017
03;Alicante/Alacant;091;Murla;477;226;251;2017
03;Alicante/Alacant;092;Muro de Alcoy;9319;4620;4699;2017
03;Alicante/Alacant;090;Mutxamel;24778;12352;12426;2017
03;Alicante/Alacant;093;Novelda;25868;12825;13043;2017
03;Alicante/Alacant;094;Nucia, la;18548;9366;9182;2017
03;Alicante/Alacant;095;Ondara;6739;3377;3362;2017
03;Alicante/Alacant;096;Onil;7493;3739;3754;2017
03;Alicante/Alacant;097;Orba;2035;994;1041;2017
03;Alicante/Alacant;099;Orihuela;76097;37829;38268;2017
03;Alicante/Alacant;098;Orxeta;760;385;375;2017
03;Alicante/Alacant;100;Parcent;965;471;494;2017
03;Alicante/Alacant;101;Pedreguer;7435;3698;3737;2017
03;Alicante/Alacant;102;Pego;9923;4960;4963;2017
03;Alicante/Alacant;103;Penàguila;308;163;145;2017
03;Alicante/Alacant;104;Petrer;34533;17162;17371;2017
03;Alicante/Alacant;902;Pilar de la Horadada;21202;10894;10308;2017
03;Alicante/Alacant;105;Pinós, el/Pinoso;7718;3896;3822;2017
03;Alicante/Alacant;106;Planes;733;389;344;2017
03;Alicante/Alacant;901;Poblets, els;2926;1392;1534;2017
03;Alicante/Alacant;107;Polop;4725;2437;2288;2017
03;Alicante/Alacant;060;Quatretondeta;109;62;47;2017
03;Alicante/Alacant;109;Rafal;4322;2165;2157;2017
03;Alicante/Alacant;110;Ràfol d'Almúnia, el;631;322;309;2017
03;Alicante/Alacant;111;Redován;7811;4028;3783;2017
03;Alicante/Alacant;112;Relleu;1118;575;543;2017
03;Alicante/Alacant;113;Rojales;16231;8201;8030;2017
03;Alicante/Alacant;114;Romana, la;2377;1232;1145;2017
03;Alicante/Alacant;115;Sagra;393;198;195;2017
03;Alicante/Alacant;116;Salinas;1562;795;767;2017
03;Alicante/Alacant;118;San Fulgencio;7646;3866;3780;2017
03;Alicante/Alacant;904;San Isidro;1920;983;937;2017
03;Alicante/Alacant;120;San Miguel de Salinas;5797;2909;2888;2017
03;Alicante/Alacant;122;San Vicente del Raspeig/Sant Vicent del Raspeig;57175;28303;28872;2017
03;Alicante/Alacant;117;Sanet y Negrals;634;325;309;2017
03;Alicante/Alacant;119;Sant Joan d'Alacant;23149;11171;11978;2017
03;Alicante/Alacant;121;Santa Pola;31137;15602;15535;2017
03;Alicante/Alacant;123;Sax;9737;4909;4828;2017
03;Alicante/Alacant;124;Sella;579;306;273;2017
03;Alicante/Alacant;125;Senija;578;293;285;2017
03;Alicante/Alacant;127;Tàrbena;640;329;311;2017
03;Alicante/Alacant;128;Teulada;10097;5041;5056;2017
03;Alicante/Alacant;129;Tibi;1603;842;761;2017
03;Alicante/Alacant;130;Tollos;50;27;23;2017
03;Alicante/Alacant;131;Tormos;333;163;170;2017
03;Alicante/Alacant;132;Torremanzanas/Torre de les Maçanes, la;682;357;325;2017
03;Alicante/Alacant;133;Torrevieja;83252;41527;41725;2017
03;Alicante/Alacant;134;Vall d'Alcalà, la;168;92;76;2017
03;Alicante/Alacant;136;Vall de Gallinera;594;323;271;2017
03;Alicante/Alacant;137;Vall de Laguar, la;825;408;417;2017
03;Alicante/Alacant;135;Vall d'Ebo, la;232;124;108;2017
03;Alicante/Alacant;138;Verger, el;4421;2212;2209;2017
03;Alicante/Alacant;139;Villajoyosa/Vila Joiosa, la;33607;16777;16830;2017
03;Alicante/Alacant;140;Villena;33968;16972;16996;2017
03;Alicante/Alacant;081;Xaló;2636;1306;1330;2017
04;Almería;001;Abla;1267;651;616;2017
04;Almería;002;Abrucena;1170;606;564;2017
04;Almería;003;Adra;24697;12480;12217;2017
04;Almería;004;Albánchez;754;378;376;2017
04;Almería;005;Alboloduy;610;299;311;2017
04;Almería;006;Albox;11481;5873;5608;2017
04;Almería;007;Alcolea;811;416;395;2017
04;Almería;008;Alcóntar;577;319;258;2017
04;Almería;009;Alcudia de Monteagud;148;68;80;2017
04;Almería;010;Alhabia;678;355;323;2017
04;Almería;011;Alhama de Almería;3653;1835;1818;2017
04;Almería;012;Alicún;217;110;107;2017
04;Almería;013;Almería;195389;95044;100345;2017
04;Almería;014;Almócita;174;91;83;2017
04;Almería;015;Alsodux;132;75;57;2017
04;Almería;016;Antas;3124;1556;1568;2017
04;Almería;017;Arboleas;4463;2238;2225;2017
04;Almería;018;Armuña de Almanzora;327;158;169;2017
04;Almería;019;Bacares;244;128;116;2017
04;Almería;904;Balanegra;2939;1532;1407;2017
04;Almería;020;Bayárcal;303;163;140;2017
04;Almería;021;Bayarque;215;108;107;2017
04;Almería;022;Bédar;892;437;455;2017
04;Almería;023;Beires;110;53;57;2017
04;Almería;024;Benahadux;4212;2092;2120;2017
04;Almería;026;Benitagla;66;39;27;2017
04;Almería;027;Benizalón;263;142;121;2017
04;Almería;028;Bentarique;238;136;102;2017
04;Almería;029;Berja;12331;6204;6127;2017
04;Almería;030;Canjáyar;1223;633;590;2017
04;Almería;031;Cantoria;3251;1653;1598;2017
04;Almería;032;Carboneras;7837;4032;3805;2017
04;Almería;033;Castro de Filabres;130;61;69;2017
04;Almería;036;Chercos;291;147;144;2017
04;Almería;037;Chirivel;1568;792;776;2017
04;Almería;034;Cóbdar;156;92;64;2017
04;Almería;035;Cuevas del Almanzora;13655;7103;6552;2017
04;Almería;038;Dalías;3986;1973;2013;2017
04;Almería;902;Ejido, El;88096;46719;41377;2017
04;Almería;041;Enix;434;241;193;2017
04;Almería;043;Felix;661;372;289;2017
04;Almería;044;Fines;2048;1066;982;2017
04;Almería;045;Fiñana;2014;1007;1007;2017
04;Almería;046;Fondón;1002;531;471;2017
04;Almería;047;Gádor;3037;1575;1462;2017
04;Almería;048;Gallardos, Los;2841;1431;1410;2017
04;Almería;049;Garrucha;8666;4465;4201;2017
04;Almería;050;Gérgal;1030;546;484;2017
04;Almería;051;Huécija;501;243;258;2017
04;Almería;052;Huércal de Almería;17234;8791;8443;2017
04;Almería;053;Huércal-Overa;18649;9254;9395;2017
04;Almería;054;Íllar;374;202;172;2017
04;Almería;055;Instinción;430;208;222;2017
04;Almería;056;Laroya;169;95;74;2017
04;Almería;057;Láujar de Andarax;1533;762;771;2017
04;Almería;058;Líjar;395;207;188;2017
04;Almería;059;Lubrín;1440;704;736;2017
04;Almería;060;Lucainena de las Torres;570;308;262;2017
04;Almería;061;Lúcar;771;382;389;2017
04;Almería;062;Macael;5576;2866;2710;2017
04;Almería;063;María;1288;659;629;2017
04;Almería;064;Mojácar;6330;3115;3215;2017
04;Almería;903;Mojonera, La;8717;4816;3901;2017
04;Almería;065;Nacimiento;475;240;235;2017
04;Almería;066;Níjar;28996;15816;13180;2017
04;Almería;067;Ohanes;626;306;320;2017
04;Almería;068;Olula de Castro;191;103;88;2017
04;Almería;069;Olula del Río;6216;3194;3022;2017
04;Almería;070;Oria;2265;1191;1074;2017
04;Almería;071;Padules;436;223;213;2017
04;Almería;072;Partaloa;975;484;491;2017
04;Almería;073;Paterna del Río;364;211;153;2017
04;Almería;074;Pechina;4010;2036;1974;2017
04;Almería;075;Pulpí;9055;4669;4386;2017
04;Almería;076;Purchena;1636;846;790;2017
04;Almería;077;Rágol;307;165;142;2017
04;Almería;078;Rioja;1367;684;683;2017
04;Almería;079;Roquetas de Mar;93363;48180;45183;2017
04;Almería;080;Santa Cruz de Marchena;225;111;114;2017
04;Almería;081;Santa Fe de Mondújar;429;216;213;2017
04;Almería;082;Senés;312;166;146;2017
04;Almería;083;Serón;2080;1058;1022;2017
04;Almería;084;Sierro;400;210;190;2017
04;Almería;085;Somontín;471;236;235;2017
04;Almería;086;Sorbas;2463;1296;1167;2017
04;Almería;087;Suflí;222;119;103;2017
04;Almería;088;Tabernas;3679;1893;1786;2017
04;Almería;089;Taberno;984;480;504;2017
04;Almería;090;Tahal;346;174;172;2017
04;Almería;091;Terque;386;194;192;2017
04;Almería;092;Tíjola;3615;1786;1829;2017
04;Almería;901;Tres Villas, Las;598;320;278;2017
04;Almería;093;Turre;3317;1692;1625;2017
04;Almería;094;Turrillas;229;133;96;2017
04;Almería;095;Uleila del Campo;848;427;421;2017
04;Almería;096;Urrácal;332;171;161;2017
04;Almería;097;Velefique;247;132;115;2017
04;Almería;098;Vélez-Blanco;1918;998;920;2017
04;Almería;099;Vélez-Rubio;6661;3227;3434;2017
04;Almería;100;Vera;15528;7916;7612;2017
04;Almería;101;Viator;5686;2911;2775;2017
04;Almería;102;Vícar;25149;13388;11761;2017
04;Almería;103;Zurgena;2877;1437;1440;2017
01;Araba/Álava;051;Agurain/Salvatierra;5025;2502;2523;2017
01;Araba/Álava;001;Alegría-Dulantzi;2913;1512;1401;2017
01;Araba/Álava;002;Amurrio;10291;5101;5190;2017
01;Araba/Álava;049;Añana;156;89;67;2017
01;Araba/Álava;003;Aramaio;1496;791;705;2017
01;Araba/Álava;006;Armiñón;239;128;111;2017
01;Araba/Álava;037;Arraia-Maeztu;725;404;321;2017
01;Araba/Álava;008;Arratzua-Ubarrundia;976;528;448;2017
01;Araba/Álava;004;Artziniega;1829;914;915;2017
01;Araba/Álava;009;Asparrena;1640;823;817;2017
01;Araba/Álava;010;Ayala/Aiara;2969;1508;1461;2017
01;Araba/Álava;011;Baños de Ebro/Mañueta;306;167;139;2017
01;Araba/Álava;013;Barrundia;898;502;396;2017
01;Araba/Álava;014;Berantevilla;443;236;207;2017
01;Araba/Álava;016;Bernedo;504;299;205;2017
01;Araba/Álava;017;Campezo/Kanpezu;1048;556;492;2017
01;Araba/Álava;021;Elburgo/Burgelu;607;319;288;2017
01;Araba/Álava;022;Elciego;1030;514;516;2017
01;Araba/Álava;023;Elvillar/Bilar;353;173;180;2017
01;Araba/Álava;046;Erriberagoitia/Ribera Alta;736;420;316;2017
01;Araba/Álava;056;Harana/Valle de Arana;232;132;100;2017
01;Araba/Álava;901;Iruña Oka/Iruña de Oca;3264;1683;1581;2017
01;Araba/Álava;027;Iruraiz-Gauna;530;289;241;2017
01;Araba/Álava;019;Kripan;184;98;86;2017
01;Araba/Álava;020;Kuartango;372;216;156;2017
01;Araba/Álava;028;Labastida/Bastida;1454;762;692;2017
01;Araba/Álava;030;Lagrán;166;92;74;2017
01;Araba/Álava;031;Laguardia;1474;763;711;2017
01;Araba/Álava;032;Lanciego/Lantziego;673;345;328;2017
01;Araba/Álava;902;Lantarón;899;502;397;2017
01;Araba/Álava;033;Lapuebla de Labarca;859;448;411;2017
01;Araba/Álava;036;Laudio/Llodio;18133;8965;9168;2017
01;Araba/Álava;058;Legutio;1800;960;840;2017
01;Araba/Álava;034;Leza;203;100;103;2017
01;Araba/Álava;039;Moreda de Álava/Moreda Araba;230;115;115;2017
01;Araba/Álava;041;Navaridas;226;132;94;2017
01;Araba/Álava;042;Okondo;1155;600;555;2017
01;Araba/Álava;043;Oyón-Oion;3338;1693;1645;2017
01;Araba/Álava;044;Peñacerrada-Urizaharra;264;156;108;2017
01;Araba/Álava;047;Ribera Baja/Erribera Beitia;1375;748;627;2017
01;Araba/Álava;052;Samaniego;323;163;160;2017
01;Araba/Álava;053;San Millán/Donemiliaga;709;394;315;2017
01;Araba/Álava;054;Urkabustaiz;1330;699;631;2017
01;Araba/Álava;055;Valdegovía/Gaubea;996;557;439;2017
01;Araba/Álava;057;Villabuena de Álava/Eskuernaga;300;152;148;2017
01;Araba/Álava;059;Vitoria-Gasteiz;246976;120500;126476;2017
01;Araba/Álava;060;Yécora/Iekora;270;139;131;2017
01;Araba/Álava;061;Zalduondo;190;106;84;2017
01;Araba/Álava;062;Zambrana;383;208;175;2017
01;Araba/Álava;018;Zigoitia;1766;960;806;2017
01;Araba/Álava;063;Zuia;2316;1191;1125;2017
33;Asturias;001;Allande;1742;881;861;2017
33;Asturias;002;Aller;11027;5423;5604;2017
33;Asturias;003;Amieva;699;385;314;2017
33;Asturias;004;Avilés;79514;37632;41882;2017
33;Asturias;005;Belmonte de Miranda;1554;806;748;2017
33;Asturias;006;Bimenes;1737;829;908;2017
33;Asturias;007;Boal;1586;799;787;2017
33;Asturias;008;Cabrales;2008;1027;981;2017
33;Asturias;009;Cabranes;1058;539;519;2017
33;Asturias;010;Candamo;2028;995;1033;2017
33;Asturias;012;Cangas de Onís;6332;3064;3268;2017
33;Asturias;011;Cangas del Narcea;12947;6392;6555;2017
33;Asturias;013;Caravia;472;241;231;2017
33;Asturias;014;Carreño;10545;5096;5449;2017
33;Asturias;015;Caso;1574;890;684;2017
33;Asturias;016;Castrillón;22490;10892;11598;2017
33;Asturias;017;Castropol;3510;1712;1798;2017
33;Asturias;018;Coaña;3387;1651;1736;2017
33;Asturias;019;Colunga;3440;1688;1752;2017
33;Asturias;020;Corvera de Asturias;15871;7794;8077;2017
33;Asturias;021;Cudillero;5183;2572;2611;2017
33;Asturias;022;Degaña;978;508;470;2017
33;Asturias;023;Franco, El;3834;1886;1948;2017
33;Asturias;024;Gijón;272365;128355;144010;2017
33;Asturias;025;Gozón;10440;5077;5363;2017
33;Asturias;026;Grado;9980;4823;5157;2017
33;Asturias;027;Grandas de Salime;874;448;426;2017
33;Asturias;028;Ibias;1362;765;597;2017
33;Asturias;029;Illano;360;181;179;2017
33;Asturias;030;Illas;1017;513;504;2017
33;Asturias;031;Langreo;40529;19289;21240;2017
33;Asturias;032;Laviana;13236;6347;6889;2017
33;Asturias;033;Lena;11278;5427;5851;2017
33;Asturias;035;Llanera;13794;6857;6937;2017
33;Asturias;036;Llanes;13759;6677;7082;2017
33;Asturias;037;Mieres;38962;18506;20456;2017
33;Asturias;038;Morcín;2666;1335;1331;2017
33;Asturias;039;Muros de Nalón;1858;885;973;2017
33;Asturias;040;Nava;5333;2626;2707;2017
33;Asturias;041;Navia;8425;4062;4363;2017
33;Asturias;042;Noreña;5210;2505;2705;2017
33;Asturias;043;Onís;743;396;347;2017
33;Asturias;044;Oviedo;220301;102047;118254;2017
33;Asturias;045;Parres;5389;2634;2755;2017
33;Asturias;046;Peñamellera Alta;544;280;264;2017
33;Asturias;047;Peñamellera Baja;1261;611;650;2017
33;Asturias;048;Pesoz;156;84;72;2017
33;Asturias;049;Piloña;7178;3546;3632;2017
33;Asturias;050;Ponga;623;372;251;2017
33;Asturias;051;Pravia;8384;4050;4334;2017
33;Asturias;052;Proaza;754;435;319;2017
33;Asturias;053;Quirós;1212;693;519;2017
33;Asturias;054;Regueras, Las;1874;958;916;2017
33;Asturias;055;Ribadedeva;1753;839;914;2017
33;Asturias;056;Ribadesella;5779;2755;3024;2017
33;Asturias;057;Ribera de Arriba;1873;940;933;2017
33;Asturias;058;Riosa;1991;1002;989;2017
33;Asturias;059;Salas;5140;2543;2597;2017
33;Asturias;061;San Martín de Oscos;403;203;200;2017
33;Asturias;060;San Martín del Rey Aurelio;16584;7947;8637;2017
33;Asturias;063;San Tirso de Abres;447;218;229;2017
33;Asturias;062;Santa Eulalia de Oscos;461;244;217;2017
33;Asturias;064;Santo Adriano;278;138;140;2017
33;Asturias;065;Sariego;1252;607;645;2017
33;Asturias;066;Siero;51776;25218;26558;2017
33;Asturias;067;Sobrescobio;834;444;390;2017
33;Asturias;068;Somiedo;1142;662;480;2017
33;Asturias;069;Soto del Barco;3924;1949;1975;2017
33;Asturias;070;Tapia de Casariego;3851;1867;1984;2017
33;Asturias;071;Taramundi;652;317;335;2017
33;Asturias;072;Teverga;1678;897;781;2017
33;Asturias;073;Tineo;9700;4884;4816;2017
33;Asturias;034;Valdés;11987;5849;6138;2017
33;Asturias;074;Vegadeo;3894;1874;2020;2017
33;Asturias;075;Villanueva de Oscos;303;150;153;2017
33;Asturias;076;Villaviciosa;14455;7137;7318;2017
33;Asturias;077;Villayón;1280;663;617;2017
33;Asturias;078;Yernes y Tameza;140;78;62;2017
05;Ávila;001;Adanero;211;117;94;2017
05;Ávila;002;Adrada, La;2583;1328;1255;2017
05;Ávila;005;Albornos;199;106;93;2017
05;Ávila;007;Aldeanueva de Santa Cruz;120;62;58;2017
05;Ávila;008;Aldeaseca;255;127;128;2017
05;Ávila;010;Aldehuela, La;172;88;84;2017
05;Ávila;012;Amavida;139;69;70;2017
05;Ávila;013;Arenal, El;996;505;491;2017
05;Ávila;014;Arenas de San Pedro;6556;3182;3374;2017
05;Ávila;015;Arevalillo;78;38;40;2017
05;Ávila;016;Arévalo;8087;3932;4155;2017
05;Ávila;017;Aveinte;83;46;37;2017
05;Ávila;018;Avellaneda;29;17;12;2017
05;Ávila;019;Ávila;58149;27784;30365;2017
05;Ávila;021;Barco de Ávila, El;2436;1175;1261;2017
05;Ávila;022;Barraco, El;1886;975;911;2017
05;Ávila;023;Barromán;183;101;82;2017
05;Ávila;024;Becedas;219;116;103;2017
05;Ávila;025;Becedillas;95;52;43;2017
05;Ávila;026;Bercial de Zapardiel;206;109;97;2017
05;Ávila;027;Berlanas, Las;324;167;157;2017
05;Ávila;029;Bernuy-Zapardiel;121;70;51;2017
05;Ávila;030;Berrocalejo de Aragona;39;19;20;2017
05;Ávila;033;Blascomillán;199;105;94;2017
05;Ávila;034;Blasconuño de Matacabras;14;8;6;2017
05;Ávila;035;Blascosancho;106;49;57;2017
05;Ávila;036;Bohodón, El;126;64;62;2017
05;Ávila;037;Bohoyo;261;144;117;2017
05;Ávila;038;Bonilla de la Sierra;124;73;51;2017
05;Ávila;039;Brabos;47;29;18;2017
05;Ávila;040;Bularros;68;44;24;2017
05;Ávila;041;Burgohondo;1225;634;591;2017
05;Ávila;042;Cabezas de Alambre;158;79;79;2017
05;Ávila;043;Cabezas del Pozo;83;45;38;2017
05;Ávila;044;Cabezas del Villar;296;165;131;2017
05;Ávila;045;Cabizuela;94;50;44;2017
05;Ávila;046;Canales;49;27;22;2017
05;Ávila;047;Candeleda;5002;2543;2459;2017
05;Ávila;048;Cantiveros;115;64;51;2017
05;Ávila;049;Cardeñosa;440;233;207;2017
05;Ávila;051;Carrera, La;184;102;82;2017
05;Ávila;052;Casas del Puerto;99;52;47;2017
05;Ávila;053;Casasola;84;44;40;2017
05;Ávila;054;Casavieja;1468;761;707;2017
05;Ávila;055;Casillas;650;348;302;2017
05;Ávila;056;Castellanos de Zapardiel;95;51;44;2017
05;Ávila;057;Cebreros;3100;1599;1501;2017
05;Ávila;058;Cepeda la Mora;80;44;36;2017
05;Ávila;067;Chamartín;82;48;34;2017
05;Ávila;059;Cillán;108;64;44;2017
05;Ávila;060;Cisla;110;57;53;2017
05;Ávila;061;Colilla, La;328;170;158;2017
05;Ávila;062;Collado de Contreras;181;95;86;2017
05;Ávila;063;Collado del Mirón;35;21;14;2017
05;Ávila;064;Constanzana;109;65;44;2017
05;Ávila;065;Crespos;516;281;235;2017
05;Ávila;066;Cuevas del Valle;492;269;223;2017
05;Ávila;903;Diego del Carpio;148;81;67;2017
05;Ávila;069;Donjimeno;79;46;33;2017
05;Ávila;070;Donvidas;36;19;17;2017
05;Ávila;072;Espinosa de los Caballeros;96;53;43;2017
05;Ávila;073;Flores de Ávila;321;177;144;2017
05;Ávila;074;Fontiveros;754;392;362;2017
05;Ávila;075;Fresnedilla;127;55;72;2017
05;Ávila;076;Fresno, El;597;308;289;2017
05;Ávila;077;Fuente el Saúz;170;92;78;2017
05;Ávila;078;Fuentes de Año;108;58;50;2017
05;Ávila;079;Gallegos de Altamiros;65;38;27;2017
05;Ávila;080;Gallegos de Sobrinos;48;22;26;2017
05;Ávila;081;Garganta del Villar;41;29;12;2017
05;Ávila;082;Gavilanes;598;316;282;2017
05;Ávila;083;Gemuño;161;84;77;2017
05;Ávila;085;Gil García;39;18;21;2017
05;Ávila;084;Gilbuena;70;41;29;2017
05;Ávila;086;Gimialcón;78;48;30;2017
05;Ávila;087;Gotarrendura;161;56;105;2017
05;Ávila;088;Grandes y San Martín;31;15;16;2017
05;Ávila;089;Guisando;521;258;263;2017
05;Ávila;090;Gutierre-Muñoz;77;37;40;2017
05;Ávila;092;Hernansancho;170;95;75;2017
05;Ávila;093;Herradón de Pinares;480;272;208;2017
05;Ávila;094;Herreros de Suso;134;73;61;2017
05;Ávila;095;Higuera de las Dueñas;281;153;128;2017
05;Ávila;096;Hija de Dios, La;81;48;33;2017
05;Ávila;097;Horcajada, La;500;255;245;2017
05;Ávila;099;Horcajo de las Torres;531;300;231;2017
05;Ávila;100;Hornillo, El;289;153;136;2017
05;Ávila;102;Hoyo de Pinares, El;2216;1146;1070;2017
05;Ávila;101;Hoyocasero;303;174;129;2017
05;Ávila;103;Hoyorredondo;71;37;34;2017
05;Ávila;106;Hoyos de Miguel Muñoz;31;15;16;2017
05;Ávila;104;Hoyos del Collado;36;21;15;2017
05;Ávila;105;Hoyos del Espino;380;209;171;2017
05;Ávila;107;Hurtumpascual;57;34;23;2017
05;Ávila;108;Junciana;42;22;20;2017
05;Ávila;109;Langa;495;259;236;2017
05;Ávila;110;Lanzahíta;860;443;417;2017
05;Ávila;113;Llanos de Tormes, Los;70;31;39;2017
05;Ávila;112;Losar del Barco, El;108;55;53;2017
05;Ávila;114;Madrigal de las Altas Torres;1464;746;718;2017
05;Ávila;115;Maello;600;308;292;2017
05;Ávila;116;Malpartida de Corneja;107;54;53;2017
05;Ávila;117;Mamblas;210;118;92;2017
05;Ávila;118;Mancera de Arriba;78;44;34;2017
05;Ávila;119;Manjabálago y Ortigosa de Rioalmar;28;17;11;2017
05;Ávila;120;Marlín;33;22;11;2017
05;Ávila;121;Martiherrero;307;160;147;2017
05;Ávila;122;Martínez;129;66;63;2017
05;Ávila;123;Mediana de Voltoya;103;51;52;2017
05;Ávila;124;Medinilla;102;44;58;2017
05;Ávila;125;Mengamuñoz;63;32;31;2017
05;Ávila;126;Mesegar de Corneja;64;37;27;2017
05;Ávila;127;Mijares;736;401;335;2017
05;Ávila;128;Mingorría;394;206;188;2017
05;Ávila;129;Mirón, El;127;77;50;2017
05;Ávila;130;Mironcillo;93;50;43;2017
05;Ávila;131;Mirueña de los Infanzones;98;55;43;2017
05;Ávila;132;Mombeltrán;1070;556;514;2017
05;Ávila;133;Monsalupe;71;36;35;2017
05;Ávila;134;Moraleja de Matacabras;51;31;20;2017
05;Ávila;135;Muñana;408;216;192;2017
05;Ávila;136;Muñico;107;53;54;2017
05;Ávila;138;Muñogalindo;343;175;168;2017
05;Ávila;139;Muñogrande;62;34;28;2017
05;Ávila;140;Muñomer del Peco;129;71;58;2017
05;Ávila;141;Muñopepe;106;62;44;2017
05;Ávila;142;Muñosancho;102;46;56;2017
05;Ávila;143;Muñotello;63;32;31;2017
05;Ávila;144;Narrillos del Álamo;78;42;36;2017
05;Ávila;145;Narrillos del Rebollar;53;30;23;2017
05;Ávila;149;Narros de Saldueña;107;61;46;2017
05;Ávila;147;Narros del Castillo;166;92;74;2017
05;Ávila;148;Narros del Puerto;23;11;12;2017
05;Ávila;152;Nava de Arévalo;761;402;359;2017
05;Ávila;153;Nava del Barco;97;52;45;2017
05;Ávila;151;Navacepedilla de Corneja;98;52;46;2017
05;Ávila;154;Navadijos;38;27;11;2017
05;Ávila;155;Navaescurial;55;34;21;2017
05;Ávila;156;Navahondilla;320;181;139;2017
05;Ávila;157;Navalacruz;243;127;116;2017
05;Ávila;158;Navalmoral;340;180;160;2017
05;Ávila;159;Navalonguilla;253;126;127;2017
05;Ávila;160;Navalosa;326;182;144;2017
05;Ávila;161;Navalperal de Pinares;815;418;397;2017
05;Ávila;162;Navalperal de Tormes;90;47;43;2017
05;Ávila;163;Navaluenga;1902;933;969;2017
05;Ávila;164;Navaquesera;21;9;12;2017
05;Ávila;165;Navarredonda de Gredos;455;222;233;2017
05;Ávila;166;Navarredondilla;184;99;85;2017
05;Ávila;167;Navarrevisca;285;154;131;2017
05;Ávila;168;Navas del Marqués, Las;5187;2635;2552;2017
05;Ávila;169;Navatalgordo;233;129;104;2017
05;Ávila;170;Navatejares;54;27;27;2017
05;Ávila;171;Neila de San Miguel;71;35;36;2017
05;Ávila;172;Niharra;188;103;85;2017
05;Ávila;173;Ojos-Albos;60;37;23;2017
05;Ávila;174;Orbita;76;41;35;2017
05;Ávila;175;Oso, El;174;100;74;2017
05;Ávila;176;Padiernos;269;146;123;2017
05;Ávila;177;Pajares de Adaja;170;90;80;2017
05;Ávila;178;Palacios de Goda;416;217;199;2017
05;Ávila;179;Papatrigo;236;117;119;2017
05;Ávila;180;Parral, El;75;40;35;2017
05;Ávila;181;Pascualcobo;43;27;16;2017
05;Ávila;182;Pedro Bernardo;876;463;413;2017
05;Ávila;183;Pedro-Rodríguez;148;78;70;2017
05;Ávila;184;Peguerinos;280;151;129;2017
05;Ávila;185;Peñalba de Ávila;109;59;50;2017
05;Ávila;186;Piedrahíta;1823;865;958;2017
05;Ávila;187;Piedralaves;2105;1060;1045;2017
05;Ávila;188;Poveda;47;30;17;2017
05;Ávila;189;Poyales del Hoyo;521;280;241;2017
05;Ávila;190;Pozanco;50;31;19;2017
05;Ávila;191;Pradosegar;132;69;63;2017
05;Ávila;192;Puerto Castilla;114;69;45;2017
05;Ávila;193;Rasueros;194;113;81;2017
05;Ávila;194;Riocabado;151;85;66;2017
05;Ávila;195;Riofrío;223;132;91;2017
05;Ávila;196;Rivilla de Barajas;59;26;33;2017
05;Ávila;197;Salobral;102;54;48;2017
05;Ávila;198;Salvadiós;75;37;38;2017
05;Ávila;199;San Bartolomé de Béjar;41;23;18;2017
05;Ávila;200;San Bartolomé de Corneja;48;23;25;2017
05;Ávila;201;San Bartolomé de Pinares;563;301;262;2017
05;Ávila;206;San Esteban de los Patos;33;19;14;2017
05;Ávila;208;San Esteban de Zapardiel;38;23;15;2017
05;Ávila;207;San Esteban del Valle;770;405;365;2017
05;Ávila;209;San García de Ingelmos;82;48;34;2017
05;Ávila;901;San Juan de Gredos;265;143;122;2017
05;Ávila;210;San Juan de la Encinilla;86;44;42;2017
05;Ávila;211;San Juan de la Nava;500;262;238;2017
05;Ávila;212;San Juan del Molinillo;205;117;88;2017
05;Ávila;213;San Juan del Olmo;104;63;41;2017
05;Ávila;214;San Lorenzo de Tormes;36;21;15;2017
05;Ávila;215;San Martín de la Vega del Alberche;177;103;74;2017
05;Ávila;216;San Martín del Pimpollar;183;105;78;2017
05;Ávila;217;San Miguel de Corneja;59;32;27;2017
05;Ávila;218;San Miguel de Serrezuela;123;66;57;2017
05;Ávila;219;San Pascual;42;26;16;2017
05;Ávila;220;San Pedro del Arroyo;427;224;203;2017
05;Ávila;231;San Vicente de Arévalo;179;104;75;2017
05;Ávila;204;Sanchidrián;738;379;359;2017
05;Ávila;205;Sanchorreja;81;41;40;2017
05;Ávila;222;Santa Cruz de Pinares;146;80;66;2017
05;Ávila;221;Santa Cruz del Valle;370;192;178;2017
05;Ávila;226;Santa María de los Caballeros;74;45;29;2017
05;Ávila;224;Santa María del Arroyo;112;59;53;2017
05;Ávila;225;Santa María del Berrocal;416;228;188;2017
05;Ávila;902;Santa María del Cubillo;309;181;128;2017
05;Ávila;227;Santa María del Tiétar;460;244;216;2017
05;Ávila;228;Santiago del Collado;178;109;69;2017
05;Ávila;904;Santiago del Tormes;130;73;57;2017
05;Ávila;229;Santo Domingo de las Posadas;79;42;37;2017
05;Ávila;230;Santo Tomé de Zabarcos;67;37;30;2017
05;Ávila;232;Serrada, La;117;62;55;2017
05;Ávila;233;Serranillos;247;138;109;2017
05;Ávila;234;Sigeres;43;22;21;2017
05;Ávila;235;Sinlabajos;130;70;60;2017
05;Ávila;236;Solana de Ávila;117;66;51;2017
05;Ávila;237;Solana de Rioalmar;173;98;75;2017
05;Ávila;238;Solosancho;859;460;399;2017
05;Ávila;239;Sotalbo;237;125;112;2017
05;Ávila;240;Sotillo de la Adrada;4535;2259;2276;2017
05;Ávila;241;Tiemblo, El;4143;2115;2028;2017
05;Ávila;242;Tiñosillos;802;412;390;2017
05;Ávila;243;Tolbaños;95;53;42;2017
05;Ávila;244;Tormellas;46;27;19;2017
05;Ávila;245;Tornadizos de Ávila;432;217;215;2017
05;Ávila;247;Torre, La;246;134;112;2017
05;Ávila;246;Tórtoles;62;32;30;2017
05;Ávila;249;Umbrías;105;56;49;2017
05;Ávila;251;Vadillo de la Sierra;57;35;22;2017
05;Ávila;252;Valdecasa;70;41;29;2017
05;Ávila;253;Vega de Santa María;87;43;44;2017
05;Ávila;254;Velayos;220;108;112;2017
05;Ávila;256;Villaflor;120;63;57;2017
05;Ávila;257;Villafranca de la Sierra;128;71;57;2017
05;Ávila;905;Villanueva de Ávila;224;111;113;2017
05;Ávila;258;Villanueva de Gómez;138;80;58;2017
05;Ávila;259;Villanueva del Aceral;131;65;66;2017
05;Ávila;260;Villanueva del Campillo;99;56;43;2017
05;Ávila;261;Villar de Corneja;37;22;15;2017
05;Ávila;262;Villarejo del Valle;381;204;177;2017
05;Ávila;263;Villatoro;178;100;78;2017
05;Ávila;264;Viñegra de Moraña;48;26;22;2017
05;Ávila;265;Vita;87;51;36;2017
05;Ávila;266;Zapardiel de la Cañada;98;55;43;2017
05;Ávila;267;Zapardiel de la Ribera;113;58;55;2017
06;Badajoz;001;Acedera;818;428;390;2017
06;Badajoz;002;Aceuchal;5436;2692;2744;2017
06;Badajoz;003;Ahillones;914;456;458;2017
06;Badajoz;004;Alange;1891;958;933;2017
06;Badajoz;005;Albuera, La;2024;1053;971;2017
06;Badajoz;006;Alburquerque;5371;2687;2684;2017
06;Badajoz;007;Alconchel;1717;861;856;2017
06;Badajoz;008;Alconera;738;361;377;2017
06;Badajoz;009;Aljucén;242;134;108;2017
06;Badajoz;010;Almendral;1262;616;646;2017
06;Badajoz;011;Almendralejo;33540;16629;16911;2017
06;Badajoz;012;Arroyo de San Serván;4167;2120;2047;2017
06;Badajoz;013;Atalaya;294;153;141;2017
06;Badajoz;014;Azuaga;7984;3950;4034;2017
06;Badajoz;015;Badajoz;150543;73003;77540;2017
06;Badajoz;016;Barcarrota;3608;1838;1770;2017
06;Badajoz;017;Baterno;305;161;144;2017
06;Badajoz;018;Benquerencia de la Serena;849;418;431;2017
06;Badajoz;019;Berlanga;2386;1201;1185;2017
06;Badajoz;020;Bienvenida;2149;1115;1034;2017
06;Badajoz;021;Bodonal de la Sierra;1060;549;511;2017
06;Badajoz;022;Burguillos del Cerro;3090;1528;1562;2017
06;Badajoz;023;Cabeza del Buey;5015;2481;2534;2017
06;Badajoz;024;Cabeza la Vaca;1345;685;660;2017
06;Badajoz;025;Calamonte;6260;3112;3148;2017
06;Badajoz;026;Calera de León;999;504;495;2017
06;Badajoz;027;Calzadilla de los Barros;789;391;398;2017
06;Badajoz;028;Campanario;5025;2476;2549;2017
06;Badajoz;029;Campillo de Llerena;1390;701;689;2017
06;Badajoz;030;Capilla;187;95;92;2017
06;Badajoz;031;Carmonita;562;281;281;2017
06;Badajoz;032;Carrascalejo, El;70;37;33;2017
06;Badajoz;033;Casas de Don Pedro;1527;789;738;2017
06;Badajoz;034;Casas de Reina;197;92;105;2017
06;Badajoz;035;Castilblanco;1005;513;492;2017
06;Badajoz;036;Castuera;6027;2964;3063;2017
06;Badajoz;042;Cheles;1213;585;628;2017
06;Badajoz;037;Codosera, La;2131;1131;1000;2017
06;Badajoz;038;Cordobilla de Lácara;937;478;459;2017
06;Badajoz;039;Coronada, La;2193;1075;1118;2017
06;Badajoz;040;Corte de Peleas;1267;624;643;2017
06;Badajoz;041;Cristina;567;289;278;2017
06;Badajoz;043;Don Álvaro;766;396;370;2017
06;Badajoz;044;Don Benito;36924;18245;18679;2017
06;Badajoz;045;Entrín Bajo;583;293;290;2017
06;Badajoz;046;Esparragalejo;1463;719;744;2017
06;Badajoz;047;Esparragosa de la Serena;1032;529;503;2017
06;Badajoz;048;Esparragosa de Lares;942;456;486;2017
06;Badajoz;049;Feria;1176;573;603;2017
06;Badajoz;050;Fregenal de la Sierra;4904;2415;2489;2017
06;Badajoz;051;Fuenlabrada de los Montes;1898;937;961;2017
06;Badajoz;052;Fuente de Cantos;4852;2407;2445;2017
06;Badajoz;053;Fuente del Arco;693;348;345;2017
06;Badajoz;054;Fuente del Maestre;6822;3383;3439;2017
06;Badajoz;055;Fuentes de León;2340;1150;1190;2017
06;Badajoz;056;Garbayuela;532;282;250;2017
06;Badajoz;057;Garlitos;614;318;296;2017
06;Badajoz;058;Garrovilla, La;2421;1216;1205;2017
06;Badajoz;059;Granja de Torrehermosa;2101;1046;1055;2017
06;Badajoz;903;Guadiana del Caudillo;2550;1254;1296;2017
06;Badajoz;060;Guareña;7057;3560;3497;2017
06;Badajoz;061;Haba, La;1263;629;634;2017
06;Badajoz;062;Helechosa de los Montes;665;376;289;2017
06;Badajoz;063;Herrera del Duque;3557;1778;1779;2017
06;Badajoz;064;Higuera de la Serena;948;498;450;2017
06;Badajoz;065;Higuera de Llerena;346;176;170;2017
06;Badajoz;066;Higuera de Vargas;1975;995;980;2017
06;Badajoz;067;Higuera la Real;2297;1156;1141;2017
06;Badajoz;068;Hinojosa del Valle;489;241;248;2017
06;Badajoz;069;Hornachos;3673;1848;1825;2017
06;Badajoz;070;Jerez de los Caballeros;9445;4675;4770;2017
06;Badajoz;071;Lapa, La;289;149;140;2017
06;Badajoz;073;Llera;875;454;421;2017
06;Badajoz;074;Llerena;5821;2896;2925;2017
06;Badajoz;072;Lobón;2804;1434;1370;2017
06;Badajoz;075;Magacela;535;279;256;2017
06;Badajoz;076;Maguilla;982;482;500;2017
06;Badajoz;077;Malcocinado;372;206;166;2017
06;Badajoz;078;Malpartida de la Serena;572;295;277;2017
06;Badajoz;079;Manchita;774;394;380;2017
06;Badajoz;080;Medellín;2285;1144;1141;2017
06;Badajoz;081;Medina de las Torres;1238;633;605;2017
06;Badajoz;082;Mengabril;470;253;217;2017
06;Badajoz;083;Mérida;59187;28889;30298;2017
06;Badajoz;084;Mirandilla;1308;665;643;2017
06;Badajoz;085;Monesterio;4261;2183;2078;2017
06;Badajoz;086;Montemolín;1403;679;724;2017
06;Badajoz;087;Monterrubio de la Serena;2463;1190;1273;2017
06;Badajoz;088;Montijo;15649;7741;7908;2017
06;Badajoz;089;Morera, La;725;368;357;2017
06;Badajoz;090;Nava de Santiago, La;969;493;476;2017
06;Badajoz;091;Navalvillar de Pela;4553;2309;2244;2017
06;Badajoz;092;Nogales;682;338;344;2017
06;Badajoz;093;Oliva de la Frontera;5256;2651;2605;2017
06;Badajoz;094;Oliva de Mérida;1763;903;860;2017
06;Badajoz;095;Olivenza;11977;5982;5995;2017
06;Badajoz;096;Orellana de la Sierra;239;127;112;2017
06;Badajoz;097;Orellana la Vieja;2756;1433;1323;2017
06;Badajoz;098;Palomas;705;347;358;2017
06;Badajoz;099;Parra, La;1348;689;659;2017
06;Badajoz;100;Peñalsordo;1008;482;526;2017
06;Badajoz;101;Peraleda del Zaucejo;530;267;263;2017
06;Badajoz;102;Puebla de Alcocer;1216;593;623;2017
06;Badajoz;103;Puebla de la Calzada;5914;2964;2950;2017
06;Badajoz;104;Puebla de la Reina;771;382;389;2017
06;Badajoz;107;Puebla de Obando;1860;944;916;2017
06;Badajoz;108;Puebla de Sancho Pérez;2745;1385;1360;2017
06;Badajoz;105;Puebla del Maestre;716;365;351;2017
06;Badajoz;106;Puebla del Prior;495;253;242;2017
06;Badajoz;902;Pueblonuevo del Guadiana;2024;1024;1000;2017
06;Badajoz;109;Quintana de la Serena;4702;2384;2318;2017
06;Badajoz;110;Reina;162;80;82;2017
06;Badajoz;111;Rena;624;320;304;2017
06;Badajoz;112;Retamal de Llerena;455;235;220;2017
06;Badajoz;113;Ribera del Fresno;3394;1674;1720;2017
06;Badajoz;114;Risco;150;76;74;2017
06;Badajoz;115;Roca de la Sierra, La;1503;740;763;2017
06;Badajoz;116;Salvaleón;1829;917;912;2017
06;Badajoz;117;Salvatierra de los Barros;1692;828;864;2017
06;Badajoz;119;San Pedro de Mérida;850;435;415;2017
06;Badajoz;123;San Vicente de Alcántara;5528;2782;2746;2017
06;Badajoz;118;Sancti-Spíritus;188;105;83;2017
06;Badajoz;120;Santa Amalia;4065;2061;2004;2017
06;Badajoz;121;Santa Marta;4204;2111;2093;2017
06;Badajoz;122;Santos de Maimona, Los;8137;4120;4017;2017
06;Badajoz;124;Segura de León;1944;957;987;2017
06;Badajoz;125;Siruela;1944;973;971;2017
06;Badajoz;126;Solana de los Barros;2679;1332;1347;2017
06;Badajoz;127;Talarrubias;3473;1730;1743;2017
06;Badajoz;128;Talavera la Real;5381;2701;2680;2017
06;Badajoz;129;Táliga;697;347;350;2017
06;Badajoz;130;Tamurejo;223;115;108;2017
06;Badajoz;131;Torre de Miguel Sesmero;1279;652;627;2017
06;Badajoz;132;Torremayor;998;481;517;2017
06;Badajoz;133;Torremejía;2270;1167;1103;2017
06;Badajoz;134;Trasierra;644;341;303;2017
06;Badajoz;135;Trujillanos;1409;727;682;2017
06;Badajoz;136;Usagre;1787;881;906;2017
06;Badajoz;137;Valdecaballeros;1105;571;534;2017
06;Badajoz;901;Valdelacalzada;2753;1404;1349;2017
06;Badajoz;138;Valdetorres;1204;590;614;2017
06;Badajoz;139;Valencia de las Torres;600;318;282;2017
06;Badajoz;140;Valencia del Mombuey;747;378;369;2017
06;Badajoz;141;Valencia del Ventoso;2035;1018;1017;2017
06;Badajoz;146;Valle de la Serena;1251;637;614;2017
06;Badajoz;147;Valle de Matamoros;372;183;189;2017
06;Badajoz;148;Valle de Santa Ana;1148;564;584;2017
06;Badajoz;142;Valverde de Burguillos;290;151;139;2017
06;Badajoz;143;Valverde de Leganés;4204;2116;2088;2017
06;Badajoz;144;Valverde de Llerena;621;308;313;2017
06;Badajoz;145;Valverde de Mérida;1068;540;528;2017
06;Badajoz;149;Villafranca de los Barros;13114;6479;6635;2017
06;Badajoz;150;Villagarcía de la Torre;926;481;445;2017
06;Badajoz;151;Villagonzalo;1247;604;643;2017
06;Badajoz;152;Villalba de los Barros;1538;783;755;2017
06;Badajoz;153;Villanueva de la Serena;25882;12636;13246;2017
06;Badajoz;154;Villanueva del Fresno;3411;1695;1716;2017
06;Badajoz;156;Villar de Rena;1397;724;673;2017
06;Badajoz;155;Villar del Rey;2203;1176;1027;2017
06;Badajoz;157;Villarta de los Montes;476;241;235;2017
06;Badajoz;158;Zafra;16822;8135;8687;2017
06;Badajoz;159;Zahínos;2819;1399;1420;2017
06;Badajoz;160;Zalamea de la Serena;3665;1847;1818;2017
06;Badajoz;162;Zarza, La;3485;1771;1714;2017
06;Badajoz;161;Zarza-Capilla;328;167;161;2017
07;Balears, Illes;002;Alaior;9097;4573;4524;2017
07;Balears, Illes;001;Alaró;5389;2603;2786;2017
07;Balears, Illes;003;Alcúdia;19395;9785;9610;2017
07;Balears, Illes;004;Algaida;5430;2771;2659;2017
07;Balears, Illes;005;Andratx;10930;5418;5512;2017
07;Balears, Illes;901;Ariany;854;454;400;2017
07;Balears, Illes;006;Artà;7541;3781;3760;2017
07;Balears, Illes;007;Banyalbufar;495;269;226;2017
07;Balears, Illes;008;Binissalem;8143;4043;4100;2017
07;Balears, Illes;009;Búger;1046;533;513;2017
07;Balears, Illes;010;Bunyola;6636;3251;3385;2017
07;Balears, Illes;011;Calvià;49063;24544;24519;2017
07;Balears, Illes;012;Campanet;2512;1250;1262;2017
07;Balears, Illes;013;Campos;10418;5150;5268;2017
07;Balears, Illes;014;Capdepera;11267;5729;5538;2017
07;Balears, Illes;064;Castell, Es;7343;3711;3632;2017
07;Balears, Illes;015;Ciutadella de Menorca;28838;14302;14536;2017
07;Balears, Illes;016;Consell;3962;2002;1960;2017
07;Balears, Illes;017;Costitx;1247;625;622;2017
07;Balears, Illes;018;Deià;637;303;334;2017
07;Balears, Illes;026;Eivissa;49689;25008;24681;2017
07;Balears, Illes;019;Escorca;217;125;92;2017
07;Balears, Illes;020;Esporles;4942;2443;2499;2017
07;Balears, Illes;021;Estellencs;305;161;144;2017
07;Balears, Illes;022;Felanitx;17333;8709;8624;2017
07;Balears, Illes;023;Ferreries;4633;2310;2323;2017
07;Balears, Illes;024;Formentera;12280;6429;5851;2017
07;Balears, Illes;025;Fornalutx;663;323;340;2017
07;Balears, Illes;027;Inca;31255;15729;15526;2017
07;Balears, Illes;028;Lloret de Vistalegre;1277;650;627;2017
07;Balears, Illes;029;Lloseta;5799;2930;2869;2017
07;Balears, Illes;030;Llubí;2206;1104;1102;2017
07;Balears, Illes;031;Llucmajor;35513;17982;17531;2017
07;Balears, Illes;033;Manacor;41095;20490;20605;2017
07;Balears, Illes;034;Mancor de la Vall;1449;726;723;2017
07;Balears, Illes;032;Maó-Mahón;28161;13795;14366;2017
07;Balears, Illes;035;Maria de la Salut;2159;1109;1050;2017
07;Balears, Illes;036;Marratxí;36383;18294;18089;2017
07;Balears, Illes;037;Mercadal, Es;4788;2424;2364;2017
07;Balears, Illes;902;Migjorn Gran, Es;1356;679;677;2017
07;Balears, Illes;038;Montuïri;2836;1433;1403;2017
07;Balears, Illes;039;Muro;6829;3429;3400;2017
07;Balears, Illes;040;Palma de Mallorca;406492;197833;208659;2017
07;Balears, Illes;041;Petra;2794;1390;1404;2017
07;Balears, Illes;044;Pobla, Sa;12793;6516;6277;2017
07;Balears, Illes;042;Pollença;16157;8055;8102;2017
07;Balears, Illes;043;Porreres;5256;2693;2563;2017
07;Balears, Illes;045;Puigpunyent;1997;997;1000;2017
07;Balears, Illes;059;Salines, Ses;4860;2451;2409;2017
07;Balears, Illes;046;Sant Antoni de Portmany;25290;13260;12030;2017
07;Balears, Illes;049;Sant Joan;2064;1018;1046;2017
07;Balears, Illes;050;Sant Joan de Labritja;6139;3129;3010;2017
07;Balears, Illes;048;Sant Josep de sa Talaia;26133;13507;12626;2017
07;Balears, Illes;051;Sant Llorenç des Cardassar;8328;4116;4212;2017
07;Balears, Illes;052;Sant Lluís;6954;3506;3448;2017
07;Balears, Illes;053;Santa Eugènia;1653;831;822;2017
07;Balears, Illes;054;Santa Eulària des Riu;36605;18615;17990;2017
07;Balears, Illes;055;Santa Margalida;11801;6007;5794;2017
07;Balears, Illes;056;Santa María del Camí;7062;3500;3562;2017
07;Balears, Illes;057;Santanyí;11348;5666;5682;2017
07;Balears, Illes;058;Selva;3869;1940;1929;2017
07;Balears, Illes;047;Sencelles;3154;1580;1574;2017
07;Balears, Illes;060;Sineu;3641;1794;1847;2017
07;Balears, Illes;061;Sóller;13936;7009;6927;2017
07;Balears, Illes;062;Son Servera;11265;5631;5634;2017
07;Balears, Illes;063;Valldemossa;1950;986;964;2017
07;Balears, Illes;065;Vilafranca de Bonany;3047;1516;1531;2017
08;Barcelona;001;Abrera;12363;6283;6080;2017
08;Barcelona;002;Aguilar de Segarra;263;142;121;2017
08;Barcelona;014;Aiguafreda;2514;1204;1310;2017
08;Barcelona;003;Alella;9625;4704;4921;2017
08;Barcelona;004;Alpens;277;144;133;2017
08;Barcelona;005;Ametlla del Vallès, L';8368;4228;4140;2017
08;Barcelona;006;Arenys de Mar;15368;7457;7911;2017
08;Barcelona;007;Arenys de Munt;8728;4380;4348;2017
08;Barcelona;008;Argençola;220;113;107;2017
08;Barcelona;009;Argentona;12133;5947;6186;2017
08;Barcelona;010;Artés;5585;2822;2763;2017
08;Barcelona;011;Avià;2249;1112;1137;2017
08;Barcelona;012;Avinyó;2240;1119;1121;2017
08;Barcelona;013;Avinyonet del Penedès;1653;873;780;2017
08;Barcelona;015;Badalona;215848;106216;109632;2017
08;Barcelona;904;Badia del Vallès;13466;6586;6880;2017
08;Barcelona;016;Bagà;2149;1061;1088;2017
08;Barcelona;017;Balenyà;3665;1844;1821;2017
08;Barcelona;018;Balsareny;3240;1618;1622;2017
08;Barcelona;252;Barberà del Vallès;32860;16211;16649;2017
08;Barcelona;019;Barcelona;1620809;766625;854184;2017
08;Barcelona;020;Begues;6830;3375;3455;2017
08;Barcelona;021;Bellprat;74;46;28;2017
08;Barcelona;022;Berga;16115;7945;8170;2017
08;Barcelona;023;Bigues i Riells;8957;4569;4388;2017
08;Barcelona;024;Borredà;480;267;213;2017
08;Barcelona;025;Bruc, El;1988;1073;915;2017
08;Barcelona;026;Brull, El;258;139;119;2017
08;Barcelona;027;Cabanyes, Les;947;484;463;2017
08;Barcelona;028;Cabrera d'Anoia;1364;724;640;2017
08;Barcelona;029;Cabrera de Mar;4594;2325;2269;2017
08;Barcelona;030;Cabrils;7296;3602;3694;2017
08;Barcelona;031;Calaf;3477;1776;1701;2017
08;Barcelona;034;Calders;962;497;465;2017
08;Barcelona;033;Caldes de Montbui;17187;8524;8663;2017
08;Barcelona;032;Caldes d'Estrac;2823;1356;1467;2017
08;Barcelona;035;Calella;18481;9015;9466;2017
08;Barcelona;037;Calldetenes;2446;1238;1208;2017
08;Barcelona;038;Callús;2067;1008;1059;2017
08;Barcelona;036;Calonge de Segarra;198;100;98;2017
08;Barcelona;039;Campins;498;260;238;2017
08;Barcelona;040;Canet de Mar;14423;7008;7415;2017
08;Barcelona;041;Canovelles;16145;8326;7819;2017
08;Barcelona;042;Cànoves i Samalús;2906;1472;1434;2017
08;Barcelona;043;Canyelles;4388;2251;2137;2017
08;Barcelona;044;Capellades;5225;2582;2643;2017
08;Barcelona;045;Capolat;99;47;52;2017
08;Barcelona;046;Cardedeu;18210;8951;9259;2017
08;Barcelona;047;Cardona;4728;2316;2412;2017
08;Barcelona;048;Carme;791;407;384;2017
08;Barcelona;049;Casserres;1557;767;790;2017
08;Barcelona;057;Castell de l'Areny;69;40;29;2017
08;Barcelona;052;Castellar de n'Hug;159;86;73;2017
08;Barcelona;050;Castellar del Riu;166;96;70;2017
08;Barcelona;051;Castellar del Vallès;23776;11702;12074;2017
08;Barcelona;053;Castellbell i el Vilar;3618;1856;1762;2017
08;Barcelona;054;Castellbisbal;12297;6220;6077;2017
08;Barcelona;055;Castellcir;723;373;350;2017
08;Barcelona;056;Castelldefels;65954;32562;33392;2017
08;Barcelona;058;Castellet i la Gornal;2233;1132;1101;2017
08;Barcelona;060;Castellfollit de Riubregós;160;91;69;2017
08;Barcelona;059;Castellfollit del Boix;440;225;215;2017
08;Barcelona;061;Castellgalí;2017;1056;961;2017
08;Barcelona;062;Castellnou de Bages;1303;658;645;2017
08;Barcelona;063;Castellolí;599;289;310;2017
08;Barcelona;064;Castellterçol;2374;1182;1192;2017
08;Barcelona;065;Castellví de la Marca;1554;772;782;2017
08;Barcelona;066;Castellví de Rosanes;1826;898;928;2017
08;Barcelona;067;Centelles;7417;3632;3785;2017
08;Barcelona;268;Cercs;1166;573;593;2017
08;Barcelona;266;Cerdanyola del Vallès;57723;28289;29434;2017
08;Barcelona;068;Cervelló;8909;4443;4466;2017
08;Barcelona;069;Collbató;4394;2274;2120;2017
08;Barcelona;070;Collsuspina;338;177;161;2017
08;Barcelona;071;Copons;316;158;158;2017
08;Barcelona;072;Corbera de Llobregat;14439;7220;7219;2017
08;Barcelona;073;Cornellà de Llobregat;86610;42023;44587;2017
08;Barcelona;074;Cubelles;14715;7428;7287;2017
08;Barcelona;075;Dosrius;5198;2622;2576;2017
08;Barcelona;076;Esparreguera;21889;11088;10801;2017
08;Barcelona;077;Esplugues de Llobregat;45890;21967;23923;2017
08;Barcelona;078;Espunyola, L';240;123;117;2017
08;Barcelona;254;Esquirol, L';2161;1098;1063;2017
08;Barcelona;079;Estany, L';405;201;204;2017
08;Barcelona;134;Figaró-Montmany;1077;533;544;2017
08;Barcelona;080;Fígols;42;24;18;2017
08;Barcelona;082;Fogars de la Selva;1448;747;701;2017
08;Barcelona;081;Fogars de Montclús;458;245;213;2017
08;Barcelona;083;Folgueroles;2298;1164;1134;2017
08;Barcelona;084;Fonollosa;1412;736;676;2017
08;Barcelona;085;Font-rubí;1358;696;662;2017
08;Barcelona;086;Franqueses del Vallès, Les;19584;9961;9623;2017
08;Barcelona;090;Gaià;162;89;73;2017
08;Barcelona;087;Gallifa;180;97;83;2017
08;Barcelona;088;Garriga, La;15984;7752;8232;2017
08;Barcelona;089;Gavà;46538;22830;23708;2017
08;Barcelona;091;Gelida;7299;3692;3607;2017
08;Barcelona;092;Gironella;4808;2357;2451;2017
08;Barcelona;093;Gisclareny;27;15;12;2017
08;Barcelona;094;Granada, La;2112;1076;1036;2017
08;Barcelona;095;Granera;78;55;23;2017
08;Barcelona;096;Granollers;60695;29897;30798;2017
08;Barcelona;097;Gualba;1423;718;705;2017
08;Barcelona;099;Guardiola de Berguedà;904;476;428;2017
08;Barcelona;100;Gurb;2616;1338;1278;2017
08;Barcelona;101;Hospitalet de Llobregat, L';257349;124443;132906;2017
08;Barcelona;162;Hostalets de Pierola, Els;2901;1494;1407;2017
08;Barcelona;102;Igualada;39316;19255;20061;2017
08;Barcelona;103;Jorba;823;413;410;2017
08;Barcelona;104;Llacuna, La;863;469;394;2017
08;Barcelona;105;Llagosta, La;13343;6586;6757;2017
08;Barcelona;107;Lliçà d'Amunt;14933;7623;7310;2017
08;Barcelona;108;Lliçà de Vall;6386;3248;3138;2017
08;Barcelona;106;Llinars del Vallès;9749;4856;4893;2017
08;Barcelona;109;Lluçà;279;137;142;2017
08;Barcelona;110;Malgrat de Mar;18345;9181;9164;2017
08;Barcelona;111;Malla;264;136;128;2017
08;Barcelona;112;Manlleu;20007;9984;10023;2017
08;Barcelona;113;Manresa;75152;36748;38404;2017
08;Barcelona;242;Marganell;254;124;130;2017
08;Barcelona;114;Martorell;27681;14100;13581;2017
08;Barcelona;115;Martorelles;4742;2384;2358;2017
08;Barcelona;116;Masies de Roda, Les;714;355;359;2017
08;Barcelona;117;Masies de Voltregà, Les;3140;1550;1590;2017
08;Barcelona;118;Masnou, El;23288;11209;12079;2017
08;Barcelona;119;Masquefa;8514;4271;4243;2017
08;Barcelona;120;Matadepera;9186;4599;4587;2017
08;Barcelona;121;Mataró;126127;62517;63610;2017
08;Barcelona;122;Mediona;2251;1131;1120;2017
08;Barcelona;138;Moià;6065;3085;2980;2017
08;Barcelona;123;Molins de Rei;25492;12407;13085;2017
08;Barcelona;124;Mollet del Vallès;51128;25210;25918;2017
08;Barcelona;128;Monistrol de Calders;677;356;321;2017
08;Barcelona;127;Monistrol de Montserrat;2935;1489;1446;2017
08;Barcelona;125;Montcada i Reixac;35063;17261;17802;2017
08;Barcelona;130;Montclar;121;61;60;2017
08;Barcelona;131;Montesquiu;960;481;479;2017
08;Barcelona;126;Montgat;11748;5788;5960;2017
08;Barcelona;132;Montmajor;459;235;224;2017
08;Barcelona;133;Montmaneu;153;85;68;2017
08;Barcelona;135;Montmeló;8748;4271;4477;2017
08;Barcelona;136;Montornès del Vallès;16240;8206;8034;2017
08;Barcelona;137;Montseny;343;174;169;2017
08;Barcelona;129;Muntanyola;613;316;297;2017
08;Barcelona;139;Mura;227;124;103;2017
08;Barcelona;140;Navarcles;5950;2895;3055;2017
08;Barcelona;141;Navàs;6020;2997;3023;2017
08;Barcelona;142;Nou de Berguedà, La;157;80;77;2017
08;Barcelona;143;Òdena;3614;1855;1759;2017
08;Barcelona;145;Olèrdola;3565;1823;1742;2017
08;Barcelona;146;Olesa de Bonesvalls;1734;915;819;2017
08;Barcelona;147;Olesa de Montserrat;23552;11734;11818;2017
08;Barcelona;148;Olivella;3655;1929;1726;2017
08;Barcelona;149;Olost;1197;602;595;2017
08;Barcelona;144;Olvan;844;410;434;2017
08;Barcelona;150;Orís;316;160;156;2017
08;Barcelona;151;Oristà;547;267;280;2017
08;Barcelona;152;Orpí;134;74;60;2017
08;Barcelona;153;Òrrius;694;359;335;2017
08;Barcelona;154;Pacs del Penedès;902;455;447;2017
08;Barcelona;155;Palafolls;9171;4629;4542;2017
08;Barcelona;156;Palau-solità i Plegamans;14626;7170;7456;2017
08;Barcelona;157;Pallejà;11416;5690;5726;2017
08;Barcelona;905;Palma de Cervelló, La;2998;1475;1523;2017
08;Barcelona;158;Papiol, El;4102;2029;2073;2017
08;Barcelona;159;Parets del Vallès;18970;9532;9438;2017
08;Barcelona;160;Perafita;411;210;201;2017
08;Barcelona;161;Piera;15194;7743;7451;2017
08;Barcelona;163;Pineda de Mar;26349;13147;13202;2017
08;Barcelona;164;Pla del Penedès, El;1232;612;620;2017
08;Barcelona;165;Pobla de Claramunt, La;2190;1109;1081;2017
08;Barcelona;166;Pobla de Lillet, La;1097;537;560;2017
08;Barcelona;167;Polinyà;8383;4232;4151;2017
08;Barcelona;182;Pont de Vilomara i Rocafort, El;3794;1954;1840;2017
08;Barcelona;168;Pontons;456;253;203;2017
08;Barcelona;169;Prat de Llobregat, El;63897;31364;32533;2017
08;Barcelona;171;Prats de Lluçanès;2533;1265;1268;2017
08;Barcelona;170;Prats de Rei, Els;535;285;250;2017
08;Barcelona;230;Premià de Dalt;10345;5188;5157;2017
08;Barcelona;172;Premià de Mar;28049;13698;14351;2017
08;Barcelona;174;Puigdàlber;506;253;253;2017
08;Barcelona;175;Puig-reig;4086;1996;2090;2017
08;Barcelona;176;Pujalt;203;110;93;2017
08;Barcelona;177;Quar, La;57;30;27;2017
08;Barcelona;178;Rajadell;536;271;265;2017
08;Barcelona;179;Rellinars;735;379;356;2017
08;Barcelona;180;Ripollet;37899;18776;19123;2017
08;Barcelona;181;Roca del Vallès, La;10536;5275;5261;2017
08;Barcelona;183;Roda de Ter;6125;2998;3127;2017
08;Barcelona;184;Rubí;75568;37444;38124;2017
08;Barcelona;185;Rubió;230;124;106;2017
08;Barcelona;901;Rupit i Pruit;281;143;138;2017
08;Barcelona;187;Sabadell;209931;102153;107778;2017
08;Barcelona;188;Sagàs;155;84;71;2017
08;Barcelona;190;Saldes;275;157;118;2017
08;Barcelona;191;Sallent;6594;3173;3421;2017
08;Barcelona;194;Sant Adrià de Besòs;36624;18041;18583;2017
08;Barcelona;195;Sant Agustí de Lluçanès;86;44;42;2017
08;Barcelona;196;Sant Andreu de la Barca;27303;13568;13735;2017
08;Barcelona;197;Sant Andreu de Llavaneres;10758;5326;5432;2017
08;Barcelona;198;Sant Antoni de Vilamajor;6005;2990;3015;2017
08;Barcelona;199;Sant Bartomeu del Grau;858;452;406;2017
08;Barcelona;200;Sant Boi de Llobregat;82142;40246;41896;2017
08;Barcelona;201;Sant Boi de Lluçanès;515;258;257;2017
08;Barcelona;203;Sant Cebrià de Vallalta;3310;1728;1582;2017
08;Barcelona;202;Sant Celoni;17588;8784;8804;2017
08;Barcelona;204;Sant Climent de Llobregat;4038;2038;2000;2017
08;Barcelona;205;Sant Cugat del Vallès;89516;43515;46001;2017
08;Barcelona;206;Sant Cugat Sesgarrigues;980;475;505;2017
08;Barcelona;207;Sant Esteve de Palautordera;2648;1309;1339;2017
08;Barcelona;208;Sant Esteve Sesrovires;7670;3838;3832;2017
08;Barcelona;210;Sant Feliu de Codines;6045;3063;2982;2017
08;Barcelona;211;Sant Feliu de Llobregat;44198;21424;22774;2017
08;Barcelona;212;Sant Feliu Sasserra;606;321;285;2017
08;Barcelona;209;Sant Fost de Campsentelles;8664;4299;4365;2017
08;Barcelona;213;Sant Fruitós de Bages;8512;4199;4313;2017
08;Barcelona;215;Sant Hipòlit de Voltregà;3453;1699;1754;2017
08;Barcelona;193;Sant Iscle de Vallalta;1295;663;632;2017
08;Barcelona;216;Sant Jaume de Frontanyà;30;19;11;2017
08;Barcelona;218;Sant Joan de Vilatorrada;10802;5402;5400;2017
08;Barcelona;217;Sant Joan Despí;33873;16500;17373;2017
08;Barcelona;903;Sant Julià de Cerdanyola;242;133;109;2017
08;Barcelona;220;Sant Julià de Vilatorta;3101;1528;1573;2017
08;Barcelona;221;Sant Just Desvern;17201;8235;8966;2017
08;Barcelona;222;Sant Llorenç d'Hortons;2547;1292;1255;2017
08;Barcelona;223;Sant Llorenç Savall;2361;1195;1166;2017
08;Barcelona;225;Sant Martí d'Albars;110;55;55;2017
08;Barcelona;224;Sant Martí de Centelles;1125;581;544;2017
08;Barcelona;226;Sant Martí de Tous;1196;610;586;2017
08;Barcelona;227;Sant Martí Sarroca;3197;1571;1626;2017
08;Barcelona;228;Sant Martí Sesgueioles;354;183;171;2017
08;Barcelona;229;Sant Mateu de Bages;611;308;303;2017
08;Barcelona;231;Sant Pere de Ribes;30142;15095;15047;2017
08;Barcelona;232;Sant Pere de Riudebitlles;2343;1170;1173;2017
08;Barcelona;233;Sant Pere de Torelló;2437;1263;1174;2017
08;Barcelona;234;Sant Pere de Vilamajor;4313;2150;2163;2017
08;Barcelona;189;Sant Pere Sallavinera;156;86;70;2017
08;Barcelona;235;Sant Pol de Mar;5062;2503;2559;2017
08;Barcelona;236;Sant Quintí de Mediona;2170;1109;1061;2017
08;Barcelona;237;Sant Quirze de Besora;2092;1031;1061;2017
08;Barcelona;238;Sant Quirze del Vallès;19867;9715;10152;2017
08;Barcelona;239;Sant Quirze Safaja;627;330;297;2017
08;Barcelona;240;Sant Sadurní d'Anoia;12749;6276;6473;2017
08;Barcelona;241;Sant Sadurní d'Osormort;79;48;31;2017
08;Barcelona;098;Sant Salvador de Guardiola;3127;1584;1543;2017
08;Barcelona;262;Sant Vicenç de Castellet;9300;4617;4683;2017
08;Barcelona;264;Sant Vicenç de Montalt;6272;3136;3136;2017
08;Barcelona;265;Sant Vicenç de Torelló;1998;985;1013;2017
08;Barcelona;263;Sant Vicenç dels Horts;27982;13932;14050;2017
08;Barcelona;243;Santa Cecília de Voltregà;189;97;92;2017
08;Barcelona;244;Santa Coloma de Cervelló;8082;3965;4117;2017
08;Barcelona;245;Santa Coloma de Gramenet;117597;58452;59145;2017
08;Barcelona;246;Santa Eugènia de Berga;2259;1156;1103;2017
08;Barcelona;247;Santa Eulàlia de Riuprimer;1289;652;637;2017
08;Barcelona;248;Santa Eulàlia de Ronçana;7124;3578;3546;2017
08;Barcelona;249;Santa Fe del Penedès;380;196;184;2017
08;Barcelona;250;Santa Margarida de Montbui;9748;4875;4873;2017
08;Barcelona;251;Santa Margarida i els Monjos;7480;3801;3679;2017
08;Barcelona;253;Santa Maria de Besora;147;75;72;2017
08;Barcelona;256;Santa Maria de Martorelles;858;436;422;2017
08;Barcelona;255;Santa Maria de Merlès;190;91;99;2017
08;Barcelona;257;Santa Maria de Miralles;123;65;58;2017
08;Barcelona;259;Santa Maria de Palautordera;9286;4662;4624;2017
08;Barcelona;258;Santa Maria d'Oló;1030;521;509;2017
08;Barcelona;260;Santa Perpètua de Mogoda;25574;12900;12674;2017
08;Barcelona;261;Santa Susanna;3352;1690;1662;2017
08;Barcelona;192;Santpedor;7496;3709;3787;2017
08;Barcelona;267;Sentmenat;8818;4455;4363;2017
08;Barcelona;269;Seva;3451;1726;1725;2017
08;Barcelona;270;Sitges;28527;14279;14248;2017
08;Barcelona;271;Sobremunt;84;36;48;2017
08;Barcelona;272;Sora;193;112;81;2017
08;Barcelona;273;Subirats;3013;1550;1463;2017
08;Barcelona;274;Súria;5911;2882;3029;2017
08;Barcelona;276;Tagamanent;326;172;154;2017
08;Barcelona;277;Talamanca;193;110;83;2017
08;Barcelona;278;Taradell;6344;3159;3185;2017
08;Barcelona;275;Tavèrnoles;317;159;158;2017
08;Barcelona;280;Tavertet;116;62;54;2017
08;Barcelona;281;Teià;6333;3117;3216;2017
08;Barcelona;279;Terrassa;216428;106557;109871;2017
08;Barcelona;282;Tiana;8645;4136;4509;2017
08;Barcelona;283;Tona;8114;4008;4106;2017
08;Barcelona;284;Tordera;16637;8427;8210;2017
08;Barcelona;285;Torelló;13995;6914;7081;2017
08;Barcelona;286;Torre de Claramunt, La;3707;1900;1807;2017
08;Barcelona;287;Torrelavit;1400;726;674;2017
08;Barcelona;288;Torrelles de Foix;2243;1202;1041;2017
08;Barcelona;289;Torrelles de Llobregat;5950;2934;3016;2017
08;Barcelona;290;Ullastrell;2054;1042;1012;2017
08;Barcelona;291;Vacarisses;6328;3239;3089;2017
08;Barcelona;292;Vallbona d'Anoia;1412;738;674;2017
08;Barcelona;293;Vallcebre;251;142;109;2017
08;Barcelona;294;Vallgorguina;2789;1414;1375;2017
08;Barcelona;295;Vallirana;14784;7408;7376;2017
08;Barcelona;296;Vallromanes;2514;1280;1234;2017
08;Barcelona;297;Veciana;167;94;73;2017
08;Barcelona;298;Vic;43964;21933;22031;2017
08;Barcelona;299;Vilada;424;222;202;2017
08;Barcelona;301;Viladecans;65993;32731;33262;2017
08;Barcelona;300;Viladecavalls;7392;3660;3732;2017
08;Barcelona;305;Vilafranca del Penedès;39532;19333;20199;2017
08;Barcelona;306;Vilalba Sasserra;690;347;343;2017
08;Barcelona;303;Vilanova de Sau;313;153;160;2017
08;Barcelona;302;Vilanova del Camí;12332;6173;6159;2017
08;Barcelona;902;Vilanova del Vallès;5285;2664;2621;2017
08;Barcelona;307;Vilanova i la Geltrú;66077;31979;34098;2017
08;Barcelona;214;Vilassar de Dalt;8961;4412;4549;2017
08;Barcelona;219;Vilassar de Mar;20636;9932;10704;2017
08;Barcelona;304;Vilobí del Penedès;1094;575;519;2017
08;Barcelona;308;Viver i Serrateix;173;88;85;2017
48;Bizkaia;001;Abadiño;7522;3748;3774;2017
48;Bizkaia;002;Abanto y Ciérvana-Abanto Zierbena;9543;4702;4841;2017
48;Bizkaia;911;Ajangiz;474;250;224;2017
48;Bizkaia;912;Alonsotegi;2900;1424;1476;2017
48;Bizkaia;003;Amorebieta-Etxano;18955;9319;9636;2017
48;Bizkaia;004;Amoroto;425;220;205;2017
48;Bizkaia;005;Arakaldo;159;76;83;2017
48;Bizkaia;006;Arantzazu;411;203;208;2017
48;Bizkaia;093;Areatza;1196;569;627;2017
48;Bizkaia;009;Arrankudiaga;960;469;491;2017
48;Bizkaia;914;Arratzu;402;193;209;2017
48;Bizkaia;010;Arrieta;564;290;274;2017
48;Bizkaia;011;Arrigorriaga;12265;5989;6276;2017
48;Bizkaia;023;Artea;749;368;381;2017
48;Bizkaia;008;Artzentales;741;399;342;2017
48;Bizkaia;091;Atxondo;1370;691;679;2017
48;Bizkaia;070;Aulesti;658;325;333;2017
48;Bizkaia;012;Bakio;2640;1337;1303;2017
48;Bizkaia;090;Balmaseda;7739;3772;3967;2017
48;Bizkaia;013;Barakaldo;100313;48520;51793;2017
48;Bizkaia;014;Barrika;1525;742;783;2017
48;Bizkaia;015;Basauri;40877;19828;21049;2017
48;Bizkaia;092;Bedia;1039;497;542;2017
48;Bizkaia;016;Berango;7065;3455;3610;2017
48;Bizkaia;017;Bermeo;16777;8265;8512;2017
48;Bizkaia;018;Berriatua;1241;671;570;2017
48;Bizkaia;019;Berriz;4695;2342;2353;2017
48;Bizkaia;020;Bilbao;345110;162571;182539;2017
48;Bizkaia;021;Busturia;1676;843;833;2017
48;Bizkaia;901;Derio;6404;3153;3251;2017
48;Bizkaia;026;Dima;1460;746;714;2017
48;Bizkaia;027;Durango;29328;14353;14975;2017
48;Bizkaia;028;Ea;836;424;412;2017
48;Bizkaia;031;Elantxobe;363;177;186;2017
48;Bizkaia;032;Elorrio;7307;3627;3680;2017
48;Bizkaia;902;Erandio;24056;11727;12329;2017
48;Bizkaia;033;Ereño;248;139;109;2017
48;Bizkaia;034;Ermua;15951;7956;7995;2017
48;Bizkaia;079;Errigoiti;502;279;223;2017
48;Bizkaia;029;Etxebarri;11176;5585;5591;2017
48;Bizkaia;030;Etxebarria;748;376;372;2017
48;Bizkaia;906;Forua;938;465;473;2017
48;Bizkaia;035;Fruiz;546;275;271;2017
48;Bizkaia;036;Galdakao;29334;14457;14877;2017
48;Bizkaia;037;Galdames;812;433;379;2017
48;Bizkaia;038;Gamiz-Fika;1361;677;684;2017
48;Bizkaia;039;Garai;308;152;156;2017
48;Bizkaia;040;Gatika;1672;831;841;2017
48;Bizkaia;041;Gautegiz Arteaga;847;427;420;2017
48;Bizkaia;046;Gernika-Lumo;16915;8123;8792;2017
48;Bizkaia;044;Getxo;78406;36767;41639;2017
48;Bizkaia;047;Gizaburuaga;209;111;98;2017
48;Bizkaia;042;Gordexola;1674;853;821;2017
48;Bizkaia;043;Gorliz;5680;2805;2875;2017
48;Bizkaia;045;Güeñes;6686;3250;3436;2017
48;Bizkaia;048;Ibarrangelu;651;331;320;2017
48;Bizkaia;094;Igorre;4251;2078;2173;2017
48;Bizkaia;049;Ispaster;706;372;334;2017
48;Bizkaia;910;Iurreta;3658;1820;1838;2017
48;Bizkaia;050;Izurtza;231;133;98;2017
48;Bizkaia;022;Karrantza Harana/Valle de Carranza;2717;1413;1304;2017
48;Bizkaia;907;Kortezubi;445;220;225;2017
48;Bizkaia;051;Lanestosa;268;137;131;2017
48;Bizkaia;052;Larrabetzu;2035;984;1051;2017
48;Bizkaia;053;Laukiz;1190;595;595;2017
48;Bizkaia;054;Leioa;31197;15205;15992;2017
48;Bizkaia;057;Lekeitio;7228;3581;3647;2017
48;Bizkaia;055;Lemoa;3534;1771;1763;2017
48;Bizkaia;056;Lemoiz;1243;657;586;2017
48;Bizkaia;081;Lezama;2390;1196;1194;2017
48;Bizkaia;903;Loiu;2361;1185;1176;2017
48;Bizkaia;058;Mallabia;1168;588;580;2017
48;Bizkaia;059;Mañaria;525;272;253;2017
48;Bizkaia;060;Markina-Xemein;4999;2569;2430;2017
48;Bizkaia;061;Maruri-Jatabe;967;493;474;2017
48;Bizkaia;062;Mendata;395;197;198;2017
48;Bizkaia;063;Mendexa;451;229;222;2017
48;Bizkaia;064;Meñaka;750;392;358;2017
48;Bizkaia;066;Morga;426;221;205;2017
48;Bizkaia;068;Mundaka;1861;890;971;2017
48;Bizkaia;069;Mungia;17384;8465;8919;2017
48;Bizkaia;007;Munitibar-Arbatzegi Gerrikaitz;466;248;218;2017
48;Bizkaia;908;Murueta;311;162;149;2017
48;Bizkaia;071;Muskiz;7579;3747;3832;2017
48;Bizkaia;067;Muxika;1407;722;685;2017
48;Bizkaia;909;Nabarniz;260;130;130;2017
48;Bizkaia;073;Ondarroa;8477;4264;4213;2017
48;Bizkaia;075;Orozko;2673;1312;1361;2017
48;Bizkaia;083;Ortuella;8376;4105;4271;2017
48;Bizkaia;072;Otxandio;1295;656;639;2017
48;Bizkaia;077;Plentzia;4387;2134;2253;2017
48;Bizkaia;078;Portugalete;46120;22062;24058;2017
48;Bizkaia;082;Santurtzi;45765;22081;23684;2017
48;Bizkaia;084;Sestao;27744;13442;14302;2017
48;Bizkaia;904;Sondika;4471;2159;2312;2017
48;Bizkaia;085;Sopela;13510;6655;6855;2017
48;Bizkaia;086;Sopuerta;2596;1294;1302;2017
48;Bizkaia;076;Sukarrieta;367;193;174;2017
48;Bizkaia;087;Trucios-Turtzioz;510;273;237;2017
48;Bizkaia;088;Ubide;175;88;87;2017
48;Bizkaia;065;Ugao-Miraballes;4133;2082;2051;2017
48;Bizkaia;089;Urduliz;4248;2108;2140;2017
48;Bizkaia;074;Urduña/Orduña;4134;2107;2027;2017
48;Bizkaia;080;Valle de Trápaga-Trapagaran;11953;5808;6145;2017
48;Bizkaia;095;Zaldibar;3077;1545;1532;2017
48;Bizkaia;096;Zalla;8421;4133;4288;2017
48;Bizkaia;905;Zamudio;3217;1566;1651;2017
48;Bizkaia;097;Zaratamo;1609;791;818;2017
48;Bizkaia;024;Zeanuri;1241;627;614;2017
48;Bizkaia;025;Zeberio;1074;548;526;2017
48;Bizkaia;913;Zierbena;1497;782;715;2017
48;Bizkaia;915;Ziortza-Bolibar;420;225;195;2017
09;Burgos;001;Abajas;27;19;8;2017
09;Burgos;003;Adrada de Haza;221;111;110;2017
09;Burgos;006;Aguas Cándidas;56;34;22;2017
09;Burgos;007;Aguilar de Bureba;60;35;25;2017
09;Burgos;009;Albillos;215;112;103;2017
09;Burgos;010;Alcocero de Mola;34;26;8;2017
09;Burgos;011;Alfoz de Bricia;77;46;31;2017
09;Burgos;907;Alfoz de Quintanadueñas;2006;1083;923;2017
09;Burgos;012;Alfoz de Santa Gadea;100;58;42;2017
09;Burgos;013;Altable;53;29;24;2017
09;Burgos;014;Altos, Los;189;111;78;2017
09;Burgos;016;Ameyugo;101;57;44;2017
09;Burgos;017;Anguix;134;74;60;2017
09;Burgos;018;Aranda de Duero;32535;15833;16702;2017
09;Burgos;019;Arandilla;164;99;65;2017
09;Burgos;020;Arauzo de Miel;328;175;153;2017
09;Burgos;021;Arauzo de Salce;59;36;23;2017
09;Burgos;022;Arauzo de Torre;73;43;30;2017
09;Burgos;023;Arcos;1626;874;752;2017
09;Burgos;024;Arenillas de Riopisuerga;178;105;73;2017
09;Burgos;025;Arija;136;71;65;2017
09;Burgos;026;Arlanzón;414;253;161;2017
09;Burgos;027;Arraya de Oca;42;26;16;2017
09;Burgos;029;Atapuerca;181;101;80;2017
09;Burgos;030;Ausines, Los;132;77;55;2017
09;Burgos;032;Avellanosa de Muñó;114;61;53;2017
09;Burgos;033;Bahabón de Esgueva;78;50;28;2017
09;Burgos;034;Balbases, Los;306;172;134;2017
09;Burgos;035;Baños de Valdearados;350;208;142;2017
09;Burgos;036;Bañuelos de Bureba;35;20;15;2017
09;Burgos;037;Barbadillo de Herreros;110;65;45;2017
09;Burgos;038;Barbadillo del Mercado;129;71;58;2017
09;Burgos;039;Barbadillo del Pez;68;42;26;2017
09;Burgos;041;Barrio de Muñó;33;18;15;2017
09;Burgos;043;Barrios de Bureba, Los;202;118;84;2017
09;Burgos;044;Barrios de Colina;51;26;25;2017
09;Burgos;045;Basconcillos del Tozo;295;165;130;2017
09;Burgos;046;Bascuñana;27;18;9;2017
09;Burgos;047;Belbimbre;64;32;32;2017
09;Burgos;048;Belorado;1852;942;910;2017
09;Burgos;050;Berberana;64;32;32;2017
09;Burgos;051;Berlangas de Roa;180;96;84;2017
09;Burgos;052;Berzosa de Bureba;30;21;9;2017
09;Burgos;054;Bozoó;109;63;46;2017
09;Burgos;055;Brazacorta;60;34;26;2017
09;Burgos;056;Briviesca;6860;3421;3439;2017
09;Burgos;057;Bugedo;173;115;58;2017
09;Burgos;058;Buniel;529;292;237;2017
09;Burgos;059;Burgos;175623;83579;92044;2017
09;Burgos;060;Busto de Bureba;154;84;70;2017
09;Burgos;061;Cabañes de Esgueva;173;97;76;2017
09;Burgos;062;Cabezón de la Sierra;59;29;30;2017
09;Burgos;064;Caleruega;441;227;214;2017
09;Burgos;065;Campillo de Aranda;167;99;68;2017
09;Burgos;066;Campolara;67;46;21;2017
09;Burgos;067;Canicosa de la Sierra;478;253;225;2017
09;Burgos;068;Cantabrana;28;16;12;2017
09;Burgos;070;Carazo;34;25;9;2017
09;Burgos;071;Carcedo de Bureba;41;24;17;2017
09;Burgos;072;Carcedo de Burgos;416;228;188;2017
09;Burgos;073;Cardeñadijo;1307;713;594;2017
09;Burgos;074;Cardeñajimeno;1086;573;513;2017
09;Burgos;075;Cardeñuela Riopico;114;66;48;2017
09;Burgos;076;Carrias;25;19;6;2017
09;Burgos;077;Cascajares de Bureba;34;16;18;2017
09;Burgos;078;Cascajares de la Sierra;37;20;17;2017
09;Burgos;079;Castellanos de Castro;51;32;19;2017
09;Burgos;083;Castil de Peones;36;20;16;2017
09;Burgos;082;Castildelgado;40;23;17;2017
09;Burgos;084;Castrillo de la Reina;189;123;66;2017
09;Burgos;085;Castrillo de la Vega;615;332;283;2017
09;Burgos;088;Castrillo de Riopisuerga;60;37;23;2017
09;Burgos;086;Castrillo del Val;786;449;337;2017
09;Burgos;090;Castrillo Mota de Judíos;53;29;24;2017
09;Burgos;091;Castrojeriz;817;422;395;2017
09;Burgos;063;Cavia;233;138;95;2017
09;Burgos;093;Cayuela;174;93;81;2017
09;Burgos;094;Cebrecos;51;31;20;2017
09;Burgos;095;Celada del Camino;91;50;41;2017
09;Burgos;098;Cerezo de Río Tirón;581;312;269;2017
09;Burgos;100;Cerratón de Juarros;51;36;15;2017
09;Burgos;101;Ciadoncha;81;47;34;2017
09;Burgos;102;Cillaperlata;35;24;11;2017
09;Burgos;103;Cilleruelo de Abajo;237;131;106;2017
09;Burgos;104;Cilleruelo de Arriba;46;24;22;2017
09;Burgos;105;Ciruelos de Cervera;110;65;45;2017
09;Burgos;108;Cogollos;531;291;240;2017
09;Burgos;109;Condado de Treviño;1339;764;575;2017
09;Burgos;110;Contreras;79;50;29;2017
09;Burgos;112;Coruña del Conde;120;74;46;2017
09;Burgos;113;Covarrubias;560;298;262;2017
09;Burgos;114;Cubillo del Campo;93;51;42;2017
09;Burgos;115;Cubo de Bureba;101;57;44;2017
09;Burgos;117;Cueva de Roa, La;87;45;42;2017
09;Burgos;119;Cuevas de San Clemente;45;15;30;2017
09;Burgos;120;Encío;40;22;18;2017
09;Burgos;122;Espinosa de Cervera;99;61;38;2017
09;Burgos;124;Espinosa de los Monteros;1727;904;823;2017
09;Burgos;123;Espinosa del Camino;45;28;17;2017
09;Burgos;125;Estépar;620;368;252;2017
09;Burgos;127;Fontioso;61;34;27;2017
09;Burgos;128;Frandovínez;90;53;37;2017
09;Burgos;129;Fresneda de la Sierra Tirón;104;70;34;2017
09;Burgos;130;Fresneña;77;44;33;2017
09;Burgos;131;Fresnillo de las Dueñas;649;340;309;2017
09;Burgos;132;Fresno de Río Tirón;184;112;72;2017
09;Burgos;133;Fresno de Rodilla;47;26;21;2017
09;Burgos;134;Frías;263;140;123;2017
09;Burgos;135;Fuentebureba;40;21;19;2017
09;Burgos;136;Fuentecén;222;127;95;2017
09;Burgos;137;Fuentelcésped;246;119;127;2017
09;Burgos;138;Fuentelisendo;86;47;39;2017
09;Burgos;139;Fuentemolinos;103;66;37;2017
09;Burgos;140;Fuentenebro;130;76;54;2017
09;Burgos;141;Fuentespina;784;409;375;2017
09;Burgos;143;Galbarros;30;19;11;2017
09;Burgos;144;Gallega, La;49;30;19;2017
09;Burgos;148;Grijalba;103;53;50;2017
09;Burgos;149;Grisaleña;39;29;10;2017
09;Burgos;151;Gumiel de Izán;545;311;234;2017
09;Burgos;152;Gumiel de Mercado;337;185;152;2017
09;Burgos;154;Hacinas;160;91;69;2017
09;Burgos;155;Haza;27;16;11;2017
09;Burgos;159;Hontanas;73;47;26;2017
09;Burgos;160;Hontangas;96;59;37;2017
09;Burgos;162;Hontoria de la Cantera;151;81;70;2017
09;Burgos;164;Hontoria de Valdearados;191;114;77;2017
09;Burgos;163;Hontoria del Pinar;662;370;292;2017
09;Burgos;166;Hormazas, Las;103;60;43;2017
09;Burgos;167;Hornillos del Camino;58;35;23;2017
09;Burgos;168;Horra, La;354;190;164;2017
09;Burgos;169;Hortigüela;102;65;37;2017
09;Burgos;170;Hoyales de Roa;224;118;106;2017
09;Burgos;172;Huérmeces;137;70;67;2017
09;Burgos;173;Huerta de Arriba;130;74;56;2017
09;Burgos;174;Huerta de Rey;937;503;434;2017
09;Burgos;175;Humada;125;82;43;2017
09;Burgos;176;Hurones;72;45;27;2017
09;Burgos;177;Ibeas de Juarros;1404;775;629;2017
09;Burgos;178;Ibrillos;45;28;17;2017
09;Burgos;179;Iglesiarrubia;41;23;18;2017
09;Burgos;180;Iglesias;145;81;64;2017
09;Burgos;181;Isar;316;164;152;2017
09;Burgos;182;Itero del Castillo;82;48;34;2017
09;Burgos;183;Jaramillo de la Fuente;53;34;19;2017
09;Burgos;184;Jaramillo Quemado;7;5;2;2017
09;Burgos;189;Junta de Traslaloma;128;71;57;2017
09;Burgos;190;Junta de Villalba de Losa;79;46;33;2017
09;Burgos;191;Jurisdicción de Lara;39;23;16;2017
09;Burgos;192;Jurisdicción de San Zadornil;52;28;24;2017
09;Burgos;194;Lerma;2596;1300;1296;2017
09;Burgos;195;Llano de Bureba;61;39;22;2017
09;Burgos;196;Madrigal del Monte;151;91;60;2017
09;Burgos;197;Madrigalejo del Monte;163;101;62;2017
09;Burgos;198;Mahamud;118;67;51;2017
09;Burgos;199;Mambrilla de Castrejón;103;57;46;2017
09;Burgos;200;Mambrillas de Lara;49;29;20;2017
09;Burgos;201;Mamolar;28;21;7;2017
09;Burgos;202;Manciles;24;16;8;2017
09;Burgos;206;Mazuela;61;35;26;2017
09;Burgos;208;Mecerreyes;214;113;101;2017
09;Burgos;209;Medina de Pomar;5847;2971;2876;2017
09;Burgos;211;Melgar de Fernamental;1661;901;760;2017
09;Burgos;213;Merindad de Cuesta-Urria;323;176;147;2017
09;Burgos;214;Merindad de Montija;756;450;306;2017
09;Burgos;906;Merindad de Río Ubierna;1441;789;652;2017
09;Burgos;215;Merindad de Sotoscueva;418;235;183;2017
09;Burgos;216;Merindad de Valdeporres;440;223;217;2017
09;Burgos;217;Merindad de Valdivielso;382;216;166;2017
09;Burgos;218;Milagros;459;249;210;2017
09;Burgos;219;Miranda de Ebro;35608;17483;18125;2017
09;Burgos;220;Miraveche;75;48;27;2017
09;Burgos;221;Modúbar de la Emparedada;639;355;284;2017
09;Burgos;223;Monasterio de la Sierra;42;28;14;2017
09;Burgos;224;Monasterio de Rodilla;173;94;79;2017
09;Burgos;225;Moncalvillo;88;52;36;2017
09;Burgos;226;Monterrubio de la Demanda;63;37;26;2017
09;Burgos;227;Montorio;150;80;70;2017
09;Burgos;228;Moradillo de Roa;180;95;85;2017
09;Burgos;229;Nava de Roa;220;116;104;2017
09;Burgos;230;Navas de Bureba;34;14;20;2017
09;Burgos;231;Nebreda;68;49;19;2017
09;Burgos;232;Neila;163;96;67;2017
09;Burgos;235;Olmedillo de Roa;199;119;80;2017
09;Burgos;236;Olmillos de Muñó;37;22;15;2017
09;Burgos;238;Oña;1043;554;489;2017
09;Burgos;239;Oquillas;55;31;24;2017
09;Burgos;241;Orbaneja Riopico;288;153;135;2017
09;Burgos;242;Padilla de Abajo;90;52;38;2017
09;Burgos;243;Padilla de Arriba;73;44;29;2017
09;Burgos;244;Padrones de Bureba;50;25;25;2017
09;Burgos;246;Palacios de la Sierra;743;381;362;2017
09;Burgos;247;Palacios de Riopisuerga;26;13;13;2017
09;Burgos;248;Palazuelos de la Sierra;81;47;34;2017
09;Burgos;249;Palazuelos de Muñó;50;28;22;2017
09;Burgos;250;Pampliega;314;169;145;2017
09;Burgos;251;Pancorbo;448;247;201;2017
09;Burgos;253;Pardilla;125;75;50;2017
09;Burgos;255;Partido de la Sierra en Tobalina;92;52;40;2017
09;Burgos;256;Pedrosa de Duero;438;244;194;2017
09;Burgos;259;Pedrosa de Río Úrbel;241;146;95;2017
09;Burgos;257;Pedrosa del Páramo;104;60;44;2017
09;Burgos;258;Pedrosa del Príncipe;172;90;82;2017
09;Burgos;261;Peñaranda de Duero;529;267;262;2017
09;Burgos;262;Peral de Arlanza;164;87;77;2017
09;Burgos;265;Piérnigas;39;24;15;2017
09;Burgos;266;Pineda de la Sierra;103;66;37;2017
09;Burgos;267;Pineda Trasmonte;110;66;44;2017
09;Burgos;268;Pinilla de los Barruecos;110;64;46;2017
09;Burgos;269;Pinilla de los Moros;32;21;11;2017
09;Burgos;270;Pinilla Trasmonte;167;97;70;2017
09;Burgos;272;Poza de la Sal;303;160;143;2017
09;Burgos;273;Prádanos de Bureba;57;36;21;2017
09;Burgos;274;Pradoluengo;1203;597;606;2017
09;Burgos;275;Presencio;187;114;73;2017
09;Burgos;276;Puebla de Arganzón, La;502;273;229;2017
09;Burgos;277;Puentedura;123;80;43;2017
09;Burgos;279;Quemada;241;144;97;2017
09;Burgos;281;Quintana del Pidio;154;79;75;2017
09;Burgos;280;Quintanabureba;28;18;10;2017
09;Burgos;283;Quintanaélez;49;25;24;2017
09;Burgos;287;Quintanaortuño;267;153;114;2017
09;Burgos;288;Quintanapalla;112;64;48;2017
09;Burgos;289;Quintanar de la Sierra;1758;922;836;2017
09;Burgos;292;Quintanavides;85;52;33;2017
09;Burgos;294;Quintanilla de la Mata;122;74;48;2017
09;Burgos;901;Quintanilla del Agua y Tordueles;395;204;191;2017
09;Burgos;295;Quintanilla del Coco;58;29;29;2017
09;Burgos;298;Quintanilla San García;83;48;35;2017
09;Burgos;301;Quintanilla Vivar;782;416;366;2017
09;Burgos;297;Quintanillas, Las;382;219;163;2017
09;Burgos;302;Rabanera del Pinar;112;67;45;2017
09;Burgos;303;Rábanos;83;51;32;2017
09;Burgos;304;Rabé de las Calzadas;214;114;100;2017
09;Burgos;306;Rebolledo de la Torre;117;64;53;2017
09;Burgos;307;Redecilla del Camino;112;70;42;2017
09;Burgos;308;Redecilla del Campo;71;42;29;2017
09;Burgos;309;Regumiel de la Sierra;356;189;167;2017
09;Burgos;310;Reinoso;12;9;3;2017
09;Burgos;311;Retuerta;60;39;21;2017
09;Burgos;314;Revilla del Campo;91;59;32;2017
09;Burgos;316;Revilla Vallejera;115;76;39;2017
09;Burgos;312;Revilla y Ahedo, La;108;60;48;2017
09;Burgos;315;Revillarruz;482;247;235;2017
09;Burgos;317;Rezmondo;20;8;12;2017
09;Burgos;318;Riocavado de la Sierra;59;38;21;2017
09;Burgos;321;Roa;2262;1151;1111;2017
09;Burgos;323;Rojas;67;44;23;2017
09;Burgos;325;Royuela de Río Franco;204;123;81;2017
09;Burgos;326;Rubena;168;99;69;2017
09;Burgos;327;Rublacedo de Abajo;35;18;17;2017
09;Burgos;328;Rucandio;74;36;38;2017
09;Burgos;329;Salas de Bureba;134;79;55;2017
09;Burgos;330;Salas de los Infantes;1974;1011;963;2017
09;Burgos;332;Saldaña de Burgos;177;94;83;2017
09;Burgos;334;Salinillas de Bureba;51;41;10;2017
09;Burgos;335;San Adrián de Juarros;92;57;35;2017
09;Burgos;337;San Juan del Monte;138;77;61;2017
09;Burgos;338;San Mamés de Burgos;290;164;126;2017
09;Burgos;339;San Martín de Rubiales;134;75;59;2017
09;Burgos;340;San Millán de Lara;79;55;24;2017
09;Burgos;360;San Vicente del Valle;27;20;7;2017
09;Burgos;343;Santa Cecilia;98;59;39;2017
09;Burgos;345;Santa Cruz de la Salceda;139;80;59;2017
09;Burgos;346;Santa Cruz del Valle Urbión;98;63;35;2017
09;Burgos;347;Santa Gadea del Cid;152;79;73;2017
09;Burgos;348;Santa Inés;150;79;71;2017
09;Burgos;350;Santa María del Campo;558;299;259;2017
09;Burgos;351;Santa María del Invierno;62;44;18;2017
09;Burgos;352;Santa María del Mercadillo;106;66;40;2017
09;Burgos;353;Santa María Rivarredonda;93;58;35;2017
09;Burgos;354;Santa Olalla de Bureba;38;28;10;2017
09;Burgos;355;Santibáñez de Esgueva;90;46;44;2017
09;Burgos;356;Santibáñez del Val;43;26;17;2017
09;Burgos;358;Santo Domingo de Silos;282;174;108;2017
09;Burgos;361;Sargentes de la Lora;114;62;52;2017
09;Burgos;362;Sarracín;236;131;105;2017
09;Burgos;363;Sasamón;1027;584;443;2017
09;Burgos;365;Sequera de Haza, La;34;23;11;2017
09;Burgos;366;Solarana;77;42;35;2017
09;Burgos;368;Sordillos;22;14;8;2017
09;Burgos;369;Sotillo de la Ribera;501;260;241;2017
09;Burgos;372;Sotragero;268;146;122;2017
09;Burgos;373;Sotresgudo;461;263;198;2017
09;Burgos;374;Susinos del Páramo;103;67;36;2017
09;Burgos;375;Tamarón;41;23;18;2017
09;Burgos;377;Tardajos;794;424;370;2017
09;Burgos;378;Tejada;29;20;9;2017
09;Burgos;380;Terradillos de Esgueva;79;36;43;2017
09;Burgos;381;Tinieblas de la Sierra;36;20;16;2017
09;Burgos;382;Tobar;25;17;8;2017
09;Burgos;384;Tordómar;351;192;159;2017
09;Burgos;386;Torrecilla del Monte;60;34;26;2017
09;Burgos;387;Torregalindo;133;83;50;2017
09;Burgos;388;Torrelara;31;16;15;2017
09;Burgos;389;Torrepadre;66;37;29;2017
09;Burgos;390;Torresandino;663;358;305;2017
09;Burgos;391;Tórtoles de Esgueva;471;244;227;2017
09;Burgos;392;Tosantos;56;32;24;2017
09;Burgos;394;Trespaderne;835;434;401;2017
09;Burgos;395;Tubilla del Agua;146;87;59;2017
09;Burgos;396;Tubilla del Lago;156;83;73;2017
09;Burgos;398;Úrbel del Castillo;75;52;23;2017
09;Burgos;400;Vadocondes;374;204;170;2017
09;Burgos;403;Valdeande;99;62;37;2017
09;Burgos;405;Valdezate;138;75;63;2017
09;Burgos;406;Valdorros;322;188;134;2017
09;Burgos;408;Vallarta de Bureba;41;25;16;2017
09;Burgos;904;Valle de las Navas;522;305;217;2017
09;Burgos;908;Valle de Losa;505;296;209;2017
09;Burgos;409;Valle de Manzanedo;118;59;59;2017
09;Burgos;410;Valle de Mena;3742;1923;1819;2017
09;Burgos;411;Valle de Oca;157;97;60;2017
09;Burgos;902;Valle de Santibáñez;488;282;206;2017
09;Burgos;905;Valle de Sedano;438;247;191;2017
09;Burgos;412;Valle de Tobalina;965;530;435;2017
09;Burgos;413;Valle de Valdebezana;477;246;231;2017
09;Burgos;414;Valle de Valdelaguna;198;113;85;2017
09;Burgos;415;Valle de Valdelucio;314;165;149;2017
09;Burgos;416;Valle de Zamanzas;57;32;25;2017
09;Burgos;417;Vallejera;43;25;18;2017
09;Burgos;418;Valles de Palenzuela;86;44;42;2017
09;Burgos;419;Valluércanes;75;49;26;2017
09;Burgos;407;Valmala;30;17;13;2017
09;Burgos;422;Vid de Bureba, La;17;9;8;2017
09;Burgos;421;Vid y Barrios, La;242;140;102;2017
09;Burgos;423;Vileña;28;18;10;2017
09;Burgos;427;Villadiego;1546;851;695;2017
09;Burgos;428;Villaescusa de Roa;108;64;44;2017
09;Burgos;429;Villaescusa la Sombría;67;49;18;2017
09;Burgos;430;Villaespasa;22;14;8;2017
09;Burgos;431;Villafranca Montes de Oca;118;73;45;2017
09;Burgos;432;Villafruela;197;111;86;2017
09;Burgos;433;Villagalijo;64;41;23;2017
09;Burgos;434;Villagonzalo Pedernales;1795;938;857;2017
09;Burgos;437;Villahoz;300;161;139;2017
09;Burgos;438;Villalba de Duero;676;355;321;2017
09;Burgos;439;Villalbilla de Burgos;1388;749;639;2017
09;Burgos;440;Villalbilla de Gumiel;86;51;35;2017
09;Burgos;441;Villaldemiro;72;41;31;2017
09;Burgos;442;Villalmanzo;439;239;200;2017
09;Burgos;443;Villamayor de los Montes;185;92;93;2017
09;Burgos;444;Villamayor de Treviño;71;36;35;2017
09;Burgos;445;Villambistia;46;33;13;2017
09;Burgos;446;Villamedianilla;12;7;5;2017
09;Burgos;447;Villamiel de la Sierra;48;29;19;2017
09;Burgos;448;Villangómez;226;140;86;2017
09;Burgos;449;Villanueva de Argaño;108;63;45;2017
09;Burgos;450;Villanueva de Carazo;28;18;10;2017
09;Burgos;451;Villanueva de Gumiel;281;145;136;2017
09;Burgos;454;Villanueva de Teba;44;28;16;2017
09;Burgos;455;Villaquirán de la Puebla;48;29;19;2017
09;Burgos;456;Villaquirán de los Infantes;146;80;66;2017
09;Burgos;903;Villarcayo de Merindad de Castilla la Vieja;4228;2170;2058;2017
09;Burgos;458;Villariezo;631;356;275;2017
09;Burgos;460;Villasandino;195;116;79;2017
09;Burgos;463;Villasur de Herreros;286;171;115;2017
09;Burgos;464;Villatuelda;37;20;17;2017
09;Burgos;466;Villaverde del Monte;120;67;53;2017
09;Burgos;467;Villaverde-Mogina;78;51;27;2017
09;Burgos;471;Villayerno Morquillas;196;104;92;2017
09;Burgos;472;Villazopeque;61;38;23;2017
09;Burgos;473;Villegas;90;53;37;2017
09;Burgos;476;Villoruebo;81;51;30;2017
09;Burgos;424;Viloria de Rioja;45;27;18;2017
09;Burgos;425;Vilviestre del Pinar;572;316;256;2017
09;Burgos;478;Vizcaínos;41;28;13;2017
09;Burgos;480;Zael;115;59;56;2017
09;Burgos;482;Zarzosa de Río Pisuerga;30;19;11;2017
09;Burgos;483;Zazuar;232;122;110;2017
09;Burgos;485;Zuñeda;58;37;21;2017
10;Cáceres;001;Abadía;337;189;148;2017
10;Cáceres;002;Abertura;408;211;197;2017
10;Cáceres;003;Acebo;601;307;294;2017
10;Cáceres;004;Acehúche;814;405;409;2017
10;Cáceres;005;Aceituna;601;314;287;2017
10;Cáceres;006;Ahigal;1405;727;678;2017
10;Cáceres;903;Alagón del Río;932;467;465;2017
10;Cáceres;007;Albalá;684;347;337;2017
10;Cáceres;008;Alcántara;1487;743;744;2017
10;Cáceres;009;Alcollarín;237;118;119;2017
10;Cáceres;010;Alcuéscar;2682;1391;1291;2017
10;Cáceres;012;Aldea del Cano;632;297;335;2017
10;Cáceres;013;Aldea del Obispo, La;309;166;143;2017
10;Cáceres;011;Aldeacentenera;609;307;302;2017
10;Cáceres;014;Aldeanueva de la Vera;2114;1035;1079;2017
10;Cáceres;015;Aldeanueva del Camino;754;364;390;2017
10;Cáceres;016;Aldehuela de Jerte;364;192;172;2017
10;Cáceres;017;Alía;865;427;438;2017
10;Cáceres;018;Aliseda;1883;953;930;2017
10;Cáceres;019;Almaraz;1651;842;809;2017
10;Cáceres;020;Almoharín;1848;907;941;2017
10;Cáceres;021;Arroyo de la Luz;5917;2945;2972;2017
10;Cáceres;023;Arroyomolinos;770;407;363;2017
10;Cáceres;022;Arroyomolinos de la Vera;452;228;224;2017
10;Cáceres;024;Baños de Montemayor;774;370;404;2017
10;Cáceres;025;Barrado;424;218;206;2017
10;Cáceres;026;Belvís de Monroy;744;388;356;2017
10;Cáceres;027;Benquerencia;79;44;35;2017
10;Cáceres;028;Berrocalejo;102;56;46;2017
10;Cáceres;029;Berzocana;451;240;211;2017
10;Cáceres;030;Bohonal de Ibor;507;263;244;2017
10;Cáceres;031;Botija;190;106;84;2017
10;Cáceres;032;Brozas;1911;954;957;2017
10;Cáceres;033;Cabañas del Castillo;447;240;207;2017
10;Cáceres;034;Cabezabellosa;362;183;179;2017
10;Cáceres;035;Cabezuela del Valle;2250;1152;1098;2017
10;Cáceres;036;Cabrero;361;199;162;2017
10;Cáceres;037;Cáceres;95917;45983;49934;2017
10;Cáceres;038;Cachorrilla;86;46;40;2017
10;Cáceres;039;Cadalso;443;223;220;2017
10;Cáceres;040;Calzadilla;485;249;236;2017
10;Cáceres;041;Caminomorisco;1203;629;574;2017
10;Cáceres;042;Campillo de Deleitosa;68;28;40;2017
10;Cáceres;043;Campo Lugar;891;440;451;2017
10;Cáceres;044;Cañamero;1664;866;798;2017
10;Cáceres;045;Cañaveral;1047;513;534;2017
10;Cáceres;046;Carbajo;221;115;106;2017
10;Cáceres;047;Carcaboso;1106;552;554;2017
10;Cáceres;048;Carrascalejo;239;119;120;2017
10;Cáceres;049;Casar de Cáceres;4532;2248;2284;2017
10;Cáceres;050;Casar de Palomero;1151;584;567;2017
10;Cáceres;051;Casares de las Hurdes;405;207;198;2017
10;Cáceres;052;Casas de Don Antonio;183;90;93;2017
10;Cáceres;053;Casas de Don Gómez;303;164;139;2017
10;Cáceres;056;Casas de Millán;606;302;304;2017
10;Cáceres;057;Casas de Miravete;148;91;57;2017
10;Cáceres;054;Casas del Castañar;594;290;304;2017
10;Cáceres;055;Casas del Monte;823;422;401;2017
10;Cáceres;058;Casatejada;1409;733;676;2017
10;Cáceres;059;Casillas de Coria;397;194;203;2017
10;Cáceres;060;Castañar de Ibor;1082;560;522;2017
10;Cáceres;061;Ceclavín;1871;963;908;2017
10;Cáceres;062;Cedillo;458;241;217;2017
10;Cáceres;063;Cerezo;176;86;90;2017
10;Cáceres;064;Cilleros;1680;855;825;2017
10;Cáceres;065;Collado de la Vera;203;112;91;2017
10;Cáceres;066;Conquista de la Sierra;189;112;77;2017
10;Cáceres;067;Coria;12729;6258;6471;2017
10;Cáceres;068;Cuacos de Yuste;850;440;410;2017
10;Cáceres;069;Cumbre, La;884;445;439;2017
10;Cáceres;070;Deleitosa;748;372;376;2017
10;Cáceres;071;Descargamaría;130;76;54;2017
10;Cáceres;072;Eljas;936;476;460;2017
10;Cáceres;073;Escurial;800;424;376;2017
10;Cáceres;075;Fresnedoso de Ibor;272;143;129;2017
10;Cáceres;076;Galisteo;985;496;489;2017
10;Cáceres;077;Garciaz;754;387;367;2017
10;Cáceres;079;Garganta la Olla;998;523;475;2017
10;Cáceres;078;Garganta, La;412;221;191;2017
10;Cáceres;080;Gargantilla;401;204;197;2017
10;Cáceres;081;Gargüera;133;74;59;2017
10;Cáceres;082;Garrovillas de Alconétar;2102;1041;1061;2017
10;Cáceres;083;Garvín;98;54;44;2017
10;Cáceres;084;Gata;1534;796;738;2017
10;Cáceres;085;Gordo, El;375;192;183;2017
10;Cáceres;086;Granja, La;342;182;160;2017
10;Cáceres;087;Guadalupe;1960;969;991;2017
10;Cáceres;088;Guijo de Coria;212;110;102;2017
10;Cáceres;089;Guijo de Galisteo;1535;775;760;2017
10;Cáceres;090;Guijo de Granadilla;548;286;262;2017
10;Cáceres;091;Guijo de Santa Bárbara;407;214;193;2017
10;Cáceres;092;Herguijuela;317;163;154;2017
10;Cáceres;093;Hernán-Pérez;470;235;235;2017
10;Cáceres;094;Herrera de Alcántara;272;142;130;2017
10;Cáceres;095;Herreruela;354;179;175;2017
10;Cáceres;096;Hervás;4102;2022;2080;2017
10;Cáceres;097;Higuera;99;61;38;2017
10;Cáceres;098;Hinojal;407;209;198;2017
10;Cáceres;099;Holguera;659;326;333;2017
10;Cáceres;100;Hoyos;893;431;462;2017
10;Cáceres;101;Huélaga;225;115;110;2017
10;Cáceres;102;Ibahernando;569;277;292;2017
10;Cáceres;103;Jaraicejo;497;240;257;2017
10;Cáceres;104;Jaraíz de la Vera;6514;3259;3255;2017
10;Cáceres;105;Jarandilla de la Vera;2883;1433;1450;2017
10;Cáceres;106;Jarilla;140;74;66;2017
10;Cáceres;107;Jerte;1276;639;637;2017
10;Cáceres;108;Ladrillar;209;110;99;2017
10;Cáceres;109;Logrosán;2025;1022;1003;2017
10;Cáceres;110;Losar de la Vera;2792;1442;1350;2017
10;Cáceres;111;Madrigal de la Vera;1603;835;768;2017
10;Cáceres;112;Madrigalejo;1808;903;905;2017
10;Cáceres;113;Madroñera;2631;1319;1312;2017
10;Cáceres;114;Majadas;1338;671;667;2017
10;Cáceres;115;Malpartida de Cáceres;4192;2106;2086;2017
10;Cáceres;116;Malpartida de Plasencia;4609;2282;2327;2017
10;Cáceres;117;Marchagaz;210;108;102;2017
10;Cáceres;118;Mata de Alcántara;314;164;150;2017
10;Cáceres;119;Membrío;658;325;333;2017
10;Cáceres;120;Mesas de Ibor;174;93;81;2017
10;Cáceres;121;Miajadas;9773;4880;4893;2017
10;Cáceres;122;Millanes;241;125;116;2017
10;Cáceres;123;Mirabel;669;333;336;2017
10;Cáceres;124;Mohedas de Granadilla;825;408;417;2017
10;Cáceres;125;Monroy;991;496;495;2017
10;Cáceres;126;Montánchez;1763;882;881;2017
10;Cáceres;127;Montehermoso;5761;2938;2823;2017
10;Cáceres;128;Moraleja;6811;3403;3408;2017
10;Cáceres;129;Morcillo;387;177;210;2017
10;Cáceres;130;Navaconcejo;2007;1018;989;2017
10;Cáceres;131;Navalmoral de la Mata;17297;8326;8971;2017
10;Cáceres;132;Navalvillar de Ibor;431;216;215;2017
10;Cáceres;133;Navas del Madroño;1355;675;680;2017
10;Cáceres;134;Navezuelas;661;343;318;2017
10;Cáceres;135;Nuñomoral;1355;715;640;2017
10;Cáceres;136;Oliva de Plasencia;308;171;137;2017
10;Cáceres;137;Palomero;369;194;175;2017
10;Cáceres;138;Pasarón de la Vera;653;313;340;2017
10;Cáceres;139;Pedroso de Acim;95;50;45;2017
10;Cáceres;140;Peraleda de la Mata;1410;709;701;2017
10;Cáceres;141;Peraleda de San Román;292;151;141;2017
10;Cáceres;142;Perales del Puerto;958;491;467;2017
10;Cáceres;143;Pescueza;158;70;88;2017
10;Cáceres;144;Pesga, La;1087;569;518;2017
10;Cáceres;145;Piedras Albas;160;76;84;2017
10;Cáceres;146;Pinofranqueado;1785;961;824;2017
10;Cáceres;147;Piornal;1536;772;764;2017
10;Cáceres;148;Plasencia;40360;19504;20856;2017
10;Cáceres;149;Plasenzuela;476;235;241;2017
10;Cáceres;150;Portaje;380;197;183;2017
10;Cáceres;151;Portezuelo;231;122;109;2017
10;Cáceres;152;Pozuelo de Zarzón;479;237;242;2017
10;Cáceres;905;Pueblonuevo de Miramontes;829;424;405;2017
10;Cáceres;153;Puerto de Santa Cruz;338;176;162;2017
10;Cáceres;154;Rebollar;210;104;106;2017
10;Cáceres;155;Riolobos;1266;662;604;2017
10;Cáceres;156;Robledillo de Gata;97;52;45;2017
10;Cáceres;157;Robledillo de la Vera;284;149;135;2017
10;Cáceres;158;Robledillo de Trujillo;357;185;172;2017
10;Cáceres;159;Robledollano;326;181;145;2017
10;Cáceres;160;Romangordo;249;121;128;2017
10;Cáceres;901;Rosalejo;1438;761;677;2017
10;Cáceres;161;Ruanes;66;37;29;2017
10;Cáceres;162;Salorino;613;320;293;2017
10;Cáceres;163;Salvatierra de Santiago;298;155;143;2017
10;Cáceres;164;San Martín de Trevejo;805;399;406;2017
10;Cáceres;165;Santa Ana;250;135;115;2017
10;Cáceres;166;Santa Cruz de la Sierra;333;168;165;2017
10;Cáceres;167;Santa Cruz de Paniagua;330;183;147;2017
10;Cáceres;168;Santa Marta de Magasca;282;143;139;2017
10;Cáceres;169;Santiago de Alcántara;533;258;275;2017
10;Cáceres;170;Santiago del Campo;275;141;134;2017
10;Cáceres;171;Santibáñez el Alto;338;177;161;2017
10;Cáceres;172;Santibáñez el Bajo;761;395;366;2017
10;Cáceres;173;Saucedilla;886;471;415;2017
10;Cáceres;174;Segura de Toro;188;90;98;2017
10;Cáceres;175;Serradilla;1608;815;793;2017
10;Cáceres;176;Serrejón;433;222;211;2017
10;Cáceres;177;Sierra de Fuentes;2006;1021;985;2017
10;Cáceres;178;Talaván;842;439;403;2017
10;Cáceres;179;Talaveruela de la Vera;325;174;151;2017
10;Cáceres;180;Talayuela;7338;3972;3366;2017
10;Cáceres;181;Tejeda de Tiétar;802;433;369;2017
10;Cáceres;904;Tiétar;922;494;428;2017
10;Cáceres;182;Toril;170;108;62;2017
10;Cáceres;183;Tornavacas;1126;591;535;2017
10;Cáceres;184;Torno, El;897;474;423;2017
10;Cáceres;187;Torre de Don Miguel;488;263;225;2017
10;Cáceres;188;Torre de Santa María;549;277;272;2017
10;Cáceres;185;Torrecilla de los Ángeles;637;333;304;2017
10;Cáceres;186;Torrecillas de la Tiesa;1103;554;549;2017
10;Cáceres;190;Torrejón el Rubio;593;303;290;2017
10;Cáceres;189;Torrejoncillo;3044;1495;1549;2017
10;Cáceres;191;Torremenga;625;333;292;2017
10;Cáceres;192;Torremocha;850;419;431;2017
10;Cáceres;193;Torreorgaz;1669;811;858;2017
10;Cáceres;194;Torrequemada;587;281;306;2017
10;Cáceres;195;Trujillo;9274;4534;4740;2017
10;Cáceres;196;Valdastillas;327;173;154;2017
10;Cáceres;197;Valdecañas de Tajo;123;66;57;2017
10;Cáceres;198;Valdefuentes;1251;621;630;2017
10;Cáceres;199;Valdehúncar;179;95;84;2017
10;Cáceres;200;Valdelacasa de Tajo;387;199;188;2017
10;Cáceres;201;Valdemorales;198;98;100;2017
10;Cáceres;202;Valdeobispo;665;327;338;2017
10;Cáceres;203;Valencia de Alcántara;5532;2715;2817;2017
10;Cáceres;204;Valverde de la Vera;485;244;241;2017
10;Cáceres;205;Valverde del Fresno;2378;1203;1175;2017
10;Cáceres;902;Vegaviana;849;438;411;2017
10;Cáceres;206;Viandar de la Vera;233;122;111;2017
10;Cáceres;207;Villa del Campo;525;255;270;2017
10;Cáceres;208;Villa del Rey;126;64;62;2017
10;Cáceres;209;Villamesías;269;135;134;2017
10;Cáceres;210;Villamiel;462;233;229;2017
10;Cáceres;211;Villanueva de la Sierra;444;222;222;2017
10;Cáceres;212;Villanueva de la Vera;2082;1050;1032;2017
10;Cáceres;214;Villar de Plasencia;234;124;110;2017
10;Cáceres;213;Villar del Pedroso;629;325;304;2017
10;Cáceres;215;Villasbuenas de Gata;357;183;174;2017
10;Cáceres;216;Zarza de Granadilla;1822;925;897;2017
10;Cáceres;217;Zarza de Montánchez;563;278;285;2017
10;Cáceres;218;Zarza la Mayor;1277;635;642;2017
10;Cáceres;219;Zorita;1412;712;700;2017
11;Cádiz;001;Alcalá de los Gazules;5258;2715;2543;2017
11;Cádiz;002;Alcalá del Valle;5150;2591;2559;2017
11;Cádiz;003;Algar;1433;741;692;2017
11;Cádiz;004;Algeciras;121133;59765;61368;2017
11;Cádiz;005;Algodonales;5630;2862;2768;2017
11;Cádiz;006;Arcos de la Frontera;30983;15515;15468;2017
11;Cádiz;007;Barbate;22548;11303;11245;2017
11;Cádiz;008;Barrios, Los;23374;11688;11686;2017
11;Cádiz;901;Benalup-Casas Viejas;6995;3557;3438;2017
11;Cádiz;009;Benaocaz;687;366;321;2017
11;Cádiz;010;Bornos;7818;3908;3910;2017
11;Cádiz;011;Bosque, El;2147;1084;1063;2017
11;Cádiz;012;Cádiz;118048;55925;62123;2017
11;Cádiz;013;Castellar de la Frontera;3022;1507;1515;2017
11;Cádiz;015;Chiclana de la Frontera;83148;41736;41412;2017
11;Cádiz;016;Chipiona;19104;9607;9497;2017
11;Cádiz;014;Conil de la Frontera;22369;11250;11119;2017
11;Cádiz;017;Espera;3909;1964;1945;2017
11;Cádiz;018;Gastor, El;1724;889;835;2017
11;Cádiz;019;Grazalema;2100;1053;1047;2017
11;Cádiz;020;Jerez de la Frontera;212915;104190;108725;2017
11;Cádiz;021;Jimena de la Frontera;9685;4971;4714;2017
11;Cádiz;022;Línea de la Concepción, La;63146;31031;32115;2017
11;Cádiz;023;Medina-Sidonia;11741;5986;5755;2017
11;Cádiz;024;Olvera;8153;4014;4139;2017
11;Cádiz;025;Paterna de Rivera;5577;2879;2698;2017
11;Cádiz;026;Prado del Rey;5710;2845;2865;2017
11;Cádiz;027;Puerto de Santa María, El;88430;43444;44986;2017
11;Cádiz;028;Puerto Real;41472;20809;20663;2017
11;Cádiz;029;Puerto Serrano;7066;3578;3488;2017
11;Cádiz;030;Rota;28996;14483;14513;2017
11;Cádiz;031;San Fernando;95643;46795;48848;2017
11;Cádiz;902;San José del Valle;4445;2276;2169;2017
11;Cádiz;033;San Roque;29969;14945;15024;2017
11;Cádiz;032;Sanlúcar de Barrameda;67640;33690;33950;2017
11;Cádiz;034;Setenil de las Bodegas;2781;1424;1357;2017
11;Cádiz;035;Tarifa;18088;9121;8967;2017
11;Cádiz;036;Torre Alháquime;795;399;396;2017
11;Cádiz;037;Trebujena;7069;3543;3526;2017
11;Cádiz;038;Ubrique;16683;8265;8418;2017
11;Cádiz;039;Vejer de la Frontera;12782;6400;6382;2017
11;Cádiz;040;Villaluenga del Rosario;446;233;213;2017
11;Cádiz;041;Villamartín;12207;6119;6088;2017
11;Cádiz;042;Zahara;1416;725;691;2017
39;Cantabria;001;Alfoz de Lloredo;2446;1254;1192;2017
39;Cantabria;002;Ampuero;4222;2156;2066;2017
39;Cantabria;003;Anievas;291;154;137;2017
39;Cantabria;004;Arenas de Iguña;1690;867;823;2017
39;Cantabria;005;Argoños;1713;889;824;2017
39;Cantabria;006;Arnuero;2098;1061;1037;2017
39;Cantabria;007;Arredondo;472;272;200;2017
39;Cantabria;008;Astillero, El;18120;8823;9297;2017
39;Cantabria;009;Bárcena de Cicero;4132;2150;1982;2017
39;Cantabria;010;Bárcena de Pie de Concha;687;344;343;2017
39;Cantabria;011;Bareyo;1987;1014;973;2017
39;Cantabria;012;Cabezón de la Sal;8326;4042;4284;2017
39;Cantabria;013;Cabezón de Liébana;595;345;250;2017
39;Cantabria;014;Cabuérniga;1001;542;459;2017
39;Cantabria;015;Camaleño;970;537;433;2017
39;Cantabria;016;Camargo;30556;14960;15596;2017
39;Cantabria;027;Campoo de Enmedio;3757;1920;1837;2017
39;Cantabria;017;Campoo de Yuso;682;361;321;2017
39;Cantabria;018;Cartes;5742;2880;2862;2017
39;Cantabria;019;Castañeda;2744;1403;1341;2017
39;Cantabria;020;Castro-Urdiales;31817;15777;16040;2017
39;Cantabria;021;Cieza;536;274;262;2017
39;Cantabria;022;Cillorigo de Liébana;1320;703;617;2017
39;Cantabria;023;Colindres;8288;4073;4215;2017
39;Cantabria;024;Comillas;2195;1042;1153;2017
39;Cantabria;025;Corrales de Buelna, Los;10912;5346;5566;2017
39;Cantabria;026;Corvera de Toranzo;2055;1046;1009;2017
39;Cantabria;028;Entrambasaguas;5010;2521;2489;2017
39;Cantabria;029;Escalante;749;390;359;2017
39;Cantabria;030;Guriezo;2358;1210;1148;2017
39;Cantabria;031;Hazas de Cesto;1550;785;765;2017
39;Cantabria;032;Hermandad de Campoo de Suso;1612;886;726;2017
39;Cantabria;033;Herrerías;623;347;276;2017
39;Cantabria;034;Lamasón;302;192;110;2017
39;Cantabria;035;Laredo;11347;5394;5953;2017
39;Cantabria;036;Liendo;1216;624;592;2017
39;Cantabria;037;Liérganes;2355;1161;1194;2017
39;Cantabria;038;Limpias;1824;908;916;2017
39;Cantabria;039;Luena;611;332;279;2017
39;Cantabria;040;Marina de Cudeyo;5147;2566;2581;2017
39;Cantabria;041;Mazcuerras;2125;1093;1032;2017
39;Cantabria;042;Medio Cudeyo;7459;3634;3825;2017
39;Cantabria;043;Meruelo;1985;1003;982;2017
39;Cantabria;044;Miengo;4676;2358;2318;2017
39;Cantabria;045;Miera;393;205;188;2017
39;Cantabria;046;Molledo;1585;789;796;2017
39;Cantabria;047;Noja;2553;1274;1279;2017
39;Cantabria;048;Penagos;2083;1059;1024;2017
39;Cantabria;049;Peñarrubia;332;182;150;2017
39;Cantabria;050;Pesaguero;298;169;129;2017
39;Cantabria;051;Pesquera;68;42;26;2017
39;Cantabria;052;Piélagos;24918;12344;12574;2017
39;Cantabria;053;Polaciones;239;152;87;2017
39;Cantabria;054;Polanco;5850;2930;2920;2017
39;Cantabria;055;Potes;1342;655;687;2017
39;Cantabria;056;Puente Viesgo;2843;1445;1398;2017
39;Cantabria;057;Ramales de la Victoria;2895;1459;1436;2017
39;Cantabria;058;Rasines;966;510;456;2017
39;Cantabria;059;Reinosa;9331;4382;4949;2017
39;Cantabria;060;Reocín;8312;4102;4210;2017
39;Cantabria;061;Ribamontán al Mar;4426;2226;2200;2017
39;Cantabria;062;Ribamontán al Monte;2223;1163;1060;2017
39;Cantabria;063;Rionansa;1045;589;456;2017
39;Cantabria;064;Riotuerto;1615;771;844;2017
39;Cantabria;065;Rozas de Valdearroyo, Las;264;147;117;2017
39;Cantabria;066;Ruente;1031;554;477;2017
39;Cantabria;067;Ruesga;870;472;398;2017
39;Cantabria;068;Ruiloba;748;386;362;2017
39;Cantabria;069;San Felices de Buelna;2421;1219;1202;2017
39;Cantabria;070;San Miguel de Aguayo;154;81;73;2017
39;Cantabria;071;San Pedro del Romeral;452;253;199;2017
39;Cantabria;072;San Roque de Riomiera;380;226;154;2017
39;Cantabria;080;San Vicente de la Barquera;4173;2084;2089;2017
39;Cantabria;073;Santa Cruz de Bezana;12818;6296;6522;2017
39;Cantabria;074;Santa María de Cayón;9095;4552;4543;2017
39;Cantabria;075;Santander;171951;79391;92560;2017
39;Cantabria;076;Santillana del Mar;4154;2029;2125;2017
39;Cantabria;077;Santiurde de Reinosa;254;149;105;2017
39;Cantabria;078;Santiurde de Toranzo;1610;836;774;2017
39;Cantabria;079;Santoña;11004;5371;5633;2017
39;Cantabria;081;Saro;515;270;245;2017
39;Cantabria;082;Selaya;1915;954;961;2017
39;Cantabria;083;Soba;1207;659;548;2017
39;Cantabria;084;Solórzano;1040;552;488;2017
39;Cantabria;085;Suances;8645;4258;4387;2017
39;Cantabria;086;Tojos, Los;402;237;165;2017
39;Cantabria;087;Torrelavega;52034;24556;27478;2017
39;Cantabria;088;Tresviso;70;47;23;2017
39;Cantabria;089;Tudanca;145;104;41;2017
39;Cantabria;090;Udías;903;456;447;2017
39;Cantabria;095;Val de San Vicente;2804;1466;1338;2017
39;Cantabria;091;Valdáliga;2218;1144;1074;2017
39;Cantabria;092;Valdeolea;994;530;464;2017
39;Cantabria;093;Valdeprado del Río;323;186;137;2017
39;Cantabria;094;Valderredible;987;556;431;2017
39;Cantabria;101;Valle de Villaverde;306;161;145;2017
39;Cantabria;096;Vega de Liébana;765;398;367;2017
39;Cantabria;097;Vega de Pas;784;409;375;2017
39;Cantabria;098;Villacarriedo;1626;847;779;2017
39;Cantabria;099;Villaescusa;3883;1928;1955;2017
39;Cantabria;100;Villafufre;1014;524;490;2017
39;Cantabria;102;Voto;2716;1433;1283;2017
12;Castellón/Castelló;002;Aín;129;69;60;2017
12;Castellón/Castelló;003;Albocàsser;1257;613;644;2017
12;Castellón/Castelló;004;Alcalà de Xivert;6796;3481;3315;2017
12;Castellón/Castelló;005;Alcora, l';10502;5305;5197;2017
12;Castellón/Castelló;006;Alcudia de Veo;204;106;98;2017
12;Castellón/Castelló;007;Alfondeguilla;870;441;429;2017
12;Castellón/Castelló;008;Algimia de Almonacid;268;147;121;2017
12;Castellón/Castelló;009;Almazora/Almassora;25648;12869;12779;2017
12;Castellón/Castelló;010;Almedíjar;270;145;125;2017
12;Castellón/Castelló;011;Almenara;5920;2966;2954;2017
12;Castellón/Castelló;901;Alqueries, les/Alquerías del Niño Perdido;4466;2211;2255;2017
12;Castellón/Castelló;012;Altura;3559;1818;1741;2017
12;Castellón/Castelló;013;Arañuel;151;76;75;2017
12;Castellón/Castelló;014;Ares del Maestrat;197;110;87;2017
12;Castellón/Castelló;015;Argelita;94;54;40;2017
12;Castellón/Castelló;016;Artana;1979;1005;974;2017
12;Castellón/Castelló;001;Atzeneta del Maestrat;1290;656;634;2017
12;Castellón/Castelló;017;Ayódar;165;89;76;2017
12;Castellón/Castelló;018;Azuébar;324;175;149;2017
12;Castellón/Castelló;020;Barracas;165;88;77;2017
12;Castellón/Castelló;022;Bejís;378;218;160;2017
12;Castellón/Castelló;024;Benafer;159;84;75;2017
12;Castellón/Castelló;025;Benafigos;148;84;64;2017
12;Castellón/Castelló;026;Benassal;1106;565;541;2017
12;Castellón/Castelló;027;Benicarló;26429;13166;13263;2017
12;Castellón/Castelló;028;Benicasim/Benicàssim;17964;8953;9011;2017
12;Castellón/Castelló;029;Benlloch;1060;529;531;2017
12;Castellón/Castelló;021;Betxí;5750;2833;2917;2017
12;Castellón/Castelló;032;Borriana/Burriana;34464;17034;17430;2017
12;Castellón/Castelló;031;Borriol;5279;2668;2611;2017
12;Castellón/Castelló;033;Cabanes;2913;1475;1438;2017
12;Castellón/Castelló;034;Càlig;1959;997;962;2017
12;Castellón/Castelló;036;Canet lo Roig;706;343;363;2017
12;Castellón/Castelló;037;Castell de Cabres;17;10;7;2017
12;Castellón/Castelló;038;Castellfort;198;106;92;2017
12;Castellón/Castelló;039;Castellnovo;966;490;476;2017
12;Castellón/Castelló;040;Castellón de la Plana/Castelló de la Plana;169498;82003;87495;2017
12;Castellón/Castelló;041;Castillo de Villamalefa;103;67;36;2017
12;Castellón/Castelló;042;Catí;757;374;383;2017
12;Castellón/Castelló;043;Caudiel;653;339;314;2017
12;Castellón/Castelló;044;Cervera del Maestre;620;296;324;2017
12;Castellón/Castelló;053;Chilches/Xilxes;2658;1392;1266;2017
12;Castellón/Castelló;055;Chodos/Xodos;115;66;49;2017
12;Castellón/Castelló;056;Chóvar;303;156;147;2017
12;Castellón/Castelló;045;Cinctorres;411;196;215;2017
12;Castellón/Castelló;046;Cirat;216;122;94;2017
12;Castellón/Castelló;048;Cortes de Arenoso;298;161;137;2017
12;Castellón/Castelló;049;Costur;532;276;256;2017
12;Castellón/Castelló;050;Coves de Vinromà, les;1836;917;919;2017
12;Castellón/Castelló;051;Culla;516;267;249;2017
12;Castellón/Castelló;057;Eslida;774;391;383;2017
12;Castellón/Castelló;058;Espadilla;73;43;30;2017
12;Castellón/Castelló;059;Fanzara;272;140;132;2017
12;Castellón/Castelló;060;Figueroles;537;271;266;2017
12;Castellón/Castelló;061;Forcall;438;214;224;2017
12;Castellón/Castelló;063;Fuente la Reina;43;24;19;2017
12;Castellón/Castelló;064;Fuentes de Ayódar;106;58;48;2017
12;Castellón/Castelló;065;Gaibiel;199;109;90;2017
12;Castellón/Castelló;067;Geldo;633;318;315;2017
12;Castellón/Castelló;068;Herbés;48;26;22;2017
12;Castellón/Castelló;069;Higueras;71;40;31;2017
12;Castellón/Castelló;070;Jana, la;684;340;344;2017
12;Castellón/Castelló;071;Jérica;1550;795;755;2017
12;Castellón/Castelló;074;Llosa, la;973;481;492;2017
12;Castellón/Castelló;072;Llucena/Lucena del Cid;1331;671;660;2017
12;Castellón/Castelló;073;Ludiente;160;91;69;2017
12;Castellón/Castelló;075;Mata de Morella, la;173;89;84;2017
12;Castellón/Castelló;076;Matet;86;46;40;2017
12;Castellón/Castelló;077;Moncofa;6092;3170;2922;2017
12;Castellón/Castelló;078;Montán;365;176;189;2017
12;Castellón/Castelló;079;Montanejos;502;258;244;2017
12;Castellón/Castelló;080;Morella;2441;1213;1228;2017
12;Castellón/Castelló;081;Navajas;714;375;339;2017
12;Castellón/Castelló;082;Nules;13266;6611;6655;2017
12;Castellón/Castelló;083;Olocau del Rey;118;66;52;2017
12;Castellón/Castelló;084;Onda;24807;12455;12352;2017
12;Castellón/Castelló;085;Oropesa del Mar/Orpesa;8983;4635;4348;2017
12;Castellón/Castelló;087;Palanques;34;19;15;2017
12;Castellón/Castelló;088;Pavías;63;38;25;2017
12;Castellón/Castelló;089;Peníscola/Peñíscola;7413;3718;3695;2017
12;Castellón/Castelló;090;Pina de Montalgrao;121;59;62;2017
12;Castellón/Castelló;093;Pobla de Benifassà, la;203;114;89;2017
12;Castellón/Castelló;094;Pobla Tornesa, la;1227;638;589;2017
12;Castellón/Castelló;091;Portell de Morella;200;98;102;2017
12;Castellón/Castelló;092;Puebla de Arenoso;133;68;65;2017
12;Castellón/Castelló;095;Ribesalbes;1210;616;594;2017
12;Castellón/Castelló;096;Rossell;987;524;463;2017
12;Castellón/Castelló;097;Sacañet;62;41;21;2017
12;Castellón/Castelló;098;Salzadella, la;743;376;367;2017
12;Castellón/Castelló;101;San Rafael del Río;464;227;237;2017
12;Castellón/Castelló;902;Sant Joan de Moró;3084;1606;1478;2017
12;Castellón/Castelló;099;Sant Jordi/San Jorge;937;483;454;2017
12;Castellón/Castelló;100;Sant Mateu;1958;959;999;2017
12;Castellón/Castelló;102;Santa Magdalena de Pulpis;765;412;353;2017
12;Castellón/Castelló;104;Segorbe;8969;4417;4552;2017
12;Castellón/Castelló;103;Serratella, la;101;52;49;2017
12;Castellón/Castelló;105;Sierra Engarcerán;1012;535;477;2017
12;Castellón/Castelló;106;Soneja;1468;714;754;2017
12;Castellón/Castelló;107;Sot de Ferrer;429;221;208;2017
12;Castellón/Castelló;108;Sueras/Suera;522;269;253;2017
12;Castellón/Castelló;109;Tales;808;407;401;2017
12;Castellón/Castelló;110;Teresa;250;128;122;2017
12;Castellón/Castelló;111;Tírig;437;223;214;2017
12;Castellón/Castelló;112;Todolella;136;76;60;2017
12;Castellón/Castelló;113;Toga;89;46;43;2017
12;Castellón/Castelló;114;Torás;225;120;105;2017
12;Castellón/Castelló;115;Toro, El;253;135;118;2017
12;Castellón/Castelló;116;Torralba del Pinar;57;28;29;2017
12;Castellón/Castelló;119;Torre d'En Besora, la;158;87;71;2017
12;Castellón/Castelló;120;Torre d'en Doménec, la;198;103;95;2017
12;Castellón/Castelló;117;Torreblanca;5419;2715;2704;2017
12;Castellón/Castelló;118;Torrechiva;77;46;31;2017
12;Castellón/Castelló;121;Traiguera;1434;721;713;2017
12;Castellón/Castelló;122;Useras/Useres, les;970;500;470;2017
12;Castellón/Castelló;124;Vall d'Alba;2781;1452;1329;2017
12;Castellón/Castelló;125;Vall de Almonacid;272;138;134;2017
12;Castellón/Castelló;126;Vall d'Uixó, la;31733;15670;16063;2017
12;Castellón/Castelló;123;Vallat;50;23;27;2017
12;Castellón/Castelló;127;Vallibona;77;43;34;2017
12;Castellón/Castelló;128;Vilafamés;1822;971;851;2017
12;Castellón/Castelló;132;Vilanova d'Alcolea;586;309;277;2017
12;Castellón/Castelló;134;Vilar de Canes;177;92;85;2017
12;Castellón/Castelló;135;Vila-real;50334;24958;25376;2017
12;Castellón/Castelló;136;Vilavella, la;3215;1609;1606;2017
12;Castellón/Castelló;129;Villafranca del Cid/Vilafranca;2267;1109;1158;2017
12;Castellón/Castelló;130;Villahermosa del Río;477;262;215;2017
12;Castellón/Castelló;131;Villamalur;62;38;24;2017
12;Castellón/Castelló;133;Villanueva de Viver;61;34;27;2017
12;Castellón/Castelló;137;Villores;42;22;20;2017
12;Castellón/Castelló;138;Vinaròs;28292;13990;14302;2017
12;Castellón/Castelló;139;Vistabella del Maestrat;352;192;160;2017
12;Castellón/Castelló;140;Viver;1509;784;725;2017
12;Castellón/Castelló;052;Xert;733;347;386;2017
12;Castellón/Castelló;141;Zorita del Maestrazgo;118;61;57;2017
12;Castellón/Castelló;142;Zucaina;189;107;82;2017
13;Ciudad Real;001;Abenójar;1438;736;702;2017
13;Ciudad Real;002;Agudo;1720;871;849;2017
13;Ciudad Real;003;Alamillo;519;265;254;2017
13;Ciudad Real;004;Albaladejo;1201;618;583;2017
13;Ciudad Real;005;Alcázar de San Juan;30943;15052;15891;2017
13;Ciudad Real;006;Alcoba;610;310;300;2017
13;Ciudad Real;007;Alcolea de Calatrava;1458;746;712;2017
13;Ciudad Real;008;Alcubillas;493;252;241;2017
13;Ciudad Real;009;Aldea del Rey;1698;862;836;2017
13;Ciudad Real;010;Alhambra;1009;518;491;2017
13;Ciudad Real;011;Almadén;5537;2654;2883;2017
13;Ciudad Real;012;Almadenejos;440;227;213;2017
13;Ciudad Real;013;Almagro;8983;4417;4566;2017
13;Ciudad Real;014;Almedina;548;293;255;2017
13;Ciudad Real;015;Almodóvar del Campo;6273;3160;3113;2017
13;Ciudad Real;016;Almuradiel;820;398;422;2017
13;Ciudad Real;017;Anchuras;323;166;157;2017
13;Ciudad Real;903;Arenales de San Gregorio;622;319;303;2017
13;Ciudad Real;018;Arenas de San Juan;1051;529;522;2017
13;Ciudad Real;019;Argamasilla de Alba;6928;3480;3448;2017
13;Ciudad Real;020;Argamasilla de Calatrava;5924;3010;2914;2017
13;Ciudad Real;021;Arroba de los Montes;452;239;213;2017
13;Ciudad Real;022;Ballesteros de Calatrava;384;192;192;2017
13;Ciudad Real;023;Bolaños de Calatrava;11882;6028;5854;2017
13;Ciudad Real;024;Brazatortas;1020;533;487;2017
13;Ciudad Real;025;Cabezarados;322;173;149;2017
13;Ciudad Real;026;Cabezarrubias del Puerto;490;254;236;2017
13;Ciudad Real;027;Calzada de Calatrava;3911;1957;1954;2017
13;Ciudad Real;028;Campo de Criptana;13763;6875;6888;2017
13;Ciudad Real;029;Cañada de Calatrava;103;61;42;2017
13;Ciudad Real;030;Caracuel de Calatrava;141;84;57;2017
13;Ciudad Real;031;Carrión de Calatrava;3069;1541;1528;2017
13;Ciudad Real;032;Carrizosa;1251;636;615;2017
13;Ciudad Real;033;Castellar de Santiago;1966;990;976;2017
13;Ciudad Real;038;Chillón;1857;908;949;2017
13;Ciudad Real;034;Ciudad Real;74641;35286;39355;2017
13;Ciudad Real;035;Corral de Calatrava;1153;568;585;2017
13;Ciudad Real;036;Cortijos, Los;904;482;422;2017
13;Ciudad Real;037;Cózar;1017;500;517;2017
13;Ciudad Real;039;Daimiel;18176;9052;9124;2017
13;Ciudad Real;040;Fernán Caballero;1027;519;508;2017
13;Ciudad Real;041;Fontanarejo;265;145;120;2017
13;Ciudad Real;042;Fuencaliente;1028;543;485;2017
13;Ciudad Real;043;Fuenllana;242;126;116;2017
13;Ciudad Real;044;Fuente el Fresno;3311;1719;1592;2017
13;Ciudad Real;045;Granátula de Calatrava;764;378;386;2017
13;Ciudad Real;046;Guadalmez;763;380;383;2017
13;Ciudad Real;047;Herencia;8431;4291;4140;2017
13;Ciudad Real;048;Hinojosas de Calatrava;529;269;260;2017
13;Ciudad Real;049;Horcajo de los Montes;935;471;464;2017
13;Ciudad Real;050;Labores, Las;580;290;290;2017
13;Ciudad Real;904;Llanos del Caudillo;722;362;360;2017
13;Ciudad Real;051;Luciana;382;205;177;2017
13;Ciudad Real;052;Malagón;8108;4019;4089;2017
13;Ciudad Real;053;Manzanares;18206;8999;9207;2017
13;Ciudad Real;054;Membrilla;6050;3033;3017;2017
13;Ciudad Real;055;Mestanza;711;352;359;2017
13;Ciudad Real;056;Miguelturra;15225;7662;7563;2017
13;Ciudad Real;057;Montiel;1364;715;649;2017
13;Ciudad Real;058;Moral de Calatrava;5309;2682;2627;2017
13;Ciudad Real;059;Navalpino;231;117;114;2017
13;Ciudad Real;060;Navas de Estena;246;133;113;2017
13;Ciudad Real;061;Pedro Muñoz;7467;3780;3687;2017
13;Ciudad Real;062;Picón;671;349;322;2017
13;Ciudad Real;063;Piedrabuena;4517;2287;2230;2017
13;Ciudad Real;064;Poblete;2465;1267;1198;2017
13;Ciudad Real;065;Porzuna;3633;1866;1767;2017
13;Ciudad Real;066;Pozuelo de Calatrava;3382;1736;1646;2017
13;Ciudad Real;067;Pozuelos de Calatrava, Los;385;202;183;2017
13;Ciudad Real;068;Puebla de Don Rodrigo;1213;665;548;2017
13;Ciudad Real;069;Puebla del Príncipe;729;370;359;2017
13;Ciudad Real;070;Puerto Lápice;947;467;480;2017
13;Ciudad Real;071;Puertollano;48477;23449;25028;2017
13;Ciudad Real;072;Retuerta del Bullaque;991;541;450;2017
13;Ciudad Real;901;Robledo, El;1111;589;522;2017
13;Ciudad Real;902;Ruidera;558;282;276;2017
13;Ciudad Real;073;Saceruela;596;325;271;2017
13;Ciudad Real;074;San Carlos del Valle;1143;593;550;2017
13;Ciudad Real;075;San Lorenzo de Calatrava;212;112;100;2017
13;Ciudad Real;076;Santa Cruz de los Cáñamos;530;264;266;2017
13;Ciudad Real;077;Santa Cruz de Mudela;4195;2078;2117;2017
13;Ciudad Real;078;Socuéllamos;12342;6240;6102;2017
13;Ciudad Real;080;Solana del Pino;336;180;156;2017
13;Ciudad Real;079;Solana, La;15640;7880;7760;2017
13;Ciudad Real;081;Terrinches;711;367;344;2017
13;Ciudad Real;082;Tomelloso;36281;18002;18279;2017
13;Ciudad Real;083;Torralba de Calatrava;3006;1491;1515;2017
13;Ciudad Real;084;Torre de Juan Abad;1035;505;530;2017
13;Ciudad Real;085;Torrenueva;2788;1412;1376;2017
13;Ciudad Real;086;Valdemanco del Esteras;178;94;84;2017
13;Ciudad Real;087;Valdepeñas;30224;14790;15434;2017
13;Ciudad Real;088;Valenzuela de Calatrava;700;323;377;2017
13;Ciudad Real;089;Villahermosa;1908;906;1002;2017
13;Ciudad Real;090;Villamanrique;1210;591;619;2017
13;Ciudad Real;091;Villamayor de Calatrava;615;308;307;2017
13;Ciudad Real;092;Villanueva de la Fuente;2185;1118;1067;2017
13;Ciudad Real;093;Villanueva de los Infantes;5064;2470;2594;2017
13;Ciudad Real;094;Villanueva de San Carlos;308;161;147;2017
13;Ciudad Real;095;Villar del Pozo;89;49;40;2017
13;Ciudad Real;096;Villarrubia de los Ojos;10026;4973;5053;2017
13;Ciudad Real;097;Villarta de San Juan;2863;1437;1426;2017
13;Ciudad Real;098;Viso del Marqués;2378;1157;1221;2017
14;Córdoba;001;Adamuz;4236;2173;2063;2017
14;Córdoba;002;Aguilar de la Frontera;13476;6784;6692;2017
14;Córdoba;003;Alcaracejos;1496;724;772;2017
14;Córdoba;004;Almedinilla;2455;1232;1223;2017
14;Córdoba;005;Almodóvar del Río;7982;4015;3967;2017
14;Córdoba;006;Añora;1553;767;786;2017
14;Córdoba;007;Baena;19523;9977;9546;2017
14;Córdoba;008;Belalcázar;3336;1611;1725;2017
14;Córdoba;009;Belmez;2913;1420;1493;2017
14;Córdoba;010;Benamejí;5025;2519;2506;2017
14;Córdoba;011;Blázquez, Los;691;358;333;2017
14;Córdoba;012;Bujalance;7599;3796;3803;2017
14;Córdoba;013;Cabra;20557;10055;10502;2017
14;Córdoba;014;Cañete de las Torres;3000;1541;1459;2017
14;Córdoba;015;Carcabuey;2471;1261;1210;2017
14;Córdoba;016;Cardeña;1532;769;763;2017
14;Córdoba;017;Carlota, La;14010;7030;6980;2017
14;Córdoba;018;Carpio, El;4480;2229;2251;2017
14;Córdoba;019;Castro del Río;7881;3918;3963;2017
14;Córdoba;020;Conquista;418;208;210;2017
14;Córdoba;021;Córdoba;325916;156522;169394;2017
14;Córdoba;022;Doña Mencía;4718;2305;2413;2017
14;Córdoba;023;Dos Torres;2426;1202;1224;2017
14;Córdoba;024;Encinas Reales;2297;1137;1160;2017
14;Córdoba;025;Espejo;3375;1706;1669;2017
14;Córdoba;026;Espiel;2474;1236;1238;2017
14;Córdoba;027;Fernán-Núñez;9680;4848;4832;2017
14;Córdoba;028;Fuente la Lancha;345;178;167;2017
14;Córdoba;029;Fuente Obejuna;4734;2423;2311;2017
14;Córdoba;030;Fuente Palmera;10871;5468;5403;2017
14;Córdoba;031;Fuente-Tójar;705;335;370;2017
14;Córdoba;032;Granjuela, La;474;244;230;2017
14;Córdoba;033;Guadalcázar;1605;803;802;2017
14;Córdoba;034;Guijo, El;355;188;167;2017
14;Córdoba;035;Hinojosa del Duque;6922;3392;3530;2017
14;Córdoba;036;Hornachuelos;4575;2293;2282;2017
14;Córdoba;037;Iznájar;4405;2209;2196;2017
14;Córdoba;038;Lucena;42511;21202;21309;2017
14;Córdoba;039;Luque;3051;1540;1511;2017
14;Córdoba;040;Montalbán de Córdoba;4420;2213;2207;2017
14;Córdoba;041;Montemayor;3902;1960;1942;2017
14;Córdoba;042;Montilla;23209;11487;11722;2017
14;Córdoba;043;Montoro;9518;4661;4857;2017
14;Córdoba;044;Monturque;1994;990;1004;2017
14;Córdoba;045;Moriles;3775;1890;1885;2017
14;Córdoba;046;Nueva Carteya;5396;2739;2657;2017
14;Córdoba;047;Obejo;2011;1053;958;2017
14;Córdoba;048;Palenciana;1515;764;751;2017
14;Córdoba;049;Palma del Río;21162;10531;10631;2017
14;Córdoba;050;Pedro Abad;2864;1451;1413;2017
14;Córdoba;051;Pedroche;1567;757;810;2017
14;Córdoba;052;Peñarroya-Pueblonuevo;11031;5335;5696;2017
14;Córdoba;053;Posadas;7411;3696;3715;2017
14;Córdoba;054;Pozoblanco;17285;8437;8848;2017
14;Córdoba;055;Priego de Córdoba;22697;11070;11627;2017
14;Córdoba;056;Puente Genil;30173;14994;15179;2017
14;Córdoba;057;Rambla, La;7547;3762;3785;2017
14;Córdoba;058;Rute;9994;4956;5038;2017
14;Córdoba;059;San Sebastián de los Ballesteros;808;405;403;2017
14;Córdoba;061;Santa Eufemia;794;397;397;2017
14;Córdoba;060;Santaella;6049;3064;2985;2017
14;Córdoba;062;Torrecampo;1123;547;576;2017
14;Córdoba;063;Valenzuela;1189;588;601;2017
14;Córdoba;064;Valsequillo;367;178;189;2017
14;Córdoba;065;Victoria, La;2327;1159;1168;2017
14;Córdoba;066;Villa del Río;7251;3628;3623;2017
14;Córdoba;067;Villafranca de Córdoba;4886;2488;2398;2017
14;Córdoba;068;Villaharta;662;324;338;2017
14;Córdoba;069;Villanueva de Córdoba;8886;4402;4484;2017
14;Córdoba;070;Villanueva del Duque;1504;753;751;2017
14;Córdoba;071;Villanueva del Rey;1081;533;548;2017
14;Córdoba;072;Villaralto;1171;585;586;2017
14;Córdoba;073;Villaviciosa de Córdoba;3347;1716;1631;2017
14;Córdoba;074;Viso, El;2586;1279;1307;2017
14;Córdoba;075;Zuheros;644;326;318;2017
15;Coruña, A;001;Abegondo;5467;2698;2769;2017
15;Coruña, A;002;Ames;30835;14811;16024;2017
15;Coruña, A;003;Aranga;1935;982;953;2017
15;Coruña, A;004;Ares;5658;2791;2867;2017
15;Coruña, A;005;Arteixo;31534;15686;15848;2017
15;Coruña, A;006;Arzúa;6123;3053;3070;2017
15;Coruña, A;007;Baña, A;3541;1690;1851;2017
15;Coruña, A;008;Bergondo;6623;3235;3388;2017
15;Coruña, A;009;Betanzos;12941;6136;6805;2017
15;Coruña, A;010;Boimorto;2040;1042;998;2017
15;Coruña, A;011;Boiro;18885;9227;9658;2017
15;Coruña, A;012;Boqueixón;4242;2096;2146;2017
15;Coruña, A;013;Brión;7699;3716;3983;2017
15;Coruña, A;014;Cabana de Bergantiños;4347;2099;2248;2017
15;Coruña, A;015;Cabanas;3314;1617;1697;2017
15;Coruña, A;016;Camariñas;5419;2641;2778;2017
15;Coruña, A;017;Cambre;24348;11902;12446;2017
15;Coruña, A;018;Capela, A;1274;633;641;2017
15;Coruña, A;019;Carballo;31195;15247;15948;2017
15;Coruña, A;901;Cariño;4004;1981;2023;2017
15;Coruña, A;020;Carnota;4060;1942;2118;2017
15;Coruña, A;021;Carral;6237;3064;3173;2017
15;Coruña, A;022;Cedeira;6888;3424;3464;2017
15;Coruña, A;023;Cee;7539;3608;3931;2017
15;Coruña, A;024;Cerceda;4992;2461;2531;2017
15;Coruña, A;025;Cerdido;1170;568;602;2017
15;Coruña, A;027;Coirós;1801;889;912;2017
15;Coruña, A;028;Corcubión;1592;770;822;2017
15;Coruña, A;029;Coristanco;6313;3024;3289;2017
15;Coruña, A;030;Coruña, A;244099;113336;130763;2017
15;Coruña, A;031;Culleredo;29982;14556;15426;2017
15;Coruña, A;032;Curtis;3968;1978;1990;2017
15;Coruña, A;033;Dodro;2832;1373;1459;2017
15;Coruña, A;034;Dumbría;3053;1464;1589;2017
15;Coruña, A;035;Fene;13110;6271;6839;2017
15;Coruña, A;036;Ferrol;67569;31692;35877;2017
15;Coruña, A;037;Fisterra;4734;2402;2332;2017
15;Coruña, A;038;Frades;2422;1206;1216;2017
15;Coruña, A;039;Irixoa;1361;676;685;2017
15;Coruña, A;041;Laracha, A;11281;5538;5743;2017
15;Coruña, A;040;Laxe;3090;1559;1531;2017
15;Coruña, A;042;Lousame;3447;1681;1766;2017
15;Coruña, A;043;Malpica de Bergantiños;5518;2696;2822;2017
15;Coruña, A;044;Mañón;1391;677;714;2017
15;Coruña, A;045;Mazaricos;4014;1920;2094;2017
15;Coruña, A;046;Melide;7503;3681;3822;2017
15;Coruña, A;047;Mesía;2637;1304;1333;2017
15;Coruña, A;048;Miño;5905;2950;2955;2017
15;Coruña, A;049;Moeche;1230;574;656;2017
15;Coruña, A;050;Monfero;1985;1028;957;2017
15;Coruña, A;051;Mugardos;5303;2599;2704;2017
15;Coruña, A;053;Muros;8792;4254;4538;2017
15;Coruña, A;052;Muxía;4852;2370;2482;2017
15;Coruña, A;054;Narón;39280;19002;20278;2017
15;Coruña, A;055;Neda;5165;2527;2638;2017
15;Coruña, A;056;Negreira;6883;3324;3559;2017
15;Coruña, A;057;Noia;14295;6844;7451;2017
15;Coruña, A;058;Oleiros;35198;17012;18186;2017
15;Coruña, A;059;Ordes;12580;6143;6437;2017
15;Coruña, A;060;Oroso;7452;3678;3774;2017
15;Coruña, A;061;Ortigueira;5966;2869;3097;2017
15;Coruña, A;062;Outes;6514;3126;3388;2017
15;Coruña, A;902;Oza-Cesuras;5133;2582;2551;2017
15;Coruña, A;064;Paderne;2441;1192;1249;2017
15;Coruña, A;065;Padrón;8463;4055;4408;2017
15;Coruña, A;066;Pino, O;4644;2334;2310;2017
15;Coruña, A;067;Pobra do Caramiñal, A;9440;4603;4837;2017
15;Coruña, A;068;Ponteceso;5613;2814;2799;2017
15;Coruña, A;069;Pontedeume;7937;3809;4128;2017
15;Coruña, A;070;Pontes de García Rodríguez, As;10324;5060;5264;2017
15;Coruña, A;071;Porto do Son;9271;4610;4661;2017
15;Coruña, A;072;Rianxo;11188;5456;5732;2017
15;Coruña, A;073;Ribeira;27159;13386;13773;2017
15;Coruña, A;074;Rois;4627;2206;2421;2017
15;Coruña, A;075;Sada;15242;7470;7772;2017
15;Coruña, A;076;San Sadurniño;2877;1429;1448;2017
15;Coruña, A;077;Santa Comba;9477;4585;4892;2017
15;Coruña, A;078;Santiago de Compostela;96456;44708;51748;2017
15;Coruña, A;079;Santiso;1630;836;794;2017
15;Coruña, A;080;Sobrado;1847;949;898;2017
15;Coruña, A;081;Somozas, As;1128;566;562;2017
15;Coruña, A;082;Teo;18478;9067;9411;2017
15;Coruña, A;083;Toques;1173;611;562;2017
15;Coruña, A;084;Tordoia;3433;1617;1816;2017
15;Coruña, A;085;Touro;3693;1837;1856;2017
15;Coruña, A;086;Trazo;3186;1580;1606;2017
15;Coruña, A;088;Val do Dubra;3931;1881;2050;2017
15;Coruña, A;087;Valdoviño;6594;3204;3390;2017
15;Coruña, A;089;Vedra;5051;2478;2573;2017
15;Coruña, A;091;Vilarmaior;1249;638;611;2017
15;Coruña, A;090;Vilasantar;1241;650;591;2017
15;Coruña, A;092;Vimianzo;7270;3493;3777;2017
15;Coruña, A;093;Zas;4671;2262;2409;2017
16;Cuenca;001;Abia de la Obispalía;66;40;26;2017
16;Cuenca;002;Acebrón, El;237;116;121;2017
16;Cuenca;003;Alarcón;148;68;80;2017
16;Cuenca;004;Albaladejo del Cuende;263;132;131;2017
16;Cuenca;005;Albalate de las Nogueras;276;144;132;2017
16;Cuenca;006;Albendea;130;60;70;2017
16;Cuenca;007;Alberca de Záncara, La;1622;826;796;2017
16;Cuenca;008;Alcalá de la Vega;90;50;40;2017
16;Cuenca;009;Alcantud;60;35;25;2017
16;Cuenca;010;Alcázar del Rey;145;72;73;2017
16;Cuenca;011;Alcohujate;34;18;16;2017
16;Cuenca;012;Alconchel de la Estrella;98;55;43;2017
16;Cuenca;013;Algarra;27;17;10;2017
16;Cuenca;014;Aliaguilla;674;349;325;2017
16;Cuenca;015;Almarcha, La;376;207;169;2017
16;Cuenca;016;Almendros;241;142;99;2017
16;Cuenca;017;Almodóvar del Pinar;421;227;194;2017
16;Cuenca;018;Almonacid del Marquesado;433;220;213;2017
16;Cuenca;019;Altarejos;217;115;102;2017
16;Cuenca;020;Arandilla del Arroyo;13;7;6;2017
16;Cuenca;905;Arcas;1691;855;836;2017
16;Cuenca;022;Arcos de la Sierra;85;50;35;2017
16;Cuenca;024;Arguisuelas;153;86;67;2017
16;Cuenca;025;Arrancacepas;28;15;13;2017
16;Cuenca;026;Atalaya del Cañavate;104;52;52;2017
16;Cuenca;027;Barajas de Melo;913;486;427;2017
16;Cuenca;029;Barchín del Hoyo;88;53;35;2017
16;Cuenca;030;Bascuñana de San Pedro;22;16;6;2017
16;Cuenca;031;Beamud;37;18;19;2017
16;Cuenca;032;Belinchón;314;161;153;2017
16;Cuenca;033;Belmonte;1958;976;982;2017
16;Cuenca;034;Belmontejo;181;101;80;2017
16;Cuenca;035;Beteta;277;135;142;2017
16;Cuenca;036;Boniches;148;73;75;2017
16;Cuenca;038;Buciegas;45;28;17;2017
16;Cuenca;039;Buenache de Alarcón;479;252;227;2017
16;Cuenca;040;Buenache de la Sierra;93;55;38;2017
16;Cuenca;041;Buendía;417;222;195;2017
16;Cuenca;042;Campillo de Altobuey;1379;683;696;2017
16;Cuenca;043;Campillos-Paravientos;115;63;52;2017
16;Cuenca;044;Campillos-Sierra;32;13;19;2017
16;Cuenca;901;Campos del Paraíso;798;401;397;2017
16;Cuenca;045;Canalejas del Arroyo;246;131;115;2017
16;Cuenca;046;Cañada del Hoyo;254;129;125;2017
16;Cuenca;047;Cañada Juncosa;255;137;118;2017
16;Cuenca;048;Cañamares;467;254;213;2017
16;Cuenca;049;Cañavate, El;154;82;72;2017
16;Cuenca;050;Cañaveras;271;133;138;2017
16;Cuenca;051;Cañaveruelas;139;71;68;2017
16;Cuenca;052;Cañete;774;404;370;2017
16;Cuenca;053;Cañizares;480;263;217;2017
16;Cuenca;055;Carboneras de Guadazaón;808;418;390;2017
16;Cuenca;056;Cardenete;501;272;229;2017
16;Cuenca;057;Carrascosa;72;44;28;2017
16;Cuenca;058;Carrascosa de Haro;115;58;57;2017
16;Cuenca;060;Casas de Benítez;875;430;445;2017
16;Cuenca;061;Casas de Fernando Alonso;1208;629;579;2017
16;Cuenca;062;Casas de Garcimolina;28;18;10;2017
16;Cuenca;063;Casas de Guijarro;111;60;51;2017
16;Cuenca;064;Casas de Haro;847;447;400;2017
16;Cuenca;065;Casas de los Pinos;443;220;223;2017
16;Cuenca;066;Casasimarro;3072;1601;1471;2017
16;Cuenca;067;Castejón;166;82;84;2017
16;Cuenca;068;Castillejo de Iniesta;160;89;71;2017
16;Cuenca;070;Castillejo-Sierra;29;14;15;2017
16;Cuenca;072;Castillo de Garcimuñoz;145;82;63;2017
16;Cuenca;071;Castillo-Albaráñez;22;10;12;2017
16;Cuenca;073;Cervera del Llano;221;114;107;2017
16;Cuenca;023;Chillarón de Cuenca;591;318;273;2017
16;Cuenca;081;Chumillas;54;28;26;2017
16;Cuenca;074;Cierva, La;35;22;13;2017
16;Cuenca;078;Cuenca;54876;26225;28651;2017
16;Cuenca;079;Cueva del Hierro;34;25;9;2017
16;Cuenca;082;Enguídanos;331;180;151;2017
16;Cuenca;083;Fresneda de Altarejos;51;25;26;2017
16;Cuenca;084;Fresneda de la Sierra;53;30;23;2017
16;Cuenca;085;Frontera, La;157;79;78;2017
16;Cuenca;086;Fuente de Pedro Naharro;1210;626;584;2017
16;Cuenca;087;Fuentelespino de Haro;249;129;120;2017
16;Cuenca;088;Fuentelespino de Moya;107;57;50;2017
16;Cuenca;904;Fuentenava de Jábaga;553;294;259;2017
16;Cuenca;089;Fuentes;447;234;213;2017
16;Cuenca;091;Fuertescusa;70;38;32;2017
16;Cuenca;092;Gabaldón;182;106;76;2017
16;Cuenca;093;Garaballa;74;39;35;2017
16;Cuenca;094;Gascueña;169;94;75;2017
16;Cuenca;095;Graja de Campalbo;92;52;40;2017
16;Cuenca;096;Graja de Iniesta;365;191;174;2017
16;Cuenca;097;Henarejos;153;76;77;2017
16;Cuenca;098;Herrumblar, El;676;344;332;2017
16;Cuenca;099;Hinojosa, La;200;101;99;2017
16;Cuenca;100;Hinojosos, Los;814;402;412;2017
16;Cuenca;101;Hito, El;154;86;68;2017
16;Cuenca;102;Honrubia;1602;801;801;2017
16;Cuenca;103;Hontanaya;290;157;133;2017
16;Cuenca;104;Hontecillas;51;28;23;2017
16;Cuenca;106;Horcajo de Santiago;3542;1798;1744;2017
16;Cuenca;107;Huélamo;103;61;42;2017
16;Cuenca;108;Huelves;54;28;26;2017
16;Cuenca;109;Huérguina;51;26;25;2017
16;Cuenca;110;Huerta de la Obispalía;134;81;53;2017
16;Cuenca;111;Huerta del Marquesado;200;118;82;2017
16;Cuenca;112;Huete;1776;917;859;2017
16;Cuenca;113;Iniesta;4337;2141;2196;2017
16;Cuenca;115;Laguna del Marquesado;45;26;19;2017
16;Cuenca;116;Lagunaseca;75;43;32;2017
16;Cuenca;117;Landete;1229;618;611;2017
16;Cuenca;118;Ledaña;1614;804;810;2017
16;Cuenca;119;Leganiel;182;93;89;2017
16;Cuenca;121;Majadas, Las;266;135;131;2017
16;Cuenca;122;Mariana;290;151;139;2017
16;Cuenca;123;Masegosa;73;42;31;2017
16;Cuenca;124;Mesas, Las;2312;1179;1133;2017
16;Cuenca;125;Minglanilla;2232;1146;1086;2017
16;Cuenca;126;Mira;929;460;469;2017
16;Cuenca;128;Monreal del Llano;69;36;33;2017
16;Cuenca;129;Montalbanejo;103;58;45;2017
16;Cuenca;130;Montalbo;639;343;296;2017
16;Cuenca;131;Monteagudo de las Salinas;120;68;52;2017
16;Cuenca;132;Mota de Altarejos;36;24;12;2017
16;Cuenca;133;Mota del Cuervo;6033;3003;3030;2017
16;Cuenca;134;Motilla del Palancar;5929;2947;2982;2017
16;Cuenca;135;Moya;153;90;63;2017
16;Cuenca;137;Narboneta;49;24;25;2017
16;Cuenca;139;Olivares de Júcar;337;175;162;2017
16;Cuenca;140;Olmeda de la Cuesta;29;17;12;2017
16;Cuenca;141;Olmeda del Rey;132;66;66;2017
16;Cuenca;142;Olmedilla de Alarcón;159;91;68;2017
16;Cuenca;143;Olmedilla de Eliz;16;11;5;2017
16;Cuenca;145;Osa de la Vega;501;259;242;2017
16;Cuenca;146;Pajarón;79;42;37;2017
16;Cuenca;147;Pajaroncillo;75;43;32;2017
16;Cuenca;148;Palomares del Campo;642;327;315;2017
16;Cuenca;149;Palomera;159;83;76;2017
16;Cuenca;150;Paracuellos;99;49;50;2017
16;Cuenca;151;Paredes;64;35;29;2017
16;Cuenca;152;Parra de las Vegas, La;39;23;16;2017
16;Cuenca;153;Pedernoso, El;1147;579;568;2017
16;Cuenca;154;Pedroñeras, Las;6581;3356;3225;2017
16;Cuenca;155;Peral, El;628;344;284;2017
16;Cuenca;156;Peraleja, La;95;55;40;2017
16;Cuenca;157;Pesquera, La;225;123;102;2017
16;Cuenca;158;Picazo, El;672;337;335;2017
16;Cuenca;159;Pinarejo;227;113;114;2017
16;Cuenca;160;Pineda de Gigüela;61;33;28;2017
16;Cuenca;161;Piqueras del Castillo;55;30;25;2017
16;Cuenca;162;Portalrubio de Guadamejud;26;13;13;2017
16;Cuenca;163;Portilla;69;36;33;2017
16;Cuenca;165;Poyatos;62;31;31;2017
16;Cuenca;166;Pozoamargo;302;160;142;2017
16;Cuenca;908;Pozorrubielos de la Mancha;196;93;103;2017
16;Cuenca;167;Pozorrubio de Santiago;315;145;170;2017
16;Cuenca;169;Pozuelo, El;54;34;20;2017
16;Cuenca;170;Priego;942;475;467;2017
16;Cuenca;171;Provencio, El;2453;1212;1241;2017
16;Cuenca;172;Puebla de Almenara;351;184;167;2017
16;Cuenca;174;Puebla del Salvador;192;107;85;2017
16;Cuenca;175;Quintanar del Rey;7533;3882;3651;2017
16;Cuenca;176;Rada de Haro;42;23;19;2017
16;Cuenca;177;Reíllo;105;56;49;2017
16;Cuenca;181;Rozalén del Monte;72;33;39;2017
16;Cuenca;185;Saceda-Trasierra;44;31;13;2017
16;Cuenca;186;Saelices;506;260;246;2017
16;Cuenca;187;Salinas del Manzano;85;48;37;2017
16;Cuenca;188;Salmeroncillos;107;63;44;2017
16;Cuenca;189;Salvacañete;315;162;153;2017
16;Cuenca;190;San Clemente;7247;3677;3570;2017
16;Cuenca;191;San Lorenzo de la Parrilla;1057;523;534;2017
16;Cuenca;192;San Martín de Boniches;46;24;22;2017
16;Cuenca;193;San Pedro Palmiches;57;33;24;2017
16;Cuenca;194;Santa Cruz de Moya;236;126;110;2017
16;Cuenca;196;Santa María de los Llanos;694;359;335;2017
16;Cuenca;195;Santa María del Campo Rus;607;298;309;2017
16;Cuenca;197;Santa María del Val;60;36;24;2017
16;Cuenca;198;Sisante;1685;848;837;2017
16;Cuenca;199;Solera de Gabaldón;28;12;16;2017
16;Cuenca;909;Sotorribas;776;400;376;2017
16;Cuenca;202;Talayuelas;898;476;422;2017
16;Cuenca;203;Tarancón;14834;7357;7477;2017
16;Cuenca;204;Tébar;283;150;133;2017
16;Cuenca;205;Tejadillos;130;65;65;2017
16;Cuenca;206;Tinajas;197;102;95;2017
16;Cuenca;209;Torralba;126;75;51;2017
16;Cuenca;211;Torrejoncillo del Rey;394;199;195;2017
16;Cuenca;212;Torrubia del Campo;265;130;135;2017
16;Cuenca;213;Torrubia del Castillo;40;24;16;2017
16;Cuenca;215;Tragacete;261;143;118;2017
16;Cuenca;216;Tresjuncos;316;169;147;2017
16;Cuenca;217;Tribaldos;91;48;43;2017
16;Cuenca;218;Uclés;219;116;103;2017
16;Cuenca;219;Uña;92;45;47;2017
16;Cuenca;906;Valdecolmenas, Los;77;47;30;2017
16;Cuenca;224;Valdemeca;87;48;39;2017
16;Cuenca;225;Valdemorillo de la Sierra;66;38;28;2017
16;Cuenca;227;Valdemoro-Sierra;114;68;46;2017
16;Cuenca;228;Valdeolivas;195;119;76;2017
16;Cuenca;902;Valdetórtola;140;79;61;2017
16;Cuenca;903;Valeras, Las;1547;820;727;2017
16;Cuenca;231;Valhermoso de la Fuente;47;25;22;2017
16;Cuenca;173;Valle de Altomira, El;221;124;97;2017
16;Cuenca;234;Valsalobre;26;15;11;2017
16;Cuenca;236;Valverde de Júcar;1111;557;554;2017
16;Cuenca;237;Valverdejo;99;52;47;2017
16;Cuenca;238;Vara de Rey;530;274;256;2017
16;Cuenca;239;Vega del Codorno;135;84;51;2017
16;Cuenca;240;Vellisca;102;58;44;2017
16;Cuenca;242;Villaconejos de Trabaque;358;180;178;2017
16;Cuenca;243;Villaescusa de Haro;494;245;249;2017
16;Cuenca;244;Villagarcía del Llano;775;396;379;2017
16;Cuenca;245;Villalba de la Sierra;499;243;256;2017
16;Cuenca;246;Villalba del Rey;546;296;250;2017
16;Cuenca;247;Villalgordo del Marquesado;78;40;38;2017
16;Cuenca;248;Villalpardo;976;485;491;2017
16;Cuenca;249;Villamayor de Santiago;2587;1316;1271;2017
16;Cuenca;250;Villanueva de Guadamejud;68;41;27;2017
16;Cuenca;251;Villanueva de la Jara;2259;1132;1127;2017
16;Cuenca;253;Villar de Cañas;402;211;191;2017
16;Cuenca;254;Villar de Domingo García;216;112;104;2017
16;Cuenca;255;Villar de la Encina;169;91;78;2017
16;Cuenca;263;Villar de Olalla;1250;668;582;2017
16;Cuenca;258;Villar del Humo;203;115;88;2017
16;Cuenca;259;Villar del Infantado;42;25;17;2017
16;Cuenca;910;Villar y Velasco;88;48;40;2017
16;Cuenca;264;Villarejo de Fuentes;475;242;233;2017
16;Cuenca;265;Villarejo de la Peñuela;20;7;13;2017
16;Cuenca;266;Villarejo-Periesteban;392;197;195;2017
16;Cuenca;269;Villares del Saz;485;236;249;2017
16;Cuenca;270;Villarrubio;196;107;89;2017
16;Cuenca;271;Villarta;829;415;414;2017
16;Cuenca;272;Villas de la Ventosa;230;133;97;2017
16;Cuenca;273;Villaverde y Pasaconsol;352;188;164;2017
16;Cuenca;274;Víllora;125;67;58;2017
16;Cuenca;275;Vindel;10;6;4;2017
16;Cuenca;276;Yémeda;24;17;7;2017
16;Cuenca;277;Zafra de Záncara;128;72;56;2017
16;Cuenca;278;Zafrilla;67;34;33;2017
16;Cuenca;279;Zarza de Tajo;248;138;110;2017
16;Cuenca;280;Zarzuela;192;103;89;2017
20;Gipuzkoa;001;Abaltzisketa;327;178;149;2017
20;Gipuzkoa;002;Aduna;472;257;215;2017
20;Gipuzkoa;016;Aia;2083;1112;971;2017
20;Gipuzkoa;003;Aizarnazabal;773;395;378;2017
20;Gipuzkoa;004;Albiztur;320;163;157;2017
20;Gipuzkoa;005;Alegia;1746;896;850;2017
20;Gipuzkoa;006;Alkiza;367;183;184;2017
20;Gipuzkoa;906;Altzaga;170;82;88;2017
20;Gipuzkoa;007;Altzo;427;220;207;2017
20;Gipuzkoa;008;Amezketa;936;510;426;2017
20;Gipuzkoa;009;Andoain;14659;7247;7412;2017
20;Gipuzkoa;010;Anoeta;2061;1065;996;2017
20;Gipuzkoa;011;Antzuola;2151;1081;1070;2017
20;Gipuzkoa;012;Arama;211;107;104;2017
20;Gipuzkoa;013;Aretxabaleta;7015;3512;3503;2017
20;Gipuzkoa;055;Arrasate/Mondragón;21977;10830;11147;2017
20;Gipuzkoa;014;Asteasu;1494;789;705;2017
20;Gipuzkoa;903;Astigarraga;6077;3113;2964;2017
20;Gipuzkoa;015;Ataun;1687;882;805;2017
20;Gipuzkoa;017;Azkoitia;11563;5758;5805;2017
20;Gipuzkoa;018;Azpeitia;14690;7348;7342;2017
20;Gipuzkoa;904;Baliarrain;142;79;63;2017
20;Gipuzkoa;019;Beasain;13854;6951;6903;2017
20;Gipuzkoa;020;Beizama;163;101;62;2017
20;Gipuzkoa;021;Belauntza;243;125;118;2017
20;Gipuzkoa;022;Berastegi;1080;550;530;2017
20;Gipuzkoa;074;Bergara;14691;7272;7419;2017
20;Gipuzkoa;023;Berrobi;581;304;277;2017
20;Gipuzkoa;024;Bidania-Goiatz;508;280;228;2017
20;Gipuzkoa;029;Deba;5502;2741;2761;2017
20;Gipuzkoa;069;Donostia/San Sebastián;186370;87640;98730;2017
20;Gipuzkoa;030;Eibar;27417;13264;14153;2017
20;Gipuzkoa;031;Elduain;238;121;117;2017
20;Gipuzkoa;033;Elgeta;1131;569;562;2017
20;Gipuzkoa;032;Elgoibar;11540;5739;5801;2017
20;Gipuzkoa;067;Errenteria;39439;19126;20313;2017
20;Gipuzkoa;066;Errezil;580;307;273;2017
20;Gipuzkoa;034;Eskoriatza;4089;2060;2029;2017
20;Gipuzkoa;035;Ezkio-Itsaso;609;317;292;2017
20;Gipuzkoa;038;Gabiria;494;263;231;2017
20;Gipuzkoa;037;Gaintza;127;74;53;2017
20;Gipuzkoa;907;Gaztelu;162;90;72;2017
20;Gipuzkoa;039;Getaria;2815;1429;1386;2017
20;Gipuzkoa;040;Hernani;20003;9772;10231;2017
20;Gipuzkoa;041;Hernialde;315;163;152;2017
20;Gipuzkoa;036;Hondarribia;17049;8456;8593;2017
20;Gipuzkoa;042;Ibarra;4191;2090;2101;2017
20;Gipuzkoa;043;Idiazabal;2304;1158;1146;2017
20;Gipuzkoa;044;Ikaztegieta;478;246;232;2017
20;Gipuzkoa;045;Irun;61855;30241;31614;2017
20;Gipuzkoa;046;Irura;1823;944;879;2017
20;Gipuzkoa;047;Itsasondo;642;322;320;2017
20;Gipuzkoa;048;Larraul;249;136;113;2017
20;Gipuzkoa;902;Lasarte-Oria;18166;8844;9322;2017
20;Gipuzkoa;049;Lazkao;5559;2800;2759;2017
20;Gipuzkoa;050;Leaburu;363;191;172;2017
20;Gipuzkoa;051;Legazpi;8438;4286;4152;2017
20;Gipuzkoa;052;Legorreta;1433;723;710;2017
20;Gipuzkoa;068;Leintz-Gatzaga;231;127;104;2017
20;Gipuzkoa;053;Lezo;6025;2974;3051;2017
20;Gipuzkoa;054;Lizartza;597;309;288;2017
20;Gipuzkoa;901;Mendaro;2012;1028;984;2017
20;Gipuzkoa;057;Mutiloa;249;137;112;2017
20;Gipuzkoa;056;Mutriku;5375;2715;2660;2017
20;Gipuzkoa;063;Oiartzun;10199;5040;5159;2017
20;Gipuzkoa;058;Olaberria;949;480;469;2017
20;Gipuzkoa;059;Oñati;11394;5631;5763;2017
20;Gipuzkoa;076;Ordizia;9998;4962;5036;2017
20;Gipuzkoa;905;Orendain;209;111;98;2017
20;Gipuzkoa;060;Orexa;127;70;57;2017
20;Gipuzkoa;061;Orio;5857;2949;2908;2017
20;Gipuzkoa;062;Ormaiztegi;1314;667;647;2017
20;Gipuzkoa;064;Pasaia;16096;7760;8336;2017
20;Gipuzkoa;070;Segura;1455;739;716;2017
20;Gipuzkoa;065;Soraluze-Placencia de las Armas;3901;1974;1927;2017
20;Gipuzkoa;071;Tolosa;19386;9341;10045;2017
20;Gipuzkoa;072;Urnieta;6242;3125;3117;2017
20;Gipuzkoa;077;Urretxu;6786;3353;3433;2017
20;Gipuzkoa;073;Usurbil;6159;3096;3063;2017
20;Gipuzkoa;075;Villabona;5878;2938;2940;2017
20;Gipuzkoa;078;Zaldibia;1578;815;763;2017
20;Gipuzkoa;079;Zarautz;23118;11283;11835;2017
20;Gipuzkoa;025;Zegama;1535;783;752;2017
20;Gipuzkoa;026;Zerain;248;115;133;2017
20;Gipuzkoa;027;Zestoa;3713;1950;1763;2017
20;Gipuzkoa;028;Zizurkil;2975;1493;1482;2017
20;Gipuzkoa;081;Zumaia;9979;4956;5023;2017
20;Gipuzkoa;080;Zumarraga;9848;4839;5009;2017
17;Girona;001;Agullana;831;414;417;2017
17;Girona;002;Aiguaviva;779;395;384;2017
17;Girona;003;Albanyà;141;75;66;2017
17;Girona;004;Albons;769;381;388;2017
17;Girona;006;Alp;1499;775;724;2017
17;Girona;007;Amer;2242;1090;1152;2017
17;Girona;008;Anglès;5479;2713;2766;2017
17;Girona;009;Arbúcies;6427;3307;3120;2017
17;Girona;010;Argelaguer;423;219;204;2017
17;Girona;011;Armentera, L';949;480;469;2017
17;Girona;012;Avinyonet de Puigventós;1565;781;784;2017
17;Girona;015;Banyoles;19397;9644;9753;2017
17;Girona;016;Bàscara;989;514;475;2017
17;Girona;013;Begur;3933;1974;1959;2017
17;Girona;018;Bellcaire d'Empordà;668;328;340;2017
17;Girona;019;Besalú;2443;1153;1290;2017
17;Girona;020;Bescanó;4929;2479;2450;2017
17;Girona;021;Beuda;181;101;80;2017
17;Girona;022;Bisbal d'Empordà, La;10775;5365;5410;2017
17;Girona;234;Biure;230;118;112;2017
17;Girona;023;Blanes;38813;19333;19480;2017
17;Girona;029;Boadella i les Escaules;267;140;127;2017
17;Girona;024;Bolvir;380;199;181;2017
17;Girona;025;Bordils;1693;854;839;2017
17;Girona;026;Borrassà;715;367;348;2017
17;Girona;027;Breda;3740;1844;1896;2017
17;Girona;028;Brunyola;369;185;184;2017
17;Girona;031;Cabanelles;265;150;115;2017
17;Girona;030;Cabanes;903;490;413;2017
17;Girona;032;Cadaqués;2794;1359;1435;2017
17;Girona;033;Caldes de Malavella;7351;3646;3705;2017
17;Girona;034;Calonge;10804;5409;5395;2017
17;Girona;035;Camós;687;343;344;2017
17;Girona;036;Campdevànol;3243;1585;1658;2017
17;Girona;037;Campelles;135;70;65;2017
17;Girona;038;Campllong;525;257;268;2017
17;Girona;039;Camprodon;2214;1091;1123;2017
17;Girona;040;Canet d'Adri;703;358;345;2017
17;Girona;041;Cantallops;322;162;160;2017
17;Girona;042;Capmany;623;316;307;2017
17;Girona;044;Cassà de la Selva;10231;5199;5032;2017
17;Girona;046;Castellfollit de la Roca;951;486;465;2017
17;Girona;047;Castelló d'Empúries;10791;5474;5317;2017
17;Girona;048;Castell-Platja d'Aro;10593;5214;5379;2017
17;Girona;189;Cellera de Ter, La;2006;1004;1002;2017
17;Girona;049;Celrà;5376;2695;2681;2017
17;Girona;050;Cervià de Ter;923;473;450;2017
17;Girona;051;Cistella;304;152;152;2017
17;Girona;054;Colera;481;242;239;2017
17;Girona;055;Colomers;179;88;91;2017
17;Girona;057;Corçà;1245;633;612;2017
17;Girona;056;Cornellà del Terri;2280;1169;1111;2017
17;Girona;058;Crespià;259;131;128;2017
17;Girona;901;Cruïlles, Monells i Sant Sadurní de l'Heura;1296;660;636;2017
17;Girona;060;Darnius;564;279;285;2017
17;Girona;061;Das;223;121;102;2017
17;Girona;062;Escala, L';10407;5313;5094;2017
17;Girona;063;Espinelves;203;99;104;2017
17;Girona;064;Espolla;423;209;214;2017
17;Girona;065;Esponellà;432;216;216;2017
17;Girona;005;Far d'Empordà, El;568;286;282;2017
17;Girona;066;Figueres;45961;22733;23228;2017
17;Girona;067;Flaçà;1050;509;541;2017
17;Girona;068;Foixà;313;163;150;2017
17;Girona;069;Fontanals de Cerdanya;448;235;213;2017
17;Girona;070;Fontanilles;138;78;60;2017
17;Girona;071;Fontcoberta;1481;737;744;2017
17;Girona;902;Forallac;1708;848;860;2017
17;Girona;073;Fornells de la Selva;2613;1294;1319;2017
17;Girona;074;Fortià;726;352;374;2017
17;Girona;075;Garrigàs;436;230;206;2017
17;Girona;076;Garrigoles;172;96;76;2017
17;Girona;077;Garriguella;851;418;433;2017
17;Girona;078;Ger;423;219;204;2017
17;Girona;079;Girona;99013;47379;51634;2017
17;Girona;080;Gombrèn;185;95;90;2017
17;Girona;081;Gualta;392;219;173;2017
17;Girona;082;Guils de Cerdanya;525;278;247;2017
17;Girona;083;Hostalric;4106;2060;2046;2017
17;Girona;084;Isòvol;270;152;118;2017
17;Girona;085;Jafre;393;213;180;2017
17;Girona;086;Jonquera, La;3157;1595;1562;2017
17;Girona;087;Juià;334;186;148;2017
17;Girona;088;Lladó;773;377;396;2017
17;Girona;089;Llagostera;8229;4201;4028;2017
17;Girona;090;Llambilles;716;363;353;2017
17;Girona;091;Llanars;507;272;235;2017
17;Girona;092;Llançà;4796;2361;2435;2017
17;Girona;093;Llers;1211;602;609;2017
17;Girona;094;Llívia;1415;758;657;2017
17;Girona;095;Lloret de Mar;36878;18857;18021;2017
17;Girona;096;Llosses, Les;210;116;94;2017
17;Girona;102;Maçanet de Cabrenys;706;345;361;2017
17;Girona;103;Maçanet de la Selva;6822;3530;3292;2017
17;Girona;097;Madremanya;284;141;143;2017
17;Girona;098;Maià de Montcal;409;216;193;2017
17;Girona;100;Masarac;279;146;133;2017
17;Girona;101;Massanes;721;392;329;2017
17;Girona;099;Meranges;99;61;38;2017
17;Girona;105;Mieres;318;162;156;2017
17;Girona;106;Mollet de Peralada;186;98;88;2017
17;Girona;107;Molló;342;164;178;2017
17;Girona;109;Montagut i Oix;919;486;433;2017
17;Girona;110;Mont-ras;1725;871;854;2017
17;Girona;111;Navata;1307;646;661;2017
17;Girona;112;Ogassa;228;133;95;2017
17;Girona;114;Olot;34194;16974;17220;2017
17;Girona;115;Ordis;364;194;170;2017
17;Girona;116;Osor;421;217;204;2017
17;Girona;117;Palafrugell;22725;11274;11451;2017
17;Girona;118;Palamós;17743;8651;9092;2017
17;Girona;119;Palau de Santa Eulàlia;96;58;38;2017
17;Girona;121;Palau-sator;285;151;134;2017
17;Girona;120;Palau-saverdera;1456;714;742;2017
17;Girona;123;Palol de Revardit;476;237;239;2017
17;Girona;124;Pals;2469;1246;1223;2017
17;Girona;125;Pardines;160;89;71;2017
17;Girona;126;Parlavà;394;206;188;2017
17;Girona;128;Pau;537;277;260;2017
17;Girona;129;Pedret i Marzà;186;98;88;2017
17;Girona;130;Pera, La;457;219;238;2017
17;Girona;132;Peralada;1859;920;939;2017
17;Girona;133;Planes d'Hostoles, Les;1629;828;801;2017
17;Girona;134;Planoles;303;168;135;2017
17;Girona;135;Pont de Molins;531;265;266;2017
17;Girona;136;Pontós;240;133;107;2017
17;Girona;137;Porqueres;4594;2271;2323;2017
17;Girona;140;Port de la Selva, El;992;508;484;2017
17;Girona;138;Portbou;1107;543;564;2017
17;Girona;139;Preses, Les;1764;874;890;2017
17;Girona;141;Puigcerdà;8839;4425;4414;2017
17;Girona;142;Quart;3570;1786;1784;2017
17;Girona;043;Queralbs;176;98;78;2017
17;Girona;143;Rabós;175;86;89;2017
17;Girona;144;Regencós;279;143;136;2017
17;Girona;145;Ribes de Freser;1783;887;896;2017
17;Girona;146;Riells i Viabrea;3922;2026;1896;2017
17;Girona;147;Ripoll;10611;5236;5375;2017
17;Girona;148;Riudarenes;2145;1106;1039;2017
17;Girona;149;Riudaura;475;229;246;2017
17;Girona;150;Riudellots de la Selva;2029;1024;1005;2017
17;Girona;151;Riumors;266;133;133;2017
17;Girona;152;Roses;19216;9645;9571;2017
17;Girona;153;Rupià;264;134;130;2017
17;Girona;154;Sales de Llierca;147;76;71;2017
17;Girona;155;Salt;29836;15685;14151;2017
17;Girona;157;Sant Andreu Salou;150;79;71;2017
17;Girona;183;Sant Aniol de Finestres;363;195;168;2017
17;Girona;158;Sant Climent Sescebes;636;372;264;2017
17;Girona;159;Sant Feliu de Buixalleu;825;431;394;2017
17;Girona;160;Sant Feliu de Guíxols;21721;10712;11009;2017
17;Girona;161;Sant Feliu de Pallerols;1342;647;695;2017
17;Girona;162;Sant Ferriol;228;125;103;2017
17;Girona;163;Sant Gregori;3636;1857;1779;2017
17;Girona;164;Sant Hilari Sacalm;5578;2801;2777;2017
17;Girona;165;Sant Jaume de Llierca;852;410;442;2017
17;Girona;167;Sant Joan de les Abadesses;3270;1631;1639;2017
17;Girona;168;Sant Joan de Mollet;498;236;262;2017
17;Girona;185;Sant Joan les Fonts;2931;1478;1453;2017
17;Girona;166;Sant Jordi Desvalls;732;357;375;2017
17;Girona;169;Sant Julià de Ramis;3447;1750;1697;2017
17;Girona;903;Sant Julià del Llor i Bonmatí;1321;683;638;2017
17;Girona;171;Sant Llorenç de la Muga;251;133;118;2017
17;Girona;172;Sant Martí de Llémena;612;314;298;2017
17;Girona;173;Sant Martí Vell;245;126;119;2017
17;Girona;174;Sant Miquel de Campmajor;226;119;107;2017
17;Girona;175;Sant Miquel de Fluvià;746;390;356;2017
17;Girona;176;Sant Mori;175;94;81;2017
17;Girona;177;Sant Pau de Segúries;672;330;342;2017
17;Girona;178;Sant Pere Pescador;2040;1102;938;2017
17;Girona;180;Santa Coloma de Farners;12854;6461;6393;2017
17;Girona;181;Santa Cristina d'Aro;5194;2600;2594;2017
17;Girona;182;Santa Llogaia d'Àlguema;353;184;169;2017
17;Girona;184;Santa Pau;1549;777;772;2017
17;Girona;186;Sarrià de Ter;5052;2484;2568;2017
17;Girona;187;Saus, Camallera i Llampaies;839;415;424;2017
17;Girona;188;Selva de Mar, La;191;109;82;2017
17;Girona;190;Serinyà;1117;577;540;2017
17;Girona;191;Serra de Daró;206;113;93;2017
17;Girona;192;Setcases;182;97;85;2017
17;Girona;193;Sils;5910;2996;2914;2017
17;Girona;052;Siurana;159;74;85;2017
17;Girona;194;Susqueda;98;56;42;2017
17;Girona;195;Tallada d'Empordà, La;450;234;216;2017
17;Girona;196;Terrades;306;149;157;2017
17;Girona;197;Torrent;161;90;71;2017
17;Girona;198;Torroella de Fluvià;688;367;321;2017
17;Girona;199;Torroella de Montgrí;11516;5842;5674;2017
17;Girona;200;Tortellà;783;380;403;2017
17;Girona;201;Toses;168;99;69;2017
17;Girona;202;Tossa de Mar;5542;2792;2750;2017
17;Girona;204;Ullà;1138;626;512;2017
17;Girona;205;Ullastret;295;148;147;2017
17;Girona;203;Ultramort;216;121;95;2017
17;Girona;206;Urús;173;81;92;2017
17;Girona;014;Vajol, La;85;47;38;2017
17;Girona;208;Vall de Bianya, La;1265;633;632;2017
17;Girona;207;Vall d'en Bas, La;3018;1519;1499;2017
17;Girona;170;Vallfogona de Ripollès;204;112;92;2017
17;Girona;209;Vall-llobrega;924;464;460;2017
17;Girona;210;Ventalló;793;397;396;2017
17;Girona;211;Verges;1159;558;601;2017
17;Girona;212;Vidrà;177;89;88;2017
17;Girona;213;Vidreres;7652;3949;3703;2017
17;Girona;214;Vilabertran;919;468;451;2017
17;Girona;215;Vilablareix;2691;1328;1363;2017
17;Girona;217;Viladamat;468;241;227;2017
17;Girona;216;Viladasens;216;112;104;2017
17;Girona;218;Vilademuls;789;415;374;2017
17;Girona;220;Viladrau;1038;517;521;2017
17;Girona;221;Vilafant;5465;2700;2765;2017
17;Girona;223;Vilajuïga;1123;561;562;2017
17;Girona;224;Vilallonga de Ter;406;213;193;2017
17;Girona;225;Vilamacolum;325;168;157;2017
17;Girona;226;Vilamalla;1146;579;567;2017
17;Girona;227;Vilamaniscle;199;108;91;2017
17;Girona;228;Vilanant;401;201;200;2017
17;Girona;230;Vila-sacra;706;345;361;2017
17;Girona;222;Vilaür;145;74;71;2017
17;Girona;233;Vilobí d'Onyar;3138;1635;1503;2017
17;Girona;232;Vilopriu;207;110;97;2017
18;Granada;001;Agrón;290;146;144;2017
18;Granada;002;Alamedilla;606;310;296;2017
18;Granada;003;Albolote;18660;9288;9372;2017
18;Granada;004;Albondón;745;411;334;2017
18;Granada;005;Albuñán;418;219;199;2017
18;Granada;006;Albuñol;6998;3742;3256;2017
18;Granada;007;Albuñuelas;836;419;417;2017
18;Granada;010;Aldeire;635;338;297;2017
18;Granada;011;Alfacar;5440;2777;2663;2017
18;Granada;012;Algarinejo;2677;1374;1303;2017
18;Granada;013;Alhama de Granada;5981;3185;2796;2017
18;Granada;014;Alhendín;8928;4503;4425;2017
18;Granada;015;Alicún de Ortega;495;248;247;2017
18;Granada;016;Almegíjar;362;199;163;2017
18;Granada;017;Almuñécar;27135;13452;13683;2017
18;Granada;904;Alpujarra de la Sierra;1021;570;451;2017
18;Granada;018;Alquife;665;330;335;2017
18;Granada;020;Arenas del Rey;1179;597;582;2017
18;Granada;021;Armilla;24028;12029;11999;2017
18;Granada;022;Atarfe;18392;9189;9203;2017
18;Granada;023;Baza;20642;10257;10385;2017
18;Granada;024;Beas de Granada;1000;532;468;2017
18;Granada;025;Beas de Guadix;345;172;173;2017
18;Granada;027;Benalúa;3286;1637;1649;2017
18;Granada;028;Benalúa de las Villas;1083;570;513;2017
18;Granada;029;Benamaurel;2337;1177;1160;2017
18;Granada;030;Bérchules;715;385;330;2017
18;Granada;032;Bubión;301;151;150;2017
18;Granada;033;Busquístar;278;145;133;2017
18;Granada;034;Cacín;587;299;288;2017
18;Granada;035;Cádiar;1486;785;701;2017
18;Granada;036;Cájar;5054;2440;2614;2017
18;Granada;114;Calahorra, La;673;337;336;2017
18;Granada;037;Calicasas;619;309;310;2017
18;Granada;038;Campotéjar;1271;652;619;2017
18;Granada;039;Caniles;4179;2134;2045;2017
18;Granada;040;Cáñar;348;196;152;2017
18;Granada;042;Capileira;559;285;274;2017
18;Granada;043;Carataunas;179;99;80;2017
18;Granada;044;Cástaras;244;149;95;2017
18;Granada;045;Castilléjar;1344;698;646;2017
18;Granada;046;Castril;2193;1120;1073;2017
18;Granada;047;Cenes de la Vega;7897;3971;3926;2017
18;Granada;059;Chauchina;5490;2715;2775;2017
18;Granada;061;Chimeneas;1326;702;624;2017
18;Granada;062;Churriana de la Vega;14556;7233;7323;2017
18;Granada;048;Cijuela;3228;1633;1595;2017
18;Granada;049;Cogollos de Guadix;659;366;293;2017
18;Granada;050;Cogollos de la Vega;2089;1041;1048;2017
18;Granada;051;Colomera;1376;717;659;2017
18;Granada;053;Cortes de Baza;1940;976;964;2017
18;Granada;054;Cortes y Graena;994;517;477;2017
18;Granada;912;Cuevas del Campo;1821;914;907;2017
18;Granada;056;Cúllar;4276;2151;2125;2017
18;Granada;057;Cúllar Vega;7330;3689;3641;2017
18;Granada;063;Darro;1571;795;776;2017
18;Granada;064;Dehesas de Guadix;419;213;206;2017
18;Granada;065;Dehesas Viejas;728;369;359;2017
18;Granada;066;Deifontes;2618;1320;1298;2017
18;Granada;067;Diezma;775;396;379;2017
18;Granada;068;Dílar;1959;997;962;2017
18;Granada;069;Dólar;638;338;300;2017
18;Granada;915;Domingo Pérez de Granada;899;470;429;2017
18;Granada;070;Dúdar;323;172;151;2017
18;Granada;071;Dúrcal;7028;3464;3564;2017
18;Granada;072;Escúzar;772;394;378;2017
18;Granada;074;Ferreira;305;158;147;2017
18;Granada;076;Fonelas;996;523;473;2017
18;Granada;078;Freila;890;456;434;2017
18;Granada;079;Fuente Vaqueros;4388;2205;2183;2017
18;Granada;905;Gabias, Las;20329;10389;9940;2017
18;Granada;082;Galera;1104;554;550;2017
18;Granada;083;Gobernador;246;114;132;2017
18;Granada;084;Gójar;5606;2855;2751;2017
18;Granada;085;Gor;746;385;361;2017
18;Granada;086;Gorafe;390;199;191;2017
18;Granada;087;Granada;232770;107844;124926;2017
18;Granada;088;Guadahortuna;1932;997;935;2017
18;Granada;089;Guadix;18799;9285;9514;2017
18;Granada;906;Guájares, Los;1037;550;487;2017
18;Granada;093;Gualchos;5051;2636;2415;2017
18;Granada;094;Güéjar Sierra;2878;1527;1351;2017
18;Granada;095;Güevéjar;2551;1342;1209;2017
18;Granada;096;Huélago;395;204;191;2017
18;Granada;097;Huéneja;1156;609;547;2017
18;Granada;098;Huéscar;7498;3701;3797;2017
18;Granada;099;Huétor de Santillán;1889;966;923;2017
18;Granada;100;Huétor Tájar;10236;5159;5077;2017
18;Granada;101;Huétor Vega;11904;5986;5918;2017
18;Granada;102;Íllora;10233;5104;5129;2017
18;Granada;103;Ítrabo;1009;508;501;2017
18;Granada;105;Iznalloz;5033;2569;2464;2017
18;Granada;106;Játar;633;349;284;2017
18;Granada;107;Jayena;1101;563;538;2017
18;Granada;108;Jerez del Marquesado;1002;528;474;2017
18;Granada;109;Jete;890;463;427;2017
18;Granada;111;Jun;3681;1869;1812;2017
18;Granada;112;Juviles;144;68;76;2017
18;Granada;115;Láchar;3270;1675;1595;2017
18;Granada;116;Lanjarón;3503;1737;1766;2017
18;Granada;117;Lanteira;559;292;267;2017
18;Granada;119;Lecrín;2089;1062;1027;2017
18;Granada;120;Lentegí;322;167;155;2017
18;Granada;121;Lobras;148;79;69;2017
18;Granada;122;Loja;20469;10205;10264;2017
18;Granada;123;Lugros;334;180;154;2017
18;Granada;124;Lújar;454;244;210;2017
18;Granada;126;Malahá, La;1856;927;929;2017
18;Granada;127;Maracena;22071;10888;11183;2017
18;Granada;128;Marchal;417;199;218;2017
18;Granada;132;Moclín;3820;1908;1912;2017
18;Granada;133;Molvízar;2796;1433;1363;2017
18;Granada;134;Monachil;7715;3982;3733;2017
18;Granada;135;Montefrío;5472;2749;2723;2017
18;Granada;136;Montejícar;2183;1119;1064;2017
18;Granada;137;Montillana;1207;630;577;2017
18;Granada;138;Moraleda de Zafayona;3176;1609;1567;2017
18;Granada;909;Morelábor;650;352;298;2017
18;Granada;140;Motril;60420;29763;30657;2017
18;Granada;141;Murtas;473;265;208;2017
18;Granada;903;Nevada;1089;560;529;2017
18;Granada;143;Nigüelas;1195;608;587;2017
18;Granada;144;Nívar;971;506;465;2017
18;Granada;145;Ogíjares;13848;6852;6996;2017
18;Granada;146;Orce;1205;615;590;2017
18;Granada;147;Órgiva;5570;2803;2767;2017
18;Granada;148;Otívar;1043;527;516;2017
18;Granada;150;Padul;8454;4261;4193;2017
18;Granada;151;Pampaneira;324;160;164;2017
18;Granada;152;Pedro Martínez;1166;573;593;2017
18;Granada;153;Peligros;11191;5548;5643;2017
18;Granada;154;Peza, La;1214;624;590;2017
18;Granada;910;Pinar, El;933;485;448;2017
18;Granada;157;Pinos Genil;1422;748;674;2017
18;Granada;158;Pinos Puente;10314;5166;5148;2017
18;Granada;159;Píñar;1139;615;524;2017
18;Granada;161;Polícar;228;121;107;2017
18;Granada;162;Polopos;1650;882;768;2017
18;Granada;163;Pórtugos;403;208;195;2017
18;Granada;164;Puebla de Don Fadrique;2308;1188;1120;2017
18;Granada;165;Pulianas;5364;2673;2691;2017
18;Granada;167;Purullena;2329;1176;1153;2017
18;Granada;168;Quéntar;928;473;455;2017
18;Granada;170;Rubite;382;214;168;2017
18;Granada;171;Salar;2667;1351;1316;2017
18;Granada;173;Salobreña;12402;6209;6193;2017
18;Granada;174;Santa Cruz del Comercio;549;286;263;2017
18;Granada;175;Santa Fe;14960;7352;7608;2017
18;Granada;176;Soportújar;266;147;119;2017
18;Granada;177;Sorvilán;550;294;256;2017
18;Granada;901;Taha, La;653;336;317;2017
18;Granada;178;Torre-Cardela;782;407;375;2017
18;Granada;179;Torvizcón;650;339;311;2017
18;Granada;180;Trevélez;758;390;368;2017
18;Granada;181;Turón;253;151;102;2017
18;Granada;182;Ugíjar;2511;1234;1277;2017
18;Granada;914;Valderrubio;2083;1021;1062;2017
18;Granada;907;Valle del Zalabí;2146;1101;1045;2017
18;Granada;902;Valle, El;938;466;472;2017
18;Granada;183;Válor;676;346;330;2017
18;Granada;911;Vegas del Genil;10808;5514;5294;2017
18;Granada;184;Vélez de Benaudalla;2885;1438;1447;2017
18;Granada;185;Ventas de Huelma;620;331;289;2017
18;Granada;149;Villa de Otura;6832;3454;3378;2017
18;Granada;908;Villamena;967;484;483;2017
18;Granada;187;Villanueva de las Torres;633;332;301;2017
18;Granada;188;Villanueva Mesía;2013;992;1021;2017
18;Granada;189;Víznar;978;504;474;2017
18;Granada;192;Zafarraya;2052;1083;969;2017
18;Granada;913;Zagra;866;440;426;2017
18;Granada;193;Zubia, La;19006;9348;9658;2017
18;Granada;194;Zújar;2612;1347;1265;2017
19;Guadalajara;001;Abánades;55;30;25;2017
19;Guadalajara;002;Ablanque;62;36;26;2017
19;Guadalajara;003;Adobes;38;21;17;2017
19;Guadalajara;004;Alaminos;67;30;37;2017
19;Guadalajara;005;Alarilla;122;77;45;2017
19;Guadalajara;006;Albalate de Zorita;930;525;405;2017
19;Guadalajara;007;Albares;549;283;266;2017
19;Guadalajara;008;Albendiego;43;28;15;2017
19;Guadalajara;009;Alcocer;332;172;160;2017
19;Guadalajara;010;Alcolea de las Peñas;12;8;4;2017
19;Guadalajara;011;Alcolea del Pinar;328;180;148;2017
19;Guadalajara;013;Alcoroches;130;79;51;2017
19;Guadalajara;015;Aldeanueva de Guadalajara;81;47;34;2017
19;Guadalajara;016;Algar de Mesa;59;40;19;2017
19;Guadalajara;017;Algora;79;49;30;2017
19;Guadalajara;018;Alhóndiga;165;94;71;2017
19;Guadalajara;019;Alique;18;9;9;2017
19;Guadalajara;020;Almadrones;60;38;22;2017
19;Guadalajara;021;Almoguera;1340;706;634;2017
19;Guadalajara;022;Almonacid de Zorita;730;351;379;2017
19;Guadalajara;023;Alocén;187;93;94;2017
19;Guadalajara;024;Alovera;12478;6324;6154;2017
19;Guadalajara;027;Alustante;147;83;64;2017
19;Guadalajara;031;Angón;13;10;3;2017
19;Guadalajara;032;Anguita;176;91;85;2017
19;Guadalajara;033;Anquela del Ducado;61;34;27;2017
19;Guadalajara;034;Anquela del Pedregal;21;15;6;2017
19;Guadalajara;036;Aranzueque;414;211;203;2017
19;Guadalajara;037;Arbancón;158;90;68;2017
19;Guadalajara;038;Arbeteta;25;18;7;2017
19;Guadalajara;039;Argecilla;65;44;21;2017
19;Guadalajara;040;Armallones;49;30;19;2017
19;Guadalajara;041;Armuña de Tajuña;234;127;107;2017
19;Guadalajara;042;Arroyo de las Fraguas;24;14;10;2017
19;Guadalajara;043;Atanzón;90;57;33;2017
19;Guadalajara;044;Atienza;452;256;196;2017
19;Guadalajara;045;Auñón;150;84;66;2017
19;Guadalajara;046;Azuqueca de Henares;34768;17606;17162;2017
19;Guadalajara;047;Baides;61;31;30;2017
19;Guadalajara;048;Baños de Tajo;16;13;3;2017
19;Guadalajara;049;Bañuelos;16;14;2;2017
19;Guadalajara;050;Barriopedro;17;12;5;2017
19;Guadalajara;051;Berninches;56;35;21;2017
19;Guadalajara;052;Bodera, La;24;15;9;2017
19;Guadalajara;053;Brihuega;2465;1286;1179;2017
19;Guadalajara;054;Budia;214;123;91;2017
19;Guadalajara;055;Bujalaro;50;27;23;2017
19;Guadalajara;057;Bustares;81;49;32;2017
19;Guadalajara;058;Cabanillas del Campo;9947;5052;4895;2017
19;Guadalajara;059;Campillo de Dueñas;81;47;34;2017
19;Guadalajara;060;Campillo de Ranas;157;103;54;2017
19;Guadalajara;061;Campisábalos;65;47;18;2017
19;Guadalajara;064;Canredondo;75;44;31;2017
19;Guadalajara;065;Cantalojas;153;96;57;2017
19;Guadalajara;066;Cañizar;60;33;27;2017
19;Guadalajara;067;Cardoso de la Sierra, El;66;42;24;2017
19;Guadalajara;070;Casa de Uceda;95;50;45;2017
19;Guadalajara;071;Casar, El;11792;6020;5772;2017
19;Guadalajara;073;Casas de San Galindo;21;16;5;2017
19;Guadalajara;074;Caspueñas;88;50;38;2017
19;Guadalajara;075;Castejón de Henares;62;39;23;2017
19;Guadalajara;076;Castellar de la Muela;30;16;14;2017
19;Guadalajara;078;Castilforte;56;37;19;2017
19;Guadalajara;079;Castilnuevo;9;5;4;2017
19;Guadalajara;080;Cendejas de Enmedio;74;39;35;2017
19;Guadalajara;081;Cendejas de la Torre;26;15;11;2017
19;Guadalajara;082;Centenera;110;63;47;2017
19;Guadalajara;103;Checa;279;163;116;2017
19;Guadalajara;104;Chequilla;17;10;7;2017
19;Guadalajara;106;Chillarón del Rey;93;54;39;2017
19;Guadalajara;105;Chiloeches;3424;1776;1648;2017
19;Guadalajara;086;Cifuentes;1749;914;835;2017
19;Guadalajara;087;Cincovillas;22;11;11;2017
19;Guadalajara;088;Ciruelas;91;51;40;2017
19;Guadalajara;089;Ciruelos del Pinar;30;18;12;2017
19;Guadalajara;090;Cobeta;110;56;54;2017
19;Guadalajara;091;Cogollor;29;17;12;2017
19;Guadalajara;092;Cogolludo;581;342;239;2017
19;Guadalajara;095;Condemios de Abajo;15;10;5;2017
19;Guadalajara;096;Condemios de Arriba;116;64;52;2017
19;Guadalajara;097;Congostrina;18;14;4;2017
19;Guadalajara;098;Copernal;26;18;8;2017
19;Guadalajara;099;Corduente;353;196;157;2017
19;Guadalajara;102;Cubillo de Uceda, El;125;65;60;2017
19;Guadalajara;107;Driebes;335;177;158;2017
19;Guadalajara;108;Durón;114;58;56;2017
19;Guadalajara;109;Embid;39;21;18;2017
19;Guadalajara;110;Escamilla;58;29;29;2017
19;Guadalajara;111;Escariche;175;105;70;2017
19;Guadalajara;112;Escopete;53;22;31;2017
19;Guadalajara;113;Espinosa de Henares;684;350;334;2017
19;Guadalajara;114;Esplegares;42;27;15;2017
19;Guadalajara;115;Establés;30;17;13;2017
19;Guadalajara;116;Estriégana;17;11;6;2017
19;Guadalajara;117;Fontanar;2347;1229;1118;2017
19;Guadalajara;118;Fuembellida;8;5;3;2017
19;Guadalajara;119;Fuencemillán;98;58;40;2017
19;Guadalajara;120;Fuentelahiguera de Albatages;128;72;56;2017
19;Guadalajara;121;Fuentelencina;295;165;130;2017
19;Guadalajara;122;Fuentelsaz;95;52;43;2017
19;Guadalajara;123;Fuentelviejo;52;26;26;2017
19;Guadalajara;124;Fuentenovilla;532;291;241;2017
19;Guadalajara;125;Gajanejos;41;27;14;2017
19;Guadalajara;126;Galápagos;2408;1280;1128;2017
19;Guadalajara;127;Galve de Sorbe;97;54;43;2017
19;Guadalajara;129;Gascueña de Bornova;32;18;14;2017
19;Guadalajara;130;Guadalajara;84145;40435;43710;2017
19;Guadalajara;132;Henche;100;52;48;2017
19;Guadalajara;133;Heras de Ayuso;241;143;98;2017
19;Guadalajara;134;Herrería;21;13;8;2017
19;Guadalajara;135;Hiendelaencina;117;66;51;2017
19;Guadalajara;136;Hijes;19;11;8;2017
19;Guadalajara;138;Hita;329;184;145;2017
19;Guadalajara;139;Hombrados;33;19;14;2017
19;Guadalajara;142;Hontoba;308;180;128;2017
19;Guadalajara;143;Horche;2542;1291;1251;2017
19;Guadalajara;145;Hortezuela de Océn;48;29;19;2017
19;Guadalajara;146;Huerce, La;43;26;17;2017
19;Guadalajara;147;Huérmeces del Cerro;42;28;14;2017
19;Guadalajara;148;Huertahernando;55;35;20;2017
19;Guadalajara;150;Hueva;142;87;55;2017
19;Guadalajara;151;Humanes;1462;720;742;2017
19;Guadalajara;152;Illana;660;373;287;2017
19;Guadalajara;153;Iniéstola;22;13;9;2017
19;Guadalajara;154;Inviernas, Las;70;47;23;2017
19;Guadalajara;155;Irueste;74;47;27;2017
19;Guadalajara;156;Jadraque;1459;759;700;2017
19;Guadalajara;157;Jirueque;57;38;19;2017
19;Guadalajara;159;Ledanca;104;53;51;2017
19;Guadalajara;160;Loranca de Tajuña;1227;675;552;2017
19;Guadalajara;161;Lupiana;248;126;122;2017
19;Guadalajara;162;Luzaga;67;38;29;2017
19;Guadalajara;163;Luzón;63;33;30;2017
19;Guadalajara;165;Majaelrayo;57;32;25;2017
19;Guadalajara;166;Málaga del Fresno;175;98;77;2017
19;Guadalajara;167;Malaguilla;146;82;64;2017
19;Guadalajara;168;Mandayona;314;163;151;2017
19;Guadalajara;169;Mantiel;41;24;17;2017
19;Guadalajara;170;Maranchón;240;131;109;2017
19;Guadalajara;171;Marchamalo;7073;3558;3515;2017
19;Guadalajara;172;Masegoso de Tajuña;57;33;24;2017
19;Guadalajara;173;Matarrubia;48;32;16;2017
19;Guadalajara;174;Matillas;122;61;61;2017
19;Guadalajara;175;Mazarete;38;17;21;2017
19;Guadalajara;176;Mazuecos;271;141;130;2017
19;Guadalajara;177;Medranda;80;40;40;2017
19;Guadalajara;178;Megina;32;21;11;2017
19;Guadalajara;179;Membrillera;91;51;40;2017
19;Guadalajara;181;Miedes de Atienza;61;35;26;2017
19;Guadalajara;182;Mierla, La;40;27;13;2017
19;Guadalajara;184;Millana;110;65;45;2017
19;Guadalajara;183;Milmarcos;80;46;34;2017
19;Guadalajara;185;Miñosa, La;31;21;10;2017
19;Guadalajara;186;Mirabueno;86;49;37;2017
19;Guadalajara;187;Miralrío;57;34;23;2017
19;Guadalajara;188;Mochales;50;29;21;2017
19;Guadalajara;189;Mohernando;169;92;77;2017
19;Guadalajara;190;Molina de Aragón;3365;1689;1676;2017
19;Guadalajara;191;Monasterio;15;5;10;2017
19;Guadalajara;192;Mondéjar;2627;1353;1274;2017
19;Guadalajara;193;Montarrón;25;14;11;2017
19;Guadalajara;194;Moratilla de los Meleros;103;60;43;2017
19;Guadalajara;195;Morenilla;41;24;17;2017
19;Guadalajara;196;Muduex;107;57;50;2017
19;Guadalajara;197;Navas de Jadraque, Las;30;19;11;2017
19;Guadalajara;198;Negredo;13;6;7;2017
19;Guadalajara;199;Ocentejo;19;14;5;2017
19;Guadalajara;200;Olivar, El;78;44;34;2017
19;Guadalajara;201;Olmeda de Cobeta;63;34;29;2017
19;Guadalajara;202;Olmeda de Jadraque, La;7;3;4;2017
19;Guadalajara;203;Ordial, El;29;17;12;2017
19;Guadalajara;204;Orea;184;109;75;2017
19;Guadalajara;208;Pálmaces de Jadraque;40;24;16;2017
19;Guadalajara;209;Pardos;42;24;18;2017
19;Guadalajara;210;Paredes de Sigüenza;20;10;10;2017
19;Guadalajara;211;Pareja;419;240;179;2017
19;Guadalajara;212;Pastrana;885;447;438;2017
19;Guadalajara;213;Pedregal, El;78;47;31;2017
19;Guadalajara;214;Peñalén;74;43;31;2017
19;Guadalajara;215;Peñalver;168;108;60;2017
19;Guadalajara;216;Peralejos de las Truchas;151;81;70;2017
19;Guadalajara;217;Peralveche;55;37;18;2017
19;Guadalajara;218;Pinilla de Jadraque;53;29;24;2017
19;Guadalajara;219;Pinilla de Molina;13;10;3;2017
19;Guadalajara;220;Pioz;3602;1903;1699;2017
19;Guadalajara;221;Piqueras;58;36;22;2017
19;Guadalajara;222;Pobo de Dueñas, El;120;60;60;2017
19;Guadalajara;223;Poveda de la Sierra;126;66;60;2017
19;Guadalajara;224;Pozo de Almoguera;98;56;42;2017
19;Guadalajara;225;Pozo de Guadalajara;1260;668;592;2017
19;Guadalajara;226;Prádena de Atienza;44;30;14;2017
19;Guadalajara;227;Prados Redondos;67;42;25;2017
19;Guadalajara;228;Puebla de Beleña;46;25;21;2017
19;Guadalajara;229;Puebla de Valles;64;36;28;2017
19;Guadalajara;230;Quer;756;399;357;2017
19;Guadalajara;231;Rebollosa de Jadraque;12;8;4;2017
19;Guadalajara;232;Recuenco, El;65;42;23;2017
19;Guadalajara;233;Renera;91;51;40;2017
19;Guadalajara;234;Retiendas;44;28;16;2017
19;Guadalajara;235;Riba de Saelices;100;57;43;2017
19;Guadalajara;237;Rillo de Gallo;46;26;20;2017
19;Guadalajara;238;Riofrío del Llano;46;28;18;2017
19;Guadalajara;239;Robledillo de Mohernando;109;53;56;2017
19;Guadalajara;240;Robledo de Corpes;47;28;19;2017
19;Guadalajara;241;Romanillos de Atienza;43;28;15;2017
19;Guadalajara;242;Romanones;108;58;50;2017
19;Guadalajara;243;Rueda de la Sierra;48;32;16;2017
19;Guadalajara;244;Sacecorbo;93;52;41;2017
19;Guadalajara;245;Sacedón;1542;813;729;2017
19;Guadalajara;246;Saelices de la Sal;48;26;22;2017
19;Guadalajara;247;Salmerón;159;88;71;2017
19;Guadalajara;248;San Andrés del Congosto;75;47;28;2017
19;Guadalajara;249;San Andrés del Rey;32;16;16;2017
19;Guadalajara;250;Santiuste;22;13;9;2017
19;Guadalajara;251;Saúca;56;31;25;2017
19;Guadalajara;252;Sayatón;83;50;33;2017
19;Guadalajara;254;Selas;52;24;28;2017
19;Guadalajara;901;Semillas;43;26;17;2017
19;Guadalajara;255;Setiles;83;50;33;2017
19;Guadalajara;256;Sienes;56;33;23;2017
19;Guadalajara;257;Sigüenza;4496;2237;2259;2017
19;Guadalajara;258;Solanillos del Extremo;92;54;38;2017
19;Guadalajara;259;Somolinos;38;17;21;2017
19;Guadalajara;260;Sotillo, El;46;25;21;2017
19;Guadalajara;261;Sotodosos;36;18;18;2017
19;Guadalajara;262;Tamajón;124;67;57;2017
19;Guadalajara;263;Taragudo;48;24;24;2017
19;Guadalajara;264;Taravilla;35;23;12;2017
19;Guadalajara;265;Tartanedo;142;86;56;2017
19;Guadalajara;266;Tendilla;329;180;149;2017
19;Guadalajara;267;Terzaga;23;13;10;2017
19;Guadalajara;268;Tierzo;34;23;11;2017
19;Guadalajara;269;Toba, La;103;57;46;2017
19;Guadalajara;271;Tordellego;55;31;24;2017
19;Guadalajara;270;Tordelrábano;14;10;4;2017
19;Guadalajara;272;Tordesilos;105;60;45;2017
19;Guadalajara;274;Torija;1380;715;665;2017
19;Guadalajara;279;Torre del Burgo;367;203;164;2017
19;Guadalajara;277;Torrecuadrada de Molina;20;13;7;2017
19;Guadalajara;278;Torrecuadradilla;25;15;10;2017
19;Guadalajara;280;Torrejón del Rey;5160;2681;2479;2017
19;Guadalajara;281;Torremocha de Jadraque;23;15;8;2017
19;Guadalajara;282;Torremocha del Campo;198;112;86;2017
19;Guadalajara;283;Torremocha del Pinar;39;17;22;2017
19;Guadalajara;284;Torremochuela;11;7;4;2017
19;Guadalajara;285;Torrubia;22;12;10;2017
19;Guadalajara;286;Tórtola de Henares;997;546;451;2017
19;Guadalajara;287;Tortuera;203;110;93;2017
19;Guadalajara;288;Tortuero;17;11;6;2017
19;Guadalajara;289;Traíd;26;17;9;2017
19;Guadalajara;290;Trijueque;1148;611;537;2017
19;Guadalajara;291;Trillo;1355;711;644;2017
19;Guadalajara;293;Uceda;2574;1333;1241;2017
19;Guadalajara;294;Ujados;34;20;14;2017
19;Guadalajara;296;Utande;35;24;11;2017
19;Guadalajara;297;Valdarachas;37;19;18;2017
19;Guadalajara;298;Valdearenas;86;55;31;2017
19;Guadalajara;299;Valdeavellano;107;56;51;2017
19;Guadalajara;300;Valdeaveruelo;1077;553;524;2017
19;Guadalajara;301;Valdeconcha;40;22;18;2017
19;Guadalajara;302;Valdegrudas;61;38;23;2017
19;Guadalajara;303;Valdelcubo;52;33;19;2017
19;Guadalajara;304;Valdenuño Fernández;263;148;115;2017
19;Guadalajara;305;Valdepeñas de la Sierra;175;102;73;2017
19;Guadalajara;306;Valderrebollo;22;12;10;2017
19;Guadalajara;307;Valdesotos;26;17;9;2017
19;Guadalajara;308;Valfermoso de Tajuña;54;36;18;2017
19;Guadalajara;309;Valhermoso;29;15;14;2017
19;Guadalajara;310;Valtablado del Río;9;6;3;2017
19;Guadalajara;311;Valverde de los Arroyos;85;46;39;2017
19;Guadalajara;314;Viana de Jadraque;52;34;18;2017
19;Guadalajara;317;Villanueva de Alcorón;172;92;80;2017
19;Guadalajara;318;Villanueva de Argecilla;30;19;11;2017
19;Guadalajara;319;Villanueva de la Torre;6561;3310;3251;2017
19;Guadalajara;321;Villares de Jadraque;52;33;19;2017
19;Guadalajara;322;Villaseca de Henares;29;15;14;2017
19;Guadalajara;323;Villaseca de Uceda;41;22;19;2017
19;Guadalajara;324;Villel de Mesa;193;106;87;2017
19;Guadalajara;325;Viñuelas;140;72;68;2017
19;Guadalajara;326;Yebes;3076;1603;1473;2017
19;Guadalajara;327;Yebra;474;246;228;2017
19;Guadalajara;329;Yélamos de Abajo;64;34;30;2017
19;Guadalajara;330;Yélamos de Arriba;83;51;32;2017
19;Guadalajara;331;Yunquera de Henares;3875;1987;1888;2017
19;Guadalajara;332;Yunta, La;98;53;45;2017
19;Guadalajara;333;Zaorejas;133;90;43;2017
19;Guadalajara;334;Zarzuela de Jadraque;39;22;17;2017
19;Guadalajara;335;Zorita de los Canes;69;34;35;2017
21;Huelva;001;Alájar;777;399;378;2017
21;Huelva;002;Aljaraque;20836;10354;10482;2017
21;Huelva;003;Almendro, El;839;441;398;2017
21;Huelva;004;Almonaster la Real;1848;978;870;2017
21;Huelva;005;Almonte;23272;11613;11659;2017
21;Huelva;006;Alosno;3954;1934;2020;2017
21;Huelva;007;Aracena;8048;3970;4078;2017
21;Huelva;008;Aroche;3131;1573;1558;2017
21;Huelva;009;Arroyomolinos de León;981;514;467;2017
21;Huelva;010;Ayamonte;20714;10369;10345;2017
21;Huelva;011;Beas;4238;2130;2108;2017
21;Huelva;012;Berrocal;330;169;161;2017
21;Huelva;013;Bollullos Par del Condado;14095;7030;7065;2017
21;Huelva;014;Bonares;6025;3004;3021;2017
21;Huelva;015;Cabezas Rubias;734;385;349;2017
21;Huelva;016;Cala;1202;609;593;2017
21;Huelva;017;Calañas;4099;2093;2006;2017
21;Huelva;018;Campillo, El;2043;995;1048;2017
21;Huelva;019;Campofrío;683;345;338;2017
21;Huelva;020;Cañaveral de León;420;210;210;2017
21;Huelva;021;Cartaya;19193;9860;9333;2017
21;Huelva;022;Castaño del Robledo;209;123;86;2017
21;Huelva;023;Cerro de Andévalo, El;2409;1206;1203;2017
21;Huelva;030;Chucena;2256;1146;1110;2017
21;Huelva;024;Corteconcepción;548;272;276;2017
21;Huelva;025;Cortegana;4812;2440;2372;2017
21;Huelva;026;Cortelazor;304;150;154;2017
21;Huelva;027;Cumbres de Enmedio;52;31;21;2017
21;Huelva;028;Cumbres de San Bartolomé;388;189;199;2017
21;Huelva;029;Cumbres Mayores;1795;889;906;2017
21;Huelva;031;Encinasola;1334;673;661;2017
21;Huelva;032;Escacena del Campo;2254;1107;1147;2017
21;Huelva;033;Fuenteheridos;646;324;322;2017
21;Huelva;034;Galaroza;1409;689;720;2017
21;Huelva;035;Gibraleón;12570;6251;6319;2017
21;Huelva;036;Granada de Río-Tinto, La;234;123;111;2017
21;Huelva;037;Granado, El;521;277;244;2017
21;Huelva;038;Higuera de la Sierra;1293;664;629;2017
21;Huelva;039;Hinojales;310;152;158;2017
21;Huelva;040;Hinojos;3891;1955;1936;2017
21;Huelva;041;Huelva;145115;69800;75315;2017
21;Huelva;042;Isla Cristina;21175;10570;10605;2017
21;Huelva;043;Jabugo;2258;1128;1130;2017
21;Huelva;044;Lepe;26931;13947;12984;2017
21;Huelva;045;Linares de la Sierra;267;133;134;2017
21;Huelva;046;Lucena del Puerto;3200;1662;1538;2017
21;Huelva;047;Manzanilla;2076;1057;1019;2017
21;Huelva;048;Marines, Los;393;213;180;2017
21;Huelva;049;Minas de Riotinto;3924;1904;2020;2017
21;Huelva;050;Moguer;21514;10809;10705;2017
21;Huelva;051;Nava, La;266;134;132;2017
21;Huelva;052;Nerva;5418;2621;2797;2017
21;Huelva;053;Niebla;4091;2077;2014;2017
21;Huelva;054;Palma del Condado, La;10690;5320;5370;2017
21;Huelva;055;Palos de la Frontera;10885;5475;5410;2017
21;Huelva;056;Paterna del Campo;3499;1767;1732;2017
21;Huelva;057;Paymogo;1195;605;590;2017
21;Huelva;058;Puebla de Guzmán;3148;1617;1531;2017
21;Huelva;059;Puerto Moral;274;135;139;2017
21;Huelva;060;Punta Umbría;15038;7649;7389;2017
21;Huelva;061;Rociana del Condado;7714;3890;3824;2017
21;Huelva;062;Rosal de la Frontera;1702;844;858;2017
21;Huelva;063;San Bartolomé de la Torre;3640;1810;1830;2017
21;Huelva;064;San Juan del Puerto;9116;4583;4533;2017
21;Huelva;066;San Silvestre de Guzmán;611;324;287;2017
21;Huelva;065;Sanlúcar de Guadiana;419;210;209;2017
21;Huelva;067;Santa Ana la Real;491;233;258;2017
21;Huelva;068;Santa Bárbara de Casa;1092;533;559;2017
21;Huelva;069;Santa Olalla del Cala;2003;1037;966;2017
21;Huelva;070;Trigueros;7708;3817;3891;2017
21;Huelva;071;Valdelarco;238;110;128;2017
21;Huelva;072;Valverde del Camino;12839;6306;6533;2017
21;Huelva;073;Villablanca;2781;1380;1401;2017
21;Huelva;074;Villalba del Alcor;3279;1624;1655;2017
21;Huelva;075;Villanueva de las Cruces;386;185;201;2017
21;Huelva;076;Villanueva de los Castillejos;2747;1375;1372;2017
21;Huelva;077;Villarrasa;2172;1105;1067;2017
21;Huelva;078;Zalamea la Real;3093;1559;1534;2017
21;Huelva;079;Zufre;845;429;416;2017
22;Huesca;001;Abiego;246;127;119;2017
22;Huesca;002;Abizanda;156;82;74;2017
22;Huesca;003;Adahuesca;172;89;83;2017
22;Huesca;004;Agüero;139;82;57;2017
22;Huesca;907;Aínsa-Sobrarbe;2128;1088;1040;2017
22;Huesca;006;Aisa;331;180;151;2017
22;Huesca;007;Albalate de Cinca;1120;590;530;2017
22;Huesca;008;Albalatillo;187;104;83;2017
22;Huesca;009;Albelda;728;376;352;2017
22;Huesca;011;Albero Alto;114;69;45;2017
22;Huesca;012;Albero Bajo;138;75;63;2017
22;Huesca;013;Alberuela de Tubo;310;158;152;2017
22;Huesca;014;Alcalá de Gurrea;267;141;126;2017
22;Huesca;015;Alcalá del Obispo;332;181;151;2017
22;Huesca;016;Alcampell;671;335;336;2017
22;Huesca;017;Alcolea de Cinca;1104;584;520;2017
22;Huesca;018;Alcubierre;377;201;176;2017
22;Huesca;019;Alerre;200;103;97;2017
22;Huesca;020;Alfántega;135;69;66;2017
22;Huesca;021;Almudévar;2444;1246;1198;2017
22;Huesca;022;Almunia de San Juan;665;349;316;2017
22;Huesca;023;Almuniente;486;242;244;2017
22;Huesca;024;Alquézar;304;162;142;2017
22;Huesca;025;Altorricón;1420;760;660;2017
22;Huesca;027;Angüés;360;187;173;2017
22;Huesca;028;Ansó;411;206;205;2017
22;Huesca;029;Antillón;154;79;75;2017
22;Huesca;032;Aragüés del Puerto;114;60;54;2017
22;Huesca;035;Arén;320;176;144;2017
22;Huesca;036;Argavieso;100;59;41;2017
22;Huesca;037;Arguis;122;67;55;2017
22;Huesca;039;Ayerbe;1071;528;543;2017
22;Huesca;040;Azanuy-Alins;173;85;88;2017
22;Huesca;041;Azara;180;92;88;2017
22;Huesca;042;Azlor;143;66;77;2017
22;Huesca;043;Baélls;103;59;44;2017
22;Huesca;044;Bailo;284;171;113;2017
22;Huesca;045;Baldellou;82;46;36;2017
22;Huesca;046;Ballobar;830;421;409;2017
22;Huesca;047;Banastás;295;158;137;2017
22;Huesca;048;Barbastro;16907;8200;8707;2017
22;Huesca;049;Barbués;81;46;35;2017
22;Huesca;050;Barbuñales;94;47;47;2017
22;Huesca;051;Bárcabo;107;59;48;2017
22;Huesca;052;Belver de Cinca;1281;727;554;2017
22;Huesca;053;Benabarre;1110;575;535;2017
22;Huesca;054;Benasque;2121;1136;985;2017
22;Huesca;246;Beranuy;77;46;31;2017
22;Huesca;055;Berbegal;357;188;169;2017
22;Huesca;057;Bielsa;473;247;226;2017
22;Huesca;058;Bierge;242;133;109;2017
22;Huesca;059;Biescas;1480;781;699;2017
22;Huesca;060;Binaced;1524;812;712;2017
22;Huesca;061;Binéfar;9391;4889;4502;2017
22;Huesca;062;Bisaurri;180;99;81;2017
22;Huesca;063;Biscarrués;192;105;87;2017
22;Huesca;064;Blecua y Torres;182;104;78;2017
22;Huesca;066;Boltaña;941;511;430;2017
22;Huesca;067;Bonansa;79;44;35;2017
22;Huesca;068;Borau;81;49;32;2017
22;Huesca;069;Broto;552;308;244;2017
22;Huesca;072;Caldearenas;228;130;98;2017
22;Huesca;074;Campo;343;181;162;2017
22;Huesca;075;Camporrélls;134;72;62;2017
22;Huesca;076;Canal de Berdún;343;188;155;2017
22;Huesca;077;Candasnos;315;164;151;2017
22;Huesca;078;Canfranc;542;301;241;2017
22;Huesca;079;Capdesaso;163;77;86;2017
22;Huesca;080;Capella;358;193;165;2017
22;Huesca;081;Casbas de Huesca;279;154;125;2017
22;Huesca;083;Castejón de Monegros;528;279;249;2017
22;Huesca;084;Castejón de Sos;738;378;360;2017
22;Huesca;082;Castejón del Puente;326;172;154;2017
22;Huesca;085;Castelflorite;112;61;51;2017
22;Huesca;086;Castiello de Jaca;244;135;109;2017
22;Huesca;087;Castigaleu;87;50;37;2017
22;Huesca;088;Castillazuelo;174;86;88;2017
22;Huesca;089;Castillonroy;321;169;152;2017
22;Huesca;094;Chalamera;111;59;52;2017
22;Huesca;095;Chía;87;53;34;2017
22;Huesca;096;Chimillas;389;196;193;2017
22;Huesca;090;Colungo;118;64;54;2017
22;Huesca;099;Esplús;581;290;291;2017
22;Huesca;102;Estada;202;116;86;2017
22;Huesca;103;Estadilla;814;398;416;2017
22;Huesca;105;Estopiñán del Castillo;132;70;62;2017
22;Huesca;106;Fago;27;14;13;2017
22;Huesca;107;Fanlo;102;62;40;2017
22;Huesca;109;Fiscal;323;171;152;2017
22;Huesca;110;Fonz;902;446;456;2017
22;Huesca;111;Foradada del Toscar;178;94;84;2017
22;Huesca;112;Fraga;15024;7643;7381;2017
22;Huesca;113;Fueva, La;608;324;284;2017
22;Huesca;114;Gistaín;142;79;63;2017
22;Huesca;115;Grado, El;422;223;199;2017
22;Huesca;116;Grañén;1748;906;842;2017
22;Huesca;117;Graus;3334;1650;1684;2017
22;Huesca;119;Gurrea de Gállego;1483;765;718;2017
22;Huesca;122;Hoz de Jaca;76;37;39;2017
22;Huesca;908;Hoz y Costean;221;122;99;2017
22;Huesca;124;Huerto;218;115;103;2017
22;Huesca;125;Huesca;52223;24957;27266;2017
22;Huesca;126;Ibieca;100;55;45;2017
22;Huesca;127;Igriés;686;356;330;2017
22;Huesca;128;Ilche;213;112;101;2017
22;Huesca;129;Isábena;261;139;122;2017
22;Huesca;130;Jaca;12889;6373;6516;2017
22;Huesca;131;Jasa;94;54;40;2017
22;Huesca;133;Labuerda;157;86;71;2017
22;Huesca;135;Laluenga;210;110;100;2017
22;Huesca;136;Lalueza;943;492;451;2017
22;Huesca;137;Lanaja;1179;628;551;2017
22;Huesca;139;Laperdiguera;91;47;44;2017
22;Huesca;141;Lascellas-Ponzano;128;81;47;2017
22;Huesca;142;Lascuarre;133;68;65;2017
22;Huesca;143;Laspaúles;244;142;102;2017
22;Huesca;144;Laspuña;281;152;129;2017
22;Huesca;149;Loarre;332;185;147;2017
22;Huesca;150;Loporzano;522;294;228;2017
22;Huesca;151;Loscorrales;100;51;49;2017
22;Huesca;905;Lupiñén-Ortilla;335;167;168;2017
22;Huesca;155;Monesma y Cajigar;77;40;37;2017
22;Huesca;156;Monflorite-Lascasas;379;204;175;2017
22;Huesca;157;Montanuy;220;123;97;2017
22;Huesca;158;Monzón;17166;8661;8505;2017
22;Huesca;160;Naval;270;143;127;2017
22;Huesca;162;Novales;155;74;81;2017
22;Huesca;163;Nueno;537;295;242;2017
22;Huesca;164;Olvena;48;24;24;2017
22;Huesca;165;Ontiñena;537;270;267;2017
22;Huesca;167;Osso de Cinca;691;375;316;2017
22;Huesca;168;Palo;26;13;13;2017
22;Huesca;170;Panticosa;795;401;394;2017
22;Huesca;172;Peñalba;662;331;331;2017
22;Huesca;173;Peñas de Riglos, Las;255;161;94;2017
22;Huesca;174;Peralta de Alcofea;576;303;273;2017
22;Huesca;175;Peralta de Calasanz;221;124;97;2017
22;Huesca;176;Peraltilla;200;104;96;2017
22;Huesca;177;Perarrúa;112;61;51;2017
22;Huesca;178;Pertusa;114;68;46;2017
22;Huesca;181;Piracés;104;59;45;2017
22;Huesca;182;Plan;287;149;138;2017
22;Huesca;184;Poleñino;205;110;95;2017
22;Huesca;186;Pozán de Vero;214;103;111;2017
22;Huesca;187;Puebla de Castro, La;361;181;180;2017
22;Huesca;188;Puente de Montañana;96;44;52;2017
22;Huesca;902;Puente la Reina de Jaca;263;134;129;2017
22;Huesca;189;Puértolas;210;121;89;2017
22;Huesca;190;Pueyo de Araguás, El;152;88;64;2017
22;Huesca;193;Pueyo de Santa Cruz;328;165;163;2017
22;Huesca;195;Quicena;283;138;145;2017
22;Huesca;197;Robres;561;286;275;2017
22;Huesca;199;Sabiñánigo;9254;4621;4633;2017
22;Huesca;200;Sahún;305;157;148;2017
22;Huesca;201;Salas Altas;303;155;148;2017
22;Huesca;202;Salas Bajas;171;83;88;2017
22;Huesca;203;Salillas;101;57;44;2017
22;Huesca;204;Sallent de Gállego;1444;730;714;2017
22;Huesca;205;San Esteban de Litera;485;246;239;2017
22;Huesca;207;San Juan de Plan;142;80;62;2017
22;Huesca;903;San Miguel del Cinca;816;417;399;2017
22;Huesca;206;Sangarrén;220;119;101;2017
22;Huesca;208;Santa Cilia;229;124;105;2017
22;Huesca;209;Santa Cruz de la Serós;177;104;73;2017
22;Huesca;906;Santa María de Dulcis;213;116;97;2017
22;Huesca;212;Santaliestra y San Quílez;87;46;41;2017
22;Huesca;213;Sariñena;4155;2142;2013;2017
22;Huesca;214;Secastilla;150;71;79;2017
22;Huesca;215;Seira;143;81;62;2017
22;Huesca;217;Sena;481;259;222;2017
22;Huesca;218;Senés de Alcubierre;42;20;22;2017
22;Huesca;220;Sesa;175;98;77;2017
22;Huesca;221;Sesué;126;68;58;2017
22;Huesca;222;Siétamo;681;376;305;2017
22;Huesca;223;Sopeira;96;51;45;2017
22;Huesca;904;Sotonera, La;932;486;446;2017
22;Huesca;225;Tamarite de Litera;3507;1804;1703;2017
22;Huesca;226;Tardienta;973;489;484;2017
22;Huesca;227;Tella-Sin;231;127;104;2017
22;Huesca;228;Tierz;754;377;377;2017
22;Huesca;229;Tolva;127;71;56;2017
22;Huesca;230;Torla-Ordesa;299;155;144;2017
22;Huesca;232;Torralba de Aragón;114;60;54;2017
22;Huesca;233;Torre la Ribera;103;55;48;2017
22;Huesca;234;Torrente de Cinca;1132;565;567;2017
22;Huesca;235;Torres de Alcanadre;93;57;36;2017
22;Huesca;236;Torres de Barbués;272;138;134;2017
22;Huesca;239;Tramaced;107;67;40;2017
22;Huesca;242;Valfarta;66;41;25;2017
22;Huesca;243;Valle de Bardají;35;19;16;2017
22;Huesca;901;Valle de Hecho;852;445;407;2017
22;Huesca;244;Valle de Lierp;48;23;25;2017
22;Huesca;245;Velilla de Cinca;448;232;216;2017
22;Huesca;909;Vencillón;392;205;187;2017
22;Huesca;247;Viacamp y Litera;35;23;12;2017
22;Huesca;248;Vicién;121;70;51;2017
22;Huesca;249;Villanova;164;82;82;2017
22;Huesca;250;Villanúa;450;239;211;2017
22;Huesca;251;Villanueva de Sigena;405;207;198;2017
22;Huesca;252;Yebra de Basa;147;86;61;2017
22;Huesca;253;Yésero;56;33;23;2017
22;Huesca;254;Zaidín;1772;929;843;2017
23;Jaén;001;Albanchez de Mágina;1060;550;510;2017
23;Jaén;002;Alcalá la Real;21758;10702;11056;2017
23;Jaén;003;Alcaudete;10634;5235;5399;2017
23;Jaén;004;Aldeaquemada;503;273;230;2017
23;Jaén;005;Andújar;37611;18449;19162;2017
23;Jaén;006;Arjona;5662;2799;2863;2017
23;Jaén;007;Arjonilla;3654;1834;1820;2017
23;Jaén;008;Arquillos;1797;893;904;2017
23;Jaén;905;Arroyo del Ojanco;2353;1199;1154;2017
23;Jaén;009;Baeza;15996;7930;8066;2017
23;Jaén;010;Bailén;17924;8917;9007;2017
23;Jaén;011;Baños de la Encina;2613;1343;1270;2017
23;Jaén;012;Beas de Segura;5275;2752;2523;2017
23;Jaén;902;Bedmar y Garcíez;2757;1379;1378;2017
23;Jaén;014;Begíjar;3073;1546;1527;2017
23;Jaén;015;Bélmez de la Moraleda;1600;806;794;2017
23;Jaén;016;Benatae;467;244;223;2017
23;Jaén;017;Cabra del Santo Cristo;1877;993;884;2017
23;Jaén;018;Cambil;2772;1436;1336;2017
23;Jaén;019;Campillo de Arenas;1854;966;888;2017
23;Jaén;020;Canena;1927;990;937;2017
23;Jaén;021;Carboneros;625;322;303;2017
23;Jaén;901;Cárcheles;1375;720;655;2017
23;Jaén;024;Carolina, La;15508;7672;7836;2017
23;Jaén;025;Castellar;3389;1703;1686;2017
23;Jaén;026;Castillo de Locubín;4165;2053;2112;2017
23;Jaén;027;Cazalilla;844;409;435;2017
23;Jaén;028;Cazorla;7613;3691;3922;2017
23;Jaén;029;Chiclana de Segura;988;503;485;2017
23;Jaén;030;Chilluévar;1483;721;762;2017
23;Jaén;031;Escañuela;952;476;476;2017
23;Jaén;032;Espeluy;666;326;340;2017
23;Jaén;033;Frailes;1610;802;808;2017
23;Jaén;034;Fuensanta de Martos;3071;1518;1553;2017
23;Jaén;035;Fuerte del Rey;1384;713;671;2017
23;Jaén;037;Génave;614;333;281;2017
23;Jaén;038;Guardia de Jaén, La;4931;2499;2432;2017
23;Jaén;039;Guarromán;2821;1426;1395;2017
23;Jaén;041;Higuera de Calatrava;622;333;289;2017
23;Jaén;042;Hinojares;334;171;163;2017
23;Jaén;043;Hornos;631;318;313;2017
23;Jaén;044;Huelma;5932;2950;2982;2017
23;Jaén;045;Huesa;2541;1281;1260;2017
23;Jaén;046;Ibros;2925;1471;1454;2017
23;Jaén;047;Iruela, La;1958;973;985;2017
23;Jaén;048;Iznatoraf;1000;518;482;2017
23;Jaén;049;Jabalquinto;2114;1058;1056;2017
23;Jaén;050;Jaén;114238;54948;59290;2017
23;Jaén;051;Jamilena;3343;1695;1648;2017
23;Jaén;052;Jimena;1293;622;671;2017
23;Jaén;053;Jódar;11901;5903;5998;2017
23;Jaén;040;Lahiguera;1759;862;897;2017
23;Jaén;054;Larva;486;248;238;2017
23;Jaén;055;Linares;58449;28619;29830;2017
23;Jaén;056;Lopera;3714;1859;1855;2017
23;Jaén;057;Lupión;881;429;452;2017
23;Jaén;058;Mancha Real;11265;5604;5661;2017
23;Jaén;059;Marmolejo;6968;3477;3491;2017
23;Jaén;060;Martos;24207;12006;12201;2017
23;Jaén;061;Mengíbar;9916;4944;4972;2017
23;Jaén;062;Montizón;1745;901;844;2017
23;Jaén;063;Navas de San Juan;4506;2260;2246;2017
23;Jaén;064;Noalejo;1963;990;973;2017
23;Jaén;065;Orcera;1860;940;920;2017
23;Jaén;066;Peal de Becerro;5290;2630;2660;2017
23;Jaén;067;Pegalajar;2945;1475;1470;2017
23;Jaén;069;Porcuna;6403;3243;3160;2017
23;Jaén;070;Pozo Alcón;4758;2432;2326;2017
23;Jaén;071;Puente de Génave;2218;1117;1101;2017
23;Jaén;072;Puerta de Segura, La;2396;1193;1203;2017
23;Jaén;073;Quesada;5400;2735;2665;2017
23;Jaén;074;Rus;3630;1858;1772;2017
23;Jaén;075;Sabiote;4012;1982;2030;2017
23;Jaén;076;Santa Elena;930;492;438;2017
23;Jaén;077;Santiago de Calatrava;709;374;335;2017
23;Jaén;904;Santiago-Pontones;3108;1599;1509;2017
23;Jaén;079;Santisteban del Puerto;4566;2353;2213;2017
23;Jaén;080;Santo Tomé;2208;1108;1100;2017
23;Jaén;081;Segura de la Sierra;1807;890;917;2017
23;Jaén;082;Siles;2305;1166;1139;2017
23;Jaén;084;Sorihuela del Guadalimar;1157;606;551;2017
23;Jaén;085;Torreblascopedro;2594;1309;1285;2017
23;Jaén;086;Torredelcampo;14435;7235;7200;2017
23;Jaén;087;Torredonjimeno;13780;6774;7006;2017
23;Jaén;088;Torreperogil;7391;3613;3778;2017
23;Jaén;090;Torres;1475;744;731;2017
23;Jaén;091;Torres de Albánchez;826;433;393;2017
23;Jaén;092;Úbeda;34733;17046;17687;2017
23;Jaén;093;Valdepeñas de Jaén;3852;1910;1942;2017
23;Jaén;094;Vilches;4567;2291;2276;2017
23;Jaén;095;Villacarrillo;10857;5459;5398;2017
23;Jaén;096;Villanueva de la Reina;3151;1588;1563;2017
23;Jaén;097;Villanueva del Arzobispo;8402;4331;4071;2017
23;Jaén;098;Villardompardo;1001;499;502;2017
23;Jaén;099;Villares, Los;6007;3001;3006;2017
23;Jaén;101;Villarrodrigo;425;220;205;2017
23;Jaén;903;Villatorres;4389;2221;2168;2017
24;León;001;Acebedo;205;117;88;2017
24;León;002;Algadefe;284;145;139;2017
24;León;003;Alija del Infantado;687;346;341;2017
24;León;004;Almanza;553;318;235;2017
24;León;005;Antigua, La;395;229;166;2017
24;León;006;Ardón;548;302;246;2017
24;León;007;Arganza;819;411;408;2017
24;León;008;Astorga;11153;5262;5891;2017
24;León;009;Balboa;318;172;146;2017
24;León;010;Bañeza, La;10349;4985;5364;2017
24;León;011;Barjas;189;101;88;2017
24;León;012;Barrios de Luna, Los;310;175;135;2017
24;León;014;Bembibre;9191;4528;4663;2017
24;León;015;Benavides;2522;1238;1284;2017
24;León;016;Benuza;487;274;213;2017
24;León;017;Bercianos del Páramo;580;298;282;2017
24;León;018;Bercianos del Real Camino;193;101;92;2017
24;León;019;Berlanga del Bierzo;366;169;197;2017
24;León;020;Boca de Huérgano;470;277;193;2017
24;León;021;Boñar;1865;955;910;2017
24;León;022;Borrenes;332;176;156;2017
24;León;023;Brazuelo;288;156;132;2017
24;León;024;Burgo Ranero, El;751;401;350;2017
24;León;025;Burón;325;192;133;2017
24;León;026;Bustillo del Páramo;1235;637;598;2017
24;León;027;Cabañas Raras;1337;690;647;2017
24;León;028;Cabreros del Río;421;231;190;2017
24;León;029;Cabrillanes;779;401;378;2017
24;León;030;Cacabelos;5152;2552;2600;2017
24;León;031;Calzada del Coto;241;142;99;2017
24;León;032;Campazas;121;58;63;2017
24;León;033;Campo de Villavidel;205;112;93;2017
24;León;034;Camponaraya;4072;2025;2047;2017
24;León;036;Candín;283;151;132;2017
24;León;037;Cármenes;363;201;162;2017
24;León;038;Carracedelo;3500;1737;1763;2017
24;León;039;Carrizo;2278;1155;1123;2017
24;León;040;Carrocera;479;257;222;2017
24;León;041;Carucedo;555;283;272;2017
24;León;042;Castilfalé;68;39;29;2017
24;León;043;Castrillo de Cabrera;129;72;57;2017
24;León;044;Castrillo de la Valduerna;171;76;95;2017
24;León;046;Castrocalbón;1002;519;483;2017
24;León;047;Castrocontrigo;807;429;378;2017
24;León;049;Castropodame;1680;859;821;2017
24;León;050;Castrotierra de Valmadrigal;110;59;51;2017
24;León;051;Cea;436;224;212;2017
24;León;052;Cebanico;158;96;62;2017
24;León;053;Cebrones del Río;472;253;219;2017
24;León;065;Chozas de Abajo;2553;1336;1217;2017
24;León;054;Cimanes de la Vega;471;244;227;2017
24;León;055;Cimanes del Tejar;755;408;347;2017
24;León;056;Cistierna;3243;1604;1639;2017
24;León;057;Congosto;1554;767;787;2017
24;León;058;Corbillos de los Oteros;217;122;95;2017
24;León;059;Corullón;927;471;456;2017
24;León;060;Crémenes;570;311;259;2017
24;León;061;Cuadros;1986;1018;968;2017
24;León;062;Cubillas de los Oteros;152;87;65;2017
24;León;063;Cubillas de Rueda;411;213;198;2017
24;León;064;Cubillos del Sil;1859;986;873;2017
24;León;066;Destriana;511;245;266;2017
24;León;067;Encinedo;715;378;337;2017
24;León;068;Ercina, La;473;245;228;2017
24;León;069;Escobar de Campos;42;25;17;2017
24;León;070;Fabero;4635;2254;2381;2017
24;León;071;Folgoso de la Ribera;1132;548;584;2017
24;León;073;Fresno de la Vega;530;267;263;2017
24;León;074;Fuentes de Carbajal;90;49;41;2017
24;León;076;Garrafe de Torío;1496;821;675;2017
24;León;077;Gordaliza del Pino;252;122;130;2017
24;León;078;Gordoncillo;433;220;213;2017
24;León;079;Gradefes;966;525;441;2017
24;León;080;Grajal de Campos;234;112;122;2017
24;León;081;Gusendos de los Oteros;138;73;65;2017
24;León;082;Hospital de Órbigo;976;486;490;2017
24;León;083;Igüeña;1190;621;569;2017
24;León;084;Izagre;179;91;88;2017
24;León;086;Joarilla de las Matas;304;164;140;2017
24;León;087;Laguna Dalga;683;369;314;2017
24;León;088;Laguna de Negrillos;1079;553;526;2017
24;León;089;León;125317;56822;68495;2017
24;León;092;Llamas de la Ribera;849;440;409;2017
24;León;090;Lucillo;391;203;188;2017
24;León;091;Luyego;678;355;323;2017
24;León;093;Magaz de Cepeda;369;187;182;2017
24;León;094;Mansilla de las Mulas;1768;894;874;2017
24;León;095;Mansilla Mayor;340;180;160;2017
24;León;096;Maraña;121;71;50;2017
24;León;097;Matadeón de los Oteros;236;125;111;2017
24;León;098;Matallana de Torío;1322;698;624;2017
24;León;099;Matanza;179;96;83;2017
24;León;100;Molinaseca;895;489;406;2017
24;León;101;Murias de Paredes;407;205;202;2017
24;León;102;Noceda del Bierzo;692;350;342;2017
24;León;103;Oencia;293;168;125;2017
24;León;104;Omañas, Las;276;145;131;2017
24;León;105;Onzonilla;1779;925;854;2017
24;León;106;Oseja de Sajambre;252;149;103;2017
24;León;107;Pajares de los Oteros;279;170;109;2017
24;León;108;Palacios de la Valduerna;400;192;208;2017
24;León;109;Palacios del Sil;1030;553;477;2017
24;León;110;Páramo del Sil;1336;682;654;2017
24;León;112;Peranzanes;321;182;139;2017
24;León;113;Pobladura de Pelayo García;379;194;185;2017
24;León;114;Pola de Gordón, La;3379;1701;1678;2017
24;León;115;Ponferrada;65788;31354;34434;2017
24;León;116;Posada de Valdeón;452;271;181;2017
24;León;117;Pozuelo del Páramo;455;229;226;2017
24;León;118;Prado de la Guzpeña;123;67;56;2017
24;León;119;Priaranza del Bierzo;785;397;388;2017
24;León;120;Prioro;374;210;164;2017
24;León;121;Puebla de Lillo;693;386;307;2017
24;León;122;Puente de Domingo Flórez;1533;797;736;2017
24;León;123;Quintana del Castillo;773;429;344;2017
24;León;124;Quintana del Marco;388;212;176;2017
24;León;125;Quintana y Congosto;343;168;175;2017
24;León;127;Regueras de Arriba;295;162;133;2017
24;León;129;Reyero;125;65;60;2017
24;León;130;Riaño;477;278;199;2017
24;León;131;Riego de la Vega;812;427;385;2017
24;León;132;Riello;622;352;270;2017
24;León;133;Rioseco de Tapia;390;216;174;2017
24;León;134;Robla, La;4045;2039;2006;2017
24;León;136;Roperuelos del Páramo;565;285;280;2017
24;León;137;Sabero;1184;596;588;2017
24;León;139;Sahagún;2597;1287;1310;2017
24;León;141;San Adrián del Valle;105;58;47;2017
24;León;142;San Andrés del Rabanedo;31123;14921;16202;2017
24;León;144;San Cristóbal de la Polantera;745;374;371;2017
24;León;145;San Emiliano;678;371;307;2017
24;León;146;San Esteban de Nogales;265;139;126;2017
24;León;148;San Justo de la Vega;1912;971;941;2017
24;León;149;San Millán de los Caballeros;176;92;84;2017
24;León;150;San Pedro Bercianos;244;133;111;2017
24;León;143;Sancedo;563;285;278;2017
24;León;151;Santa Colomba de Curueño;508;271;237;2017
24;León;152;Santa Colomba de Somoza;498;273;225;2017
24;León;153;Santa Cristina de Valmadrigal;272;140;132;2017
24;León;154;Santa Elena de Jamuz;1109;579;530;2017
24;León;155;Santa María de la Isla;498;261;237;2017
24;León;158;Santa María de Ordás;329;168;161;2017
24;León;156;Santa María del Monte de Cea;237;130;107;2017
24;León;157;Santa María del Páramo;3104;1520;1584;2017
24;León;159;Santa Marina del Rey;1959;975;984;2017
24;León;160;Santas Martas;768;402;366;2017
24;León;161;Santiago Millas;338;190;148;2017
24;León;162;Santovenia de la Valdoncina;2069;1054;1015;2017
24;León;163;Sariegos;4950;2462;2488;2017
24;León;164;Sena de Luna;389;192;197;2017
24;León;165;Sobrado;333;169;164;2017
24;León;166;Soto de la Vega;1578;823;755;2017
24;León;167;Soto y Amío;823;421;402;2017
24;León;168;Toral de los Guzmanes;515;272;243;2017
24;León;206;Toral de los Vados;1909;944;965;2017
24;León;169;Toreno;3219;1610;1609;2017
24;León;170;Torre del Bierzo;2157;1102;1055;2017
24;León;171;Trabadelo;352;195;157;2017
24;León;172;Truchas;426;222;204;2017
24;León;173;Turcia;1035;525;510;2017
24;León;174;Urdiales del Páramo;502;272;230;2017
24;León;185;Val de San Lorenzo;519;258;261;2017
24;León;175;Valdefresno;2167;1110;1057;2017
24;León;176;Valdefuentes del Páramo;335;176;159;2017
24;León;177;Valdelugueros;530;301;229;2017
24;León;178;Valdemora;74;33;41;2017
24;León;179;Valdepiélago;338;193;145;2017
24;León;180;Valdepolo;1240;656;584;2017
24;León;181;Valderas;1719;875;844;2017
24;León;182;Valderrey;450;216;234;2017
24;León;183;Valderrueda;885;456;429;2017
24;León;184;Valdesamario;199;112;87;2017
24;León;187;Valdevimbre;1006;533;473;2017
24;León;188;Valencia de Don Juan;5201;2547;2654;2017
24;León;191;Vallecillo;121;71;50;2017
24;León;189;Valverde de la Virgen;7305;3785;3520;2017
24;León;190;Valverde-Enrique;161;84;77;2017
24;León;193;Vecilla, La;409;213;196;2017
24;León;196;Vega de Espinareda;2210;1119;1091;2017
24;León;197;Vega de Infanzones;880;445;435;2017
24;León;198;Vega de Valcarce;621;319;302;2017
24;León;194;Vegacervera;293;152;141;2017
24;León;199;Vegaquemada;445;243;202;2017
24;León;201;Vegas del Condado;1158;664;494;2017
24;León;202;Villablino;9150;4510;4640;2017
24;León;203;Villabraz;99;59;40;2017
24;León;205;Villadangos del Páramo;1106;570;536;2017
24;León;207;Villademor de la Vega;337;182;155;2017
24;León;209;Villafranca del Bierzo;3055;1476;1579;2017
24;León;210;Villagatón;588;320;268;2017
24;León;211;Villamandos;303;169;134;2017
24;León;901;Villamanín;958;499;459;2017
24;León;212;Villamañán;1181;575;606;2017
24;León;213;Villamartín de Don Sancho;153;86;67;2017
24;León;214;Villamejil;704;370;334;2017
24;León;215;Villamol;167;83;84;2017
24;León;216;Villamontán de la Valduerna;758;398;360;2017
24;León;217;Villamoratiel de las Matas;163;92;71;2017
24;León;218;Villanueva de las Manzanas;501;264;237;2017
24;León;219;Villaobispo de Otero;576;315;261;2017
24;León;902;Villaornate y Castro;360;179;181;2017
24;León;221;Villaquejida;904;456;448;2017
24;León;222;Villaquilambre;18666;9241;9425;2017
24;León;223;Villarejo de Órbigo;3034;1487;1547;2017
24;León;224;Villares de Órbigo;643;339;304;2017
24;León;225;Villasabariego;1152;616;536;2017
24;León;226;Villaselán;199;112;87;2017
24;León;227;Villaturiel;1932;994;938;2017
24;León;228;Villazala;693;367;326;2017
24;León;229;Villazanzo de Valderaduey;440;252;188;2017
24;León;230;Zotes del Páramo;443;247;196;2017
25;Lleida;001;Abella de la Conca;184;102;82;2017
25;Lleida;002;Àger;586;315;271;2017
25;Lleida;003;Agramunt;5405;2706;2699;2017
25;Lleida;038;Aitona;2548;1321;1227;2017
25;Lleida;004;Alamús, Els;777;411;366;2017
25;Lleida;005;Alàs i Cerc;351;178;173;2017
25;Lleida;006;Albagés, L';393;211;182;2017
25;Lleida;007;Albatàrrec;2275;1183;1092;2017
25;Lleida;008;Albesa;1582;855;727;2017
25;Lleida;009;Albi, L';781;404;377;2017
25;Lleida;010;Alcanó;243;121;122;2017
25;Lleida;011;Alcarràs;9363;4836;4527;2017
25;Lleida;012;Alcoletge;3415;1773;1642;2017
25;Lleida;013;Alfarràs;2879;1515;1364;2017
25;Lleida;014;Alfés;313;162;151;2017
25;Lleida;015;Algerri;417;222;195;2017
25;Lleida;016;Alguaire;2970;1562;1408;2017
25;Lleida;017;Alins;286;152;134;2017
25;Lleida;019;Almacelles;6857;3577;3280;2017
25;Lleida;020;Almatret;319;174;145;2017
25;Lleida;021;Almenar;3468;1838;1630;2017
25;Lleida;022;Alòs de Balaguer;128;74;54;2017
25;Lleida;023;Alpicat;6285;3146;3139;2017
25;Lleida;024;Alt Àneu;405;229;176;2017
25;Lleida;027;Anglesola;1324;665;659;2017
25;Lleida;029;Arbeca;2231;1129;1102;2017
25;Lleida;031;Arres;59;37;22;2017
25;Lleida;032;Arsèguel;82;48;34;2017
25;Lleida;033;Artesa de Lleida;1527;795;732;2017
25;Lleida;034;Artesa de Segre;3508;1791;1717;2017
25;Lleida;036;Aspa;214;107;107;2017
25;Lleida;037;Avellanes i Santa Linya, Les;455;262;193;2017
25;Lleida;039;Baix Pallars;341;183;158;2017
25;Lleida;040;Balaguer;16670;8420;8250;2017
25;Lleida;041;Barbens;933;497;436;2017
25;Lleida;042;Baronia de Rialb, La;235;124;111;2017
25;Lleida;044;Bassella;229;109;120;2017
25;Lleida;045;Bausen;67;33;34;2017
25;Lleida;046;Belianes;519;261;258;2017
25;Lleida;170;Bellaguarda;305;159;146;2017
25;Lleida;047;Bellcaire d'Urgell;1237;623;614;2017
25;Lleida;048;Bell-lloc d'Urgell;2321;1157;1164;2017
25;Lleida;049;Bellmunt d'Urgell;188;92;96;2017
25;Lleida;050;Bellpuig;4985;2591;2394;2017
25;Lleida;051;Bellver de Cerdanya;1973;1014;959;2017
25;Lleida;052;Bellvís;2276;1157;1119;2017
25;Lleida;053;Benavent de Segrià;1442;753;689;2017
25;Lleida;055;Biosca;186;99;87;2017
25;Lleida;057;Bòrdes, Es;252;140;112;2017
25;Lleida;058;Borges Blanques, Les;6005;3068;2937;2017
25;Lleida;059;Bossòst;1120;546;574;2017
25;Lleida;056;Bovera;266;147;119;2017
25;Lleida;060;Cabanabona;81;35;46;2017
25;Lleida;061;Cabó;93;51;42;2017
25;Lleida;062;Camarasa;863;439;424;2017
25;Lleida;063;Canejan;88;51;37;2017
25;Lleida;904;Castell de Mur;168;94;74;2017
25;Lleida;064;Castellar de la Ribera;140;72;68;2017
25;Lleida;067;Castelldans;943;506;437;2017
25;Lleida;068;Castellnou de Seana;686;362;324;2017
25;Lleida;069;Castelló de Farfanya;542;289;253;2017
25;Lleida;070;Castellserà;1008;507;501;2017
25;Lleida;071;Cava;52;32;20;2017
25;Lleida;072;Cervera;9037;4559;4478;2017
25;Lleida;073;Cervià de les Garrigues;660;348;312;2017
25;Lleida;074;Ciutadilla;202;109;93;2017
25;Lleida;075;Clariana de Cardener;145;72;73;2017
25;Lleida;076;Cogul, El;162;87;75;2017
25;Lleida;077;Coll de Nargó;558;286;272;2017
25;Lleida;163;Coma i la Pedra, La;259;157;102;2017
25;Lleida;161;Conca de Dalt;445;233;212;2017
25;Lleida;078;Corbins;1411;764;647;2017
25;Lleida;079;Cubells;373;198;175;2017
25;Lleida;081;Espluga Calba, L';363;182;181;2017
25;Lleida;082;Espot;365;194;171;2017
25;Lleida;088;Estamariu;124;72;52;2017
25;Lleida;085;Estaràs;158;85;73;2017
25;Lleida;086;Esterri d'Àneu;769;369;400;2017
25;Lleida;087;Esterri de Cardós;67;34;33;2017
25;Lleida;089;Farrera;121;70;51;2017
25;Lleida;908;Fígols i Alinyà;245;139;106;2017
25;Lleida;092;Floresta, La;155;83;72;2017
25;Lleida;093;Fondarella;796;394;402;2017
25;Lleida;094;Foradada;170;98;72;2017
25;Lleida;096;Fuliola, La;1237;624;613;2017
25;Lleida;097;Fulleda;86;43;43;2017
25;Lleida;098;Gavet de la Conca;280;132;148;2017
25;Lleida;912;Gimenells i el Pla de la Font;1107;579;528;2017
25;Lleida;099;Golmés;1852;916;936;2017
25;Lleida;100;Gósol;222;121;101;2017
25;Lleida;101;Granadella, La;737;388;349;2017
25;Lleida;102;Granja d'Escarp, La;971;522;449;2017
25;Lleida;103;Granyanella;147;81;66;2017
25;Lleida;105;Granyena de les Garrigues;158;95;63;2017
25;Lleida;104;Granyena de Segarra;143;73;70;2017
25;Lleida;109;Guimerà;273;148;125;2017
25;Lleida;903;Guingueta d'Àneu, La;311;166;145;2017
25;Lleida;110;Guissona;7014;3721;3293;2017
25;Lleida;111;Guixers;140;86;54;2017
25;Lleida;115;Isona i Conca Dellà;1027;544;483;2017
25;Lleida;112;Ivars de Noguera;332;175;157;2017
25;Lleida;113;Ivars d'Urgell;1568;820;748;2017
25;Lleida;114;Ivorra;107;57;50;2017
25;Lleida;910;Josa i Tuixén;115;68;47;2017
25;Lleida;118;Juncosa;408;217;191;2017
25;Lleida;119;Juneda;3383;1766;1617;2017
25;Lleida;121;Les;955;471;484;2017
25;Lleida;122;Linyola;2626;1317;1309;2017
25;Lleida;123;Lladorre;225;108;117;2017
25;Lleida;124;Lladurs;183;95;88;2017
25;Lleida;125;Llardecans;470;246;224;2017
25;Lleida;126;Llavorsí;359;173;186;2017
25;Lleida;120;Lleida;137327;67855;69472;2017
25;Lleida;127;Lles de Cerdanya;253;144;109;2017
25;Lleida;128;Llimiana;142;83;59;2017
25;Lleida;129;Llobera;201;110;91;2017
25;Lleida;133;Maials;945;521;424;2017
25;Lleida;130;Maldà;227;114;113;2017
25;Lleida;131;Massalcoreig;588;335;253;2017
25;Lleida;132;Massoteres;214;116;98;2017
25;Lleida;134;Menàrguens;819;458;361;2017
25;Lleida;135;Miralcamp;1358;684;674;2017
25;Lleida;137;Mollerussa;14574;7437;7137;2017
25;Lleida;136;Molsosa, La;109;53;56;2017
25;Lleida;139;Montellà i Martinet;554;305;249;2017
25;Lleida;140;Montferrer i Castellbò;1092;591;501;2017
25;Lleida;138;Montgai;636;332;304;2017
25;Lleida;142;Montoliu de Lleida;469;234;235;2017
25;Lleida;141;Montoliu de Segarra;178;98;80;2017
25;Lleida;143;Montornès de Segarra;97;46;51;2017
25;Lleida;145;Nalec;101;54;47;2017
25;Lleida;025;Naut Aran;1781;916;865;2017
25;Lleida;146;Navès;288;144;144;2017
25;Lleida;148;Odèn;256;150;106;2017
25;Lleida;149;Oliana;1826;918;908;2017
25;Lleida;150;Oliola;211;113;98;2017
25;Lleida;151;Olius;931;497;434;2017
25;Lleida;152;Oluges, Les;155;81;74;2017
25;Lleida;153;Omellons, Els;210;111;99;2017
25;Lleida;154;Omells de na Gaia, Els;135;72;63;2017
25;Lleida;155;Organyà;801;401;400;2017
25;Lleida;156;Os de Balaguer;1013;514;499;2017
25;Lleida;157;Ossó de Sió;213;106;107;2017
25;Lleida;158;Palau d'Anglesola, El;2183;1072;1111;2017
25;Lleida;164;Penelles;463;265;198;2017
25;Lleida;165;Peramola;341;169;172;2017
25;Lleida;166;Pinell de Solsonès;211;123;88;2017
25;Lleida;167;Pinós;312;163;149;2017
25;Lleida;911;Plans de Sió, Els;509;267;242;2017
25;Lleida;168;Poal, El;637;333;304;2017
25;Lleida;169;Pobla de Cérvoles, La;194;109;85;2017
25;Lleida;171;Pobla de Segur, La;2949;1462;1487;2017
25;Lleida;030;Pont de Bar, El;171;94;77;2017
25;Lleida;173;Pont de Suert, El;2265;1140;1125;2017
25;Lleida;172;Ponts;2622;1292;1330;2017
25;Lleida;174;Portella, La;708;395;313;2017
25;Lleida;175;Prats i Sansor;232;119;113;2017
25;Lleida;176;Preixana;381;199;182;2017
25;Lleida;177;Preixens;443;228;215;2017
25;Lleida;179;Prullans;224;110;114;2017
25;Lleida;180;Puiggròs;280;141;139;2017
25;Lleida;181;Puigverd d'Agramunt;228;127;101;2017
25;Lleida;182;Puigverd de Lleida;1350;694;656;2017
25;Lleida;183;Rialp;666;345;321;2017
25;Lleida;905;Ribera d'Ondara;433;222;211;2017
25;Lleida;185;Ribera d'Urgellet;936;483;453;2017
25;Lleida;186;Riner;262;130;132;2017
25;Lleida;913;Riu de Cerdanya;93;55;38;2017
25;Lleida;189;Rosselló;3083;1549;1534;2017
25;Lleida;190;Salàs de Pallars;337;180;157;2017
25;Lleida;191;Sanaüja;401;209;192;2017
25;Lleida;196;Sant Esteve de la Sarga;130;77;53;2017
25;Lleida;192;Sant Guim de Freixenet;1028;538;490;2017
25;Lleida;197;Sant Guim de la Plana;177;101;76;2017
25;Lleida;193;Sant Llorenç de Morunys;949;470;479;2017
25;Lleida;902;Sant Martí de Riucorb;661;347;314;2017
25;Lleida;194;Sant Ramon;507;275;232;2017
25;Lleida;201;Sarroca de Bellera;120;69;51;2017
25;Lleida;200;Sarroca de Lleida;370;201;169;2017
25;Lleida;202;Senterada;136;79;57;2017
25;Lleida;035;Sentiu de Sió, La;445;229;216;2017
25;Lleida;204;Seròs;1895;1020;875;2017
25;Lleida;203;Seu d'Urgell, La;12015;5789;6226;2017
25;Lleida;205;Sidamon;732;383;349;2017
25;Lleida;206;Soleràs, El;346;183;163;2017
25;Lleida;207;Solsona;8974;4444;4530;2017
25;Lleida;208;Soriguera;403;220;183;2017
25;Lleida;209;Sort;2128;1056;1072;2017
25;Lleida;210;Soses;1719;889;830;2017
25;Lleida;211;Sudanell;874;482;392;2017
25;Lleida;212;Sunyer;359;209;150;2017
25;Lleida;215;Talarn;702;476;226;2017
25;Lleida;216;Talavera;250;141;109;2017
25;Lleida;217;Tàrrega;16599;8230;8369;2017
25;Lleida;218;Tarrés;99;56;43;2017
25;Lleida;219;Tarroja de Segarra;181;99;82;2017
25;Lleida;220;Térmens;1442;720;722;2017
25;Lleida;221;Tírvia;141;69;72;2017
25;Lleida;222;Tiurana;76;37;39;2017
25;Lleida;223;Torà;1223;613;610;2017
25;Lleida;224;Torms, Els;147;83;64;2017
25;Lleida;225;Tornabous;858;465;393;2017
25;Lleida;227;Torre de Cabdella, La;754;386;368;2017
25;Lleida;226;Torrebesses;290;155;135;2017
25;Lleida;228;Torrefarrera;4653;2363;2290;2017
25;Lleida;907;Torrefeta i Florejacs;591;313;278;2017
25;Lleida;230;Torregrossa;2192;1113;1079;2017
25;Lleida;231;Torrelameu;715;403;312;2017
25;Lleida;232;Torres de Segre;2225;1130;1095;2017
25;Lleida;233;Torre-serona;363;185;178;2017
25;Lleida;234;Tremp;5906;2910;2996;2017
25;Lleida;043;Vall de Boí, La;1015;537;478;2017
25;Lleida;901;Vall de Cardós;360;191;169;2017
25;Lleida;238;Vallbona de les Monges;226;122;104;2017
25;Lleida;240;Vallfogona de Balaguer;1867;929;938;2017
25;Lleida;906;Valls d'Aguilar, Les;277;152;125;2017
25;Lleida;239;Valls de Valira, Les;808;418;390;2017
25;Lleida;909;Vansa i Fórnols, La;180;96;84;2017
25;Lleida;242;Verdú;924;441;483;2017
25;Lleida;243;Vielha e Mijaran;5512;2811;2701;2017
25;Lleida;244;Vilagrassa;522;270;252;2017
25;Lleida;245;Vilaller;547;292;255;2017
25;Lleida;247;Vilamòs;151;83;68;2017
25;Lleida;248;Vilanova de Bellpuig;1159;587;572;2017
25;Lleida;254;Vilanova de la Barca;1044;533;511;2017
25;Lleida;249;Vilanova de l'Aguda;206;102;104;2017
25;Lleida;250;Vilanova de Meià;401;224;177;2017
25;Lleida;251;Vilanova de Segrià;943;497;446;2017
25;Lleida;252;Vila-sana;721;356;365;2017
25;Lleida;253;Vilosell, El;180;91;89;2017
25;Lleida;255;Vinaixa;483;254;229;2017
27;Lugo;001;Abadín;2490;1231;1259;2017
27;Lugo;002;Alfoz;1782;856;926;2017
27;Lugo;003;Antas de Ulla;2059;1012;1047;2017
27;Lugo;004;Baleira;1296;684;612;2017
27;Lugo;901;Baralla;2630;1376;1254;2017
27;Lugo;005;Barreiros;2948;1405;1543;2017
27;Lugo;006;Becerreá;2856;1434;1422;2017
27;Lugo;007;Begonte;3071;1539;1532;2017
27;Lugo;008;Bóveda;1527;784;743;2017
27;Lugo;902;Burela;9524;4727;4797;2017
27;Lugo;009;Carballedo;2266;1141;1125;2017
27;Lugo;010;Castro de Rei;5013;2463;2550;2017
27;Lugo;011;Castroverde;2676;1381;1295;2017
27;Lugo;012;Cervantes;1423;805;618;2017
27;Lugo;013;Cervo;4274;2097;2177;2017
27;Lugo;016;Chantada;8371;4065;4306;2017
27;Lugo;014;Corgo, O;3523;1786;1737;2017
27;Lugo;015;Cospeito;4665;2258;2407;2017
27;Lugo;017;Folgoso do Courel;1025;539;486;2017
27;Lugo;018;Fonsagrada, A;3670;1905;1765;2017
27;Lugo;019;Foz;9931;4853;5078;2017
27;Lugo;020;Friol;3842;1935;1907;2017
27;Lugo;022;Guitiriz;5512;2738;2774;2017
27;Lugo;023;Guntín;2780;1418;1362;2017
27;Lugo;024;Incio, O;1667;833;834;2017
27;Lugo;026;Láncara;2696;1368;1328;2017
27;Lugo;027;Lourenzá;2224;1079;1145;2017
27;Lugo;028;Lugo;97995;45468;52527;2017
27;Lugo;029;Meira;1726;859;867;2017
27;Lugo;030;Mondoñedo;3722;1745;1977;2017
27;Lugo;031;Monforte de Lemos;18783;8923;9860;2017
27;Lugo;032;Monterroso;3678;1839;1839;2017
27;Lugo;033;Muras;648;327;321;2017
27;Lugo;034;Navia de Suarna;1140;640;500;2017
27;Lugo;035;Negueira de Muñiz;219;113;106;2017
27;Lugo;037;Nogais, As;1146;608;538;2017
27;Lugo;038;Ourol;1016;514;502;2017
27;Lugo;039;Outeiro de Rei;5063;2600;2463;2017
27;Lugo;040;Palas de Rei;3489;1768;1721;2017
27;Lugo;041;Pantón;2565;1233;1332;2017
27;Lugo;042;Paradela;1851;923;928;2017
27;Lugo;043;Páramo, O;1420;718;702;2017
27;Lugo;044;Pastoriza, A;3133;1578;1555;2017
27;Lugo;045;Pedrafita do Cebreiro;1070;575;495;2017
27;Lugo;047;Pobra do Brollón, A;1709;854;855;2017
27;Lugo;046;Pol;1663;822;841;2017
27;Lugo;048;Pontenova, A;2330;1124;1206;2017
27;Lugo;049;Portomarín;1508;774;734;2017
27;Lugo;050;Quiroga;3328;1600;1728;2017
27;Lugo;056;Rábade;1519;762;757;2017
27;Lugo;051;Ribadeo;9962;4762;5200;2017
27;Lugo;052;Ribas de Sil;980;491;489;2017
27;Lugo;053;Ribeira de Piquín;554;281;273;2017
27;Lugo;054;Riotorto;1288;638;650;2017
27;Lugo;055;Samos;1343;714;629;2017
27;Lugo;057;Sarria;13359;6515;6844;2017
27;Lugo;058;Saviñao, O;3832;1927;1905;2017
27;Lugo;059;Sober;2338;1145;1193;2017
27;Lugo;060;Taboada;2862;1355;1507;2017
27;Lugo;061;Trabada;1117;541;576;2017
27;Lugo;062;Triacastela;658;327;331;2017
27;Lugo;063;Valadouro, O;2002;971;1031;2017
27;Lugo;064;Vicedo, O;1747;858;889;2017
27;Lugo;065;Vilalba;14354;6971;7383;2017
27;Lugo;066;Viveiro;15550;7626;7924;2017
27;Lugo;021;Xermade;1884;911;973;2017
27;Lugo;025;Xove;3342;1663;1679;2017
28;Madrid;001;Acebeda, La;66;37;29;2017
28;Madrid;002;Ajalvir;4455;2327;2128;2017
28;Madrid;003;Alameda del Valle;199;117;82;2017
28;Madrid;004;Álamo, El;9149;4553;4596;2017
28;Madrid;005;Alcalá de Henares;194310;94877;99433;2017
28;Madrid;006;Alcobendas;114864;55206;59658;2017
28;Madrid;007;Alcorcón;168141;81235;86906;2017
28;Madrid;008;Aldea del Fresno;2616;1377;1239;2017
28;Madrid;009;Algete;20419;10122;10297;2017
28;Madrid;010;Alpedrete;14240;6980;7260;2017
28;Madrid;011;Ambite;677;352;325;2017
28;Madrid;012;Anchuelo;1238;647;591;2017
28;Madrid;013;Aranjuez;58213;28387;29826;2017
28;Madrid;014;Arganda del Rey;53821;27006;26815;2017
28;Madrid;015;Arroyomolinos;29128;14624;14504;2017
28;Madrid;016;Atazar, El;97;56;41;2017
28;Madrid;017;Batres;1610;823;787;2017
28;Madrid;018;Becerril de la Sierra;5457;2710;2747;2017
28;Madrid;019;Belmonte de Tajo;1628;854;774;2017
28;Madrid;021;Berrueco, El;743;384;359;2017
28;Madrid;020;Berzosa del Lozoya;203;120;83;2017
28;Madrid;022;Boadilla del Monte;51463;25163;26300;2017
28;Madrid;023;Boalo, El;7358;3724;3634;2017
28;Madrid;024;Braojos;208;122;86;2017
28;Madrid;025;Brea de Tajo;539;308;231;2017
28;Madrid;026;Brunete;10373;5125;5248;2017
28;Madrid;027;Buitrago del Lozoya;1854;887;967;2017
28;Madrid;028;Bustarviejo;2399;1197;1202;2017
28;Madrid;029;Cabanillas de la Sierra;712;371;341;2017
28;Madrid;030;Cabrera, La;2570;1278;1292;2017
28;Madrid;031;Cadalso de los Vidrios;3053;1599;1454;2017
28;Madrid;032;Camarma de Esteruelas;7084;3590;3494;2017
28;Madrid;033;Campo Real;5995;3022;2973;2017
28;Madrid;034;Canencia;448;241;207;2017
28;Madrid;035;Carabaña;1940;961;979;2017
28;Madrid;036;Casarrubuelos;3650;1867;1783;2017
28;Madrid;037;Cenicientos;1984;973;1011;2017
28;Madrid;038;Cercedilla;6853;3353;3500;2017
28;Madrid;039;Cervera de Buitrago;156;92;64;2017
28;Madrid;051;Chapinería;2225;1135;1090;2017
28;Madrid;052;Chinchón;5240;2645;2595;2017
28;Madrid;040;Ciempozuelos;23737;11951;11786;2017
28;Madrid;041;Cobeña;7163;3534;3629;2017
28;Madrid;046;Collado Mediano;6666;3336;3330;2017
28;Madrid;047;Collado Villalba;62152;30269;31883;2017
28;Madrid;043;Colmenar de Oreja;7810;3959;3851;2017
28;Madrid;042;Colmenar del Arroyo;1632;839;793;2017
28;Madrid;045;Colmenar Viejo;48614;24029;24585;2017
28;Madrid;044;Colmenarejo;9015;4434;4581;2017
28;Madrid;048;Corpa;684;363;321;2017
28;Madrid;049;Coslada;83011;40782;42229;2017
28;Madrid;050;Cubas de la Sagra;6112;3024;3088;2017
28;Madrid;053;Daganzo de Arriba;10082;5039;5043;2017
28;Madrid;054;Escorial, El;15562;7675;7887;2017
28;Madrid;055;Estremera;1261;640;621;2017
28;Madrid;056;Fresnedillas de la Oliva;1550;792;758;2017
28;Madrid;057;Fresno de Torote;2115;1109;1006;2017
28;Madrid;058;Fuenlabrada;194669;96237;98432;2017
28;Madrid;059;Fuente el Saz de Jarama;6424;3258;3166;2017
28;Madrid;060;Fuentidueña de Tajo;1980;1003;977;2017
28;Madrid;061;Galapagar;32903;16148;16755;2017
28;Madrid;062;Garganta de los Montes;331;181;150;2017
28;Madrid;063;Gargantilla del Lozoya y Pinilla de Buitrago;315;176;139;2017
28;Madrid;064;Gascones;176;105;71;2017
28;Madrid;065;Getafe;178288;87292;90996;2017
28;Madrid;066;Griñón;10060;5001;5059;2017
28;Madrid;067;Guadalix de la Sierra;6049;3028;3021;2017
28;Madrid;068;Guadarrama;15620;7686;7934;2017
28;Madrid;069;Hiruela, La;52;33;19;2017
28;Madrid;070;Horcajo de la Sierra-Aoslos;142;78;64;2017
28;Madrid;071;Horcajuelo de la Sierra;88;43;45;2017
28;Madrid;072;Hoyo de Manzanares;8032;4039;3993;2017
28;Madrid;073;Humanes de Madrid;19607;9859;9748;2017
28;Madrid;074;Leganés;187720;91340;96380;2017
28;Madrid;075;Loeches;8525;4304;4221;2017
28;Madrid;076;Lozoya;559;292;267;2017
28;Madrid;901;Lozoyuela-Navas-Sieteiglesias;1237;649;588;2017
28;Madrid;078;Madarcos;46;29;17;2017
28;Madrid;079;Madrid;3182981;1480600;1702381;2017
28;Madrid;080;Majadahonda;71299;33810;37489;2017
28;Madrid;082;Manzanares el Real;8500;4308;4192;2017
28;Madrid;083;Meco;13570;6859;6711;2017
28;Madrid;084;Mejorada del Campo;22948;11445;11503;2017
28;Madrid;085;Miraflores de la Sierra;5817;2997;2820;2017
28;Madrid;086;Molar, El;8491;4279;4212;2017
28;Madrid;087;Molinos, Los;4345;2145;2200;2017
28;Madrid;088;Montejo de la Sierra;356;181;175;2017
28;Madrid;089;Moraleja de Enmedio;4870;2431;2439;2017
28;Madrid;090;Moralzarzal;12496;6242;6254;2017
28;Madrid;091;Morata de Tajuña;7482;3750;3732;2017
28;Madrid;092;Móstoles;206589;100871;105718;2017
28;Madrid;093;Navacerrada;2894;1435;1459;2017
28;Madrid;094;Navalafuente;1340;680;660;2017
28;Madrid;095;Navalagamella;2443;1261;1182;2017
28;Madrid;096;Navalcarnero;27570;13775;13795;2017
28;Madrid;097;Navarredonda y San Mamés;131;84;47;2017
28;Madrid;099;Navas del Rey;2751;1466;1285;2017
28;Madrid;100;Nuevo Baztán;6091;3095;2996;2017
28;Madrid;101;Olmeda de las Fuentes;332;173;159;2017
28;Madrid;102;Orusco de Tajuña;1218;612;606;2017
28;Madrid;104;Paracuellos de Jarama;23905;12121;11784;2017
28;Madrid;106;Parla;125898;62635;63263;2017
28;Madrid;107;Patones;553;262;291;2017
28;Madrid;108;Pedrezuela;5613;2811;2802;2017
28;Madrid;109;Pelayos de la Presa;2468;1250;1218;2017
28;Madrid;110;Perales de Tajuña;2817;1421;1396;2017
28;Madrid;111;Pezuela de las Torres;816;426;390;2017
28;Madrid;112;Pinilla del Valle;185;106;79;2017
28;Madrid;113;Pinto;50442;24984;25458;2017
28;Madrid;114;Piñuécar-Gandullas;183;95;88;2017
28;Madrid;115;Pozuelo de Alarcón;85605;41076;44529;2017
28;Madrid;116;Pozuelo del Rey;1099;577;522;2017
28;Madrid;117;Prádena del Rincón;132;73;59;2017
28;Madrid;118;Puebla de la Sierra;61;37;24;2017
28;Madrid;902;Puentes Viejas;632;345;287;2017
28;Madrid;119;Quijorna;3282;1660;1622;2017
28;Madrid;120;Rascafría;1672;914;758;2017
28;Madrid;121;Redueña;248;135;113;2017
28;Madrid;122;Ribatejada;702;360;342;2017
28;Madrid;123;Rivas-Vaciamadrid;83767;41625;42142;2017
28;Madrid;124;Robledillo de la Jara;87;43;44;2017
28;Madrid;125;Robledo de Chavela;4073;2126;1947;2017
28;Madrid;126;Robregordo;44;27;17;2017
28;Madrid;127;Rozas de Madrid, Las;95071;46015;49056;2017
28;Madrid;128;Rozas de Puerto Real;534;310;224;2017
28;Madrid;129;San Agustín del Guadalix;13103;6430;6673;2017
28;Madrid;130;San Fernando de Henares;39681;19358;20323;2017
28;Madrid;131;San Lorenzo de El Escorial;18024;8637;9387;2017
28;Madrid;132;San Martín de la Vega;18824;9600;9224;2017
28;Madrid;133;San Martín de Valdeiglesias;8298;4157;4141;2017
28;Madrid;134;San Sebastián de los Reyes;86707;42420;44287;2017
28;Madrid;135;Santa María de la Alameda;1163;616;547;2017
28;Madrid;136;Santorcaz;856;437;419;2017
28;Madrid;137;Santos de la Humosa, Los;2486;1270;1216;2017
28;Madrid;138;Serna del Monte, La;73;40;33;2017
28;Madrid;140;Serranillos del Valle;3967;1966;2001;2017
28;Madrid;141;Sevilla la Nueva;9093;4485;4608;2017
28;Madrid;143;Somosierra;77;44;33;2017
28;Madrid;144;Soto del Real;8607;4223;4384;2017
28;Madrid;145;Talamanca de Jarama;3573;1769;1804;2017
28;Madrid;146;Tielmes;2610;1330;1280;2017
28;Madrid;147;Titulcia;1274;651;623;2017
28;Madrid;148;Torrejón de Ardoz;128013;63115;64898;2017
28;Madrid;149;Torrejón de la Calzada;8418;4152;4266;2017
28;Madrid;150;Torrejón de Velasco;4261;2137;2124;2017
28;Madrid;151;Torrelaguna;4712;2381;2331;2017
28;Madrid;152;Torrelodones;23128;11123;12005;2017
28;Madrid;153;Torremocha de Jarama;942;475;467;2017
28;Madrid;154;Torres de la Alameda;7825;4002;3823;2017
28;Madrid;903;Tres Cantos;46046;22349;23697;2017
28;Madrid;155;Valdaracete;643;335;308;2017
28;Madrid;156;Valdeavero;1450;758;692;2017
28;Madrid;157;Valdelaguna;867;438;429;2017
28;Madrid;158;Valdemanco;916;490;426;2017
28;Madrid;159;Valdemaqueda;768;391;377;2017
28;Madrid;160;Valdemorillo;12300;6243;6057;2017
28;Madrid;161;Valdemoro;73976;36694;37282;2017
28;Madrid;162;Valdeolmos-Alalpardo;3906;1987;1919;2017
28;Madrid;163;Valdepiélagos;587;315;272;2017
28;Madrid;164;Valdetorres de Jarama;4316;2193;2123;2017
28;Madrid;165;Valdilecha;2755;1430;1325;2017
28;Madrid;166;Valverde de Alcalá;427;225;202;2017
28;Madrid;167;Velilla de San Antonio;12111;6100;6011;2017
28;Madrid;168;Vellón, El;1834;968;866;2017
28;Madrid;169;Venturada;2032;1077;955;2017
28;Madrid;171;Villa del Prado;6337;3226;3111;2017
28;Madrid;170;Villaconejos;3350;1700;1650;2017
28;Madrid;172;Villalbilla;13038;6591;6447;2017
28;Madrid;173;Villamanrique de Tajo;694;354;340;2017
28;Madrid;174;Villamanta;2491;1258;1233;2017
28;Madrid;175;Villamantilla;1382;685;697;2017
28;Madrid;176;Villanueva de la Cañada;20320;9913;10407;2017
28;Madrid;178;Villanueva de Perales;1519;771;748;2017
28;Madrid;177;Villanueva del Pardillo;17025;8297;8728;2017
28;Madrid;179;Villar del Olmo;1997;1018;979;2017
28;Madrid;180;Villarejo de Salvanés;7245;3643;3602;2017
28;Madrid;181;Villaviciosa de Odón;27504;13337;14167;2017
28;Madrid;182;Villavieja del Lozoya;267;148;119;2017
28;Madrid;183;Zarzalejo;1596;834;762;2017
29;Málaga;001;Alameda;5384;2714;2670;2017
29;Málaga;002;Alcaucín;2253;1159;1094;2017
29;Málaga;003;Alfarnate;1113;573;540;2017
29;Málaga;004;Alfarnatejo;397;210;187;2017
29;Málaga;005;Algarrobo;6284;3152;3132;2017
29;Málaga;006;Algatocín;778;402;376;2017
29;Málaga;007;Alhaurín de la Torre;39153;19458;19695;2017
29;Málaga;008;Alhaurín el Grande;24720;12350;12370;2017
29;Málaga;009;Almáchar;1814;936;878;2017
29;Málaga;010;Almargen;2004;1025;979;2017
29;Málaga;011;Almogía;3765;1937;1828;2017
29;Málaga;012;Álora;12924;6527;6397;2017
29;Málaga;013;Alozaina;2017;1019;998;2017
29;Málaga;014;Alpandeire;244;125;119;2017
29;Málaga;015;Antequera;41104;20132;20972;2017
29;Málaga;016;Árchez;405;205;200;2017
29;Málaga;017;Archidona;8398;4264;4134;2017
29;Málaga;018;Ardales;2469;1263;1206;2017
29;Málaga;019;Arenas;1190;616;574;2017
29;Málaga;020;Arriate;4094;2015;2079;2017
29;Málaga;021;Atajate;167;89;78;2017
29;Málaga;022;Benadalid;223;111;112;2017
29;Málaga;023;Benahavís;7348;3703;3645;2017
29;Málaga;024;Benalauría;449;237;212;2017
29;Málaga;025;Benalmádena;68859;34082;34777;2017
29;Málaga;026;Benamargosa;1532;791;741;2017
29;Málaga;027;Benamocarra;2988;1515;1473;2017
29;Málaga;028;Benaoján;1497;779;718;2017
29;Málaga;029;Benarrabá;480;240;240;2017
29;Málaga;030;Borge, El;940;493;447;2017
29;Málaga;031;Burgo, El;1848;940;908;2017
29;Málaga;032;Campillos;8547;4345;4202;2017
29;Málaga;033;Canillas de Aceituno;1672;891;781;2017
29;Málaga;034;Canillas de Albaida;741;369;372;2017
29;Málaga;035;Cañete la Real;1674;840;834;2017
29;Málaga;036;Carratraca;751;390;361;2017
29;Málaga;037;Cartajima;244;130;114;2017
29;Málaga;038;Cártama;25317;12772;12545;2017
29;Málaga;039;Casabermeja;3442;1806;1636;2017
29;Málaga;040;Casarabonela;2550;1350;1200;2017
29;Málaga;041;Casares;5743;2932;2811;2017
29;Málaga;042;Coín;21562;10824;10738;2017
29;Málaga;043;Colmenar;3383;1742;1641;2017
29;Málaga;044;Comares;1315;718;597;2017
29;Málaga;045;Cómpeta;3847;1930;1917;2017
29;Málaga;046;Cortes de la Frontera;3268;1678;1590;2017
29;Málaga;047;Cuevas Bajas;1416;711;705;2017
29;Málaga;049;Cuevas de San Marcos;3722;1877;1845;2017
29;Málaga;048;Cuevas del Becerro;1608;792;816;2017
29;Málaga;050;Cútar;597;306;291;2017
29;Málaga;051;Estepona;66863;32956;33907;2017
29;Málaga;052;Faraján;248;123;125;2017
29;Málaga;053;Frigiliana;3066;1543;1523;2017
29;Málaga;054;Fuengirola;74929;36642;38287;2017
29;Málaga;055;Fuente de Piedra;2507;1289;1218;2017
29;Málaga;056;Gaucín;1588;830;758;2017
29;Málaga;057;Genalguacil;405;209;196;2017
29;Málaga;058;Guaro;2087;1057;1030;2017
29;Málaga;059;Humilladero;3292;1649;1643;2017
29;Málaga;060;Igualeja;778;393;385;2017
29;Málaga;061;Istán;1432;721;711;2017
29;Málaga;062;Iznate;856;444;412;2017
29;Málaga;063;Jimera de Líbar;396;203;193;2017
29;Málaga;064;Jubrique;589;300;289;2017
29;Málaga;065;Júzcar;226;128;98;2017
29;Málaga;066;Macharaviaya;448;238;210;2017
29;Málaga;067;Málaga;569002;273636;295366;2017
29;Málaga;068;Manilva;14589;7480;7109;2017
29;Málaga;069;Marbella;141172;68127;73045;2017
29;Málaga;070;Mijas;77151;38549;38602;2017
29;Málaga;071;Moclinejo;1204;628;576;2017
29;Málaga;072;Mollina;4924;2484;2440;2017
29;Málaga;073;Monda;2475;1260;1215;2017
29;Málaga;903;Montecorto;630;324;306;2017
29;Málaga;074;Montejaque;997;488;509;2017
29;Málaga;075;Nerja;21047;10398;10649;2017
29;Málaga;076;Ojén;3517;1792;1725;2017
29;Málaga;077;Parauta;209;104;105;2017
29;Málaga;079;Periana;3124;1644;1480;2017
29;Málaga;080;Pizarra;9073;4580;4493;2017
29;Málaga;081;Pujerra;307;160;147;2017
29;Málaga;082;Rincón de la Victoria;45138;22116;23022;2017
29;Málaga;083;Riogordo;2715;1423;1292;2017
29;Málaga;084;Ronda;34268;16665;17603;2017
29;Málaga;085;Salares;175;88;87;2017
29;Málaga;086;Sayalonga;1579;810;769;2017
29;Málaga;087;Sedella;634;354;280;2017
29;Málaga;904;Serrato;494;250;244;2017
29;Málaga;088;Sierra de Yeguas;3363;1703;1660;2017
29;Málaga;089;Teba;3847;1948;1899;2017
29;Málaga;090;Tolox;2062;1045;1017;2017
29;Málaga;901;Torremolinos;67701;33841;33860;2017
29;Málaga;091;Torrox;15371;7843;7528;2017
29;Málaga;092;Totalán;710;373;337;2017
29;Málaga;093;Valle de Abdalajís;2577;1315;1262;2017
29;Málaga;094;Vélez-Málaga;79878;39499;40379;2017
29;Málaga;095;Villanueva de Algaidas;4238;2181;2057;2017
29;Málaga;902;Villanueva de la Concepción;3290;1605;1685;2017
29;Málaga;098;Villanueva de Tapia;1523;772;751;2017
29;Málaga;096;Villanueva del Rosario;3383;1654;1729;2017
29;Málaga;097;Villanueva del Trabuco;5327;2665;2662;2017
29;Málaga;099;Viñuela;2045;1061;984;2017
29;Málaga;100;Yunquera;2926;1496;1430;2017
30;Murcia;001;Abanilla;6158;3122;3036;2017
30;Murcia;002;Abarán;13089;6578;6511;2017
30;Murcia;003;Águilas;34758;17354;17404;2017
30;Murcia;004;Albudeite;1359;694;665;2017
30;Murcia;005;Alcantarilla;41331;20392;20939;2017
30;Murcia;902;Alcázares, Los;15349;7773;7576;2017
30;Murcia;006;Aledo;945;466;479;2017
30;Murcia;007;Alguazas;9557;4933;4624;2017
30;Murcia;008;Alhama de Murcia;21448;10864;10584;2017
30;Murcia;009;Archena;18771;9817;8954;2017
30;Murcia;010;Beniel;11233;5772;5461;2017
30;Murcia;011;Blanca;6521;3324;3197;2017
30;Murcia;012;Bullas;11546;5804;5742;2017
30;Murcia;013;Calasparra;10214;5172;5042;2017
30;Murcia;014;Campos del Río;2022;958;1064;2017
30;Murcia;015;Caravaca de la Cruz;25633;12795;12838;2017
30;Murcia;016;Cartagena;214177;106988;107189;2017
30;Murcia;017;Cehegín;15193;7636;7557;2017
30;Murcia;018;Ceutí;11472;5751;5721;2017
30;Murcia;019;Cieza;34987;17576;17411;2017
30;Murcia;020;Fortuna;10049;5365;4684;2017
30;Murcia;021;Fuente Álamo de Murcia;16180;8452;7728;2017
30;Murcia;022;Jumilla;25672;13416;12256;2017
30;Murcia;023;Librilla;5160;2632;2528;2017
30;Murcia;024;Lorca;92299;47240;45059;2017
30;Murcia;025;Lorquí;7039;3577;3462;2017
30;Murcia;026;Mazarrón;30996;15992;15004;2017
30;Murcia;027;Molina de Segura;70344;35035;35309;2017
30;Murcia;028;Moratalla;8048;4116;3932;2017
30;Murcia;029;Mula;16713;8558;8155;2017
30;Murcia;030;Murcia;443243;216548;226695;2017
30;Murcia;031;Ojós;494;268;226;2017
30;Murcia;032;Pliego;3873;2008;1865;2017
30;Murcia;033;Puerto Lumbreras;15020;7541;7479;2017
30;Murcia;034;Ricote;1315;695;620;2017
30;Murcia;035;San Javier;31695;15960;15735;2017
30;Murcia;036;San Pedro del Pinatar;24903;12590;12313;2017
30;Murcia;901;Santomera;16058;8120;7938;2017
30;Murcia;037;Torre-Pacheco;35198;18381;16817;2017
30;Murcia;038;Torres de Cotillas, Las;21420;10884;10536;2017
30;Murcia;039;Totana;31394;16154;15240;2017
30;Murcia;040;Ulea;891;460;431;2017
30;Murcia;041;Unión, La;19764;10031;9733;2017
30;Murcia;042;Villanueva del Río Segura;2650;1323;1327;2017
30;Murcia;043;Yecla;34092;17123;16969;2017
31;Navarra;001;Abáigar;88;50;38;2017
31;Navarra;002;Abárzuza/Abartzuza;524;259;265;2017
31;Navarra;003;Abaurregaina/Abaurrea Alta;124;77;47;2017
31;Navarra;004;Abaurrepea/Abaurrea Baja;34;21;13;2017
31;Navarra;005;Aberin;358;195;163;2017
31;Navarra;006;Ablitas;2514;1276;1238;2017
31;Navarra;007;Adiós;155;87;68;2017
31;Navarra;008;Aguilar de Codés;72;40;32;2017
31;Navarra;009;Aibar/Oibar;800;424;376;2017
31;Navarra;011;Allín/Allin;853;461;392;2017
31;Navarra;012;Allo;980;494;486;2017
31;Navarra;010;Altsasu/Alsasua;7419;3741;3678;2017
31;Navarra;013;Améscoa Baja;750;397;353;2017
31;Navarra;014;Ancín/Antzin;357;196;161;2017
31;Navarra;015;Andosilla;2718;1379;1339;2017
31;Navarra;016;Ansoáin/Antsoain;10752;5305;5447;2017
31;Navarra;017;Anue;477;260;217;2017
31;Navarra;018;Añorbe;543;302;241;2017
31;Navarra;019;Aoiz/Agoitz;2561;1284;1277;2017
31;Navarra;020;Araitz;523;295;228;2017
31;Navarra;025;Arakil;947;492;455;2017
31;Navarra;021;Aranarache/Aranaratxe;74;44;30;2017
31;Navarra;023;Aranguren;10239;5171;5068;2017
31;Navarra;024;Arano;110;59;51;2017
31;Navarra;022;Arantza;623;334;289;2017
31;Navarra;026;Aras;163;86;77;2017
31;Navarra;027;Arbizu;1119;566;553;2017
31;Navarra;028;Arce/Artzi;271;145;126;2017
31;Navarra;029;Arcos, Los;1104;549;555;2017
31;Navarra;030;Arellano;159;86;73;2017
31;Navarra;031;Areso;261;134;127;2017
31;Navarra;032;Arguedas;2300;1181;1119;2017
31;Navarra;033;Aria;53;31;22;2017
31;Navarra;034;Aribe;41;22;19;2017
31;Navarra;035;Armañanzas;60;33;27;2017
31;Navarra;036;Arróniz;1044;557;487;2017
31;Navarra;037;Arruazu;101;53;48;2017
31;Navarra;038;Artajona;1658;844;814;2017
31;Navarra;039;Artazu;117;57;60;2017
31;Navarra;040;Atez/Atetz;227;128;99;2017
31;Navarra;058;Auritz/Burguete;244;121;123;2017
31;Navarra;041;Ayegui/Aiegi;2346;1235;1111;2017
31;Navarra;042;Azagra;3843;1973;1870;2017
31;Navarra;043;Azuelo;34;13;21;2017
31;Navarra;044;Bakaiku;345;181;164;2017
31;Navarra;901;Barañáin/Barañain;20124;9733;10391;2017
31;Navarra;045;Barásoain;650;348;302;2017
31;Navarra;046;Barbarin;58;27;31;2017
31;Navarra;047;Bargota;276;135;141;2017
31;Navarra;048;Barillas;218;117;101;2017
31;Navarra;049;Basaburua;850;482;368;2017
31;Navarra;050;Baztan;7736;3909;3827;2017
31;Navarra;137;Beintza-Labaien;232;132;100;2017
31;Navarra;051;Beire;298;152;146;2017
31;Navarra;052;Belascoáin;123;62;61;2017
31;Navarra;250;Bera;3763;1864;1899;2017
31;Navarra;053;Berbinzana;605;309;296;2017
31;Navarra;905;Beriáin;3894;1893;2001;2017
31;Navarra;902;Berrioplano/Berriobeiti;6872;3520;3352;2017
31;Navarra;903;Berriozar;9874;4991;4883;2017
31;Navarra;054;Bertizarana;591;293;298;2017
31;Navarra;055;Betelu;346;184;162;2017
31;Navarra;253;Bidaurreta;169;92;77;2017
31;Navarra;056;Biurrun-Olcoz;207;118;89;2017
31;Navarra;057;Buñuel;2232;1085;1147;2017
31;Navarra;059;Burgui/Burgi;209;120;89;2017
31;Navarra;060;Burlada/Burlata;18591;8981;9610;2017
31;Navarra;061;Busto, El;62;31;31;2017
31;Navarra;062;Cabanillas;1366;717;649;2017
31;Navarra;063;Cabredo;101;56;45;2017
31;Navarra;064;Cadreita;2028;1057;971;2017
31;Navarra;065;Caparroso;2724;1423;1301;2017
31;Navarra;066;Cárcar;1038;521;517;2017
31;Navarra;067;Carcastillo;2491;1259;1232;2017
31;Navarra;068;Cascante;3780;1878;1902;2017
31;Navarra;069;Cáseda;975;479;496;2017
31;Navarra;070;Castejón;4116;2053;2063;2017
31;Navarra;071;Castillonuevo;17;13;4;2017
31;Navarra;193;Cendea de Olza/Oltza Zendea;1853;932;921;2017
31;Navarra;072;Cintruénigo;7839;4017;3822;2017
31;Navarra;074;Cirauqui/Zirauki;478;260;218;2017
31;Navarra;075;Ciriza/Ziritza;137;64;73;2017
31;Navarra;076;Cizur;3784;1952;1832;2017
31;Navarra;077;Corella;7640;3874;3766;2017
31;Navarra;078;Cortes;3137;1574;1563;2017
31;Navarra;079;Desojo;79;45;34;2017
31;Navarra;080;Dicastillo;612;319;293;2017
31;Navarra;081;Donamaria;434;220;214;2017
31;Navarra;221;Doneztebe/Santesteban;1732;884;848;2017
31;Navarra;083;Echarri/Etxarri;80;40;40;2017
31;Navarra;087;Elgorriaga;203;100;103;2017
31;Navarra;089;Enériz/Eneritz;293;151;142;2017
31;Navarra;090;Eratsun;154;95;59;2017
31;Navarra;091;Ergoiena;399;214;185;2017
31;Navarra;092;Erro;789;441;348;2017
31;Navarra;094;Eslava;118;59;59;2017
31;Navarra;095;Esparza de Salazar/Espartza Zaraitzu;79;42;37;2017
31;Navarra;096;Espronceda;108;60;48;2017
31;Navarra;097;Estella-Lizarra;13707;6593;7114;2017
31;Navarra;098;Esteribar;2629;1362;1267;2017
31;Navarra;099;Etayo;70;38;32;2017
31;Navarra;082;Etxalar;808;434;374;2017
31;Navarra;084;Etxarri Aranatz;2464;1280;1184;2017
31;Navarra;085;Etxauri;602;317;285;2017
31;Navarra;100;Eulate;289;164;125;2017
31;Navarra;101;Ezcabarte;1797;932;865;2017
31;Navarra;093;Ezcároz/Ezkaroze;313;169;144;2017
31;Navarra;102;Ezkurra;154;101;53;2017
31;Navarra;103;Ezprogui;44;22;22;2017
31;Navarra;104;Falces;2313;1166;1147;2017
31;Navarra;105;Fitero;2034;1029;1005;2017
31;Navarra;106;Fontellas;963;484;479;2017
31;Navarra;107;Funes;2482;1330;1152;2017
31;Navarra;108;Fustiñana;2466;1219;1247;2017
31;Navarra;109;Galar;2194;1155;1039;2017
31;Navarra;110;Gallipienzo/Galipentzu;99;57;42;2017
31;Navarra;111;Gallués/Galoze;104;67;37;2017
31;Navarra;112;Garaioa;89;51;38;2017
31;Navarra;113;Garde;148;91;57;2017
31;Navarra;114;Garínoain;456;249;207;2017
31;Navarra;115;Garralda;184;97;87;2017
31;Navarra;116;Genevilla;76;46;30;2017
31;Navarra;117;Goizueta;717;385;332;2017
31;Navarra;118;Goñi;169;108;61;2017
31;Navarra;119;Güesa/Gorza;44;25;19;2017
31;Navarra;120;Guesálaz/Gesalatz;454;265;189;2017
31;Navarra;121;Guirguillano;76;41;35;2017
31;Navarra;256;Hiriberri/Villanueva de Aezkoa;110;59;51;2017
31;Navarra;122;Huarte/Uharte;6917;3483;3434;2017
31;Navarra;124;Ibargoiti;247;145;102;2017
31;Navarra;259;Igantzi;626;325;301;2017
31;Navarra;125;Igúzquiza;338;177;161;2017
31;Navarra;126;Imotz;430;224;206;2017
31;Navarra;127;Irañeta;174;95;79;2017
31;Navarra;904;Irurtzun;2183;1129;1054;2017
31;Navarra;128;Isaba/Izaba;429;212;217;2017
31;Navarra;129;Ituren;519;267;252;2017
31;Navarra;130;Iturmendi;398;205;193;2017
31;Navarra;131;Iza/Itza;1192;638;554;2017
31;Navarra;132;Izagaondoa;183;118;65;2017
31;Navarra;133;Izalzu/Itzaltzu;48;29;19;2017
31;Navarra;134;Jaurrieta;186;103;83;2017
31;Navarra;135;Javier;102;33;69;2017
31;Navarra;136;Juslapeña;550;294;256;2017
31;Navarra;138;Lakuntza;1262;655;607;2017
31;Navarra;139;Lana;166;95;71;2017
31;Navarra;140;Lantz;153;90;63;2017
31;Navarra;141;Lapoblación;125;69;56;2017
31;Navarra;142;Larraga;2060;1091;969;2017
31;Navarra;143;Larraona;104;50;54;2017
31;Navarra;144;Larraun;974;531;443;2017
31;Navarra;145;Lazagurría;193;99;94;2017
31;Navarra;146;Leache/Leatxe;35;21;14;2017
31;Navarra;147;Legarda;110;60;50;2017
31;Navarra;148;Legaria;98;41;57;2017
31;Navarra;149;Leitza;2856;1486;1370;2017
31;Navarra;908;Lekunberri;1502;741;761;2017
31;Navarra;150;Leoz/Leotz;232;146;86;2017
31;Navarra;151;Lerga;70;42;28;2017
31;Navarra;152;Lerín;1654;843;811;2017
31;Navarra;153;Lesaka;2737;1420;1317;2017
31;Navarra;154;Lezáun;252;148;104;2017
31;Navarra;155;Liédena;301;156;145;2017
31;Navarra;156;Lizoáin-Arriasgoiti;295;172;123;2017
31;Navarra;157;Lodosa;4730;2395;2335;2017
31;Navarra;158;Lónguida/Longida;303;162;141;2017
31;Navarra;159;Lumbier;1336;725;611;2017
31;Navarra;160;Luquin;128;69;59;2017
31;Navarra;248;Luzaide/Valcarlos;387;230;157;2017
31;Navarra;161;Mañeru;422;223;199;2017
31;Navarra;162;Marañón;51;25;26;2017
31;Navarra;163;Marcilla;2828;1422;1406;2017
31;Navarra;164;Mélida;718;366;352;2017
31;Navarra;165;Mendavia;3570;1840;1730;2017
31;Navarra;166;Mendaza;301;158;143;2017
31;Navarra;167;Mendigorría;1044;547;497;2017
31;Navarra;168;Metauten;285;158;127;2017
31;Navarra;169;Milagro;3400;1796;1604;2017
31;Navarra;170;Mirafuentes;56;26;30;2017
31;Navarra;171;Miranda de Arga;855;446;409;2017
31;Navarra;172;Monreal/Elo;479;258;221;2017
31;Navarra;173;Monteagudo;1078;537;541;2017
31;Navarra;174;Morentin;126;61;65;2017
31;Navarra;175;Mues;82;44;38;2017
31;Navarra;176;Murchante;3944;1974;1970;2017
31;Navarra;177;Murieta;334;181;153;2017
31;Navarra;178;Murillo el Cuende;659;342;317;2017
31;Navarra;179;Murillo el Fruto;603;313;290;2017
31;Navarra;180;Muruzábal;241;103;138;2017
31;Navarra;181;Navascués/Nabaskoze;145;86;59;2017
31;Navarra;182;Nazar;39;23;16;2017
31;Navarra;088;Noáin (Valle de Elorz)/Noain (Elortzibar);8115;4094;4021;2017
31;Navarra;183;Obanos;906;455;451;2017
31;Navarra;185;Ochagavía/Otsagabia;534;283;251;2017
31;Navarra;184;Oco;77;39;38;2017
31;Navarra;186;Odieta;362;200;162;2017
31;Navarra;187;Oiz;130;76;54;2017
31;Navarra;188;Olaibar;363;203;160;2017
31;Navarra;189;Olazti/Olazagutía;1518;781;737;2017
31;Navarra;190;Olejua;53;29;24;2017
31;Navarra;191;Olite/Erriberri;3927;1992;1935;2017
31;Navarra;192;Olóriz/Oloritz;198;112;86;2017
31;Navarra;195;Orbaizeta;200;99;101;2017
31;Navarra;196;Orbara;38;20;18;2017
31;Navarra;197;Orísoain;85;45;40;2017
31;Navarra;906;Orkoien;3910;1960;1950;2017
31;Navarra;198;Oronz/Orontze;48;27;21;2017
31;Navarra;199;Oroz-Betelu/Orotz-Betelu;149;85;64;2017
31;Navarra;211;Orreaga/Roncesvalles;21;11;10;2017
31;Navarra;200;Oteiza;922;485;437;2017
31;Navarra;201;Pamplona/Iruña;197138;93388;103750;2017
31;Navarra;202;Peralta/Azkoien;5828;2936;2892;2017
31;Navarra;203;Petilla de Aragón;34;20;14;2017
31;Navarra;204;Piedramillera;37;24;13;2017
31;Navarra;205;Pitillas;492;244;248;2017
31;Navarra;206;Puente la Reina/Gares;2805;1431;1374;2017
31;Navarra;207;Pueyo;340;184;156;2017
31;Navarra;208;Ribaforada;3704;1926;1778;2017
31;Navarra;209;Romanzado;180;96;84;2017
31;Navarra;210;Roncal/Erronkari;213;114;99;2017
31;Navarra;212;Sada;151;83;68;2017
31;Navarra;213;Saldías;119;69;50;2017
31;Navarra;214;Salinas de Oro/Jaitz;113;64;49;2017
31;Navarra;215;San Adrián;6214;3085;3129;2017
31;Navarra;217;San Martín de Unx;383;199;184;2017
31;Navarra;216;Sangüesa/Zangoza;5002;2556;2446;2017
31;Navarra;219;Sansol;102;55;47;2017
31;Navarra;220;Santacara;868;445;423;2017
31;Navarra;222;Sarriés/Sartze;64;41;23;2017
31;Navarra;223;Sartaguda;1316;672;644;2017
31;Navarra;224;Sesma;1152;586;566;2017
31;Navarra;225;Sorlada;52;30;22;2017
31;Navarra;226;Sunbilla;675;348;327;2017
31;Navarra;227;Tafalla;10638;5244;5394;2017
31;Navarra;228;Tiebas-Muruarte de Reta;613;314;299;2017
31;Navarra;229;Tirapu;45;28;17;2017
31;Navarra;230;Torralba del Río;110;58;52;2017
31;Navarra;231;Torres del Río;128;61;67;2017
31;Navarra;232;Tudela;35298;17339;17959;2017
31;Navarra;233;Tulebras;123;50;73;2017
31;Navarra;234;Ucar;183;104;79;2017
31;Navarra;123;Uharte Arakil;828;435;393;2017
31;Navarra;235;Ujué;171;100;71;2017
31;Navarra;236;Ultzama;1661;860;801;2017
31;Navarra;237;Unciti;217;126;91;2017
31;Navarra;238;Unzué/Untzue;136;71;65;2017
31;Navarra;239;Urdazubi/Urdax;394;191;203;2017
31;Navarra;240;Urdiain;671;354;317;2017
31;Navarra;241;Urraul Alto;144;93;51;2017
31;Navarra;242;Urraul Bajo;305;135;170;2017
31;Navarra;244;Urroz;185;104;81;2017
31;Navarra;243;Urroz-Villa;385;206;179;2017
31;Navarra;245;Urzainqui/Urzainki;85;54;31;2017
31;Navarra;246;Uterga;164;96;68;2017
31;Navarra;247;Uztárroz/Uztarroze;146;71;75;2017
31;Navarra;086;Valle de Egüés/Eguesibar;20417;10283;10134;2017
31;Navarra;194;Valle de Ollo/Ollaran;399;213;186;2017
31;Navarra;260;Valle de Yerri/Deierri;1513;777;736;2017
31;Navarra;249;Valtierra;2384;1188;1196;2017
31;Navarra;251;Viana;4078;2064;2014;2017
31;Navarra;252;Vidángoz/Bidankoze;95;51;44;2017
31;Navarra;254;Villafranca;2845;1426;1419;2017
31;Navarra;255;Villamayor de Monjardín;115;61;54;2017
31;Navarra;257;Villatuerta;1178;587;591;2017
31;Navarra;258;Villava/Atarrabia;10217;5001;5216;2017
31;Navarra;261;Yesa;291;167;124;2017
31;Navarra;262;Zabalza/Zabaltza;294;158;136;2017
31;Navarra;073;Ziordia;357;185;172;2017
31;Navarra;907;Zizur Mayor/Zizur Nagusia;14686;7185;7501;2017
31;Navarra;263;Zubieta;308;160;148;2017
31;Navarra;264;Zugarramurdi;232;116;116;2017
31;Navarra;265;Zúñiga;108;69;39;2017
32;Ourense;001;Allariz;6026;3029;2997;2017
32;Ourense;002;Amoeiro;2231;1102;1129;2017
32;Ourense;003;Arnoia, A;1013;507;506;2017
32;Ourense;004;Avión;1860;852;1008;2017
32;Ourense;005;Baltar;957;514;443;2017
32;Ourense;006;Bande;1618;785;833;2017
32;Ourense;007;Baños de Molgas;1623;797;826;2017
32;Ourense;008;Barbadás;10791;5274;5517;2017
32;Ourense;009;Barco de Valdeorras, O;13581;6620;6961;2017
32;Ourense;010;Beade;411;224;187;2017
32;Ourense;011;Beariz;982;431;551;2017
32;Ourense;012;Blancos, Os;812;442;370;2017
32;Ourense;013;Boborás;2375;1116;1259;2017
32;Ourense;014;Bola, A;1251;592;659;2017
32;Ourense;015;Bolo, O;938;470;468;2017
32;Ourense;016;Calvos de Randín;818;403;415;2017
32;Ourense;018;Carballeda de Avia;1356;658;698;2017
32;Ourense;017;Carballeda de Valdeorras;1623;834;789;2017
32;Ourense;019;Carballiño, O;13854;6491;7363;2017
32;Ourense;020;Cartelle;2683;1314;1369;2017
32;Ourense;022;Castrelo de Miño;1445;726;719;2017
32;Ourense;021;Castrelo do Val;1028;526;502;2017
32;Ourense;023;Castro Caldelas;1298;658;640;2017
32;Ourense;024;Celanova;5455;2601;2854;2017
32;Ourense;025;Cenlle;1176;575;601;2017
32;Ourense;029;Chandrexa de Queixa;494;280;214;2017
32;Ourense;026;Coles;3077;1546;1531;2017
32;Ourense;027;Cortegada;1125;554;571;2017
32;Ourense;028;Cualedro;1721;883;838;2017
32;Ourense;030;Entrimo;1184;562;622;2017
32;Ourense;031;Esgos;1154;588;566;2017
32;Ourense;033;Gomesende;778;378;400;2017
32;Ourense;034;Gudiña, A;1360;714;646;2017
32;Ourense;035;Irixo, O;1519;732;787;2017
32;Ourense;038;Larouco;472;226;246;2017
32;Ourense;039;Laza;1331;688;643;2017
32;Ourense;040;Leiro;1601;764;837;2017
32;Ourense;041;Lobeira;825;396;429;2017
32;Ourense;042;Lobios;1795;905;890;2017
32;Ourense;043;Maceda;2924;1431;1493;2017
32;Ourense;044;Manzaneda;906;443;463;2017
32;Ourense;045;Maside;2797;1373;1424;2017
32;Ourense;046;Melón;1254;597;657;2017
32;Ourense;047;Merca, A;1924;935;989;2017
32;Ourense;048;Mezquita, A;1034;541;493;2017
32;Ourense;049;Montederramo;760;392;368;2017
32;Ourense;050;Monterrei;2655;1346;1309;2017
32;Ourense;051;Muíños;1514;768;746;2017
32;Ourense;052;Nogueira de Ramuín;2033;1028;1005;2017
32;Ourense;053;Oímbra;1818;989;829;2017
32;Ourense;054;Ourense;105636;48117;57519;2017
32;Ourense;055;Paderne de Allariz;1414;698;716;2017
32;Ourense;056;Padrenda;1838;876;962;2017
32;Ourense;057;Parada de Sil;593;314;279;2017
32;Ourense;058;Pereiro de Aguiar, O;6228;3215;3013;2017
32;Ourense;059;Peroxa, A;1902;936;966;2017
32;Ourense;060;Petín;921;456;465;2017
32;Ourense;061;Piñor;1172;590;582;2017
32;Ourense;063;Pobra de Trives, A;2150;1069;1081;2017
32;Ourense;064;Pontedeva;570;283;287;2017
32;Ourense;062;Porqueira;848;416;432;2017
32;Ourense;065;Punxín;713;346;367;2017
32;Ourense;066;Quintela de Leirado;615;271;344;2017
32;Ourense;067;Rairiz de Veiga;1330;678;652;2017
32;Ourense;068;Ramirás;1550;700;850;2017
32;Ourense;069;Ribadavia;5095;2479;2616;2017
32;Ourense;071;Riós;1609;813;796;2017
32;Ourense;072;Rúa, A;4459;2189;2270;2017
32;Ourense;073;Rubiá;1462;715;747;2017
32;Ourense;074;San Amaro;1112;538;574;2017
32;Ourense;075;San Cibrao das Viñas;5184;2629;2555;2017
32;Ourense;076;San Cristovo de Cea;2241;1104;1137;2017
32;Ourense;070;San Xoán de Río;561;278;283;2017
32;Ourense;077;Sandiás;1261;580;681;2017
32;Ourense;078;Sarreaus;1220;617;603;2017
32;Ourense;079;Taboadela;1458;747;711;2017
32;Ourense;080;Teixeira, A;339;170;169;2017
32;Ourense;081;Toén;2377;1224;1153;2017
32;Ourense;082;Trasmiras;1327;663;664;2017
32;Ourense;083;Veiga, A;907;459;448;2017
32;Ourense;084;Verea;956;458;498;2017
32;Ourense;085;Verín;13889;6710;7179;2017
32;Ourense;086;Viana do Bolo;2964;1492;1472;2017
32;Ourense;087;Vilamarín;1940;986;954;2017
32;Ourense;088;Vilamartín de Valdeorras;1771;923;848;2017
32;Ourense;089;Vilar de Barrio;1360;688;672;2017
32;Ourense;090;Vilar de Santos;850;416;434;2017
32;Ourense;091;Vilardevós;1971;1026;945;2017
32;Ourense;092;Vilariño de Conso;558;322;236;2017
32;Ourense;032;Xinzo de Limia;9875;4801;5074;2017
32;Ourense;036;Xunqueira de Ambía;1438;721;717;2017
32;Ourense;037;Xunqueira de Espadanedo;756;376;380;2017
34;Palencia;001;Abarca de Campos;43;27;16;2017
34;Palencia;003;Abia de las Torres;174;95;79;2017
34;Palencia;004;Aguilar de Campoo;6916;3362;3554;2017
34;Palencia;005;Alar del Rey;944;465;479;2017
34;Palencia;006;Alba de Cerrato;87;48;39;2017
34;Palencia;009;Amayuelas de Arriba;36;24;12;2017
34;Palencia;010;Ampudia;621;320;301;2017
34;Palencia;011;Amusco;431;238;193;2017
34;Palencia;012;Antigüedad;368;198;170;2017
34;Palencia;015;Arconada;43;25;18;2017
34;Palencia;017;Astudillo;1012;508;504;2017
34;Palencia;018;Autilla del Pino;235;130;105;2017
34;Palencia;019;Autillo de Campos;136;72;64;2017
34;Palencia;020;Ayuela;53;33;20;2017
34;Palencia;022;Baltanás;1234;640;594;2017
34;Palencia;024;Baquerín de Campos;33;22;11;2017
34;Palencia;025;Bárcena de Campos;62;28;34;2017
34;Palencia;027;Barruelo de Santullán;1203;590;613;2017
34;Palencia;028;Báscones de Ojeda;149;80;69;2017
34;Palencia;029;Becerril de Campos;769;402;367;2017
34;Palencia;031;Belmonte de Campos;32;18;14;2017
34;Palencia;032;Berzosilla;44;23;21;2017
34;Palencia;033;Boada de Campos;17;12;5;2017
34;Palencia;035;Boadilla de Rioseco;117;68;49;2017
34;Palencia;034;Boadilla del Camino;117;66;51;2017
34;Palencia;036;Brañosera;250;144;106;2017
34;Palencia;037;Buenavista de Valdavia;275;152;123;2017
34;Palencia;038;Bustillo de la Vega;310;171;139;2017
34;Palencia;039;Bustillo del Páramo de Carrión;62;36;26;2017
34;Palencia;041;Calahorra de Boedo;94;46;48;2017
34;Palencia;042;Calzada de los Molinos;338;190;148;2017
34;Palencia;045;Capillas;77;39;38;2017
34;Palencia;046;Cardeñosa de Volpejera;43;24;19;2017
34;Palencia;047;Carrión de los Condes;2118;1002;1116;2017
34;Palencia;048;Castil de Vela;64;33;31;2017
34;Palencia;049;Castrejón de la Peña;371;200;171;2017
34;Palencia;050;Castrillo de Don Juan;230;127;103;2017
34;Palencia;051;Castrillo de Onielo;102;54;48;2017
34;Palencia;052;Castrillo de Villavega;187;102;85;2017
34;Palencia;053;Castromocho;222;120;102;2017
34;Palencia;055;Cervatos de la Cueza;278;157;121;2017
34;Palencia;056;Cervera de Pisuerga;2359;1185;1174;2017
34;Palencia;057;Cevico de la Torre;490;239;251;2017
34;Palencia;058;Cevico Navero;211;113;98;2017
34;Palencia;059;Cisneros;445;219;226;2017
34;Palencia;060;Cobos de Cerrato;142;79;63;2017
34;Palencia;061;Collazos de Boedo;107;60;47;2017
34;Palencia;062;Congosto de Valdavia;173;107;66;2017
34;Palencia;063;Cordovilla la Real;94;56;38;2017
34;Palencia;066;Cubillas de Cerrato;69;40;29;2017
34;Palencia;067;Dehesa de Montejo;138;79;59;2017
34;Palencia;068;Dehesa de Romanos;41;24;17;2017
34;Palencia;069;Dueñas;2658;1357;1301;2017
34;Palencia;070;Espinosa de Cerrato;158;81;77;2017
34;Palencia;071;Espinosa de Villagonzalo;186;98;88;2017
34;Palencia;072;Frechilla;159;81;78;2017
34;Palencia;073;Fresno del Río;200;98;102;2017
34;Palencia;074;Frómista;790;405;385;2017
34;Palencia;076;Fuentes de Nava;673;349;324;2017
34;Palencia;077;Fuentes de Valdepero;425;220;205;2017
34;Palencia;079;Grijota;2212;1140;1072;2017
34;Palencia;080;Guardo;6279;3129;3150;2017
34;Palencia;081;Guaza de Campos;59;35;24;2017
34;Palencia;082;Hérmedes de Cerrato;81;45;36;2017
34;Palencia;083;Herrera de Pisuerga;2056;1003;1053;2017
34;Palencia;084;Herrera de Valdecañas;147;81;66;2017
34;Palencia;086;Hontoria de Cerrato;102;52;50;2017
34;Palencia;087;Hornillos de Cerrato;145;80;65;2017
34;Palencia;088;Husillos;303;170;133;2017
34;Palencia;089;Itero de la Vega;165;92;73;2017
34;Palencia;091;Lagartos;136;77;59;2017
34;Palencia;092;Lantadilla;305;162;143;2017
34;Palencia;094;Ledigos;67;38;29;2017
34;Palencia;903;Loma de Ucieza;208;121;87;2017
34;Palencia;096;Lomas;53;33;20;2017
34;Palencia;098;Magaz de Pisuerga;981;518;463;2017
34;Palencia;099;Manquillos;84;45;39;2017
34;Palencia;100;Mantinos;146;82;64;2017
34;Palencia;101;Marcilla de Campos;36;17;19;2017
34;Palencia;102;Mazariegos;215;124;91;2017
34;Palencia;103;Mazuecos de Valdeginate;95;57;38;2017
34;Palencia;104;Melgar de Yuso;256;148;108;2017
34;Palencia;106;Meneses de Campos;117;62;55;2017
34;Palencia;107;Micieces de Ojeda;80;46;34;2017
34;Palencia;108;Monzón de Campos;616;316;300;2017
34;Palencia;109;Moratinos;58;35;23;2017
34;Palencia;110;Mudá;87;48;39;2017
34;Palencia;112;Nogal de las Huertas;48;27;21;2017
34;Palencia;113;Olea de Boedo;38;14;24;2017
34;Palencia;114;Olmos de Ojeda;201;121;80;2017
34;Palencia;116;Osornillo;61;31;30;2017
34;Palencia;901;Osorno la Mayor;1252;656;596;2017
34;Palencia;120;Palencia;78892;37207;41685;2017
34;Palencia;121;Palenzuela;212;114;98;2017
34;Palencia;122;Páramo de Boedo;116;63;53;2017
34;Palencia;123;Paredes de Nava;1923;989;934;2017
34;Palencia;124;Payo de Ojeda;64;38;26;2017
34;Palencia;125;Pedraza de Campos;88;44;44;2017
34;Palencia;126;Pedrosa de la Vega;341;186;155;2017
34;Palencia;127;Perales;95;51;44;2017
34;Palencia;904;Pernía, La;324;185;139;2017
34;Palencia;129;Pino del Río;184;114;70;2017
34;Palencia;130;Piña de Campos;230;119;111;2017
34;Palencia;131;Población de Arroyo;61;33;28;2017
34;Palencia;132;Población de Campos;137;76;61;2017
34;Palencia;133;Población de Cerrato;116;64;52;2017
34;Palencia;134;Polentinos;44;25;19;2017
34;Palencia;135;Pomar de Valdivia;467;264;203;2017
34;Palencia;136;Poza de la Vega;197;114;83;2017
34;Palencia;137;Pozo de Urama;25;17;8;2017
34;Palencia;139;Prádanos de Ojeda;193;104;89;2017
34;Palencia;140;Puebla de Valdavia, La;108;57;51;2017
34;Palencia;141;Quintana del Puente;255;141;114;2017
34;Palencia;143;Quintanilla de Onsoña;186;110;76;2017
34;Palencia;146;Reinoso de Cerrato;51;34;17;2017
34;Palencia;147;Renedo de la Vega;195;105;90;2017
34;Palencia;149;Requena de Campos;22;11;11;2017
34;Palencia;151;Respenda de la Peña;161;95;66;2017
34;Palencia;152;Revenga de Campos;148;78;70;2017
34;Palencia;154;Revilla de Collazos;80;44;36;2017
34;Palencia;155;Ribas de Campos;150;77;73;2017
34;Palencia;156;Riberos de la Cueza;54;35;19;2017
34;Palencia;157;Saldaña;3067;1552;1515;2017
34;Palencia;158;Salinas de Pisuerga;334;179;155;2017
34;Palencia;159;San Cebrián de Campos;445;248;197;2017
34;Palencia;160;San Cebrián de Mudá;159;84;75;2017
34;Palencia;161;San Cristóbal de Boedo;23;14;9;2017
34;Palencia;163;San Mamés de Campos;53;26;27;2017
34;Palencia;165;San Román de la Cuba;68;39;29;2017
34;Palencia;167;Santa Cecilia del Alcor;121;69;52;2017
34;Palencia;168;Santa Cruz de Boedo;53;32;21;2017
34;Palencia;169;Santervás de la Vega;466;260;206;2017
34;Palencia;170;Santibáñez de Ecla;58;32;26;2017
34;Palencia;171;Santibáñez de la Peña;1060;529;531;2017
34;Palencia;174;Santoyo;206;110;96;2017
34;Palencia;175;Serna, La;97;61;36;2017
34;Palencia;177;Soto de Cerrato;188;108;80;2017
34;Palencia;176;Sotobañado y Priorato;150;91;59;2017
34;Palencia;178;Tabanera de Cerrato;146;78;68;2017
34;Palencia;179;Tabanera de Valdavia;26;15;11;2017
34;Palencia;180;Támara de Campos;71;37;34;2017
34;Palencia;181;Tariego de Cerrato;513;274;239;2017
34;Palencia;182;Torquemada;989;532;457;2017
34;Palencia;184;Torremormojón;57;31;26;2017
34;Palencia;185;Triollo;61;33;28;2017
34;Palencia;186;Valbuena de Pisuerga;49;27;22;2017
34;Palencia;189;Valdeolmillos;64;38;26;2017
34;Palencia;190;Valderrábano;55;28;27;2017
34;Palencia;192;Valde-Ucieza;96;57;39;2017
34;Palencia;196;Valle de Cerrato;90;54;36;2017
34;Palencia;902;Valle del Retortillo;177;101;76;2017
34;Palencia;199;Velilla del Río Carrión;1330;675;655;2017
34;Palencia;023;Venta de Baños;6429;3227;3202;2017
34;Palencia;201;Vertavillo;196;105;91;2017
34;Palencia;093;Vid de Ojeda, La;98;60;38;2017
34;Palencia;202;Villabasta de Valdavia;30;16;14;2017
34;Palencia;204;Villacidaler;46;27;19;2017
34;Palencia;205;Villaconancio;65;37;28;2017
34;Palencia;206;Villada;1002;504;498;2017
34;Palencia;208;Villaeles de Valdavia;52;31;21;2017
34;Palencia;210;Villahán;105;54;51;2017
34;Palencia;211;Villaherreros;203;105;98;2017
34;Palencia;213;Villalaco;59;33;26;2017
34;Palencia;214;Villalba de Guardo;198;107;91;2017
34;Palencia;215;Villalcázar de Sirga;172;93;79;2017
34;Palencia;216;Villalcón;68;40;28;2017
34;Palencia;217;Villalobón;1612;808;804;2017
34;Palencia;218;Villaluenga de la Vega;575;324;251;2017
34;Palencia;220;Villamartín de Campos;172;95;77;2017
34;Palencia;221;Villamediana;184;100;84;2017
34;Palencia;222;Villameriel;122;70;52;2017
34;Palencia;223;Villamoronta;244;140;104;2017
34;Palencia;224;Villamuera de la Cueza;46;29;17;2017
34;Palencia;225;Villamuriel de Cerrato;6483;3338;3145;2017
34;Palencia;227;Villanueva del Rebollar;76;38;38;2017
34;Palencia;228;Villanuño de Valdavia;95;54;41;2017
34;Palencia;229;Villaprovedo;68;45;23;2017
34;Palencia;230;Villarmentero de Campos;23;13;10;2017
34;Palencia;231;Villarrabé;215;115;100;2017
34;Palencia;232;Villarramiel;833;452;381;2017
34;Palencia;233;Villasarracino;139;82;57;2017
34;Palencia;234;Villasila de Valdavia;72;48;24;2017
34;Palencia;236;Villaturde;166;87;79;2017
34;Palencia;237;Villaumbrales;676;342;334;2017
34;Palencia;238;Villaviudas;379;184;195;2017
34;Palencia;240;Villerías de Campos;97;53;44;2017
34;Palencia;241;Villodre;17;10;7;2017
34;Palencia;242;Villodrigo;115;65;50;2017
34;Palencia;243;Villoldo;358;189;169;2017
34;Palencia;245;Villota del Páramo;333;191;142;2017
34;Palencia;246;Villovieco;72;38;34;2017
35;Palmas, Las;001;Agaete;5526;2757;2769;2017
35;Palmas, Las;002;Agüimes;30882;15668;15214;2017
35;Palmas, Las;020;Aldea de San Nicolás, La;7613;3894;3719;2017
35;Palmas, Las;003;Antigua;11405;6096;5309;2017
35;Palmas, Las;004;Arrecife;59771;29961;29810;2017
35;Palmas, Las;005;Artenara;1096;592;504;2017
35;Palmas, Las;006;Arucas;37367;18578;18789;2017
35;Palmas, Las;007;Betancuria;710;373;337;2017
35;Palmas, Las;008;Firgas;7570;3814;3756;2017
35;Palmas, Las;009;Gáldar;24251;12167;12084;2017
35;Palmas, Las;010;Haría;4858;2473;2385;2017
35;Palmas, Las;011;Ingenio;30529;15398;15131;2017
35;Palmas, Las;012;Mogán;19783;10216;9567;2017
35;Palmas, Las;013;Moya;7792;3954;3838;2017
35;Palmas, Las;014;Oliva, La;25349;13251;12098;2017
35;Palmas, Las;015;Pájara;19823;10302;9521;2017
35;Palmas, Las;016;Palmas de Gran Canaria, Las;377650;182881;194769;2017
35;Palmas, Las;017;Puerto del Rosario;38711;19650;19061;2017
35;Palmas, Las;018;San Bartolomé;18249;9187;9062;2017
35;Palmas, Las;019;San Bartolomé de Tirajana;53542;27845;25697;2017
35;Palmas, Las;021;Santa Brígida;18295;9102;9193;2017
35;Palmas, Las;022;Santa Lucía de Tirajana;70396;35183;35213;2017
35;Palmas, Las;023;Santa María de Guía de Gran Canaria;13924;6918;7006;2017
35;Palmas, Las;024;Teguise;21896;11086;10810;2017
35;Palmas, Las;025;Tejeda;1950;1046;904;2017
35;Palmas, Las;026;Telde;102005;50320;51685;2017
35;Palmas, Las;027;Teror;12424;6393;6031;2017
35;Palmas, Las;028;Tías;19964;10219;9745;2017
35;Palmas, Las;029;Tinajo;6028;3123;2905;2017
35;Palmas, Las;030;Tuineje;14301;7313;6988;2017
35;Palmas, Las;032;Valleseco;3810;1993;1817;2017
35;Palmas, Las;031;Valsequillo de Gran Canaria;9191;4631;4560;2017
35;Palmas, Las;033;Vega de San Mateo;7562;3894;3668;2017
35;Palmas, Las;034;Yaiza;16257;8438;7819;2017
36;Pontevedra;020;Agolada;2431;1215;1216;2017
36;Pontevedra;001;Arbo;2711;1384;1327;2017
36;Pontevedra;003;Baiona;12169;6018;6151;2017
36;Pontevedra;002;Barro;3699;1842;1857;2017
36;Pontevedra;004;Bueu;12145;5988;6157;2017
36;Pontevedra;005;Caldas de Reis;9825;4750;5075;2017
36;Pontevedra;006;Cambados;13900;6711;7189;2017
36;Pontevedra;007;Campo Lameiro;1867;882;985;2017
36;Pontevedra;008;Cangas;26490;13080;13410;2017
36;Pontevedra;009;Cañiza, A;5233;2546;2687;2017
36;Pontevedra;010;Catoira;3337;1623;1714;2017
36;Pontevedra;902;Cerdedo-Cotobade;6107;2913;3194;2017
36;Pontevedra;013;Covelo;2505;1245;1260;2017
36;Pontevedra;014;Crecente;2082;997;1085;2017
36;Pontevedra;015;Cuntis;4750;2255;2495;2017
36;Pontevedra;016;Dozón;1179;611;568;2017
36;Pontevedra;017;Estrada, A;20700;9962;10738;2017
36;Pontevedra;018;Forcarei;3523;1674;1849;2017
36;Pontevedra;019;Fornelos de Montes;1694;810;884;2017
36;Pontevedra;021;Gondomar;14233;7066;7167;2017
36;Pontevedra;022;Grove, O;10746;5305;5441;2017
36;Pontevedra;023;Guarda, A;10051;4889;5162;2017
36;Pontevedra;901;Illa de Arousa, A;4968;2461;2507;2017
36;Pontevedra;024;Lalín;20075;9751;10324;2017
36;Pontevedra;025;Lama, A;2478;1217;1261;2017
36;Pontevedra;026;Marín;24637;12324;12313;2017
36;Pontevedra;027;Meaño;5318;2594;2724;2017
36;Pontevedra;028;Meis;4788;2281;2507;2017
36;Pontevedra;029;Moaña;19439;9429;10010;2017
36;Pontevedra;030;Mondariz;4548;2230;2318;2017
36;Pontevedra;031;Mondariz-Balneario;627;326;301;2017
36;Pontevedra;032;Moraña;4246;2057;2189;2017
36;Pontevedra;033;Mos;15132;7487;7645;2017
36;Pontevedra;034;Neves, As;3968;1915;2053;2017
36;Pontevedra;035;Nigrán;17622;8647;8975;2017
36;Pontevedra;036;Oia;3004;1498;1506;2017
36;Pontevedra;037;Pazos de Borbén;2991;1450;1541;2017
36;Pontevedra;041;Poio;16871;8355;8516;2017
36;Pontevedra;043;Ponte Caldelas;5562;2676;2886;2017
36;Pontevedra;042;Ponteareas;22893;11146;11747;2017
36;Pontevedra;044;Pontecesures;3037;1512;1525;2017
36;Pontevedra;038;Pontevedra;82671;39194;43477;2017
36;Pontevedra;039;Porriño, O;19600;9652;9948;2017
36;Pontevedra;040;Portas;3016;1442;1574;2017
36;Pontevedra;045;Redondela;29392;14313;15079;2017
36;Pontevedra;046;Ribadumia;5081;2486;2595;2017
36;Pontevedra;047;Rodeiro;2567;1304;1263;2017
36;Pontevedra;048;Rosal, O;6328;3110;3218;2017
36;Pontevedra;049;Salceda de Caselas;9017;4498;4519;2017
36;Pontevedra;050;Salvaterra de Miño;9657;4813;4844;2017
36;Pontevedra;051;Sanxenxo;17241;8523;8718;2017
36;Pontevedra;052;Silleda;8669;4215;4454;2017
36;Pontevedra;053;Soutomaior;7242;3580;3662;2017
36;Pontevedra;054;Tomiño;13585;6836;6749;2017
36;Pontevedra;055;Tui;16860;8123;8737;2017
36;Pontevedra;056;Valga;5986;2933;3053;2017
36;Pontevedra;057;Vigo;292986;138867;154119;2017
36;Pontevedra;059;Vila de Cruces;5389;2641;2748;2017
36;Pontevedra;058;Vilaboa;6023;2933;3090;2017
36;Pontevedra;060;Vilagarcía de Arousa;37479;17955;19524;2017
36;Pontevedra;061;Vilanova de Arousa;10361;5077;5284;2017
26;Rioja, La;001;Ábalos;249;146;103;2017
26;Rioja, La;002;Agoncillo;1072;582;490;2017
26;Rioja, La;003;Aguilar del Río Alhama;479;239;240;2017
26;Rioja, La;004;Ajamil de Cameros;66;46;20;2017
26;Rioja, La;005;Albelda de Iregua;3408;1735;1673;2017
26;Rioja, La;006;Alberite;2412;1219;1193;2017
26;Rioja, La;007;Alcanadre;663;347;316;2017
26;Rioja, La;008;Aldeanueva de Ebro;2730;1426;1304;2017
26;Rioja, La;009;Alesanco;508;269;239;2017
26;Rioja, La;010;Alesón;107;65;42;2017
26;Rioja, La;011;Alfaro;9503;4770;4733;2017
26;Rioja, La;012;Almarza de Cameros;26;16;10;2017
26;Rioja, La;013;Anguciana;433;238;195;2017
26;Rioja, La;014;Anguiano;506;282;224;2017
26;Rioja, La;015;Arenzana de Abajo;239;126;113;2017
26;Rioja, La;016;Arenzana de Arriba;30;21;9;2017
26;Rioja, La;017;Arnedillo;451;223;228;2017
26;Rioja, La;018;Arnedo;14756;7333;7423;2017
26;Rioja, La;019;Arrúbal;479;261;218;2017
26;Rioja, La;020;Ausejo;754;398;356;2017
26;Rioja, La;021;Autol;4507;2237;2270;2017
26;Rioja, La;022;Azofra;204;108;96;2017
26;Rioja, La;023;Badarán;507;257;250;2017
26;Rioja, La;024;Bañares;240;128;112;2017
26;Rioja, La;026;Baños de Río Tobía;1600;798;802;2017
26;Rioja, La;025;Baños de Rioja;91;54;37;2017
26;Rioja, La;027;Berceo;166;107;59;2017
26;Rioja, La;028;Bergasa;147;81;66;2017
26;Rioja, La;029;Bergasillas Bajera;38;20;18;2017
26;Rioja, La;030;Bezares;20;10;10;2017
26;Rioja, La;031;Bobadilla;111;57;54;2017
26;Rioja, La;032;Brieva de Cameros;53;31;22;2017
26;Rioja, La;033;Briñas;202;91;111;2017
26;Rioja, La;034;Briones;784;415;369;2017
26;Rioja, La;035;Cabezón de Cameros;16;12;4;2017
26;Rioja, La;036;Calahorra;23737;11641;12096;2017
26;Rioja, La;037;Camprovín;148;81;67;2017
26;Rioja, La;038;Canales de la Sierra;87;57;30;2017
26;Rioja, La;039;Canillas de Río Tuerto;38;18;20;2017
26;Rioja, La;040;Cañas;103;57;46;2017
26;Rioja, La;041;Cárdenas;151;81;70;2017
26;Rioja, La;042;Casalarreina;1150;586;564;2017
26;Rioja, La;043;Castañares de Rioja;430;210;220;2017
26;Rioja, La;044;Castroviejo;55;35;20;2017
26;Rioja, La;045;Cellorigo;12;5;7;2017
26;Rioja, La;046;Cenicero;2016;1016;1000;2017
26;Rioja, La;047;Cervera del Río Alhama;2346;1204;1142;2017
26;Rioja, La;048;Cidamón;24;12;12;2017
26;Rioja, La;049;Cihuri;200;106;94;2017
26;Rioja, La;050;Cirueña;139;92;47;2017
26;Rioja, La;051;Clavijo;281;166;115;2017
26;Rioja, La;052;Cordovín;155;77;78;2017
26;Rioja, La;053;Corera;255;133;122;2017
26;Rioja, La;054;Cornago;337;196;141;2017
26;Rioja, La;055;Corporales;41;23;18;2017
26;Rioja, La;056;Cuzcurrita de Río Tirón;496;275;221;2017
26;Rioja, La;057;Daroca de Rioja;45;31;14;2017
26;Rioja, La;058;Enciso;173;108;65;2017
26;Rioja, La;059;Entrena;1499;782;717;2017
26;Rioja, La;060;Estollo;95;64;31;2017
26;Rioja, La;061;Ezcaray;2044;1061;983;2017
26;Rioja, La;062;Foncea;93;52;41;2017
26;Rioja, La;063;Fonzaleche;134;82;52;2017
26;Rioja, La;064;Fuenmayor;3095;1559;1536;2017
26;Rioja, La;065;Galbárruli;52;32;20;2017
26;Rioja, La;066;Galilea;342;176;166;2017
26;Rioja, La;067;Gallinero de Cameros;23;16;7;2017
26;Rioja, La;068;Gimileo;118;63;55;2017
26;Rioja, La;069;Grañón;255;146;109;2017
26;Rioja, La;070;Grávalos;192;98;94;2017
26;Rioja, La;071;Haro;11305;5538;5767;2017
26;Rioja, La;072;Herce;325;174;151;2017
26;Rioja, La;073;Herramélluri;109;59;50;2017
26;Rioja, La;074;Hervías;118;60;58;2017
26;Rioja, La;075;Hormilla;431;234;197;2017
26;Rioja, La;076;Hormilleja;141;72;69;2017
26;Rioja, La;077;Hornillos de Cameros;21;10;11;2017
26;Rioja, La;078;Hornos de Moncalvillo;88;52;36;2017
26;Rioja, La;079;Huércanos;823;440;383;2017
26;Rioja, La;080;Igea;607;340;267;2017
26;Rioja, La;081;Jalón de Cameros;18;10;8;2017
26;Rioja, La;082;Laguna de Cameros;119;72;47;2017
26;Rioja, La;083;Lagunilla del Jubera;292;163;129;2017
26;Rioja, La;084;Lardero;9872;4972;4900;2017
26;Rioja, La;086;Ledesma de la Cogolla;15;12;3;2017
26;Rioja, La;087;Leiva;245;125;120;2017
26;Rioja, La;088;Leza de Río Leza;37;22;15;2017
26;Rioja, La;089;Logroño;150979;71727;79252;2017
26;Rioja, La;091;Lumbreras;166;111;55;2017
26;Rioja, La;092;Manjarrés;116;72;44;2017
26;Rioja, La;093;Mansilla de la Sierra;67;47;20;2017
26;Rioja, La;094;Manzanares de Rioja;84;49;35;2017
26;Rioja, La;095;Matute;93;48;45;2017
26;Rioja, La;096;Medrano;304;165;139;2017
26;Rioja, La;098;Munilla;107;60;47;2017
26;Rioja, La;099;Murillo de Río Leza;1678;854;824;2017
26;Rioja, La;100;Muro de Aguas;52;29;23;2017
26;Rioja, La;101;Muro en Cameros;44;25;19;2017
26;Rioja, La;102;Nájera;8088;3975;4113;2017
26;Rioja, La;103;Nalda;993;534;459;2017
26;Rioja, La;104;Navajún;14;10;4;2017
26;Rioja, La;105;Navarrete;2949;1496;1453;2017
26;Rioja, La;106;Nestares;93;52;41;2017
26;Rioja, La;107;Nieva de Cameros;96;62;34;2017
26;Rioja, La;109;Ochánduri;84;51;33;2017
26;Rioja, La;108;Ocón;280;175;105;2017
26;Rioja, La;110;Ojacastro;176;106;70;2017
26;Rioja, La;111;Ollauri;278;148;130;2017
26;Rioja, La;112;Ortigosa de Cameros;241;140;101;2017
26;Rioja, La;113;Pazuengos;34;26;8;2017
26;Rioja, La;114;Pedroso;77;54;23;2017
26;Rioja, La;115;Pinillos;18;11;7;2017
26;Rioja, La;117;Pradejón;3908;1986;1922;2017
26;Rioja, La;118;Pradillo;59;30;29;2017
26;Rioja, La;119;Préjano;221;123;98;2017
26;Rioja, La;120;Quel;2011;1066;945;2017
26;Rioja, La;121;Rabanera;28;20;8;2017
26;Rioja, La;122;Rasillo de Cameros, El;150;78;72;2017
26;Rioja, La;123;Redal, El;141;80;61;2017
26;Rioja, La;124;Ribafrecha;978;511;467;2017
26;Rioja, La;125;Rincón de Soto;3722;1891;1831;2017
26;Rioja, La;126;Robres del Castillo;30;19;11;2017
26;Rioja, La;127;Rodezno;249;137;112;2017
26;Rioja, La;128;Sajazarra;130;63;67;2017
26;Rioja, La;129;San Asensio;1130;603;527;2017
26;Rioja, La;130;San Millán de la Cogolla;228;152;76;2017
26;Rioja, La;131;San Millán de Yécora;37;26;11;2017
26;Rioja, La;132;San Román de Cameros;140;83;57;2017
26;Rioja, La;139;San Torcuato;66;30;36;2017
26;Rioja, La;142;San Vicente de la Sonsierra;1014;523;491;2017
26;Rioja, La;134;Santa Coloma;90;56;34;2017
26;Rioja, La;135;Santa Engracia del Jubera;159;104;55;2017
26;Rioja, La;136;Santa Eulalia Bajera;115;60;55;2017
26;Rioja, La;138;Santo Domingo de la Calzada;6298;3157;3141;2017
26;Rioja, La;140;Santurde de Rioja;272;146;126;2017
26;Rioja, La;141;Santurdejo;110;71;39;2017
26;Rioja, La;143;Sojuela;287;166;121;2017
26;Rioja, La;144;Sorzano;220;126;94;2017
26;Rioja, La;145;Sotés;291;165;126;2017
26;Rioja, La;146;Soto en Cameros;97;56;41;2017
26;Rioja, La;147;Terroba;32;16;16;2017
26;Rioja, La;148;Tirgo;194;97;97;2017
26;Rioja, La;149;Tobía;53;31;22;2017
26;Rioja, La;150;Tormantos;132;78;54;2017
26;Rioja, La;153;Torre en Cameros;10;8;2;2017
26;Rioja, La;151;Torrecilla en Cameros;482;262;220;2017
26;Rioja, La;152;Torrecilla sobre Alesanco;34;20;14;2017
26;Rioja, La;154;Torremontalbo;12;6;6;2017
26;Rioja, La;155;Treviana;169;90;79;2017
26;Rioja, La;157;Tricio;378;188;190;2017
26;Rioja, La;158;Tudelilla;349;192;157;2017
26;Rioja, La;160;Uruñuela;980;499;481;2017
26;Rioja, La;161;Valdemadera;8;5;3;2017
26;Rioja, La;162;Valgañón;140;87;53;2017
26;Rioja, La;163;Ventosa;176;90;86;2017
26;Rioja, La;164;Ventrosa;54;33;21;2017
26;Rioja, La;165;Viguera;408;226;182;2017
26;Rioja, La;166;Villalba de Rioja;147;92;55;2017
26;Rioja, La;167;Villalobar de Rioja;69;48;21;2017
26;Rioja, La;168;Villamediana de Iregua;7855;3956;3899;2017
26;Rioja, La;169;Villanueva de Cameros;71;39;32;2017
26;Rioja, La;170;Villar de Arnedo, El;605;312;293;2017
26;Rioja, La;171;Villar de Torre;172;101;71;2017
26;Rioja, La;172;Villarejo;29;23;6;2017
26;Rioja, La;173;Villarroya;5;3;2;2017
26;Rioja, La;174;Villarta-Quintana;144;83;61;2017
26;Rioja, La;175;Villavelayo;48;30;18;2017
26;Rioja, La;176;Villaverde de Rioja;55;31;24;2017
26;Rioja, La;177;Villoslada de Cameros;323;201;122;2017
26;Rioja, La;178;Viniegra de Abajo;75;45;30;2017
26;Rioja, La;179;Viniegra de Arriba;39;25;14;2017
26;Rioja, La;180;Zarratón;253;139;114;2017
26;Rioja, La;181;Zarzosa;14;10;4;2017
26;Rioja, La;183;Zorraquín;90;43;47;2017
37;Salamanca;001;Abusejo;203;107;96;2017
37;Salamanca;002;Agallas;153;76;77;2017
37;Salamanca;003;Ahigal de los Aceiteros;126;67;59;2017
37;Salamanca;004;Ahigal de Villarino;35;19;16;2017
37;Salamanca;005;Alameda de Gardón, La;79;41;38;2017
37;Salamanca;006;Alamedilla, La;140;71;69;2017
37;Salamanca;007;Alaraz;481;249;232;2017
37;Salamanca;008;Alba de Tormes;5198;2600;2598;2017
37;Salamanca;009;Alba de Yeltes;225;122;103;2017
37;Salamanca;010;Alberca, La;1128;555;573;2017
37;Salamanca;011;Alberguería de Argañán, La;123;62;61;2017
37;Salamanca;012;Alconada;160;85;75;2017
37;Salamanca;015;Aldea del Obispo;281;149;132;2017
37;Salamanca;013;Aldeacipreste;119;64;55;2017
37;Salamanca;014;Aldeadávila de la Ribera;1258;637;621;2017
37;Salamanca;016;Aldealengua;677;339;338;2017
37;Salamanca;017;Aldeanueva de Figueroa;263;139;124;2017
37;Salamanca;018;Aldeanueva de la Sierra;107;59;48;2017
37;Salamanca;019;Aldearrodrigo;148;77;71;2017
37;Salamanca;020;Aldearrubia;481;259;222;2017
37;Salamanca;021;Aldeaseca de Alba;77;35;42;2017
37;Salamanca;022;Aldeaseca de la Frontera;280;142;138;2017
37;Salamanca;023;Aldeatejada;1878;945;933;2017
37;Salamanca;024;Aldeavieja de Tormes;103;55;48;2017
37;Salamanca;025;Aldehuela de la Bóveda;289;153;136;2017
37;Salamanca;026;Aldehuela de Yeltes;198;107;91;2017
37;Salamanca;027;Almenara de Tormes;254;145;109;2017
37;Salamanca;028;Almendra;164;96;68;2017
37;Salamanca;029;Anaya de Alba;211;121;90;2017
37;Salamanca;030;Añover de Tormes;94;50;44;2017
37;Salamanca;031;Arabayona de Mógica;380;211;169;2017
37;Salamanca;032;Arapiles;653;350;303;2017
37;Salamanca;033;Arcediano;103;55;48;2017
37;Salamanca;034;Arco, El;87;43;44;2017
37;Salamanca;035;Armenteros;209;117;92;2017
37;Salamanca;037;Atalaya, La;117;64;53;2017
37;Salamanca;038;Babilafuente;919;473;446;2017
37;Salamanca;039;Bañobárez;302;157;145;2017
37;Salamanca;040;Barbadillo;414;215;199;2017
37;Salamanca;041;Barbalos;77;41;36;2017
37;Salamanca;042;Barceo;49;30;19;2017
37;Salamanca;044;Barruecopardo;461;252;209;2017
37;Salamanca;045;Bastida, La;27;16;11;2017
37;Salamanca;046;Béjar;13221;6233;6988;2017
37;Salamanca;047;Beleña;229;121;108;2017
37;Salamanca;049;Bermellar;136;66;70;2017
37;Salamanca;050;Berrocal de Huebra;69;38;31;2017
37;Salamanca;051;Berrocal de Salvatierra;85;46;39;2017
37;Salamanca;052;Boada;292;148;144;2017
37;Salamanca;054;Bodón, El;285;154;131;2017
37;Salamanca;055;Bogajo;141;75;66;2017
37;Salamanca;056;Bouza, La;52;24;28;2017
37;Salamanca;057;Bóveda del Río Almar;237;130;107;2017
37;Salamanca;058;Brincones;58;30;28;2017
37;Salamanca;059;Buenamadre;133;71;62;2017
37;Salamanca;060;Buenavista;326;174;152;2017
37;Salamanca;061;Cabaco, El;245;124;121;2017
37;Salamanca;063;Cabeza de Béjar, La;72;42;30;2017
37;Salamanca;065;Cabeza del Caballo;316;169;147;2017
37;Salamanca;062;Cabezabellosa de la Calzada;83;47;36;2017
37;Salamanca;067;Cabrerizos;4196;2100;2096;2017
37;Salamanca;068;Cabrillas;395;202;193;2017
37;Salamanca;069;Calvarrasa de Abajo;1152;608;544;2017
37;Salamanca;070;Calvarrasa de Arriba;603;322;281;2017
37;Salamanca;071;Calzada de Béjar, La;87;48;39;2017
37;Salamanca;072;Calzada de Don Diego;170;90;80;2017
37;Salamanca;073;Calzada de Valdunciel;666;336;330;2017
37;Salamanca;074;Campillo de Azaba;162;93;69;2017
37;Salamanca;077;Campo de Peñaranda, El;271;156;115;2017
37;Salamanca;078;Candelario;934;469;465;2017
37;Salamanca;079;Canillas de Abajo;78;55;23;2017
37;Salamanca;080;Cantagallo;261;144;117;2017
37;Salamanca;081;Cantalapiedra;1003;522;481;2017
37;Salamanca;082;Cantalpino;895;489;406;2017
37;Salamanca;083;Cantaracillo;194;104;90;2017
37;Salamanca;085;Carbajosa de la Sagrada;6848;3423;3425;2017
37;Salamanca;086;Carpio de Azaba;105;59;46;2017
37;Salamanca;087;Carrascal de Barregas;1151;609;542;2017
37;Salamanca;088;Carrascal del Obispo;223;118;105;2017
37;Salamanca;089;Casafranca;70;39;31;2017
37;Salamanca;090;Casas del Conde, Las;56;28;28;2017
37;Salamanca;091;Casillas de Flores;187;95;92;2017
37;Salamanca;092;Castellanos de Moriscos;2557;1309;1248;2017
37;Salamanca;185;Castellanos de Villiquera;670;360;310;2017
37;Salamanca;096;Castillejo de Martín Viejo;226;129;97;2017
37;Salamanca;097;Castraz;40;24;16;2017
37;Salamanca;098;Cepeda;346;174;172;2017
37;Salamanca;099;Cereceda de la Sierra;66;36;30;2017
37;Salamanca;100;Cerezal de Peñahorcada;74;41;33;2017
37;Salamanca;101;Cerralbo;160;88;72;2017
37;Salamanca;102;Cerro, El;430;212;218;2017
37;Salamanca;103;Cespedosa de Tormes;508;270;238;2017
37;Salamanca;114;Chagarcía Medianero;81;42;39;2017
37;Salamanca;104;Cilleros de la Bastida;28;13;15;2017
37;Salamanca;106;Cipérez;284;144;140;2017
37;Salamanca;107;Ciudad Rodrigo;12668;6115;6553;2017
37;Salamanca;108;Coca de Alba;97;46;51;2017
37;Salamanca;109;Colmenar de Montemayor;187;107;80;2017
37;Salamanca;110;Cordovilla;134;72;62;2017
37;Salamanca;112;Cristóbal;168;96;72;2017
37;Salamanca;113;Cubo de Don Sancho, El;449;244;205;2017
37;Salamanca;115;Dios le Guarde;132;69;63;2017
37;Salamanca;116;Doñinos de Ledesma;69;36;33;2017
37;Salamanca;117;Doñinos de Salamanca;2014;1048;966;2017
37;Salamanca;118;Ejeme;130;74;56;2017
37;Salamanca;120;Encina de San Silvestre;109;54;55;2017
37;Salamanca;119;Encina, La;108;65;43;2017
37;Salamanca;121;Encinas de Abajo;651;341;310;2017
37;Salamanca;122;Encinas de Arriba;241;121;120;2017
37;Salamanca;123;Encinasola de los Comendadores;174;96;78;2017
37;Salamanca;124;Endrinal;232;127;105;2017
37;Salamanca;125;Escurial de la Sierra;237;133;104;2017
37;Salamanca;126;Espadaña;36;22;14;2017
37;Salamanca;127;Espeja;240;126;114;2017
37;Salamanca;128;Espino de la Orbada;273;148;125;2017
37;Salamanca;129;Florida de Liébana;267;145;122;2017
37;Salamanca;130;Forfoleda;192;103;89;2017
37;Salamanca;131;Frades de la Sierra;200;109;91;2017
37;Salamanca;132;Fregeneda, La;363;178;185;2017
37;Salamanca;133;Fresnedoso;111;63;48;2017
37;Salamanca;134;Fresno Alhándiga;225;121;104;2017
37;Salamanca;135;Fuente de San Esteban, La;1334;663;671;2017
37;Salamanca;136;Fuenteguinaldo;678;340;338;2017
37;Salamanca;137;Fuenteliante;104;53;51;2017
37;Salamanca;138;Fuenterroble de Salvatierra;242;124;118;2017
37;Salamanca;139;Fuentes de Béjar;240;120;120;2017
37;Salamanca;140;Fuentes de Oñoro;1208;630;578;2017
37;Salamanca;141;Gajates;169;78;91;2017
37;Salamanca;142;Galindo y Perahuy;703;409;294;2017
37;Salamanca;143;Galinduste;440;215;225;2017
37;Salamanca;144;Galisancho;402;220;182;2017
37;Salamanca;145;Gallegos de Argañán;279;144;135;2017
37;Salamanca;146;Gallegos de Solmirón;124;70;54;2017
37;Salamanca;147;Garcibuey;195;112;83;2017
37;Salamanca;148;Garcihernández;469;249;220;2017
37;Salamanca;149;Garcirrey;69;41;28;2017
37;Salamanca;150;Gejuelo del Barro;38;22;16;2017
37;Salamanca;151;Golpejas;154;81;73;2017
37;Salamanca;152;Gomecello;455;239;216;2017
37;Salamanca;154;Guadramiro;152;87;65;2017
37;Salamanca;155;Guijo de Ávila;67;39;28;2017
37;Salamanca;156;Guijuelo;5627;2821;2806;2017
37;Salamanca;157;Herguijuela de Ciudad Rodrigo;78;46;32;2017
37;Salamanca;158;Herguijuela de la Sierra;271;150;121;2017
37;Salamanca;159;Herguijuela del Campo;82;39;43;2017
37;Salamanca;160;Hinojosa de Duero;691;345;346;2017
37;Salamanca;161;Horcajo de Montemayor;144;76;68;2017
37;Salamanca;162;Horcajo Medianero;217;113;104;2017
37;Salamanca;163;Hoya, La;41;24;17;2017
37;Salamanca;164;Huerta;298;167;131;2017
37;Salamanca;165;Iruelos;34;14;20;2017
37;Salamanca;166;Ituero de Azaba;233;121;112;2017
37;Salamanca;167;Juzbado;173;91;82;2017
37;Salamanca;168;Lagunilla;481;260;221;2017
37;Salamanca;169;Larrodrigo;193;110;83;2017
37;Salamanca;170;Ledesma;1688;837;851;2017
37;Salamanca;171;Ledrada;489;245;244;2017
37;Salamanca;172;Linares de Riofrío;979;539;440;2017
37;Salamanca;173;Lumbrales;1662;840;822;2017
37;Salamanca;175;Machacón;449;232;217;2017
37;Salamanca;174;Macotera;1114;581;533;2017
37;Salamanca;176;Madroñal;146;83;63;2017
37;Salamanca;177;Maíllo, El;279;154;125;2017
37;Salamanca;178;Malpartida;101;57;44;2017
37;Salamanca;179;Mancera de Abajo;231;118;113;2017
37;Salamanca;180;Manzano, El;75;40;35;2017
37;Salamanca;181;Martiago;292;154;138;2017
37;Salamanca;183;Martín de Yeltes;424;219;205;2017
37;Salamanca;182;Martinamor;83;50;33;2017
37;Salamanca;184;Masueco;304;156;148;2017
37;Salamanca;186;Mata de Ledesma, La;106;58;48;2017
37;Salamanca;187;Matilla de los Caños del Río;640;321;319;2017
37;Salamanca;188;Maya, La;185;111;74;2017
37;Salamanca;189;Membribe de la Sierra;123;72;51;2017
37;Salamanca;190;Mieza;222;109;113;2017
37;Salamanca;191;Milano, El;122;72;50;2017
37;Salamanca;192;Miranda de Azán;425;225;200;2017
37;Salamanca;193;Miranda del Castañar;416;218;198;2017
37;Salamanca;194;Mogarraz;283;146;137;2017
37;Salamanca;195;Molinillo;42;25;17;2017
37;Salamanca;196;Monforte de la Sierra;72;38;34;2017
37;Salamanca;197;Monleón;93;53;40;2017
37;Salamanca;198;Monleras;234;109;125;2017
37;Salamanca;199;Monsagro;141;75;66;2017
37;Salamanca;200;Montejo;218;121;97;2017
37;Salamanca;201;Montemayor del Río;272;141;131;2017
37;Salamanca;202;Monterrubio de Armuña;1334;709;625;2017
37;Salamanca;203;Monterrubio de la Sierra;162;91;71;2017
37;Salamanca;204;Morasverdes;269;143;126;2017
37;Salamanca;205;Morille;239;128;111;2017
37;Salamanca;206;Moríñigo;106;58;48;2017
37;Salamanca;207;Moriscos;349;195;154;2017
37;Salamanca;208;Moronta;75;45;30;2017
37;Salamanca;209;Mozárbez;493;258;235;2017
37;Salamanca;211;Narros de Matalayegua;235;127;108;2017
37;Salamanca;213;Nava de Béjar;96;51;45;2017
37;Salamanca;214;Nava de Francia;140;78;62;2017
37;Salamanca;215;Nava de Sotrobal;163;92;71;2017
37;Salamanca;212;Navacarros;104;57;47;2017
37;Salamanca;216;Navales;322;176;146;2017
37;Salamanca;217;Navalmoral de Béjar;62;27;35;2017
37;Salamanca;218;Navamorales;64;41;23;2017
37;Salamanca;219;Navarredonda de la Rinconada;173;88;85;2017
37;Salamanca;221;Navasfrías;469;248;221;2017
37;Salamanca;222;Negrilla de Palencia;89;51;38;2017
37;Salamanca;223;Olmedo de Camaces;106;56;50;2017
37;Salamanca;224;Orbada, La;218;114;104;2017
37;Salamanca;225;Pajares de la Laguna;112;60;52;2017
37;Salamanca;226;Palacios del Arzobispo;161;79;82;2017
37;Salamanca;228;Palaciosrubios;368;194;174;2017
37;Salamanca;229;Palencia de Negrilla;155;88;67;2017
37;Salamanca;230;Parada de Arriba;250;127;123;2017
37;Salamanca;231;Parada de Rubiales;267;138;129;2017
37;Salamanca;232;Paradinas de San Juan;413;238;175;2017
37;Salamanca;233;Pastores;54;31;23;2017
37;Salamanca;234;Payo, El;354;175;179;2017
37;Salamanca;235;Pedraza de Alba;239;125;114;2017
37;Salamanca;236;Pedrosillo de Alba;148;86;62;2017
37;Salamanca;237;Pedrosillo de los Aires;369;205;164;2017
37;Salamanca;238;Pedrosillo el Ralo;128;67;61;2017
37;Salamanca;239;Pedroso de la Armuña, El;222;114;108;2017
37;Salamanca;240;Pelabravo;1247;666;581;2017
37;Salamanca;241;Pelarrodríguez;166;100;66;2017
37;Salamanca;242;Pelayos;94;54;40;2017
37;Salamanca;243;Peña, La;100;48;52;2017
37;Salamanca;244;Peñacaballera;142;69;73;2017
37;Salamanca;245;Peñaparda;369;187;182;2017
37;Salamanca;246;Peñaranda de Bracamonte;6420;3146;3274;2017
37;Salamanca;247;Peñarandilla;197;103;94;2017
37;Salamanca;248;Peralejos de Abajo;160;86;74;2017
37;Salamanca;249;Peralejos de Arriba;42;25;17;2017
37;Salamanca;250;Pereña de la Ribera;366;192;174;2017
37;Salamanca;251;Peromingo;132;64;68;2017
37;Salamanca;252;Pinedas;115;65;50;2017
37;Salamanca;253;Pino de Tormes, El;159;88;71;2017
37;Salamanca;254;Pitiegua;192;106;86;2017
37;Salamanca;255;Pizarral;53;31;22;2017
37;Salamanca;256;Poveda de las Cintas;234;131;103;2017
37;Salamanca;257;Pozos de Hinojo;49;28;21;2017
37;Salamanca;258;Puebla de Azaba;179;100;79;2017
37;Salamanca;259;Puebla de San Medel;44;26;18;2017
37;Salamanca;260;Puebla de Yeltes;146;76;70;2017
37;Salamanca;261;Puente del Congosto;227;125;102;2017
37;Salamanca;262;Puertas;86;47;39;2017
37;Salamanca;263;Puerto de Béjar;368;182;186;2017
37;Salamanca;264;Puerto Seguro;62;30;32;2017
37;Salamanca;265;Rágama;227;118;109;2017
37;Salamanca;266;Redonda, La;86;51;35;2017
37;Salamanca;267;Retortillo;204;110;94;2017
37;Salamanca;268;Rinconada de la Sierra, La;119;67;52;2017
37;Salamanca;269;Robleda;503;270;233;2017
37;Salamanca;270;Robliza de Cojos;201;102;99;2017
37;Salamanca;271;Rollán;384;209;175;2017
37;Salamanca;272;Saelices el Chico;150;80;70;2017
37;Salamanca;273;Sagrada, La;109;60;49;2017
37;Salamanca;303;Sahugo, El;191;103;88;2017
37;Salamanca;274;Salamanca;144436;65702;78734;2017
37;Salamanca;275;Saldeana;113;62;51;2017
37;Salamanca;276;Salmoral;138;86;52;2017
37;Salamanca;277;Salvatierra de Tormes;77;37;40;2017
37;Salamanca;278;San Cristóbal de la Cuesta;989;527;462;2017
37;Salamanca;284;San Esteban de la Sierra;345;194;151;2017
37;Salamanca;285;San Felices de los Gallegos;428;218;210;2017
37;Salamanca;286;San Martín del Castañar;225;120;105;2017
37;Salamanca;287;San Miguel de Valero;334;171;163;2017
37;Salamanca;036;San Miguel del Robledo;60;32;28;2017
37;Salamanca;288;San Morales;332;184;148;2017
37;Salamanca;289;San Muñoz;241;122;119;2017
37;Salamanca;291;San Pedro de Rozados;311;171;140;2017
37;Salamanca;290;San Pedro del Valle;148;81;67;2017
37;Salamanca;292;San Pelayo de Guareña;96;51;45;2017
37;Salamanca;280;Sanchón de la Ribera;84;45;39;2017
37;Salamanca;281;Sanchón de la Sagrada;39;23;16;2017
37;Salamanca;282;Sanchotello;229;120;109;2017
37;Salamanca;279;Sancti-Spíritus;841;459;382;2017
37;Salamanca;283;Sando;127;78;49;2017
37;Salamanca;293;Santa María de Sando;114;60;54;2017
37;Salamanca;294;Santa Marta de Tormes;14806;7277;7529;2017
37;Salamanca;296;Santiago de la Puebla;334;176;158;2017
37;Salamanca;297;Santibáñez de Béjar;476;240;236;2017
37;Salamanca;298;Santibáñez de la Sierra;187;102;85;2017
37;Salamanca;299;Santiz;242;126;116;2017
37;Salamanca;300;Santos, Los;633;328;305;2017
37;Salamanca;301;Sardón de los Frailes;84;51;33;2017
37;Salamanca;302;Saucelle;295;152;143;2017
37;Salamanca;304;Sepulcro-Hilario;181;101;80;2017
37;Salamanca;305;Sequeros;234;117;117;2017
37;Salamanca;306;Serradilla del Arroyo;267;147;120;2017
37;Salamanca;307;Serradilla del Llano;167;82;85;2017
37;Salamanca;309;Sierpe, La;46;21;25;2017
37;Salamanca;310;Sieteiglesias de Tormes;191;96;95;2017
37;Salamanca;311;Sobradillo;234;120;114;2017
37;Salamanca;312;Sorihuela;273;140;133;2017
37;Salamanca;313;Sotoserrano;590;316;274;2017
37;Salamanca;314;Tabera de Abajo;106;61;45;2017
37;Salamanca;315;Tala, La;94;54;40;2017
37;Salamanca;316;Tamames;805;419;386;2017
37;Salamanca;317;Tarazona de Guareña;325;173;152;2017
37;Salamanca;318;Tardáguila;221;127;94;2017
37;Salamanca;319;Tejado, El;109;59;50;2017
37;Salamanca;320;Tejeda y Segoyuela;91;50;41;2017
37;Salamanca;321;Tenebrón;156;75;81;2017
37;Salamanca;322;Terradillos;3053;1556;1497;2017
37;Salamanca;323;Topas;549;295;254;2017
37;Salamanca;324;Tordillos;367;204;163;2017
37;Salamanca;325;Tornadizo, El;93;53;40;2017
37;Salamanca;327;Torresmenudas;193;97;96;2017
37;Salamanca;328;Trabanca;212;104;108;2017
37;Salamanca;329;Tremedal de Tormes;45;23;22;2017
37;Salamanca;330;Valdecarros;363;186;177;2017
37;Salamanca;331;Valdefuentes de Sangusín;217;121;96;2017
37;Salamanca;332;Valdehijaderos;79;43;36;2017
37;Salamanca;333;Valdelacasa;235;139;96;2017
37;Salamanca;334;Valdelageve;74;38;36;2017
37;Salamanca;335;Valdelosa;433;212;221;2017
37;Salamanca;336;Valdemierque;62;39;23;2017
37;Salamanca;337;Valderrodrigo;153;74;79;2017
37;Salamanca;338;Valdunciel;97;47;50;2017
37;Salamanca;339;Valero;315;171;144;2017
37;Salamanca;343;Vallejera de Riofrío;68;32;36;2017
37;Salamanca;340;Valsalabroso;153;85;68;2017
37;Salamanca;341;Valverde de Valdelacasa;76;42;34;2017
37;Salamanca;342;Valverdón;285;148;137;2017
37;Salamanca;344;Vecinos;261;134;127;2017
37;Salamanca;345;Vega de Tirados;171;92;79;2017
37;Salamanca;346;Veguillas, Las;295;139;156;2017
37;Salamanca;347;Vellés, La;549;302;247;2017
37;Salamanca;348;Ventosa del Río Almar;116;67;49;2017
37;Salamanca;349;Vídola, La;117;55;62;2017
37;Salamanca;351;Villaflores;288;147;141;2017
37;Salamanca;352;Villagonzalo de Tormes;212;124;88;2017
37;Salamanca;353;Villalba de los Llanos;137;76;61;2017
37;Salamanca;354;Villamayor;7107;3566;3541;2017
37;Salamanca;355;Villanueva del Conde;173;89;84;2017
37;Salamanca;356;Villar de Argañán;87;45;42;2017
37;Salamanca;357;Villar de Ciervo;271;143;128;2017
37;Salamanca;358;Villar de Gallimazo;196;124;72;2017
37;Salamanca;359;Villar de la Yegua;197;102;95;2017
37;Salamanca;360;Villar de Peralonso;241;120;121;2017
37;Salamanca;361;Villar de Samaniego;92;53;39;2017
37;Salamanca;362;Villares de la Reina;6256;3112;3144;2017
37;Salamanca;363;Villares de Yeltes;126;61;65;2017
37;Salamanca;364;Villarino de los Aires;843;438;405;2017
37;Salamanca;365;Villarmayor;192;107;85;2017
37;Salamanca;366;Villarmuerto;42;27;15;2017
37;Salamanca;367;Villasbuenas;198;109;89;2017
37;Salamanca;368;Villasdardo;17;6;11;2017
37;Salamanca;369;Villaseco de los Gamitos;141;80;61;2017
37;Salamanca;370;Villaseco de los Reyes;340;194;146;2017
37;Salamanca;371;Villasrubias;281;155;126;2017
37;Salamanca;372;Villaverde de Guareña;149;81;68;2017
37;Salamanca;373;Villavieja de Yeltes;809;419;390;2017
37;Salamanca;374;Villoria;1368;686;682;2017
37;Salamanca;375;Villoruela;790;401;389;2017
37;Salamanca;350;Vilvestre;436;218;218;2017
37;Salamanca;376;Vitigudino;2580;1258;1322;2017
37;Salamanca;377;Yecla de Yeltes;252;131;121;2017
37;Salamanca;378;Zamarra;100;57;43;2017
37;Salamanca;379;Zamayón;207;124;83;2017
37;Salamanca;380;Zarapicos;55;30;25;2017
37;Salamanca;381;Zarza de Pumareda, La;152;85;67;2017
37;Salamanca;382;Zorita de la Frontera;162;85;77;2017
38;Santa Cruz de Tenerife;001;Adeje;46833;23612;23221;2017
38;Santa Cruz de Tenerife;002;Agulo;1066;538;528;2017
38;Santa Cruz de Tenerife;003;Alajeró;1983;1060;923;2017
38;Santa Cruz de Tenerife;004;Arafo;5531;2721;2810;2017
38;Santa Cruz de Tenerife;005;Arico;7594;3960;3634;2017
38;Santa Cruz de Tenerife;006;Arona;78930;40358;38572;2017
38;Santa Cruz de Tenerife;007;Barlovento;1859;948;911;2017
38;Santa Cruz de Tenerife;008;Breña Alta;7061;3466;3595;2017
38;Santa Cruz de Tenerife;009;Breña Baja;5434;2733;2701;2017
38;Santa Cruz de Tenerife;010;Buenavista del Norte;4797;2416;2381;2017
38;Santa Cruz de Tenerife;011;Candelaria;27149;13202;13947;2017
38;Santa Cruz de Tenerife;012;Fasnia;2743;1433;1310;2017
38;Santa Cruz de Tenerife;013;Frontera;3983;2011;1972;2017
38;Santa Cruz de Tenerife;014;Fuencaliente de la Palma;1695;867;828;2017
38;Santa Cruz de Tenerife;015;Garachico;4827;2419;2408;2017
38;Santa Cruz de Tenerife;016;Garafía;1584;832;752;2017
38;Santa Cruz de Tenerife;017;Granadilla de Abona;46816;23429;23387;2017
38;Santa Cruz de Tenerife;018;Guancha, La;5426;2654;2772;2017
38;Santa Cruz de Tenerife;019;Guía de Isora;20537;10245;10292;2017
38;Santa Cruz de Tenerife;020;Güímar;19273;9537;9736;2017
38;Santa Cruz de Tenerife;021;Hermigua;1808;931;877;2017
38;Santa Cruz de Tenerife;022;Icod de los Vinos;22558;11115;11443;2017
38;Santa Cruz de Tenerife;024;Llanos de Aridane, Los;20107;9723;10384;2017
38;Santa Cruz de Tenerife;025;Matanza de Acentejo, La;8854;4449;4405;2017
38;Santa Cruz de Tenerife;026;Orotava, La;41500;20356;21144;2017
38;Santa Cruz de Tenerife;027;Paso, El;7464;3728;3736;2017
38;Santa Cruz de Tenerife;901;Pinar de El Hierro, El;1776;932;844;2017
38;Santa Cruz de Tenerife;028;Puerto de la Cruz;30036;14670;15366;2017
38;Santa Cruz de Tenerife;029;Puntagorda;2009;1018;991;2017
38;Santa Cruz de Tenerife;030;Puntallana;2429;1209;1220;2017
38;Santa Cruz de Tenerife;031;Realejos, Los;36218;17835;18383;2017
38;Santa Cruz de Tenerife;032;Rosario, El;17312;8764;8548;2017
38;Santa Cruz de Tenerife;033;San Andrés y Sauces;4135;2069;2066;2017
38;Santa Cruz de Tenerife;023;San Cristóbal de La Laguna;153655;74542;79113;2017
38;Santa Cruz de Tenerife;034;San Juan de la Rambla;4828;2400;2428;2017
38;Santa Cruz de Tenerife;035;San Miguel de Abona;18887;9510;9377;2017
38;Santa Cruz de Tenerife;036;San Sebastián de la Gomera;8760;4393;4367;2017
38;Santa Cruz de Tenerife;037;Santa Cruz de la Palma;15581;7560;8021;2017
38;Santa Cruz de Tenerife;038;Santa Cruz de Tenerife;203692;97298;106394;2017
38;Santa Cruz de Tenerife;039;Santa Úrsula;14189;7080;7109;2017
38;Santa Cruz de Tenerife;040;Santiago del Teide;10576;5299;5277;2017
38;Santa Cruz de Tenerife;041;Sauzal, El;8873;4381;4492;2017
38;Santa Cruz de Tenerife;042;Silos, Los;4848;2407;2441;2017
38;Santa Cruz de Tenerife;043;Tacoronte;23812;11856;11956;2017
38;Santa Cruz de Tenerife;044;Tanque, El;2650;1280;1370;2017
38;Santa Cruz de Tenerife;045;Tazacorte;4620;2357;2263;2017
38;Santa Cruz de Tenerife;046;Tegueste;11108;5492;5616;2017
38;Santa Cruz de Tenerife;047;Tijarafe;2590;1306;1284;2017
38;Santa Cruz de Tenerife;049;Valle Gran Rey;4371;2199;2172;2017
38;Santa Cruz de Tenerife;050;Vallehermoso;2988;1539;1449;2017
38;Santa Cruz de Tenerife;048;Valverde;4920;2483;2437;2017
38;Santa Cruz de Tenerife;051;Victoria de Acentejo, La;8969;4522;4447;2017
38;Santa Cruz de Tenerife;052;Vilaflor de Chasna;1615;841;774;2017
38;Santa Cruz de Tenerife;053;Villa de Mazo;4782;2412;2370;2017
40;Segovia;001;Abades;864;430;434;2017
40;Segovia;002;Adrada de Pirón;41;20;21;2017
40;Segovia;003;Adrados;138;76;62;2017
40;Segovia;004;Aguilafuente;585;283;302;2017
40;Segovia;005;Alconada de Maderuelo;29;18;11;2017
40;Segovia;012;Aldea Real;310;167;143;2017
40;Segovia;006;Aldealcorvo;25;15;10;2017
40;Segovia;007;Aldealengua de Pedraza;80;51;29;2017
40;Segovia;008;Aldealengua de Santa María;65;33;32;2017
40;Segovia;009;Aldeanueva de la Serrezuela;49;36;13;2017
40;Segovia;010;Aldeanueva del Codonal;127;68;59;2017
40;Segovia;013;Aldeasoña;57;32;25;2017
40;Segovia;014;Aldehorno;58;33;25;2017
40;Segovia;015;Aldehuela del Codonal;27;14;13;2017
40;Segovia;016;Aldeonte;58;28;30;2017
40;Segovia;017;Anaya;124;57;67;2017
40;Segovia;018;Añe;90;51;39;2017
40;Segovia;019;Arahuetes;41;28;13;2017
40;Segovia;020;Arcones;159;77;82;2017
40;Segovia;021;Arevalillo de Cega;27;16;11;2017
40;Segovia;022;Armuña;230;132;98;2017
40;Segovia;024;Ayllón;1212;628;584;2017
40;Segovia;025;Barbolla;167;90;77;2017
40;Segovia;026;Basardilla;146;64;82;2017
40;Segovia;028;Bercial;117;62;55;2017
40;Segovia;029;Bercimuel;27;13;14;2017
40;Segovia;030;Bernardos;518;288;230;2017
40;Segovia;031;Bernuy de Porreros;762;407;355;2017
40;Segovia;032;Boceguillas;708;363;345;2017
40;Segovia;033;Brieva;98;53;45;2017
40;Segovia;034;Caballar;91;49;42;2017
40;Segovia;035;Cabañas de Polendos;178;97;81;2017
40;Segovia;036;Cabezuela;681;346;335;2017
40;Segovia;037;Calabazas de Fuentidueña;35;20;15;2017
40;Segovia;039;Campo de San Pedro;265;147;118;2017
40;Segovia;040;Cantalejo;3579;1771;1808;2017
40;Segovia;041;Cantimpalos;1331;694;637;2017
40;Segovia;043;Carbonero el Mayor;2523;1302;1221;2017
40;Segovia;044;Carrascal del Río;151;82;69;2017
40;Segovia;045;Casla;163;94;69;2017
40;Segovia;046;Castillejo de Mesleón;135;77;58;2017
40;Segovia;047;Castro de Fuentidueña;32;20;12;2017
40;Segovia;048;Castrojimeno;33;18;15;2017
40;Segovia;049;Castroserna de Abajo;47;27;20;2017
40;Segovia;051;Castroserracín;50;30;20;2017
40;Segovia;052;Cedillo de la Torre;97;52;45;2017
40;Segovia;053;Cerezo de Abajo;123;67;56;2017
40;Segovia;054;Cerezo de Arriba;136;76;60;2017
40;Segovia;065;Chañe;813;398;415;2017
40;Segovia;055;Cilleruelo de San Mamés;34;22;12;2017
40;Segovia;056;Cobos de Fuentidueña;34;17;17;2017
40;Segovia;057;Coca;1826;914;912;2017
40;Segovia;058;Codorniz;342;173;169;2017
40;Segovia;059;Collado Hermoso;125;60;65;2017
40;Segovia;060;Condado de Castilnovo;104;58;46;2017
40;Segovia;061;Corral de Ayllón;85;49;36;2017
40;Segovia;902;Cozuelos de Fuentidueña;131;71;60;2017
40;Segovia;062;Cubillo;72;42;30;2017
40;Segovia;063;Cuéllar;9524;4807;4717;2017
40;Segovia;905;Cuevas de Provanco;136;75;61;2017
40;Segovia;068;Domingo García;27;16;11;2017
40;Segovia;069;Donhierro;92;50;42;2017
40;Segovia;070;Duruelo;175;106;69;2017
40;Segovia;071;Encinas;43;22;21;2017
40;Segovia;072;Encinillas;284;157;127;2017
40;Segovia;073;Escalona del Prado;512;272;240;2017
40;Segovia;074;Escarabajosa de Cabezas;306;167;139;2017
40;Segovia;075;Escobar de Polendos;177;95;82;2017
40;Segovia;076;Espinar, El;9155;4678;4477;2017
40;Segovia;077;Espirdo;1248;664;584;2017
40;Segovia;078;Fresneda de Cuéllar;173;97;76;2017
40;Segovia;079;Fresno de Cantespino;261;145;116;2017
40;Segovia;080;Fresno de la Fuente;74;43;31;2017
40;Segovia;081;Frumales;113;58;55;2017
40;Segovia;082;Fuente de Santa Cruz;122;66;56;2017
40;Segovia;083;Fuente el Olmo de Fuentidueña;170;76;94;2017
40;Segovia;084;Fuente el Olmo de Íscar;66;38;28;2017
40;Segovia;086;Fuentepelayo;860;456;404;2017
40;Segovia;087;Fuentepiñel;97;51;46;2017
40;Segovia;088;Fuenterrebollo;352;178;174;2017
40;Segovia;089;Fuentesaúco de Fuentidueña;240;127;113;2017
40;Segovia;091;Fuentesoto;113;61;52;2017
40;Segovia;092;Fuentidueña;141;83;58;2017
40;Segovia;093;Gallegos;92;50;42;2017
40;Segovia;094;Garcillán;450;232;218;2017
40;Segovia;095;Gomezserracín;699;364;335;2017
40;Segovia;097;Grajera;211;118;93;2017
40;Segovia;099;Honrubia de la Cuesta;58;32;26;2017
40;Segovia;100;Hontalbilla;304;166;138;2017
40;Segovia;101;Hontanares de Eresma;1363;721;642;2017
40;Segovia;103;Huertos, Los;175;102;73;2017
40;Segovia;104;Ituero y Lama;349;183;166;2017
40;Segovia;105;Juarros de Riomoros;55;30;25;2017
40;Segovia;106;Juarros de Voltoya;222;111;111;2017
40;Segovia;107;Labajos;126;71;55;2017
40;Segovia;108;Laguna de Contreras;118;68;50;2017
40;Segovia;109;Languilla;79;47;32;2017
40;Segovia;110;Lastras de Cuéllar;375;191;184;2017
40;Segovia;111;Lastras del Pozo;72;35;37;2017
40;Segovia;112;Lastrilla, La;3730;1895;1835;2017
40;Segovia;113;Losa, La;538;301;237;2017
40;Segovia;115;Maderuelo;99;57;42;2017
40;Segovia;903;Marazoleja;105;69;36;2017
40;Segovia;118;Marazuela;51;29;22;2017
40;Segovia;119;Martín Miguel;212;126;86;2017
40;Segovia;120;Martín Muñoz de la Dehesa;227;119;108;2017
40;Segovia;121;Martín Muñoz de las Posadas;308;158;150;2017
40;Segovia;122;Marugán;623;331;292;2017
40;Segovia;124;Mata de Cuéllar;260;136;124;2017
40;Segovia;123;Matabuena;166;95;71;2017
40;Segovia;125;Matilla, La;98;54;44;2017
40;Segovia;126;Melque de Cercos;81;42;39;2017
40;Segovia;127;Membibre de la Hoz;31;17;14;2017
40;Segovia;128;Migueláñez;140;77;63;2017
40;Segovia;129;Montejo de Arévalo;191;103;88;2017
40;Segovia;130;Montejo de la Vega de la Serrezuela;151;89;62;2017
40;Segovia;131;Monterrubio;62;35;27;2017
40;Segovia;132;Moral de Hornuez;59;34;25;2017
40;Segovia;134;Mozoncillo;914;488;426;2017
40;Segovia;135;Muñopedro;323;171;152;2017
40;Segovia;136;Muñoveros;160;78;82;2017
40;Segovia;138;Nava de la Asunción;2814;1414;1400;2017
40;Segovia;139;Navafría;304;160;144;2017
40;Segovia;140;Navalilla;108;57;51;2017
40;Segovia;141;Navalmanzano;1081;566;515;2017
40;Segovia;142;Navares de Ayuso;51;26;25;2017
40;Segovia;143;Navares de Enmedio;92;55;37;2017
40;Segovia;144;Navares de las Cuevas;27;16;11;2017
40;Segovia;145;Navas de Oro;1368;693;675;2017
40;Segovia;904;Navas de Riofrío;399;194;205;2017
40;Segovia;146;Navas de San Antonio;350;182;168;2017
40;Segovia;148;Nieva;284;147;137;2017
40;Segovia;149;Olombrada;588;308;280;2017
40;Segovia;150;Orejana;65;37;28;2017
40;Segovia;151;Ortigosa de Pestaño;59;31;28;2017
40;Segovia;901;Ortigosa del Monte;552;295;257;2017
40;Segovia;152;Otero de Herreros;975;490;485;2017
40;Segovia;154;Pajarejos;13;9;4;2017
40;Segovia;155;Palazuelos de Eresma;5174;2660;2514;2017
40;Segovia;156;Pedraza;388;218;170;2017
40;Segovia;157;Pelayos del Arroyo;46;28;18;2017
40;Segovia;158;Perosillo;16;12;4;2017
40;Segovia;159;Pinarejos;181;103;78;2017
40;Segovia;160;Pinarnegrillo;101;55;46;2017
40;Segovia;161;Pradales;47;29;18;2017
40;Segovia;162;Prádena;530;282;248;2017
40;Segovia;163;Puebla de Pedraza;57;28;29;2017
40;Segovia;164;Rapariegos;194;102;92;2017
40;Segovia;181;Real Sitio de San Ildefonso;5315;2627;2688;2017
40;Segovia;165;Rebollo;87;47;40;2017
40;Segovia;166;Remondo;302;154;148;2017
40;Segovia;168;Riaguas de San Bartolomé;36;22;14;2017
40;Segovia;170;Riaza;2138;1139;999;2017
40;Segovia;171;Ribota;40;32;8;2017
40;Segovia;172;Riofrío de Riaza;38;24;14;2017
40;Segovia;173;Roda de Eresma;185;97;88;2017
40;Segovia;174;Sacramenia;383;203;180;2017
40;Segovia;176;Samboal;469;257;212;2017
40;Segovia;177;San Cristóbal de Cuéllar;152;82;70;2017
40;Segovia;178;San Cristóbal de la Vega;110;60;50;2017
40;Segovia;906;San Cristóbal de Segovia;3028;1532;1496;2017
40;Segovia;182;San Martín y Mudrián;241;118;123;2017
40;Segovia;183;San Miguel de Bernuy;137;70;67;2017
40;Segovia;184;San Pedro de Gaíllos;300;161;139;2017
40;Segovia;179;Sanchonuño;918;449;469;2017
40;Segovia;180;Sangarcía;319;174;145;2017
40;Segovia;185;Santa María la Real de Nieva;1004;546;458;2017
40;Segovia;186;Santa Marta del Cerro;42;21;21;2017
40;Segovia;188;Santiuste de Pedraza;99;64;35;2017
40;Segovia;189;Santiuste de San Juan Bautista;575;319;256;2017
40;Segovia;190;Santo Domingo de Pirón;61;36;25;2017
40;Segovia;191;Santo Tomé del Puerto;277;153;124;2017
40;Segovia;192;Sauquillo de Cabezas;168;89;79;2017
40;Segovia;193;Sebúlcor;264;140;124;2017
40;Segovia;194;Segovia;51756;24341;27415;2017
40;Segovia;195;Sepúlveda;1105;579;526;2017
40;Segovia;196;Sequera de Fresno;36;24;12;2017
40;Segovia;198;Sotillo;26;15;11;2017
40;Segovia;199;Sotosalbos;110;56;54;2017
40;Segovia;200;Tabanera la Luenga;51;25;26;2017
40;Segovia;201;Tolocirio;53;25;28;2017
40;Segovia;206;Torre Val de San Pedro;188;97;91;2017
40;Segovia;202;Torreadrada;64;29;35;2017
40;Segovia;203;Torrecaballeros;1339;686;653;2017
40;Segovia;204;Torrecilla del Pinar;198;106;92;2017
40;Segovia;205;Torreiglesias;282;148;134;2017
40;Segovia;207;Trescasas;1059;545;514;2017
40;Segovia;208;Turégano;1005;499;506;2017
40;Segovia;210;Urueñas;111;68;43;2017
40;Segovia;211;Valdeprados;74;41;33;2017
40;Segovia;212;Valdevacas de Montejo;32;16;16;2017
40;Segovia;213;Valdevacas y Guijar;95;51;44;2017
40;Segovia;218;Valle de Tabladillo;96;56;40;2017
40;Segovia;219;Vallelado;697;373;324;2017
40;Segovia;220;Valleruela de Pedraza;73;36;37;2017
40;Segovia;221;Valleruela de Sepúlveda;52;25;27;2017
40;Segovia;214;Valseca;245;138;107;2017
40;Segovia;215;Valtiendas;80;45;35;2017
40;Segovia;216;Valverde del Majano;1064;540;524;2017
40;Segovia;222;Veganzones;229;128;101;2017
40;Segovia;223;Vegas de Matute;265;162;103;2017
40;Segovia;224;Ventosilla y Tejadilla;20;14;6;2017
40;Segovia;225;Villacastín;1495;775;720;2017
40;Segovia;228;Villaverde de Íscar;615;323;292;2017
40;Segovia;229;Villaverde de Montejo;30;17;13;2017
40;Segovia;230;Villeguillo;106;65;41;2017
40;Segovia;231;Yanguas de Eresma;140;69;71;2017
40;Segovia;233;Zarzuela del Monte;506;262;244;2017
40;Segovia;234;Zarzuela del Pinar;442;232;210;2017
41;Sevilla;001;Aguadulce;2047;1014;1033;2017
41;Sevilla;002;Alanís;1781;895;886;2017
41;Sevilla;003;Albaida del Aljarafe;3137;1574;1563;2017
41;Sevilla;004;Alcalá de Guadaíra;75106;37345;37761;2017
41;Sevilla;005;Alcalá del Río;11950;6068;5882;2017
41;Sevilla;006;Alcolea del Río;3413;1711;1702;2017
41;Sevilla;007;Algaba, La;16275;8074;8201;2017
41;Sevilla;008;Algámitas;1284;664;620;2017
41;Sevilla;009;Almadén de la Plata;1424;737;687;2017
41;Sevilla;010;Almensilla;5929;2966;2963;2017
41;Sevilla;011;Arahal;19532;9664;9868;2017
41;Sevilla;012;Aznalcázar;4493;2258;2235;2017
41;Sevilla;013;Aznalcóllar;6116;3131;2985;2017
41;Sevilla;014;Badolatosa;3121;1604;1517;2017
41;Sevilla;015;Benacazón;7167;3599;3568;2017
41;Sevilla;016;Bollullos de la Mitación;10512;5278;5234;2017
41;Sevilla;017;Bormujos;21667;10737;10930;2017
41;Sevilla;018;Brenes;12638;6321;6317;2017
41;Sevilla;019;Burguillos;6523;3281;3242;2017
41;Sevilla;020;Cabezas de San Juan, Las;16418;8253;8165;2017
41;Sevilla;021;Camas;27293;13326;13967;2017
41;Sevilla;022;Campana, La;5349;2679;2670;2017
41;Sevilla;023;Cantillana;10612;5413;5199;2017
41;Sevilla;901;Cañada Rosal;3307;1635;1672;2017
41;Sevilla;024;Carmona;28540;14360;14180;2017
41;Sevilla;025;Carrión de los Céspedes;2524;1220;1304;2017
41;Sevilla;026;Casariche;5566;2844;2722;2017
41;Sevilla;027;Castilblanco de los Arroyos;4831;2440;2391;2017
41;Sevilla;028;Castilleja de Guzmán;2835;1460;1375;2017
41;Sevilla;029;Castilleja de la Cuesta;17429;8472;8957;2017
41;Sevilla;030;Castilleja del Campo;628;319;309;2017
41;Sevilla;031;Castillo de las Guardas, El;1464;747;717;2017
41;Sevilla;032;Cazalla de la Sierra;4849;2392;2457;2017
41;Sevilla;033;Constantina;6040;3014;3026;2017
41;Sevilla;034;Coria del Río;30535;15243;15292;2017
41;Sevilla;035;Coripe;1298;646;652;2017
41;Sevilla;036;Coronil, El;4830;2420;2410;2017
41;Sevilla;037;Corrales, Los;3997;2033;1964;2017
41;Sevilla;903;Cuervo de Sevilla, El;8698;4391;4307;2017
41;Sevilla;038;Dos Hermanas;132551;65319;67232;2017
41;Sevilla;039;Écija;40087;19740;20347;2017
41;Sevilla;040;Espartinas;15423;7710;7713;2017
41;Sevilla;041;Estepa;12526;6243;6283;2017
41;Sevilla;042;Fuentes de Andalucía;7149;3550;3599;2017
41;Sevilla;043;Garrobo, El;775;390;385;2017
41;Sevilla;044;Gelves;10051;5017;5034;2017
41;Sevilla;045;Gerena;7489;3758;3731;2017
41;Sevilla;046;Gilena;3826;1935;1891;2017
41;Sevilla;047;Gines;13361;6558;6803;2017
41;Sevilla;048;Guadalcanal;2659;1322;1337;2017
41;Sevilla;049;Guillena;12647;6409;6238;2017
41;Sevilla;050;Herrera;6463;3195;3268;2017
41;Sevilla;051;Huévar del Aljarafe;2883;1474;1409;2017
41;Sevilla;902;Isla Mayor;5889;2944;2945;2017
41;Sevilla;052;Lantejuela;3836;1969;1867;2017
41;Sevilla;053;Lebrija;27410;13672;13738;2017
41;Sevilla;054;Lora de Estepa;852;434;418;2017
41;Sevilla;055;Lora del Río;18934;9390;9544;2017
41;Sevilla;056;Luisiana, La;4569;2302;2267;2017
41;Sevilla;057;Madroño, El;284;138;146;2017
41;Sevilla;058;Mairena del Alcor;23222;11621;11601;2017
41;Sevilla;059;Mairena del Aljarafe;45471;22237;23234;2017
41;Sevilla;060;Marchena;19691;9846;9845;2017
41;Sevilla;061;Marinaleda;2665;1366;1299;2017
41;Sevilla;062;Martín de la Jara;2740;1416;1324;2017
41;Sevilla;063;Molares, Los;3455;1757;1698;2017
41;Sevilla;064;Montellano;7073;3545;3528;2017
41;Sevilla;065;Morón de la Frontera;27930;13813;14117;2017
41;Sevilla;066;Navas de la Concepción, Las;1601;792;809;2017
41;Sevilla;067;Olivares;9422;4734;4688;2017
41;Sevilla;068;Osuna;17735;8824;8911;2017
41;Sevilla;069;Palacios y Villafranca, Los;38246;19266;18980;2017
41;Sevilla;070;Palomares del Río;8418;4234;4184;2017
41;Sevilla;071;Paradas;6923;3458;3465;2017
41;Sevilla;072;Pedrera;5308;2609;2699;2017
41;Sevilla;073;Pedroso, El;2055;1010;1045;2017
41;Sevilla;074;Peñaflor;3680;1847;1833;2017
41;Sevilla;075;Pilas;13988;7052;6936;2017
41;Sevilla;076;Pruna;2671;1364;1307;2017
41;Sevilla;077;Puebla de Cazalla, La;11081;5527;5554;2017
41;Sevilla;078;Puebla de los Infantes, La;3051;1508;1543;2017
41;Sevilla;079;Puebla del Río, La;11914;5900;6014;2017
41;Sevilla;080;Real de la Jara, El;1530;754;776;2017
41;Sevilla;081;Rinconada, La;38339;19025;19314;2017
41;Sevilla;082;Roda de Andalucía, La;4277;2117;2160;2017
41;Sevilla;083;Ronquillo, El;1354;685;669;2017
41;Sevilla;084;Rubio, El;3457;1689;1768;2017
41;Sevilla;085;Salteras;5499;2660;2839;2017
41;Sevilla;086;San Juan de Aznalfarache;21458;10359;11099;2017
41;Sevilla;088;San Nicolás del Puerto;593;304;289;2017
41;Sevilla;087;Sanlúcar la Mayor;13583;6718;6865;2017
41;Sevilla;089;Santiponce;8445;4178;4267;2017
41;Sevilla;090;Saucejo, El;4310;2134;2176;2017
41;Sevilla;091;Sevilla;689434;327162;362272;2017
41;Sevilla;092;Tocina;9656;4786;4870;2017
41;Sevilla;093;Tomares;25042;12375;12667;2017
41;Sevilla;094;Umbrete;8695;4363;4332;2017
41;Sevilla;095;Utrera;52701;26225;26476;2017
41;Sevilla;096;Valencina de la Concepción;7860;3871;3989;2017
41;Sevilla;097;Villamanrique de la Condesa;4454;2185;2269;2017
41;Sevilla;100;Villanueva de San Juan;1181;570;611;2017
41;Sevilla;098;Villanueva del Ariscal;6573;3194;3379;2017
41;Sevilla;099;Villanueva del Río y Minas;4866;2429;2437;2017
41;Sevilla;101;Villaverde del Río;7824;3981;3843;2017
41;Sevilla;102;Viso del Alcor, El;19234;9630;9604;2017
42;Soria;001;Abejar;318;174;144;2017
42;Soria;003;Adradas;48;28;20;2017
42;Soria;004;Ágreda;2993;1526;1467;2017
42;Soria;006;Alconaba;191;123;68;2017
42;Soria;007;Alcubilla de Avellaneda;112;60;52;2017
42;Soria;008;Alcubilla de las Peñas;62;38;24;2017
42;Soria;009;Aldealafuente;89;47;42;2017
42;Soria;010;Aldealices;30;19;11;2017
42;Soria;011;Aldealpozo;18;8;10;2017
42;Soria;012;Aldealseñor;31;17;14;2017
42;Soria;013;Aldehuela de Periáñez;37;21;16;2017
42;Soria;014;Aldehuelas, Las;65;36;29;2017
42;Soria;015;Alentisque;33;19;14;2017
42;Soria;016;Aliud;17;13;4;2017
42;Soria;017;Almajano;179;95;84;2017
42;Soria;018;Almaluez;148;86;62;2017
42;Soria;019;Almarza;604;346;258;2017
42;Soria;020;Almazán;5526;2795;2731;2017
42;Soria;021;Almazul;70;41;29;2017
42;Soria;022;Almenar de Soria;234;137;97;2017
42;Soria;023;Alpanseque;60;34;26;2017
42;Soria;024;Arancón;90;58;32;2017
42;Soria;025;Arcos de Jalón;1486;794;692;2017
42;Soria;026;Arenillas;26;12;14;2017
42;Soria;027;Arévalo de la Sierra;76;48;28;2017
42;Soria;028;Ausejo de la Sierra;83;43;40;2017
42;Soria;029;Baraona;143;86;57;2017
42;Soria;030;Barca;103;64;39;2017
42;Soria;031;Barcones;22;15;7;2017
42;Soria;032;Bayubas de Abajo;146;80;66;2017
42;Soria;033;Bayubas de Arriba;48;30;18;2017
42;Soria;034;Beratón;28;19;9;2017
42;Soria;035;Berlanga de Duero;902;455;447;2017
42;Soria;036;Blacos;45;24;21;2017
42;Soria;037;Bliecos;36;20;16;2017
42;Soria;038;Borjabad;35;21;14;2017
42;Soria;039;Borobia;242;129;113;2017
42;Soria;041;Buberos;33;18;15;2017
42;Soria;042;Buitrago;59;32;27;2017
42;Soria;043;Burgo de Osma-Ciudad de Osma;4984;2472;2512;2017
42;Soria;044;Cabrejas del Campo;56;35;21;2017
42;Soria;045;Cabrejas del Pinar;356;205;151;2017
42;Soria;046;Calatañazor;51;28;23;2017
42;Soria;048;Caltojar;59;38;21;2017
42;Soria;049;Candilichera;124;72;52;2017
42;Soria;050;Cañamaque;33;24;9;2017
42;Soria;051;Carabantes;19;9;10;2017
42;Soria;052;Caracena;13;9;4;2017
42;Soria;053;Carrascosa de Abajo;23;15;8;2017
42;Soria;054;Carrascosa de la Sierra;18;12;6;2017
42;Soria;055;Casarejos;171;91;80;2017
42;Soria;056;Castilfrío de la Sierra;29;18;11;2017
42;Soria;058;Castillejo de Robledo;117;67;50;2017
42;Soria;057;Castilruiz;181;96;85;2017
42;Soria;059;Centenera de Andaluz;22;10;12;2017
42;Soria;060;Cerbón;34;21;13;2017
42;Soria;061;Cidones;320;192;128;2017
42;Soria;062;Cigudosa;20;13;7;2017
42;Soria;063;Cihuela;49;26;23;2017
42;Soria;064;Ciria;90;46;44;2017
42;Soria;065;Cirujales del Río;22;16;6;2017
42;Soria;068;Coscurita;81;49;32;2017
42;Soria;069;Covaleda;1749;907;842;2017
42;Soria;070;Cubilla;34;20;14;2017
42;Soria;071;Cubo de la Solana;182;99;83;2017
42;Soria;073;Cueva de Ágreda;70;44;26;2017
42;Soria;075;Dévanos;85;46;39;2017
42;Soria;076;Deza;230;117;113;2017
42;Soria;078;Duruelo de la Sierra;1122;573;549;2017
42;Soria;079;Escobosa de Almazán;23;16;7;2017
42;Soria;080;Espeja de San Marcelino;170;99;71;2017
42;Soria;081;Espejón;175;89;86;2017
42;Soria;082;Estepa de San Juan;7;6;1;2017
42;Soria;083;Frechilla de Almazán;25;14;11;2017
42;Soria;084;Fresno de Caracena;20;13;7;2017
42;Soria;085;Fuentearmegil;187;107;80;2017
42;Soria;086;Fuentecambrón;37;22;15;2017
42;Soria;087;Fuentecantos;55;27;28;2017
42;Soria;088;Fuentelmonge;69;40;29;2017
42;Soria;089;Fuentelsaz de Soria;62;30;32;2017
42;Soria;090;Fuentepinilla;91;58;33;2017
42;Soria;092;Fuentes de Magaña;64;36;28;2017
42;Soria;093;Fuentestrún;40;27;13;2017
42;Soria;094;Garray;745;404;341;2017
42;Soria;095;Golmayo;2561;1353;1208;2017
42;Soria;096;Gómara;310;170;140;2017
42;Soria;097;Gormaz;27;19;8;2017
42;Soria;098;Herrera de Soria;9;7;2;2017
42;Soria;100;Hinojosa del Campo;33;22;11;2017
42;Soria;103;Langa de Duero;746;409;337;2017
42;Soria;105;Liceras;53;27;26;2017
42;Soria;106;Losilla, La;13;9;4;2017
42;Soria;107;Magaña;80;47;33;2017
42;Soria;108;Maján;13;7;6;2017
42;Soria;110;Matalebreras;53;30;23;2017
42;Soria;111;Matamala de Almazán;322;168;154;2017
42;Soria;113;Medinaceli;744;365;379;2017
42;Soria;115;Miño de Medinaceli;78;47;31;2017
42;Soria;116;Miño de San Esteban;47;31;16;2017
42;Soria;117;Molinos de Duero;167;88;79;2017
42;Soria;118;Momblona;23;16;7;2017
42;Soria;119;Monteagudo de las Vicarías;206;107;99;2017
42;Soria;120;Montejo de Tiermes;161;106;55;2017
42;Soria;121;Montenegro de Cameros;61;39;22;2017
42;Soria;123;Morón de Almazán;203;107;96;2017
42;Soria;124;Muriel de la Fuente;64;37;27;2017
42;Soria;125;Muriel Viejo;88;54;34;2017
42;Soria;127;Nafría de Ucero;33;20;13;2017
42;Soria;128;Narros;45;26;19;2017
42;Soria;129;Navaleno;789;423;366;2017
42;Soria;130;Nepas;57;38;19;2017
42;Soria;131;Nolay;57;31;26;2017
42;Soria;132;Noviercas;158;81;77;2017
42;Soria;134;Ólvega;3621;1879;1742;2017
42;Soria;135;Oncala;74;43;31;2017
42;Soria;139;Pinilla del Campo;24;14;10;2017
42;Soria;140;Portillo de Soria;16;11;5;2017
42;Soria;141;Póveda de Soria, La;114;70;44;2017
42;Soria;142;Pozalmuro;63;28;35;2017
42;Soria;144;Quintana Redonda;493;279;214;2017
42;Soria;145;Quintanas de Gormaz;147;89;58;2017
42;Soria;148;Quiñonería;9;5;4;2017
42;Soria;149;Rábanos, Los;479;272;207;2017
42;Soria;151;Rebollar;39;18;21;2017
42;Soria;152;Recuerda;88;50;38;2017
42;Soria;153;Rello;15;10;5;2017
42;Soria;154;Renieblas;106;64;42;2017
42;Soria;155;Retortillo de Soria;169;102;67;2017
42;Soria;156;Reznos;30;20;10;2017
42;Soria;157;Riba de Escalote, La;11;8;3;2017
42;Soria;158;Rioseco de Soria;123;74;49;2017
42;Soria;159;Rollamienta;36;24;12;2017
42;Soria;160;Royo, El;262;141;121;2017
42;Soria;161;Salduero;141;79;62;2017
42;Soria;162;San Esteban de Gormaz;3021;1596;1425;2017
42;Soria;163;San Felices;58;35;23;2017
42;Soria;164;San Leonardo de Yagüe;2083;1064;1019;2017
42;Soria;165;San Pedro Manrique;602;336;266;2017
42;Soria;166;Santa Cruz de Yanguas;63;41;22;2017
42;Soria;167;Santa María de Huerta;285;157;128;2017
42;Soria;168;Santa María de las Hoyas;106;59;47;2017
42;Soria;171;Serón de Nágima;121;67;54;2017
42;Soria;172;Soliedra;34;19;15;2017
42;Soria;173;Soria;38881;18332;20549;2017
42;Soria;174;Sotillo del Rincón;186;101;85;2017
42;Soria;175;Suellacabras;27;16;11;2017
42;Soria;176;Tajahuerce;29;16;13;2017
42;Soria;177;Tajueco;71;40;31;2017
42;Soria;178;Talveila;123;70;53;2017
42;Soria;181;Tardelcuende;435;229;206;2017
42;Soria;182;Taroda;47;25;22;2017
42;Soria;183;Tejado;116;66;50;2017
42;Soria;184;Torlengua;59;31;28;2017
42;Soria;185;Torreblacos;26;14;12;2017
42;Soria;187;Torrubia de Soria;68;48;20;2017
42;Soria;188;Trévago;48;22;26;2017
42;Soria;189;Ucero;53;28;25;2017
42;Soria;190;Vadillo;97;54;43;2017
42;Soria;191;Valdeavellano de Tera;192;106;86;2017
42;Soria;192;Valdegeña;42;30;12;2017
42;Soria;193;Valdelagua del Cerro;19;12;7;2017
42;Soria;194;Valdemaluque;164;74;90;2017
42;Soria;195;Valdenebro;114;66;48;2017
42;Soria;196;Valdeprado;9;6;3;2017
42;Soria;197;Valderrodilla;75;43;32;2017
42;Soria;198;Valtajeros;25;14;11;2017
42;Soria;200;Velamazán;87;55;32;2017
42;Soria;201;Velilla de la Sierra;23;14;9;2017
42;Soria;202;Velilla de los Ajos;21;12;9;2017
42;Soria;204;Viana de Duero;53;39;14;2017
42;Soria;205;Villaciervos;90;57;33;2017
42;Soria;206;Villanueva de Gormaz;7;5;2;2017
42;Soria;207;Villar del Ala;53;28;25;2017
42;Soria;208;Villar del Campo;22;14;8;2017
42;Soria;209;Villar del Río;143;88;55;2017
42;Soria;211;Villares de Soria, Los;86;51;35;2017
42;Soria;212;Villasayas;71;46;25;2017
42;Soria;213;Villaseca de Arciel;35;19;16;2017
42;Soria;215;Vinuesa;888;479;409;2017
42;Soria;216;Vizmanos;29;20;9;2017
42;Soria;217;Vozmediano;37;24;13;2017
42;Soria;218;Yanguas;93;60;33;2017
42;Soria;219;Yelo;43;25;18;2017
43;Tarragona;001;Aiguamúrcia;893;460;433;2017
43;Tarragona;002;Albinyana;2340;1185;1155;2017
43;Tarragona;003;Albiol, L';479;247;232;2017
43;Tarragona;004;Alcanar;9393;4738;4655;2017
43;Tarragona;005;Alcover;5163;2571;2592;2017
43;Tarragona;904;Aldea, L';4211;2215;1996;2017
43;Tarragona;006;Aldover;842;420;422;2017
43;Tarragona;007;Aleixar, L';866;445;421;2017
43;Tarragona;008;Alfara de Carles;369;199;170;2017
43;Tarragona;009;Alforja;1799;923;876;2017
43;Tarragona;010;Alió;408;195;213;2017
43;Tarragona;011;Almoster;1361;682;679;2017
43;Tarragona;012;Altafulla;5089;2485;2604;2017
43;Tarragona;013;Ametlla de Mar, L';6887;3473;3414;2017
43;Tarragona;906;Ampolla, L';3334;1699;1635;2017
43;Tarragona;014;Amposta;20572;10331;10241;2017
43;Tarragona;016;Arboç, L';5489;2822;2667;2017
43;Tarragona;015;Arbolí;123;70;53;2017
43;Tarragona;017;Argentera, L';135;76;59;2017
43;Tarragona;018;Arnes;459;234;225;2017
43;Tarragona;019;Ascó;1690;868;822;2017
43;Tarragona;020;Banyeres del Penedès;3121;1572;1549;2017
43;Tarragona;021;Barberà de la Conca;477;254;223;2017
43;Tarragona;022;Batea;1938;965;973;2017
43;Tarragona;023;Bellmunt del Priorat;290;146;144;2017
43;Tarragona;024;Bellvei;2193;1125;1068;2017
43;Tarragona;025;Benifallet;721;345;376;2017
43;Tarragona;026;Benissanet;1172;631;541;2017
43;Tarragona;027;Bisbal de Falset, La;217;117;100;2017
43;Tarragona;028;Bisbal del Penedès, La;3460;1846;1614;2017
43;Tarragona;029;Blancafort;381;199;182;2017
43;Tarragona;030;Bonastre;661;333;328;2017
43;Tarragona;031;Borges del Camp, Les;2080;1057;1023;2017
43;Tarragona;032;Bot;609;306;303;2017
43;Tarragona;033;Botarell;1078;566;512;2017
43;Tarragona;034;Bràfim;672;335;337;2017
43;Tarragona;035;Cabacés;309;159;150;2017
43;Tarragona;036;Cabra del Camp;1131;592;539;2017
43;Tarragona;037;Calafell;24898;12541;12357;2017
43;Tarragona;903;Camarles;3270;1661;1609;2017
43;Tarragona;038;Cambrils;32855;16099;16756;2017
43;Tarragona;907;Canonja, La;5804;2849;2955;2017
43;Tarragona;039;Capafonts;102;54;48;2017
43;Tarragona;040;Capçanes;403;201;202;2017
43;Tarragona;041;Caseres;234;118;116;2017
43;Tarragona;042;Castellvell del Camp;2849;1425;1424;2017
43;Tarragona;043;Catllar, El;4251;2195;2056;2017
43;Tarragona;045;Colldejou;170;91;79;2017
43;Tarragona;046;Conesa;111;57;54;2017
43;Tarragona;047;Constantí;6493;3368;3125;2017
43;Tarragona;048;Corbera d'Ebre;1061;566;495;2017
43;Tarragona;049;Cornudella de Montsant;953;503;450;2017
43;Tarragona;050;Creixell;3465;1761;1704;2017
43;Tarragona;051;Cunit;12041;5902;6139;2017
43;Tarragona;901;Deltebre;11499;5793;5706;2017
43;Tarragona;053;Duesaigües;243;140;103;2017
43;Tarragona;054;Espluga de Francolí, L';3756;1807;1949;2017
43;Tarragona;055;Falset;2820;1409;1411;2017
43;Tarragona;056;Fatarella, La;980;482;498;2017
43;Tarragona;057;Febró, La;42;27;15;2017
43;Tarragona;058;Figuera, La;102;59;43;2017
43;Tarragona;059;Figuerola del Camp;330;160;170;2017
43;Tarragona;060;Flix;3605;1807;1798;2017
43;Tarragona;061;Forès;45;27;18;2017
43;Tarragona;062;Freginals;397;208;189;2017
43;Tarragona;063;Galera, La;719;370;349;2017
43;Tarragona;064;Gandesa;3011;1540;1471;2017
43;Tarragona;065;Garcia;531;269;262;2017
43;Tarragona;066;Garidells, Els;194;95;99;2017
43;Tarragona;067;Ginestar;777;406;371;2017
43;Tarragona;068;Godall;608;307;301;2017
43;Tarragona;069;Gratallops;237;128;109;2017
43;Tarragona;070;Guiamets, Els;272;126;146;2017
43;Tarragona;071;Horta de Sant Joan;1171;610;561;2017
43;Tarragona;072;Lloar, El;117;60;57;2017
43;Tarragona;073;Llorac;93;52;41;2017
43;Tarragona;074;Llorenç del Penedès;2302;1142;1160;2017
43;Tarragona;076;Marçà;602;322;280;2017
43;Tarragona;075;Margalef;101;60;41;2017
43;Tarragona;077;Mas de Barberans;584;288;296;2017
43;Tarragona;078;Masdenverge;1067;551;516;2017
43;Tarragona;079;Masllorenç;496;268;228;2017
43;Tarragona;080;Masó, La;281;153;128;2017
43;Tarragona;081;Maspujols;791;403;388;2017
43;Tarragona;082;Masroig, El;510;283;227;2017
43;Tarragona;083;Milà, El;182;92;90;2017
43;Tarragona;084;Miravet;726;389;337;2017
43;Tarragona;085;Molar, El;286;151;135;2017
43;Tarragona;086;Montblanc;7307;3682;3625;2017
43;Tarragona;088;Montbrió del Camp;2806;1453;1353;2017
43;Tarragona;089;Montferri;388;209;179;2017
43;Tarragona;090;Montmell, El;1405;747;658;2017
43;Tarragona;091;Mont-ral;164;97;67;2017
43;Tarragona;092;Mont-roig del Camp;11597;6035;5562;2017
43;Tarragona;093;Móra d'Ebre;5625;2801;2824;2017
43;Tarragona;094;Móra la Nova;3070;1542;1528;2017
43;Tarragona;095;Morell, El;3631;1850;1781;2017
43;Tarragona;096;Morera de Montsant, La;158;90;68;2017
43;Tarragona;097;Nou de Gaià, La;563;275;288;2017
43;Tarragona;098;Nulles;464;249;215;2017
43;Tarragona;100;Pallaresos, Els;4635;2348;2287;2017
43;Tarragona;099;Palma d'Ebre, La;356;171;185;2017
43;Tarragona;101;Passanant i Belltall;149;85;64;2017
43;Tarragona;102;Paüls;567;276;291;2017
43;Tarragona;103;Perafort;1253;654;599;2017
43;Tarragona;104;Perelló, El;2884;1492;1392;2017
43;Tarragona;105;Piles, Les;216;116;100;2017
43;Tarragona;106;Pinell de Brai, El;1012;509;503;2017
43;Tarragona;107;Pira;500;269;231;2017
43;Tarragona;108;Pla de Santa Maria, El;2266;1166;1100;2017
43;Tarragona;109;Pobla de Mafumet, La;3854;1983;1871;2017
43;Tarragona;110;Pobla de Massaluca, La;335;184;151;2017
43;Tarragona;111;Pobla de Montornès, La;2795;1468;1327;2017
43;Tarragona;112;Poboleda;356;198;158;2017
43;Tarragona;113;Pont d'Armentera, El;501;252;249;2017
43;Tarragona;141;Pontils;118;65;53;2017
43;Tarragona;114;Porrera;441;236;205;2017
43;Tarragona;115;Pradell de la Teixeta;163;76;87;2017
43;Tarragona;116;Prades;599;317;282;2017
43;Tarragona;117;Prat de Comte;181;98;83;2017
43;Tarragona;118;Pratdip;718;374;344;2017
43;Tarragona;119;Puigpelat;1147;588;559;2017
43;Tarragona;120;Querol;532;298;234;2017
43;Tarragona;121;Rasquera;796;396;400;2017
43;Tarragona;122;Renau;153;78;75;2017
43;Tarragona;123;Reus;103123;49805;53318;2017
43;Tarragona;124;Riba, La;590;322;268;2017
43;Tarragona;125;Riba-roja d'Ebre;1116;589;527;2017
43;Tarragona;126;Riera de Gaià, La;1704;851;853;2017
43;Tarragona;127;Riudecanyes;1101;576;525;2017
43;Tarragona;128;Riudecols;1165;611;554;2017
43;Tarragona;129;Riudoms;6515;3357;3158;2017
43;Tarragona;130;Rocafort de Queralt;241;124;117;2017
43;Tarragona;131;Roda de Berà;6354;3273;3081;2017
43;Tarragona;132;Rodonyà;498;262;236;2017
43;Tarragona;133;Roquetes;8084;4194;3890;2017
43;Tarragona;134;Rourell, El;369;184;185;2017
43;Tarragona;135;Salomó;545;284;261;2017
43;Tarragona;905;Salou;26233;13618;12615;2017
43;Tarragona;136;Sant Carles de la Ràpita;14902;7295;7607;2017
43;Tarragona;137;Sant Jaume dels Domenys;2561;1319;1242;2017
43;Tarragona;902;Sant Jaume d'Enveja;3479;1748;1731;2017
43;Tarragona;138;Santa Bàrbara;3797;1933;1864;2017
43;Tarragona;139;Santa Coloma de Queralt;2695;1334;1361;2017
43;Tarragona;140;Santa Oliva;3315;1679;1636;2017
43;Tarragona;142;Sarral;1560;789;771;2017
43;Tarragona;143;Savallà del Comtat;56;28;28;2017
43;Tarragona;144;Secuita, La;1676;841;835;2017
43;Tarragona;145;Selva del Camp, La;5546;2786;2760;2017
43;Tarragona;146;Senan;49;33;16;2017
43;Tarragona;044;Sénia, La;5652;2837;2815;2017
43;Tarragona;147;Solivella;614;312;302;2017
43;Tarragona;148;Tarragona;131507;63941;67566;2017
43;Tarragona;149;Tivenys;879;448;431;2017
43;Tarragona;150;Tivissa;1677;841;836;2017
43;Tarragona;151;Torre de Fontaubella, La;137;72;65;2017
43;Tarragona;152;Torre de l'Espanyol, La;634;327;307;2017
43;Tarragona;153;Torredembarra;15726;7667;8059;2017
43;Tarragona;154;Torroja del Priorat;149;82;67;2017
43;Tarragona;155;Tortosa;33445;16613;16832;2017
43;Tarragona;156;Ulldecona;6321;3252;3069;2017
43;Tarragona;157;Ulldemolins;395;226;169;2017
43;Tarragona;158;Vallclara;103;62;41;2017
43;Tarragona;159;Vallfogona de Riucorb;87;51;36;2017
43;Tarragona;160;Vallmoll;1702;864;838;2017
43;Tarragona;161;Valls;24112;11978;12134;2017
43;Tarragona;162;Vandellòs i l'Hospitalet de l'Infant;6294;3155;3139;2017
43;Tarragona;163;Vendrell, El;36568;18145;18423;2017
43;Tarragona;164;Vespella de Gaià;424;234;190;2017
43;Tarragona;165;Vilabella;749;388;361;2017
43;Tarragona;175;Vilalba dels Arcs;643;323;320;2017
43;Tarragona;166;Vilallonga del Camp;2340;1200;1140;2017
43;Tarragona;168;Vilanova de Prades;121;63;58;2017
43;Tarragona;167;Vilanova d'Escornalbou;521;275;246;2017
43;Tarragona;169;Vilaplana;585;299;286;2017
43;Tarragona;170;Vila-rodona;1259;653;606;2017
43;Tarragona;171;Vila-seca;21993;11062;10931;2017
43;Tarragona;172;Vilaverd;440;228;212;2017
43;Tarragona;173;Vilella Alta, La;127;69;58;2017
43;Tarragona;174;Vilella Baixa, La;200;111;89;2017
43;Tarragona;176;Vimbodí i Poblet;917;509;408;2017
43;Tarragona;177;Vinebre;428;214;214;2017
43;Tarragona;178;Vinyols i els Arcs;1928;1003;925;2017
43;Tarragona;052;Xerta;1188;578;610;2017
44;Teruel;001;Ababuj;73;45;28;2017
44;Teruel;002;Abejuela;50;31;19;2017
44;Teruel;003;Aguatón;19;7;12;2017
44;Teruel;004;Aguaviva;531;262;269;2017
44;Teruel;005;Aguilar del Alfambra;65;38;27;2017
44;Teruel;006;Alacón;274;139;135;2017
44;Teruel;007;Alba;185;103;82;2017
44;Teruel;008;Albalate del Arzobispo;1978;1008;970;2017
44;Teruel;009;Albarracín;1044;541;503;2017
44;Teruel;010;Albentosa;255;134;121;2017
44;Teruel;011;Alcaine;62;38;24;2017
44;Teruel;012;Alcalá de la Selva;369;202;167;2017
44;Teruel;013;Alcañiz;15937;7910;8027;2017
44;Teruel;014;Alcorisa;3313;1681;1632;2017
44;Teruel;016;Alfambra;554;289;265;2017
44;Teruel;017;Aliaga;348;191;157;2017
44;Teruel;021;Allepuz;129;65;64;2017
44;Teruel;022;Alloza;594;305;289;2017
44;Teruel;023;Allueva;31;17;14;2017
44;Teruel;018;Almohaja;18;13;5;2017
44;Teruel;019;Alobras;65;38;27;2017
44;Teruel;020;Alpeñés;23;14;9;2017
44;Teruel;024;Anadón;27;17;10;2017
44;Teruel;025;Andorra;7799;3935;3864;2017
44;Teruel;026;Arcos de las Salinas;106;59;47;2017
44;Teruel;027;Arens de Lledó;199;96;103;2017
44;Teruel;028;Argente;207;99;108;2017
44;Teruel;029;Ariño;733;367;366;2017
44;Teruel;031;Azaila;97;47;50;2017
44;Teruel;032;Bádenas;18;10;8;2017
44;Teruel;033;Báguena;318;175;143;2017
44;Teruel;034;Bañón;149;81;68;2017
44;Teruel;035;Barrachina;121;65;56;2017
44;Teruel;036;Bea;30;18;12;2017
44;Teruel;037;Beceite;551;281;270;2017
44;Teruel;039;Bello;244;113;131;2017
44;Teruel;038;Belmonte de San José;113;55;58;2017
44;Teruel;040;Berge;245;125;120;2017
44;Teruel;041;Bezas;62;39;23;2017
44;Teruel;042;Blancas;134;77;57;2017
44;Teruel;043;Blesa;97;64;33;2017
44;Teruel;044;Bordón;108;62;46;2017
44;Teruel;045;Bronchales;440;250;190;2017
44;Teruel;046;Bueña;57;31;26;2017
44;Teruel;047;Burbáguena;254;135;119;2017
44;Teruel;048;Cabra de Mora;64;37;27;2017
44;Teruel;049;Calaceite;1038;517;521;2017
44;Teruel;050;Calamocha;4353;2152;2201;2017
44;Teruel;051;Calanda;3729;1852;1877;2017
44;Teruel;052;Calomarde;78;47;31;2017
44;Teruel;053;Camañas;129;71;58;2017
44;Teruel;054;Camarena de la Sierra;116;71;45;2017
44;Teruel;055;Camarillas;89;53;36;2017
44;Teruel;056;Caminreal;616;316;300;2017
44;Teruel;059;Cantavieja;717;380;337;2017
44;Teruel;060;Cañada de Benatanduz;42;28;14;2017
44;Teruel;061;Cañada de Verich, La;85;53;32;2017
44;Teruel;062;Cañada Vellida;35;25;10;2017
44;Teruel;063;Cañizar del Olivar;93;50;43;2017
44;Teruel;064;Cascante del Río;73;44;29;2017
44;Teruel;065;Castejón de Tornos;62;37;25;2017
44;Teruel;066;Castel de Cabra;112;60;52;2017
44;Teruel;070;Castellar, El;54;36;18;2017
44;Teruel;071;Castellote;688;352;336;2017
44;Teruel;067;Castelnou;146;74;72;2017
44;Teruel;068;Castelserás;823;428;395;2017
44;Teruel;074;Cedrillas;611;311;300;2017
44;Teruel;075;Celadas;408;231;177;2017
44;Teruel;076;Cella;2640;1378;1262;2017
44;Teruel;077;Cerollera, La;98;59;39;2017
44;Teruel;080;Codoñera, La;362;193;169;2017
44;Teruel;082;Corbalán;109;59;50;2017
44;Teruel;084;Cortes de Aragón;57;23;34;2017
44;Teruel;085;Cosa;55;31;24;2017
44;Teruel;086;Cretas;572;294;278;2017
44;Teruel;087;Crivillén;71;36;35;2017
44;Teruel;088;Cuba, La;36;20;16;2017
44;Teruel;089;Cubla;55;38;17;2017
44;Teruel;090;Cucalón;91;54;37;2017
44;Teruel;092;Cuervo, El;93;49;44;2017
44;Teruel;093;Cuevas de Almudén;138;77;61;2017
44;Teruel;094;Cuevas Labradas;126;70;56;2017
44;Teruel;096;Ejulve;187;97;90;2017
44;Teruel;097;Escorihuela;147;74;73;2017
44;Teruel;099;Escucha;913;495;418;2017
44;Teruel;100;Estercuel;223;127;96;2017
44;Teruel;101;Ferreruela de Huerva;65;36;29;2017
44;Teruel;102;Fonfría;30;17;13;2017
44;Teruel;103;Formiche Alto;155;85;70;2017
44;Teruel;105;Fórnoles;78;42;36;2017
44;Teruel;106;Fortanete;203;114;89;2017
44;Teruel;107;Foz-Calanda;260;136;124;2017
44;Teruel;108;Fresneda, La;436;244;192;2017
44;Teruel;109;Frías de Albarracín;125;70;55;2017
44;Teruel;110;Fuenferrada;51;30;21;2017
44;Teruel;111;Fuentes Calientes;111;61;50;2017
44;Teruel;112;Fuentes Claras;482;264;218;2017
44;Teruel;113;Fuentes de Rubielos;112;59;53;2017
44;Teruel;114;Fuentespalda;298;150;148;2017
44;Teruel;115;Galve;162;82;80;2017
44;Teruel;116;Gargallo;101;51;50;2017
44;Teruel;117;Gea de Albarracín;372;198;174;2017
44;Teruel;118;Ginebrosa, La;197;106;91;2017
44;Teruel;119;Griegos;151;91;60;2017
44;Teruel;120;Guadalaviar;241;138;103;2017
44;Teruel;121;Gúdar;81;44;37;2017
44;Teruel;122;Híjar;1697;856;841;2017
44;Teruel;123;Hinojosa de Jarque;132;76;56;2017
44;Teruel;124;Hoz de la Vieja, La;86;45;41;2017
44;Teruel;125;Huesa del Común;67;42;25;2017
44;Teruel;126;Iglesuela del Cid, La;414;215;199;2017
44;Teruel;127;Jabaloyas;68;38;30;2017
44;Teruel;128;Jarque de la Val;72;38;34;2017
44;Teruel;129;Jatiel;41;23;18;2017
44;Teruel;130;Jorcas;32;19;13;2017
44;Teruel;131;Josa;32;19;13;2017
44;Teruel;132;Lagueruela;84;45;39;2017
44;Teruel;133;Lanzuela;27;20;7;2017
44;Teruel;135;Libros;103;65;38;2017
44;Teruel;136;Lidón;53;27;26;2017
44;Teruel;137;Linares de Mora;260;152;108;2017
44;Teruel;141;Lledó;166;90;76;2017
44;Teruel;138;Loscos;139;83;56;2017
44;Teruel;142;Maicas;31;17;14;2017
44;Teruel;143;Manzanera;512;271;241;2017
44;Teruel;144;Martín del Río;432;214;218;2017
44;Teruel;145;Mas de las Matas;1270;665;605;2017
44;Teruel;146;Mata de los Olmos, La;272;136;136;2017
44;Teruel;147;Mazaleón;543;292;251;2017
44;Teruel;148;Mezquita de Jarque;102;60;42;2017
44;Teruel;149;Mirambel;119;68;51;2017
44;Teruel;150;Miravete de la Sierra;31;21;10;2017
44;Teruel;151;Molinos;245;129;116;2017
44;Teruel;152;Monforte de Moyuela;64;46;18;2017
44;Teruel;153;Monreal del Campo;2478;1231;1247;2017
44;Teruel;154;Monroyo;335;201;134;2017
44;Teruel;155;Montalbán;1256;632;624;2017
44;Teruel;156;Monteagudo del Castillo;51;27;24;2017
44;Teruel;157;Monterde de Albarracín;62;35;27;2017
44;Teruel;158;Mora de Rubielos;1565;784;781;2017
44;Teruel;159;Moscardón;57;30;27;2017
44;Teruel;160;Mosqueruela;558;305;253;2017
44;Teruel;161;Muniesa;630;330;300;2017
44;Teruel;163;Noguera de Albarracín;134;73;61;2017
44;Teruel;164;Nogueras;28;18;10;2017
44;Teruel;165;Nogueruelas;211;117;94;2017
44;Teruel;167;Obón;44;24;20;2017
44;Teruel;168;Odón;217;117;100;2017
44;Teruel;169;Ojos Negros;393;211;182;2017
44;Teruel;171;Olba;227;131;96;2017
44;Teruel;172;Oliete;357;184;173;2017
44;Teruel;173;Olmos, Los;122;67;55;2017
44;Teruel;174;Orihuela del Tremedal;493;272;221;2017
44;Teruel;175;Orrios;127;68;59;2017
44;Teruel;176;Palomar de Arroyos;169;101;68;2017
44;Teruel;177;Pancrudo;119;72;47;2017
44;Teruel;178;Parras de Castellote, Las;61;35;26;2017
44;Teruel;179;Peñarroya de Tastavins;461;251;210;2017
44;Teruel;180;Peracense;75;43;32;2017
44;Teruel;181;Peralejos;87;47;40;2017
44;Teruel;182;Perales del Alfambra;221;119;102;2017
44;Teruel;183;Pitarque;84;43;41;2017
44;Teruel;184;Plou;45;30;15;2017
44;Teruel;185;Pobo, El;129;80;49;2017
44;Teruel;187;Portellada, La;246;124;122;2017
44;Teruel;189;Pozondón;54;30;24;2017
44;Teruel;190;Pozuel del Campo;70;38;32;2017
44;Teruel;191;Puebla de Híjar, La;944;475;469;2017
44;Teruel;192;Puebla de Valverde, La;457;253;204;2017
44;Teruel;193;Puertomingalvo;117;64;53;2017
44;Teruel;194;Ráfales;146;82;64;2017
44;Teruel;195;Rillo;92;52;40;2017
44;Teruel;196;Riodeva;149;72;77;2017
44;Teruel;197;Ródenas;62;34;28;2017
44;Teruel;198;Royuela;209;113;96;2017
44;Teruel;199;Rubiales;52;29;23;2017
44;Teruel;200;Rubielos de la Cérida;38;23;15;2017
44;Teruel;201;Rubielos de Mora;626;324;302;2017
44;Teruel;203;Salcedillo;17;11;6;2017
44;Teruel;204;Saldón;26;17;9;2017
44;Teruel;205;Samper de Calanda;821;409;412;2017
44;Teruel;206;San Agustín;131;84;47;2017
44;Teruel;207;San Martín del Río;155;82;73;2017
44;Teruel;208;Santa Cruz de Nogueras;38;19;19;2017
44;Teruel;209;Santa Eulalia;1033;523;510;2017
44;Teruel;210;Sarrión;1125;596;529;2017
44;Teruel;211;Segura de los Baños;43;27;16;2017
44;Teruel;212;Seno;40;18;22;2017
44;Teruel;213;Singra;79;47;32;2017
44;Teruel;215;Terriente;178;101;77;2017
44;Teruel;216;Teruel;35484;16936;18548;2017
44;Teruel;217;Toril y Masegoso;29;24;5;2017
44;Teruel;218;Tormón;34;20;14;2017
44;Teruel;219;Tornos;222;118;104;2017
44;Teruel;220;Torralba de los Sisones;162;90;72;2017
44;Teruel;223;Torre de Arcas;83;38;45;2017
44;Teruel;224;Torre de las Arcas;28;14;14;2017
44;Teruel;225;Torre del Compte;130;64;66;2017
44;Teruel;227;Torre los Negros;86;45;41;2017
44;Teruel;221;Torrecilla de Alcañiz;426;224;202;2017
44;Teruel;222;Torrecilla del Rebollar;136;87;49;2017
44;Teruel;226;Torrelacárcel;169;89;80;2017
44;Teruel;228;Torremocha de Jiloca;107;61;46;2017
44;Teruel;229;Torres de Albarracín;178;99;79;2017
44;Teruel;230;Torrevelilla;192;94;98;2017
44;Teruel;231;Torrijas;39;18;21;2017
44;Teruel;232;Torrijo del Campo;447;237;210;2017
44;Teruel;234;Tramacastiel;67;38;29;2017
44;Teruel;235;Tramacastilla;107;52;55;2017
44;Teruel;236;Tronchón;69;37;32;2017
44;Teruel;237;Urrea de Gaén;461;228;233;2017
44;Teruel;238;Utrillas;3014;1554;1460;2017
44;Teruel;239;Valacloche;23;13;10;2017
44;Teruel;240;Valbona;181;99;82;2017
44;Teruel;241;Valdealgorfa;632;317;315;2017
44;Teruel;243;Valdecuenca;37;23;14;2017
44;Teruel;244;Valdelinares;89;52;37;2017
44;Teruel;245;Valdeltormo;298;144;154;2017
44;Teruel;246;Valderrobres;2338;1179;1159;2017
44;Teruel;247;Valjunquera;341;175;166;2017
44;Teruel;249;Vallecillo, El;49;28;21;2017
44;Teruel;250;Veguillas de la Sierra;19;11;8;2017
44;Teruel;251;Villafranca del Campo;289;149;140;2017
44;Teruel;252;Villahermosa del Campo;94;63;31;2017
44;Teruel;256;Villanueva del Rebollar de la Sierra;43;25;18;2017
44;Teruel;257;Villar del Cobo;175;100;75;2017
44;Teruel;258;Villar del Salz;59;36;23;2017
44;Teruel;260;Villarluengo;169;103;66;2017
44;Teruel;261;Villarquemado;875;455;420;2017
44;Teruel;262;Villarroya de los Pinares;155;82;73;2017
44;Teruel;263;Villastar;501;252;249;2017
44;Teruel;264;Villel;330;188;142;2017
44;Teruel;265;Vinaceite;262;135;127;2017
44;Teruel;266;Visiedo;135;59;76;2017
44;Teruel;267;Vivel del Río Martín;71;37;34;2017
44;Teruel;268;Zoma, La;18;6;12;2017
45;Toledo;001;Ajofrín;2245;1114;1131;2017
45;Toledo;002;Alameda de la Sagra;3534;1848;1686;2017
45;Toledo;003;Albarreal de Tajo;702;364;338;2017
45;Toledo;004;Alcabón;685;355;330;2017
45;Toledo;005;Alcañizo;286;146;140;2017
45;Toledo;006;Alcaudete de la Jara;1748;886;862;2017
45;Toledo;007;Alcolea de Tajo;820;407;413;2017
45;Toledo;008;Aldea en Cabo;165;86;79;2017
45;Toledo;009;Aldeanueva de Barbarroya;561;284;277;2017
45;Toledo;010;Aldeanueva de San Bartolomé;452;237;215;2017
45;Toledo;011;Almendral de la Cañada;316;169;147;2017
45;Toledo;012;Almonacid de Toledo;814;398;416;2017
45;Toledo;013;Almorox;2215;1166;1049;2017
45;Toledo;014;Añover de Tajo;5148;2639;2509;2017
45;Toledo;015;Arcicóllar;780;393;387;2017
45;Toledo;016;Argés;6163;3107;3056;2017
45;Toledo;017;Azután;289;143;146;2017
45;Toledo;018;Barcience;806;421;385;2017
45;Toledo;019;Bargas;10030;5016;5014;2017
45;Toledo;020;Belvís de la Jara;1567;782;785;2017
45;Toledo;021;Borox;3626;1899;1727;2017
45;Toledo;022;Buenaventura;423;215;208;2017
45;Toledo;023;Burguillos de Toledo;3173;1628;1545;2017
45;Toledo;024;Burujón;1324;684;640;2017
45;Toledo;025;Cabañas de la Sagra;1777;913;864;2017
45;Toledo;026;Cabañas de Yepes;237;126;111;2017
45;Toledo;027;Cabezamesada;360;193;167;2017
45;Toledo;028;Calera y Chozas;4631;2354;2277;2017
45;Toledo;029;Caleruela;223;111;112;2017
45;Toledo;030;Calzada de Oropesa;534;295;239;2017
45;Toledo;031;Camarena;3734;1933;1801;2017
45;Toledo;032;Camarenilla;556;284;272;2017
45;Toledo;033;Campillo de la Jara, El;373;198;175;2017
45;Toledo;034;Camuñas;1779;919;860;2017
45;Toledo;035;Cardiel de los Montes;348;185;163;2017
45;Toledo;036;Carmena;743;380;363;2017
45;Toledo;037;Carpio de Tajo, El;1930;963;967;2017
45;Toledo;038;Carranque;4681;2424;2257;2017
45;Toledo;039;Carriches;266;137;129;2017
45;Toledo;040;Casar de Escalona, El;1841;984;857;2017
45;Toledo;041;Casarrubios del Monte;5335;2809;2526;2017
45;Toledo;042;Casasbuenas;201;99;102;2017
45;Toledo;043;Castillo de Bayuela;894;452;442;2017
45;Toledo;045;Cazalegas;1743;887;856;2017
45;Toledo;046;Cebolla;3344;1698;1646;2017
45;Toledo;047;Cedillo del Condado;3727;1936;1791;2017
45;Toledo;048;Cerralbos, Los;414;222;192;2017
45;Toledo;049;Cervera de los Montes;520;266;254;2017
45;Toledo;056;Chozas de Canales;3760;1981;1779;2017
45;Toledo;057;Chueca;265;143;122;2017
45;Toledo;050;Ciruelos;544;289;255;2017
45;Toledo;051;Cobeja;2192;1144;1048;2017
45;Toledo;052;Cobisa;4221;2110;2111;2017
45;Toledo;053;Consuegra;10146;5122;5024;2017
45;Toledo;054;Corral de Almaguer;5443;2791;2652;2017
45;Toledo;055;Cuerva;1361;713;648;2017
45;Toledo;058;Domingo Pérez;417;215;202;2017
45;Toledo;059;Dosbarrios;2230;1141;1089;2017
45;Toledo;060;Erustes;211;108;103;2017
45;Toledo;061;Escalona;3240;1667;1573;2017
45;Toledo;062;Escalonilla;1447;722;725;2017
45;Toledo;063;Espinoso del Rey;466;258;208;2017
45;Toledo;064;Esquivias;5378;2710;2668;2017
45;Toledo;065;Estrella, La;241;126;115;2017
45;Toledo;066;Fuensalida;10976;5542;5434;2017
45;Toledo;067;Gálvez;3075;1541;1534;2017
45;Toledo;068;Garciotum;190;96;94;2017
45;Toledo;069;Gerindote;2347;1199;1148;2017
45;Toledo;070;Guadamur;1802;906;896;2017
45;Toledo;071;Guardia, La;2248;1140;1108;2017
45;Toledo;072;Herencias, Las;793;425;368;2017
45;Toledo;073;Herreruela de Oropesa;357;183;174;2017
45;Toledo;074;Hinojosa de San Vicente;415;227;188;2017
45;Toledo;075;Hontanar;163;99;64;2017
45;Toledo;076;Hormigos;686;371;315;2017
45;Toledo;077;Huecas;654;333;321;2017
45;Toledo;078;Huerta de Valdecarábanos;1703;841;862;2017
45;Toledo;079;Iglesuela, La;425;220;205;2017
45;Toledo;080;Illán de Vacas;5;4;1;2017
45;Toledo;081;Illescas;27332;13866;13466;2017
45;Toledo;082;Lagartera;1422;710;712;2017
45;Toledo;083;Layos;652;322;330;2017
45;Toledo;084;Lillo;2695;1399;1296;2017
45;Toledo;085;Lominchar;2369;1232;1137;2017
45;Toledo;086;Lucillos;591;310;281;2017
45;Toledo;087;Madridejos;10637;5333;5304;2017
45;Toledo;088;Magán;3259;1670;1589;2017
45;Toledo;089;Malpica de Tajo;1802;920;882;2017
45;Toledo;090;Manzaneque;406;198;208;2017
45;Toledo;091;Maqueda;469;237;232;2017
45;Toledo;092;Marjaliza;270;130;140;2017
45;Toledo;093;Marrupe;156;83;73;2017
45;Toledo;094;Mascaraque;444;223;221;2017
45;Toledo;095;Mata, La;864;438;426;2017
45;Toledo;096;Mazarambroz;1259;648;611;2017
45;Toledo;097;Mejorada;1266;658;608;2017
45;Toledo;098;Menasalbas;2739;1440;1299;2017
45;Toledo;099;Méntrida;4900;2496;2404;2017
45;Toledo;100;Mesegar de Tajo;228;124;104;2017
45;Toledo;101;Miguel Esteban;4976;2494;2482;2017
45;Toledo;102;Mocejón;4830;2442;2388;2017
45;Toledo;103;Mohedas de la Jara;420;233;187;2017
45;Toledo;104;Montearagón;520;270;250;2017
45;Toledo;105;Montesclaros;417;224;193;2017
45;Toledo;106;Mora;9853;4946;4907;2017
45;Toledo;107;Nambroca;4557;2346;2211;2017
45;Toledo;108;Nava de Ricomalillo, La;565;294;271;2017
45;Toledo;109;Navahermosa;3738;1913;1825;2017
45;Toledo;110;Navalcán;2080;1095;985;2017
45;Toledo;111;Navalmoralejo;64;34;30;2017
45;Toledo;112;Navalmorales, Los;2617;1361;1256;2017
45;Toledo;113;Navalucillos, Los;2251;1159;1092;2017
45;Toledo;114;Navamorcuende;643;323;320;2017
45;Toledo;115;Noblejas;3499;1776;1723;2017
45;Toledo;116;Noez;881;450;431;2017
45;Toledo;117;Nombela;895;471;424;2017
45;Toledo;118;Novés;2721;1403;1318;2017
45;Toledo;119;Numancia de la Sagra;4755;2496;2259;2017
45;Toledo;120;Nuño Gómez;138;77;61;2017
45;Toledo;121;Ocaña;10733;5418;5315;2017
45;Toledo;122;Olías del Rey;7587;3876;3711;2017
45;Toledo;123;Ontígola;4272;2274;1998;2017
45;Toledo;124;Orgaz;2675;1334;1341;2017
45;Toledo;125;Oropesa;2730;1347;1383;2017
45;Toledo;126;Otero;343;172;171;2017
45;Toledo;127;Palomeque;894;477;417;2017
45;Toledo;128;Pantoja;3277;1646;1631;2017
45;Toledo;129;Paredes de Escalona;129;62;67;2017
45;Toledo;130;Parrillas;355;192;163;2017
45;Toledo;131;Pelahustán;318;177;141;2017
45;Toledo;132;Pepino;2809;1461;1348;2017
45;Toledo;133;Polán;3849;1931;1918;2017
45;Toledo;134;Portillo de Toledo;2138;1070;1068;2017
45;Toledo;135;Puebla de Almoradiel, La;5360;2721;2639;2017
45;Toledo;136;Puebla de Montalbán, La;7910;4015;3895;2017
45;Toledo;137;Pueblanueva, La;2252;1133;1119;2017
45;Toledo;138;Puente del Arzobispo, El;1279;630;649;2017
45;Toledo;139;Puerto de San Vicente;165;87;78;2017
45;Toledo;140;Pulgar;1555;795;760;2017
45;Toledo;141;Quero;1042;531;511;2017
45;Toledo;142;Quintanar de la Orden;10926;5445;5481;2017
45;Toledo;143;Quismondo;1509;784;725;2017
45;Toledo;144;Real de San Vicente, El;969;512;457;2017
45;Toledo;145;Recas;4220;2339;1881;2017
45;Toledo;146;Retamoso de la Jara;105;53;52;2017
45;Toledo;147;Rielves;756;384;372;2017
45;Toledo;148;Robledo del Mazo;299;169;130;2017
45;Toledo;149;Romeral, El;609;305;304;2017
45;Toledo;150;San Bartolomé de las Abiertas;464;248;216;2017
45;Toledo;151;San Martín de Montalbán;744;370;374;2017
45;Toledo;152;San Martín de Pusa;685;358;327;2017
45;Toledo;153;San Pablo de los Montes;1867;944;923;2017
45;Toledo;154;San Román de los Montes;1887;1005;882;2017
45;Toledo;155;Santa Ana de Pusa;397;227;170;2017
45;Toledo;156;Santa Cruz de la Zarza;4285;2165;2120;2017
45;Toledo;157;Santa Cruz del Retamar;2871;1494;1377;2017
45;Toledo;158;Santa Olalla;3219;1658;1561;2017
45;Toledo;901;Santo Domingo-Caudilla;1019;540;479;2017
45;Toledo;159;Sartajada;102;60;42;2017
45;Toledo;160;Segurilla;1345;673;672;2017
45;Toledo;161;Seseña;22992;11882;11110;2017
45;Toledo;162;Sevilleja de la Jara;717;390;327;2017
45;Toledo;163;Sonseca;11068;5611;5457;2017
45;Toledo;164;Sotillo de las Palomas;198;107;91;2017
45;Toledo;165;Talavera de la Reina;83303;40041;43262;2017
45;Toledo;166;Tembleque;2036;1029;1007;2017
45;Toledo;167;Toboso, El;1831;921;910;2017
45;Toledo;168;Toledo;83741;40038;43703;2017
45;Toledo;169;Torralba de Oropesa;210;110;100;2017
45;Toledo;171;Torre de Esteban Hambrán, La;1712;875;837;2017
45;Toledo;170;Torrecilla de la Jara;238;122;116;2017
45;Toledo;172;Torrico;748;382;366;2017
45;Toledo;173;Torrijos;13295;6578;6717;2017
45;Toledo;174;Totanés;355;179;176;2017
45;Toledo;175;Turleque;804;411;393;2017
45;Toledo;176;Ugena;5297;2747;2550;2017
45;Toledo;177;Urda;2636;1307;1329;2017
45;Toledo;179;Valdeverdeja;598;295;303;2017
45;Toledo;180;Valmojado;4126;2073;2053;2017
45;Toledo;181;Velada;2859;1485;1374;2017
45;Toledo;182;Ventas con Peña Aguilera, Las;1144;584;560;2017
45;Toledo;183;Ventas de Retamosa, Las;3266;1728;1538;2017
45;Toledo;184;Ventas de San Julián, Las;231;113;118;2017
45;Toledo;186;Villa de Don Fadrique, La;3798;1890;1908;2017
45;Toledo;185;Villacañas;9840;4898;4942;2017
45;Toledo;187;Villafranca de los Caballeros;5024;2500;2524;2017
45;Toledo;188;Villaluenga de la Sagra;3780;1887;1893;2017
45;Toledo;189;Villamiel de Toledo;876;455;421;2017
45;Toledo;190;Villaminaya;552;280;272;2017
45;Toledo;191;Villamuelas;632;331;301;2017
45;Toledo;192;Villanueva de Alcardete;3362;1743;1619;2017
45;Toledo;193;Villanueva de Bogas;742;380;362;2017
45;Toledo;194;Villarejo de Montalbán;82;46;36;2017
45;Toledo;195;Villarrubia de Santiago;2588;1299;1289;2017
45;Toledo;196;Villaseca de la Sagra;1815;911;904;2017
45;Toledo;197;Villasequilla;2510;1296;1214;2017
45;Toledo;198;Villatobas;2407;1244;1163;2017
45;Toledo;199;Viso de San Juan, El;4238;2264;1974;2017
45;Toledo;200;Yébenes, Los;6009;3079;2930;2017
45;Toledo;201;Yeles;5177;2703;2474;2017
45;Toledo;202;Yepes;5074;2604;2470;2017
45;Toledo;203;Yuncler;3679;1863;1816;2017
45;Toledo;204;Yunclillos;830;428;402;2017
45;Toledo;205;Yuncos;10827;5571;5256;2017
46;Valencia/València;001;Ademuz;1073;574;499;2017
46;Valencia/València;002;Ador;1400;745;655;2017
46;Valencia/València;004;Agullent;2387;1189;1198;2017
46;Valencia/València;042;Aielo de Malferit;4706;2352;2354;2017
46;Valencia/València;043;Aielo de Rugat;160;86;74;2017
46;Valencia/València;005;Alaquàs;29474;14455;15019;2017
46;Valencia/València;006;Albaida;5946;2944;3002;2017
46;Valencia/València;007;Albal;16244;8135;8109;2017
46;Valencia/València;008;Albalat de la Ribera;3361;1697;1664;2017
46;Valencia/València;009;Albalat dels Sorells;3900;1915;1985;2017
46;Valencia/València;010;Albalat dels Tarongers;1169;626;543;2017
46;Valencia/València;011;Alberic;10504;5239;5265;2017
46;Valencia/València;012;Alborache;1140;601;539;2017
46;Valencia/València;013;Alboraia/Alboraya;24031;11802;12229;2017
46;Valencia/València;014;Albuixech;3911;1931;1980;2017
46;Valencia/València;016;Alcàntera de Xúquer;1318;655;663;2017
46;Valencia/València;015;Alcàsser;9813;4944;4869;2017
46;Valencia/València;018;Alcublas;678;355;323;2017
46;Valencia/València;020;Alcúdia de Crespins, l';5108;2541;2567;2017
46;Valencia/València;019;Alcúdia, l';11926;5838;6088;2017
46;Valencia/València;021;Aldaia;31320;15624;15696;2017
46;Valencia/València;022;Alfafar;20776;10173;10603;2017
46;Valencia/València;024;Alfara de la Baronia;535;266;269;2017
46;Valencia/València;025;Alfara del Patriarca;3348;1630;1718;2017
46;Valencia/València;026;Alfarp;1517;778;739;2017
46;Valencia/València;027;Alfarrasí;1256;622;634;2017
46;Valencia/València;023;Alfauir;448;229;219;2017
46;Valencia/València;028;Algar de Palancia;471;242;229;2017
46;Valencia/València;029;Algemesí;27511;13685;13826;2017
46;Valencia/València;030;Algimia de Alfara;1051;527;524;2017
46;Valencia/València;031;Alginet;13186;6702;6484;2017
46;Valencia/València;032;Almàssera;7308;3565;3743;2017
46;Valencia/València;033;Almiserà;261;132;129;2017
46;Valencia/València;034;Almoines;2343;1173;1170;2017
46;Valencia/València;035;Almussafes;8914;4463;4451;2017
46;Valencia/València;036;Alpuente;644;356;288;2017
46;Valencia/València;037;Alqueria de la Comtessa, l';1443;708;735;2017
46;Valencia/València;017;Alzira;44255;21566;22689;2017
46;Valencia/València;038;Andilla;322;209;113;2017
46;Valencia/València;039;Anna;2639;1336;1303;2017
46;Valencia/València;040;Antella;1233;610;623;2017
46;Valencia/València;041;Aras de los Olmos;375;207;168;2017
46;Valencia/València;003;Atzeneta d'Albaida;1155;590;565;2017
46;Valencia/València;044;Ayora;5311;2645;2666;2017
46;Valencia/València;046;Barx;1227;637;590;2017
46;Valencia/València;045;Barxeta;1577;814;763;2017
46;Valencia/València;047;Bèlgida;690;336;354;2017
46;Valencia/València;048;Bellreguard;4550;2255;2295;2017
46;Valencia/València;049;Bellús;315;161;154;2017
46;Valencia/València;050;Benagéber;192;107;85;2017
46;Valencia/València;051;Benaguasil;10960;5564;5396;2017
46;Valencia/València;052;Benavites;613;290;323;2017
46;Valencia/València;053;Beneixida;648;316;332;2017
46;Valencia/València;054;Benetússer;14495;7041;7454;2017
46;Valencia/València;055;Beniarjó;1759;880;879;2017
46;Valencia/València;056;Beniatjar;219;110;109;2017
46;Valencia/València;057;Benicolet;585;294;291;2017
46;Valencia/València;904;Benicull de Xúquer;970;484;486;2017
46;Valencia/València;060;Benifaió;11956;5948;6008;2017
46;Valencia/València;059;Benifairó de la Valldigna;1596;792;804;2017
46;Valencia/València;058;Benifairó de les Valls;2205;1097;1108;2017
46;Valencia/València;061;Beniflá;458;233;225;2017
46;Valencia/València;062;Benigànim;5850;2957;2893;2017
46;Valencia/València;063;Benimodo;2230;1137;1093;2017
46;Valencia/València;064;Benimuslem;656;337;319;2017
46;Valencia/València;065;Beniparrell;1964;1015;949;2017
46;Valencia/València;066;Benirredrà;1570;772;798;2017
46;Valencia/València;067;Benissanó;2238;1119;1119;2017
46;Valencia/València;068;Benissoda;425;232;193;2017
46;Valencia/València;069;Benissuera;194;97;97;2017
46;Valencia/València;070;Bétera;23178;11610;11568;2017
46;Valencia/València;071;Bicorp;526;269;257;2017
46;Valencia/València;072;Bocairent;4271;2162;2109;2017
46;Valencia/València;073;Bolbaite;1362;684;678;2017
46;Valencia/València;074;Bonrepòs i Mirambell;3629;1774;1855;2017
46;Valencia/València;075;Bufali;163;90;73;2017
46;Valencia/València;076;Bugarra;711;362;349;2017
46;Valencia/València;077;Buñol;9596;4812;4784;2017
46;Valencia/València;078;Burjassot;37575;18106;19469;2017
46;Valencia/València;079;Calles;345;194;151;2017
46;Valencia/València;080;Camporrobles;1217;625;592;2017
46;Valencia/València;081;Canals;13631;6827;6804;2017
46;Valencia/València;082;Canet d'En Berenguer;6473;3314;3159;2017
46;Valencia/València;083;Carcaixent;20483;10143;10340;2017
46;Valencia/València;084;Càrcer;1923;917;1006;2017
46;Valencia/València;085;Carlet;15446;7668;7778;2017
46;Valencia/València;086;Carrícola;95;49;46;2017
46;Valencia/València;087;Casas Altas;139;74;65;2017
46;Valencia/València;088;Casas Bajas;172;88;84;2017
46;Valencia/València;089;Casinos;2759;1415;1344;2017
46;Valencia/València;090;Castelló de Rugat;2278;1165;1113;2017
46;Valencia/València;091;Castellonet de la Conquesta;138;74;64;2017
46;Valencia/València;092;Castielfabib;311;163;148;2017
46;Valencia/València;093;Catadau;2773;1389;1384;2017
46;Valencia/València;094;Catarroja;27752;13711;14041;2017
46;Valencia/València;095;Caudete de las Fuentes;706;374;332;2017
46;Valencia/València;096;Cerdà;341;183;158;2017
46;Valencia/València;107;Chella;2513;1234;1279;2017
46;Valencia/València;106;Chelva;1516;785;731;2017
46;Valencia/València;108;Chera;484;258;226;2017
46;Valencia/València;109;Cheste;8372;4265;4107;2017
46;Valencia/València;111;Chiva;14867;7645;7222;2017
46;Valencia/València;112;Chulilla;628;333;295;2017
46;Valencia/València;097;Cofrentes;1104;563;541;2017
46;Valencia/València;098;Corbera;3190;1581;1609;2017
46;Valencia/València;099;Cortes de Pallás;876;481;395;2017
46;Valencia/València;100;Cotes;336;173;163;2017
46;Valencia/València;105;Cullera;21999;10932;11067;2017
46;Valencia/València;113;Daimús;3018;1508;1510;2017
46;Valencia/València;114;Domeño;689;352;337;2017
46;Valencia/València;115;Dos Aguas;379;218;161;2017
46;Valencia/València;116;Eliana, l';17760;8660;9100;2017
46;Valencia/València;117;Emperador;707;368;339;2017
46;Valencia/València;118;Enguera;4926;2435;2491;2017
46;Valencia/València;119;Ènova, l';919;468;451;2017
46;Valencia/València;120;Estivella;1416;689;727;2017
46;Valencia/València;121;Estubeny;119;59;60;2017
46;Valencia/València;122;Faura;3503;1766;1737;2017
46;Valencia/València;123;Favara;2473;1248;1225;2017
46;Valencia/València;126;Foios;7234;3564;3670;2017
46;Valencia/València;128;Font de la Figuera, la;2067;1041;1026;2017
46;Valencia/València;127;Font d'En Carròs, la;3743;1850;1893;2017
46;Valencia/València;124;Fontanars dels Alforins;985;502;483;2017
46;Valencia/València;125;Fortaleny;1033;515;518;2017
46;Valencia/València;129;Fuenterrobles;709;391;318;2017
46;Valencia/València;131;Gandia;74121;36490;37631;2017
46;Valencia/València;902;Gátova;398;185;213;2017
46;Valencia/València;130;Gavarda;1073;509;564;2017
46;Valencia/València;132;Genovés;2815;1420;1395;2017
46;Valencia/València;133;Gestalgar;596;315;281;2017
46;Valencia/València;134;Gilet;3308;1717;1591;2017
46;Valencia/València;135;Godella;13031;6302;6729;2017
46;Valencia/València;136;Godelleta;3391;1736;1655;2017
46;Valencia/València;137;Granja de la Costera, la;312;153;159;2017
46;Valencia/València;138;Guadasséquies;459;244;215;2017
46;Valencia/València;139;Guadassuar;5913;2912;3001;2017
46;Valencia/València;140;Guardamar de la Safor;472;249;223;2017
46;Valencia/València;141;Higueruelas;503;265;238;2017
46;Valencia/València;142;Jalance;852;446;406;2017
46;Valencia/València;144;Jarafuel;785;411;374;2017
46;Valencia/València;154;Llanera de Ranes;1042;528;514;2017
46;Valencia/València;155;Llaurí;1221;617;604;2017
46;Valencia/València;147;Llíria;22793;11572;11221;2017
46;Valencia/València;152;Llocnou de la Corona;116;59;57;2017
46;Valencia/València;153;Llocnou de Sant Jeroni;544;270;274;2017
46;Valencia/València;151;Llocnou d'En Fenollet;887;461;426;2017
46;Valencia/València;156;Llombai;2702;1361;1341;2017
46;Valencia/València;157;Llosa de Ranes, la;3599;1847;1752;2017
46;Valencia/València;150;Llutxent;2367;1218;1149;2017
46;Valencia/València;148;Loriguilla;1985;1030;955;2017
46;Valencia/València;149;Losa del Obispo;510;258;252;2017
46;Valencia/València;158;Macastre;1236;650;586;2017
46;Valencia/València;159;Manises;30630;15110;15520;2017
46;Valencia/València;160;Manuel;2448;1193;1255;2017
46;Valencia/València;161;Marines;1858;966;892;2017
46;Valencia/València;162;Massalavés;1596;836;760;2017
46;Valencia/València;163;Massalfassar;2462;1229;1233;2017
46;Valencia/València;164;Massamagrell;15553;7710;7843;2017
46;Valencia/València;165;Massanassa;9375;4651;4724;2017
46;Valencia/València;166;Meliana;10678;5240;5438;2017
46;Valencia/València;167;Millares;349;177;172;2017
46;Valencia/València;168;Miramar;2608;1349;1259;2017
46;Valencia/València;169;Mislata;43042;20878;22164;2017
46;Valencia/València;170;Mogente/Moixent;4371;2195;2176;2017
46;Valencia/València;171;Moncada;21623;10602;11021;2017
46;Valencia/València;173;Montaverner;1666;836;830;2017
46;Valencia/València;174;Montesa;1204;610;594;2017
46;Valencia/València;175;Montitxelvo/Montichelvo;614;304;310;2017
46;Valencia/València;176;Montroi/Montroy;2865;1533;1332;2017
46;Valencia/València;172;Montserrat;7419;3854;3565;2017
46;Valencia/València;177;Museros;6164;3087;3077;2017
46;Valencia/València;178;Náquera;6058;3175;2883;2017
46;Valencia/València;179;Navarrés;3031;1521;1510;2017
46;Valencia/València;180;Novelé/Novetlè;858;422;436;2017
46;Valencia/València;181;Oliva;25488;12577;12911;2017
46;Valencia/València;183;Olleria, l';8261;4140;4121;2017
46;Valencia/València;182;Olocau;1750;924;826;2017
46;Valencia/València;184;Ontinyent;35342;17467;17875;2017
46;Valencia/València;185;Otos;450;228;222;2017
46;Valencia/València;186;Paiporta;25241;12538;12703;2017
46;Valencia/València;187;Palma de Gandía;1511;777;734;2017
46;Valencia/València;188;Palmera;1024;535;489;2017
46;Valencia/València;189;Palomar, el;579;296;283;2017
46;Valencia/València;190;Paterna;68547;33963;34584;2017
46;Valencia/València;191;Pedralba;2785;1465;1320;2017
46;Valencia/València;192;Petrés;968;480;488;2017
46;Valencia/València;193;Picanya;11278;5570;5708;2017
46;Valencia/València;194;Picassent;20658;10439;10219;2017
46;Valencia/València;195;Piles;2712;1350;1362;2017
46;Valencia/València;196;Pinet;159;78;81;2017
46;Valencia/València;199;Pobla de Farnals, la;7747;3885;3862;2017
46;Valencia/València;202;Pobla de Vallbona, la;23684;11978;11706;2017
46;Valencia/València;200;Pobla del Duc, la;2589;1255;1334;2017
46;Valencia/València;203;Pobla Llarga, la;4493;2251;2242;2017
46;Valencia/València;197;Polinyà de Xúquer;2484;1257;1227;2017
46;Valencia/València;198;Potries;1013;516;497;2017
46;Valencia/València;205;Puçol;19531;9639;9892;2017
46;Valencia/València;201;Puebla de San Miguel;62;39;23;2017
46;Valencia/València;204;Puig de Santa Maria, el;8618;4200;4418;2017
46;Valencia/València;101;Quart de les Valls;1042;498;544;2017
46;Valencia/València;102;Quart de Poblet;24491;11963;12528;2017
46;Valencia/València;103;Quartell;1539;739;800;2017
46;Valencia/València;104;Quatretonda;2278;1153;1125;2017
46;Valencia/València;206;Quesa;673;354;319;2017
46;Valencia/València;207;Rafelbunyol;8870;4361;4509;2017
46;Valencia/València;208;Rafelcofer;1375;669;706;2017
46;Valencia/València;209;Rafelguaraf;2394;1183;1211;2017
46;Valencia/València;210;Ráfol de Salem;425;205;220;2017
46;Valencia/València;212;Real;2184;1114;1070;2017
46;Valencia/València;211;Real de Gandia, el;2363;1149;1214;2017
46;Valencia/València;213;Requena;20320;10140;10180;2017
46;Valencia/València;214;Riba-roja de Túria;21626;10961;10665;2017
46;Valencia/València;215;Riola;1785;911;874;2017
46;Valencia/València;216;Rocafort;7004;3441;3563;2017
46;Valencia/València;217;Rotglà i Corberà;1108;557;551;2017
46;Valencia/València;218;Rótova;1259;653;606;2017
46;Valencia/València;219;Rugat;158;83;75;2017
46;Valencia/València;220;Sagunto/Sagunt;65278;31978;33300;2017
46;Valencia/València;221;Salem;437;220;217;2017
46;Valencia/València;903;San Antonio de Benagéber;8755;4317;4438;2017
46;Valencia/València;222;Sant Joanet;484;237;247;2017
46;Valencia/València;223;Sedaví;10179;4952;5227;2017
46;Valencia/València;224;Segart;158;79;79;2017
46;Valencia/València;225;Sellent;376;190;186;2017
46;Valencia/València;226;Sempere;41;22;19;2017
46;Valencia/València;227;Senyera;1149;568;581;2017
46;Valencia/València;228;Serra;3068;1573;1495;2017
46;Valencia/València;229;Siete Aguas;1196;639;557;2017
46;Valencia/València;230;Silla;18440;9160;9280;2017
46;Valencia/València;231;Simat de la Valldigna;3297;1651;1646;2017
46;Valencia/València;232;Sinarcas;1147;588;559;2017
46;Valencia/València;233;Sollana;4886;2388;2498;2017
46;Valencia/València;234;Sot de Chera;370;194;176;2017
46;Valencia/València;235;Sueca;27598;13608;13990;2017
46;Valencia/València;236;Sumacàrcer;1141;563;578;2017
46;Valencia/València;237;Tavernes Blanques;9095;4441;4654;2017
46;Valencia/València;238;Tavernes de la Valldigna;17336;8687;8649;2017
46;Valencia/València;239;Teresa de Cofrentes;631;327;304;2017
46;Valencia/València;240;Terrateig;284;150;134;2017
46;Valencia/València;241;Titaguas;450;233;217;2017
46;Valencia/València;242;Torrebaja;412;214;198;2017
46;Valencia/València;243;Torrella;145;78;67;2017
46;Valencia/València;244;Torrent;80630;39761;40869;2017
46;Valencia/València;245;Torres Torres;641;345;296;2017
46;Valencia/València;246;Tous;1268;646;622;2017
46;Valencia/València;247;Tuéjar;1147;605;542;2017
46;Valencia/València;248;Turís;6627;3464;3163;2017
46;Valencia/València;249;Utiel;11601;5785;5816;2017
46;Valencia/València;250;Valencia;787808;375210;412598;2017
46;Valencia/València;251;Vallada;3093;1573;1520;2017
46;Valencia/València;252;Vallanca;120;61;59;2017
46;Valencia/València;253;Vallés;153;82;71;2017
46;Valencia/València;254;Venta del Moro;1277;681;596;2017
46;Valencia/València;255;Vilallonga/Villalonga;4371;2155;2216;2017
46;Valencia/València;256;Vilamarxant;9376;4855;4521;2017
46;Valencia/València;257;Villanueva de Castellón;7209;3572;3637;2017
46;Valencia/València;258;Villar del Arzobispo;3542;1804;1738;2017
46;Valencia/València;259;Villargordo del Cabriel;612;329;283;2017
46;Valencia/València;260;Vinalesa;3345;1622;1723;2017
46;Valencia/València;145;Xàtiva;29070;14215;14855;2017
46;Valencia/València;143;Xeraco;5715;2889;2826;2017
46;Valencia/València;146;Xeresa;2162;1111;1051;2017
46;Valencia/València;110;Xirivella;28950;14302;14648;2017
46;Valencia/València;261;Yátova;2080;1071;1009;2017
46;Valencia/València;262;Yesa, La;234;125;109;2017
46;Valencia/València;263;Zarra;381;208;173;2017
47;Valladolid;001;Adalia;59;36;23;2017
47;Valladolid;002;Aguasal;24;18;6;2017
47;Valladolid;003;Aguilar de Campos;256;146;110;2017
47;Valladolid;004;Alaejos;1389;747;642;2017
47;Valladolid;005;Alcazarén;647;343;304;2017
47;Valladolid;006;Aldea de San Miguel;232;123;109;2017
47;Valladolid;007;Aldeamayor de San Martín;5292;2739;2553;2017
47;Valladolid;008;Almenara de Adaja;25;12;13;2017
47;Valladolid;009;Amusquillo;110;70;40;2017
47;Valladolid;010;Arroyo de la Encomienda;19421;9768;9653;2017
47;Valladolid;011;Ataquines;572;315;257;2017
47;Valladolid;012;Bahabón;112;51;61;2017
47;Valladolid;013;Barcial de la Loma;99;54;45;2017
47;Valladolid;014;Barruelo del Valle;62;37;25;2017
47;Valladolid;015;Becilla de Valderaduey;230;129;101;2017
47;Valladolid;016;Benafarces;71;37;34;2017
47;Valladolid;017;Bercero;211;116;95;2017
47;Valladolid;018;Berceruelo;37;22;15;2017
47;Valladolid;019;Berrueces;93;55;38;2017
47;Valladolid;020;Bobadilla del Campo;304;176;128;2017
47;Valladolid;021;Bocigas;84;47;37;2017
47;Valladolid;022;Bocos de Duero;60;25;35;2017
47;Valladolid;023;Boecillo;4104;2091;2013;2017
47;Valladolid;024;Bolaños de Campos;334;181;153;2017
47;Valladolid;025;Brahojos de Medina;124;67;57;2017
47;Valladolid;026;Bustillo de Chaves;72;42;30;2017
47;Valladolid;027;Cabezón de Pisuerga;3678;1876;1802;2017
47;Valladolid;028;Cabezón de Valderaduey;37;20;17;2017
47;Valladolid;029;Cabreros del Monte;66;36;30;2017
47;Valladolid;030;Campaspero;1114;603;511;2017
47;Valladolid;031;Campillo, El;225;133;92;2017
47;Valladolid;032;Camporredondo;161;93;68;2017
47;Valladolid;033;Canalejas de Peñafiel;224;124;100;2017
47;Valladolid;034;Canillas de Esgueva;75;45;30;2017
47;Valladolid;035;Carpio;1022;542;480;2017
47;Valladolid;036;Casasola de Arión;249;141;108;2017
47;Valladolid;037;Castrejón de Trabancos;178;88;90;2017
47;Valladolid;038;Castrillo de Duero;119;67;52;2017
47;Valladolid;039;Castrillo-Tejeriego;184;104;80;2017
47;Valladolid;040;Castrobol;66;35;31;2017
47;Valladolid;041;Castrodeza;158;96;62;2017
47;Valladolid;042;Castromembibre;58;37;21;2017
47;Valladolid;043;Castromonte;315;183;132;2017
47;Valladolid;044;Castronuevo de Esgueva;385;205;180;2017
47;Valladolid;045;Castronuño;871;430;441;2017
47;Valladolid;046;Castroponce;145;80;65;2017
47;Valladolid;047;Castroverde de Cerrato;230;142;88;2017
47;Valladolid;048;Ceinos de Campos;228;124;104;2017
47;Valladolid;049;Cervillego de la Cruz;94;54;40;2017
47;Valladolid;050;Cigales;5067;2580;2487;2017
47;Valladolid;051;Ciguñuela;385;200;185;2017
47;Valladolid;052;Cistérniga;8984;4560;4424;2017
47;Valladolid;053;Cogeces de Íscar;139;69;70;2017
47;Valladolid;054;Cogeces del Monte;703;380;323;2017
47;Valladolid;055;Corcos;203;105;98;2017
47;Valladolid;056;Corrales de Duero;98;56;42;2017
47;Valladolid;057;Cubillas de Santa Marta;295;170;125;2017
47;Valladolid;058;Cuenca de Campos;227;118;109;2017
47;Valladolid;059;Curiel de Duero;129;80;49;2017
47;Valladolid;060;Encinas de Esgueva;272;158;114;2017
47;Valladolid;061;Esguevillas de Esgueva;272;147;125;2017
47;Valladolid;062;Fombellida;174;102;72;2017
47;Valladolid;063;Fompedraza;107;56;51;2017
47;Valladolid;064;Fontihoyuelo;34;20;14;2017
47;Valladolid;065;Fresno el Viejo;927;495;432;2017
47;Valladolid;066;Fuensaldaña;1607;829;778;2017
47;Valladolid;067;Fuente el Sol;168;89;79;2017
47;Valladolid;068;Fuente-Olmedo;35;18;17;2017
47;Valladolid;069;Gallegos de Hornija;134;68;66;2017
47;Valladolid;070;Gatón de Campos;34;18;16;2017
47;Valladolid;071;Geria;508;246;262;2017
47;Valladolid;073;Herrín de Campos;130;64;66;2017
47;Valladolid;074;Hornillos de Eresma;163;91;72;2017
47;Valladolid;075;Íscar;6420;3231;3189;2017
47;Valladolid;076;Laguna de Duero;22691;11311;11380;2017
47;Valladolid;077;Langayo;258;163;95;2017
47;Valladolid;079;Llano de Olmedo;62;33;29;2017
47;Valladolid;078;Lomoviejo;178;94;84;2017
47;Valladolid;080;Manzanillo;50;27;23;2017
47;Valladolid;081;Marzales;48;23;25;2017
47;Valladolid;082;Matapozuelos;1055;542;513;2017
47;Valladolid;083;Matilla de los Caños;106;59;47;2017
47;Valladolid;084;Mayorga;1618;804;814;2017
47;Valladolid;086;Medina de Rioseco;4770;2339;2431;2017
47;Valladolid;085;Medina del Campo;20679;10038;10641;2017
47;Valladolid;087;Megeces;431;228;203;2017
47;Valladolid;088;Melgar de Abajo;102;57;45;2017
47;Valladolid;089;Melgar de Arriba;166;88;78;2017
47;Valladolid;090;Mojados;3243;1699;1544;2017
47;Valladolid;091;Monasterio de Vega;86;49;37;2017
47;Valladolid;092;Montealegre de Campos;120;70;50;2017
47;Valladolid;093;Montemayor de Pililla;896;480;416;2017
47;Valladolid;094;Moral de la Reina;169;94;75;2017
47;Valladolid;095;Moraleja de las Panaderas;41;27;14;2017
47;Valladolid;096;Morales de Campos;140;73;67;2017
47;Valladolid;097;Mota del Marqués;373;195;178;2017
47;Valladolid;098;Mucientes;681;347;334;2017
47;Valladolid;099;Mudarra, La;161;81;80;2017
47;Valladolid;100;Muriel;140;77;63;2017
47;Valladolid;101;Nava del Rey;2074;1058;1016;2017
47;Valladolid;102;Nueva Villa de las Torres;301;172;129;2017
47;Valladolid;103;Olivares de Duero;308;171;137;2017
47;Valladolid;104;Olmedo;3666;1799;1867;2017
47;Valladolid;105;Olmos de Esgueva;211;115;96;2017
47;Valladolid;106;Olmos de Peñafiel;60;33;27;2017
47;Valladolid;109;Palazuelo de Vedija;205;105;100;2017
47;Valladolid;110;Parrilla, La;493;248;245;2017
47;Valladolid;111;Pedraja de Portillo, La;1123;567;556;2017
47;Valladolid;112;Pedrajas de San Esteban;3342;1720;1622;2017
47;Valladolid;113;Pedrosa del Rey;193;109;84;2017
47;Valladolid;114;Peñafiel;5201;2592;2609;2017
47;Valladolid;115;Peñaflor de Hornija;305;176;129;2017
47;Valladolid;116;Pesquera de Duero;466;253;213;2017
47;Valladolid;117;Piña de Esgueva;341;179;162;2017
47;Valladolid;118;Piñel de Abajo;183;98;85;2017
47;Valladolid;119;Piñel de Arriba;100;55;45;2017
47;Valladolid;121;Pollos;595;314;281;2017
47;Valladolid;122;Portillo;2435;1281;1154;2017
47;Valladolid;123;Pozal de Gallinas;549;300;249;2017
47;Valladolid;124;Pozaldez;492;260;232;2017
47;Valladolid;125;Pozuelo de la Orden;57;33;24;2017
47;Valladolid;126;Puras;50;27;23;2017
47;Valladolid;127;Quintanilla de Arriba;155;85;70;2017
47;Valladolid;129;Quintanilla de Onésimo;1055;547;508;2017
47;Valladolid;130;Quintanilla de Trigueros;101;51;50;2017
47;Valladolid;128;Quintanilla del Molar;63;28;35;2017
47;Valladolid;131;Rábano;184;99;85;2017
47;Valladolid;132;Ramiro;49;28;21;2017
47;Valladolid;133;Renedo de Esgueva;3724;1902;1822;2017
47;Valladolid;134;Roales de Campos;163;92;71;2017
47;Valladolid;135;Robladillo;94;54;40;2017
47;Valladolid;137;Roturas;31;19;12;2017
47;Valladolid;138;Rubí de Bracamonte;247;139;108;2017
47;Valladolid;139;Rueda;1300;672;628;2017
47;Valladolid;140;Saelices de Mayorga;119;73;46;2017
47;Valladolid;141;Salvador de Zapardiel;135;77;58;2017
47;Valladolid;142;San Cebrián de Mazote;147;88;59;2017
47;Valladolid;143;San Llorente;120;66;54;2017
47;Valladolid;144;San Martín de Valvení;85;47;38;2017
47;Valladolid;145;San Miguel del Arroyo;677;360;317;2017
47;Valladolid;146;San Miguel del Pino;331;175;156;2017
47;Valladolid;147;San Pablo de la Moraleja;117;60;57;2017
47;Valladolid;148;San Pedro de Latarce;510;274;236;2017
47;Valladolid;149;San Pelayo;54;26;28;2017
47;Valladolid;150;San Román de Hornija;327;158;169;2017
47;Valladolid;151;San Salvador;31;16;15;2017
47;Valladolid;156;San Vicente del Palacio;177;96;81;2017
47;Valladolid;152;Santa Eufemia del Arroyo;86;45;41;2017
47;Valladolid;153;Santervás de Campos;121;64;57;2017
47;Valladolid;154;Santibáñez de Valcorba;162;91;71;2017
47;Valladolid;155;Santovenia de Pisuerga;4298;2220;2078;2017
47;Valladolid;157;Sardón de Duero;597;311;286;2017
47;Valladolid;158;Seca, La;1091;559;532;2017
47;Valladolid;159;Serrada;1127;587;540;2017
47;Valladolid;160;Siete Iglesias de Trabancos;456;243;213;2017
47;Valladolid;161;Simancas;5214;2646;2568;2017
47;Valladolid;162;Tamariz de Campos;57;32;25;2017
47;Valladolid;163;Tiedra;297;147;150;2017
47;Valladolid;164;Tordehumos;441;233;208;2017
47;Valladolid;165;Tordesillas;8858;4486;4372;2017
47;Valladolid;169;Torre de Esgueva;72;36;36;2017
47;Valladolid;170;Torre de Peñafiel;41;24;17;2017
47;Valladolid;166;Torrecilla de la Abadesa;280;139;141;2017
47;Valladolid;167;Torrecilla de la Orden;261;134;127;2017
47;Valladolid;168;Torrecilla de la Torre;30;19;11;2017
47;Valladolid;171;Torrelobatón;433;227;206;2017
47;Valladolid;172;Torrescárcela;160;87;73;2017
47;Valladolid;173;Traspinedo;1090;594;496;2017
47;Valladolid;174;Trigueros del Valle;296;160;136;2017
47;Valladolid;175;Tudela de Duero;8551;4364;4187;2017
47;Valladolid;176;Unión de Campos, La;254;124;130;2017
47;Valladolid;177;Urones de Castroponce;109;62;47;2017
47;Valladolid;178;Urueña;192;104;88;2017
47;Valladolid;179;Valbuena de Duero;475;252;223;2017
47;Valladolid;180;Valdearcos de la Vega;71;39;32;2017
47;Valladolid;181;Valdenebro de los Valles;208;105;103;2017
47;Valladolid;182;Valdestillas;1665;870;795;2017
47;Valladolid;183;Valdunquillo;141;70;71;2017
47;Valladolid;186;Valladolid;299715;140893;158822;2017
47;Valladolid;184;Valoria la Buena;668;354;314;2017
47;Valladolid;185;Valverde de Campos;104;63;41;2017
47;Valladolid;187;Vega de Ruiponce;100;62;38;2017
47;Valladolid;188;Vega de Valdetronco;109;62;47;2017
47;Valladolid;189;Velascálvaro;166;92;74;2017
47;Valladolid;190;Velilla;113;53;60;2017
47;Valladolid;191;Velliza;108;69;39;2017
47;Valladolid;192;Ventosa de la Cuesta;110;63;47;2017
47;Valladolid;193;Viana de Cega;2021;1068;953;2017
47;Valladolid;195;Villabáñez;519;288;231;2017
47;Valladolid;196;Villabaruz de Campos;35;15;20;2017
47;Valladolid;197;Villabrágima;1040;553;487;2017
47;Valladolid;198;Villacarralón;88;51;37;2017
47;Valladolid;199;Villacid de Campos;77;48;29;2017
47;Valladolid;200;Villaco;90;57;33;2017
47;Valladolid;203;Villafrades de Campos;68;36;32;2017
47;Valladolid;204;Villafranca de Duero;279;142;137;2017
47;Valladolid;205;Villafrechós;491;266;225;2017
47;Valladolid;206;Villafuerte;86;49;37;2017
47;Valladolid;207;Villagarcía de Campos;322;187;135;2017
47;Valladolid;208;Villagómez la Nueva;65;34;31;2017
47;Valladolid;209;Villalán de Campos;39;25;14;2017
47;Valladolid;210;Villalar de los Comuneros;458;221;237;2017
47;Valladolid;211;Villalba de la Loma;54;29;25;2017
47;Valladolid;212;Villalba de los Alcores;409;221;188;2017
47;Valladolid;213;Villalbarba;121;63;58;2017
47;Valladolid;214;Villalón de Campos;1652;808;844;2017
47;Valladolid;215;Villamuriel de Campos;56;27;29;2017
47;Valladolid;216;Villán de Tordesillas;123;73;50;2017
47;Valladolid;217;Villanubla;2671;1391;1280;2017
47;Valladolid;218;Villanueva de Duero;1165;606;559;2017
47;Valladolid;219;Villanueva de la Condesa;58;31;27;2017
47;Valladolid;220;Villanueva de los Caballeros;169;85;84;2017
47;Valladolid;221;Villanueva de los Infantes;111;68;43;2017
47;Valladolid;222;Villanueva de San Mancio;84;46;38;2017
47;Valladolid;223;Villardefrades;168;94;74;2017
47;Valladolid;224;Villarmentero de Esgueva;101;55;46;2017
47;Valladolid;225;Villasexmir;79;46;33;2017
47;Valladolid;226;Villavaquerín;173;97;76;2017
47;Valladolid;227;Villavellid;61;37;24;2017
47;Valladolid;228;Villaverde de Medina;517;278;239;2017
47;Valladolid;229;Villavicencio de los Caballeros;221;112;109;2017
47;Valladolid;194;Viloria;349;180;169;2017
47;Valladolid;230;Wamba;335;178;157;2017
47;Valladolid;231;Zaratán;6201;3183;3018;2017
47;Valladolid;232;Zarza, La;116;63;53;2017
49;Zamora;002;Abezames;63;32;31;2017
49;Zamora;003;Alcañices;1076;555;521;2017
49;Zamora;004;Alcubilla de Nogales;131;71;60;2017
49;Zamora;005;Alfaraz de Sayago;136;78;58;2017
49;Zamora;006;Algodre;153;85;68;2017
49;Zamora;007;Almaraz de Duero;408;206;202;2017
49;Zamora;008;Almeida de Sayago;479;255;224;2017
49;Zamora;009;Andavías;440;229;211;2017
49;Zamora;010;Arcenillas;413;208;205;2017
49;Zamora;011;Arcos de la Polvorosa;236;127;109;2017
49;Zamora;012;Argañín;79;39;40;2017
49;Zamora;013;Argujillo;256;128;128;2017
49;Zamora;014;Arquillinos;119;61;58;2017
49;Zamora;015;Arrabalde;239;118;121;2017
49;Zamora;016;Aspariegos;262;120;142;2017
49;Zamora;017;Asturianos;257;129;128;2017
49;Zamora;018;Ayoó de Vidriales;339;173;166;2017
49;Zamora;019;Barcial del Barco;261;141;120;2017
49;Zamora;020;Belver de los Montes;291;158;133;2017
49;Zamora;021;Benavente;18237;8828;9409;2017
49;Zamora;022;Benegiles;327;172;155;2017
49;Zamora;023;Bermillo de Sayago;1057;561;496;2017
49;Zamora;024;Bóveda de Toro, La;748;373;375;2017
49;Zamora;025;Bretó;182;106;76;2017
49;Zamora;026;Bretocino;232;123;109;2017
49;Zamora;027;Brime de Sog;144;70;74;2017
49;Zamora;028;Brime de Urz;119;69;50;2017
49;Zamora;029;Burganes de Valverde;675;352;323;2017
49;Zamora;030;Bustillo del Oro;91;48;43;2017
49;Zamora;031;Cabañas de Sayago;157;85;72;2017
49;Zamora;032;Calzadilla de Tera;331;154;177;2017
49;Zamora;033;Camarzana de Tera;839;422;417;2017
49;Zamora;034;Cañizal;460;238;222;2017
49;Zamora;035;Cañizo;245;132;113;2017
49;Zamora;036;Carbajales de Alba;558;284;274;2017
49;Zamora;037;Carbellino;200;109;91;2017
49;Zamora;038;Casaseca de Campeán;101;55;46;2017
49;Zamora;039;Casaseca de las Chanas;385;209;176;2017
49;Zamora;040;Castrillo de la Guareña;123;62;61;2017
49;Zamora;041;Castrogonzalo;480;258;222;2017
49;Zamora;042;Castronuevo;233;113;120;2017
49;Zamora;043;Castroverde de Campos;318;164;154;2017
49;Zamora;044;Cazurra;82;45;37;2017
49;Zamora;046;Cerecinos de Campos;289;155;134;2017
49;Zamora;047;Cerecinos del Carrizal;139;75;64;2017
49;Zamora;048;Cernadilla;124;64;60;2017
49;Zamora;050;Cobreros;578;316;262;2017
49;Zamora;052;Coomonte;198;109;89;2017
49;Zamora;053;Coreses;1061;543;518;2017
49;Zamora;054;Corrales del Vino;1002;494;508;2017
49;Zamora;055;Cotanes del Monte;107;57;50;2017
49;Zamora;056;Cubillos;316;159;157;2017
49;Zamora;057;Cubo de Benavente;119;65;54;2017
49;Zamora;058;Cubo de Tierra del Vino, El;335;183;152;2017
49;Zamora;059;Cuelgamures;92;56;36;2017
49;Zamora;061;Entrala;160;87;73;2017
49;Zamora;062;Espadañedo;117;56;61;2017
49;Zamora;063;Faramontanos de Tábara;355;181;174;2017
49;Zamora;064;Fariza;529;278;251;2017
49;Zamora;065;Fermoselle;1262;644;618;2017
49;Zamora;066;Ferreras de Abajo;537;275;262;2017
49;Zamora;067;Ferreras de Arriba;396;214;182;2017
49;Zamora;068;Ferreruela;498;271;227;2017
49;Zamora;069;Figueruela de Arriba;357;171;186;2017
49;Zamora;071;Fonfría;789;407;382;2017
49;Zamora;075;Fresno de la Polvorosa;144;76;68;2017
49;Zamora;076;Fresno de la Ribera;376;202;174;2017
49;Zamora;077;Fresno de Sayago;193;102;91;2017
49;Zamora;078;Friera de Valverde;168;90;78;2017
49;Zamora;079;Fuente Encalada;112;62;50;2017
49;Zamora;080;Fuentelapeña;729;391;338;2017
49;Zamora;082;Fuentes de Ropel;393;198;195;2017
49;Zamora;081;Fuentesaúco;1551;772;779;2017
49;Zamora;083;Fuentesecas;51;24;27;2017
49;Zamora;084;Fuentespreadas;315;166;149;2017
49;Zamora;085;Galende;1068;552;516;2017
49;Zamora;086;Gallegos del Pan;117;69;48;2017
49;Zamora;087;Gallegos del Río;514;280;234;2017
49;Zamora;088;Gamones;98;57;41;2017
49;Zamora;090;Gema;232;114;118;2017
49;Zamora;091;Granja de Moreruela;280;146;134;2017
49;Zamora;092;Granucillo;133;65;68;2017
49;Zamora;093;Guarrate;334;172;162;2017
49;Zamora;094;Hermisende;253;133;120;2017
49;Zamora;095;Hiniesta, La;326;170;156;2017
49;Zamora;096;Jambrina;170;88;82;2017
49;Zamora;097;Justel;89;54;35;2017
49;Zamora;098;Losacino;224;122;102;2017
49;Zamora;099;Losacio;109;61;48;2017
49;Zamora;100;Lubián;313;169;144;2017
49;Zamora;101;Luelmo;158;82;76;2017
49;Zamora;102;Maderal, El;200;104;96;2017
49;Zamora;103;Madridanos;472;248;224;2017
49;Zamora;104;Mahide;334;186;148;2017
49;Zamora;105;Maire de Castroponce;152;80;72;2017
49;Zamora;107;Malva;136;63;73;2017
49;Zamora;108;Manganeses de la Lampreana;498;250;248;2017
49;Zamora;109;Manganeses de la Polvorosa;683;335;348;2017
49;Zamora;110;Manzanal de Arriba;366;197;169;2017
49;Zamora;112;Manzanal de los Infantes;127;71;56;2017
49;Zamora;111;Manzanal del Barco;130;66;64;2017
49;Zamora;113;Matilla de Arzón;170;99;71;2017
49;Zamora;114;Matilla la Seca;42;23;19;2017
49;Zamora;115;Mayalde;196;106;90;2017
49;Zamora;116;Melgar de Tera;390;201;189;2017
49;Zamora;117;Micereces de Tera;479;243;236;2017
49;Zamora;118;Milles de la Polvorosa;223;121;102;2017
49;Zamora;119;Molacillos;262;144;118;2017
49;Zamora;120;Molezuelas de la Carballeda;70;36;34;2017
49;Zamora;121;Mombuey;396;216;180;2017
49;Zamora;122;Monfarracinos;981;508;473;2017
49;Zamora;123;Montamarta;590;310;280;2017
49;Zamora;124;Moral de Sayago;269;153;116;2017
49;Zamora;126;Moraleja de Sayago;262;136;126;2017
49;Zamora;125;Moraleja del Vino;1716;875;841;2017
49;Zamora;128;Morales de Rey;582;293;289;2017
49;Zamora;129;Morales de Toro;987;517;470;2017
49;Zamora;130;Morales de Valverde;180;93;87;2017
49;Zamora;127;Morales del Vino;2950;1547;1403;2017
49;Zamora;131;Moralina;276;142;134;2017
49;Zamora;132;Moreruela de los Infanzones;353;185;168;2017
49;Zamora;133;Moreruela de Tábara;323;167;156;2017
49;Zamora;134;Muelas de los Caballeros;189;103;86;2017
49;Zamora;135;Muelas del Pan;665;341;324;2017
49;Zamora;136;Muga de Sayago;351;169;182;2017
49;Zamora;137;Navianos de Valverde;196;109;87;2017
49;Zamora;138;Olmillos de Castro;235;128;107;2017
49;Zamora;139;Otero de Bodas;175;93;82;2017
49;Zamora;141;Pajares de la Lampreana;351;177;174;2017
49;Zamora;143;Palacios de Sanabria;263;134;129;2017
49;Zamora;142;Palacios del Pan;266;137;129;2017
49;Zamora;145;Pedralba de la Pradería;261;139;122;2017
49;Zamora;146;Pego, El;305;155;150;2017
49;Zamora;147;Peleagonzalo;240;120;120;2017
49;Zamora;148;Peleas de Abajo;288;143;145;2017
49;Zamora;149;Peñausende;410;206;204;2017
49;Zamora;150;Peque;141;60;81;2017
49;Zamora;151;Perdigón, El;710;377;333;2017
49;Zamora;152;Pereruela;559;301;258;2017
49;Zamora;153;Perilla de Castro;171;88;83;2017
49;Zamora;154;Pías;135;77;58;2017
49;Zamora;155;Piedrahita de Castro;90;48;42;2017
49;Zamora;156;Pinilla de Toro;236;123;113;2017
49;Zamora;157;Pino del Oro;213;114;99;2017
49;Zamora;158;Piñero, El;238;128;110;2017
49;Zamora;160;Pobladura de Valderaduey;39;21;18;2017
49;Zamora;159;Pobladura del Valle;300;155;145;2017
49;Zamora;162;Porto;179;98;81;2017
49;Zamora;163;Pozoantiguo;224;113;111;2017
49;Zamora;164;Pozuelo de Tábara;164;84;80;2017
49;Zamora;165;Prado;57;32;25;2017
49;Zamora;166;Puebla de Sanabria;1432;700;732;2017
49;Zamora;167;Pueblica de Valverde;199;108;91;2017
49;Zamora;170;Quintanilla de Urz;105;54;51;2017
49;Zamora;168;Quintanilla del Monte;105;52;53;2017
49;Zamora;169;Quintanilla del Olmo;33;18;15;2017
49;Zamora;171;Quiruelas de Vidriales;693;351;342;2017
49;Zamora;172;Rabanales;545;283;262;2017
49;Zamora;173;Rábano de Aliste;389;191;198;2017
49;Zamora;174;Requejo;139;70;69;2017
49;Zamora;175;Revellinos;273;144;129;2017
49;Zamora;176;Riofrío de Aliste;701;383;318;2017
49;Zamora;177;Rionegro del Puente;283;147;136;2017
49;Zamora;178;Roales;889;475;414;2017
49;Zamora;179;Robleda-Cervantes;443;239;204;2017
49;Zamora;180;Roelos de Sayago;165;81;84;2017
49;Zamora;181;Rosinos de la Requejada;383;204;179;2017
49;Zamora;183;Salce;102;46;56;2017
49;Zamora;184;Samir de los Caños;174;97;77;2017
49;Zamora;185;San Agustín del Pozo;196;104;92;2017
49;Zamora;186;San Cebrián de Castro;264;131;133;2017
49;Zamora;187;San Cristóbal de Entreviñas;1417;745;672;2017
49;Zamora;188;San Esteban del Molar;128;73;55;2017
49;Zamora;189;San Justo;230;125;105;2017
49;Zamora;190;San Martín de Valderaduey;57;31;26;2017
49;Zamora;191;San Miguel de la Ribera;295;145;150;2017
49;Zamora;192;San Miguel del Valle;139;69;70;2017
49;Zamora;193;San Pedro de Ceque;484;247;237;2017
49;Zamora;194;San Pedro de la Nave-Almendra;351;181;170;2017
49;Zamora;208;San Vicente de la Cabeza;403;213;190;2017
49;Zamora;209;San Vitero;534;300;234;2017
49;Zamora;197;Santa Clara de Avedillo;176;89;87;2017
49;Zamora;199;Santa Colomba de las Monjas;270;135;135;2017
49;Zamora;200;Santa Cristina de la Polvorosa;1087;554;533;2017
49;Zamora;201;Santa Croya de Tera;316;157;159;2017
49;Zamora;202;Santa Eufemia del Barco;187;107;80;2017
49;Zamora;203;Santa María de la Vega;328;167;161;2017
49;Zamora;204;Santa María de Valverde;57;25;32;2017
49;Zamora;205;Santibáñez de Tera;393;201;192;2017
49;Zamora;206;Santibáñez de Vidriales;998;507;491;2017
49;Zamora;207;Santovenia;273;132;141;2017
49;Zamora;210;Sanzoles;524;265;259;2017
49;Zamora;214;Tábara;787;407;380;2017
49;Zamora;216;Tapioles;160;94;66;2017
49;Zamora;219;Toro;8974;4380;4594;2017
49;Zamora;220;Torre del Valle, La;152;80;72;2017
49;Zamora;221;Torregamones;286;150;136;2017
49;Zamora;222;Torres del Carrizal;418;211;207;2017
49;Zamora;223;Trabazos;913;474;439;2017
49;Zamora;224;Trefacio;183;93;90;2017
49;Zamora;225;Uña de Quintana;141;74;67;2017
49;Zamora;226;Vadillo de la Guareña;266;143;123;2017
49;Zamora;227;Valcabado;370;192;178;2017
49;Zamora;228;Valdefinjas;51;31;20;2017
49;Zamora;229;Valdescorriel;140;68;72;2017
49;Zamora;230;Vallesa de la Guareña;90;48;42;2017
49;Zamora;231;Vega de Tera;360;175;185;2017
49;Zamora;232;Vega de Villalobos;115;53;62;2017
49;Zamora;233;Vegalatrave;98;54;44;2017
49;Zamora;234;Venialbo;453;247;206;2017
49;Zamora;235;Vezdemarbán;404;202;202;2017
49;Zamora;236;Vidayanes;94;48;46;2017
49;Zamora;237;Videmala;168;87;81;2017
49;Zamora;238;Villabrázaro;216;113;103;2017
49;Zamora;239;Villabuena del Puente;715;366;349;2017
49;Zamora;240;Villadepera;220;117;103;2017
49;Zamora;241;Villaescusa;256;141;115;2017
49;Zamora;242;Villafáfila;493;256;237;2017
49;Zamora;243;Villaferrueña;112;57;55;2017
49;Zamora;244;Villageriz;48;29;19;2017
49;Zamora;245;Villalazán;280;137;143;2017
49;Zamora;246;Villalba de la Lampreana;242;134;108;2017
49;Zamora;247;Villalcampo;455;225;230;2017
49;Zamora;248;Villalobos;255;127;128;2017
49;Zamora;249;Villalonso;81;44;37;2017
49;Zamora;250;Villalpando;1501;740;761;2017
49;Zamora;251;Villalube;164;86;78;2017
49;Zamora;252;Villamayor de Campos;310;158;152;2017
49;Zamora;255;Villamor de los Escuderos;402;213;189;2017
49;Zamora;256;Villanázar;299;156;143;2017
49;Zamora;257;Villanueva de Azoague;340;174;166;2017
49;Zamora;258;Villanueva de Campeán;116;67;49;2017
49;Zamora;259;Villanueva de las Peras;83;44;39;2017
49;Zamora;260;Villanueva del Campo;874;431;443;2017
49;Zamora;263;Villar de Fallaves;46;25;21;2017
49;Zamora;264;Villar del Buey;606;315;291;2017
49;Zamora;261;Villaralbo;1866;949;917;2017
49;Zamora;262;Villardeciervos;429;212;217;2017
49;Zamora;265;Villardiegua de la Ribera;134;67;67;2017
49;Zamora;266;Villárdiga;79;45;34;2017
49;Zamora;267;Villardondiego;95;52;43;2017
49;Zamora;268;Villarrín de Campos;411;223;188;2017
49;Zamora;269;Villaseco del Pan;235;110;125;2017
49;Zamora;270;Villavendimio;172;102;70;2017
49;Zamora;272;Villaveza de Valverde;87;44;43;2017
49;Zamora;271;Villaveza del Agua;195;109;86;2017
49;Zamora;273;Viñas;197;101;96;2017
49;Zamora;275;Zamora;62389;29072;33317;2017
50;Zaragoza;001;Abanto;98;57;41;2017
50;Zaragoza;002;Acered;171;96;75;2017
50;Zaragoza;003;Agón;146;82;64;2017
50;Zaragoza;004;Aguarón;684;357;327;2017
50;Zaragoza;005;Aguilón;238;128;110;2017
50;Zaragoza;006;Ainzón;1095;555;540;2017
50;Zaragoza;007;Aladrén;47;32;15;2017
50;Zaragoza;008;Alagón;7025;3485;3540;2017
50;Zaragoza;009;Alarba;144;84;60;2017
50;Zaragoza;010;Alberite de San Juan;77;45;32;2017
50;Zaragoza;011;Albeta;134;66;68;2017
50;Zaragoza;012;Alborge;105;55;50;2017
50;Zaragoza;013;Alcalá de Ebro;270;127;143;2017
50;Zaragoza;014;Alcalá de Moncayo;152;88;64;2017
50;Zaragoza;015;Alconchel de Ariza;70;38;32;2017
50;Zaragoza;016;Aldehuela de Liestos;53;37;16;2017
50;Zaragoza;017;Alfajarín;2288;1179;1109;2017
50;Zaragoza;018;Alfamén;1460;767;693;2017
50;Zaragoza;019;Alforque;57;34;23;2017
50;Zaragoza;020;Alhama de Aragón;1053;544;509;2017
50;Zaragoza;021;Almochuel;30;13;17;2017
50;Zaragoza;022;Almolda, La;562;284;278;2017
50;Zaragoza;023;Almonacid de la Cuba;260;129;131;2017
50;Zaragoza;024;Almonacid de la Sierra;701;393;308;2017
50;Zaragoza;025;Almunia de Doña Godina, La;7660;3897;3763;2017
50;Zaragoza;026;Alpartir;546;274;272;2017
50;Zaragoza;027;Ambel;254;122;132;2017
50;Zaragoza;028;Anento;93;59;34;2017
50;Zaragoza;029;Aniñón;723;391;332;2017
50;Zaragoza;030;Añón de Moncayo;200;118;82;2017
50;Zaragoza;031;Aranda de Moncayo;174;110;64;2017
50;Zaragoza;032;Arándiga;308;159;149;2017
50;Zaragoza;033;Ardisa;72;44;28;2017
50;Zaragoza;034;Ariza;1133;578;555;2017
50;Zaragoza;035;Artieda;75;44;31;2017
50;Zaragoza;036;Asín;102;53;49;2017
50;Zaragoza;037;Atea;145;91;54;2017
50;Zaragoza;038;Ateca;1825;942;883;2017
50;Zaragoza;039;Azuara;551;308;243;2017
50;Zaragoza;040;Badules;87;49;38;2017
50;Zaragoza;041;Bagüés;11;8;3;2017
50;Zaragoza;042;Balconchán;16;5;11;2017
50;Zaragoza;043;Bárboles;312;170;142;2017
50;Zaragoza;044;Bardallur;258;124;134;2017
50;Zaragoza;045;Belchite;1526;770;756;2017
50;Zaragoza;046;Belmonte de Gracián;206;115;91;2017
50;Zaragoza;047;Berdejo;51;34;17;2017
50;Zaragoza;048;Berrueco;33;19;14;2017
50;Zaragoza;901;Biel;133;83;50;2017
50;Zaragoza;050;Bijuesca;99;63;36;2017
50;Zaragoza;051;Biota;959;488;471;2017
50;Zaragoza;052;Bisimbre;99;56;43;2017
50;Zaragoza;053;Boquiñeni;844;420;424;2017
50;Zaragoza;054;Bordalba;58;38;20;2017
50;Zaragoza;055;Borja;4946;2505;2441;2017
50;Zaragoza;056;Botorrita;506;273;233;2017
50;Zaragoza;057;Brea de Aragón;1682;852;830;2017
50;Zaragoza;058;Bubierca;66;36;30;2017
50;Zaragoza;059;Bujaraloz;1001;524;477;2017
50;Zaragoza;060;Bulbuente;218;122;96;2017
50;Zaragoza;061;Bureta;222;115;107;2017
50;Zaragoza;062;Burgo de Ebro, El;2431;1226;1205;2017
50;Zaragoza;063;Buste, El;68;37;31;2017
50;Zaragoza;064;Cabañas de Ebro;501;263;238;2017
50;Zaragoza;065;Cabolafuente;34;19;15;2017
50;Zaragoza;066;Cadrete;3749;1990;1759;2017
50;Zaragoza;067;Calatayud;20173;9932;10241;2017
50;Zaragoza;068;Calatorao;2845;1501;1344;2017
50;Zaragoza;069;Calcena;75;44;31;2017
50;Zaragoza;070;Calmarza;64;36;28;2017
50;Zaragoza;071;Campillo de Aragón;155;83;72;2017
50;Zaragoza;072;Carenas;174;90;84;2017
50;Zaragoza;073;Cariñena;3339;1683;1656;2017
50;Zaragoza;074;Caspe;9491;4913;4578;2017
50;Zaragoza;075;Castejón de Alarba;91;56;35;2017
50;Zaragoza;076;Castejón de las Armas;87;50;37;2017
50;Zaragoza;077;Castejón de Valdejasa;221;113;108;2017
50;Zaragoza;078;Castiliscar;262;139;123;2017
50;Zaragoza;079;Cervera de la Cañada;286;158;128;2017
50;Zaragoza;080;Cerveruela;38;24;14;2017
50;Zaragoza;081;Cetina;606;310;296;2017
50;Zaragoza;092;Chiprana;481;249;232;2017
50;Zaragoza;093;Chodes;112;62;50;2017
50;Zaragoza;082;Cimballa;103;55;48;2017
50;Zaragoza;083;Cinco Olivas;114;54;60;2017
50;Zaragoza;084;Clarés de Ribota;72;43;29;2017
50;Zaragoza;085;Codo;191;99;92;2017
50;Zaragoza;086;Codos;198;125;73;2017
50;Zaragoza;087;Contamina;35;21;14;2017
50;Zaragoza;088;Cosuenda;372;199;173;2017
50;Zaragoza;089;Cuarte de Huerva;12862;6569;6293;2017
50;Zaragoza;090;Cubel;175;83;92;2017
50;Zaragoza;091;Cuerlas, Las;44;23;21;2017
50;Zaragoza;094;Daroca;2044;1010;1034;2017
50;Zaragoza;095;Ejea de los Caballeros;16596;8465;8131;2017
50;Zaragoza;096;Embid de Ariza;39;19;20;2017
50;Zaragoza;098;Encinacorba;198;105;93;2017
50;Zaragoza;099;Épila;4413;2285;2128;2017
50;Zaragoza;100;Erla;354;178;176;2017
50;Zaragoza;101;Escatrón;1046;519;527;2017
50;Zaragoza;102;Fabara;1172;625;547;2017
50;Zaragoza;104;Farlete;391;192;199;2017
50;Zaragoza;105;Fayón;347;179;168;2017
50;Zaragoza;106;Fayos, Los;136;77;59;2017
50;Zaragoza;107;Figueruelas;1230;611;619;2017
50;Zaragoza;108;Fombuena;52;32;20;2017
50;Zaragoza;109;Frago, El;107;67;40;2017
50;Zaragoza;110;Frasno, El;386;209;177;2017
50;Zaragoza;111;Fréscano;203;108;95;2017
50;Zaragoza;113;Fuendejalón;817;428;389;2017
50;Zaragoza;114;Fuendetodos;126;71;55;2017
50;Zaragoza;115;Fuentes de Ebro;4554;2369;2185;2017
50;Zaragoza;116;Fuentes de Jiloca;245;131;114;2017
50;Zaragoza;117;Gallocanta;162;91;71;2017
50;Zaragoza;118;Gallur;2643;1334;1309;2017
50;Zaragoza;119;Gelsa;1055;551;504;2017
50;Zaragoza;120;Godojos;52;27;25;2017
50;Zaragoza;121;Gotor;314;168;146;2017
50;Zaragoza;122;Grisel;75;46;29;2017
50;Zaragoza;123;Grisén;625;318;307;2017
50;Zaragoza;124;Herrera de los Navarros;526;279;247;2017
50;Zaragoza;125;Ibdes;413;218;195;2017
50;Zaragoza;126;Illueca;3044;1507;1537;2017
50;Zaragoza;128;Isuerre;31;19;12;2017
50;Zaragoza;129;Jaraba;301;157;144;2017
50;Zaragoza;130;Jarque;448;245;203;2017
50;Zaragoza;131;Jaulín;250;134;116;2017
50;Zaragoza;132;Joyosa, La;1058;548;510;2017
50;Zaragoza;133;Lagata;119;67;52;2017
50;Zaragoza;134;Langa del Castillo;133;66;67;2017
50;Zaragoza;135;Layana;105;60;45;2017
50;Zaragoza;136;Lécera;687;382;305;2017
50;Zaragoza;138;Lechón;51;30;21;2017
50;Zaragoza;137;Leciñena;1199;611;588;2017
50;Zaragoza;139;Letux;349;197;152;2017
50;Zaragoza;140;Litago;171;95;76;2017
50;Zaragoza;141;Lituénigo;119;62;57;2017
50;Zaragoza;142;Lobera de Onsella;30;16;14;2017
50;Zaragoza;143;Longares;798;448;350;2017
50;Zaragoza;144;Longás;32;21;11;2017
50;Zaragoza;146;Lucena de Jalón;237;132;105;2017
50;Zaragoza;147;Luceni;971;490;481;2017
50;Zaragoza;148;Luesia;310;169;141;2017
50;Zaragoza;149;Luesma;34;21;13;2017
50;Zaragoza;150;Lumpiaque;834;423;411;2017
50;Zaragoza;151;Luna;726;383;343;2017
50;Zaragoza;152;Maella;2004;1083;921;2017
50;Zaragoza;153;Magallón;1150;597;553;2017
50;Zaragoza;154;Mainar;151;81;70;2017
50;Zaragoza;155;Malanquilla;105;66;39;2017
50;Zaragoza;156;Maleján;254;130;124;2017
50;Zaragoza;160;Mallén;3140;1631;1509;2017
50;Zaragoza;157;Malón;349;178;171;2017
50;Zaragoza;159;Maluenda;951;456;495;2017
50;Zaragoza;161;Manchones;99;57;42;2017
50;Zaragoza;162;Mara;185;94;91;2017
50;Zaragoza;163;María de Huerva;5619;2868;2751;2017
50;Zaragoza;902;Marracos;89;50;39;2017
50;Zaragoza;164;Mediana de Aragón;468;226;242;2017
50;Zaragoza;165;Mequinenza;2329;1193;1136;2017
50;Zaragoza;166;Mesones de Isuela;274;137;137;2017
50;Zaragoza;167;Mezalocha;248;143;105;2017
50;Zaragoza;168;Mianos;32;20;12;2017
50;Zaragoza;169;Miedes de Aragón;454;239;215;2017
50;Zaragoza;170;Monegrillo;419;234;185;2017
50;Zaragoza;171;Moneva;103;63;40;2017
50;Zaragoza;172;Monreal de Ariza;208;118;90;2017
50;Zaragoza;173;Monterde;168;101;67;2017
50;Zaragoza;174;Montón;94;55;39;2017
50;Zaragoza;175;Morata de Jalón;1146;556;590;2017
50;Zaragoza;176;Morata de Jiloca;282;162;120;2017
50;Zaragoza;177;Morés;335;178;157;2017
50;Zaragoza;178;Moros;364;185;179;2017
50;Zaragoza;179;Moyuela;258;136;122;2017
50;Zaragoza;180;Mozota;136;66;70;2017
50;Zaragoza;181;Muel;1324;683;641;2017
50;Zaragoza;182;Muela, La;5238;2737;2501;2017
50;Zaragoza;183;Munébrega;403;219;184;2017
50;Zaragoza;184;Murero;119;68;51;2017
50;Zaragoza;185;Murillo de Gállego;175;103;72;2017
50;Zaragoza;186;Navardún;41;25;16;2017
50;Zaragoza;187;Nigüella;69;41;28;2017
50;Zaragoza;188;Nombrevilla;31;18;13;2017
50;Zaragoza;189;Nonaspe;964;513;451;2017
50;Zaragoza;190;Novallas;838;445;393;2017
50;Zaragoza;191;Novillas;546;273;273;2017
50;Zaragoza;192;Nuévalos;332;180;152;2017
50;Zaragoza;193;Nuez de Ebro;838;425;413;2017
50;Zaragoza;194;Olvés;104;62;42;2017
50;Zaragoza;195;Orcajo;57;37;20;2017
50;Zaragoza;196;Orera;120;63;57;2017
50;Zaragoza;197;Orés;106;63;43;2017
50;Zaragoza;198;Oseja;55;35;20;2017
50;Zaragoza;199;Osera de Ebro;396;195;201;2017
50;Zaragoza;200;Paniza;650;340;310;2017
50;Zaragoza;201;Paracuellos de Jiloca;583;305;278;2017
50;Zaragoza;202;Paracuellos de la Ribera;171;91;80;2017
50;Zaragoza;203;Pastriz;1314;624;690;2017
50;Zaragoza;204;Pedrola;3453;1784;1669;2017
50;Zaragoza;205;Pedrosas, Las;106;52;54;2017
50;Zaragoza;206;Perdiguera;596;318;278;2017
50;Zaragoza;207;Piedratajada;110;57;53;2017
50;Zaragoza;208;Pina de Ebro;2435;1241;1194;2017
50;Zaragoza;209;Pinseque;3850;1991;1859;2017
50;Zaragoza;210;Pintanos, Los;37;23;14;2017
50;Zaragoza;211;Plasencia de Jalón;315;176;139;2017
50;Zaragoza;212;Pleitas;41;16;25;2017
50;Zaragoza;213;Plenas;102;56;46;2017
50;Zaragoza;214;Pomer;27;18;9;2017
50;Zaragoza;215;Pozuel de Ariza;23;13;10;2017
50;Zaragoza;216;Pozuelo de Aragón;281;152;129;2017
50;Zaragoza;217;Pradilla de Ebro;562;300;262;2017
50;Zaragoza;218;Puebla de Albortón;122;77;45;2017
50;Zaragoza;219;Puebla de Alfindén, La;6109;3123;2986;2017
50;Zaragoza;220;Puendeluna;46;26;20;2017
50;Zaragoza;221;Purujosa;37;26;11;2017
50;Zaragoza;222;Quinto;1960;999;961;2017
50;Zaragoza;223;Remolinos;1088;556;532;2017
50;Zaragoza;224;Retascón;73;44;29;2017
50;Zaragoza;225;Ricla;2894;1519;1375;2017
50;Zaragoza;227;Romanos;119;65;54;2017
50;Zaragoza;228;Rueda de Jalón;316;173;143;2017
50;Zaragoza;229;Ruesca;72;37;35;2017
50;Zaragoza;241;Sabiñán;699;375;324;2017
50;Zaragoza;230;Sádaba;1347;690;657;2017
50;Zaragoza;231;Salillas de Jalón;305;157;148;2017
50;Zaragoza;232;Salvatierra de Esca;212;100;112;2017
50;Zaragoza;233;Samper del Salz;112;63;49;2017
50;Zaragoza;234;San Martín de la Virgen de Moncayo;287;160;127;2017
50;Zaragoza;235;San Mateo de Gállego;3077;1579;1498;2017
50;Zaragoza;236;Santa Cruz de Grío;118;70;48;2017
50;Zaragoza;237;Santa Cruz de Moncayo;121;63;58;2017
50;Zaragoza;238;Santa Eulalia de Gállego;99;53;46;2017
50;Zaragoza;239;Santed;63;41;22;2017
50;Zaragoza;240;Sástago;1175;594;581;2017
50;Zaragoza;242;Sediles;100;62;38;2017
50;Zaragoza;243;Sestrica;387;220;167;2017
50;Zaragoza;244;Sierra de Luna;250;132;118;2017
50;Zaragoza;245;Sigüés;94;50;44;2017
50;Zaragoza;246;Sisamón;33;22;11;2017
50;Zaragoza;247;Sobradiel;1074;512;562;2017
50;Zaragoza;248;Sos del Rey Católico;588;309;279;2017
50;Zaragoza;249;Tabuenca;331;190;141;2017
50;Zaragoza;250;Talamantes;52;26;26;2017
50;Zaragoza;251;Tarazona;10538;5202;5336;2017
50;Zaragoza;252;Tauste;6892;3430;3462;2017
50;Zaragoza;253;Terrer;479;258;221;2017
50;Zaragoza;254;Tierga;190;103;87;2017
50;Zaragoza;255;Tobed;224;118;106;2017
50;Zaragoza;256;Torralba de los Frailes;88;46;42;2017
50;Zaragoza;257;Torralba de Ribota;181;103;78;2017
50;Zaragoza;258;Torralbilla;57;33;24;2017
50;Zaragoza;259;Torrehermosa;65;36;29;2017
50;Zaragoza;260;Torrelapaja;34;21;13;2017
50;Zaragoza;261;Torrellas;254;133;121;2017
50;Zaragoza;262;Torres de Berrellén;1469;766;703;2017
50;Zaragoza;263;Torrijo de la Cañada;210;118;92;2017
50;Zaragoza;264;Tosos;192;106;86;2017
50;Zaragoza;265;Trasmoz;86;49;37;2017
50;Zaragoza;266;Trasobares;121;74;47;2017
50;Zaragoza;267;Uncastillo;662;311;351;2017
50;Zaragoza;268;Undués de Lerda;59;32;27;2017
50;Zaragoza;269;Urrea de Jalón;402;215;187;2017
50;Zaragoza;270;Urriés;38;20;18;2017
50;Zaragoza;271;Used;276;153;123;2017
50;Zaragoza;272;Utebo;18593;9239;9354;2017
50;Zaragoza;274;Val de San Martín;65;37;28;2017
50;Zaragoza;273;Valdehorna;30;15;15;2017
50;Zaragoza;275;Valmadrid;124;75;49;2017
50;Zaragoza;276;Valpalmas;135;64;71;2017
50;Zaragoza;277;Valtorres;64;31;33;2017
50;Zaragoza;278;Velilla de Ebro;224;120;104;2017
50;Zaragoza;279;Velilla de Jiloca;100;49;51;2017
50;Zaragoza;280;Vera de Moncayo;375;191;184;2017
50;Zaragoza;281;Vierlas;73;39;34;2017
50;Zaragoza;283;Villadoz;90;52;38;2017
50;Zaragoza;284;Villafeliche;168;89;79;2017
50;Zaragoza;285;Villafranca de Ebro;821;403;418;2017
50;Zaragoza;286;Villalba de Perejil;93;47;46;2017
50;Zaragoza;287;Villalengua;324;176;148;2017
50;Zaragoza;903;Villamayor de Gállego;2721;1365;1356;2017
50;Zaragoza;288;Villanueva de Gállego;4656;2365;2291;2017
50;Zaragoza;290;Villanueva de Huerva;462;239;223;2017
50;Zaragoza;289;Villanueva de Jiloca;52;25;27;2017
50;Zaragoza;291;Villar de los Navarros;102;57;45;2017
50;Zaragoza;292;Villarreal de Huerva;260;145;115;2017
50;Zaragoza;293;Villarroya de la Sierra;467;244;223;2017
50;Zaragoza;294;Villarroya del Campo;71;37;34;2017
50;Zaragoza;282;Vilueña, La;88;45;43;2017
50;Zaragoza;295;Vistabella;50;28;22;2017
50;Zaragoza;296;Zaida, La;463;230;233;2017
50;Zaragoza;297;Zaragoza;664938;318419;346519;2017
50;Zaragoza;298;Zuera;8253;4268;3985;2017
51;Ceuta;001;Ceuta;84959;43034;41925;2017
52;Melilla;001;Melilla;86120;43629;42491;2017
02;Albacete;001;Abengibre;757;363;394;2018
02;Albacete;002;Alatoz;529;300;229;2018
02;Albacete;003;Albacete;173050;84613;88437;2018
02;Albacete;004;Albatana;693;357;336;2018
02;Albacete;005;Alborea;650;339;311;2018
02;Albacete;006;Alcadozo;655;356;299;2018
02;Albacete;007;Alcalá del Júcar;1199;639;560;2018
02;Albacete;008;Alcaraz;1405;724;681;2018
02;Albacete;009;Almansa;24537;12215;12322;2018
02;Albacete;010;Alpera;2275;1183;1092;2018
02;Albacete;011;Ayna;638;341;297;2018
02;Albacete;012;Balazote;2360;1205;1155;2018
02;Albacete;014;Ballestero, El;409;208;201;2018
02;Albacete;013;Balsa de Ves;150;85;65;2018
02;Albacete;015;Barrax;1864;941;923;2018
02;Albacete;016;Bienservida;610;326;284;2018
02;Albacete;017;Bogarra;873;462;411;2018
02;Albacete;018;Bonete;1057;538;519;2018
02;Albacete;019;Bonillo, El;2837;1447;1390;2018
02;Albacete;020;Carcelén;508;279;229;2018
02;Albacete;021;Casas de Juan Núñez;1275;669;606;2018
02;Albacete;022;Casas de Lázaro;344;194;150;2018
02;Albacete;023;Casas de Ves;588;311;277;2018
02;Albacete;024;Casas-Ibáñez;4522;2291;2231;2018
02;Albacete;025;Caudete;10003;5089;4914;2018
02;Albacete;026;Cenizate;1182;601;581;2018
02;Albacete;029;Chinchilla de Monte-Aragón;4182;2183;1999;2018
02;Albacete;027;Corral-Rubio;330;177;153;2018
02;Albacete;028;Cotillas;128;64;64;2018
02;Albacete;030;Elche de la Sierra;3624;1819;1805;2018
02;Albacete;031;Férez;674;327;347;2018
02;Albacete;032;Fuensanta;297;168;129;2018
02;Albacete;033;Fuente-Álamo;2489;1303;1186;2018
02;Albacete;034;Fuentealbilla;1816;912;904;2018
02;Albacete;035;Gineta, La;2448;1259;1189;2018
02;Albacete;036;Golosalvo;110;58;52;2018
02;Albacete;037;Hellín;30268;15124;15144;2018
02;Albacete;038;Herrera, La;349;181;168;2018
02;Albacete;039;Higueruela;1184;610;574;2018
02;Albacete;040;Hoya-Gonzalo;621;332;289;2018
02;Albacete;041;Jorquera;360;195;165;2018
02;Albacete;042;Letur;928;448;480;2018
02;Albacete;043;Lezuza;1398;721;677;2018
02;Albacete;044;Liétor;1200;626;574;2018
02;Albacete;045;Madrigueras;4665;2387;2278;2018
02;Albacete;046;Mahora;1359;698;661;2018
02;Albacete;047;Masegoso;113;62;51;2018
02;Albacete;048;Minaya;1537;799;738;2018
02;Albacete;049;Molinicos;840;435;405;2018
02;Albacete;050;Montalvos;96;53;43;2018
02;Albacete;051;Montealegre del Castillo;2042;1036;1006;2018
02;Albacete;052;Motilleja;548;292;256;2018
02;Albacete;053;Munera;3513;1793;1720;2018
02;Albacete;054;Navas de Jorquera;518;271;247;2018
02;Albacete;055;Nerpio;1222;676;546;2018
02;Albacete;056;Ontur;2028;1022;1006;2018
02;Albacete;057;Ossa de Montiel;2352;1169;1183;2018
02;Albacete;058;Paterna del Madera;360;194;166;2018
02;Albacete;060;Peñas de San Pedro;1420;832;588;2018
02;Albacete;059;Peñascosa;331;181;150;2018
02;Albacete;061;Pétrola;696;359;337;2018
02;Albacete;062;Povedilla;446;247;199;2018
02;Albacete;901;Pozo Cañada;2786;1401;1385;2018
02;Albacete;063;Pozohondo;1635;853;782;2018
02;Albacete;064;Pozo-Lorente;401;205;196;2018
02;Albacete;065;Pozuelo;489;258;231;2018
02;Albacete;066;Recueja, La;254;133;121;2018
02;Albacete;067;Riópar;1357;696;661;2018
02;Albacete;068;Robledo;363;200;163;2018
02;Albacete;069;Roda, La;15515;7835;7680;2018
02;Albacete;070;Salobre;501;265;236;2018
02;Albacete;071;San Pedro;1153;587;566;2018
02;Albacete;072;Socovos;1790;920;870;2018
02;Albacete;073;Tarazona de la Mancha;6255;3198;3057;2018
02;Albacete;074;Tobarra;7738;3955;3783;2018
02;Albacete;075;Valdeganga;1943;1004;939;2018
02;Albacete;076;Vianos;355;179;176;2018
02;Albacete;077;Villa de Ves;57;34;23;2018
02;Albacete;078;Villalgordo del Júcar;1115;585;530;2018
02;Albacete;079;Villamalea;4112;2077;2035;2018
02;Albacete;080;Villapalacios;589;307;282;2018
02;Albacete;081;Villarrobledo;25241;12463;12778;2018
02;Albacete;082;Villatoya;95;58;37;2018
02;Albacete;083;Villavaliente;226;137;89;2018
02;Albacete;084;Villaverde de Guadalimar;340;174;166;2018
02;Albacete;085;Viveros;340;174;166;2018
02;Albacete;086;Yeste;2674;1371;1303;2018
03;Alicante/Alacant;002;Agost;4713;2344;2369;2018
03;Alicante/Alacant;003;Agres;551;294;257;2018
03;Alicante/Alacant;004;Aigües;936;493;443;2018
03;Alicante/Alacant;005;Albatera;12042;6172;5870;2018
03;Alicante/Alacant;006;Alcalalí;1298;645;653;2018
03;Alicante/Alacant;007;Alcocer de Planes;229;115;114;2018
03;Alicante/Alacant;008;Alcoleja;180;94;86;2018
03;Alicante/Alacant;009;Alcoy/Alcoi;58977;28806;30171;2018
03;Alicante/Alacant;010;Alfafara;407;198;209;2018
03;Alicante/Alacant;011;Alfàs del Pi, l';20053;9947;10106;2018
03;Alicante/Alacant;012;Algorfa;2838;1427;1411;2018
03;Alicante/Alacant;013;Algueña;1341;671;670;2018
03;Alicante/Alacant;014;Alicante/Alacant;331577;160595;170982;2018
03;Alicante/Alacant;015;Almoradí;20542;10398;10144;2018
03;Alicante/Alacant;016;Almudaina;104;54;50;2018
03;Alicante/Alacant;017;Alqueria d'Asnar, l';491;237;254;2018
03;Alicante/Alacant;018;Altea;21995;10756;11239;2018
03;Alicante/Alacant;019;Aspe;20537;10324;10213;2018
03;Alicante/Alacant;001;Atzúbia, l';661;346;315;2018
03;Alicante/Alacant;020;Balones;122;65;57;2018
03;Alicante/Alacant;021;Banyeres de Mariola;7113;3562;3551;2018
03;Alicante/Alacant;022;Benasau;156;77;79;2018
03;Alicante/Alacant;023;Beneixama;1703;866;837;2018
03;Alicante/Alacant;024;Benejúzar;5361;2689;2672;2018
03;Alicante/Alacant;025;Benferri;1940;1011;929;2018
03;Alicante/Alacant;026;Beniarbeig;1983;1005;978;2018
03;Alicante/Alacant;027;Beniardá;178;89;89;2018
03;Alicante/Alacant;028;Beniarrés;1118;566;552;2018
03;Alicante/Alacant;030;Benidoleig;1110;556;554;2018
03;Alicante/Alacant;031;Benidorm;67558;33581;33977;2018
03;Alicante/Alacant;032;Benifallim;108;59;49;2018
03;Alicante/Alacant;033;Benifato;149;74;75;2018
03;Alicante/Alacant;029;Benigembla;444;228;216;2018
03;Alicante/Alacant;034;Benijófar;3357;1634;1723;2018
03;Alicante/Alacant;035;Benilloba;742;384;358;2018
03;Alicante/Alacant;036;Benillup;94;43;51;2018
03;Alicante/Alacant;037;Benimantell;490;241;249;2018
03;Alicante/Alacant;038;Benimarfull;413;205;208;2018
03;Alicante/Alacant;039;Benimassot;96;55;41;2018
03;Alicante/Alacant;040;Benimeli;410;190;220;2018
03;Alicante/Alacant;041;Benissa;10768;5264;5504;2018
03;Alicante/Alacant;042;Benitachell/Poble Nou de Benitatxell, el;4130;2039;2091;2018
03;Alicante/Alacant;043;Biar;3651;1792;1859;2018
03;Alicante/Alacant;044;Bigastro;6702;3380;3322;2018
03;Alicante/Alacant;045;Bolulla;418;221;197;2018
03;Alicante/Alacant;046;Busot;2925;1498;1427;2018
03;Alicante/Alacant;049;Callosa de Segura;18864;9602;9262;2018
03;Alicante/Alacant;048;Callosa d'en Sarrià;7257;3708;3549;2018
03;Alicante/Alacant;047;Calp;21633;10900;10733;2018
03;Alicante/Alacant;050;Campello, el;27893;13565;14328;2018
03;Alicante/Alacant;051;Campo de Mirra/Camp de Mirra, el;428;218;210;2018
03;Alicante/Alacant;052;Cañada;1214;609;605;2018
03;Alicante/Alacant;053;Castalla;9880;5016;4864;2018
03;Alicante/Alacant;054;Castell de Castells;435;223;212;2018
03;Alicante/Alacant;075;Castell de Guadalest, el;209;104;105;2018
03;Alicante/Alacant;055;Catral;8631;4319;4312;2018
03;Alicante/Alacant;056;Cocentaina;11456;5822;5634;2018
03;Alicante/Alacant;057;Confrides;208;118;90;2018
03;Alicante/Alacant;058;Cox;7226;3698;3528;2018
03;Alicante/Alacant;059;Crevillent;28957;14640;14317;2018
03;Alicante/Alacant;061;Daya Nueva;1718;850;868;2018
03;Alicante/Alacant;062;Daya Vieja;685;356;329;2018
03;Alicante/Alacant;063;Dénia;41733;20245;21488;2018
03;Alicante/Alacant;064;Dolores;7383;3689;3694;2018
03;Alicante/Alacant;065;Elche/Elx;230625;114332;116293;2018
03;Alicante/Alacant;066;Elda;52404;25549;26855;2018
03;Alicante/Alacant;067;Facheca;101;52;49;2018
03;Alicante/Alacant;068;Famorca;53;29;24;2018
03;Alicante/Alacant;069;Finestrat;6381;3231;3150;2018
03;Alicante/Alacant;077;Fondó de les Neus, el/Hondón de las Nieves;2474;1256;1218;2018
03;Alicante/Alacant;070;Formentera del Segura;4131;2069;2062;2018
03;Alicante/Alacant;072;Gaianes;471;241;230;2018
03;Alicante/Alacant;071;Gata de Gorgos;5893;2974;2919;2018
03;Alicante/Alacant;073;Gorga;258;144;114;2018
03;Alicante/Alacant;074;Granja de Rocamora;2489;1310;1179;2018
03;Alicante/Alacant;076;Guardamar del Segura;15058;7358;7700;2018
03;Alicante/Alacant;078;Hondón de los Frailes;1132;585;547;2018
03;Alicante/Alacant;079;Ibi;23403;11720;11683;2018
03;Alicante/Alacant;080;Jacarilla;1986;1009;977;2018
03;Alicante/Alacant;082;Jávea/Xàbia;27224;13528;13696;2018
03;Alicante/Alacant;083;Jijona/Xixona;6875;3342;3533;2018
03;Alicante/Alacant;085;Llíber;1051;529;522;2018
03;Alicante/Alacant;084;Lorcha/Orxa, l';596;293;303;2018
03;Alicante/Alacant;086;Millena;229;122;107;2018
03;Alicante/Alacant;088;Monforte del Cid;7944;4172;3772;2018
03;Alicante/Alacant;089;Monóvar/Monòver;12175;6077;6098;2018
03;Alicante/Alacant;903;Montesinos, Los;4844;2453;2391;2018
03;Alicante/Alacant;091;Murla;493;233;260;2018
03;Alicante/Alacant;092;Muro de Alcoy;9328;4627;4701;2018
03;Alicante/Alacant;090;Mutxamel;25009;12458;12551;2018
03;Alicante/Alacant;093;Novelda;25725;12803;12922;2018
03;Alicante/Alacant;094;Nucia, la;18242;9205;9037;2018
03;Alicante/Alacant;095;Ondara;6815;3418;3397;2018
03;Alicante/Alacant;096;Onil;7475;3734;3741;2018
03;Alicante/Alacant;097;Orba;2111;1036;1075;2018
03;Alicante/Alacant;099;Orihuela;76778;38144;38634;2018
03;Alicante/Alacant;098;Orxeta;738;373;365;2018
03;Alicante/Alacant;100;Parcent;908;443;465;2018
03;Alicante/Alacant;101;Pedreguer;7490;3717;3773;2018
03;Alicante/Alacant;102;Pego;10052;5036;5016;2018
03;Alicante/Alacant;103;Penàguila;301;158;143;2018
03;Alicante/Alacant;104;Petrer;34479;17121;17358;2018
03;Alicante/Alacant;902;Pilar de la Horadada;21418;10981;10437;2018
03;Alicante/Alacant;105;Pinós, el/Pinoso;7845;3962;3883;2018
03;Alicante/Alacant;106;Planes;713;387;326;2018
03;Alicante/Alacant;901;Poblets, els;2864;1360;1504;2018
03;Alicante/Alacant;107;Polop;4850;2499;2351;2018
03;Alicante/Alacant;060;Quatretondeta;121;68;53;2018
03;Alicante/Alacant;109;Rafal;4418;2207;2211;2018
03;Alicante/Alacant;110;Ràfol d'Almúnia, el;644;328;316;2018
03;Alicante/Alacant;111;Redován;7797;4007;3790;2018
03;Alicante/Alacant;112;Relleu;1147;589;558;2018
03;Alicante/Alacant;113;Rojales;16560;8393;8167;2018
03;Alicante/Alacant;114;Romana, la;2376;1230;1146;2018
03;Alicante/Alacant;115;Sagra;389;193;196;2018
03;Alicante/Alacant;116;Salinas;1585;813;772;2018
03;Alicante/Alacant;118;San Fulgencio;7943;4030;3913;2018
03;Alicante/Alacant;904;San Isidro;1933;988;945;2018
03;Alicante/Alacant;120;San Miguel de Salinas;5811;2949;2862;2018
03;Alicante/Alacant;122;San Vicente del Raspeig/Sant Vicent del Raspeig;57785;28588;29197;2018
03;Alicante/Alacant;117;Sanet y Negrals;648;331;317;2018
03;Alicante/Alacant;119;Sant Joan d'Alacant;23518;11376;12142;2018
03;Alicante/Alacant;121;Santa Pola;31745;15916;15829;2018
03;Alicante/Alacant;123;Sax;9771;4920;4851;2018
03;Alicante/Alacant;124;Sella;585;308;277;2018
03;Alicante/Alacant;125;Senija;581;303;278;2018
03;Alicante/Alacant;127;Tàrbena;627;324;303;2018
03;Alicante/Alacant;128;Teulada;10722;5331;5391;2018
03;Alicante/Alacant;129;Tibi;1564;824;740;2018
03;Alicante/Alacant;130;Tollos;56;30;26;2018
03;Alicante/Alacant;131;Tormos;336;164;172;2018
03;Alicante/Alacant;132;Torremanzanas/Torre de les Maçanes, la;654;348;306;2018
03;Alicante/Alacant;133;Torrevieja;82599;41038;41561;2018
03;Alicante/Alacant;134;Vall d'Alcalà, la;164;90;74;2018
03;Alicante/Alacant;136;Vall de Gallinera;589;319;270;2018
03;Alicante/Alacant;137;Vall de Laguar, la;820;407;413;2018
03;Alicante/Alacant;135;Vall d'Ebo, la;224;117;107;2018
03;Alicante/Alacant;138;Verger, el;4520;2247;2273;2018
03;Alicante/Alacant;139;Villajoyosa/Vila Joiosa, la;33969;16949;17020;2018
03;Alicante/Alacant;140;Villena;33983;16992;16991;2018
03;Alicante/Alacant;081;Xaló;2683;1338;1345;2018
04;Almería;001;Abla;1235;633;602;2018
04;Almería;002;Abrucena;1150;600;550;2018
04;Almería;003;Adra;24859;12639;12220;2018
04;Almería;004;Albanchez;753;384;369;2018
04;Almería;005;Alboloduy;621;307;314;2018
04;Almería;006;Albox;11696;6023;5673;2018
04;Almería;007;Alcolea;814;417;397;2018
04;Almería;008;Alcóntar;528;288;240;2018
04;Almería;009;Alcudia de Monteagud;135;59;76;2018
04;Almería;010;Alhabia;648;340;308;2018
04;Almería;011;Alhama de Almería;3615;1811;1804;2018
04;Almería;012;Alicún;212;111;101;2018
04;Almería;013;Almería;196851;95953;100898;2018
04;Almería;014;Almócita;176;91;85;2018
04;Almería;015;Alsodux;133;79;54;2018
04;Almería;016;Antas;3169;1595;1574;2018
04;Almería;017;Arboleas;4586;2311;2275;2018
04;Almería;018;Armuña de Almanzora;321;157;164;2018
04;Almería;019;Bacares;232;124;108;2018
04;Almería;904;Balanegra;2933;1528;1405;2018
04;Almería;020;Bayárcal;284;150;134;2018
04;Almería;021;Bayarque;206;101;105;2018
04;Almería;022;Bédar;927;463;464;2018
04;Almería;023;Beires;117;58;59;2018
04;Almería;024;Benahadux;4357;2157;2200;2018
04;Almería;026;Benitagla;68;39;29;2018
04;Almería;027;Benizalón;248;130;118;2018
04;Almería;028;Bentarique;243;140;103;2018
04;Almería;029;Berja;12381;6267;6114;2018
04;Almería;030;Canjáyar;1202;629;573;2018
04;Almería;031;Cantoria;3228;1630;1598;2018
04;Almería;032;Carboneras;7757;3977;3780;2018
04;Almería;033;Castro de Filabres;121;59;62;2018
04;Almería;036;Chercos;283;143;140;2018
04;Almería;037;Chirivel;1525;762;763;2018
04;Almería;034;Cóbdar;143;83;60;2018
04;Almería;035;Cuevas del Almanzora;13776;7168;6608;2018
04;Almería;038;Dalías;4031;1987;2044;2018
04;Almería;902;Ejido, El;84710;44462;40248;2018
04;Almería;041;Enix;418;236;182;2018
04;Almería;043;Felix;642;363;279;2018
04;Almería;044;Fines;1992;1046;946;2018
04;Almería;045;Fiñana;1992;1005;987;2018
04;Almería;046;Fondón;975;512;463;2018
04;Almería;047;Gádor;3027;1575;1452;2018
04;Almería;048;Gallardos, Los;2803;1417;1386;2018
04;Almería;049;Garrucha;8838;4562;4276;2018
04;Almería;050;Gérgal;1031;553;478;2018
04;Almería;051;Huécija;486;236;250;2018
04;Almería;052;Huércal de Almería;17418;8869;8549;2018
04;Almería;053;Huércal-Overa;18816;9359;9457;2018
04;Almería;054;Íllar;390;212;178;2018
04;Almería;055;Instinción;429;213;216;2018
04;Almería;056;Laroya;169;99;70;2018
04;Almería;057;Láujar de Andarax;1538;767;771;2018
04;Almería;058;Líjar;390;205;185;2018
04;Almería;059;Lubrín;1431;700;731;2018
04;Almería;060;Lucainena de las Torres;546;299;247;2018
04;Almería;061;Lúcar;766;377;389;2018
04;Almería;062;Macael;5539;2843;2696;2018
04;Almería;063;María;1261;649;612;2018
04;Almería;064;Mojácar;6301;3085;3216;2018
04;Almería;903;Mojonera, La;9003;5027;3976;2018
04;Almería;065;Nacimiento;460;231;229;2018
04;Almería;066;Níjar;30122;16618;13504;2018
04;Almería;067;Ohanes;596;299;297;2018
04;Almería;068;Olula de Castro;180;100;80;2018
04;Almería;069;Olula del Río;6212;3194;3018;2018
04;Almería;070;Oria;2238;1172;1066;2018
04;Almería;071;Padules;419;216;203;2018
04;Almería;072;Partaloa;1055;530;525;2018
04;Almería;073;Paterna del Río;362;212;150;2018
04;Almería;074;Pechina;4018;2038;1980;2018
04;Almería;075;Pulpí;9502;4966;4536;2018
04;Almería;076;Purchena;1621;851;770;2018
04;Almería;077;Rágol;304;163;141;2018
04;Almería;078;Rioja;1364;690;674;2018
04;Almería;079;Roquetas de Mar;94925;49038;45887;2018
04;Almería;080;Santa Cruz de Marchena;218;107;111;2018
04;Almería;081;Santa Fe de Mondújar;432;219;213;2018
04;Almería;082;Senés;300;157;143;2018
04;Almería;083;Serón;2035;1035;1000;2018
04;Almería;084;Sierro;393;206;187;2018
04;Almería;085;Somontín;463;234;229;2018
04;Almería;086;Sorbas;2389;1254;1135;2018
04;Almería;087;Suflí;217;120;97;2018
04;Almería;088;Tabernas;3704;1916;1788;2018
04;Almería;089;Taberno;963;463;500;2018
04;Almería;090;Tahal;324;159;165;2018
04;Almería;091;Terque;381;192;189;2018
04;Almería;092;Tíjola;3569;1769;1800;2018
04;Almería;901;Tres Villas, Las;570;307;263;2018
04;Almería;093;Turre;3384;1734;1650;2018
04;Almería;094;Turrillas;233;136;97;2018
04;Almería;095;Uleila del Campo;836;415;421;2018
04;Almería;096;Urrácal;329;172;157;2018
04;Almería;097;Velefique;253;137;116;2018
04;Almería;098;Vélez-Blanco;1938;995;943;2018
04;Almería;099;Vélez-Rubio;6630;3231;3399;2018
04;Almería;100;Vera;15837;8052;7785;2018
04;Almería;101;Viator;5791;2939;2852;2018
04;Almería;102;Vícar;25405;13547;11858;2018
04;Almería;103;Zurgena;2893;1441;1452;2018
01;Araba/Álava;051;Agurain/Salvatierra;5018;2497;2521;2018
01;Araba/Álava;001;Alegría-Dulantzi;2887;1507;1380;2018
01;Araba/Álava;002;Amurrio;10286;5075;5211;2018
01;Araba/Álava;049;Añana;151;87;64;2018
01;Araba/Álava;003;Aramaio;1483;774;709;2018
01;Araba/Álava;006;Armiñón;219;115;104;2018
01;Araba/Álava;037;Arraia-Maeztu;717;399;318;2018
01;Araba/Álava;008;Arratzua-Ubarrundia;982;535;447;2018
01;Araba/Álava;004;Artziniega;1831;912;919;2018
01;Araba/Álava;009;Asparrena;1643;833;810;2018
01;Araba/Álava;010;Ayala/Aiara;2967;1503;1464;2018
01;Araba/Álava;011;Baños de Ebro/Mañueta;286;159;127;2018
01;Araba/Álava;013;Barrundia;883;493;390;2018
01;Araba/Álava;014;Berantevilla;443;238;205;2018
01;Araba/Álava;016;Bernedo;511;303;208;2018
01;Araba/Álava;017;Campezo/Kanpezu;1040;548;492;2018
01;Araba/Álava;021;Elburgo/Burgelu;603;316;287;2018
01;Araba/Álava;022;Elciego;1025;513;512;2018
01;Araba/Álava;023;Elvillar/Bilar;348;170;178;2018
01;Araba/Álava;046;Erriberagoitia/Ribera Alta;780;447;333;2018
01;Araba/Álava;056;Harana/Valle de Arana;229;129;100;2018
01;Araba/Álava;901;Iruña Oka/Iruña de Oca;3333;1721;1612;2018
01;Araba/Álava;027;Iruraiz-Gauna;517;281;236;2018
01;Araba/Álava;019;Kripan;181;96;85;2018
01;Araba/Álava;020;Kuartango;381;222;159;2018
01;Araba/Álava;028;Labastida/Bastida;1445;759;686;2018
01;Araba/Álava;030;Lagrán;158;88;70;2018
01;Araba/Álava;031;Laguardia;1505;776;729;2018
01;Araba/Álava;032;Lanciego/Lantziego;667;341;326;2018
01;Araba/Álava;902;Lantarón;872;491;381;2018
01;Araba/Álava;033;Lapuebla de Labarca;857;441;416;2018
01;Araba/Álava;036;Laudio/Llodio;18205;8979;9226;2018
01;Araba/Álava;058;Legutio;1869;992;877;2018
01;Araba/Álava;034;Leza;196;100;96;2018
01;Araba/Álava;039;Moreda de Álava/Moreda Araba;229;113;116;2018
01;Araba/Álava;041;Navaridas;209;117;92;2018
01;Araba/Álava;042;Okondo;1162;601;561;2018
01;Araba/Álava;043;Oyón-Oion;3368;1718;1650;2018
01;Araba/Álava;044;Peñacerrada-Urizaharra;257;152;105;2018
01;Araba/Álava;047;Ribera Baja/Erribera Beitia;1374;745;629;2018
01;Araba/Álava;052;Samaniego;319;155;164;2018
01;Araba/Álava;053;San Millán/Donemiliaga;709;390;319;2018
01;Araba/Álava;054;Urkabustaiz;1336;688;648;2018
01;Araba/Álava;055;Valdegovía/Gaubea;991;546;445;2018
01;Araba/Álava;057;Villabuena de Álava/Eskuernaga;299;150;149;2018
01;Araba/Álava;059;Vitoria-Gasteiz;249176;121358;127818;2018
01;Araba/Álava;060;Yécora/Iekora;269;139;130;2018
01;Araba/Álava;061;Zalduondo;186;104;82;2018
01;Araba/Álava;062;Zambrana;400;214;186;2018
01;Araba/Álava;018;Zigoitia;1753;952;801;2018
01;Araba/Álava;063;Zuia;2313;1193;1120;2018
33;Asturias;001;Allande;1697;854;843;2018
33;Asturias;002;Aller;10808;5326;5482;2018
33;Asturias;003;Amieva;675;379;296;2018
33;Asturias;004;Avilés;78715;37191;41524;2018
33;Asturias;005;Belmonte de Miranda;1522;795;727;2018
33;Asturias;006;Bimenes;1700;810;890;2018
33;Asturias;007;Boal;1571;791;780;2018
33;Asturias;008;Cabrales;2002;1021;981;2018
33;Asturias;009;Cabranes;1035;514;521;2018
33;Asturias;010;Candamo;1985;974;1011;2018
33;Asturias;012;Cangas de Onís;6278;3033;3245;2018
33;Asturias;011;Cangas del Narcea;12579;6196;6383;2018
33;Asturias;013;Caravia;477;242;235;2018
33;Asturias;014;Carreño;10444;5043;5401;2018
33;Asturias;015;Caso;1553;881;672;2018
33;Asturias;016;Castrillón;22464;10894;11570;2018
33;Asturias;017;Castropol;3470;1689;1781;2018
33;Asturias;018;Coaña;3336;1627;1709;2018
33;Asturias;019;Colunga;3332;1636;1696;2018
33;Asturias;020;Corvera de Asturias;15721;7730;7991;2018
33;Asturias;021;Cudillero;5078;2505;2573;2018
33;Asturias;022;Degaña;949;493;456;2018
33;Asturias;023;Franco, El;3830;1882;1948;2018
33;Asturias;024;Gijón;271843;128208;143635;2018
33;Asturias;025;Gozón;10427;5088;5339;2018
33;Asturias;026;Grado;9839;4748;5091;2018
33;Asturias;027;Grandas de Salime;853;439;414;2018
33;Asturias;028;Ibias;1301;736;565;2018
33;Asturias;029;Illano;352;175;177;2018
33;Asturias;030;Illas;1022;516;506;2018
33;Asturias;031;Langreo;39984;19051;20933;2018
33;Asturias;032;Laviana;13087;6269;6818;2018
33;Asturias;033;Lena;11086;5339;5747;2018
33;Asturias;035;Llanera;13676;6783;6893;2018
33;Asturias;036;Llanes;13639;6621;7018;2018
33;Asturias;037;Mieres;38428;18237;20191;2018
33;Asturias;038;Morcín;2631;1320;1311;2018
33;Asturias;039;Muros de Nalón;1846;883;963;2018
33;Asturias;040;Nava;5334;2624;2710;2018
33;Asturias;041;Navia;8409;4043;4366;2018
33;Asturias;042;Noreña;5167;2481;2686;2018
33;Asturias;043;Onís;740;401;339;2018
33;Asturias;044;Oviedo;220020;101906;118114;2018
33;Asturias;045;Parres;5353;2626;2727;2018
33;Asturias;046;Peñamellera Alta;531;279;252;2018
33;Asturias;047;Peñamellera Baja;1246;610;636;2018
33;Asturias;048;Pesoz;146;81;65;2018
33;Asturias;049;Piloña;7101;3503;3598;2018
33;Asturias;050;Ponga;598;354;244;2018
33;Asturias;051;Pravia;8282;3998;4284;2018
33;Asturias;052;Proaza;737;425;312;2018
33;Asturias;053;Quirós;1194;691;503;2018
33;Asturias;054;Regueras, Las;1865;964;901;2018
33;Asturias;055;Ribadedeva;1758;845;913;2018
33;Asturias;056;Ribadesella;5730;2738;2992;2018
33;Asturias;057;Ribera de Arriba;1857;929;928;2018
33;Asturias;058;Riosa;1933;971;962;2018
33;Asturias;059;Salas;5084;2512;2572;2018
33;Asturias;061;San Martín de Oscos;393;194;199;2018
33;Asturias;060;San Martín del Rey Aurelio;16283;7785;8498;2018
33;Asturias;063;San Tirso de Abres;433;212;221;2018
33;Asturias;062;Santa Eulalia de Oscos;453;235;218;2018
33;Asturias;064;Santo Adriano;288;142;146;2018
33;Asturias;065;Sariego;1254;604;650;2018
33;Asturias;066;Siero;51662;25234;26428;2018
33;Asturias;067;Sobrescobio;818;434;384;2018
33;Asturias;068;Somiedo;1125;650;475;2018
33;Asturias;069;Soto del Barco;3887;1919;1968;2018
33;Asturias;070;Tapia de Casariego;3795;1846;1949;2018
33;Asturias;071;Taramundi;646;308;338;2018
33;Asturias;072;Teverga;1628;871;757;2018
33;Asturias;073;Tineo;9543;4815;4728;2018
33;Asturias;034;Valdés;11734;5730;6004;2018
33;Asturias;074;Vegadeo;3866;1862;2004;2018
33;Asturias;075;Villanueva de Oscos;298;150;148;2018
33;Asturias;076;Villaviciosa;14430;7120;7310;2018
33;Asturias;077;Villayón;1248;649;599;2018
33;Asturias;078;Yernes y Tameza;140;78;62;2018
05;Ávila;001;Adanero;202;113;89;2018
05;Ávila;002;Adrada, La;2517;1298;1219;2018
05;Ávila;005;Albornos;190;100;90;2018
05;Ávila;007;Aldeanueva de Santa Cruz;119;63;56;2018
05;Ávila;008;Aldeaseca;233;115;118;2018
05;Ávila;010;Aldehuela, La;168;85;83;2018
05;Ávila;012;Amavida;135;69;66;2018
05;Ávila;013;Arenal, El;972;495;477;2018
05;Ávila;014;Arenas de San Pedro;6454;3135;3319;2018
05;Ávila;015;Arevalillo;75;35;40;2018
05;Ávila;016;Arévalo;8069;3919;4150;2018
05;Ávila;017;Aveinte;86;49;37;2018
05;Ávila;018;Avellaneda;26;15;11;2018
05;Ávila;019;Ávila;57657;27472;30185;2018
05;Ávila;021;Barco de Ávila, El;2368;1145;1223;2018
05;Ávila;022;Barraco, El;1889;976;913;2018
05;Ávila;023;Barromán;186;103;83;2018
05;Ávila;024;Becedas;206;108;98;2018
05;Ávila;025;Becedillas;90;50;40;2018
05;Ávila;026;Bercial de Zapardiel;199;106;93;2018
05;Ávila;027;Berlanas, Las;323;164;159;2018
05;Ávila;029;Bernuy-Zapardiel;108;64;44;2018
05;Ávila;030;Berrocalejo de Aragona;43;22;21;2018
05;Ávila;033;Blascomillán;193;102;91;2018
05;Ávila;034;Blasconuño de Matacabras;16;8;8;2018
05;Ávila;035;Blascosancho;114;57;57;2018
05;Ávila;036;Bohodón, El;126;62;64;2018
05;Ávila;037;Bohoyo;248;142;106;2018
05;Ávila;038;Bonilla de la Sierra;120;71;49;2018
05;Ávila;039;Brabos;44;27;17;2018
05;Ávila;040;Bularros;65;43;22;2018
05;Ávila;041;Burgohondo;1196;621;575;2018
05;Ávila;042;Cabezas de Alambre;157;77;80;2018
05;Ávila;043;Cabezas del Pozo;84;44;40;2018
05;Ávila;044;Cabezas del Villar;275;150;125;2018
05;Ávila;045;Cabizuela;82;43;39;2018
05;Ávila;046;Canales;48;26;22;2018
05;Ávila;047;Candeleda;4998;2528;2470;2018
05;Ávila;048;Cantiveros;112;63;49;2018
05;Ávila;049;Cardeñosa;452;239;213;2018
05;Ávila;051;Carrera, La;181;98;83;2018
05;Ávila;052;Casas del Puerto;92;48;44;2018
05;Ávila;053;Casasola;84;46;38;2018
05;Ávila;054;Casavieja;1429;742;687;2018
05;Ávila;055;Casillas;637;338;299;2018
05;Ávila;056;Castellanos de Zapardiel;95;53;42;2018
05;Ávila;057;Cebreros;3056;1576;1480;2018
05;Ávila;058;Cepeda la Mora;76;43;33;2018
05;Ávila;067;Chamartín;79;47;32;2018
05;Ávila;059;Cillán;100;60;40;2018
05;Ávila;060;Cisla;109;56;53;2018
05;Ávila;061;Colilla, La;329;172;157;2018
05;Ávila;062;Collado de Contreras;179;92;87;2018
05;Ávila;063;Collado del Mirón;32;20;12;2018
05;Ávila;064;Constanzana;106;60;46;2018
05;Ávila;065;Crespos;496;264;232;2018
05;Ávila;066;Cuevas del Valle;491;271;220;2018
05;Ávila;903;Diego del Carpio;147;83;64;2018
05;Ávila;069;Donjimeno;79;45;34;2018
05;Ávila;070;Donvidas;33;17;16;2018
05;Ávila;072;Espinosa de los Caballeros;106;57;49;2018
05;Ávila;073;Flores de Ávila;307;168;139;2018
05;Ávila;074;Fontiveros;751;391;360;2018
05;Ávila;075;Fresnedilla;121;56;65;2018
05;Ávila;076;Fresno, El;601;312;289;2018
05;Ávila;077;Fuente el Saúz;165;88;77;2018
05;Ávila;078;Fuentes de Año;105;59;46;2018
05;Ávila;079;Gallegos de Altamiros;63;37;26;2018
05;Ávila;080;Gallegos de Sobrinos;43;21;22;2018
05;Ávila;081;Garganta del Villar;40;28;12;2018
05;Ávila;082;Gavilanes;587;317;270;2018
05;Ávila;083;Gemuño;155;82;73;2018
05;Ávila;085;Gil García;36;17;19;2018
05;Ávila;084;Gilbuena;68;40;28;2018
05;Ávila;086;Gimialcón;77;48;29;2018
05;Ávila;087;Gotarrendura;161;54;107;2018
05;Ávila;088;Grandes y San Martín;31;15;16;2018
05;Ávila;089;Guisando;511;252;259;2018
05;Ávila;090;Gutierre-Muñoz;78;38;40;2018
05;Ávila;092;Hernansancho;169;94;75;2018
05;Ávila;093;Herradón de Pinares;405;230;175;2018
05;Ávila;094;Herreros de Suso;135;74;61;2018
05;Ávila;095;Higuera de las Dueñas;267;148;119;2018
05;Ávila;096;Hija de Dios, La;78;47;31;2018
05;Ávila;097;Horcajada, La;518;274;244;2018
05;Ávila;099;Horcajo de las Torres;512;287;225;2018
05;Ávila;100;Hornillo, El;295;155;140;2018
05;Ávila;102;Hoyo de Pinares, El;2164;1123;1041;2018
05;Ávila;101;Hoyocasero;290;167;123;2018
05;Ávila;103;Hoyorredondo;67;34;33;2018
05;Ávila;106;Hoyos de Miguel Muñoz;29;15;14;2018
05;Ávila;104;Hoyos del Collado;34;20;14;2018
05;Ávila;105;Hoyos del Espino;363;197;166;2018
05;Ávila;107;Hurtumpascual;54;33;21;2018
05;Ávila;108;Junciana;40;21;19;2018
05;Ávila;109;Langa;487;255;232;2018
05;Ávila;110;Lanzahíta;844;431;413;2018
05;Ávila;113;Llanos de Tormes, Los;64;30;34;2018
05;Ávila;112;Losar del Barco, El;110;56;54;2018
05;Ávila;114;Madrigal de las Altas Torres;1440;732;708;2018
05;Ávila;115;Maello;596;310;286;2018
05;Ávila;116;Malpartida de Corneja;102;51;51;2018
05;Ávila;117;Mamblas;208;119;89;2018
05;Ávila;118;Mancera de Arriba;74;40;34;2018
05;Ávila;119;Manjabálago y Ortigosa de Rioalmar;27;18;9;2018
05;Ávila;120;Marlín;31;20;11;2018
05;Ávila;121;Martiherrero;317;165;152;2018
05;Ávila;122;Martínez;122;62;60;2018
05;Ávila;123;Mediana de Voltoya;105;52;53;2018
05;Ávila;124;Medinilla;99;45;54;2018
05;Ávila;125;Mengamuñoz;61;31;30;2018
05;Ávila;126;Mesegar de Corneja;60;36;24;2018
05;Ávila;127;Mijares;704;394;310;2018
05;Ávila;128;Mingorría;395;207;188;2018
05;Ávila;129;Mirón, El;124;73;51;2018
05;Ávila;130;Mironcillo;95;50;45;2018
05;Ávila;131;Mirueña de los Infanzones;92;54;38;2018
05;Ávila;132;Mombeltrán;1006;520;486;2018
05;Ávila;133;Monsalupe;73;38;35;2018
05;Ávila;134;Moraleja de Matacabras;50;30;20;2018
05;Ávila;135;Muñana;394;208;186;2018
05;Ávila;136;Muñico;94;50;44;2018
05;Ávila;138;Muñogalindo;334;172;162;2018
05;Ávila;139;Muñogrande;67;37;30;2018
05;Ávila;140;Muñomer del Peco;128;71;57;2018
05;Ávila;141;Muñopepe;103;57;46;2018
05;Ávila;142;Muñosancho;96;45;51;2018
05;Ávila;143;Muñotello;62;31;31;2018
05;Ávila;144;Narrillos del Álamo;77;42;35;2018
05;Ávila;145;Narrillos del Rebollar;50;28;22;2018
05;Ávila;149;Narros de Saldueña;101;59;42;2018
05;Ávila;147;Narros del Castillo;161;91;70;2018
05;Ávila;148;Narros del Puerto;22;11;11;2018
05;Ávila;152;Nava de Arévalo;753;398;355;2018
05;Ávila;153;Nava del Barco;93;50;43;2018
05;Ávila;151;Navacepedilla de Corneja;98;50;48;2018
05;Ávila;154;Navadijos;34;24;10;2018
05;Ávila;155;Navaescurial;46;30;16;2018
05;Ávila;156;Navahondilla;310;180;130;2018
05;Ávila;157;Navalacruz;247;134;113;2018
05;Ávila;158;Navalmoral;336;182;154;2018
05;Ávila;159;Navalonguilla;236;116;120;2018
05;Ávila;160;Navalosa;321;176;145;2018
05;Ávila;161;Navalperal de Pinares;777;399;378;2018
05;Ávila;162;Navalperal de Tormes;90;47;43;2018
05;Ávila;163;Navaluenga;1878;924;954;2018
05;Ávila;164;Navaquesera;16;8;8;2018
05;Ávila;165;Navarredonda de Gredos;434;213;221;2018
05;Ávila;166;Navarredondilla;168;92;76;2018
05;Ávila;167;Navarrevisca;279;155;124;2018
05;Ávila;168;Navas del Marqués, Las;5139;2616;2523;2018
05;Ávila;169;Navatalgordo;251;145;106;2018
05;Ávila;170;Navatejares;55;27;28;2018
05;Ávila;171;Neila de San Miguel;69;34;35;2018
05;Ávila;172;Niharra;184;103;81;2018
05;Ávila;173;Ojos-Albos;63;39;24;2018
05;Ávila;174;Orbita;75;41;34;2018
05;Ávila;175;Oso, El;172;98;74;2018
05;Ávila;176;Padiernos;272;150;122;2018
05;Ávila;177;Pajares de Adaja;154;81;73;2018
05;Ávila;178;Palacios de Goda;402;211;191;2018
05;Ávila;179;Papatrigo;232;114;118;2018
05;Ávila;180;Parral, El;72;39;33;2018
05;Ávila;181;Pascualcobo;43;29;14;2018
05;Ávila;182;Pedro Bernardo;844;444;400;2018
05;Ávila;183;Pedro-Rodríguez;140;74;66;2018
05;Ávila;184;Peguerinos;272;152;120;2018
05;Ávila;185;Peñalba de Ávila;113;58;55;2018
05;Ávila;186;Piedrahíta;1811;869;942;2018
05;Ávila;187;Piedralaves;2057;1025;1032;2018
05;Ávila;188;Poveda;45;28;17;2018
05;Ávila;189;Poyales del Hoyo;482;254;228;2018
05;Ávila;190;Pozanco;49;30;19;2018
05;Ávila;191;Pradosegar;126;64;62;2018
05;Ávila;192;Puerto Castilla;107;66;41;2018
05;Ávila;193;Rasueros;181;103;78;2018
05;Ávila;194;Riocabado;146;82;64;2018
05;Ávila;195;Riofrío;227;135;92;2018
05;Ávila;196;Rivilla de Barajas;65;28;37;2018
05;Ávila;197;Salobral;116;64;52;2018
05;Ávila;198;Salvadiós;75;35;40;2018
05;Ávila;199;San Bartolomé de Béjar;42;22;20;2018
05;Ávila;200;San Bartolomé de Corneja;43;21;22;2018
05;Ávila;201;San Bartolomé de Pinares;553;297;256;2018
05;Ávila;206;San Esteban de los Patos;30;18;12;2018
05;Ávila;208;San Esteban de Zapardiel;36;22;14;2018
05;Ávila;207;San Esteban del Valle;747;388;359;2018
05;Ávila;209;San García de Ingelmos;80;48;32;2018
05;Ávila;901;San Juan de Gredos;251;137;114;2018
05;Ávila;210;San Juan de la Encinilla;86;43;43;2018
05;Ávila;211;San Juan de la Nava;473;251;222;2018
05;Ávila;212;San Juan del Molinillo;199;111;88;2018
05;Ávila;213;San Juan del Olmo;105;64;41;2018
05;Ávila;214;San Lorenzo de Tormes;37;21;16;2018
05;Ávila;215;San Martín de la Vega del Alberche;174;104;70;2018
05;Ávila;216;San Martín del Pimpollar;189;109;80;2018
05;Ávila;217;San Miguel de Corneja;55;30;25;2018
05;Ávila;218;San Miguel de Serrezuela;125;68;57;2018
05;Ávila;219;San Pascual;44;26;18;2018
05;Ávila;220;San Pedro del Arroyo;428;226;202;2018
05;Ávila;231;San Vicente de Arévalo;171;100;71;2018
05;Ávila;204;Sanchidrián;726;373;353;2018
05;Ávila;205;Sanchorreja;86;43;43;2018
05;Ávila;222;Santa Cruz de Pinares;141;76;65;2018
05;Ávila;221;Santa Cruz del Valle;365;192;173;2018
05;Ávila;226;Santa María de los Caballeros;73;44;29;2018
05;Ávila;224;Santa María del Arroyo;111;58;53;2018
05;Ávila;225;Santa María del Berrocal;403;219;184;2018
05;Ávila;902;Santa María del Cubillo;314;183;131;2018
05;Ávila;227;Santa María del Tiétar;436;234;202;2018
05;Ávila;228;Santiago del Collado;176;109;67;2018
05;Ávila;904;Santiago del Tormes;122;69;53;2018
05;Ávila;229;Santo Domingo de las Posadas;75;40;35;2018
05;Ávila;230;Santo Tomé de Zabarcos;65;35;30;2018
05;Ávila;232;Serrada, La;111;58;53;2018
05;Ávila;233;Serranillos;250;140;110;2018
05;Ávila;234;Sigeres;43;22;21;2018
05;Ávila;235;Sinlabajos;124;69;55;2018
05;Ávila;236;Solana de Ávila;113;66;47;2018
05;Ávila;237;Solana de Rioalmar;165;95;70;2018
05;Ávila;238;Solosancho;837;446;391;2018
05;Ávila;239;Sotalbo;251;134;117;2018
05;Ávila;240;Sotillo de la Adrada;4542;2252;2290;2018
05;Ávila;241;Tiemblo, El;4097;2090;2007;2018
05;Ávila;242;Tiñosillos;796;411;385;2018
05;Ávila;243;Tolbaños;85;48;37;2018
05;Ávila;244;Tormellas;41;26;15;2018
05;Ávila;245;Tornadizos de Ávila;435;222;213;2018
05;Ávila;247;Torre, La;239;131;108;2018
05;Ávila;246;Tórtoles;60;33;27;2018
05;Ávila;249;Umbrías;105;55;50;2018
05;Ávila;251;Vadillo de la Sierra;67;42;25;2018
05;Ávila;252;Valdecasa;62;37;25;2018
05;Ávila;253;Vega de Santa María;85;41;44;2018
05;Ávila;254;Velayos;213;106;107;2018
05;Ávila;256;Villaflor;117;62;55;2018
05;Ávila;257;Villafranca de la Sierra;132;71;61;2018
05;Ávila;905;Villanueva de Ávila;254;127;127;2018
05;Ávila;258;Villanueva de Gómez;132;76;56;2018
05;Ávila;259;Villanueva del Aceral;122;61;61;2018
05;Ávila;260;Villanueva del Campillo;103;57;46;2018
05;Ávila;261;Villar de Corneja;39;22;17;2018
05;Ávila;262;Villarejo del Valle;363;191;172;2018
05;Ávila;263;Villatoro;166;96;70;2018
05;Ávila;264;Viñegra de Moraña;58;34;24;2018
05;Ávila;265;Vita;87;52;35;2018
05;Ávila;266;Zapardiel de la Cañada;97;53;44;2018
05;Ávila;267;Zapardiel de la Ribera;115;60;55;2018
06;Badajoz;001;Acedera;798;418;380;2018
06;Badajoz;002;Aceuchal;5461;2706;2755;2018
06;Badajoz;003;Ahillones;893;443;450;2018
06;Badajoz;004;Alange;1880;945;935;2018
06;Badajoz;005;Albuera, La;2029;1058;971;2018
06;Badajoz;006;Alburquerque;5340;2667;2673;2018
06;Badajoz;007;Alconchel;1704;859;845;2018
06;Badajoz;008;Alconera;730;359;371;2018
06;Badajoz;009;Aljucén;245;133;112;2018
06;Badajoz;010;Almendral;1240;607;633;2018
06;Badajoz;011;Almendralejo;33468;16588;16880;2018
06;Badajoz;012;Arroyo de San Serván;4126;2102;2024;2018
06;Badajoz;013;Atalaya;293;150;143;2018
06;Badajoz;014;Azuaga;7891;3914;3977;2018
06;Badajoz;015;Badajoz;150530;72988;77542;2018
06;Badajoz;016;Barcarrota;3580;1822;1758;2018
06;Badajoz;017;Baterno;293;156;137;2018
06;Badajoz;018;Benquerencia de la Serena;841;417;424;2018
06;Badajoz;019;Berlanga;2360;1192;1168;2018
06;Badajoz;020;Bienvenida;2128;1101;1027;2018
06;Badajoz;021;Bodonal de la Sierra;1052;539;513;2018
06;Badajoz;022;Burguillos del Cerro;3085;1524;1561;2018
06;Badajoz;023;Cabeza del Buey;4929;2441;2488;2018
06;Badajoz;024;Cabeza la Vaca;1331;679;652;2018
06;Badajoz;025;Calamonte;6241;3101;3140;2018
06;Badajoz;026;Calera de León;969;490;479;2018
06;Badajoz;027;Calzadilla de los Barros;769;383;386;2018
06;Badajoz;028;Campanario;4967;2442;2525;2018
06;Badajoz;029;Campillo de Llerena;1373;693;680;2018
06;Badajoz;030;Capilla;186;96;90;2018
06;Badajoz;031;Carmonita;551;276;275;2018
06;Badajoz;032;Carrascalejo, El;67;33;34;2018
06;Badajoz;033;Casas de Don Pedro;1483;762;721;2018
06;Badajoz;034;Casas de Reina;191;94;97;2018
06;Badajoz;035;Castilblanco;972;498;474;2018
06;Badajoz;036;Castuera;5921;2919;3002;2018
06;Badajoz;042;Cheles;1210;587;623;2018
06;Badajoz;037;Codosera, La;2119;1121;998;2018
06;Badajoz;038;Cordobilla de Lácara;916;471;445;2018
06;Badajoz;039;Coronada, La;2182;1065;1117;2018
06;Badajoz;040;Corte de Peleas;1238;607;631;2018
06;Badajoz;041;Cristina;567;293;274;2018
06;Badajoz;043;Don Álvaro;768;395;373;2018
06;Badajoz;044;Don Benito;37010;18268;18742;2018
06;Badajoz;045;Entrín Bajo;569;287;282;2018
06;Badajoz;046;Esparragalejo;1459;720;739;2018
06;Badajoz;047;Esparragosa de la Serena;1031;528;503;2018
06;Badajoz;048;Esparragosa de Lares;938;451;487;2018
06;Badajoz;049;Feria;1150;560;590;2018
06;Badajoz;050;Fregenal de la Sierra;4918;2419;2499;2018
06;Badajoz;051;Fuenlabrada de los Montes;1879;931;948;2018
06;Badajoz;052;Fuente de Cantos;4784;2367;2417;2018
06;Badajoz;053;Fuente del Arco;697;350;347;2018
06;Badajoz;054;Fuente del Maestre;6774;3367;3407;2018
06;Badajoz;055;Fuentes de León;2311;1142;1169;2018
06;Badajoz;056;Garbayuela;522;277;245;2018
06;Badajoz;057;Garlitos;599;312;287;2018
06;Badajoz;058;Garrovilla, La;2401;1206;1195;2018
06;Badajoz;059;Granja de Torrehermosa;2041;1013;1028;2018
06;Badajoz;903;Guadiana del Caudillo;2518;1237;1281;2018
06;Badajoz;060;Guareña;7006;3530;3476;2018
06;Badajoz;061;Haba, La;1247;622;625;2018
06;Badajoz;062;Helechosa de los Montes;653;368;285;2018
06;Badajoz;063;Herrera del Duque;3485;1748;1737;2018
06;Badajoz;064;Higuera de la Serena;941;492;449;2018
06;Badajoz;065;Higuera de Llerena;343;174;169;2018
06;Badajoz;066;Higuera de Vargas;1950;982;968;2018
06;Badajoz;067;Higuera la Real;2264;1134;1130;2018
06;Badajoz;068;Hinojosa del Valle;489;238;251;2018
06;Badajoz;069;Hornachos;3639;1832;1807;2018
06;Badajoz;070;Jerez de los Caballeros;9367;4610;4757;2018
06;Badajoz;071;Lapa, La;284;143;141;2018
06;Badajoz;073;Llera;860;446;414;2018
06;Badajoz;074;Llerena;5758;2861;2897;2018
06;Badajoz;072;Lobón;2757;1414;1343;2018
06;Badajoz;075;Magacela;526;280;246;2018
06;Badajoz;076;Maguilla;970;478;492;2018
06;Badajoz;077;Malcocinado;374;203;171;2018
06;Badajoz;078;Malpartida de la Serena;569;294;275;2018
06;Badajoz;079;Manchita;763;391;372;2018
06;Badajoz;080;Medellín;2276;1134;1142;2018
06;Badajoz;081;Medina de las Torres;1207;621;586;2018
06;Badajoz;082;Mengabril;472;254;218;2018
06;Badajoz;083;Mérida;59352;28958;30394;2018
06;Badajoz;084;Mirandilla;1300;659;641;2018
06;Badajoz;085;Monesterio;4254;2189;2065;2018
06;Badajoz;086;Montemolín;1367;659;708;2018
06;Badajoz;087;Monterrubio de la Serena;2415;1177;1238;2018
06;Badajoz;088;Montijo;15614;7721;7893;2018
06;Badajoz;089;Morera, La;719;365;354;2018
06;Badajoz;090;Nava de Santiago, La;949;482;467;2018
06;Badajoz;091;Navalvillar de Pela;4444;2258;2186;2018
06;Badajoz;092;Nogales;666;330;336;2018
06;Badajoz;093;Oliva de la Frontera;5195;2601;2594;2018
06;Badajoz;094;Oliva de Mérida;1734;892;842;2018
06;Badajoz;095;Olivenza;11986;5977;6009;2018
06;Badajoz;096;Orellana de la Sierra;235;123;112;2018
06;Badajoz;097;Orellana la Vieja;2729;1415;1314;2018
06;Badajoz;098;Palomas;686;342;344;2018
06;Badajoz;099;Parra, La;1360;705;655;2018
06;Badajoz;100;Peñalsordo;949;450;499;2018
06;Badajoz;101;Peraleda del Zaucejo;512;259;253;2018
06;Badajoz;102;Puebla de Alcocer;1188;585;603;2018
06;Badajoz;103;Puebla de la Calzada;5876;2933;2943;2018
06;Badajoz;104;Puebla de la Reina;745;374;371;2018
06;Badajoz;107;Puebla de Obando;1868;938;930;2018
06;Badajoz;108;Puebla de Sancho Pérez;2731;1377;1354;2018
06;Badajoz;105;Puebla del Maestre;698;356;342;2018
06;Badajoz;106;Puebla del Prior;500;256;244;2018
06;Badajoz;902;Pueblonuevo del Guadiana;2033;1032;1001;2018
06;Badajoz;109;Quintana de la Serena;4650;2354;2296;2018
06;Badajoz;110;Reina;159;79;80;2018
06;Badajoz;111;Rena;622;320;302;2018
06;Badajoz;112;Retamal de Llerena;443;226;217;2018
06;Badajoz;113;Ribera del Fresno;3357;1664;1693;2018
06;Badajoz;114;Risco;141;72;69;2018
06;Badajoz;115;Roca de la Sierra, La;1473;727;746;2018
06;Badajoz;116;Salvaleón;1800;907;893;2018
06;Badajoz;117;Salvatierra de los Barros;1664;811;853;2018
06;Badajoz;119;San Pedro de Mérida;837;433;404;2018
06;Badajoz;123;San Vicente de Alcántara;5475;2756;2719;2018
06;Badajoz;118;Sancti-Spíritus;175;100;75;2018
06;Badajoz;120;Santa Amalia;4059;2056;2003;2018
06;Badajoz;121;Santa Marta;4176;2109;2067;2018
06;Badajoz;122;Santos de Maimona, Los;8126;4104;4022;2018
06;Badajoz;124;Segura de León;1921;951;970;2018
06;Badajoz;125;Siruela;1912;962;950;2018
06;Badajoz;126;Solana de los Barros;2645;1317;1328;2018
06;Badajoz;127;Talarrubias;3420;1704;1716;2018
06;Badajoz;128;Talavera la Real;5376;2681;2695;2018
06;Badajoz;129;Táliga;681;341;340;2018
06;Badajoz;130;Tamurejo;215;111;104;2018
06;Badajoz;131;Torre de Miguel Sesmero;1265;648;617;2018
06;Badajoz;132;Torremayor;973;465;508;2018
06;Badajoz;133;Torremejía;2264;1168;1096;2018
06;Badajoz;134;Trasierra;633;334;299;2018
06;Badajoz;135;Trujillanos;1401;720;681;2018
06;Badajoz;136;Usagre;1777;879;898;2018
06;Badajoz;137;Valdecaballeros;1074;555;519;2018
06;Badajoz;901;Valdelacalzada;2734;1398;1336;2018
06;Badajoz;138;Valdetorres;1179;577;602;2018
06;Badajoz;139;Valencia de las Torres;578;305;273;2018
06;Badajoz;140;Valencia del Mombuey;731;368;363;2018
06;Badajoz;141;Valencia del Ventoso;2008;994;1014;2018
06;Badajoz;146;Valle de la Serena;1224;620;604;2018
06;Badajoz;147;Valle de Matamoros;367;180;187;2018
06;Badajoz;148;Valle de Santa Ana;1152;565;587;2018
06;Badajoz;142;Valverde de Burguillos;281;150;131;2018
06;Badajoz;143;Valverde de Leganés;4176;2101;2075;2018
06;Badajoz;144;Valverde de Llerena;603;299;304;2018
06;Badajoz;145;Valverde de Mérida;1060;534;526;2018
06;Badajoz;149;Villafranca de los Barros;12926;6365;6561;2018
06;Badajoz;150;Villagarcía de la Torre;913;470;443;2018
06;Badajoz;151;Villagonzalo;1243;603;640;2018
06;Badajoz;152;Villalba de los Barros;1504;761;743;2018
06;Badajoz;153;Villanueva de la Serena;25759;12528;13231;2018
06;Badajoz;154;Villanueva del Fresno;3401;1700;1701;2018
06;Badajoz;156;Villar de Rena;1383;715;668;2018
06;Badajoz;155;Villar del Rey;2168;1157;1011;2018
06;Badajoz;157;Villarta de los Montes;444;226;218;2018
06;Badajoz;158;Zafra;16776;8086;8690;2018
06;Badajoz;159;Zahínos;2805;1399;1406;2018
06;Badajoz;160;Zalamea de la Serena;3606;1810;1796;2018
06;Badajoz;162;Zarza, La;3508;1783;1725;2018
06;Badajoz;161;Zarza-Capilla;310;157;153;2018
07;Balears, Illes;002;Alaior;9012;4520;4492;2018
07;Balears, Illes;001;Alaró;5494;2658;2836;2018
07;Balears, Illes;003;Alcúdia;19793;9974;9819;2018
07;Balears, Illes;004;Algaida;5529;2822;2707;2018
07;Balears, Illes;005;Andratx;11004;5470;5534;2018
07;Balears, Illes;901;Ariany;860;451;409;2018
07;Balears, Illes;006;Artà;7671;3844;3827;2018
07;Balears, Illes;007;Banyalbufar;503;265;238;2018
07;Balears, Illes;008;Binissalem;8316;4130;4186;2018
07;Balears, Illes;009;Búger;1054;545;509;2018
07;Balears, Illes;010;Bunyola;6714;3284;3430;2018
07;Balears, Illes;011;Calvià;49333;24727;24606;2018
07;Balears, Illes;012;Campanet;2612;1302;1310;2018
07;Balears, Illes;013;Campos;10610;5268;5342;2018
07;Balears, Illes;014;Capdepera;11600;5907;5693;2018
07;Balears, Illes;064;Castell, Es;7348;3723;3625;2018
07;Balears, Illes;015;Ciutadella de Menorca;29223;14483;14740;2018
07;Balears, Illes;016;Consell;4008;2012;1996;2018
07;Balears, Illes;017;Costitx;1271;624;647;2018
07;Balears, Illes;018;Deià;620;293;327;2018
07;Balears, Illes;026;Eivissa;49727;24984;24743;2018
07;Balears, Illes;019;Escorca;211;129;82;2018
07;Balears, Illes;020;Esporles;5020;2478;2542;2018
07;Balears, Illes;021;Estellencs;318;171;147;2018
07;Balears, Illes;022;Felanitx;17497;8801;8696;2018
07;Balears, Illes;023;Ferreries;4695;2335;2360;2018
07;Balears, Illes;024;Formentera;12216;6428;5788;2018
07;Balears, Illes;025;Fornalutx;678;332;346;2018
07;Balears, Illes;027;Inca;32137;16169;15968;2018
07;Balears, Illes;028;Lloret de Vistalegre;1289;652;637;2018
07;Balears, Illes;029;Lloseta;5858;2941;2917;2018
07;Balears, Illes;030;Llubí;2243;1131;1112;2018
07;Balears, Illes;031;Llucmajor;36358;18444;17914;2018
07;Balears, Illes;033;Manacor;42631;21270;21361;2018
07;Balears, Illes;034;Mancor de la Vall;1455;738;717;2018
07;Balears, Illes;032;Maó-Mahón;28592;13990;14602;2018
07;Balears, Illes;035;Maria de la Salut;2143;1108;1035;2018
07;Balears, Illes;036;Marratxí;36725;18495;18230;2018
07;Balears, Illes;037;Mercadal, Es;4788;2428;2360;2018
07;Balears, Illes;902;Migjorn Gran, Es;1370;683;687;2018
07;Balears, Illes;038;Montuïri;2867;1449;1418;2018
07;Balears, Illes;039;Muro;6931;3504;3427;2018
07;Balears, Illes;040;Palma;409661;199652;210009;2018
07;Balears, Illes;041;Petra;2825;1399;1426;2018
07;Balears, Illes;044;Pobla, Sa;13026;6623;6403;2018
07;Balears, Illes;042;Pollença;16189;8059;8130;2018
07;Balears, Illes;043;Porreres;5339;2722;2617;2018
07;Balears, Illes;045;Puigpunyent;1967;974;993;2018
07;Balears, Illes;059;Salines, Ses;4877;2474;2403;2018
07;Balears, Illes;046;Sant Antoni de Portmany;25779;13529;12250;2018
07;Balears, Illes;049;Sant Joan;2083;1023;1060;2018
07;Balears, Illes;050;Sant Joan de Labritja;6200;3153;3047;2018
07;Balears, Illes;048;Sant Josep de sa Talaia;26496;13663;12833;2018
07;Balears, Illes;051;Sant Llorenç des Cardassar;8405;4151;4254;2018
07;Balears, Illes;052;Sant Lluís;6892;3494;3398;2018
07;Balears, Illes;053;Santa Eugènia;1671;831;840;2018
07;Balears, Illes;054;Santa Eulària des Riu;36457;18517;17940;2018
07;Balears, Illes;055;Santa Margalida;11958;6108;5850;2018
07;Balears, Illes;056;Santa María del Camí;7167;3564;3603;2018
07;Balears, Illes;057;Santanyí;12112;6089;6023;2018
07;Balears, Illes;058;Selva;3981;1994;1987;2018
07;Balears, Illes;047;Sencelles;3195;1615;1580;2018
07;Balears, Illes;060;Sineu;3764;1866;1898;2018
07;Balears, Illes;061;Sóller;14041;7050;6991;2018
07;Balears, Illes;062;Son Servera;11378;5696;5682;2018
07;Balears, Illes;063;Valldemossa;1945;989;956;2018
07;Balears, Illes;065;Vilafranca de Bonany;3176;1606;1570;2018
08;Barcelona;001;Abrera;12334;6248;6086;2018
08;Barcelona;002;Aguilar de Segarra;277;148;129;2018
08;Barcelona;014;Aiguafreda;2501;1204;1297;2018
08;Barcelona;003;Alella;9764;4751;5013;2018
08;Barcelona;004;Alpens;273;146;127;2018
08;Barcelona;005;Ametlla del Vallès, L';8496;4285;4211;2018
08;Barcelona;006;Arenys de Mar;15533;7536;7997;2018
08;Barcelona;007;Arenys de Munt;8838;4439;4399;2018
08;Barcelona;008;Argençola;219;110;109;2018
08;Barcelona;009;Argentona;12295;6053;6242;2018
08;Barcelona;010;Artés;5648;2851;2797;2018
08;Barcelona;011;Avià;2250;1120;1130;2018
08;Barcelona;012;Avinyó;2250;1120;1130;2018
08;Barcelona;013;Avinyonet del Penedès;1669;887;782;2018
08;Barcelona;015;Badalona;217741;107092;110649;2018
08;Barcelona;904;Badia del Vallès;13417;6565;6852;2018
08;Barcelona;016;Bagà;2152;1075;1077;2018
08;Barcelona;017;Balenyà;3783;1907;1876;2018
08;Barcelona;018;Balsareny;3205;1586;1619;2018
08;Barcelona;252;Barberà del Vallès;32839;16167;16672;2018
08;Barcelona;019;Barcelona;1620343;765962;854381;2018
08;Barcelona;020;Begues;6961;3440;3521;2018
08;Barcelona;021;Bellprat;74;46;28;2018
08;Barcelona;022;Berga;16199;7979;8220;2018
08;Barcelona;023;Bigues i Riells;9003;4587;4416;2018
08;Barcelona;024;Borredà;456;257;199;2018
08;Barcelona;025;Bruc, El;2027;1095;932;2018
08;Barcelona;026;Brull, El;257;142;115;2018
08;Barcelona;027;Cabanyes, Les;965;492;473;2018
08;Barcelona;028;Cabrera d'Anoia;1376;726;650;2018
08;Barcelona;029;Cabrera de Mar;4664;2346;2318;2018
08;Barcelona;030;Cabrils;7348;3626;3722;2018
08;Barcelona;031;Calaf;3547;1790;1757;2018
08;Barcelona;034;Calders;946;488;458;2018
08;Barcelona;033;Caldes de Montbui;17449;8669;8780;2018
08;Barcelona;032;Caldes d'Estrac;2859;1380;1479;2018
08;Barcelona;035;Calella;18728;9152;9576;2018
08;Barcelona;037;Calldetenes;2497;1265;1232;2018
08;Barcelona;038;Callús;2095;1025;1070;2018
08;Barcelona;036;Calonge de Segarra;191;95;96;2018
08;Barcelona;039;Campins;515;272;243;2018
08;Barcelona;040;Canet de Mar;14583;7075;7508;2018
08;Barcelona;041;Canovelles;16317;8458;7859;2018
08;Barcelona;042;Cànoves i Samalús;2995;1521;1474;2018
08;Barcelona;043;Canyelles;4481;2310;2171;2018
08;Barcelona;044;Capellades;5211;2572;2639;2018
08;Barcelona;045;Capolat;96;45;51;2018
08;Barcelona;046;Cardedeu;18165;8892;9273;2018
08;Barcelona;047;Cardona;4652;2271;2381;2018
08;Barcelona;048;Carme;783;398;385;2018
08;Barcelona;049;Casserres;1572;780;792;2018
08;Barcelona;057;Castell de l'Areny;72;41;31;2018
08;Barcelona;052;Castellar de n'Hug;165;86;79;2018
08;Barcelona;050;Castellar del Riu;165;92;73;2018
08;Barcelona;051;Castellar del Vallès;24036;11855;12181;2018
08;Barcelona;053;Castellbell i el Vilar;3599;1841;1758;2018
08;Barcelona;054;Castellbisbal;12332;6244;6088;2018
08;Barcelona;055;Castellcir;728;377;351;2018
08;Barcelona;056;Castelldefels;66375;32747;33628;2018
08;Barcelona;058;Castellet i la Gornal;2247;1147;1100;2018
08;Barcelona;060;Castellfollit de Riubregós;156;90;66;2018
08;Barcelona;059;Castellfollit del Boix;446;228;218;2018
08;Barcelona;061;Castellgalí;2053;1065;988;2018
08;Barcelona;062;Castellnou de Bages;1319;666;653;2018
08;Barcelona;063;Castellolí;610;295;315;2018
08;Barcelona;064;Castellterçol;2418;1208;1210;2018
08;Barcelona;065;Castellví de la Marca;1534;772;762;2018
08;Barcelona;066;Castellví de Rosanes;1865;917;948;2018
08;Barcelona;067;Centelles;7423;3643;3780;2018
08;Barcelona;268;Cercs;1152;567;585;2018
08;Barcelona;266;Cerdanyola del Vallès;57740;28259;29481;2018
08;Barcelona;068;Cervelló;8970;4495;4475;2018
08;Barcelona;069;Collbató;4458;2304;2154;2018
08;Barcelona;070;Collsuspina;339;173;166;2018
08;Barcelona;071;Copons;306;151;155;2018
08;Barcelona;072;Corbera de Llobregat;14643;7357;7286;2018
08;Barcelona;073;Cornellà de Llobregat;87173;42226;44947;2018
08;Barcelona;074;Cubelles;14992;7554;7438;2018
08;Barcelona;075;Dosrius;5281;2681;2600;2018
08;Barcelona;076;Esparreguera;22045;11153;10892;2018
08;Barcelona;077;Esplugues de Llobregat;46355;22144;24211;2018
08;Barcelona;078;Espunyola, L';258;130;128;2018
08;Barcelona;254;Esquirol, L';2141;1083;1058;2018
08;Barcelona;079;Estany, L';393;193;200;2018
08;Barcelona;134;Figaró-Montmany;1109;551;558;2018
08;Barcelona;080;Fígols;42;25;17;2018
08;Barcelona;082;Fogars de la Selva;1467;753;714;2018
08;Barcelona;081;Fogars de Montclús;466;245;221;2018
08;Barcelona;083;Folgueroles;2276;1156;1120;2018
08;Barcelona;084;Fonollosa;1439;743;696;2018
08;Barcelona;085;Font-rubí;1354;702;652;2018
08;Barcelona;086;Franqueses del Vallès, Les;19768;10003;9765;2018
08;Barcelona;090;Gaià;167;93;74;2018
08;Barcelona;087;Gallifa;169;90;79;2018
08;Barcelona;088;Garriga, La;16227;7861;8366;2018
08;Barcelona;089;Gavà;46705;22916;23789;2018
08;Barcelona;091;Gelida;7371;3700;3671;2018
08;Barcelona;092;Gironella;4834;2396;2438;2018
08;Barcelona;093;Gisclareny;26;15;11;2018
08;Barcelona;094;Granada, La;2130;1077;1053;2018
08;Barcelona;095;Granera;80;56;24;2018
08;Barcelona;096;Granollers;60981;30023;30958;2018
08;Barcelona;097;Gualba;1481;750;731;2018
08;Barcelona;099;Guardiola de Berguedà;887;458;429;2018
08;Barcelona;100;Gurb;2654;1360;1294;2018
08;Barcelona;101;Hospitalet de Llobregat, L';261068;126066;135002;2018
08;Barcelona;162;Hostalets de Pierola, Els;2930;1502;1428;2018
08;Barcelona;102;Igualada;39540;19393;20147;2018
08;Barcelona;103;Jorba;841;431;410;2018
08;Barcelona;104;Llacuna, La;863;469;394;2018
08;Barcelona;105;Llagosta, La;13367;6595;6772;2018
08;Barcelona;107;Lliçà d'Amunt;15111;7738;7373;2018
08;Barcelona;108;Lliçà de Vall;6480;3299;3181;2018
08;Barcelona;106;Llinars del Vallès;9838;4907;4931;2018
08;Barcelona;109;Lluçà;276;135;141;2018
08;Barcelona;110;Malgrat de Mar;18439;9217;9222;2018
08;Barcelona;111;Malla;271;140;131;2018
08;Barcelona;112;Manlleu;20194;10068;10126;2018
08;Barcelona;113;Manresa;76250;37311;38939;2018
08;Barcelona;242;Marganell;258;127;131;2018
08;Barcelona;114;Martorell;27850;14179;13671;2018
08;Barcelona;115;Martorelles;4794;2410;2384;2018
08;Barcelona;116;Masies de Roda, Les;704;354;350;2018
08;Barcelona;117;Masies de Voltregà, Les;3124;1543;1581;2018
08;Barcelona;118;Masnou, El;23340;11266;12074;2018
08;Barcelona;119;Masquefa;8641;4338;4303;2018
08;Barcelona;120;Matadepera;9291;4666;4625;2018
08;Barcelona;121;Mataró;126988;62945;64043;2018
08;Barcelona;122;Mediona;2331;1170;1161;2018
08;Barcelona;138;Moià;6190;3147;3043;2018
08;Barcelona;123;Molins de Rei;25687;12499;13188;2018
08;Barcelona;124;Mollet del Vallès;51133;25152;25981;2018
08;Barcelona;128;Monistrol de Calders;677;357;320;2018
08;Barcelona;127;Monistrol de Montserrat;2955;1501;1454;2018
08;Barcelona;125;Montcada i Reixac;35599;17522;18077;2018
08;Barcelona;130;Montclar;129;66;63;2018
08;Barcelona;131;Montesquiu;968;492;476;2018
08;Barcelona;126;Montgat;11819;5832;5987;2018
08;Barcelona;132;Montmajor;465;237;228;2018
08;Barcelona;133;Montmaneu;154;88;66;2018
08;Barcelona;135;Montmeló;8784;4298;4486;2018
08;Barcelona;136;Montornès del Vallès;16263;8167;8096;2018
08;Barcelona;137;Montseny;321;166;155;2018
08;Barcelona;129;Muntanyola;620;316;304;2018
08;Barcelona;139;Mura;223;121;102;2018
08;Barcelona;140;Navarcles;5966;2917;3049;2018
08;Barcelona;141;Navàs;6023;2988;3035;2018
08;Barcelona;142;Nou de Berguedà, La;160;81;79;2018
08;Barcelona;143;Òdena;3608;1847;1761;2018
08;Barcelona;145;Olèrdola;3611;1855;1756;2018
08;Barcelona;146;Olesa de Bonesvalls;1787;941;846;2018
08;Barcelona;147;Olesa de Montserrat;23779;11860;11919;2018
08;Barcelona;148;Olivella;3729;1962;1767;2018
08;Barcelona;149;Olost;1188;587;601;2018
08;Barcelona;144;Olvan;837;405;432;2018
08;Barcelona;150;Orís;310;156;154;2018
08;Barcelona;151;Oristà;537;268;269;2018
08;Barcelona;152;Orpí;136;75;61;2018
08;Barcelona;153;Òrrius;730;375;355;2018
08;Barcelona;154;Pacs del Penedès;908;455;453;2018
08;Barcelona;155;Palafolls;9256;4652;4604;2018
08;Barcelona;156;Palau-solità i Plegamans;14636;7160;7476;2018
08;Barcelona;157;Pallejà;11486;5725;5761;2018
08;Barcelona;905;Palma de Cervelló, La;2982;1458;1524;2018
08;Barcelona;158;Papiol, El;4103;2031;2072;2018
08;Barcelona;159;Parets del Vallès;19041;9551;9490;2018
08;Barcelona;160;Perafita;412;210;202;2018
08;Barcelona;161;Piera;15362;7848;7514;2018
08;Barcelona;163;Pineda de Mar;26659;13254;13405;2018
08;Barcelona;164;Pla del Penedès, El;1259;634;625;2018
08;Barcelona;165;Pobla de Claramunt, La;2177;1109;1068;2018
08;Barcelona;166;Pobla de Lillet, La;1101;535;566;2018
08;Barcelona;167;Polinyà;8389;4230;4159;2018
08;Barcelona;182;Pont de Vilomara i Rocafort, El;3801;1959;1842;2018
08;Barcelona;168;Pontons;458;258;200;2018
08;Barcelona;169;Prat de Llobregat, El;64132;31413;32719;2018
08;Barcelona;171;Prats de Lluçanès;2537;1273;1264;2018
08;Barcelona;170;Prats de Rei, Els;545;288;257;2018
08;Barcelona;230;Premià de Dalt;10429;5206;5223;2018
08;Barcelona;172;Premià de Mar;28071;13720;14351;2018
08;Barcelona;174;Puigdàlber;518;257;261;2018
08;Barcelona;175;Puig-reig;4094;2024;2070;2018
08;Barcelona;176;Pujalt;207;113;94;2018
08;Barcelona;177;Quar, La;60;32;28;2018
08;Barcelona;178;Rajadell;539;274;265;2018
08;Barcelona;179;Rellinars;747;386;361;2018
08;Barcelona;180;Ripollet;38347;18980;19367;2018
08;Barcelona;181;Roca del Vallès, La;10666;5314;5352;2018
08;Barcelona;183;Roda de Ter;6197;3039;3158;2018
08;Barcelona;184;Rubí;76423;37840;38583;2018
08;Barcelona;185;Rubió;232;129;103;2018
08;Barcelona;901;Rupit i Pruit;279;139;140;2018
08;Barcelona;187;Sabadell;211734;102927;108807;2018
08;Barcelona;188;Sagàs;161;90;71;2018
08;Barcelona;190;Saldes;265;154;111;2018
08;Barcelona;191;Sallent;6636;3194;3442;2018
08;Barcelona;194;Sant Adrià de Besòs;36669;18028;18641;2018
08;Barcelona;195;Sant Agustí de Lluçanès;87;44;43;2018
08;Barcelona;196;Sant Andreu de la Barca;27332;13552;13780;2018
08;Barcelona;197;Sant Andreu de Llavaneres;10877;5370;5507;2018
08;Barcelona;198;Sant Antoni de Vilamajor;6095;3032;3063;2018
08;Barcelona;199;Sant Bartomeu del Grau;840;446;394;2018
08;Barcelona;200;Sant Boi de Llobregat;82904;40601;42303;2018
08;Barcelona;201;Sant Boi de Lluçanès;532;260;272;2018
08;Barcelona;203;Sant Cebrià de Vallalta;3344;1743;1601;2018
08;Barcelona;202;Sant Celoni;17754;8833;8921;2018
08;Barcelona;204;Sant Climent de Llobregat;4107;2074;2033;2018
08;Barcelona;205;Sant Cugat del Vallès;90664;44106;46558;2018
08;Barcelona;206;Sant Cugat Sesgarrigues;989;474;515;2018
08;Barcelona;207;Sant Esteve de Palautordera;2749;1359;1390;2018
08;Barcelona;208;Sant Esteve Sesrovires;7800;3920;3880;2018
08;Barcelona;210;Sant Feliu de Codines;6184;3132;3052;2018
08;Barcelona;211;Sant Feliu de Llobregat;44474;21536;22938;2018
08;Barcelona;212;Sant Feliu Sasserra;600;316;284;2018
08;Barcelona;209;Sant Fost de Campsentelles;8722;4330;4392;2018
08;Barcelona;213;Sant Fruitós de Bages;8593;4256;4337;2018
08;Barcelona;215;Sant Hipòlit de Voltregà;3475;1721;1754;2018
08;Barcelona;193;Sant Iscle de Vallalta;1313;677;636;2018
08;Barcelona;216;Sant Jaume de Frontanyà;30;18;12;2018
08;Barcelona;218;Sant Joan de Vilatorrada;10820;5422;5398;2018
08;Barcelona;217;Sant Joan Despí;34084;16569;17515;2018
08;Barcelona;903;Sant Julià de Cerdanyola;244;133;111;2018
08;Barcelona;220;Sant Julià de Vilatorta;3096;1529;1567;2018
08;Barcelona;221;Sant Just Desvern;17494;8361;9133;2018
08;Barcelona;222;Sant Llorenç d'Hortons;2598;1323;1275;2018
08;Barcelona;223;Sant Llorenç Savall;2371;1190;1181;2018
08;Barcelona;225;Sant Martí d'Albars;113;56;57;2018
08;Barcelona;224;Sant Martí de Centelles;1131;590;541;2018
08;Barcelona;226;Sant Martí de Tous;1206;616;590;2018
08;Barcelona;227;Sant Martí Sarroca;3231;1591;1640;2018
08;Barcelona;228;Sant Martí Sesgueioles;344;179;165;2018
08;Barcelona;229;Sant Mateu de Bages;600;300;300;2018
08;Barcelona;231;Sant Pere de Ribes;30658;15311;15347;2018
08;Barcelona;232;Sant Pere de Riudebitlles;2338;1161;1177;2018
08;Barcelona;233;Sant Pere de Torelló;2419;1251;1168;2018
08;Barcelona;234;Sant Pere de Vilamajor;4371;2168;2203;2018
08;Barcelona;189;Sant Pere Sallavinera;155;84;71;2018
08;Barcelona;235;Sant Pol de Mar;5178;2563;2615;2018
08;Barcelona;236;Sant Quintí de Mediona;2179;1119;1060;2018
08;Barcelona;237;Sant Quirze de Besora;2107;1027;1080;2018
08;Barcelona;238;Sant Quirze del Vallès;19939;9754;10185;2018
08;Barcelona;239;Sant Quirze Safaja;637;332;305;2018
08;Barcelona;240;Sant Sadurní d'Anoia;12866;6322;6544;2018
08;Barcelona;241;Sant Sadurní d'Osormort;79;46;33;2018
08;Barcelona;098;Sant Salvador de Guardiola;3168;1624;1544;2018
08;Barcelona;262;Sant Vicenç de Castellet;9274;4620;4654;2018
08;Barcelona;264;Sant Vicenç de Montalt;6372;3194;3178;2018
08;Barcelona;265;Sant Vicenç de Torelló;2014;993;1021;2018
08;Barcelona;263;Sant Vicenç dels Horts;27901;13846;14055;2018
08;Barcelona;243;Santa Cecília de Voltregà;187;96;91;2018
08;Barcelona;244;Santa Coloma de Cervelló;8179;4018;4161;2018
08;Barcelona;245;Santa Coloma de Gramenet;118821;58849;59972;2018
08;Barcelona;246;Santa Eugènia de Berga;2226;1130;1096;2018
08;Barcelona;247;Santa Eulàlia de Riuprimer;1309;670;639;2018
08;Barcelona;248;Santa Eulàlia de Ronçana;7192;3601;3591;2018
08;Barcelona;249;Santa Fe del Penedès;379;191;188;2018
08;Barcelona;250;Santa Margarida de Montbui;9874;4940;4934;2018
08;Barcelona;251;Santa Margarida i els Monjos;7503;3802;3701;2018
08;Barcelona;253;Santa Maria de Besora;143;72;71;2018
08;Barcelona;256;Santa Maria de Martorelles;882;439;443;2018
08;Barcelona;255;Santa Maria de Merlès;183;90;93;2018
08;Barcelona;257;Santa Maria de Miralles;128;69;59;2018
08;Barcelona;259;Santa Maria de Palautordera;9325;4673;4652;2018
08;Barcelona;258;Santa Maria d'Oló;1024;516;508;2018
08;Barcelona;260;Santa Perpètua de Mogoda;25705;12933;12772;2018
08;Barcelona;261;Santa Susanna;3381;1700;1681;2018
08;Barcelona;192;Santpedor;7532;3739;3793;2018
08;Barcelona;267;Sentmenat;8957;4532;4425;2018
08;Barcelona;269;Seva;3472;1746;1726;2018
08;Barcelona;270;Sitges;28969;14476;14493;2018
08;Barcelona;271;Sobremunt;79;34;45;2018
08;Barcelona;272;Sora;205;115;90;2018
08;Barcelona;273;Subirats;3025;1556;1469;2018
08;Barcelona;274;Súria;5895;2874;3021;2018
08;Barcelona;276;Tagamanent;333;174;159;2018
08;Barcelona;277;Talamanca;202;115;87;2018
08;Barcelona;278;Taradell;6412;3188;3224;2018
08;Barcelona;275;Tavèrnoles;320;159;161;2018
08;Barcelona;280;Tavertet;111;58;53;2018
08;Barcelona;281;Teià;6312;3093;3219;2018
08;Barcelona;279;Terrassa;218535;107540;110995;2018
08;Barcelona;282;Tiana;8709;4170;4539;2018
08;Barcelona;283;Tona;8131;4024;4107;2018
08;Barcelona;284;Tordera;16937;8576;8361;2018
08;Barcelona;285;Torelló;14172;7021;7151;2018
08;Barcelona;286;Torre de Claramunt, La;3716;1911;1805;2018
08;Barcelona;287;Torrelavit;1430;736;694;2018
08;Barcelona;288;Torrelles de Foix;2281;1219;1062;2018
08;Barcelona;289;Torrelles de Llobregat;5945;2941;3004;2018
08;Barcelona;290;Ullastrell;2069;1038;1031;2018
08;Barcelona;291;Vacarisses;6486;3340;3146;2018
08;Barcelona;292;Vallbona d'Anoia;1399;729;670;2018
08;Barcelona;293;Vallcebre;246;139;107;2018
08;Barcelona;294;Vallgorguina;2854;1427;1427;2018
08;Barcelona;295;Vallirana;14877;7441;7436;2018
08;Barcelona;296;Vallromanes;2530;1297;1233;2018
08;Barcelona;297;Veciana;170;95;75;2018
08;Barcelona;298;Vic;45040;22626;22414;2018
08;Barcelona;299;Vilada;430;226;204;2018
08;Barcelona;301;Viladecans;66168;32785;33383;2018
08;Barcelona;300;Viladecavalls;7480;3707;3773;2018
08;Barcelona;305;Vilafranca del Penedès;40055;19552;20503;2018
08;Barcelona;306;Vilalba Sasserra;688;343;345;2018
08;Barcelona;303;Vilanova de Sau;308;143;165;2018
08;Barcelona;302;Vilanova del Camí;12361;6178;6183;2018
08;Barcelona;902;Vilanova del Vallès;5339;2701;2638;2018
08;Barcelona;307;Vilanova i la Geltrú;66274;32079;34195;2018
08;Barcelona;214;Vilassar de Dalt;9013;4435;4578;2018
08;Barcelona;219;Vilassar de Mar;20764;10018;10746;2018
08;Barcelona;304;Vilobí del Penedès;1106;582;524;2018
08;Barcelona;308;Viver i Serrateix;164;86;78;2018
48;Bizkaia;001;Abadiño;7533;3771;3762;2018
48;Bizkaia;002;Abanto y Ciérvana-Abanto Zierbena;9545;4701;4844;2018
48;Bizkaia;911;Ajangiz;482;253;229;2018
48;Bizkaia;912;Alonsotegi;2903;1429;1474;2018
48;Bizkaia;003;Amorebieta-Etxano;19140;9380;9760;2018
48;Bizkaia;004;Amoroto;419;215;204;2018
48;Bizkaia;005;Arakaldo;156;72;84;2018
48;Bizkaia;006;Arantzazu;393;193;200;2018
48;Bizkaia;093;Areatza;1212;579;633;2018
48;Bizkaia;009;Arrankudiaga;970;477;493;2018
48;Bizkaia;914;Arratzu;418;202;216;2018
48;Bizkaia;010;Arrieta;567;290;277;2018
48;Bizkaia;011;Arrigorriaga;12230;5957;6273;2018
48;Bizkaia;023;Artea;735;365;370;2018
48;Bizkaia;008;Artzentales;734;395;339;2018
48;Bizkaia;091;Atxondo;1377;696;681;2018
48;Bizkaia;070;Aulesti;648;319;329;2018
48;Bizkaia;012;Bakio;2645;1339;1306;2018
48;Bizkaia;090;Balmaseda;7684;3728;3956;2018
48;Bizkaia;013;Barakaldo;100435;48549;51886;2018
48;Bizkaia;014;Barrika;1541;757;784;2018
48;Bizkaia;015;Basauri;40762;19775;20987;2018
48;Bizkaia;092;Bedia;1041;499;542;2018
48;Bizkaia;016;Berango;7130;3495;3635;2018
48;Bizkaia;017;Bermeo;16688;8239;8449;2018
48;Bizkaia;018;Berriatua;1247;685;562;2018
48;Bizkaia;019;Berriz;4678;2338;2340;2018
48;Bizkaia;020;Bilbao;345821;162931;182890;2018
48;Bizkaia;021;Busturia;1637;825;812;2018
48;Bizkaia;901;Derio;6545;3216;3329;2018
48;Bizkaia;026;Dima;1447;750;697;2018
48;Bizkaia;027;Durango;29636;14510;15126;2018
48;Bizkaia;028;Ea;831;424;407;2018
48;Bizkaia;031;Elantxobe;346;172;174;2018
48;Bizkaia;032;Elorrio;7336;3625;3711;2018
48;Bizkaia;902;Erandio;24222;11764;12458;2018
48;Bizkaia;033;Ereño;239;134;105;2018
48;Bizkaia;034;Ermua;15890;7915;7975;2018
48;Bizkaia;079;Errigoiti;487;268;219;2018
48;Bizkaia;029;Etxebarri;11304;5660;5644;2018
48;Bizkaia;030;Etxebarria;772;385;387;2018
48;Bizkaia;906;Forua;929;458;471;2018
48;Bizkaia;035;Fruiz;545;270;275;2018
48;Bizkaia;036;Galdakao;29288;14438;14850;2018
48;Bizkaia;037;Galdames;829;445;384;2018
48;Bizkaia;038;Gamiz-Fika;1375;677;698;2018
48;Bizkaia;039;Garai;320;161;159;2018
48;Bizkaia;040;Gatika;1673;834;839;2018
48;Bizkaia;041;Gautegiz Arteaga;840;422;418;2018
48;Bizkaia;046;Gernika-Lumo;16972;8179;8793;2018
48;Bizkaia;044;Getxo;78276;36639;41637;2018
48;Bizkaia;047;Gizaburuaga;212;111;101;2018
48;Bizkaia;042;Gordexola;1686;854;832;2018
48;Bizkaia;043;Gorliz;5683;2809;2874;2018
48;Bizkaia;045;Güeñes;6681;3224;3457;2018
48;Bizkaia;048;Ibarrangelu;636;328;308;2018
48;Bizkaia;094;Igorre;4257;2082;2175;2018
48;Bizkaia;049;Ispaster;725;383;342;2018
48;Bizkaia;910;Iurreta;3643;1818;1825;2018
48;Bizkaia;050;Izurtza;255;155;100;2018
48;Bizkaia;022;Karrantza Harana/Valle de Carranza;2715;1408;1307;2018
48;Bizkaia;907;Kortezubi;444;222;222;2018
48;Bizkaia;051;Lanestosa;254;135;119;2018
48;Bizkaia;052;Larrabetzu;2029;981;1048;2018
48;Bizkaia;053;Laukiz;1191;593;598;2018
48;Bizkaia;054;Leioa;31495;15366;16129;2018
48;Bizkaia;057;Lekeitio;7258;3591;3667;2018
48;Bizkaia;055;Lemoa;3521;1760;1761;2018
48;Bizkaia;056;Lemoiz;1241;656;585;2018
48;Bizkaia;081;Lezama;2429;1205;1224;2018
48;Bizkaia;903;Loiu;2416;1212;1204;2018
48;Bizkaia;058;Mallabia;1158;586;572;2018
48;Bizkaia;059;Mañaria;519;271;248;2018
48;Bizkaia;060;Markina-Xemein;4934;2508;2426;2018
48;Bizkaia;061;Maruri-Jatabe;982;505;477;2018
48;Bizkaia;062;Mendata;381;194;187;2018
48;Bizkaia;063;Mendexa;432;220;212;2018
48;Bizkaia;064;Meñaka;755;397;358;2018
48;Bizkaia;066;Morga;423;225;198;2018
48;Bizkaia;068;Mundaka;1835;883;952;2018
48;Bizkaia;069;Mungia;17554;8552;9002;2018
48;Bizkaia;007;Munitibar-Arbatzegi Gerrikaitz;460;249;211;2018
48;Bizkaia;908;Murueta;309;156;153;2018
48;Bizkaia;071;Muskiz;7567;3731;3836;2018
48;Bizkaia;067;Muxika;1455;762;693;2018
48;Bizkaia;909;Nabarniz;255;128;127;2018
48;Bizkaia;073;Ondarroa;8397;4218;4179;2018
48;Bizkaia;075;Orozko;2651;1297;1354;2018
48;Bizkaia;083;Ortuella;8360;4081;4279;2018
48;Bizkaia;072;Otxandio;1296;655;641;2018
48;Bizkaia;077;Plentzia;4363;2134;2229;2018
48;Bizkaia;078;Portugalete;45826;21955;23871;2018
48;Bizkaia;082;Santurtzi;45795;22039;23756;2018
48;Bizkaia;084;Sestao;27445;13309;14136;2018
48;Bizkaia;904;Sondika;4495;2170;2325;2018
48;Bizkaia;085;Sopela;13643;6716;6927;2018
48;Bizkaia;086;Sopuerta;2569;1282;1287;2018
48;Bizkaia;076;Sukarrieta;357;186;171;2018
48;Bizkaia;087;Trucios-Turtzioz;511;272;239;2018
48;Bizkaia;088;Ubide;177;92;85;2018
48;Bizkaia;065;Ugao-Miraballes;4124;2063;2061;2018
48;Bizkaia;089;Urduliz;4319;2136;2183;2018
48;Bizkaia;074;Urduña/Orduña;4180;2159;2021;2018
48;Bizkaia;080;Valle de Trápaga-Trapagaran;11953;5821;6132;2018
48;Bizkaia;095;Zaldibar;3054;1539;1515;2018
48;Bizkaia;096;Zalla;8379;4125;4254;2018
48;Bizkaia;905;Zamudio;3236;1584;1652;2018
48;Bizkaia;097;Zaratamo;1615;799;816;2018
48;Bizkaia;024;Zeanuri;1242;624;618;2018
48;Bizkaia;025;Zeberio;1059;544;515;2018
48;Bizkaia;913;Zierbena;1492;792;700;2018
48;Bizkaia;915;Ziortza-Bolibar;427;227;200;2018
09;Burgos;001;Abajas;27;19;8;2018
09;Burgos;003;Adrada de Haza;219;110;109;2018
09;Burgos;006;Aguas Cándidas;57;35;22;2018
09;Burgos;007;Aguilar de Bureba;61;38;23;2018
09;Burgos;009;Albillos;214;111;103;2018
09;Burgos;010;Alcocero de Mola;36;26;10;2018
09;Burgos;011;Alfoz de Bricia;77;46;31;2018
09;Burgos;907;Alfoz de Quintanadueñas;2007;1071;936;2018
09;Burgos;012;Alfoz de Santa Gadea;100;57;43;2018
09;Burgos;013;Altable;53;31;22;2018
09;Burgos;014;Altos, Los;186;111;75;2018
09;Burgos;016;Ameyugo;105;60;45;2018
09;Burgos;017;Anguix;135;74;61;2018
09;Burgos;018;Aranda de Duero;32523;15805;16718;2018
09;Burgos;019;Arandilla;161;99;62;2018
09;Burgos;020;Arauzo de Miel;326;176;150;2018
09;Burgos;021;Arauzo de Salce;56;34;22;2018
09;Burgos;022;Arauzo de Torre;73;42;31;2018
09;Burgos;023;Arcos;1684;895;789;2018
09;Burgos;024;Arenillas de Riopisuerga;182;107;75;2018
09;Burgos;025;Arija;126;65;61;2018
09;Burgos;026;Arlanzón;408;252;156;2018
09;Burgos;027;Arraya de Oca;49;29;20;2018
09;Burgos;029;Atapuerca;172;98;74;2018
09;Burgos;030;Ausines, Los;129;75;54;2018
09;Burgos;032;Avellanosa de Muñó;112;60;52;2018
09;Burgos;033;Bahabón de Esgueva;73;45;28;2018
09;Burgos;034;Balbases, Los;311;173;138;2018
09;Burgos;035;Baños de Valdearados;342;201;141;2018
09;Burgos;036;Bañuelos de Bureba;34;19;15;2018
09;Burgos;037;Barbadillo de Herreros;109;64;45;2018
09;Burgos;038;Barbadillo del Mercado;143;76;67;2018
09;Burgos;039;Barbadillo del Pez;67;41;26;2018
09;Burgos;041;Barrio de Muñó;33;19;14;2018
09;Burgos;043;Barrios de Bureba, Los;194;115;79;2018
09;Burgos;044;Barrios de Colina;53;28;25;2018
09;Burgos;045;Basconcillos del Tozo;285;159;126;2018
09;Burgos;046;Bascuñana;25;16;9;2018
09;Burgos;047;Belbimbre;67;34;33;2018
09;Burgos;048;Belorado;1816;926;890;2018
09;Burgos;050;Berberana;55;31;24;2018
09;Burgos;051;Berlangas de Roa;184;100;84;2018
09;Burgos;052;Berzosa de Bureba;29;21;8;2018
09;Burgos;054;Bozoó;98;61;37;2018
09;Burgos;055;Brazacorta;55;31;24;2018
09;Burgos;056;Briviesca;6675;3323;3352;2018
09;Burgos;057;Bugedo;173;114;59;2018
09;Burgos;058;Buniel;543;299;244;2018
09;Burgos;059;Burgos;175921;83728;92193;2018
09;Burgos;060;Busto de Bureba;149;79;70;2018
09;Burgos;061;Cabañes de Esgueva;169;94;75;2018
09;Burgos;062;Cabezón de la Sierra;53;26;27;2018
09;Burgos;064;Caleruega;433;227;206;2018
09;Burgos;065;Campillo de Aranda;162;98;64;2018
09;Burgos;066;Campolara;61;45;16;2018
09;Burgos;067;Canicosa de la Sierra;470;246;224;2018
09;Burgos;068;Cantabrana;27;15;12;2018
09;Burgos;070;Carazo;33;24;9;2018
09;Burgos;071;Carcedo de Bureba;44;25;19;2018
09;Burgos;072;Carcedo de Burgos;411;223;188;2018
09;Burgos;073;Cardeñadijo;1313;722;591;2018
09;Burgos;074;Cardeñajimeno;1101;569;532;2018
09;Burgos;075;Cardeñuela Riopico;112;65;47;2018
09;Burgos;076;Carrias;25;19;6;2018
09;Burgos;077;Cascajares de Bureba;33;16;17;2018
09;Burgos;078;Cascajares de la Sierra;37;21;16;2018
09;Burgos;079;Castellanos de Castro;50;30;20;2018
09;Burgos;083;Castil de Peones;32;18;14;2018
09;Burgos;082;Castildelgado;36;21;15;2018
09;Burgos;084;Castrillo de la Reina;185;119;66;2018
09;Burgos;085;Castrillo de la Vega;632;345;287;2018
09;Burgos;088;Castrillo de Riopisuerga;62;38;24;2018
09;Burgos;086;Castrillo del Val;792;453;339;2018
09;Burgos;090;Castrillo Mota de Judíos;52;28;24;2018
09;Burgos;091;Castrojeriz;803;417;386;2018
09;Burgos;063;Cavia;233;138;95;2018
09;Burgos;093;Cayuela;177;94;83;2018
09;Burgos;094;Cebrecos;54;33;21;2018
09;Burgos;095;Celada del Camino;115;57;58;2018
09;Burgos;098;Cerezo de Río Tirón;575;313;262;2018
09;Burgos;100;Cerratón de Juarros;57;37;20;2018
09;Burgos;101;Ciadoncha;78;46;32;2018
09;Burgos;102;Cillaperlata;33;22;11;2018
09;Burgos;103;Cilleruelo de Abajo;224;124;100;2018
09;Burgos;104;Cilleruelo de Arriba;44;23;21;2018
09;Burgos;105;Ciruelos de Cervera;101;58;43;2018
09;Burgos;108;Cogollos;545;299;246;2018
09;Burgos;109;Condado de Treviño;1352;768;584;2018
09;Burgos;110;Contreras;80;50;30;2018
09;Burgos;112;Coruña del Conde;112;69;43;2018
09;Burgos;113;Covarrubias;545;289;256;2018
09;Burgos;114;Cubillo del Campo;95;53;42;2018
09;Burgos;115;Cubo de Bureba;98;55;43;2018
09;Burgos;117;Cueva de Roa, La;85;43;42;2018
09;Burgos;119;Cuevas de San Clemente;45;16;29;2018
09;Burgos;120;Encío;42;24;18;2018
09;Burgos;122;Espinosa de Cervera;95;60;35;2018
09;Burgos;124;Espinosa de los Monteros;1696;891;805;2018
09;Burgos;123;Espinosa del Camino;44;27;17;2018
09;Burgos;125;Estépar;608;363;245;2018
09;Burgos;127;Fontioso;52;31;21;2018
09;Burgos;128;Frandovínez;84;49;35;2018
09;Burgos;129;Fresneda de la Sierra Tirón;101;66;35;2018
09;Burgos;130;Fresneña;76;47;29;2018
09;Burgos;131;Fresnillo de las Dueñas;653;342;311;2018
09;Burgos;132;Fresno de Río Tirón;181;112;69;2018
09;Burgos;133;Fresno de Rodilla;45;25;20;2018
09;Burgos;134;Frías;254;133;121;2018
09;Burgos;135;Fuentebureba;41;22;19;2018
09;Burgos;136;Fuentecén;227;124;103;2018
09;Burgos;137;Fuentelcésped;235;118;117;2018
09;Burgos;138;Fuentelisendo;83;45;38;2018
09;Burgos;139;Fuentemolinos;107;69;38;2018
09;Burgos;140;Fuentenebro;126;77;49;2018
09;Burgos;141;Fuentespina;775;400;375;2018
09;Burgos;143;Galbarros;29;18;11;2018
09;Burgos;144;Gallega, La;45;29;16;2018
09;Burgos;148;Grijalba;100;51;49;2018
09;Burgos;149;Grisaleña;37;28;9;2018
09;Burgos;151;Gumiel de Izán;548;310;238;2018
09;Burgos;152;Gumiel de Mercado;310;171;139;2018
09;Burgos;154;Hacinas;155;89;66;2018
09;Burgos;155;Haza;26;16;10;2018
09;Burgos;159;Hontanas;69;43;26;2018
09;Burgos;160;Hontangas;91;59;32;2018
09;Burgos;162;Hontoria de la Cantera;156;82;74;2018
09;Burgos;164;Hontoria de Valdearados;180;109;71;2018
09;Burgos;163;Hontoria del Pinar;669;371;298;2018
09;Burgos;166;Hormazas, Las;105;61;44;2018
09;Burgos;167;Hornillos del Camino;58;36;22;2018
09;Burgos;168;Horra, La;337;182;155;2018
09;Burgos;169;Hortigüela;103;69;34;2018
09;Burgos;170;Hoyales de Roa;223;120;103;2018
09;Burgos;172;Huérmeces;136;70;66;2018
09;Burgos;173;Huerta de Arriba;133;75;58;2018
09;Burgos;174;Huerta de Rey;932;507;425;2018
09;Burgos;175;Humada;121;82;39;2018
09;Burgos;176;Hurones;62;42;20;2018
09;Burgos;177;Ibeas de Juarros;1405;764;641;2018
09;Burgos;178;Ibrillos;45;29;16;2018
09;Burgos;179;Iglesiarrubia;41;22;19;2018
09;Burgos;180;Iglesias;137;76;61;2018
09;Burgos;181;Isar;307;160;147;2018
09;Burgos;182;Itero del Castillo;78;45;33;2018
09;Burgos;183;Jaramillo de la Fuente;49;31;18;2018
09;Burgos;184;Jaramillo Quemado;8;6;2;2018
09;Burgos;189;Junta de Traslaloma;131;72;59;2018
09;Burgos;190;Junta de Villalba de Losa;86;48;38;2018
09;Burgos;191;Jurisdicción de Lara;33;20;13;2018
09;Burgos;192;Jurisdicción de San Zadornil;55;31;24;2018
09;Burgos;194;Lerma;2560;1281;1279;2018
09;Burgos;195;Llano de Bureba;60;39;21;2018
09;Burgos;196;Madrigal del Monte;147;89;58;2018
09;Burgos;197;Madrigalejo del Monte;168;109;59;2018
09;Burgos;198;Mahamud;112;65;47;2018
09;Burgos;199;Mambrilla de Castrejón;100;56;44;2018
09;Burgos;200;Mambrillas de Lara;52;31;21;2018
09;Burgos;201;Mamolar;29;21;8;2018
09;Burgos;202;Manciles;22;14;8;2018
09;Burgos;206;Mazuela;56;32;24;2018
09;Burgos;208;Mecerreyes;211;111;100;2018
09;Burgos;209;Medina de Pomar;5816;2958;2858;2018
09;Burgos;211;Melgar de Fernamental;1611;866;745;2018
09;Burgos;213;Merindad de Cuesta-Urria;313;172;141;2018
09;Burgos;214;Merindad de Montija;733;438;295;2018
09;Burgos;906;Merindad de Río Ubierna;1443;798;645;2018
09;Burgos;215;Merindad de Sotoscueva;402;227;175;2018
09;Burgos;216;Merindad de Valdeporres;429;222;207;2018
09;Burgos;217;Merindad de Valdivielso;386;222;164;2018
09;Burgos;218;Milagros;451;244;207;2018
09;Burgos;219;Miranda de Ebro;35477;17433;18044;2018
09;Burgos;220;Miraveche;71;47;24;2018
09;Burgos;221;Modúbar de la Emparedada;669;369;300;2018
09;Burgos;223;Monasterio de la Sierra;44;29;15;2018
09;Burgos;224;Monasterio de Rodilla;164;89;75;2018
09;Burgos;225;Moncalvillo;87;52;35;2018
09;Burgos;226;Monterrubio de la Demanda;59;36;23;2018
09;Burgos;227;Montorio;148;78;70;2018
09;Burgos;228;Moradillo de Roa;172;92;80;2018
09;Burgos;229;Nava de Roa;224;121;103;2018
09;Burgos;230;Navas de Bureba;35;18;17;2018
09;Burgos;231;Nebreda;65;47;18;2018
09;Burgos;232;Neila;158;93;65;2018
09;Burgos;235;Olmedillo de Roa;189;110;79;2018
09;Burgos;236;Olmillos de Muñó;37;22;15;2018
09;Burgos;238;Oña;1024;538;486;2018
09;Burgos;239;Oquillas;55;31;24;2018
09;Burgos;241;Orbaneja Riopico;328;177;151;2018
09;Burgos;242;Padilla de Abajo;78;44;34;2018
09;Burgos;243;Padilla de Arriba;77;47;30;2018
09;Burgos;244;Padrones de Bureba;50;25;25;2018
09;Burgos;246;Palacios de la Sierra;721;371;350;2018
09;Burgos;247;Palacios de Riopisuerga;24;12;12;2018
09;Burgos;248;Palazuelos de la Sierra;82;48;34;2018
09;Burgos;249;Palazuelos de Muñó;52;29;23;2018
09;Burgos;250;Pampliega;282;152;130;2018
09;Burgos;251;Pancorbo;436;239;197;2018
09;Burgos;253;Pardilla;117;69;48;2018
09;Burgos;255;Partido de la Sierra en Tobalina;90;52;38;2018
09;Burgos;256;Pedrosa de Duero;438;253;185;2018
09;Burgos;259;Pedrosa de Río Úrbel;251;149;102;2018
09;Burgos;257;Pedrosa del Páramo;94;57;37;2018
09;Burgos;258;Pedrosa del Príncipe;174;93;81;2018
09;Burgos;261;Peñaranda de Duero;527;261;266;2018
09;Burgos;262;Peral de Arlanza;167;91;76;2018
09;Burgos;265;Piérnigas;38;22;16;2018
09;Burgos;266;Pineda de la Sierra;103;66;37;2018
09;Burgos;267;Pineda Trasmonte;111;66;45;2018
09;Burgos;268;Pinilla de los Barruecos;111;62;49;2018
09;Burgos;269;Pinilla de los Moros;36;21;15;2018
09;Burgos;270;Pinilla Trasmonte;167;96;71;2018
09;Burgos;272;Poza de la Sal;294;155;139;2018
09;Burgos;273;Prádanos de Bureba;53;33;20;2018
09;Burgos;274;Pradoluengo;1169;586;583;2018
09;Burgos;275;Presencio;179;110;69;2018
09;Burgos;276;Puebla de Arganzón, La;495;269;226;2018
09;Burgos;277;Puentedura;115;78;37;2018
09;Burgos;279;Quemada;238;142;96;2018
09;Burgos;281;Quintana del Pidio;154;80;74;2018
09;Burgos;280;Quintanabureba;24;14;10;2018
09;Burgos;283;Quintanaélez;46;24;22;2018
09;Burgos;287;Quintanaortuño;267;154;113;2018
09;Burgos;288;Quintanapalla;111;63;48;2018
09;Burgos;289;Quintanar de la Sierra;1690;892;798;2018
09;Burgos;292;Quintanavides;79;48;31;2018
09;Burgos;294;Quintanilla de la Mata;114;69;45;2018
09;Burgos;901;Quintanilla del Agua y Tordueles;383;200;183;2018
09;Burgos;295;Quintanilla del Coco;57;28;29;2018
09;Burgos;298;Quintanilla San García;87;49;38;2018
09;Burgos;301;Quintanilla Vivar;803;426;377;2018
09;Burgos;297;Quintanillas, Las;376;217;159;2018
09;Burgos;302;Rabanera del Pinar;108;66;42;2018
09;Burgos;303;Rábanos;83;51;32;2018
09;Burgos;304;Rabé de las Calzadas;208;111;97;2018
09;Burgos;306;Rebolledo de la Torre;112;61;51;2018
09;Burgos;307;Redecilla del Camino;115;72;43;2018
09;Burgos;308;Redecilla del Campo;68;39;29;2018
09;Burgos;309;Regumiel de la Sierra;349;185;164;2018
09;Burgos;310;Reinoso;11;8;3;2018
09;Burgos;311;Retuerta;59;37;22;2018
09;Burgos;314;Revilla del Campo;94;60;34;2018
09;Burgos;316;Revilla Vallejera;115;73;42;2018
09;Burgos;312;Revilla y Ahedo, La;107;60;47;2018
09;Burgos;315;Revillarruz;523;269;254;2018
09;Burgos;317;Rezmondo;19;7;12;2018
09;Burgos;318;Riocavado de la Sierra;60;38;22;2018
09;Burgos;321;Roa;2185;1104;1081;2018
09;Burgos;323;Rojas;65;43;22;2018
09;Burgos;325;Royuela de Río Franco;193;117;76;2018
09;Burgos;326;Rubena;183;106;77;2018
09;Burgos;327;Rublacedo de Abajo;36;18;18;2018
09;Burgos;328;Rucandio;65;31;34;2018
09;Burgos;329;Salas de Bureba;131;76;55;2018
09;Burgos;330;Salas de los Infantes;1955;1007;948;2018
09;Burgos;332;Saldaña de Burgos;169;92;77;2018
09;Burgos;334;Salinillas de Bureba;51;41;10;2018
09;Burgos;335;San Adrián de Juarros;88;55;33;2018
09;Burgos;337;San Juan del Monte;142;79;63;2018
09;Burgos;338;San Mamés de Burgos;298;168;130;2018
09;Burgos;339;San Martín de Rubiales;141;82;59;2018
09;Burgos;340;San Millán de Lara;79;56;23;2018
09;Burgos;360;San Vicente del Valle;25;20;5;2018
09;Burgos;343;Santa Cecilia;101;61;40;2018
09;Burgos;345;Santa Cruz de la Salceda;140;87;53;2018
09;Burgos;346;Santa Cruz del Valle Urbión;99;65;34;2018
09;Burgos;347;Santa Gadea del Cid;145;74;71;2018
09;Burgos;348;Santa Inés;141;74;67;2018
09;Burgos;350;Santa María del Campo;537;291;246;2018
09;Burgos;351;Santa María del Invierno;62;45;17;2018
09;Burgos;352;Santa María del Mercadillo;104;66;38;2018
09;Burgos;353;Santa María Rivarredonda;91;54;37;2018
09;Burgos;354;Santa Olalla de Bureba;35;26;9;2018
09;Burgos;355;Santibáñez de Esgueva;85;46;39;2018
09;Burgos;356;Santibáñez del Val;45;28;17;2018
09;Burgos;358;Santo Domingo de Silos;279;172;107;2018
09;Burgos;361;Sargentes de la Lora;114;64;50;2018
09;Burgos;362;Sarracín;245;135;110;2018
09;Burgos;363;Sasamón;995;562;433;2018
09;Burgos;365;Sequera de Haza, La;31;22;9;2018
09;Burgos;366;Solarana;77;45;32;2018
09;Burgos;368;Sordillos;23;16;7;2018
09;Burgos;369;Sotillo de la Ribera;490;255;235;2018
09;Burgos;372;Sotragero;268;143;125;2018
09;Burgos;373;Sotresgudo;448;258;190;2018
09;Burgos;374;Susinos del Páramo;103;66;37;2018
09;Burgos;375;Tamarón;38;21;17;2018
09;Burgos;377;Tardajos;782;422;360;2018
09;Burgos;378;Tejada;29;17;12;2018
09;Burgos;380;Terradillos de Esgueva;80;38;42;2018
09;Burgos;381;Tinieblas de la Sierra;34;20;14;2018
09;Burgos;382;Tobar;24;17;7;2018
09;Burgos;384;Tordómar;346;189;157;2018
09;Burgos;386;Torrecilla del Monte;65;37;28;2018
09;Burgos;387;Torregalindo;126;81;45;2018
09;Burgos;388;Torrelara;30;16;14;2018
09;Burgos;389;Torrepadre;68;39;29;2018
09;Burgos;390;Torresandino;657;356;301;2018
09;Burgos;391;Tórtoles de Esgueva;458;242;216;2018
09;Burgos;392;Tosantos;57;32;25;2018
09;Burgos;394;Trespaderne;809;414;395;2018
09;Burgos;395;Tubilla del Agua;134;81;53;2018
09;Burgos;396;Tubilla del Lago;160;85;75;2018
09;Burgos;398;Úrbel del Castillo;79;52;27;2018
09;Burgos;400;Vadocondes;369;201;168;2018
09;Burgos;403;Valdeande;104;62;42;2018
09;Burgos;405;Valdezate;136;75;61;2018
09;Burgos;406;Valdorros;333;189;144;2018
09;Burgos;408;Vallarta de Bureba;42;26;16;2018
09;Burgos;904;Valle de las Navas;514;300;214;2018
09;Burgos;908;Valle de Losa;498;290;208;2018
09;Burgos;409;Valle de Manzanedo;126;67;59;2018
09;Burgos;410;Valle de Mena;3739;1911;1828;2018
09;Burgos;411;Valle de Oca;157;96;61;2018
09;Burgos;902;Valle de Santibáñez;480;277;203;2018
09;Burgos;905;Valle de Sedano;427;244;183;2018
09;Burgos;412;Valle de Tobalina;948;515;433;2018
09;Burgos;413;Valle de Valdebezana;477;247;230;2018
09;Burgos;414;Valle de Valdelaguna;195;114;81;2018
09;Burgos;415;Valle de Valdelucio;321;176;145;2018
09;Burgos;416;Valle de Zamanzas;50;28;22;2018
09;Burgos;417;Vallejera;42;24;18;2018
09;Burgos;418;Valles de Palenzuela;83;42;41;2018
09;Burgos;419;Valluércanes;76;48;28;2018
09;Burgos;407;Valmala;29;17;12;2018
09;Burgos;422;Vid de Bureba, La;17;9;8;2018
09;Burgos;421;Vid y Barrios, La;239;139;100;2018
09;Burgos;423;Vileña;29;19;10;2018
09;Burgos;427;Villadiego;1527;843;684;2018
09;Burgos;428;Villaescusa de Roa;105;61;44;2018
09;Burgos;429;Villaescusa la Sombría;59;44;15;2018
09;Burgos;430;Villaespasa;24;15;9;2018
09;Burgos;431;Villafranca Montes de Oca;119;73;46;2018
09;Burgos;432;Villafruela;191;110;81;2018
09;Burgos;433;Villagalijo;61;39;22;2018
09;Burgos;434;Villagonzalo Pedernales;1785;938;847;2018
09;Burgos;437;Villahoz;309;167;142;2018
09;Burgos;438;Villalba de Duero;673;354;319;2018
09;Burgos;439;Villalbilla de Burgos;1406;763;643;2018
09;Burgos;440;Villalbilla de Gumiel;88;54;34;2018
09;Burgos;441;Villaldemiro;71;42;29;2018
09;Burgos;442;Villalmanzo;438;236;202;2018
09;Burgos;443;Villamayor de los Montes;175;85;90;2018
09;Burgos;444;Villamayor de Treviño;68;35;33;2018
09;Burgos;445;Villambistia;45;32;13;2018
09;Burgos;446;Villamedianilla;12;7;5;2018
09;Burgos;447;Villamiel de la Sierra;46;28;18;2018
09;Burgos;448;Villangómez;217;133;84;2018
09;Burgos;449;Villanueva de Argaño;108;63;45;2018
09;Burgos;450;Villanueva de Carazo;30;19;11;2018
09;Burgos;451;Villanueva de Gumiel;278;144;134;2018
09;Burgos;454;Villanueva de Teba;41;27;14;2018
09;Burgos;455;Villaquirán de la Puebla;45;28;17;2018
09;Burgos;456;Villaquirán de los Infantes;150;80;70;2018
09;Burgos;903;Villarcayo de Merindad de Castilla la Vieja;4207;2152;2055;2018
09;Burgos;458;Villariezo;644;358;286;2018
09;Burgos;460;Villasandino;189;112;77;2018
09;Burgos;463;Villasur de Herreros;276;170;106;2018
09;Burgos;464;Villatuelda;40;23;17;2018
09;Burgos;466;Villaverde del Monte;112;65;47;2018
09;Burgos;467;Villaverde-Mogina;75;50;25;2018
09;Burgos;471;Villayerno Morquillas;194;98;96;2018
09;Burgos;472;Villazopeque;58;36;22;2018
09;Burgos;473;Villegas;87;50;37;2018
09;Burgos;476;Villoruebo;74;47;27;2018
09;Burgos;424;Viloria de Rioja;42;25;17;2018
09;Burgos;425;Vilviestre del Pinar;549;301;248;2018
09;Burgos;478;Vizcaínos;43;30;13;2018
09;Burgos;480;Zael;112;58;54;2018
09;Burgos;482;Zarzosa de Río Pisuerga;31;19;12;2018
09;Burgos;483;Zazuar;226;117;109;2018
09;Burgos;485;Zuñeda;58;36;22;2018
10;Cáceres;001;Abadía;335;189;146;2018
10;Cáceres;002;Abertura;403;207;196;2018
10;Cáceres;003;Acebo;580;294;286;2018
10;Cáceres;004;Acehúche;801;399;402;2018
10;Cáceres;005;Aceituna;607;312;295;2018
10;Cáceres;006;Ahigal;1401;723;678;2018
10;Cáceres;903;Alagón del Río;934;467;467;2018
10;Cáceres;007;Albalá;663;337;326;2018
10;Cáceres;008;Alcántara;1480;738;742;2018
10;Cáceres;009;Alcollarín;225;112;113;2018
10;Cáceres;010;Alcuéscar;2646;1384;1262;2018
10;Cáceres;012;Aldea del Cano;620;288;332;2018
10;Cáceres;013;Aldea del Obispo, La;305;163;142;2018
10;Cáceres;011;Aldeacentenera;576;289;287;2018
10;Cáceres;014;Aldeanueva de la Vera;2085;1026;1059;2018
10;Cáceres;015;Aldeanueva del Camino;753;367;386;2018
10;Cáceres;016;Aldehuela de Jerte;370;194;176;2018
10;Cáceres;017;Alía;831;416;415;2018
10;Cáceres;018;Aliseda;1850;948;902;2018
10;Cáceres;019;Almaraz;1765;902;863;2018
10;Cáceres;020;Almoharín;1838;901;937;2018
10;Cáceres;021;Arroyo de la Luz;5851;2912;2939;2018
10;Cáceres;023;Arroyomolinos;736;390;346;2018
10;Cáceres;022;Arroyomolinos de la Vera;444;222;222;2018
10;Cáceres;024;Baños de Montemayor;776;365;411;2018
10;Cáceres;025;Barrado;407;209;198;2018
10;Cáceres;026;Belvís de Monroy;729;378;351;2018
10;Cáceres;027;Benquerencia;77;43;34;2018
10;Cáceres;028;Berrocalejo;91;50;41;2018
10;Cáceres;029;Berzocana;437;232;205;2018
10;Cáceres;030;Bohonal de Ibor;500;260;240;2018
10;Cáceres;031;Botija;187;106;81;2018
10;Cáceres;032;Brozas;1867;926;941;2018
10;Cáceres;033;Cabañas del Castillo;434;232;202;2018
10;Cáceres;034;Cabezabellosa;349;176;173;2018
10;Cáceres;035;Cabezuela del Valle;2151;1104;1047;2018
10;Cáceres;036;Cabrero;345;189;156;2018
10;Cáceres;037;Cáceres;96068;46051;50017;2018
10;Cáceres;038;Cachorrilla;78;39;39;2018
10;Cáceres;039;Cadalso;428;217;211;2018
10;Cáceres;040;Calzadilla;490;252;238;2018
10;Cáceres;041;Caminomorisco;1185;621;564;2018
10;Cáceres;042;Campillo de Deleitosa;62;25;37;2018
10;Cáceres;043;Campo Lugar;856;421;435;2018
10;Cáceres;044;Cañamero;1634;860;774;2018
10;Cáceres;045;Cañaveral;1019;500;519;2018
10;Cáceres;046;Carbajo;208;110;98;2018
10;Cáceres;047;Carcaboso;1110;552;558;2018
10;Cáceres;048;Carrascalejo;230;113;117;2018
10;Cáceres;049;Casar de Cáceres;4500;2217;2283;2018
10;Cáceres;050;Casar de Palomero;1124;571;553;2018
10;Cáceres;051;Casares de las Hurdes;386;194;192;2018
10;Cáceres;052;Casas de Don Antonio;163;81;82;2018
10;Cáceres;053;Casas de Don Gómez;301;164;137;2018
10;Cáceres;056;Casas de Millán;585;293;292;2018
10;Cáceres;057;Casas de Miravete;140;85;55;2018
10;Cáceres;054;Casas del Castañar;581;285;296;2018
10;Cáceres;055;Casas del Monte;815;420;395;2018
10;Cáceres;058;Casatejada;1381;715;666;2018
10;Cáceres;059;Casillas de Coria;375;182;193;2018
10;Cáceres;060;Castañar de Ibor;1053;542;511;2018
10;Cáceres;061;Ceclavín;1854;950;904;2018
10;Cáceres;062;Cedillo;449;236;213;2018
10;Cáceres;063;Cerezo;170;84;86;2018
10;Cáceres;064;Cilleros;1650;838;812;2018
10;Cáceres;065;Collado de la Vera;190;105;85;2018
10;Cáceres;066;Conquista de la Sierra;185;109;76;2018
10;Cáceres;067;Coria;12531;6164;6367;2018
10;Cáceres;068;Cuacos de Yuste;846;442;404;2018
10;Cáceres;069;Cumbre, La;864;435;429;2018
10;Cáceres;070;Deleitosa;728;364;364;2018
10;Cáceres;071;Descargamaría;120;71;49;2018
10;Cáceres;072;Eljas;915;466;449;2018
10;Cáceres;073;Escurial;849;445;404;2018
10;Cáceres;075;Fresnedoso de Ibor;275;150;125;2018
10;Cáceres;076;Galisteo;953;478;475;2018
10;Cáceres;077;Garciaz;725;375;350;2018
10;Cáceres;079;Garganta la Olla;984;518;466;2018
10;Cáceres;078;Garganta, La;392;214;178;2018
10;Cáceres;080;Gargantilla;403;208;195;2018
10;Cáceres;081;Gargüera;128;71;57;2018
10;Cáceres;082;Garrovillas de Alconétar;2054;1020;1034;2018
10;Cáceres;083;Garvín;98;52;46;2018
10;Cáceres;084;Gata;1493;774;719;2018
10;Cáceres;085;Gordo, El;363;186;177;2018
10;Cáceres;086;Granja, La;335;175;160;2018
10;Cáceres;087;Guadalupe;1887;931;956;2018
10;Cáceres;088;Guijo de Coria;204;107;97;2018
10;Cáceres;089;Guijo de Galisteo;1529;770;759;2018
10;Cáceres;090;Guijo de Granadilla;536;281;255;2018
10;Cáceres;091;Guijo de Santa Bárbara;387;203;184;2018
10;Cáceres;092;Herguijuela;299;155;144;2018
10;Cáceres;093;Hernán-Pérez;457;228;229;2018
10;Cáceres;094;Herrera de Alcántara;255;131;124;2018
10;Cáceres;095;Herreruela;342;176;166;2018
10;Cáceres;096;Hervás;4052;1992;2060;2018
10;Cáceres;097;Higuera;102;62;40;2018
10;Cáceres;098;Hinojal;396;206;190;2018
10;Cáceres;099;Holguera;647;322;325;2018
10;Cáceres;100;Hoyos;906;444;462;2018
10;Cáceres;101;Huélaga;216;108;108;2018
10;Cáceres;102;Ibahernando;564;276;288;2018
10;Cáceres;103;Jaraicejo;489;242;247;2018
10;Cáceres;104;Jaraíz de la Vera;6477;3232;3245;2018
10;Cáceres;105;Jarandilla de la Vera;2868;1429;1439;2018
10;Cáceres;106;Jarilla;141;73;68;2018
10;Cáceres;107;Jerte;1266;636;630;2018
10;Cáceres;108;Ladrillar;201;106;95;2018
10;Cáceres;109;Logrosán;2007;1008;999;2018
10;Cáceres;110;Losar de la Vera;2749;1420;1329;2018
10;Cáceres;111;Madrigal de la Vera;1595;836;759;2018
10;Cáceres;112;Madrigalejo;1759;875;884;2018
10;Cáceres;113;Madroñera;2595;1290;1305;2018
10;Cáceres;114;Majadas;1328;665;663;2018
10;Cáceres;115;Malpartida de Cáceres;4156;2089;2067;2018
10;Cáceres;116;Malpartida de Plasencia;4602;2275;2327;2018
10;Cáceres;117;Marchagaz;217;112;105;2018
10;Cáceres;118;Mata de Alcántara;309;159;150;2018
10;Cáceres;119;Membrío;634;314;320;2018
10;Cáceres;120;Mesas de Ibor;175;90;85;2018
10;Cáceres;121;Miajadas;9685;4818;4867;2018
10;Cáceres;122;Millanes;256;128;128;2018
10;Cáceres;123;Mirabel;653;327;326;2018
10;Cáceres;124;Mohedas de Granadilla;827;412;415;2018
10;Cáceres;125;Monroy;969;497;472;2018
10;Cáceres;126;Montánchez;1732;875;857;2018
10;Cáceres;127;Montehermoso;5731;2918;2813;2018
10;Cáceres;128;Moraleja;6792;3384;3408;2018
10;Cáceres;129;Morcillo;378;176;202;2018
10;Cáceres;130;Navaconcejo;2003;1008;995;2018
10;Cáceres;131;Navalmoral de la Mata;17170;8274;8896;2018
10;Cáceres;132;Navalvillar de Ibor;416;207;209;2018
10;Cáceres;133;Navas del Madroño;1336;669;667;2018
10;Cáceres;134;Navezuelas;646;330;316;2018
10;Cáceres;135;Nuñomoral;1311;691;620;2018
10;Cáceres;136;Oliva de Plasencia;310;178;132;2018
10;Cáceres;137;Palomero;411;220;191;2018
10;Cáceres;138;Pasarón de la Vera;641;309;332;2018
10;Cáceres;139;Pedroso de Acim;85;47;38;2018
10;Cáceres;140;Peraleda de la Mata;1390;708;682;2018
10;Cáceres;141;Peraleda de San Román;277;143;134;2018
10;Cáceres;142;Perales del Puerto;941;483;458;2018
10;Cáceres;143;Pescueza;151;66;85;2018
10;Cáceres;144;Pesga, La;1065;554;511;2018
10;Cáceres;145;Piedras Albas;149;70;79;2018
10;Cáceres;146;Pinofranqueado;1748;928;820;2018
10;Cáceres;147;Piornal;1530;771;759;2018
10;Cáceres;148;Plasencia;40141;19421;20720;2018
10;Cáceres;149;Plasenzuela;487;244;243;2018
10;Cáceres;150;Portaje;362;187;175;2018
10;Cáceres;151;Portezuelo;225;118;107;2018
10;Cáceres;152;Pozuelo de Zarzón;471;237;234;2018
10;Cáceres;905;Pueblonuevo de Miramontes;814;417;397;2018
10;Cáceres;153;Puerto de Santa Cruz;323;168;155;2018
10;Cáceres;154;Rebollar;213;107;106;2018
10;Cáceres;155;Riolobos;1248;649;599;2018
10;Cáceres;156;Robledillo de Gata;91;49;42;2018
10;Cáceres;157;Robledillo de la Vera;272;143;129;2018
10;Cáceres;158;Robledillo de Trujillo;369;186;183;2018
10;Cáceres;159;Robledollano;315;174;141;2018
10;Cáceres;160;Romangordo;259;127;132;2018
10;Cáceres;901;Rosalejo;1362;715;647;2018
10;Cáceres;161;Ruanes;65;36;29;2018
10;Cáceres;162;Salorino;581;302;279;2018
10;Cáceres;163;Salvatierra de Santiago;323;165;158;2018
10;Cáceres;164;San Martín de Trevejo;788;388;400;2018
10;Cáceres;165;Santa Ana;249;136;113;2018
10;Cáceres;166;Santa Cruz de la Sierra;324;161;163;2018
10;Cáceres;167;Santa Cruz de Paniagua;315;174;141;2018
10;Cáceres;168;Santa Marta de Magasca;271;138;133;2018
10;Cáceres;169;Santiago de Alcántara;522;256;266;2018
10;Cáceres;170;Santiago del Campo;259;132;127;2018
10;Cáceres;171;Santibáñez el Alto;382;205;177;2018
10;Cáceres;172;Santibáñez el Bajo;763;392;371;2018
10;Cáceres;173;Saucedilla;858;452;406;2018
10;Cáceres;174;Segura de Toro;187;91;96;2018
10;Cáceres;175;Serradilla;1568;790;778;2018
10;Cáceres;176;Serrejón;420;220;200;2018
10;Cáceres;177;Sierra de Fuentes;1996;1015;981;2018
10;Cáceres;178;Talaván;832;432;400;2018
10;Cáceres;179;Talaveruela de la Vera;306;163;143;2018
10;Cáceres;180;Talayuela;7345;3968;3377;2018
10;Cáceres;181;Tejeda de Tiétar;806;430;376;2018
10;Cáceres;904;Tiétar;921;485;436;2018
10;Cáceres;182;Toril;164;104;60;2018
10;Cáceres;183;Tornavacas;1143;608;535;2018
10;Cáceres;184;Torno, El;884;463;421;2018
10;Cáceres;187;Torre de Don Miguel;461;246;215;2018
10;Cáceres;188;Torre de Santa María;532;267;265;2018
10;Cáceres;185;Torrecilla de los Ángeles;622;330;292;2018
10;Cáceres;186;Torrecillas de la Tiesa;1071;543;528;2018
10;Cáceres;190;Torrejón el Rubio;571;286;285;2018
10;Cáceres;189;Torrejoncillo;2975;1451;1524;2018
10;Cáceres;191;Torremenga;610;324;286;2018
10;Cáceres;192;Torremocha;840;420;420;2018
10;Cáceres;193;Torreorgaz;1677;816;861;2018
10;Cáceres;194;Torrequemada;570;272;298;2018
10;Cáceres;195;Trujillo;9193;4477;4716;2018
10;Cáceres;196;Valdastillas;334;175;159;2018
10;Cáceres;197;Valdecañas de Tajo;99;55;44;2018
10;Cáceres;198;Valdefuentes;1230;605;625;2018
10;Cáceres;199;Valdehúncar;178;96;82;2018
10;Cáceres;200;Valdelacasa de Tajo;361;188;173;2018
10;Cáceres;201;Valdemorales;197;97;100;2018
10;Cáceres;202;Valdeobispo;664;322;342;2018
10;Cáceres;203;Valencia de Alcántara;5439;2662;2777;2018
10;Cáceres;204;Valverde de la Vera;460;233;227;2018
10;Cáceres;205;Valverde del Fresno;2349;1183;1166;2018
10;Cáceres;902;Vegaviana;868;446;422;2018
10;Cáceres;206;Viandar de la Vera;233;122;111;2018
10;Cáceres;207;Villa del Campo;502;239;263;2018
10;Cáceres;208;Villa del Rey;136;69;67;2018
10;Cáceres;209;Villamesías;260;135;125;2018
10;Cáceres;210;Villamiel;426;214;212;2018
10;Cáceres;211;Villanueva de la Sierra;433;217;216;2018
10;Cáceres;212;Villanueva de la Vera;2046;1027;1019;2018
10;Cáceres;214;Villar de Plasencia;234;125;109;2018
10;Cáceres;213;Villar del Pedroso;618;317;301;2018
10;Cáceres;215;Villasbuenas de Gata;341;170;171;2018
10;Cáceres;216;Zarza de Granadilla;1823;917;906;2018
10;Cáceres;217;Zarza de Montánchez;550;275;275;2018
10;Cáceres;218;Zarza la Mayor;1258;629;629;2018
10;Cáceres;219;Zorita;1377;697;680;2018
11;Cádiz;001;Alcalá de los Gazules;5242;2701;2541;2018
11;Cádiz;002;Alcalá del Valle;5123;2572;2551;2018
11;Cádiz;003;Algar;1413;730;683;2018
11;Cádiz;004;Algeciras;121414;59852;61562;2018
11;Cádiz;005;Algodonales;5590;2842;2748;2018
11;Cádiz;006;Arcos de la Frontera;30741;15346;15395;2018
11;Cádiz;007;Barbate;22551;11305;11246;2018
11;Cádiz;008;Barrios, Los;23513;11745;11768;2018
11;Cádiz;901;Benalup-Casas Viejas;6969;3546;3423;2018
11;Cádiz;009;Benaocaz;680;364;316;2018
11;Cádiz;010;Bornos;7750;3882;3868;2018
11;Cádiz;011;Bosque, El;2167;1097;1070;2018
11;Cádiz;012;Cádiz;116979;55374;61605;2018
11;Cádiz;013;Castellar de la Frontera;3013;1506;1507;2018
11;Cádiz;015;Chiclana de la Frontera;83831;41968;41863;2018
11;Cádiz;016;Chipiona;19068;9564;9504;2018
11;Cádiz;014;Conil de la Frontera;22427;11304;11123;2018
11;Cádiz;017;Espera;3903;1964;1939;2018
11;Cádiz;018;Gastor, El;1726;892;834;2018
11;Cádiz;019;Grazalema;2053;1018;1035;2018
11;Cádiz;020;Jerez de la Frontera;212879;104084;108795;2018
11;Cádiz;021;Jimena de la Frontera;9773;5045;4728;2018
11;Cádiz;022;Línea de la Concepción, La;62940;30895;32045;2018
11;Cádiz;023;Medina-Sidonia;11658;5934;5724;2018
11;Cádiz;024;Olvera;8124;3983;4141;2018
11;Cádiz;025;Paterna de Rivera;5530;2856;2674;2018
11;Cádiz;026;Prado del Rey;5636;2815;2821;2018
11;Cádiz;027;Puerto de Santa María, El;88364;43326;45038;2018
11;Cádiz;028;Puerto Real;41650;20922;20728;2018
11;Cádiz;029;Puerto Serrano;6996;3537;3459;2018
11;Cádiz;030;Rota;28848;14403;14445;2018
11;Cádiz;031;San Fernando;95174;46602;48572;2018
11;Cádiz;902;San José del Valle;4402;2255;2147;2018
11;Cádiz;033;San Roque;30472;15209;15263;2018
11;Cádiz;032;Sanlúcar de Barrameda;68037;33868;34169;2018
11;Cádiz;034;Setenil de las Bodegas;2732;1401;1331;2018
11;Cádiz;035;Tarifa;18169;9151;9018;2018
11;Cádiz;036;Torre Alháquime;804;401;403;2018
11;Cádiz;037;Trebujena;7054;3522;3532;2018
11;Cádiz;038;Ubrique;16615;8207;8408;2018
11;Cádiz;039;Vejer de la Frontera;12739;6349;6390;2018
11;Cádiz;040;Villaluenga del Rosario;438;229;209;2018
11;Cádiz;041;Villamartín;12127;6078;6049;2018
11;Cádiz;042;Zahara;1400;713;687;2018
39;Cantabria;001;Alfoz de Lloredo;2408;1233;1175;2018
39;Cantabria;002;Ampuero;4219;2139;2080;2018
39;Cantabria;003;Anievas;279;149;130;2018
39;Cantabria;004;Arenas de Iguña;1676;864;812;2018
39;Cantabria;005;Argoños;1723;885;838;2018
39;Cantabria;006;Arnuero;2108;1074;1034;2018
39;Cantabria;007;Arredondo;470;267;203;2018
39;Cantabria;008;Astillero, El;18108;8840;9268;2018
39;Cantabria;009;Bárcena de Cicero;4186;2178;2008;2018
39;Cantabria;010;Bárcena de Pie de Concha;680;343;337;2018
39;Cantabria;011;Bareyo;1972;1005;967;2018
39;Cantabria;012;Cabezón de la Sal;8349;4021;4328;2018
39;Cantabria;013;Cabezón de Liébana;592;338;254;2018
39;Cantabria;014;Cabuérniga;999;546;453;2018
39;Cantabria;015;Camaleño;946;535;411;2018
39;Cantabria;016;Camargo;30263;14811;15452;2018
39;Cantabria;027;Campoo de Enmedio;3750;1925;1825;2018
39;Cantabria;017;Campoo de Yuso;668;360;308;2018
39;Cantabria;018;Cartes;5778;2901;2877;2018
39;Cantabria;019;Castañeda;2809;1443;1366;2018
39;Cantabria;020;Castro-Urdiales;31977;15843;16134;2018
39;Cantabria;021;Cieza;539;274;265;2018
39;Cantabria;022;Cillorigo de Liébana;1337;695;642;2018
39;Cantabria;023;Colindres;8453;4145;4308;2018
39;Cantabria;024;Comillas;2156;1021;1135;2018
39;Cantabria;025;Corrales de Buelna, Los;10910;5331;5579;2018
39;Cantabria;026;Corvera de Toranzo;2041;1038;1003;2018
39;Cantabria;028;Entrambasaguas;5090;2571;2519;2018
39;Cantabria;029;Escalante;771;399;372;2018
39;Cantabria;030;Guriezo;2347;1204;1143;2018
39;Cantabria;031;Hazas de Cesto;1541;773;768;2018
39;Cantabria;032;Hermandad de Campoo de Suso;1627;899;728;2018
39;Cantabria;033;Herrerías;609;344;265;2018
39;Cantabria;034;Lamasón;287;182;105;2018
39;Cantabria;035;Laredo;11148;5301;5847;2018
39;Cantabria;036;Liendo;1194;613;581;2018
39;Cantabria;037;Liérganes;2370;1169;1201;2018
39;Cantabria;038;Limpias;1867;932;935;2018
39;Cantabria;039;Luena;601;329;272;2018
39;Cantabria;040;Marina de Cudeyo;5118;2550;2568;2018
39;Cantabria;041;Mazcuerras;2120;1086;1034;2018
39;Cantabria;042;Medio Cudeyo;7520;3632;3888;2018
39;Cantabria;043;Meruelo;1982;995;987;2018
39;Cantabria;044;Miengo;4713;2380;2333;2018
39;Cantabria;045;Miera;389;201;188;2018
39;Cantabria;046;Molledo;1544;774;770;2018
39;Cantabria;047;Noja;2539;1268;1271;2018
39;Cantabria;048;Penagos;2108;1068;1040;2018
39;Cantabria;049;Peñarrubia;321;176;145;2018
39;Cantabria;050;Pesaguero;285;165;120;2018
39;Cantabria;051;Pesquera;68;43;25;2018
39;Cantabria;052;Piélagos;25223;12484;12739;2018
39;Cantabria;053;Polaciones;238;151;87;2018
39;Cantabria;054;Polanco;5845;2891;2954;2018
39;Cantabria;055;Potes;1350;653;697;2018
39;Cantabria;056;Puente Viesgo;2868;1460;1408;2018
39;Cantabria;057;Ramales de la Victoria;2881;1446;1435;2018
39;Cantabria;058;Rasines;952;493;459;2018
39;Cantabria;059;Reinosa;9095;4266;4829;2018
39;Cantabria;060;Reocín;8381;4124;4257;2018
39;Cantabria;061;Ribamontán al Mar;4447;2243;2204;2018
39;Cantabria;062;Ribamontán al Monte;2257;1170;1087;2018
39;Cantabria;063;Rionansa;1038;584;454;2018
39;Cantabria;064;Riotuerto;1609;767;842;2018
39;Cantabria;065;Rozas de Valdearroyo, Las;268;154;114;2018
39;Cantabria;066;Ruente;1026;552;474;2018
39;Cantabria;067;Ruesga;872;473;399;2018
39;Cantabria;068;Ruiloba;732;373;359;2018
39;Cantabria;069;San Felices de Buelna;2387;1198;1189;2018
39;Cantabria;070;San Miguel de Aguayo;147;76;71;2018
39;Cantabria;071;San Pedro del Romeral;466;260;206;2018
39;Cantabria;072;San Roque de Riomiera;370;220;150;2018
39;Cantabria;080;San Vicente de la Barquera;4158;2062;2096;2018
39;Cantabria;073;Santa Cruz de Bezana;12964;6383;6581;2018
39;Cantabria;074;Santa María de Cayón;9060;4554;4506;2018
39;Cantabria;075;Santander;172044;79371;92673;2018
39;Cantabria;076;Santillana del Mar;4172;2051;2121;2018
39;Cantabria;077;Santiurde de Reinosa;257;151;106;2018
39;Cantabria;078;Santiurde de Toranzo;1623;845;778;2018
39;Cantabria;079;Santoña;11050;5388;5662;2018
39;Cantabria;081;Saro;512;267;245;2018
39;Cantabria;082;Selaya;1891;947;944;2018
39;Cantabria;083;Soba;1193;662;531;2018
39;Cantabria;084;Solórzano;1050;557;493;2018
39;Cantabria;085;Suances;8716;4294;4422;2018
39;Cantabria;086;Tojos, Los;400;233;167;2018
39;Cantabria;087;Torrelavega;51687;24341;27346;2018
39;Cantabria;088;Tresviso;64;44;20;2018
39;Cantabria;089;Tudanca;140;98;42;2018
39;Cantabria;090;Udías;925;473;452;2018
39;Cantabria;095;Val de San Vicente;2772;1441;1331;2018
39;Cantabria;091;Valdáliga;2191;1137;1054;2018
39;Cantabria;092;Valdeolea;967;512;455;2018
39;Cantabria;093;Valdeprado del Río;316;181;135;2018
39;Cantabria;094;Valderredible;974;549;425;2018
39;Cantabria;101;Valle de Villaverde;286;155;131;2018
39;Cantabria;096;Vega de Liébana;745;389;356;2018
39;Cantabria;097;Vega de Pas;775;406;369;2018
39;Cantabria;098;Villacarriedo;1604;840;764;2018
39;Cantabria;099;Villaescusa;3912;1941;1971;2018
39;Cantabria;100;Villafufre;1029;532;497;2018
39;Cantabria;102;Voto;2745;1464;1281;2018
12;Castellón/Castelló;002;Aín;125;66;59;2018
12;Castellón/Castelló;003;Albocàsser;1234;615;619;2018
12;Castellón/Castelló;004;Alcalà de Xivert;6679;3440;3239;2018
12;Castellón/Castelló;005;Alcora, l';10430;5262;5168;2018
12;Castellón/Castelló;006;Alcudia de Veo;201;108;93;2018
12;Castellón/Castelló;007;Alfondeguilla;862;438;424;2018
12;Castellón/Castelló;008;Algimia de Almonacid;259;146;113;2018
12;Castellón/Castelló;009;Almassora;25831;12984;12847;2018
12;Castellón/Castelló;010;Almedíjar;256;141;115;2018
12;Castellón/Castelló;011;Almenara;5900;2958;2942;2018
12;Castellón/Castelló;901;Alqueries, les/Alquerías del Niño Perdido;4460;2220;2240;2018
12;Castellón/Castelló;012;Altura;3509;1791;1718;2018
12;Castellón/Castelló;013;Arañuel;146;72;74;2018
12;Castellón/Castelló;014;Ares del Maestrat;190;107;83;2018
12;Castellón/Castelló;015;Argelita;113;69;44;2018
12;Castellón/Castelló;016;Artana;1958;992;966;2018
12;Castellón/Castelló;001;Atzeneta del Maestrat;1271;643;628;2018
12;Castellón/Castelló;017;Ayódar;164;88;76;2018
12;Castellón/Castelló;018;Azuébar;324;172;152;2018
12;Castellón/Castelló;020;Barracas;169;93;76;2018
12;Castellón/Castelló;022;Bejís;373;214;159;2018
12;Castellón/Castelló;024;Benafer;156;82;74;2018
12;Castellón/Castelló;025;Benafigos;149;84;65;2018
12;Castellón/Castelló;026;Benassal;1084;560;524;2018
12;Castellón/Castelló;027;Benicarló;26744;13326;13418;2018
12;Castellón/Castelló;028;Benicasim/Benicàssim;18055;9015;9040;2018
12;Castellón/Castelló;029;Benlloch;1036;524;512;2018
12;Castellón/Castelló;021;Betxí;5709;2815;2894;2018
12;Castellón/Castelló;032;Borriana/Burriana;34544;17121;17423;2018
12;Castellón/Castelló;031;Borriol;5322;2696;2626;2018
12;Castellón/Castelló;033;Cabanes;2889;1468;1421;2018
12;Castellón/Castelló;034;Càlig;1945;995;950;2018
12;Castellón/Castelló;036;Canet lo Roig;696;338;358;2018
12;Castellón/Castelló;037;Castell de Cabres;19;10;9;2018
12;Castellón/Castelló;038;Castellfort;192;104;88;2018
12;Castellón/Castelló;039;Castellnovo;946;479;467;2018
12;Castellón/Castelló;040;Castellón de la Plana/Castelló de la Plana;170888;82695;88193;2018
12;Castellón/Castelló;041;Castillo de Villamalefa;101;66;35;2018
12;Castellón/Castelló;042;Catí;742;370;372;2018
12;Castellón/Castelló;043;Caudiel;647;334;313;2018
12;Castellón/Castelló;044;Cervera del Maestre;599;292;307;2018
12;Castellón/Castelló;053;Chilches/Xilxes;2670;1377;1293;2018
12;Castellón/Castelló;055;Chodos/Xodos;113;66;47;2018
12;Castellón/Castelló;056;Chóvar;297;155;142;2018
12;Castellón/Castelló;045;Cinctorres;399;193;206;2018
12;Castellón/Castelló;046;Cirat;206;113;93;2018
12;Castellón/Castelló;048;Cortes de Arenoso;317;173;144;2018
12;Castellón/Castelló;049;Costur;511;272;239;2018
12;Castellón/Castelló;050;Coves de Vinromà, les;1822;914;908;2018
12;Castellón/Castelló;051;Culla;504;261;243;2018
12;Castellón/Castelló;057;Eslida;776;397;379;2018
12;Castellón/Castelló;058;Espadilla;72;41;31;2018
12;Castellón/Castelló;059;Fanzara;276;139;137;2018
12;Castellón/Castelló;060;Figueroles;525;266;259;2018
12;Castellón/Castelló;061;Forcall;453;223;230;2018
12;Castellón/Castelló;063;Fuente la Reina;49;27;22;2018
12;Castellón/Castelló;064;Fuentes de Ayódar;94;53;41;2018
12;Castellón/Castelló;065;Gaibiel;193;103;90;2018
12;Castellón/Castelló;067;Geldo;633;314;319;2018
12;Castellón/Castelló;068;Herbés;49;27;22;2018
12;Castellón/Castelló;069;Higueras;62;37;25;2018
12;Castellón/Castelló;070;Jana, la;666;334;332;2018
12;Castellón/Castelló;071;Jérica;1553;803;750;2018
12;Castellón/Castelló;074;Llosa, la;940;467;473;2018
12;Castellón/Castelló;072;Llucena/Lucena del Cid;1319;664;655;2018
12;Castellón/Castelló;073;Ludiente;155;86;69;2018
12;Castellón/Castelló;075;Mata de Morella, la;162;85;77;2018
12;Castellón/Castelló;076;Matet;84;43;41;2018
12;Castellón/Castelló;077;Moncofa;6278;3257;3021;2018
12;Castellón/Castelló;078;Montán;359;172;187;2018
12;Castellón/Castelló;079;Montanejos;548;286;262;2018
12;Castellón/Castelló;080;Morella;2437;1197;1240;2018
12;Castellón/Castelló;081;Navajas;712;373;339;2018
12;Castellón/Castelló;082;Nules;13170;6584;6586;2018
12;Castellón/Castelló;083;Olocau del Rey;117;65;52;2018
12;Castellón/Castelló;084;Onda;24850;12464;12386;2018
12;Castellón/Castelló;085;Oropesa del Mar/Orpesa;8830;4544;4286;2018
12;Castellón/Castelló;087;Palanques;31;17;14;2018
12;Castellón/Castelló;088;Pavías;62;39;23;2018
12;Castellón/Castelló;089;Peníscola/Peñíscola;7447;3747;3700;2018
12;Castellón/Castelló;090;Pina de Montalgrao;114;59;55;2018
12;Castellón/Castelló;093;Pobla de Benifassà, la;197;110;87;2018
12;Castellón/Castelló;094;Pobla Tornesa, la;1208;628;580;2018
12;Castellón/Castelló;091;Portell de Morella;197;97;100;2018
12;Castellón/Castelló;092;Puebla de Arenoso;144;77;67;2018
12;Castellón/Castelló;095;Ribesalbes;1180;605;575;2018
12;Castellón/Castelló;096;Rossell;952;500;452;2018
12;Castellón/Castelló;097;Sacañet;59;39;20;2018
12;Castellón/Castelló;098;Salzadella, la;729;366;363;2018
12;Castellón/Castelló;101;San Rafael del Río;462;230;232;2018
12;Castellón/Castelló;902;Sant Joan de Moró;3099;1618;1481;2018
12;Castellón/Castelló;099;Sant Jordi/San Jorge;935;486;449;2018
12;Castellón/Castelló;100;Sant Mateu;1974;973;1001;2018
12;Castellón/Castelló;102;Santa Magdalena de Pulpis;761;407;354;2018
12;Castellón/Castelló;104;Segorbe;8878;4351;4527;2018
12;Castellón/Castelló;103;Serratella, la;101;49;52;2018
12;Castellón/Castelló;105;Sierra Engarcerán;1023;542;481;2018
12;Castellón/Castelló;106;Soneja;1439;702;737;2018
12;Castellón/Castelló;107;Sot de Ferrer;428;220;208;2018
12;Castellón/Castelló;108;Sueras/Suera;520;270;250;2018
12;Castellón/Castelló;109;Tales;814;408;406;2018
12;Castellón/Castelló;110;Teresa;249;131;118;2018
12;Castellón/Castelló;111;Tírig;435;220;215;2018
12;Castellón/Castelló;112;Todolella;138;81;57;2018
12;Castellón/Castelló;113;Toga;100;54;46;2018
12;Castellón/Castelló;114;Torás;229;120;109;2018
12;Castellón/Castelló;115;Toro, El;253;138;115;2018
12;Castellón/Castelló;116;Torralba del Pinar;54;26;28;2018
12;Castellón/Castelló;119;Torre d'En Besora, la;157;87;70;2018
12;Castellón/Castelló;120;Torre d'en Doménec, la;191;96;95;2018
12;Castellón/Castelló;117;Torreblanca;5461;2754;2707;2018
12;Castellón/Castelló;118;Torrechiva;74;45;29;2018
12;Castellón/Castelló;121;Traiguera;1375;692;683;2018
12;Castellón/Castelló;122;Useras/Useres, les;966;503;463;2018
12;Castellón/Castelló;124;Vall d'Alba;2817;1471;1346;2018
12;Castellón/Castelló;125;Vall de Almonacid;281;140;141;2018
12;Castellón/Castelló;126;Vall d'Uixó, la;31552;15577;15975;2018
12;Castellón/Castelló;123;Vallat;49;23;26;2018
12;Castellón/Castelló;127;Vallibona;75;42;33;2018
12;Castellón/Castelló;128;Vilafamés;1833;982;851;2018
12;Castellón/Castelló;132;Vilanova d'Alcolea;575;298;277;2018
12;Castellón/Castelló;134;Vilar de Canes;172;90;82;2018
12;Castellón/Castelló;135;Vila-real;50577;25125;25452;2018
12;Castellón/Castelló;136;Vilavella, la;3226;1611;1615;2018
12;Castellón/Castelló;129;Villafranca del Cid/Vilafranca;2227;1102;1125;2018
12;Castellón/Castelló;130;Villahermosa del Río;462;252;210;2018
12;Castellón/Castelló;131;Villamalur;63;38;25;2018
12;Castellón/Castelló;133;Villanueva de Viver;66;34;32;2018
12;Castellón/Castelló;137;Villores;42;23;19;2018
12;Castellón/Castelló;138;Vinaròs;28438;14011;14427;2018
12;Castellón/Castelló;139;Vistabella del Maestrat;342;190;152;2018
12;Castellón/Castelló;140;Viver;1538;796;742;2018
12;Castellón/Castelló;052;Xert;725;344;381;2018
12;Castellón/Castelló;141;Zorita del Maestrazgo;112;58;54;2018
12;Castellón/Castelló;142;Zucaina;172;97;75;2018
13;Ciudad Real;001;Abenójar;1395;715;680;2018
13;Ciudad Real;002;Agudo;1687;846;841;2018
13;Ciudad Real;003;Alamillo;507;260;247;2018
13;Ciudad Real;004;Albaladejo;1185;615;570;2018
13;Ciudad Real;005;Alcázar de San Juan;30686;14982;15704;2018
13;Ciudad Real;006;Alcoba;602;302;300;2018
13;Ciudad Real;007;Alcolea de Calatrava;1455;739;716;2018
13;Ciudad Real;008;Alcubillas;485;247;238;2018
13;Ciudad Real;009;Aldea del Rey;1660;844;816;2018
13;Ciudad Real;010;Alhambra;1000;506;494;2018
13;Ciudad Real;011;Almadén;5461;2614;2847;2018
13;Ciudad Real;012;Almadenejos;417;218;199;2018
13;Ciudad Real;013;Almagro;8922;4388;4534;2018
13;Ciudad Real;014;Almedina;526;277;249;2018
13;Ciudad Real;015;Almodóvar del Campo;6139;3084;3055;2018
13;Ciudad Real;016;Almuradiel;799;394;405;2018
13;Ciudad Real;017;Anchuras;327;164;163;2018
13;Ciudad Real;903;Arenales de San Gregorio;595;308;287;2018
13;Ciudad Real;018;Arenas de San Juan;1043;536;507;2018
13;Ciudad Real;019;Argamasilla de Alba;6901;3466;3435;2018
13;Ciudad Real;020;Argamasilla de Calatrava;5921;3000;2921;2018
13;Ciudad Real;021;Arroba de los Montes;449;242;207;2018
13;Ciudad Real;022;Ballesteros de Calatrava;387;193;194;2018
13;Ciudad Real;023;Bolaños de Calatrava;11884;6033;5851;2018
13;Ciudad Real;024;Brazatortas;1000;520;480;2018
13;Ciudad Real;025;Cabezarados;311;168;143;2018
13;Ciudad Real;026;Cabezarrubias del Puerto;487;255;232;2018
13;Ciudad Real;027;Calzada de Calatrava;3802;1892;1910;2018
13;Ciudad Real;028;Campo de Criptana;13597;6780;6817;2018
13;Ciudad Real;029;Cañada de Calatrava;92;56;36;2018
13;Ciudad Real;030;Caracuel de Calatrava;139;83;56;2018
13;Ciudad Real;031;Carrión de Calatrava;3080;1544;1536;2018
13;Ciudad Real;032;Carrizosa;1225;627;598;2018
13;Ciudad Real;033;Castellar de Santiago;1918;965;953;2018
13;Ciudad Real;038;Chillón;1831;888;943;2018
13;Ciudad Real;034;Ciudad Real;74743;35421;39322;2018
13;Ciudad Real;035;Corral de Calatrava;1129;554;575;2018
13;Ciudad Real;036;Cortijos, Los;882;468;414;2018
13;Ciudad Real;037;Cózar;973;483;490;2018
13;Ciudad Real;039;Daimiel;18051;9004;9047;2018
13;Ciudad Real;040;Fernán Caballero;1022;504;518;2018
13;Ciudad Real;041;Fontanarejo;261;142;119;2018
13;Ciudad Real;042;Fuencaliente;1031;546;485;2018
13;Ciudad Real;043;Fuenllana;217;112;105;2018
13;Ciudad Real;044;Fuente el Fresno;3253;1677;1576;2018
13;Ciudad Real;045;Granátula de Calatrava;731;359;372;2018
13;Ciudad Real;046;Guadalmez;731;362;369;2018
13;Ciudad Real;047;Herencia;8425;4303;4122;2018
13;Ciudad Real;048;Hinojosas de Calatrava;532;271;261;2018
13;Ciudad Real;049;Horcajo de los Montes;903;457;446;2018
13;Ciudad Real;050;Labores, Las;569;282;287;2018
13;Ciudad Real;904;Llanos del Caudillo;719;354;365;2018
13;Ciudad Real;051;Luciana;374;202;172;2018
13;Ciudad Real;052;Malagón;8129;4021;4108;2018
13;Ciudad Real;053;Manzanares;18043;8930;9113;2018
13;Ciudad Real;054;Membrilla;6016;3028;2988;2018
13;Ciudad Real;055;Mestanza;688;346;342;2018
13;Ciudad Real;056;Miguelturra;15316;7705;7611;2018
13;Ciudad Real;057;Montiel;1330;701;629;2018
13;Ciudad Real;058;Moral de Calatrava;5279;2672;2607;2018
13;Ciudad Real;059;Navalpino;219;113;106;2018
13;Ciudad Real;060;Navas de Estena;223;123;100;2018
13;Ciudad Real;061;Pedro Muñoz;7385;3707;3678;2018
13;Ciudad Real;062;Picón;654;340;314;2018
13;Ciudad Real;063;Piedrabuena;4459;2271;2188;2018
13;Ciudad Real;064;Poblete;2571;1320;1251;2018
13;Ciudad Real;065;Porzuna;3571;1825;1746;2018
13;Ciudad Real;066;Pozuelo de Calatrava;3443;1760;1683;2018
13;Ciudad Real;067;Pozuelos de Calatrava, Los;370;198;172;2018
13;Ciudad Real;068;Puebla de Don Rodrigo;1200;658;542;2018
13;Ciudad Real;069;Puebla del Príncipe;701;357;344;2018
13;Ciudad Real;070;Puerto Lápice;937;463;474;2018
13;Ciudad Real;071;Puertollano;47881;23165;24716;2018
13;Ciudad Real;072;Retuerta del Bullaque;978;539;439;2018
13;Ciudad Real;901;Robledo, El;1111;588;523;2018
13;Ciudad Real;902;Ruidera;548;276;272;2018
13;Ciudad Real;073;Saceruela;577;307;270;2018
13;Ciudad Real;074;San Carlos del Valle;1128;581;547;2018
13;Ciudad Real;075;San Lorenzo de Calatrava;213;114;99;2018
13;Ciudad Real;076;Santa Cruz de los Cáñamos;523;254;269;2018
13;Ciudad Real;077;Santa Cruz de Mudela;4154;2060;2094;2018
13;Ciudad Real;078;Socuéllamos;12268;6184;6084;2018
13;Ciudad Real;080;Solana del Pino;333;176;157;2018
13;Ciudad Real;079;Solana, La;15523;7832;7691;2018
13;Ciudad Real;081;Terrinches;697;360;337;2018
13;Ciudad Real;082;Tomelloso;36091;17867;18224;2018
13;Ciudad Real;083;Torralba de Calatrava;2959;1479;1480;2018
13;Ciudad Real;084;Torre de Juan Abad;1018;495;523;2018
13;Ciudad Real;085;Torrenueva;2752;1395;1357;2018
13;Ciudad Real;086;Valdemanco del Esteras;169;88;81;2018
13;Ciudad Real;087;Valdepeñas;30210;14762;15448;2018
13;Ciudad Real;088;Valenzuela de Calatrava;692;324;368;2018
13;Ciudad Real;089;Villahermosa;1854;895;959;2018
13;Ciudad Real;090;Villamanrique;1180;572;608;2018
13;Ciudad Real;091;Villamayor de Calatrava;602;303;299;2018
13;Ciudad Real;092;Villanueva de la Fuente;2123;1083;1040;2018
13;Ciudad Real;093;Villanueva de los Infantes;5030;2477;2553;2018
13;Ciudad Real;094;Villanueva de San Carlos;295;159;136;2018
13;Ciudad Real;095;Villar del Pozo;86;46;40;2018
13;Ciudad Real;096;Villarrubia de los Ojos;9902;4915;4987;2018
13;Ciudad Real;097;Villarta de San Juan;2845;1426;1419;2018
13;Ciudad Real;098;Viso del Marqués;2363;1144;1219;2018
14;Córdoba;001;Adamuz;4185;2155;2030;2018
14;Córdoba;002;Aguilar de la Frontera;13438;6738;6700;2018
14;Córdoba;003;Alcaracejos;1473;713;760;2018
14;Córdoba;004;Almedinilla;2409;1204;1205;2018
14;Córdoba;005;Almodóvar del Río;7964;3987;3977;2018
14;Córdoba;006;Añora;1524;754;770;2018
14;Córdoba;007;Baena;19338;9868;9470;2018
14;Córdoba;008;Belalcázar;3273;1571;1702;2018
14;Córdoba;009;Belmez;2964;1435;1529;2018
14;Córdoba;010;Benamejí;4975;2492;2483;2018
14;Córdoba;011;Blázquez, Los;681;351;330;2018
14;Córdoba;012;Bujalance;7537;3752;3785;2018
14;Córdoba;013;Cabra;20417;9961;10456;2018
14;Córdoba;014;Cañete de las Torres;2969;1526;1443;2018
14;Córdoba;015;Carcabuey;2454;1251;1203;2018
14;Córdoba;016;Cardeña;1503;744;759;2018
14;Córdoba;017;Carlota, La;14067;7026;7041;2018
14;Córdoba;018;Carpio, El;4457;2204;2253;2018
14;Córdoba;019;Castro del Río;7834;3889;3945;2018
14;Córdoba;020;Conquista;401;196;205;2018
14;Córdoba;021;Córdoba;325708;156417;169291;2018
14;Córdoba;022;Doña Mencía;4684;2282;2402;2018
14;Córdoba;023;Dos Torres;2416;1199;1217;2018
14;Córdoba;024;Encinas Reales;2285;1130;1155;2018
14;Córdoba;025;Espejo;3333;1673;1660;2018
14;Córdoba;026;Espiel;2438;1227;1211;2018
14;Córdoba;027;Fernán-Núñez;9668;4856;4812;2018
14;Córdoba;028;Fuente la Lancha;350;183;167;2018
14;Córdoba;029;Fuente Obejuna;4651;2398;2253;2018
14;Córdoba;030;Fuente Palmera;10817;5425;5392;2018
14;Córdoba;031;Fuente-Tójar;680;327;353;2018
14;Córdoba;032;Granjuela, La;456;233;223;2018
14;Córdoba;033;Guadalcázar;1578;788;790;2018
14;Córdoba;034;Guijo, El;353;182;171;2018
14;Córdoba;035;Hinojosa del Duque;6868;3365;3503;2018
14;Córdoba;036;Hornachuelos;4541;2266;2275;2018
14;Córdoba;037;Iznájar;4343;2175;2168;2018
14;Córdoba;038;Lucena;42530;21212;21318;2018
14;Córdoba;039;Luque;3037;1532;1505;2018
14;Córdoba;040;Montalbán de Córdoba;4429;2202;2227;2018
14;Córdoba;041;Montemayor;3874;1947;1927;2018
14;Córdoba;042;Montilla;23031;11423;11608;2018
14;Córdoba;043;Montoro;9436;4641;4795;2018
14;Córdoba;044;Monturque;1964;976;988;2018
14;Córdoba;045;Moriles;3726;1870;1856;2018
14;Córdoba;046;Nueva Carteya;5393;2733;2660;2018
14;Córdoba;047;Obejo;1990;1043;947;2018
14;Córdoba;048;Palenciana;1481;743;738;2018
14;Córdoba;049;Palma del Río;21159;10540;10619;2018
14;Córdoba;050;Pedro Abad;2834;1434;1400;2018
14;Córdoba;051;Pedroche;1529;738;791;2018
14;Córdoba;052;Peñarroya-Pueblonuevo;10870;5245;5625;2018
14;Córdoba;053;Posadas;7343;3648;3695;2018
14;Córdoba;054;Pozoblanco;17222;8382;8840;2018
14;Córdoba;055;Priego de Córdoba;22585;11008;11577;2018
14;Córdoba;056;Puente Genil;30241;15058;15183;2018
14;Córdoba;057;Rambla, La;7508;3731;3777;2018
14;Córdoba;058;Rute;9857;4906;4951;2018
14;Córdoba;059;San Sebastián de los Ballesteros;814;404;410;2018
14;Córdoba;061;Santa Eufemia;768;384;384;2018
14;Córdoba;060;Santaella;6014;3039;2975;2018
14;Córdoba;062;Torrecampo;1063;517;546;2018
14;Córdoba;063;Valenzuela;1157;578;579;2018
14;Córdoba;064;Valsequillo;368;178;190;2018
14;Córdoba;065;Victoria, La;2284;1138;1146;2018
14;Córdoba;066;Villa del Río;7200;3603;3597;2018
14;Córdoba;067;Villafranca de Córdoba;4861;2481;2380;2018
14;Córdoba;068;Villaharta;643;314;329;2018
14;Córdoba;069;Villanueva de Córdoba;8774;4340;4434;2018
14;Córdoba;070;Villanueva del Duque;1494;753;741;2018
14;Córdoba;071;Villanueva del Rey;1068;520;548;2018
14;Córdoba;072;Villaralto;1154;577;577;2018
14;Córdoba;073;Villaviciosa de Córdoba;3298;1700;1598;2018
14;Córdoba;074;Viso, El;2568;1278;1290;2018
14;Córdoba;075;Zuheros;641;326;315;2018
15;Coruña, A;001;Abegondo;5454;2684;2770;2018
15;Coruña, A;002;Ames;31278;15015;16263;2018
15;Coruña, A;003;Aranga;1894;984;910;2018
15;Coruña, A;004;Ares;5671;2798;2873;2018
15;Coruña, A;005;Arteixo;31917;15853;16064;2018
15;Coruña, A;006;Arzúa;6053;3010;3043;2018
15;Coruña, A;007;Baña, A;3505;1659;1846;2018
15;Coruña, A;008;Bergondo;6602;3222;3380;2018
15;Coruña, A;009;Betanzos;12916;6131;6785;2018
15;Coruña, A;010;Boimorto;2022;1026;996;2018
15;Coruña, A;011;Boiro;18844;9191;9653;2018
15;Coruña, A;012;Boqueixón;4215;2069;2146;2018
15;Coruña, A;013;Brión;7748;3727;4021;2018
15;Coruña, A;014;Cabana de Bergantiños;4337;2091;2246;2018
15;Coruña, A;015;Cabanas;3318;1628;1690;2018
15;Coruña, A;016;Camariñas;5322;2605;2717;2018
15;Coruña, A;017;Cambre;24603;12027;12576;2018
15;Coruña, A;018;Capela, A;1238;617;621;2018
15;Coruña, A;019;Carballo;31261;15299;15962;2018
15;Coruña, A;901;Cariño;3945;1959;1986;2018
15;Coruña, A;020;Carnota;4031;1915;2116;2018
15;Coruña, A;021;Carral;6294;3096;3198;2018
15;Coruña, A;022;Cedeira;6794;3373;3421;2018
15;Coruña, A;023;Cee;7576;3627;3949;2018
15;Coruña, A;024;Cerceda;5023;2478;2545;2018
15;Coruña, A;025;Cerdido;1126;551;575;2018
15;Coruña, A;027;Coirós;1824;896;928;2018
15;Coruña, A;028;Corcubión;1578;764;814;2018
15;Coruña, A;029;Coristanco;6177;2955;3222;2018
15;Coruña, A;030;Coruña, A;244850;113613;131237;2018
15;Coruña, A;031;Culleredo;30221;14586;15635;2018
15;Coruña, A;032;Curtis;3958;1979;1979;2018
15;Coruña, A;033;Dodro;2791;1357;1434;2018
15;Coruña, A;034;Dumbría;3040;1467;1573;2018
15;Coruña, A;035;Fene;13013;6214;6799;2018
15;Coruña, A;036;Ferrol;66799;31319;35480;2018
15;Coruña, A;037;Fisterra;4701;2375;2326;2018
15;Coruña, A;038;Frades;2385;1182;1203;2018
15;Coruña, A;039;Irixoa;1333;664;669;2018
15;Coruña, A;041;Laracha, A;11302;5564;5738;2018
15;Coruña, A;040;Laxe;3084;1543;1541;2018
15;Coruña, A;042;Lousame;3386;1658;1728;2018
15;Coruña, A;043;Malpica de Bergantiños;5447;2646;2801;2018
15;Coruña, A;044;Mañón;1363;670;693;2018
15;Coruña, A;045;Mazaricos;3947;1887;2060;2018
15;Coruña, A;046;Melide;7443;3659;3784;2018
15;Coruña, A;047;Mesía;2582;1271;1311;2018
15;Coruña, A;048;Miño;6056;3024;3032;2018
15;Coruña, A;049;Moeche;1226;576;650;2018
15;Coruña, A;050;Monfero;1962;1014;948;2018
15;Coruña, A;051;Mugardos;5307;2582;2725;2018
15;Coruña, A;053;Muros;8695;4205;4490;2018
15;Coruña, A;052;Muxía;4736;2297;2439;2018
15;Coruña, A;054;Narón;39115;18891;20224;2018
15;Coruña, A;055;Neda;5112;2478;2634;2018
15;Coruña, A;056;Negreira;6877;3325;3552;2018
15;Coruña, A;057;Noia;14271;6839;7432;2018
15;Coruña, A;058;Oleiros;35559;17193;18366;2018
15;Coruña, A;059;Ordes;12632;6157;6475;2018
15;Coruña, A;060;Oroso;7452;3700;3752;2018
15;Coruña, A;061;Ortigueira;5804;2773;3031;2018
15;Coruña, A;062;Outes;6412;3081;3331;2018
15;Coruña, A;902;Oza-Cesuras;5155;2596;2559;2018
15;Coruña, A;064;Paderne;2419;1179;1240;2018
15;Coruña, A;065;Padrón;8386;4025;4361;2018
15;Coruña, A;066;Pino, O;4656;2333;2323;2018
15;Coruña, A;067;Pobra do Caramiñal, A;9390;4568;4822;2018
15;Coruña, A;068;Ponteceso;5565;2794;2771;2018
15;Coruña, A;069;Pontedeume;7884;3775;4109;2018
15;Coruña, A;070;Pontes de García Rodríguez, As;10237;4999;5238;2018
15;Coruña, A;071;Porto do Son;9243;4596;4647;2018
15;Coruña, A;072;Rianxo;11104;5421;5683;2018
15;Coruña, A;073;Ribeira;27067;13355;13712;2018
15;Coruña, A;074;Rois;4564;2177;2387;2018
15;Coruña, A;075;Sada;15495;7574;7921;2018
15;Coruña, A;076;San Sadurniño;2828;1401;1427;2018
15;Coruña, A;077;Santa Comba;9450;4576;4874;2018
15;Coruña, A;078;Santiago de Compostela;96405;44780;51625;2018
15;Coruña, A;079;Santiso;1610;825;785;2018
15;Coruña, A;080;Sobrado;1799;927;872;2018
15;Coruña, A;081;Somozas, As;1103;553;550;2018
15;Coruña, A;082;Teo;18525;9115;9410;2018
15;Coruña, A;083;Toques;1151;599;552;2018
15;Coruña, A;084;Tordoia;3361;1581;1780;2018
15;Coruña, A;085;Touro;3620;1806;1814;2018
15;Coruña, A;086;Trazo;3148;1551;1597;2018
15;Coruña, A;088;Val do Dubra;3925;1884;2041;2018
15;Coruña, A;087;Valdoviño;6613;3209;3404;2018
15;Coruña, A;089;Vedra;5046;2485;2561;2018
15;Coruña, A;091;Vilarmaior;1231;629;602;2018
15;Coruña, A;090;Vilasantar;1225;645;580;2018
15;Coruña, A;092;Vimianzo;7138;3421;3717;2018
15;Coruña, A;093;Zas;4581;2219;2362;2018
16;Cuenca;001;Abia de la Obispalía;64;39;25;2018
16;Cuenca;002;Acebrón, El;234;116;118;2018
16;Cuenca;003;Alarcón;153;70;83;2018
16;Cuenca;004;Albaladejo del Cuende;252;134;118;2018
16;Cuenca;005;Albalate de las Nogueras;268;142;126;2018
16;Cuenca;006;Albendea;125;58;67;2018
16;Cuenca;007;Alberca de Záncara, La;1590;802;788;2018
16;Cuenca;008;Alcalá de la Vega;90;50;40;2018
16;Cuenca;009;Alcantud;56;32;24;2018
16;Cuenca;010;Alcázar del Rey;137;65;72;2018
16;Cuenca;011;Alcohujate;30;16;14;2018
16;Cuenca;012;Alconchel de la Estrella;90;52;38;2018
16;Cuenca;013;Algarra;25;14;11;2018
16;Cuenca;014;Aliaguilla;659;342;317;2018
16;Cuenca;015;Almarcha, La;375;208;167;2018
16;Cuenca;016;Almendros;225;131;94;2018
16;Cuenca;017;Almodóvar del Pinar;390;212;178;2018
16;Cuenca;018;Almonacid del Marquesado;431;221;210;2018
16;Cuenca;019;Altarejos;195;104;91;2018
16;Cuenca;020;Arandilla del Arroyo;10;5;5;2018
16;Cuenca;905;Arcas;1665;847;818;2018
16;Cuenca;022;Arcos de la Sierra;85;49;36;2018
16;Cuenca;024;Arguisuelas;147;81;66;2018
16;Cuenca;025;Arrancacepas;26;14;12;2018
16;Cuenca;026;Atalaya del Cañavate;95;48;47;2018
16;Cuenca;027;Barajas de Melo;903;482;421;2018
16;Cuenca;029;Barchín del Hoyo;87;54;33;2018
16;Cuenca;030;Bascuñana de San Pedro;19;14;5;2018
16;Cuenca;031;Beamud;35;19;16;2018
16;Cuenca;032;Belinchón;328;169;159;2018
16;Cuenca;033;Belmonte;1938;972;966;2018
16;Cuenca;034;Belmontejo;165;95;70;2018
16;Cuenca;035;Beteta;279;133;146;2018
16;Cuenca;036;Boniches;144;69;75;2018
16;Cuenca;038;Buciegas;40;26;14;2018
16;Cuenca;039;Buenache de Alarcón;446;235;211;2018
16;Cuenca;040;Buenache de la Sierra;90;53;37;2018
16;Cuenca;041;Buendía;414;221;193;2018
16;Cuenca;042;Campillo de Altobuey;1344;665;679;2018
16;Cuenca;043;Campillos-Paravientos;113;63;50;2018
16;Cuenca;044;Campillos-Sierra;40;19;21;2018
16;Cuenca;901;Campos del Paraíso;767;380;387;2018
16;Cuenca;045;Canalejas del Arroyo;219;121;98;2018
16;Cuenca;046;Cañada del Hoyo;247;126;121;2018
16;Cuenca;047;Cañada Juncosa;252;134;118;2018
16;Cuenca;048;Cañamares;467;255;212;2018
16;Cuenca;049;Cañavate, El;151;80;71;2018
16;Cuenca;050;Cañaveras;267;134;133;2018
16;Cuenca;051;Cañaveruelas;138;71;67;2018
16;Cuenca;052;Cañete;769;395;374;2018
16;Cuenca;053;Cañizares;456;251;205;2018
16;Cuenca;055;Carboneras de Guadazaón;785;404;381;2018
16;Cuenca;056;Cardenete;495;265;230;2018
16;Cuenca;057;Carrascosa;75;45;30;2018
16;Cuenca;058;Carrascosa de Haro;111;57;54;2018
16;Cuenca;060;Casas de Benítez;877;427;450;2018
16;Cuenca;061;Casas de Fernando Alonso;1210;637;573;2018
16;Cuenca;062;Casas de Garcimolina;27;18;9;2018
16;Cuenca;063;Casas de Guijarro;111;59;52;2018
16;Cuenca;064;Casas de Haro;836;441;395;2018
16;Cuenca;065;Casas de los Pinos;459;229;230;2018
16;Cuenca;066;Casasimarro;3072;1604;1468;2018
16;Cuenca;067;Castejón;155;79;76;2018
16;Cuenca;068;Castillejo de Iniesta;150;82;68;2018
16;Cuenca;070;Castillejo-Sierra;30;16;14;2018
16;Cuenca;072;Castillo de Garcimuñoz;139;80;59;2018
16;Cuenca;071;Castillo-Albaráñez;21;10;11;2018
16;Cuenca;073;Cervera del Llano;216;111;105;2018
16;Cuenca;023;Chillarón de Cuenca;602;316;286;2018
16;Cuenca;081;Chumillas;57;33;24;2018
16;Cuenca;074;Cierva, La;30;17;13;2018
16;Cuenca;078;Cuenca;54898;26154;28744;2018
16;Cuenca;079;Cueva del Hierro;29;21;8;2018
16;Cuenca;082;Enguídanos;321;170;151;2018
16;Cuenca;083;Fresneda de Altarejos;49;25;24;2018
16;Cuenca;084;Fresneda de la Sierra;48;27;21;2018
16;Cuenca;085;Frontera, La;169;90;79;2018
16;Cuenca;086;Fuente de Pedro Naharro;1212;629;583;2018
16;Cuenca;087;Fuentelespino de Haro;248;130;118;2018
16;Cuenca;088;Fuentelespino de Moya;105;56;49;2018
16;Cuenca;904;Fuentenava de Jábaga;525;275;250;2018
16;Cuenca;089;Fuentes;454;239;215;2018
16;Cuenca;091;Fuertescusa;70;39;31;2018
16;Cuenca;092;Gabaldón;183;106;77;2018
16;Cuenca;093;Garaballa;68;37;31;2018
16;Cuenca;094;Gascueña;154;84;70;2018
16;Cuenca;095;Graja de Campalbo;93;52;41;2018
16;Cuenca;096;Graja de Iniesta;365;193;172;2018
16;Cuenca;097;Henarejos;145;73;72;2018
16;Cuenca;098;Herrumblar, El;678;346;332;2018
16;Cuenca;099;Hinojosa, La;195;98;97;2018
16;Cuenca;100;Hinojosos, Los;789;386;403;2018
16;Cuenca;101;Hito, El;142;78;64;2018
16;Cuenca;102;Honrubia;1597;800;797;2018
16;Cuenca;103;Hontanaya;263;142;121;2018
16;Cuenca;104;Hontecillas;53;29;24;2018
16;Cuenca;106;Horcajo de Santiago;3526;1789;1737;2018
16;Cuenca;107;Huélamo;98;57;41;2018
16;Cuenca;108;Huelves;51;27;24;2018
16;Cuenca;109;Huérguina;52;29;23;2018
16;Cuenca;110;Huerta de la Obispalía;124;72;52;2018
16;Cuenca;111;Huerta del Marquesado;190;108;82;2018
16;Cuenca;112;Huete;1777;919;858;2018
16;Cuenca;113;Iniesta;4299;2131;2168;2018
16;Cuenca;115;Laguna del Marquesado;45;26;19;2018
16;Cuenca;116;Lagunaseca;65;39;26;2018
16;Cuenca;117;Landete;1216;613;603;2018
16;Cuenca;118;Ledaña;1584;782;802;2018
16;Cuenca;119;Leganiel;189;95;94;2018
16;Cuenca;121;Majadas, Las;251;130;121;2018
16;Cuenca;122;Mariana;293;150;143;2018
16;Cuenca;123;Masegosa;70;41;29;2018
16;Cuenca;124;Mesas, Las;2328;1178;1150;2018
16;Cuenca;125;Minglanilla;2211;1130;1081;2018
16;Cuenca;126;Mira;926;459;467;2018
16;Cuenca;128;Monreal del Llano;67;36;31;2018
16;Cuenca;129;Montalbanejo;106;54;52;2018
16;Cuenca;130;Montalbo;626;334;292;2018
16;Cuenca;131;Monteagudo de las Salinas;110;64;46;2018
16;Cuenca;132;Mota de Altarejos;36;23;13;2018
16;Cuenca;133;Mota del Cuervo;6030;2995;3035;2018
16;Cuenca;134;Motilla del Palancar;5959;2972;2987;2018
16;Cuenca;135;Moya;138;78;60;2018
16;Cuenca;137;Narboneta;43;21;22;2018
16;Cuenca;139;Olivares de Júcar;334;176;158;2018
16;Cuenca;140;Olmeda de la Cuesta;21;11;10;2018
16;Cuenca;141;Olmeda del Rey;133;68;65;2018
16;Cuenca;142;Olmedilla de Alarcón;151;87;64;2018
16;Cuenca;143;Olmedilla de Eliz;15;11;4;2018
16;Cuenca;145;Osa de la Vega;485;249;236;2018
16;Cuenca;146;Pajarón;81;41;40;2018
16;Cuenca;147;Pajaroncillo;67;41;26;2018
16;Cuenca;148;Palomares del Campo;625;323;302;2018
16;Cuenca;149;Palomera;159;81;78;2018
16;Cuenca;150;Paracuellos;101;53;48;2018
16;Cuenca;151;Paredes;58;33;25;2018
16;Cuenca;152;Parra de las Vegas, La;34;22;12;2018
16;Cuenca;153;Pedernoso, El;1127;569;558;2018
16;Cuenca;154;Pedroñeras, Las;6548;3345;3203;2018
16;Cuenca;155;Peral, El;611;334;277;2018
16;Cuenca;156;Peraleja, La;96;57;39;2018
16;Cuenca;157;Pesquera, La;215;118;97;2018
16;Cuenca;158;Picazo, El;679;337;342;2018
16;Cuenca;159;Pinarejo;213;105;108;2018
16;Cuenca;160;Pineda de Gigüela;59;35;24;2018
16;Cuenca;161;Piqueras del Castillo;53;29;24;2018
16;Cuenca;162;Portalrubio de Guadamejud;27;13;14;2018
16;Cuenca;163;Portilla;64;35;29;2018
16;Cuenca;165;Poyatos;60;31;29;2018
16;Cuenca;166;Pozoamargo;290;156;134;2018
16;Cuenca;908;Pozorrubielos de la Mancha;188;89;99;2018
16;Cuenca;167;Pozorrubio de Santiago;305;144;161;2018
16;Cuenca;169;Pozuelo, El;51;33;18;2018
16;Cuenca;170;Priego;920;469;451;2018
16;Cuenca;171;Provencio, El;2418;1195;1223;2018
16;Cuenca;172;Puebla de Almenara;345;181;164;2018
16;Cuenca;174;Puebla del Salvador;183;103;80;2018
16;Cuenca;175;Quintanar del Rey;7589;3914;3675;2018
16;Cuenca;176;Rada de Haro;46;26;20;2018
16;Cuenca;177;Reíllo;118;62;56;2018
16;Cuenca;181;Rozalén del Monte;67;31;36;2018
16;Cuenca;185;Saceda-Trasierra;38;28;10;2018
16;Cuenca;186;Saelices;505;260;245;2018
16;Cuenca;187;Salinas del Manzano;81;48;33;2018
16;Cuenca;188;Salmeroncillos;100;58;42;2018
16;Cuenca;189;Salvacañete;296;158;138;2018
16;Cuenca;190;San Clemente;7107;3586;3521;2018
16;Cuenca;191;San Lorenzo de la Parrilla;1040;522;518;2018
16;Cuenca;192;San Martín de Boniches;46;24;22;2018
16;Cuenca;193;San Pedro Palmiches;55;32;23;2018
16;Cuenca;194;Santa Cruz de Moya;227;122;105;2018
16;Cuenca;196;Santa María de los Llanos;688;357;331;2018
16;Cuenca;195;Santa María del Campo Rus;590;289;301;2018
16;Cuenca;197;Santa María del Val;68;41;27;2018
16;Cuenca;198;Sisante;1643;831;812;2018
16;Cuenca;199;Solera de Gabaldón;23;11;12;2018
16;Cuenca;909;Sotorribas;756;389;367;2018
16;Cuenca;202;Talayuelas;884;470;414;2018
16;Cuenca;203;Tarancón;14990;7425;7565;2018
16;Cuenca;204;Tébar;280;148;132;2018
16;Cuenca;205;Tejadillos;124;61;63;2018
16;Cuenca;206;Tinajas;195;103;92;2018
16;Cuenca;209;Torralba;114;69;45;2018
16;Cuenca;211;Torrejoncillo del Rey;363;187;176;2018
16;Cuenca;212;Torrubia del Campo;257;126;131;2018
16;Cuenca;213;Torrubia del Castillo;39;24;15;2018
16;Cuenca;215;Tragacete;259;143;116;2018
16;Cuenca;216;Tresjuncos;302;160;142;2018
16;Cuenca;217;Tribaldos;96;53;43;2018
16;Cuenca;218;Uclés;223;117;106;2018
16;Cuenca;219;Uña;89;46;43;2018
16;Cuenca;906;Valdecolmenas, Los;75;48;27;2018
16;Cuenca;224;Valdemeca;88;49;39;2018
16;Cuenca;225;Valdemorillo de la Sierra;66;41;25;2018
16;Cuenca;227;Valdemoro-Sierra;113;67;46;2018
16;Cuenca;228;Valdeolivas;203;125;78;2018
16;Cuenca;902;Valdetórtola;130;74;56;2018
16;Cuenca;903;Valeras, Las;1516;801;715;2018
16;Cuenca;231;Valhermoso de la Fuente;48;27;21;2018
16;Cuenca;173;Valle de Altomira, El;216;121;95;2018
16;Cuenca;234;Valsalobre;28;16;12;2018
16;Cuenca;236;Valverde de Júcar;1071;537;534;2018
16;Cuenca;237;Valverdejo;102;54;48;2018
16;Cuenca;238;Vara de Rey;501;257;244;2018
16;Cuenca;239;Vega del Codorno;134;85;49;2018
16;Cuenca;240;Vellisca;100;57;43;2018
16;Cuenca;242;Villaconejos de Trabaque;348;172;176;2018
16;Cuenca;243;Villaescusa de Haro;470;241;229;2018
16;Cuenca;244;Villagarcía del Llano;745;380;365;2018
16;Cuenca;245;Villalba de la Sierra;476;232;244;2018
16;Cuenca;246;Villalba del Rey;515;285;230;2018
16;Cuenca;247;Villalgordo del Marquesado;76;39;37;2018
16;Cuenca;248;Villalpardo;1016;504;512;2018
16;Cuenca;249;Villamayor de Santiago;2522;1281;1241;2018
16;Cuenca;250;Villanueva de Guadamejud;70;43;27;2018
16;Cuenca;251;Villanueva de la Jara;2304;1164;1140;2018
16;Cuenca;253;Villar de Cañas;378;202;176;2018
16;Cuenca;254;Villar de Domingo García;229;113;116;2018
16;Cuenca;255;Villar de la Encina;165;88;77;2018
16;Cuenca;263;Villar de Olalla;1258;673;585;2018
16;Cuenca;258;Villar del Humo;189;101;88;2018
16;Cuenca;259;Villar del Infantado;47;27;20;2018
16;Cuenca;910;Villar y Velasco;82;47;35;2018
16;Cuenca;264;Villarejo de Fuentes;454;232;222;2018
16;Cuenca;265;Villarejo de la Peñuela;21;9;12;2018
16;Cuenca;266;Villarejo-Periesteban;385;191;194;2018
16;Cuenca;269;Villares del Saz;466;231;235;2018
16;Cuenca;270;Villarrubio;196;104;92;2018
16;Cuenca;271;Villarta;821;408;413;2018
16;Cuenca;272;Villas de la Ventosa;233;139;94;2018
16;Cuenca;273;Villaverde y Pasaconsol;337;179;158;2018
16;Cuenca;274;Víllora;128;67;61;2018
16;Cuenca;275;Vindel;10;6;4;2018
16;Cuenca;276;Yémeda;22;14;8;2018
16;Cuenca;277;Zafra de Záncara;124;67;57;2018
16;Cuenca;278;Zafrilla;64;32;32;2018
16;Cuenca;279;Zarza de Tajo;229;129;100;2018
16;Cuenca;280;Zarzuela;181;96;85;2018
20;Gipuzkoa;001;Abaltzisketa;320;173;147;2018
20;Gipuzkoa;002;Aduna;469;256;213;2018
20;Gipuzkoa;016;Aia;2081;1098;983;2018
20;Gipuzkoa;003;Aizarnazabal;777;394;383;2018
20;Gipuzkoa;004;Albiztur;309;160;149;2018
20;Gipuzkoa;005;Alegia;1726;884;842;2018
20;Gipuzkoa;006;Alkiza;374;183;191;2018
20;Gipuzkoa;906;Altzaga;179;87;92;2018
20;Gipuzkoa;007;Altzo;427;223;204;2018
20;Gipuzkoa;008;Amezketa;939;508;431;2018
20;Gipuzkoa;009;Andoain;14618;7209;7409;2018
20;Gipuzkoa;010;Anoeta;2034;1052;982;2018
20;Gipuzkoa;011;Antzuola;2136;1070;1066;2018
20;Gipuzkoa;012;Arama;205;100;105;2018
20;Gipuzkoa;013;Aretxabaleta;6987;3514;3473;2018
20;Gipuzkoa;055;Arrasate/Mondragón;22019;10822;11197;2018
20;Gipuzkoa;014;Asteasu;1533;802;731;2018
20;Gipuzkoa;903;Astigarraga;6272;3204;3068;2018
20;Gipuzkoa;015;Ataun;1669;863;806;2018
20;Gipuzkoa;017;Azkoitia;11609;5768;5841;2018
20;Gipuzkoa;018;Azpeitia;14786;7387;7399;2018
20;Gipuzkoa;904;Baliarrain;137;75;62;2018
20;Gipuzkoa;019;Beasain;13881;6938;6943;2018
20;Gipuzkoa;020;Beizama;151;90;61;2018
20;Gipuzkoa;021;Belauntza;239;129;110;2018
20;Gipuzkoa;022;Berastegi;1081;559;522;2018
20;Gipuzkoa;074;Bergara;14596;7257;7339;2018
20;Gipuzkoa;023;Berrobi;602;315;287;2018
20;Gipuzkoa;024;Bidania-Goiatz;508;279;229;2018
20;Gipuzkoa;029;Deba;5457;2717;2740;2018
20;Gipuzkoa;069;Donostia/San Sebastián;186665;87764;98901;2018
20;Gipuzkoa;030;Eibar;27406;13294;14112;2018
20;Gipuzkoa;031;Elduain;239;123;116;2018
20;Gipuzkoa;033;Elgeta;1135;572;563;2018
20;Gipuzkoa;032;Elgoibar;11582;5730;5852;2018
20;Gipuzkoa;067;Errenteria;39355;19037;20318;2018
20;Gipuzkoa;066;Errezil;589;311;278;2018
20;Gipuzkoa;034;Eskoriatza;4087;2052;2035;2018
20;Gipuzkoa;035;Ezkio-Itsaso;575;296;279;2018
20;Gipuzkoa;038;Gabiria;488;256;232;2018
20;Gipuzkoa;037;Gaintza;129;74;55;2018
20;Gipuzkoa;907;Gaztelu;153;83;70;2018
20;Gipuzkoa;039;Getaria;2818;1428;1390;2018
20;Gipuzkoa;040;Hernani;20222;9890;10332;2018
20;Gipuzkoa;041;Hernialde;313;165;148;2018
20;Gipuzkoa;036;Hondarribia;17018;8462;8556;2018
20;Gipuzkoa;042;Ibarra;4172;2082;2090;2018
20;Gipuzkoa;043;Idiazabal;2305;1170;1135;2018
20;Gipuzkoa;044;Ikaztegieta;488;248;240;2018
20;Gipuzkoa;045;Irun;61983;30306;31677;2018
20;Gipuzkoa;046;Irura;1862;961;901;2018
20;Gipuzkoa;047;Itsasondo;641;327;314;2018
20;Gipuzkoa;048;Larraul;253;139;114;2018
20;Gipuzkoa;902;Lasarte-Oria;18253;8873;9380;2018
20;Gipuzkoa;049;Lazkao;5646;2838;2808;2018
20;Gipuzkoa;050;Leaburu;377;195;182;2018
20;Gipuzkoa;051;Legazpi;8384;4251;4133;2018
20;Gipuzkoa;052;Legorreta;1430;728;702;2018
20;Gipuzkoa;068;Leintz-Gatzaga;232;129;103;2018
20;Gipuzkoa;053;Lezo;6045;3006;3039;2018
20;Gipuzkoa;054;Lizartza;602;312;290;2018
20;Gipuzkoa;901;Mendaro;2010;1014;996;2018
20;Gipuzkoa;057;Mutiloa;252;139;113;2018
20;Gipuzkoa;056;Mutriku;5354;2712;2642;2018
20;Gipuzkoa;063;Oiartzun;10276;5103;5173;2018
20;Gipuzkoa;058;Olaberria;945;478;467;2018
20;Gipuzkoa;059;Oñati;11335;5601;5734;2018
20;Gipuzkoa;076;Ordizia;10150;4996;5154;2018
20;Gipuzkoa;905;Orendain;218;112;106;2018
20;Gipuzkoa;060;Orexa;123;67;56;2018
20;Gipuzkoa;061;Orio;5948;2998;2950;2018
20;Gipuzkoa;062;Ormaiztegi;1302;661;641;2018
20;Gipuzkoa;064;Pasaia;16128;7739;8389;2018
20;Gipuzkoa;070;Segura;1432;720;712;2018
20;Gipuzkoa;065;Soraluze-Placencia de las Armas;3894;1945;1949;2018
20;Gipuzkoa;071;Tolosa;19525;9431;10094;2018
20;Gipuzkoa;072;Urnieta;6170;3080;3090;2018
20;Gipuzkoa;077;Urretxu;6730;3319;3411;2018
20;Gipuzkoa;073;Usurbil;6165;3092;3073;2018
20;Gipuzkoa;075;Villabona;5881;2938;2943;2018
20;Gipuzkoa;078;Zaldibia;1613;827;786;2018
20;Gipuzkoa;079;Zarautz;23223;11308;11915;2018
20;Gipuzkoa;025;Zegama;1519;773;746;2018
20;Gipuzkoa;026;Zerain;252;120;132;2018
20;Gipuzkoa;027;Zestoa;3725;1955;1770;2018
20;Gipuzkoa;028;Zizurkil;2976;1489;1487;2018
20;Gipuzkoa;081;Zumaia;10044;5004;5040;2018
20;Gipuzkoa;080;Zumarraga;9834;4857;4977;2018
17;Girona;001;Agullana;841;418;423;2018
17;Girona;002;Aiguaviva;767;388;379;2018
17;Girona;003;Albanyà;139;72;67;2018
17;Girona;004;Albons;765;396;369;2018
17;Girona;006;Alp;1559;809;750;2018
17;Girona;007;Amer;2256;1106;1150;2018
17;Girona;008;Anglès;5519;2735;2784;2018
17;Girona;009;Arbúcies;6515;3378;3137;2018
17;Girona;010;Argelaguer;423;219;204;2018
17;Girona;011;Armentera, L';937;468;469;2018
17;Girona;012;Avinyonet de Puigventós;1604;803;801;2018
17;Girona;015;Banyoles;19615;9741;9874;2018
17;Girona;016;Bàscara;1000;521;479;2018
17;Girona;013;Begur;3934;1972;1962;2018
17;Girona;018;Bellcaire d'Empordà;671;328;343;2018
17;Girona;019;Besalú;2467;1161;1306;2018
17;Girona;020;Bescanó;4941;2493;2448;2018
17;Girona;021;Beuda;187;101;86;2018
17;Girona;022;Bisbal d'Empordà, La;10859;5407;5452;2018
17;Girona;234;Biure;238;120;118;2018
17;Girona;023;Blanes;38790;19272;19518;2018
17;Girona;029;Boadella i les Escaules;269;139;130;2018
17;Girona;024;Bolvir;383;200;183;2018
17;Girona;025;Bordils;1701;851;850;2018
17;Girona;026;Borrassà;702;369;333;2018
17;Girona;027;Breda;3733;1855;1878;2018
17;Girona;028;Brunyola;369;185;184;2018
17;Girona;031;Cabanelles;273;153;120;2018
17;Girona;030;Cabanes;944;502;442;2018
17;Girona;032;Cadaqués;2752;1344;1408;2018
17;Girona;033;Caldes de Malavella;7458;3716;3742;2018
17;Girona;034;Calonge;10897;5457;5440;2018
17;Girona;035;Camós;690;347;343;2018
17;Girona;036;Campdevànol;3204;1556;1648;2018
17;Girona;037;Campelles;133;70;63;2018
17;Girona;038;Campllong;535;263;272;2018
17;Girona;039;Camprodon;2261;1111;1150;2018
17;Girona;040;Canet d'Adri;708;364;344;2018
17;Girona;041;Cantallops;313;155;158;2018
17;Girona;042;Capmany;613;308;305;2018
17;Girona;044;Cassà de la Selva;10359;5285;5074;2018
17;Girona;046;Castellfollit de la Roca;956;486;470;2018
17;Girona;047;Castelló d'Empúries;10820;5495;5325;2018
17;Girona;048;Castell-Platja d'Aro;10585;5215;5370;2018
17;Girona;189;Cellera de Ter, La;1976;981;995;2018
17;Girona;049;Celrà;5390;2708;2682;2018
17;Girona;050;Cervià de Ter;948;487;461;2018
17;Girona;051;Cistella;300;148;152;2018
17;Girona;054;Colera;465;235;230;2018
17;Girona;055;Colomers;176;88;88;2018
17;Girona;057;Corçà;1253;642;611;2018
17;Girona;056;Cornellà del Terri;2322;1182;1140;2018
17;Girona;058;Crespià;251;130;121;2018
17;Girona;901;Cruïlles, Monells i Sant Sadurní de l'Heura;1274;639;635;2018
17;Girona;060;Darnius;557;276;281;2018
17;Girona;061;Das;227;122;105;2018
17;Girona;062;Escala, L';10417;5308;5109;2018
17;Girona;063;Espinelves;206;106;100;2018
17;Girona;064;Espolla;425;210;215;2018
17;Girona;065;Esponellà;433;222;211;2018
17;Girona;005;Far d'Empordà, El;576;287;289;2018
17;Girona;066;Figueres;46381;22917;23464;2018
17;Girona;067;Flaçà;1081;525;556;2018
17;Girona;068;Foixà;305;159;146;2018
17;Girona;069;Fontanals de Cerdanya;455;231;224;2018
17;Girona;070;Fontanilles;138;76;62;2018
17;Girona;071;Fontcoberta;1474;733;741;2018
17;Girona;902;Forallac;1713;843;870;2018
17;Girona;073;Fornells de la Selva;2649;1316;1333;2018
17;Girona;074;Fortià;732;362;370;2018
17;Girona;075;Garrigàs;439;226;213;2018
17;Girona;076;Garrigoles;175;94;81;2018
17;Girona;077;Garriguella;840;416;424;2018
17;Girona;078;Ger;429;213;216;2018
17;Girona;079;Girona;100266;48030;52236;2018
17;Girona;080;Gombrèn;186;94;92;2018
17;Girona;081;Gualta;392;220;172;2018
17;Girona;082;Guils de Cerdanya;529;278;251;2018
17;Girona;083;Hostalric;4139;2096;2043;2018
17;Girona;084;Isòvol;278;159;119;2018
17;Girona;085;Jafre;390;206;184;2018
17;Girona;086;Jonquera, La;3233;1620;1613;2018
17;Girona;087;Juià;335;180;155;2018
17;Girona;088;Lladó;787;386;401;2018
17;Girona;089;Llagostera;8297;4240;4057;2018
17;Girona;090;Llambilles;693;353;340;2018
17;Girona;091;Llanars;514;267;247;2018
17;Girona;092;Llançà;4868;2412;2456;2018
17;Girona;093;Llers;1239;617;622;2018
17;Girona;094;Llívia;1428;764;664;2018
17;Girona;095;Lloret de Mar;37350;19099;18251;2018
17;Girona;096;Llosses, Les;219;122;97;2018
17;Girona;102;Maçanet de Cabrenys;681;336;345;2018
17;Girona;103;Maçanet de la Selva;6919;3561;3358;2018
17;Girona;097;Madremanya;282;136;146;2018
17;Girona;098;Maià de Montcal;413;217;196;2018
17;Girona;100;Masarac;272;140;132;2018
17;Girona;101;Massanes;730;394;336;2018
17;Girona;099;Meranges;98;58;40;2018
17;Girona;105;Mieres;312;159;153;2018
17;Girona;106;Mollet de Peralada;190;98;92;2018
17;Girona;107;Molló;328;159;169;2018
17;Girona;109;Montagut i Oix;899;475;424;2018
17;Girona;110;Mont-ras;1691;858;833;2018
17;Girona;111;Navata;1313;647;666;2018
17;Girona;112;Ogassa;226;129;97;2018
17;Girona;114;Olot;34486;17139;17347;2018
17;Girona;115;Ordis;382;202;180;2018
17;Girona;116;Osor;416;217;199;2018
17;Girona;117;Palafrugell;22860;11322;11538;2018
17;Girona;118;Palamós;17898;8742;9156;2018
17;Girona;119;Palau de Santa Eulàlia;95;56;39;2018
17;Girona;121;Palau-sator;295;160;135;2018
17;Girona;120;Palau-saverdera;1439;718;721;2018
17;Girona;123;Palol de Revardit;467;229;238;2018
17;Girona;124;Pals;2461;1246;1215;2018
17;Girona;125;Pardines;162;90;72;2018
17;Girona;126;Parlavà;394;200;194;2018
17;Girona;128;Pau;547;278;269;2018
17;Girona;129;Pedret i Marzà;195;101;94;2018
17;Girona;130;Pera, La;447;216;231;2018
17;Girona;132;Peralada;1868;916;952;2018
17;Girona;133;Planes d'Hostoles, Les;1660;843;817;2018
17;Girona;134;Planoles;303;170;133;2018
17;Girona;135;Pont de Molins;530;265;265;2018
17;Girona;136;Pontós;247;135;112;2018
17;Girona;137;Porqueres;4595;2281;2314;2018
17;Girona;140;Port de la Selva, El;980;502;478;2018
17;Girona;138;Portbou;1077;525;552;2018
17;Girona;139;Preses, Les;1763;873;890;2018
17;Girona;141;Puigcerdà;8981;4475;4506;2018
17;Girona;142;Quart;3640;1825;1815;2018
17;Girona;043;Queralbs;186;103;83;2018
17;Girona;143;Rabós;179;90;89;2018
17;Girona;144;Regencós;276;142;134;2018
17;Girona;145;Ribes de Freser;1766;879;887;2018
17;Girona;146;Riells i Viabrea;4002;2060;1942;2018
17;Girona;147;Ripoll;10632;5251;5381;2018
17;Girona;148;Riudarenes;2181;1125;1056;2018
17;Girona;149;Riudaura;462;224;238;2018
17;Girona;150;Riudellots de la Selva;2059;1053;1006;2018
17;Girona;151;Riumors;263;132;131;2018
17;Girona;152;Roses;19319;9713;9606;2018
17;Girona;153;Rupià;269;135;134;2018
17;Girona;154;Sales de Llierca;151;76;75;2018
17;Girona;155;Salt;30622;16048;14574;2018
17;Girona;157;Sant Andreu Salou;156;82;74;2018
17;Girona;183;Sant Aniol de Finestres;351;186;165;2018
17;Girona;158;Sant Climent Sescebes;635;368;267;2018
17;Girona;159;Sant Feliu de Buixalleu;804;419;385;2018
17;Girona;160;Sant Feliu de Guíxols;21824;10761;11063;2018
17;Girona;161;Sant Feliu de Pallerols;1343;648;695;2018
17;Girona;162;Sant Ferriol;245;125;120;2018
17;Girona;163;Sant Gregori;3740;1916;1824;2018
17;Girona;164;Sant Hilari Sacalm;5591;2818;2773;2018
17;Girona;165;Sant Jaume de Llierca;840;406;434;2018
17;Girona;167;Sant Joan de les Abadesses;3224;1606;1618;2018
17;Girona;168;Sant Joan de Mollet;502;241;261;2018
17;Girona;185;Sant Joan les Fonts;2966;1506;1460;2018
17;Girona;166;Sant Jordi Desvalls;731;359;372;2018
17;Girona;169;Sant Julià de Ramis;3461;1749;1712;2018
17;Girona;903;Sant Julià del Llor i Bonmatí;1275;656;619;2018
17;Girona;171;Sant Llorenç de la Muga;251;131;120;2018
17;Girona;172;Sant Martí de Llémena;626;324;302;2018
17;Girona;173;Sant Martí Vell;249;127;122;2018
17;Girona;174;Sant Miquel de Campmajor;228;120;108;2018
17;Girona;175;Sant Miquel de Fluvià;746;395;351;2018
17;Girona;176;Sant Mori;177;93;84;2018
17;Girona;177;Sant Pau de Segúries;707;349;358;2018
17;Girona;178;Sant Pere Pescador;2039;1088;951;2018
17;Girona;180;Santa Coloma de Farners;12894;6490;6404;2018
17;Girona;181;Santa Cristina d'Aro;5203;2608;2595;2018
17;Girona;182;Santa Llogaia d'Àlguema;363;191;172;2018
17;Girona;184;Santa Pau;1573;794;779;2018
17;Girona;186;Sarrià de Ter;5114;2513;2601;2018
17;Girona;187;Saus, Camallera i Llampaies;848;419;429;2018
17;Girona;188;Selva de Mar, La;187;106;81;2018
17;Girona;190;Serinyà;1108;570;538;2018
17;Girona;191;Serra de Daró;210;117;93;2018
17;Girona;192;Setcases;168;89;79;2018
17;Girona;193;Sils;5969;3023;2946;2018
17;Girona;052;Siurana;162;77;85;2018
17;Girona;194;Susqueda;97;56;41;2018
17;Girona;195;Tallada d'Empordà, La;459;234;225;2018
17;Girona;196;Terrades;314;149;165;2018
17;Girona;197;Torrent;165;90;75;2018
17;Girona;198;Torroella de Fluvià;723;365;358;2018
17;Girona;199;Torroella de Montgrí;11537;5842;5695;2018
17;Girona;200;Tortellà;801;390;411;2018
17;Girona;201;Toses;165;100;65;2018
17;Girona;202;Tossa de Mar;5584;2816;2768;2018
17;Girona;204;Ullà;1139;625;514;2018
17;Girona;205;Ullastret;286;141;145;2018
17;Girona;203;Ultramort;214;117;97;2018
17;Girona;206;Urús;178;84;94;2018
17;Girona;014;Vajol, La;85;46;39;2018
17;Girona;208;Vall de Bianya, La;1286;651;635;2018
17;Girona;207;Vall d'en Bas, La;3029;1528;1501;2018
17;Girona;170;Vallfogona de Ripollès;212;115;97;2018
17;Girona;209;Vall-llobrega;912;454;458;2018
17;Girona;210;Ventalló;854;432;422;2018
17;Girona;211;Verges;1189;582;607;2018
17;Girona;212;Vidrà;173;88;85;2018
17;Girona;213;Vidreres;7740;3995;3745;2018
17;Girona;214;Vilabertran;951;486;465;2018
17;Girona;215;Vilablareix;2789;1383;1406;2018
17;Girona;217;Viladamat;466;246;220;2018
17;Girona;216;Viladasens;204;108;96;2018
17;Girona;218;Vilademuls;823;432;391;2018
17;Girona;220;Viladrau;1026;505;521;2018
17;Girona;221;Vilafant;5443;2658;2785;2018
17;Girona;223;Vilajuïga;1112;552;560;2018
17;Girona;224;Vilallonga de Ter;404;211;193;2018
17;Girona;225;Vilamacolum;312;167;145;2018
17;Girona;226;Vilamalla;1157;581;576;2018
17;Girona;227;Vilamaniscle;208;116;92;2018
17;Girona;228;Vilanant;399;198;201;2018
17;Girona;230;Vila-sacra;709;348;361;2018
17;Girona;222;Vilaür;147;77;70;2018
17;Girona;233;Vilobí d'Onyar;3196;1660;1536;2018
17;Girona;232;Vilopriu;205;109;96;2018
18;Granada;001;Agrón;288;141;147;2018
18;Granada;002;Alamedilla;599;307;292;2018
18;Granada;003;Albolote;18746;9329;9417;2018
18;Granada;004;Albondón;729;403;326;2018
18;Granada;005;Albuñán;415;214;201;2018
18;Granada;006;Albuñol;7128;3879;3249;2018
18;Granada;007;Albuñuelas;830;419;411;2018
18;Granada;010;Aldeire;628;331;297;2018
18;Granada;011;Alfacar;5378;2735;2643;2018
18;Granada;012;Algarinejo;2591;1333;1258;2018
18;Granada;013;Alhama de Granada;5980;3201;2779;2018
18;Granada;014;Alhendín;9168;4630;4538;2018
18;Granada;015;Alicún de Ortega;475;235;240;2018
18;Granada;016;Almegíjar;346;186;160;2018
18;Granada;017;Almuñécar;26377;13032;13345;2018
18;Granada;904;Alpujarra de la Sierra;978;550;428;2018
18;Granada;018;Alquife;624;311;313;2018
18;Granada;020;Arenas del Rey;1178;613;565;2018
18;Granada;021;Armilla;23968;11936;12032;2018
18;Granada;022;Atarfe;18554;9254;9300;2018
18;Granada;023;Baza;20519;10210;10309;2018
18;Granada;024;Beas de Granada;985;518;467;2018
18;Granada;025;Beas de Guadix;340;171;169;2018
18;Granada;027;Benalúa;3285;1636;1649;2018
18;Granada;028;Benalúa de las Villas;1065;551;514;2018
18;Granada;029;Benamaurel;2297;1155;1142;2018
18;Granada;030;Bérchules;719;387;332;2018
18;Granada;032;Bubión;302;158;144;2018
18;Granada;033;Busquístar;279;146;133;2018
18;Granada;034;Cacín;578;292;286;2018
18;Granada;035;Cádiar;1469;768;701;2018
18;Granada;036;Cájar;5070;2445;2625;2018
18;Granada;114;Calahorra, La;661;330;331;2018
18;Granada;037;Calicasas;609;305;304;2018
18;Granada;038;Campotéjar;1253;643;610;2018
18;Granada;039;Caniles;4060;2085;1975;2018
18;Granada;040;Cáñar;343;184;159;2018
18;Granada;042;Capileira;558;278;280;2018
18;Granada;043;Carataunas;178;96;82;2018
18;Granada;044;Cástaras;244;144;100;2018
18;Granada;045;Castilléjar;1337;692;645;2018
18;Granada;046;Castril;2124;1098;1026;2018
18;Granada;047;Cenes de la Vega;7928;3969;3959;2018
18;Granada;059;Chauchina;5546;2741;2805;2018
18;Granada;061;Chimeneas;1291;673;618;2018
18;Granada;062;Churriana de la Vega;14851;7407;7444;2018
18;Granada;048;Cijuela;3243;1657;1586;2018
18;Granada;049;Cogollos de Guadix;656;362;294;2018
18;Granada;050;Cogollos de la Vega;2044;1018;1026;2018
18;Granada;051;Colomera;1350;706;644;2018
18;Granada;053;Cortes de Baza;1901;945;956;2018
18;Granada;054;Cortes y Graena;993;526;467;2018
18;Granada;912;Cuevas del Campo;1774;886;888;2018
18;Granada;056;Cúllar;4171;2084;2087;2018
18;Granada;057;Cúllar Vega;7378;3732;3646;2018
18;Granada;063;Darro;1583;805;778;2018
18;Granada;064;Dehesas de Guadix;420;213;207;2018
18;Granada;065;Dehesas Viejas;723;367;356;2018
18;Granada;066;Deifontes;2616;1311;1305;2018
18;Granada;067;Diezma;755;391;364;2018
18;Granada;068;Dílar;2032;1017;1015;2018
18;Granada;069;Dólar;621;337;284;2018
18;Granada;915;Domingo Pérez de Granada;890;465;425;2018
18;Granada;070;Dúdar;320;170;150;2018
18;Granada;071;Dúrcal;6975;3467;3508;2018
18;Granada;072;Escúzar;789;404;385;2018
18;Granada;074;Ferreira;300;155;145;2018
18;Granada;076;Fonelas;993;517;476;2018
18;Granada;078;Freila;900;460;440;2018
18;Granada;079;Fuente Vaqueros;4387;2197;2190;2018
18;Granada;905;Gabias, Las;20703;10547;10156;2018
18;Granada;082;Galera;1090;549;541;2018
18;Granada;083;Gobernador;233;110;123;2018
18;Granada;084;Gójar;5703;2898;2805;2018
18;Granada;085;Gor;736;377;359;2018
18;Granada;086;Gorafe;379;196;183;2018
18;Granada;087;Granada;232208;107414;124794;2018
18;Granada;088;Guadahortuna;1924;993;931;2018
18;Granada;089;Guadix;18718;9264;9454;2018
18;Granada;906;Guájares, Los;1028;538;490;2018
18;Granada;093;Gualchos;5210;2787;2423;2018
18;Granada;094;Güéjar Sierra;2849;1517;1332;2018
18;Granada;095;Güevéjar;2541;1336;1205;2018
18;Granada;096;Huélago;388;203;185;2018
18;Granada;097;Huéneja;1151;614;537;2018
18;Granada;098;Huéscar;7367;3643;3724;2018
18;Granada;099;Huétor de Santillán;1882;970;912;2018
18;Granada;100;Huétor Tájar;10286;5182;5104;2018
18;Granada;101;Huétor Vega;11966;6014;5952;2018
18;Granada;102;Íllora;10135;5063;5072;2018
18;Granada;103;Ítrabo;1002;503;499;2018
18;Granada;105;Iznalloz;5085;2605;2480;2018
18;Granada;106;Játar;599;326;273;2018
18;Granada;107;Jayena;1104;561;543;2018
18;Granada;108;Jérez del Marquesado;977;511;466;2018
18;Granada;109;Jete;909;478;431;2018
18;Granada;111;Jun;3785;1932;1853;2018
18;Granada;112;Juviles;142;68;74;2018
18;Granada;115;Láchar;3354;1721;1633;2018
18;Granada;116;Lanjarón;3485;1738;1747;2018
18;Granada;117;Lanteira;576;310;266;2018
18;Granada;119;Lecrín;2103;1068;1035;2018
18;Granada;120;Lentegí;328;172;156;2018
18;Granada;121;Lobras;148;78;70;2018
18;Granada;122;Loja;20371;10143;10228;2018
18;Granada;123;Lugros;332;177;155;2018
18;Granada;124;Lújar;462;252;210;2018
18;Granada;126;Malahá, La;1827;915;912;2018
18;Granada;127;Maracena;22047;10849;11198;2018
18;Granada;128;Marchal;409;193;216;2018
18;Granada;132;Moclín;3723;1857;1866;2018
18;Granada;133;Molvízar;2759;1411;1348;2018
18;Granada;134;Monachil;7826;4033;3793;2018
18;Granada;135;Montefrío;5479;2763;2716;2018
18;Granada;136;Montejícar;2163;1112;1051;2018
18;Granada;137;Montillana;1157;610;547;2018
18;Granada;138;Moraleda de Zafayona;3159;1592;1567;2018
18;Granada;909;Morelábor;619;334;285;2018
18;Granada;140;Motril;60592;29831;30761;2018
18;Granada;141;Murtas;464;259;205;2018
18;Granada;903;Nevada;1079;556;523;2018
18;Granada;143;Nigüelas;1182;604;578;2018
18;Granada;144;Nívar;996;524;472;2018
18;Granada;145;Ogíjares;14025;6940;7085;2018
18;Granada;146;Orce;1198;609;589;2018
18;Granada;147;Órgiva;5649;2837;2812;2018
18;Granada;148;Otívar;1029;523;506;2018
18;Granada;150;Padul;8396;4220;4176;2018
18;Granada;151;Pampaneira;321;160;161;2018
18;Granada;152;Pedro Martínez;1134;556;578;2018
18;Granada;153;Peligros;11286;5603;5683;2018
18;Granada;154;Peza, La;1177;600;577;2018
18;Granada;910;Pinar, El;919;475;444;2018
18;Granada;157;Pinos Genil;1449;762;687;2018
18;Granada;158;Pinos Puente;10144;5101;5043;2018
18;Granada;159;Píñar;1120;608;512;2018
18;Granada;161;Polícar;236;127;109;2018
18;Granada;162;Polopos;1703;929;774;2018
18;Granada;163;Pórtugos;389;199;190;2018
18;Granada;164;Puebla de Don Fadrique;2292;1176;1116;2018
18;Granada;165;Pulianas;5348;2656;2692;2018
18;Granada;167;Purullena;2312;1176;1136;2018
18;Granada;168;Quéntar;916;468;448;2018
18;Granada;170;Rubite;382;212;170;2018
18;Granada;171;Salar;2639;1330;1309;2018
18;Granada;173;Salobreña;12396;6173;6223;2018
18;Granada;174;Santa Cruz del Comercio;541;281;260;2018
18;Granada;175;Santa Fe;14986;7368;7618;2018
18;Granada;176;Soportújar;266;144;122;2018
18;Granada;177;Sorvilán;545;299;246;2018
18;Granada;901;Taha, La;653;343;310;2018
18;Granada;178;Torre-Cardela;759;402;357;2018
18;Granada;179;Torvizcón;663;347;316;2018
18;Granada;180;Trevélez;742;386;356;2018
18;Granada;181;Turón;255;153;102;2018
18;Granada;182;Ugíjar;2521;1240;1281;2018
18;Granada;914;Valderrubio;2086;1020;1066;2018
18;Granada;907;Valle del Zalabí;2145;1094;1051;2018
18;Granada;902;Valle, El;935;465;470;2018
18;Granada;183;Válor;672;344;328;2018
18;Granada;911;Vegas del Genil;10981;5609;5372;2018
18;Granada;184;Vélez de Benaudalla;2870;1425;1445;2018
18;Granada;185;Ventas de Huelma;610;332;278;2018
18;Granada;149;Villa de Otura;6917;3478;3439;2018
18;Granada;908;Villamena;950;477;473;2018
18;Granada;187;Villanueva de las Torres;585;310;275;2018
18;Granada;188;Villanueva Mesía;2024;997;1027;2018
18;Granada;189;Víznar;980;509;471;2018
18;Granada;192;Zafarraya;2057;1097;960;2018
18;Granada;913;Zagra;855;432;423;2018
18;Granada;193;Zubia, La;18995;9374;9621;2018
18;Granada;194;Zújar;2597;1338;1259;2018
19;Guadalajara;001;Abánades;53;29;24;2018
19;Guadalajara;002;Ablanque;60;34;26;2018
19;Guadalajara;003;Adobes;31;17;14;2018
19;Guadalajara;004;Alaminos;62;27;35;2018
19;Guadalajara;005;Alarilla;156;101;55;2018
19;Guadalajara;006;Albalate de Zorita;918;517;401;2018
19;Guadalajara;007;Albares;540;271;269;2018
19;Guadalajara;008;Albendiego;46;31;15;2018
19;Guadalajara;009;Alcocer;326;168;158;2018
19;Guadalajara;010;Alcolea de las Peñas;12;8;4;2018
19;Guadalajara;011;Alcolea del Pinar;321;174;147;2018
19;Guadalajara;013;Alcoroches;125;79;46;2018
19;Guadalajara;015;Aldeanueva de Guadalajara;84;49;35;2018
19;Guadalajara;016;Algar de Mesa;59;42;17;2018
19;Guadalajara;017;Algora;77;46;31;2018
19;Guadalajara;018;Alhóndiga;157;90;67;2018
19;Guadalajara;019;Alique;16;8;8;2018
19;Guadalajara;020;Almadrones;58;38;20;2018
19;Guadalajara;021;Almoguera;1306;686;620;2018
19;Guadalajara;022;Almonacid de Zorita;720;352;368;2018
19;Guadalajara;023;Alocén;177;88;89;2018
19;Guadalajara;024;Alovera;12570;6383;6187;2018
19;Guadalajara;027;Alustante;157;89;68;2018
19;Guadalajara;031;Angón;10;8;2;2018
19;Guadalajara;032;Anguita;163;83;80;2018
19;Guadalajara;033;Anquela del Ducado;51;29;22;2018
19;Guadalajara;034;Anquela del Pedregal;23;17;6;2018
19;Guadalajara;036;Aranzueque;390;205;185;2018
19;Guadalajara;037;Arbancón;158;93;65;2018
19;Guadalajara;038;Arbeteta;26;19;7;2018
19;Guadalajara;039;Argecilla;65;44;21;2018
19;Guadalajara;040;Armallones;51;32;19;2018
19;Guadalajara;041;Armuña de Tajuña;226;124;102;2018
19;Guadalajara;042;Arroyo de las Fraguas;22;12;10;2018
19;Guadalajara;043;Atanzón;92;59;33;2018
19;Guadalajara;044;Atienza;431;247;184;2018
19;Guadalajara;045;Auñón;146;81;65;2018
19;Guadalajara;046;Azuqueca de Henares;34685;17550;17135;2018
19;Guadalajara;047;Baides;55;29;26;2018
19;Guadalajara;048;Baños de Tajo;17;12;5;2018
19;Guadalajara;049;Bañuelos;14;12;2;2018
19;Guadalajara;050;Barriopedro;16;11;5;2018
19;Guadalajara;051;Berninches;50;34;16;2018
19;Guadalajara;052;Bodera, La;26;16;10;2018
19;Guadalajara;053;Brihuega;2399;1252;1147;2018
19;Guadalajara;054;Budia;208;122;86;2018
19;Guadalajara;055;Bujalaro;43;21;22;2018
19;Guadalajara;057;Bustares;76;46;30;2018
19;Guadalajara;058;Cabanillas del Campo;10123;5138;4985;2018
19;Guadalajara;059;Campillo de Dueñas;79;45;34;2018
19;Guadalajara;060;Campillo de Ranas;147;94;53;2018
19;Guadalajara;061;Campisábalos;52;38;14;2018
19;Guadalajara;064;Canredondo;63;40;23;2018
19;Guadalajara;065;Cantalojas;144;88;56;2018
19;Guadalajara;066;Cañizar;58;33;25;2018
19;Guadalajara;067;Cardoso de la Sierra, El;64;40;24;2018
19;Guadalajara;070;Casa de Uceda;93;51;42;2018
19;Guadalajara;071;Casar, El;11812;6009;5803;2018
19;Guadalajara;073;Casas de San Galindo;18;15;3;2018
19;Guadalajara;074;Caspueñas;83;49;34;2018
19;Guadalajara;075;Castejón de Henares;63;39;24;2018
19;Guadalajara;076;Castellar de la Muela;26;14;12;2018
19;Guadalajara;078;Castilforte;56;36;20;2018
19;Guadalajara;079;Castilnuevo;9;5;4;2018
19;Guadalajara;080;Cendejas de Enmedio;71;39;32;2018
19;Guadalajara;081;Cendejas de la Torre;24;15;9;2018
19;Guadalajara;082;Centenera;107;57;50;2018
19;Guadalajara;103;Checa;273;163;110;2018
19;Guadalajara;104;Chequilla;17;9;8;2018
19;Guadalajara;106;Chillarón del Rey;92;53;39;2018
19;Guadalajara;105;Chiloeches;3508;1819;1689;2018
19;Guadalajara;086;Cifuentes;1697;896;801;2018
19;Guadalajara;087;Cincovillas;23;12;11;2018
19;Guadalajara;088;Ciruelas;104;59;45;2018
19;Guadalajara;089;Ciruelos del Pinar;32;20;12;2018
19;Guadalajara;090;Cobeta;115;59;56;2018
19;Guadalajara;091;Cogollor;30;17;13;2018
19;Guadalajara;092;Cogolludo;549;323;226;2018
19;Guadalajara;095;Condemios de Abajo;14;9;5;2018
19;Guadalajara;096;Condemios de Arriba;105;60;45;2018
19;Guadalajara;097;Congostrina;16;12;4;2018
19;Guadalajara;098;Copernal;24;17;7;2018
19;Guadalajara;099;Corduente;345;188;157;2018
19;Guadalajara;102;Cubillo de Uceda, El;118;61;57;2018
19;Guadalajara;107;Driebes;339;182;157;2018
19;Guadalajara;108;Durón;109;58;51;2018
19;Guadalajara;109;Embid;35;20;15;2018
19;Guadalajara;110;Escamilla;60;32;28;2018
19;Guadalajara;111;Escariche;171;105;66;2018
19;Guadalajara;112;Escopete;50;20;30;2018
19;Guadalajara;113;Espinosa de Henares;665;343;322;2018
19;Guadalajara;114;Esplegares;38;26;12;2018
19;Guadalajara;115;Establés;30;17;13;2018
19;Guadalajara;116;Estriégana;13;8;5;2018
19;Guadalajara;117;Fontanar;2364;1232;1132;2018
19;Guadalajara;118;Fuembellida;8;5;3;2018
19;Guadalajara;119;Fuencemillán;88;56;32;2018
19;Guadalajara;120;Fuentelahiguera de Albatages;131;73;58;2018
19;Guadalajara;121;Fuentelencina;284;160;124;2018
19;Guadalajara;122;Fuentelsaz;89;49;40;2018
19;Guadalajara;123;Fuentelviejo;43;24;19;2018
19;Guadalajara;124;Fuentenovilla;526;290;236;2018
19;Guadalajara;125;Gajanejos;49;33;16;2018
19;Guadalajara;126;Galápagos;2416;1292;1124;2018
19;Guadalajara;127;Galve de Sorbe;107;58;49;2018
19;Guadalajara;129;Gascueña de Bornova;29;17;12;2018
19;Guadalajara;130;Guadalajara;84910;40835;44075;2018
19;Guadalajara;132;Henche;100;52;48;2018
19;Guadalajara;133;Heras de Ayuso;272;165;107;2018
19;Guadalajara;134;Herrería;19;12;7;2018
19;Guadalajara;135;Hiendelaencina;118;67;51;2018
19;Guadalajara;136;Hijes;19;10;9;2018
19;Guadalajara;138;Hita;307;169;138;2018
19;Guadalajara;139;Hombrados;29;18;11;2018
19;Guadalajara;142;Hontoba;299;178;121;2018
19;Guadalajara;143;Horche;2538;1288;1250;2018
19;Guadalajara;145;Hortezuela de Océn;43;26;17;2018
19;Guadalajara;146;Huerce, La;44;28;16;2018
19;Guadalajara;147;Huérmeces del Cerro;42;29;13;2018
19;Guadalajara;148;Huertahernando;53;34;19;2018
19;Guadalajara;150;Hueva;130;81;49;2018
19;Guadalajara;151;Humanes;1487;731;756;2018
19;Guadalajara;152;Illana;654;365;289;2018
19;Guadalajara;153;Iniéstola;21;13;8;2018
19;Guadalajara;154;Inviernas, Las;63;42;21;2018
19;Guadalajara;155;Irueste;73;49;24;2018
19;Guadalajara;156;Jadraque;1434;752;682;2018
19;Guadalajara;157;Jirueque;55;39;16;2018
19;Guadalajara;159;Ledanca;99;52;47;2018
19;Guadalajara;160;Loranca de Tajuña;1199;658;541;2018
19;Guadalajara;161;Lupiana;250;130;120;2018
19;Guadalajara;162;Luzaga;72;41;31;2018
19;Guadalajara;163;Luzón;67;34;33;2018
19;Guadalajara;165;Majaelrayo;55;31;24;2018
19;Guadalajara;166;Málaga del Fresno;183;101;82;2018
19;Guadalajara;167;Malaguilla;156;87;69;2018
19;Guadalajara;168;Mandayona;297;149;148;2018
19;Guadalajara;169;Mantiel;37;22;15;2018
19;Guadalajara;170;Maranchón;222;120;102;2018
19;Guadalajara;171;Marchamalo;7229;3626;3603;2018
19;Guadalajara;172;Masegoso de Tajuña;51;29;22;2018
19;Guadalajara;173;Matarrubia;61;38;23;2018
19;Guadalajara;174;Matillas;106;54;52;2018
19;Guadalajara;175;Mazarete;37;17;20;2018
19;Guadalajara;176;Mazuecos;257;136;121;2018
19;Guadalajara;177;Medranda;72;37;35;2018
19;Guadalajara;178;Megina;30;19;11;2018
19;Guadalajara;179;Membrillera;88;51;37;2018
19;Guadalajara;181;Miedes de Atienza;60;37;23;2018
19;Guadalajara;182;Mierla, La;40;26;14;2018
19;Guadalajara;184;Millana;102;63;39;2018
19;Guadalajara;183;Milmarcos;77;47;30;2018
19;Guadalajara;185;Miñosa, La;28;19;9;2018
19;Guadalajara;186;Mirabueno;83;49;34;2018
19;Guadalajara;187;Miralrío;55;32;23;2018
19;Guadalajara;188;Mochales;48;27;21;2018
19;Guadalajara;189;Mohernando;172;91;81;2018
19;Guadalajara;190;Molina de Aragón;3295;1654;1641;2018
19;Guadalajara;191;Monasterio;14;6;8;2018
19;Guadalajara;192;Mondéjar;2637;1356;1281;2018
19;Guadalajara;193;Montarrón;26;15;11;2018
19;Guadalajara;194;Moratilla de los Meleros;100;57;43;2018
19;Guadalajara;195;Morenilla;38;23;15;2018
19;Guadalajara;196;Muduex;102;55;47;2018
19;Guadalajara;197;Navas de Jadraque, Las;28;19;9;2018
19;Guadalajara;198;Negredo;17;9;8;2018
19;Guadalajara;199;Ocentejo;18;13;5;2018
19;Guadalajara;200;Olivar, El;75;43;32;2018
19;Guadalajara;201;Olmeda de Cobeta;64;35;29;2018
19;Guadalajara;202;Olmeda de Jadraque, La;9;5;4;2018
19;Guadalajara;203;Ordial, El;27;16;11;2018
19;Guadalajara;204;Orea;177;109;68;2018
19;Guadalajara;208;Pálmaces de Jadraque;41;25;16;2018
19;Guadalajara;209;Pardos;44;25;19;2018
19;Guadalajara;210;Paredes de Sigüenza;19;10;9;2018
19;Guadalajara;211;Pareja;389;228;161;2018
19;Guadalajara;212;Pastrana;873;439;434;2018
19;Guadalajara;213;Pedregal, El;77;47;30;2018
19;Guadalajara;214;Peñalén;76;44;32;2018
19;Guadalajara;215;Peñalver;152;98;54;2018
19;Guadalajara;216;Peralejos de las Truchas;156;83;73;2018
19;Guadalajara;217;Peralveche;49;34;15;2018
19;Guadalajara;218;Pinilla de Jadraque;52;27;25;2018
19;Guadalajara;219;Pinilla de Molina;11;9;2;2018
19;Guadalajara;220;Pioz;3770;1978;1792;2018
19;Guadalajara;221;Piqueras;56;36;20;2018
19;Guadalajara;222;Pobo de Dueñas, El;111;57;54;2018
19;Guadalajara;223;Poveda de la Sierra;120;62;58;2018
19;Guadalajara;224;Pozo de Almoguera;106;65;41;2018
19;Guadalajara;225;Pozo de Guadalajara;1269;676;593;2018
19;Guadalajara;226;Prádena de Atienza;42;29;13;2018
19;Guadalajara;227;Prados Redondos;61;40;21;2018
19;Guadalajara;228;Puebla de Beleña;36;21;15;2018
19;Guadalajara;229;Puebla de Valles;60;33;27;2018
19;Guadalajara;230;Quer;778;406;372;2018
19;Guadalajara;231;Rebollosa de Jadraque;12;8;4;2018
19;Guadalajara;232;Recuenco, El;60;38;22;2018
19;Guadalajara;233;Renera;92;54;38;2018
19;Guadalajara;234;Retiendas;42;28;14;2018
19;Guadalajara;235;Riba de Saelices;87;50;37;2018
19;Guadalajara;237;Rillo de Gallo;44;25;19;2018
19;Guadalajara;238;Riofrío del Llano;49;29;20;2018
19;Guadalajara;239;Robledillo de Mohernando;106;53;53;2018
19;Guadalajara;240;Robledo de Corpes;45;27;18;2018
19;Guadalajara;241;Romanillos de Atienza;42;25;17;2018
19;Guadalajara;242;Romanones;100;53;47;2018
19;Guadalajara;243;Rueda de la Sierra;40;30;10;2018
19;Guadalajara;244;Sacecorbo;85;47;38;2018
19;Guadalajara;245;Sacedón;1519;792;727;2018
19;Guadalajara;246;Saelices de la Sal;44;23;21;2018
19;Guadalajara;247;Salmerón;155;87;68;2018
19;Guadalajara;248;San Andrés del Congosto;72;46;26;2018
19;Guadalajara;249;San Andrés del Rey;35;19;16;2018
19;Guadalajara;250;Santiuste;18;10;8;2018
19;Guadalajara;251;Saúca;53;31;22;2018
19;Guadalajara;252;Sayatón;81;47;34;2018
19;Guadalajara;254;Selas;47;22;25;2018
19;Guadalajara;901;Semillas;40;23;17;2018
19;Guadalajara;255;Setiles;76;45;31;2018
19;Guadalajara;256;Sienes;53;31;22;2018
19;Guadalajara;257;Sigüenza;4356;2154;2202;2018
19;Guadalajara;258;Solanillos del Extremo;96;56;40;2018
19;Guadalajara;259;Somolinos;35;16;19;2018
19;Guadalajara;260;Sotillo, El;41;22;19;2018
19;Guadalajara;261;Sotodosos;34;18;16;2018
19;Guadalajara;262;Tamajón;123;67;56;2018
19;Guadalajara;263;Taragudo;44;22;22;2018
19;Guadalajara;264;Taravilla;33;21;12;2018
19;Guadalajara;265;Tartanedo;149;88;61;2018
19;Guadalajara;266;Tendilla;304;166;138;2018
19;Guadalajara;267;Terzaga;22;12;10;2018
19;Guadalajara;268;Tierzo;30;20;10;2018
19;Guadalajara;269;Toba, La;96;55;41;2018
19;Guadalajara;271;Tordellego;50;28;22;2018
19;Guadalajara;270;Tordelrábano;13;10;3;2018
19;Guadalajara;272;Tordesilos;96;54;42;2018
19;Guadalajara;274;Torija;1424;741;683;2018
19;Guadalajara;279;Torre del Burgo;502;268;234;2018
19;Guadalajara;277;Torrecuadrada de Molina;19;13;6;2018
19;Guadalajara;278;Torrecuadradilla;25;15;10;2018
19;Guadalajara;280;Torrejón del Rey;5300;2754;2546;2018
19;Guadalajara;281;Torremocha de Jadraque;23;15;8;2018
19;Guadalajara;282;Torremocha del Campo;175;102;73;2018
19;Guadalajara;283;Torremocha del Pinar;40;19;21;2018
19;Guadalajara;284;Torremochuela;11;7;4;2018
19;Guadalajara;285;Torrubia;22;12;10;2018
19;Guadalajara;286;Tórtola de Henares;1012;561;451;2018
19;Guadalajara;287;Tortuera;206;115;91;2018
19;Guadalajara;288;Tortuero;18;12;6;2018
19;Guadalajara;289;Traíd;27;19;8;2018
19;Guadalajara;290;Trijueque;1172;626;546;2018
19;Guadalajara;291;Trillo;1319;693;626;2018
19;Guadalajara;293;Uceda;2573;1334;1239;2018
19;Guadalajara;294;Ujados;28;16;12;2018
19;Guadalajara;296;Utande;35;24;11;2018
19;Guadalajara;297;Valdarachas;35;18;17;2018
19;Guadalajara;298;Valdearenas;79;52;27;2018
19;Guadalajara;299;Valdeavellano;108;57;51;2018
19;Guadalajara;300;Valdeaveruelo;1062;556;506;2018
19;Guadalajara;301;Valdeconcha;40;24;16;2018
19;Guadalajara;302;Valdegrudas;57;35;22;2018
19;Guadalajara;303;Valdelcubo;49;35;14;2018
19;Guadalajara;304;Valdenuño Fernández;253;140;113;2018
19;Guadalajara;305;Valdepeñas de la Sierra;168;99;69;2018
19;Guadalajara;306;Valderrebollo;22;12;10;2018
19;Guadalajara;307;Valdesotos;25;16;9;2018
19;Guadalajara;308;Valfermoso de Tajuña;59;41;18;2018
19;Guadalajara;309;Valhermoso;25;12;13;2018
19;Guadalajara;310;Valtablado del Río;8;5;3;2018
19;Guadalajara;311;Valverde de los Arroyos;82;44;38;2018
19;Guadalajara;314;Viana de Jadraque;48;32;16;2018
19;Guadalajara;317;Villanueva de Alcorón;162;89;73;2018
19;Guadalajara;318;Villanueva de Argecilla;29;19;10;2018
19;Guadalajara;319;Villanueva de la Torre;6568;3298;3270;2018
19;Guadalajara;321;Villares de Jadraque;47;30;17;2018
19;Guadalajara;322;Villaseca de Henares;27;13;14;2018
19;Guadalajara;323;Villaseca de Uceda;36;21;15;2018
19;Guadalajara;324;Villel de Mesa;185;103;82;2018
19;Guadalajara;325;Viñuelas;137;70;67;2018
19;Guadalajara;326;Yebes;3518;1836;1682;2018
19;Guadalajara;327;Yebra;444;236;208;2018
19;Guadalajara;329;Yélamos de Abajo;63;33;30;2018
19;Guadalajara;330;Yélamos de Arriba;77;46;31;2018
19;Guadalajara;331;Yunquera de Henares;3937;1995;1942;2018
19;Guadalajara;332;Yunta, La;86;50;36;2018
19;Guadalajara;333;Zaorejas;125;82;43;2018
19;Guadalajara;334;Zarzuela de Jadraque;37;21;16;2018
19;Guadalajara;335;Zorita de los Canes;70;36;34;2018
21;Huelva;001;Alájar;763;385;378;2018
21;Huelva;002;Aljaraque;21054;10466;10588;2018
21;Huelva;003;Almendro, El;837;439;398;2018
21;Huelva;004;Almonaster la Real;1837;984;853;2018
21;Huelva;005;Almonte;24013;11642;12371;2018
21;Huelva;006;Alosno;3942;1926;2016;2018
21;Huelva;007;Aracena;8040;3959;4081;2018
21;Huelva;008;Aroche;3109;1553;1556;2018
21;Huelva;009;Arroyomolinos de León;965;502;463;2018
21;Huelva;010;Ayamonte;20883;10483;10400;2018
21;Huelva;011;Beas;4236;2135;2101;2018
21;Huelva;012;Berrocal;319;160;159;2018
21;Huelva;013;Bollullos Par del Condado;14114;7016;7098;2018
21;Huelva;014;Bonares;6060;3017;3043;2018
21;Huelva;015;Cabezas Rubias;741;387;354;2018
21;Huelva;016;Cala;1184;600;584;2018
21;Huelva;017;Calañas;4077;2068;2009;2018
21;Huelva;018;Campillo, El;2036;986;1050;2018
21;Huelva;019;Campofrío;702;356;346;2018
21;Huelva;020;Cañaveral de León;411;209;202;2018
21;Huelva;021;Cartaya;19433;9974;9459;2018
21;Huelva;022;Castaño del Robledo;209;118;91;2018
21;Huelva;023;Cerro de Andévalo, El;2389;1187;1202;2018
21;Huelva;030;Chucena;2232;1136;1096;2018
21;Huelva;024;Corteconcepción;543;274;269;2018
21;Huelva;025;Cortegana;4735;2406;2329;2018
21;Huelva;026;Cortelazor;305;147;158;2018
21;Huelva;027;Cumbres de Enmedio;57;34;23;2018
21;Huelva;028;Cumbres de San Bartolomé;373;186;187;2018
21;Huelva;029;Cumbres Mayores;1785;882;903;2018
21;Huelva;031;Encinasola;1332;669;663;2018
21;Huelva;032;Escacena del Campo;2278;1109;1169;2018
21;Huelva;033;Fuenteheridos;623;314;309;2018
21;Huelva;034;Galaroza;1401;685;716;2018
21;Huelva;035;Gibraleón;12548;6259;6289;2018
21;Huelva;036;Granada de Río-Tinto, La;235;123;112;2018
21;Huelva;037;Granado, El;519;277;242;2018
21;Huelva;038;Higuera de la Sierra;1293;666;627;2018
21;Huelva;039;Hinojales;307;151;156;2018
21;Huelva;040;Hinojos;3909;1962;1947;2018
21;Huelva;041;Huelva;144258;69336;74922;2018
21;Huelva;042;Isla Cristina;21077;10540;10537;2018
21;Huelva;043;Jabugo;2258;1136;1122;2018
21;Huelva;044;Lepe;27047;13951;13096;2018
21;Huelva;045;Linares de la Sierra;262;129;133;2018
21;Huelva;046;Lucena del Puerto;3395;1778;1617;2018
21;Huelva;047;Manzanilla;2079;1056;1023;2018
21;Huelva;048;Marines, Los;402;215;187;2018
21;Huelva;049;Minas de Riotinto;3866;1870;1996;2018
21;Huelva;050;Moguer;21699;10862;10837;2018
21;Huelva;051;Nava, La;253;132;121;2018
21;Huelva;052;Nerva;5303;2555;2748;2018
21;Huelva;053;Niebla;4103;2071;2032;2018
21;Huelva;054;Palma del Condado, La;10762;5357;5405;2018
21;Huelva;055;Palos de la Frontera;11112;5613;5499;2018
21;Huelva;056;Paterna del Campo;3484;1760;1724;2018
21;Huelva;057;Paymogo;1167;590;577;2018
21;Huelva;058;Puebla de Guzmán;3142;1612;1530;2018
21;Huelva;059;Puerto Moral;281;138;143;2018
21;Huelva;060;Punta Umbría;15134;7715;7419;2018
21;Huelva;061;Rociana del Condado;7751;3927;3824;2018
21;Huelva;062;Rosal de la Frontera;1707;849;858;2018
21;Huelva;063;San Bartolomé de la Torre;3679;1828;1851;2018
21;Huelva;064;San Juan del Puerto;9198;4635;4563;2018
21;Huelva;066;San Silvestre de Guzmán;607;316;291;2018
21;Huelva;065;Sanlúcar de Guadiana;396;196;200;2018
21;Huelva;067;Santa Ana la Real;480;229;251;2018
21;Huelva;068;Santa Bárbara de Casa;1054;519;535;2018
21;Huelva;069;Santa Olalla del Cala;2004;1039;965;2018
21;Huelva;070;Trigueros;7782;3868;3914;2018
21;Huelva;071;Valdelarco;243;112;131;2018
21;Huelva;072;Valverde del Camino;12780;6285;6495;2018
21;Huelva;073;Villablanca;2839;1398;1441;2018
21;Huelva;074;Villalba del Alcor;3283;1623;1660;2018
21;Huelva;075;Villanueva de las Cruces;382;180;202;2018
21;Huelva;076;Villanueva de los Castillejos;2761;1383;1378;2018
21;Huelva;077;Villarrasa;2152;1083;1069;2018
21;Huelva;078;Zalamea la Real;3090;1563;1527;2018
21;Huelva;079;Zufre;831;432;399;2018
22;Huesca;001;Abiego;237;124;113;2018
22;Huesca;002;Abizanda;151;76;75;2018
22;Huesca;003;Adahuesca;172;91;81;2018
22;Huesca;004;Agüero;130;78;52;2018
22;Huesca;907;Aínsa-Sobrarbe;2151;1084;1067;2018
22;Huesca;006;Aisa;321;174;147;2018
22;Huesca;007;Albalate de Cinca;1102;586;516;2018
22;Huesca;008;Albalatillo;181;102;79;2018
22;Huesca;009;Albelda;721;376;345;2018
22;Huesca;011;Albero Alto;105;63;42;2018
22;Huesca;012;Albero Bajo;141;76;65;2018
22;Huesca;013;Alberuela de Tubo;309;158;151;2018
22;Huesca;014;Alcalá de Gurrea;246;130;116;2018
22;Huesca;015;Alcalá del Obispo;325;179;146;2018
22;Huesca;016;Alcampell;652;320;332;2018
22;Huesca;017;Alcolea de Cinca;1160;614;546;2018
22;Huesca;018;Alcubierre;363;194;169;2018
22;Huesca;019;Alerre;201;101;100;2018
22;Huesca;020;Alfántega;127;66;61;2018
22;Huesca;021;Almudévar;2394;1228;1166;2018
22;Huesca;022;Almunia de San Juan;654;338;316;2018
22;Huesca;023;Almuniente;471;236;235;2018
22;Huesca;024;Alquézar;296;158;138;2018
22;Huesca;025;Altorricón;1409;743;666;2018
22;Huesca;027;Angüés;367;196;171;2018
22;Huesca;028;Ansó;431;217;214;2018
22;Huesca;029;Antillón;149;75;74;2018
22;Huesca;032;Aragüés del Puerto;116;64;52;2018
22;Huesca;035;Arén;318;173;145;2018
22;Huesca;036;Argavieso;96;56;40;2018
22;Huesca;037;Arguis;129;70;59;2018
22;Huesca;039;Ayerbe;1041;516;525;2018
22;Huesca;040;Azanuy-Alins;176;83;93;2018
22;Huesca;041;Azara;174;85;89;2018
22;Huesca;042;Azlor;153;70;83;2018
22;Huesca;043;Baélls;104;59;45;2018
22;Huesca;044;Bailo;279;166;113;2018
22;Huesca;045;Baldellou;77;44;33;2018
22;Huesca;046;Ballobar;823;424;399;2018
22;Huesca;047;Banastás;292;153;139;2018
22;Huesca;048;Barbastro;16944;8236;8708;2018
22;Huesca;049;Barbués;77;44;33;2018
22;Huesca;050;Barbuñales;95;49;46;2018
22;Huesca;051;Bárcabo;105;59;46;2018
22;Huesca;052;Belver de Cinca;1292;733;559;2018
22;Huesca;053;Benabarre;1107;569;538;2018
22;Huesca;054;Benasque;2157;1150;1007;2018
22;Huesca;246;Beranuy;78;46;32;2018
22;Huesca;055;Berbegal;345;177;168;2018
22;Huesca;057;Bielsa;476;254;222;2018
22;Huesca;058;Bierge;231;130;101;2018
22;Huesca;059;Biescas;1479;776;703;2018
22;Huesca;060;Binaced;1555;828;727;2018
22;Huesca;061;Binéfar;9435;4935;4500;2018
22;Huesca;062;Bisaurri;181;98;83;2018
22;Huesca;063;Biscarrués;189;102;87;2018
22;Huesca;064;Blecua y Torres;183;104;79;2018
22;Huesca;066;Boltaña;986;534;452;2018
22;Huesca;067;Bonansa;86;50;36;2018
22;Huesca;068;Borau;80;48;32;2018
22;Huesca;069;Broto;531;301;230;2018
22;Huesca;072;Caldearenas;218;129;89;2018
22;Huesca;074;Campo;323;171;152;2018
22;Huesca;075;Camporrélls;137;72;65;2018
22;Huesca;076;Canal de Berdún;321;178;143;2018
22;Huesca;077;Candasnos;317;168;149;2018
22;Huesca;078;Canfranc;532;294;238;2018
22;Huesca;079;Capdesaso;174;77;97;2018
22;Huesca;080;Capella;354;186;168;2018
22;Huesca;081;Casbas de Huesca;269;145;124;2018
22;Huesca;083;Castejón de Monegros;531;284;247;2018
22;Huesca;084;Castejón de Sos;753;387;366;2018
22;Huesca;082;Castejón del Puente;315;164;151;2018
22;Huesca;085;Castelflorite;108;58;50;2018
22;Huesca;086;Castiello de Jaca;267;140;127;2018
22;Huesca;087;Castigaleu;86;51;35;2018
22;Huesca;088;Castillazuelo;169;85;84;2018
22;Huesca;089;Castillonroy;312;167;145;2018
22;Huesca;094;Chalamera;108;55;53;2018
22;Huesca;095;Chía;86;54;32;2018
22;Huesca;096;Chimillas;391;200;191;2018
22;Huesca;090;Colungo;114;64;50;2018
22;Huesca;099;Esplús;541;266;275;2018
22;Huesca;102;Estada;204;117;87;2018
22;Huesca;103;Estadilla;794;383;411;2018
22;Huesca;105;Estopiñán del Castillo;126;69;57;2018
22;Huesca;106;Fago;23;12;11;2018
22;Huesca;107;Fanlo;97;61;36;2018
22;Huesca;109;Fiscal;327;182;145;2018
22;Huesca;110;Fonz;870;432;438;2018
22;Huesca;111;Foradada del Toscar;173;92;81;2018
22;Huesca;112;Fraga;14979;7594;7385;2018
22;Huesca;113;Fueva, La;597;314;283;2018
22;Huesca;114;Gistaín;149;81;68;2018
22;Huesca;115;Grado, El;426;228;198;2018
22;Huesca;116;Grañén;1753;907;846;2018
22;Huesca;117;Graus;3305;1617;1688;2018
22;Huesca;119;Gurrea de Gállego;1476;755;721;2018
22;Huesca;122;Hoz de Jaca;76;37;39;2018
22;Huesca;908;Hoz y Costean;226;131;95;2018
22;Huesca;124;Huerto;218;118;100;2018
22;Huesca;125;Huesca;52463;25023;27440;2018
22;Huesca;126;Ibieca;97;55;42;2018
22;Huesca;127;Igriés;705;366;339;2018
22;Huesca;128;Ilche;212;110;102;2018
22;Huesca;129;Isábena;238;126;112;2018
22;Huesca;130;Jaca;12813;6302;6511;2018
22;Huesca;131;Jasa;92;53;39;2018
22;Huesca;133;Labuerda;162;91;71;2018
22;Huesca;135;Laluenga;194;103;91;2018
22;Huesca;136;Lalueza;913;475;438;2018
22;Huesca;137;Lanaja;1202;637;565;2018
22;Huesca;139;Laperdiguera;91;48;43;2018
22;Huesca;141;Lascellas-Ponzano;126;80;46;2018
22;Huesca;142;Lascuarre;136;70;66;2018
22;Huesca;143;Laspaúles;230;134;96;2018
22;Huesca;144;Laspuña;291;160;131;2018
22;Huesca;149;Loarre;331;184;147;2018
22;Huesca;150;Loporzano;522;296;226;2018
22;Huesca;151;Loscorrales;106;52;54;2018
22;Huesca;905;Lupiñén-Ortilla;341;171;170;2018
22;Huesca;155;Monesma y Cajigar;73;39;34;2018
22;Huesca;156;Monflorite-Lascasas;403;220;183;2018
22;Huesca;157;Montanuy;215;121;94;2018
22;Huesca;158;Monzón;17061;8614;8447;2018
22;Huesca;160;Naval;269;141;128;2018
22;Huesca;162;Novales;155;75;80;2018
22;Huesca;163;Nueno;532;292;240;2018
22;Huesca;164;Olvena;50;24;26;2018
22;Huesca;165;Ontiñena;533;269;264;2018
22;Huesca;167;Osso de Cinca;687;377;310;2018
22;Huesca;168;Palo;27;14;13;2018
22;Huesca;170;Panticosa;786;404;382;2018
22;Huesca;172;Peñalba;622;315;307;2018
22;Huesca;173;Peñas de Riglos, Las;251;158;93;2018
22;Huesca;174;Peralta de Alcofea;562;295;267;2018
22;Huesca;175;Peralta de Calasanz;219;125;94;2018
22;Huesca;176;Peraltilla;199;99;100;2018
22;Huesca;177;Perarrúa;109;58;51;2018
22;Huesca;178;Pertusa;110;63;47;2018
22;Huesca;181;Piracés;98;54;44;2018
22;Huesca;182;Plan;287;145;142;2018
22;Huesca;184;Poleñino;200;108;92;2018
22;Huesca;186;Pozán de Vero;218;104;114;2018
22;Huesca;187;Puebla de Castro, La;372;185;187;2018
22;Huesca;188;Puente de Montañana;93;40;53;2018
22;Huesca;902;Puente la Reina de Jaca;260;130;130;2018
22;Huesca;189;Puértolas;215;121;94;2018
22;Huesca;190;Pueyo de Araguás, El;154;89;65;2018
22;Huesca;193;Pueyo de Santa Cruz;314;158;156;2018
22;Huesca;195;Quicena;283;138;145;2018
22;Huesca;197;Robres;541;274;267;2018
22;Huesca;199;Sabiñánigo;9245;4621;4624;2018
22;Huesca;200;Sahún;294;153;141;2018
22;Huesca;201;Salas Altas;308;159;149;2018
22;Huesca;202;Salas Bajas;167;81;86;2018
22;Huesca;203;Salillas;96;54;42;2018
22;Huesca;204;Sallent de Gállego;1463;728;735;2018
22;Huesca;205;San Esteban de Litera;506;257;249;2018
22;Huesca;207;San Juan de Plan;152;86;66;2018
22;Huesca;903;San Miguel del Cinca;813;419;394;2018
22;Huesca;206;Sangarrén;219;118;101;2018
22;Huesca;208;Santa Cilia;231;124;107;2018
22;Huesca;209;Santa Cruz de la Serós;180;109;71;2018
22;Huesca;906;Santa María de Dulcis;208;112;96;2018
22;Huesca;212;Santaliestra y San Quílez;81;43;38;2018
22;Huesca;213;Sariñena;4168;2167;2001;2018
22;Huesca;214;Secastilla;146;67;79;2018
22;Huesca;215;Seira;150;83;67;2018
22;Huesca;217;Sena;489;261;228;2018
22;Huesca;218;Senés de Alcubierre;41;20;21;2018
22;Huesca;220;Sesa;167;94;73;2018
22;Huesca;221;Sesué;127;68;59;2018
22;Huesca;222;Siétamo;664;366;298;2018
22;Huesca;223;Sopeira;94;50;44;2018
22;Huesca;904;Sotonera, La;894;472;422;2018
22;Huesca;225;Tamarite de Litera;3528;1819;1709;2018
22;Huesca;226;Tardienta;952;474;478;2018
22;Huesca;227;Tella-Sin;226;126;100;2018
22;Huesca;228;Tierz;758;378;380;2018
22;Huesca;229;Tolva;123;67;56;2018
22;Huesca;230;Torla-Ordesa;298;155;143;2018
22;Huesca;232;Torralba de Aragón;103;57;46;2018
22;Huesca;233;Torre la Ribera;102;54;48;2018
22;Huesca;234;Torrente de Cinca;1148;577;571;2018
22;Huesca;235;Torres de Alcanadre;92;56;36;2018
22;Huesca;236;Torres de Barbués;266;134;132;2018
22;Huesca;239;Tramaced;99;62;37;2018
22;Huesca;242;Valfarta;69;43;26;2018
22;Huesca;243;Valle de Bardají;34;20;14;2018
22;Huesca;901;Valle de Hecho;839;442;397;2018
22;Huesca;244;Valle de Lierp;46;23;23;2018
22;Huesca;245;Velilla de Cinca;463;244;219;2018
22;Huesca;909;Vencillón;399;210;189;2018
22;Huesca;247;Viacamp y Litera;36;24;12;2018
22;Huesca;248;Vicién;116;68;48;2018
22;Huesca;249;Villanova;159;79;80;2018
22;Huesca;250;Villanúa;447;237;210;2018
22;Huesca;251;Villanueva de Sigena;394;199;195;2018
22;Huesca;252;Yebra de Basa;147;85;62;2018
22;Huesca;253;Yésero;60;36;24;2018
22;Huesca;254;Zaidín;1774;939;835;2018
23;Jaén;001;Albanchez de Mágina;1027;536;491;2018
23;Jaén;002;Alcalá la Real;21708;10678;11030;2018
23;Jaén;003;Alcaudete;10558;5193;5365;2018
23;Jaén;004;Aldeaquemada;501;270;231;2018
23;Jaén;005;Andújar;37113;18179;18934;2018
23;Jaén;006;Arjona;5595;2756;2839;2018
23;Jaén;007;Arjonilla;3610;1820;1790;2018
23;Jaén;008;Arquillos;1767;884;883;2018
23;Jaén;905;Arroyo del Ojanco;2323;1182;1141;2018
23;Jaén;009;Baeza;15902;7898;8004;2018
23;Jaén;010;Bailén;17820;8842;8978;2018
23;Jaén;011;Baños de la Encina;2611;1343;1268;2018
23;Jaén;012;Beas de Segura;5191;2700;2491;2018
23;Jaén;902;Bedmar y Garcíez;2682;1342;1340;2018
23;Jaén;014;Begíjar;3075;1550;1525;2018
23;Jaén;015;Bélmez de la Moraleda;1567;789;778;2018
23;Jaén;016;Benatae;457;238;219;2018
23;Jaén;017;Cabra del Santo Cristo;1840;965;875;2018
23;Jaén;018;Cambil;2739;1427;1312;2018
23;Jaén;019;Campillo de Arenas;1784;919;865;2018
23;Jaén;020;Canena;1882;963;919;2018
23;Jaén;021;Carboneros;606;313;293;2018
23;Jaén;901;Cárcheles;1373;717;656;2018
23;Jaén;024;Carolina, La;15306;7569;7737;2018
23;Jaén;025;Castellar;3364;1697;1667;2018
23;Jaén;026;Castillo de Locubín;4120;2038;2082;2018
23;Jaén;027;Cazalilla;829;410;419;2018
23;Jaén;028;Cazorla;7574;3690;3884;2018
23;Jaén;029;Chiclana de Segura;962;491;471;2018
23;Jaén;030;Chilluévar;1459;704;755;2018
23;Jaén;031;Escañuela;949;472;477;2018
23;Jaén;032;Espeluy;643;317;326;2018
23;Jaén;033;Frailes;1592;799;793;2018
23;Jaén;034;Fuensanta de Martos;3086;1531;1555;2018
23;Jaén;035;Fuerte del Rey;1387;715;672;2018
23;Jaén;037;Génave;614;332;282;2018
23;Jaén;038;Guardia de Jaén, La;4965;2527;2438;2018
23;Jaén;039;Guarromán;2779;1395;1384;2018
23;Jaén;041;Higuera de Calatrava;616;329;287;2018
23;Jaén;042;Hinojares;335;175;160;2018
23;Jaén;043;Hornos;620;312;308;2018
23;Jaén;044;Huelma;5845;2905;2940;2018
23;Jaén;045;Huesa;2527;1270;1257;2018
23;Jaén;046;Ibros;2884;1448;1436;2018
23;Jaén;047;Iruela, La;1935;964;971;2018
23;Jaén;048;Iznatoraf;995;514;481;2018
23;Jaén;049;Jabalquinto;2070;1042;1028;2018
23;Jaén;050;Jaén;113457;54533;58924;2018
23;Jaén;051;Jamilena;3327;1684;1643;2018
23;Jaén;052;Jimena;1286;622;664;2018
23;Jaén;053;Jódar;11805;5877;5928;2018
23;Jaén;040;Lahiguera;1742;852;890;2018
23;Jaén;054;Larva;482;244;238;2018
23;Jaén;055;Linares;57811;28279;29532;2018
23;Jaén;056;Lopera;3673;1849;1824;2018
23;Jaén;057;Lupión;852;415;437;2018
23;Jaén;058;Mancha Real;11322;5627;5695;2018
23;Jaén;059;Marmolejo;6877;3429;3448;2018
23;Jaén;060;Martos;24207;12006;12201;2018
23;Jaén;061;Mengíbar;9927;4941;4986;2018
23;Jaén;062;Montizón;1716;882;834;2018
23;Jaén;063;Navas de San Juan;4555;2280;2275;2018
23;Jaén;064;Noalejo;1948;983;965;2018
23;Jaén;065;Orcera;1835;928;907;2018
23;Jaén;066;Peal de Becerro;5277;2607;2670;2018
23;Jaén;067;Pegalajar;2916;1464;1452;2018
23;Jaén;069;Porcuna;6283;3171;3112;2018
23;Jaén;070;Pozo Alcón;4708;2391;2317;2018
23;Jaén;071;Puente de Génave;2179;1091;1088;2018
23;Jaén;072;Puerta de Segura, La;2339;1163;1176;2018
23;Jaén;073;Quesada;5303;2689;2614;2018
23;Jaén;074;Rus;3580;1828;1752;2018
23;Jaén;075;Sabiote;3958;1953;2005;2018
23;Jaén;076;Santa Elena;913;483;430;2018
23;Jaén;077;Santiago de Calatrava;697;367;330;2018
23;Jaén;904;Santiago-Pontones;3060;1573;1487;2018
23;Jaén;079;Santisteban del Puerto;4520;2324;2196;2018
23;Jaén;080;Santo Tomé;2154;1079;1075;2018
23;Jaén;081;Segura de la Sierra;1782;876;906;2018
23;Jaén;082;Siles;2262;1134;1128;2018
23;Jaén;084;Sorihuela del Guadalimar;1124;583;541;2018
23;Jaén;085;Torreblascopedro;2564;1297;1267;2018
23;Jaén;086;Torredelcampo;14335;7168;7167;2018
23;Jaén;087;Torredonjimeno;13731;6747;6984;2018
23;Jaén;088;Torreperogil;7286;3554;3732;2018
23;Jaén;090;Torres;1434;720;714;2018
23;Jaén;091;Torres de Albánchez;804;417;387;2018
23;Jaén;092;Úbeda;34602;16960;17642;2018
23;Jaén;093;Valdepeñas de Jaén;3799;1875;1924;2018
23;Jaén;094;Vilches;4519;2274;2245;2018
23;Jaén;095;Villacarrillo;10795;5417;5378;2018
23;Jaén;096;Villanueva de la Reina;3146;1582;1564;2018
23;Jaén;097;Villanueva del Arzobispo;8301;4264;4037;2018
23;Jaén;098;Villardompardo;966;490;476;2018
23;Jaén;099;Villares, Los;5980;2991;2989;2018
23;Jaén;101;Villarrodrigo;416;221;195;2018
23;Jaén;903;Villatorres;4357;2215;2142;2018
24;León;001;Acebedo;202;117;85;2018
24;León;002;Algadefe;286;145;141;2018
24;León;003;Alija del Infantado;671;338;333;2018
24;León;004;Almanza;558;321;237;2018
24;León;005;Antigua, La;377;220;157;2018
24;León;006;Ardón;533;292;241;2018
24;León;007;Arganza;802;403;399;2018
24;León;008;Astorga;11029;5204;5825;2018
24;León;009;Balboa;308;166;142;2018
24;León;010;Bañeza, La;10307;4976;5331;2018
24;León;011;Barjas;194;108;86;2018
24;León;012;Barrios de Luna, Los;313;178;135;2018
24;León;014;Bembibre;8979;4372;4607;2018
24;León;015;Benavides;2497;1228;1269;2018
24;León;016;Benuza;489;279;210;2018
24;León;017;Bercianos del Páramo;580;297;283;2018
24;León;018;Bercianos del Real Camino;193;97;96;2018
24;León;019;Berlanga del Bierzo;360;169;191;2018
24;León;020;Boca de Huérgano;475;281;194;2018
24;León;021;Boñar;1850;942;908;2018
24;León;022;Borrenes;319;169;150;2018
24;León;023;Brazuelo;287;154;133;2018
24;León;024;Burgo Ranero, El;733;388;345;2018
24;León;025;Burón;304;177;127;2018
24;León;026;Bustillo del Páramo;1184;610;574;2018
24;León;027;Cabañas Raras;1330;688;642;2018
24;León;028;Cabreros del Río;412;226;186;2018
24;León;029;Cabrillanes;775;404;371;2018
24;León;030;Cacabelos;5132;2551;2581;2018
24;León;031;Calzada del Coto;231;134;97;2018
24;León;032;Campazas;123;55;68;2018
24;León;033;Campo de Villavidel;203;112;91;2018
24;León;034;Camponaraya;4062;2018;2044;2018
24;León;036;Candín;273;149;124;2018
24;León;037;Cármenes;357;197;160;2018
24;León;038;Carracedelo;3472;1728;1744;2018
24;León;039;Carrizo;2269;1146;1123;2018
24;León;040;Carrocera;465;250;215;2018
24;León;041;Carucedo;557;283;274;2018
24;León;042;Castilfalé;65;38;27;2018
24;León;043;Castrillo de Cabrera;122;71;51;2018
24;León;044;Castrillo de la Valduerna;164;72;92;2018
24;León;046;Castrocalbón;979;504;475;2018
24;León;047;Castrocontrigo;794;423;371;2018
24;León;049;Castropodame;1658;851;807;2018
24;León;050;Castrotierra de Valmadrigal;113;59;54;2018
24;León;051;Cea;426;221;205;2018
24;León;052;Cebanico;153;94;59;2018
24;León;053;Cebrones del Río;461;251;210;2018
24;León;065;Chozas de Abajo;2564;1344;1220;2018
24;León;054;Cimanes de la Vega;472;244;228;2018
24;León;055;Cimanes del Tejar;740;396;344;2018
24;León;056;Cistierna;3150;1555;1595;2018
24;León;057;Congosto;1533;767;766;2018
24;León;058;Corbillos de los Oteros;209;119;90;2018
24;León;059;Corullón;914;468;446;2018
24;León;060;Crémenes;544;290;254;2018
24;León;061;Cuadros;2018;1027;991;2018
24;León;062;Cubillas de los Oteros;147;84;63;2018
24;León;063;Cubillas de Rueda;404;214;190;2018
24;León;064;Cubillos del Sil;1839;973;866;2018
24;León;066;Destriana;495;235;260;2018
24;León;067;Encinedo;686;358;328;2018
24;León;068;Ercina, La;462;241;221;2018
24;León;069;Escobar de Campos;42;24;18;2018
24;León;070;Fabero;4551;2230;2321;2018
24;León;071;Folgoso de la Ribera;1108;539;569;2018
24;León;073;Fresno de la Vega;500;258;242;2018
24;León;074;Fuentes de Carbajal;95;49;46;2018
24;León;076;Garrafe de Torío;1475;807;668;2018
24;León;077;Gordaliza del Pino;244;119;125;2018
24;León;078;Gordoncillo;406;206;200;2018
24;León;079;Gradefes;944;514;430;2018
24;León;080;Grajal de Campos;223;108;115;2018
24;León;081;Gusendos de los Oteros;128;66;62;2018
24;León;082;Hospital de Órbigo;987;497;490;2018
24;León;083;Igüeña;1142;593;549;2018
24;León;084;Izagre;174;86;88;2018
24;León;086;Joarilla de las Matas;298;159;139;2018
24;León;087;Laguna Dalga;666;356;310;2018
24;León;088;Laguna de Negrillos;1066;549;517;2018
24;León;089;León;124772;56536;68236;2018
24;León;092;Llamas de la Ribera;831;432;399;2018
24;León;090;Lucillo;383;201;182;2018
24;León;091;Luyego;645;341;304;2018
24;León;093;Magaz de Cepeda;362;187;175;2018
24;León;094;Mansilla de las Mulas;1743;875;868;2018
24;León;095;Mansilla Mayor;333;179;154;2018
24;León;096;Maraña;118;70;48;2018
24;León;097;Matadeón de los Oteros;232;123;109;2018
24;León;098;Matallana de Torío;1306;687;619;2018
24;León;099;Matanza;175;92;83;2018
24;León;100;Molinaseca;872;480;392;2018
24;León;101;Murias de Paredes;395;196;199;2018
24;León;102;Noceda del Bierzo;680;344;336;2018
24;León;103;Oencia;278;164;114;2018
24;León;104;Omañas, Las;271;147;124;2018
24;León;105;Onzonilla;1835;945;890;2018
24;León;106;Oseja de Sajambre;240;138;102;2018
24;León;107;Pajares de los Oteros;279;169;110;2018
24;León;108;Palacios de la Valduerna;382;185;197;2018
24;León;109;Palacios del Sil;989;526;463;2018
24;León;110;Páramo del Sil;1293;662;631;2018
24;León;112;Peranzanes;317;185;132;2018
24;León;113;Pobladura de Pelayo García;382;197;185;2018
24;León;114;Pola de Gordón, La;3325;1689;1636;2018
24;León;115;Ponferrada;65239;31021;34218;2018
24;León;116;Posada de Valdeón;433;253;180;2018
24;León;117;Pozuelo del Páramo;439;221;218;2018
24;León;118;Prado de la Guzpeña;122;68;54;2018
24;León;119;Priaranza del Bierzo;793;404;389;2018
24;León;120;Prioro;355;205;150;2018
24;León;121;Puebla de Lillo;671;379;292;2018
24;León;122;Puente de Domingo Flórez;1511;789;722;2018
24;León;123;Quintana del Castillo;748;415;333;2018
24;León;124;Quintana del Marco;381;208;173;2018
24;León;125;Quintana y Congosto;354;178;176;2018
24;León;127;Regueras de Arriba;293;159;134;2018
24;León;129;Reyero;123;67;56;2018
24;León;130;Riaño;474;277;197;2018
24;León;131;Riego de la Vega;772;410;362;2018
24;León;132;Riello;622;352;270;2018
24;León;133;Rioseco de Tapia;379;209;170;2018
24;León;134;Robla, La;3884;1935;1949;2018
24;León;136;Roperuelos del Páramo;550;278;272;2018
24;León;137;Sabero;1161;589;572;2018
24;León;139;Sahagún;2517;1237;1280;2018
24;León;141;San Adrián del Valle;106;59;47;2018
24;León;142;San Andrés del Rabanedo;30820;14748;16072;2018
24;León;144;San Cristóbal de la Polantera;716;365;351;2018
24;León;145;San Emiliano;665;362;303;2018
24;León;146;San Esteban de Nogales;261;134;127;2018
24;León;148;San Justo de la Vega;1875;964;911;2018
24;León;149;San Millán de los Caballeros;168;88;80;2018
24;León;150;San Pedro Bercianos;237;128;109;2018
24;León;143;Sancedo;561;278;283;2018
24;León;151;Santa Colomba de Curueño;490;261;229;2018
24;León;152;Santa Colomba de Somoza;504;273;231;2018
24;León;153;Santa Cristina de Valmadrigal;273;142;131;2018
24;León;154;Santa Elena de Jamuz;1092;568;524;2018
24;León;155;Santa María de la Isla;492;257;235;2018
24;León;158;Santa María de Ordás;326;170;156;2018
24;León;156;Santa María del Monte de Cea;233;129;104;2018
24;León;157;Santa María del Páramo;3096;1521;1575;2018
24;León;159;Santa Marina del Rey;1939;967;972;2018
24;León;160;Santas Martas;757;401;356;2018
24;León;161;Santiago Millas;334;186;148;2018
24;León;162;Santovenia de la Valdoncina;2108;1068;1040;2018
24;León;163;Sariegos;5040;2511;2529;2018
24;León;164;Sena de Luna;385;191;194;2018
24;León;165;Sobrado;324;162;162;2018
24;León;166;Soto de la Vega;1557;813;744;2018
24;León;167;Soto y Amío;801;414;387;2018
24;León;168;Toral de los Guzmanes;508;276;232;2018
24;León;206;Toral de los Vados;1887;928;959;2018
24;León;169;Toreno;3157;1569;1588;2018
24;León;170;Torre del Bierzo;2162;1102;1060;2018
24;León;171;Trabadelo;353;199;154;2018
24;León;172;Truchas;413;213;200;2018
24;León;173;Turcia;1005;510;495;2018
24;León;174;Urdiales del Páramo;503;267;236;2018
24;León;185;Val de San Lorenzo;515;256;259;2018
24;León;175;Valdefresno;2177;1117;1060;2018
24;León;176;Valdefuentes del Páramo;335;176;159;2018
24;León;177;Valdelugueros;509;289;220;2018
24;León;178;Valdemora;73;33;40;2018
24;León;179;Valdepiélago;337;196;141;2018
24;León;180;Valdepolo;1224;652;572;2018
24;León;181;Valderas;1661;854;807;2018
24;León;182;Valderrey;436;214;222;2018
24;León;183;Valderrueda;853;445;408;2018
24;León;184;Valdesamario;196;109;87;2018
24;León;187;Valdevimbre;1003;528;475;2018
24;León;188;Valencia de Don Juan;5302;2593;2709;2018
24;León;191;Vallecillo;124;76;48;2018
24;León;189;Valverde de la Virgen;7294;3768;3526;2018
24;León;190;Valverde-Enrique;159;81;78;2018
24;León;193;Vecilla, La;393;209;184;2018
24;León;196;Vega de Espinareda;2137;1080;1057;2018
24;León;197;Vega de Infanzones;854;434;420;2018
24;León;198;Vega de Valcarce;604;314;290;2018
24;León;194;Vegacervera;284;147;137;2018
24;León;199;Vegaquemada;437;241;196;2018
24;León;201;Vegas del Condado;1117;650;467;2018
24;León;202;Villablino;8919;4383;4536;2018
24;León;203;Villabraz;93;55;38;2018
24;León;205;Villadangos del Páramo;1094;562;532;2018
24;León;207;Villademor de la Vega;336;183;153;2018
24;León;209;Villafranca del Bierzo;2974;1430;1544;2018
24;León;210;Villagatón;588;319;269;2018
24;León;211;Villamandos;308;170;138;2018
24;León;901;Villamanín;936;480;456;2018
24;León;212;Villamañán;1155;566;589;2018
24;León;213;Villamartín de Don Sancho;152;87;65;2018
24;León;214;Villamejil;696;370;326;2018
24;León;215;Villamol;162;82;80;2018
24;León;216;Villamontán de la Valduerna;736;386;350;2018
24;León;217;Villamoratiel de las Matas;158;90;68;2018
24;León;218;Villanueva de las Manzanas;485;256;229;2018
24;León;219;Villaobispo de Otero;563;307;256;2018
24;León;902;Villaornate y Castro;371;185;186;2018
24;León;221;Villaquejida;896;455;441;2018
24;León;222;Villaquilambre;18676;9223;9453;2018
24;León;223;Villarejo de Órbigo;3001;1470;1531;2018
24;León;224;Villares de Órbigo;615;323;292;2018
24;León;225;Villasabariego;1135;601;534;2018
24;León;226;Villaselán;196;111;85;2018
24;León;227;Villaturiel;1877;981;896;2018
24;León;228;Villazala;673;358;315;2018
24;León;229;Villazanzo de Valderaduey;429;250;179;2018
24;León;230;Zotes del Páramo;439;242;197;2018
25;Lleida;001;Abella de la Conca;181;99;82;2018
25;Lleida;002;Àger;611;324;287;2018
25;Lleida;003;Agramunt;5393;2700;2693;2018
25;Lleida;038;Aitona;2545;1328;1217;2018
25;Lleida;004;Alamús, Els;796;421;375;2018
25;Lleida;005;Alàs i Cerc;342;174;168;2018
25;Lleida;006;Albagés, L';375;199;176;2018
25;Lleida;007;Albatàrrec;2335;1205;1130;2018
25;Lleida;008;Albesa;1576;862;714;2018
25;Lleida;009;Albi, L';762;393;369;2018
25;Lleida;010;Alcanó;232;118;114;2018
25;Lleida;011;Alcarràs;9422;4876;4546;2018
25;Lleida;012;Alcoletge;3419;1772;1647;2018
25;Lleida;013;Alfarràs;2822;1480;1342;2018
25;Lleida;014;Alfés;313;163;150;2018
25;Lleida;015;Algerri;399;216;183;2018
25;Lleida;016;Alguaire;2937;1552;1385;2018
25;Lleida;017;Alins;290;153;137;2018
25;Lleida;019;Almacelles;6789;3554;3235;2018
25;Lleida;020;Almatret;314;174;140;2018
25;Lleida;021;Almenar;3453;1824;1629;2018
25;Lleida;022;Alòs de Balaguer;131;77;54;2018
25;Lleida;023;Alpicat;6230;3129;3101;2018
25;Lleida;024;Alt Àneu;406;228;178;2018
25;Lleida;027;Anglesola;1328;670;658;2018
25;Lleida;029;Arbeca;2162;1101;1061;2018
25;Lleida;031;Arres;63;40;23;2018
25;Lleida;032;Arsèguel;85;48;37;2018
25;Lleida;033;Artesa de Lleida;1538;804;734;2018
25;Lleida;034;Artesa de Segre;3447;1770;1677;2018
25;Lleida;036;Aspa;217;109;108;2018
25;Lleida;037;Avellanes i Santa Linya, Les;455;261;194;2018
25;Lleida;039;Baix Pallars;330;175;155;2018
25;Lleida;040;Balaguer;16841;8519;8322;2018
25;Lleida;041;Barbens;939;505;434;2018
25;Lleida;042;Baronia de Rialb, La;231;121;110;2018
25;Lleida;044;Bassella;231;113;118;2018
25;Lleida;045;Bausen;64;34;30;2018
25;Lleida;046;Belianes;525;265;260;2018
25;Lleida;170;Bellaguarda;301;160;141;2018
25;Lleida;047;Bellcaire d'Urgell;1252;634;618;2018
25;Lleida;048;Bell-lloc d'Urgell;2289;1129;1160;2018
25;Lleida;049;Bellmunt d'Urgell;193;94;99;2018
25;Lleida;050;Bellpuig;5060;2635;2425;2018
25;Lleida;051;Bellver de Cerdanya;1979;1021;958;2018
25;Lleida;052;Bellvís;2266;1149;1117;2018
25;Lleida;053;Benavent de Segrià;1468;768;700;2018
25;Lleida;055;Biosca;181;97;84;2018
25;Lleida;057;Bòrdes, Es;266;145;121;2018
25;Lleida;058;Borges Blanques, Les;6002;3054;2948;2018
25;Lleida;059;Bossòst;1110;544;566;2018
25;Lleida;056;Bovera;257;139;118;2018
25;Lleida;060;Cabanabona;76;33;43;2018
25;Lleida;061;Cabó;97;52;45;2018
25;Lleida;062;Camarasa;842;432;410;2018
25;Lleida;063;Canejan;84;48;36;2018
25;Lleida;904;Castell de Mur;165;91;74;2018
25;Lleida;064;Castellar de la Ribera;137;70;67;2018
25;Lleida;067;Castelldans;931;502;429;2018
25;Lleida;068;Castellnou de Seana;687;361;326;2018
25;Lleida;069;Castelló de Farfanya;538;290;248;2018
25;Lleida;070;Castellserà;1000;496;504;2018
25;Lleida;071;Cava;46;28;18;2018
25;Lleida;072;Cervera;9066;4594;4472;2018
25;Lleida;073;Cervià de les Garrigues;648;345;303;2018
25;Lleida;074;Ciutadilla;206;109;97;2018
25;Lleida;075;Clariana de Cardener;147;74;73;2018
25;Lleida;076;Cogul, El;161;88;73;2018
25;Lleida;077;Coll de Nargó;549;284;265;2018
25;Lleida;163;Coma i la Pedra, La;265;160;105;2018
25;Lleida;161;Conca de Dalt;428;220;208;2018
25;Lleida;078;Corbins;1431;777;654;2018
25;Lleida;079;Cubells;358;184;174;2018
25;Lleida;081;Espluga Calba, L';357;181;176;2018
25;Lleida;082;Espot;352;190;162;2018
25;Lleida;088;Estamariu;119;69;50;2018
25;Lleida;085;Estaràs;160;85;75;2018
25;Lleida;086;Esterri d'Àneu;756;363;393;2018
25;Lleida;087;Esterri de Cardós;69;36;33;2018
25;Lleida;089;Farrera;122;69;53;2018
25;Lleida;908;Fígols i Alinyà;253;141;112;2018
25;Lleida;092;Floresta, La;154;83;71;2018
25;Lleida;093;Fondarella;792;388;404;2018
25;Lleida;094;Foradada;173;103;70;2018
25;Lleida;096;Fuliola, La;1217;606;611;2018
25;Lleida;097;Fulleda;84;43;41;2018
25;Lleida;098;Gavet de la Conca;274;133;141;2018
25;Lleida;912;Gimenells i el Pla de la Font;1108;587;521;2018
25;Lleida;099;Golmés;1864;937;927;2018
25;Lleida;100;Gósol;209;120;89;2018
25;Lleida;101;Granadella, La;728;388;340;2018
25;Lleida;102;Granja d'Escarp, La;956;519;437;2018
25;Lleida;103;Granyanella;140;79;61;2018
25;Lleida;105;Granyena de les Garrigues;144;87;57;2018
25;Lleida;104;Granyena de Segarra;147;76;71;2018
25;Lleida;109;Guimerà;270;146;124;2018
25;Lleida;903;Guingueta d'Àneu, La;298;160;138;2018
25;Lleida;110;Guissona;7034;3746;3288;2018
25;Lleida;111;Guixers;138;88;50;2018
25;Lleida;115;Isona i Conca Dellà;1028;546;482;2018
25;Lleida;112;Ivars de Noguera;337;174;163;2018
25;Lleida;113;Ivars d'Urgell;1557;817;740;2018
25;Lleida;114;Ivorra;104;57;47;2018
25;Lleida;910;Josa i Tuixén;118;66;52;2018
25;Lleida;118;Juncosa;393;211;182;2018
25;Lleida;119;Juneda;3409;1785;1624;2018
25;Lleida;121;Les;954;480;474;2018
25;Lleida;122;Linyola;2660;1340;1320;2018
25;Lleida;123;Lladorre;227;111;116;2018
25;Lleida;124;Lladurs;179;95;84;2018
25;Lleida;125;Llardecans;460;239;221;2018
25;Lleida;126;Llavorsí;352;171;181;2018
25;Lleida;120;Lleida;137856;68070;69786;2018
25;Lleida;127;Lles de Cerdanya;255;146;109;2018
25;Lleida;128;Llimiana;142;86;56;2018
25;Lleida;129;Llobera;195;107;88;2018
25;Lleida;133;Maials;931;511;420;2018
25;Lleida;130;Maldà;225;115;110;2018
25;Lleida;131;Massalcoreig;585;334;251;2018
25;Lleida;132;Massoteres;232;122;110;2018
25;Lleida;134;Menàrguens;801;450;351;2018
25;Lleida;135;Miralcamp;1347;676;671;2018
25;Lleida;137;Mollerussa;14740;7543;7197;2018
25;Lleida;136;Molsosa, La;109;54;55;2018
25;Lleida;139;Montellà i Martinet;554;307;247;2018
25;Lleida;140;Montferrer i Castellbò;1074;578;496;2018
25;Lleida;138;Montgai;635;327;308;2018
25;Lleida;142;Montoliu de Lleida;469;236;233;2018
25;Lleida;141;Montoliu de Segarra;190;105;85;2018
25;Lleida;143;Montornès de Segarra;98;46;52;2018
25;Lleida;145;Nalec;93;52;41;2018
25;Lleida;025;Naut Aran;1790;928;862;2018
25;Lleida;146;Navès;291;147;144;2018
25;Lleida;148;Odèn;260;153;107;2018
25;Lleida;149;Oliana;1787;900;887;2018
25;Lleida;150;Oliola;202;108;94;2018
25;Lleida;151;Olius;961;508;453;2018
25;Lleida;152;Oluges, Les;172;90;82;2018
25;Lleida;153;Omellons, Els;212;114;98;2018
25;Lleida;154;Omells de na Gaia, Els;134;73;61;2018
25;Lleida;155;Organyà;792;396;396;2018
25;Lleida;156;Os de Balaguer;1009;512;497;2018
25;Lleida;157;Ossó de Sió;205;104;101;2018
25;Lleida;158;Palau d'Anglesola, El;2163;1070;1093;2018
25;Lleida;164;Penelles;462;266;196;2018
25;Lleida;165;Peramola;353;175;178;2018
25;Lleida;166;Pinell de Solsonès;203;119;84;2018
25;Lleida;167;Pinós;298;155;143;2018
25;Lleida;911;Plans de Sió, Els;507;269;238;2018
25;Lleida;168;Poal, El;626;325;301;2018
25;Lleida;169;Pobla de Cérvoles, La;191;107;84;2018
25;Lleida;171;Pobla de Segur, La;2939;1448;1491;2018
25;Lleida;030;Pont de Bar, El;171;97;74;2018
25;Lleida;173;Pont de Suert, El;2216;1107;1109;2018
25;Lleida;172;Ponts;2604;1299;1305;2018
25;Lleida;174;Portella, La;703;399;304;2018
25;Lleida;175;Prats i Sansor;231;121;110;2018
25;Lleida;176;Preixana;385;198;187;2018
25;Lleida;177;Preixens;428;217;211;2018
25;Lleida;179;Prullans;224;109;115;2018
25;Lleida;180;Puiggròs;272;136;136;2018
25;Lleida;181;Puigverd d'Agramunt;231;131;100;2018
25;Lleida;182;Puigverd de Lleida;1363;700;663;2018
25;Lleida;183;Rialp;663;338;325;2018
25;Lleida;905;Ribera d'Ondara;422;215;207;2018
25;Lleida;185;Ribera d'Urgellet;923;478;445;2018
25;Lleida;186;Riner;261;130;131;2018
25;Lleida;913;Riu de Cerdanya;94;55;39;2018
25;Lleida;189;Rosselló;3130;1571;1559;2018
25;Lleida;190;Salàs de Pallars;324;174;150;2018
25;Lleida;191;Sanaüja;393;206;187;2018
25;Lleida;196;Sant Esteve de la Sarga;129;78;51;2018
25;Lleida;192;Sant Guim de Freixenet;1040;546;494;2018
25;Lleida;197;Sant Guim de la Plana;177;101;76;2018
25;Lleida;193;Sant Llorenç de Morunys;934;457;477;2018
25;Lleida;902;Sant Martí de Riucorb;648;337;311;2018
25;Lleida;194;Sant Ramon;495;262;233;2018
25;Lleida;201;Sarroca de Bellera;120;69;51;2018
25;Lleida;200;Sarroca de Lleida;361;198;163;2018
25;Lleida;202;Senterada;139;80;59;2018
25;Lleida;035;Sentiu de Sió, La;427;223;204;2018
25;Lleida;204;Seròs;1889;1012;877;2018
25;Lleida;203;Seu d'Urgell, La;12041;5834;6207;2018
25;Lleida;205;Sidamon;733;385;348;2018
25;Lleida;206;Soleràs, El;328;175;153;2018
25;Lleida;207;Solsona;9014;4465;4549;2018
25;Lleida;208;Soriguera;399;215;184;2018
25;Lleida;209;Sort;2164;1076;1088;2018
25;Lleida;210;Soses;1764;926;838;2018
25;Lleida;211;Sudanell;851;470;381;2018
25;Lleida;212;Sunyer;355;208;147;2018
25;Lleida;215;Talarn;651;456;195;2018
25;Lleida;216;Talavera;247;142;105;2018
25;Lleida;217;Tàrrega;16795;8323;8472;2018
25;Lleida;218;Tarrés;99;53;46;2018
25;Lleida;219;Tarroja de Segarra;183;100;83;2018
25;Lleida;220;Térmens;1383;705;678;2018
25;Lleida;221;Tírvia;134;66;68;2018
25;Lleida;222;Tiurana;74;38;36;2018
25;Lleida;223;Torà;1244;624;620;2018
25;Lleida;224;Torms, Els;151;83;68;2018
25;Lleida;225;Tornabous;879;473;406;2018
25;Lleida;227;Torre de Cabdella, La;747;379;368;2018
25;Lleida;226;Torrebesses;289;153;136;2018
25;Lleida;228;Torrefarrera;4630;2353;2277;2018
25;Lleida;907;Torrefeta i Florejacs;590;316;274;2018
25;Lleida;230;Torregrossa;2190;1124;1066;2018
25;Lleida;231;Torrelameu;742;426;316;2018
25;Lleida;232;Torres de Segre;2307;1195;1112;2018
25;Lleida;233;Torre-serona;386;202;184;2018
25;Lleida;234;Tremp;5824;2847;2977;2018
25;Lleida;043;Vall de Boí, La;1022;546;476;2018
25;Lleida;901;Vall de Cardós;372;195;177;2018
25;Lleida;238;Vallbona de les Monges;234;123;111;2018
25;Lleida;240;Vallfogona de Balaguer;1884;942;942;2018
25;Lleida;906;Valls d'Aguilar, Les;272;151;121;2018
25;Lleida;239;Valls de Valira, Les;803;418;385;2018
25;Lleida;909;Vansa i Fórnols, La;168;87;81;2018
25;Lleida;242;Verdú;905;434;471;2018
25;Lleida;243;Vielha e Mijaran;5493;2787;2706;2018
25;Lleida;244;Vilagrassa;510;261;249;2018
25;Lleida;245;Vilaller;536;281;255;2018
25;Lleida;247;Vilamòs;159;90;69;2018
25;Lleida;248;Vilanova de Bellpuig;1170;582;588;2018
25;Lleida;254;Vilanova de la Barca;1039;531;508;2018
25;Lleida;249;Vilanova de l'Aguda;202;101;101;2018
25;Lleida;250;Vilanova de Meià;395;225;170;2018
25;Lleida;251;Vilanova de Segrià;945;494;451;2018
25;Lleida;252;Vila-sana;717;358;359;2018
25;Lleida;253;Vilosell, El;168;85;83;2018
25;Lleida;255;Vinaixa;482;252;230;2018
27;Lugo;001;Abadín;2428;1195;1233;2018
27;Lugo;002;Alfoz;1757;847;910;2018
27;Lugo;003;Antas de Ulla;2008;985;1023;2018
27;Lugo;004;Baleira;1268;672;596;2018
27;Lugo;901;Baralla;2566;1348;1218;2018
27;Lugo;005;Barreiros;2941;1408;1533;2018
27;Lugo;006;Becerreá;2827;1422;1405;2018
27;Lugo;007;Begonte;3037;1527;1510;2018
27;Lugo;008;Bóveda;1503;777;726;2018
27;Lugo;902;Burela;9566;4753;4813;2018
27;Lugo;009;Carballedo;2235;1126;1109;2018
27;Lugo;010;Castro de Rei;5011;2468;2543;2018
27;Lugo;011;Castroverde;2675;1382;1293;2018
27;Lugo;012;Cervantes;1377;788;589;2018
27;Lugo;013;Cervo;4227;2076;2151;2018
27;Lugo;016;Chantada;8324;4024;4300;2018
27;Lugo;014;Corgo, O;3487;1768;1719;2018
27;Lugo;015;Cospeito;4596;2226;2370;2018
27;Lugo;017;Folgoso do Courel;1018;529;489;2018
27;Lugo;018;Fonsagrada, A;3589;1867;1722;2018
27;Lugo;019;Foz;10002;4865;5137;2018
27;Lugo;020;Friol;3772;1903;1869;2018
27;Lugo;022;Guitiriz;5505;2739;2766;2018
27;Lugo;023;Guntín;2718;1393;1325;2018
27;Lugo;024;Incio, O;1609;806;803;2018
27;Lugo;026;Láncara;2637;1338;1299;2018
27;Lugo;027;Lourenzá;2181;1059;1122;2018
27;Lugo;028;Lugo;98025;45456;52569;2018
27;Lugo;029;Meira;1711;852;859;2018
27;Lugo;030;Mondoñedo;3639;1712;1927;2018
27;Lugo;031;Monforte de Lemos;18599;8827;9772;2018
27;Lugo;032;Monterroso;3667;1827;1840;2018
27;Lugo;033;Muras;636;314;322;2018
27;Lugo;034;Navia de Suarna;1103;622;481;2018
27;Lugo;035;Negueira de Muñiz;218;112;106;2018
27;Lugo;037;Nogais, As;1114;591;523;2018
27;Lugo;038;Ourol;1018;517;501;2018
27;Lugo;039;Outeiro de Rei;5093;2624;2469;2018
27;Lugo;040;Palas de Rei;3414;1731;1683;2018
27;Lugo;041;Pantón;2539;1232;1307;2018
27;Lugo;042;Paradela;1820;916;904;2018
27;Lugo;043;Páramo, O;1388;693;695;2018
27;Lugo;044;Pastoriza, A;3056;1543;1513;2018
27;Lugo;045;Pedrafita do Cebreiro;1032;563;469;2018
27;Lugo;047;Pobra do Brollón, A;1685;842;843;2018
27;Lugo;046;Pol;1616;800;816;2018
27;Lugo;048;Pontenova, A;2283;1104;1179;2018
27;Lugo;049;Portomarín;1487;767;720;2018
27;Lugo;050;Quiroga;3257;1559;1698;2018
27;Lugo;056;Rábade;1501;755;746;2018
27;Lugo;051;Ribadeo;9900;4733;5167;2018
27;Lugo;052;Ribas de Sil;970;483;487;2018
27;Lugo;053;Ribeira de Piquín;543;278;265;2018
27;Lugo;054;Riotorto;1255;616;639;2018
27;Lugo;055;Samos;1293;691;602;2018
27;Lugo;057;Sarria;13345;6524;6821;2018
27;Lugo;058;Saviñao, O;3743;1889;1854;2018
27;Lugo;059;Sober;2301;1133;1168;2018
27;Lugo;060;Taboada;2830;1341;1489;2018
27;Lugo;061;Trabada;1121;546;575;2018
27;Lugo;062;Triacastela;643;317;326;2018
27;Lugo;063;Valadouro, O;2004;963;1041;2018
27;Lugo;064;Vicedo, O;1723;844;879;2018
27;Lugo;065;Vilalba;14226;6894;7332;2018
27;Lugo;066;Viveiro;15510;7606;7904;2018
27;Lugo;021;Xermade;1841;892;949;2018
27;Lugo;025;Xove;3314;1647;1667;2018
28;Madrid;001;Acebeda, La;65;35;30;2018
28;Madrid;002;Ajalvir;4559;2374;2185;2018
28;Madrid;003;Alameda del Valle;195;117;78;2018
28;Madrid;004;Álamo, El;9353;4617;4736;2018
28;Madrid;005;Alcalá de Henares;193751;94359;99392;2018
28;Madrid;006;Alcobendas;116037;55613;60424;2018
28;Madrid;007;Alcorcón;169502;81750;87752;2018
28;Madrid;008;Aldea del Fresno;2698;1408;1290;2018
28;Madrid;009;Algete;20473;10091;10382;2018
28;Madrid;010;Alpedrete;14364;7037;7327;2018
28;Madrid;011;Ambite;601;301;300;2018
28;Madrid;012;Anchuelo;1272;661;611;2018
28;Madrid;013;Aranjuez;59037;28775;30262;2018
28;Madrid;014;Arganda del Rey;54554;27377;27177;2018
28;Madrid;015;Arroyomolinos;30052;15097;14955;2018
28;Madrid;016;Atazar, El;93;53;40;2018
28;Madrid;017;Batres;1638;840;798;2018
28;Madrid;018;Becerril de la Sierra;5564;2787;2777;2018
28;Madrid;019;Belmonte de Tajo;1627;861;766;2018
28;Madrid;021;Berrueco, El;741;379;362;2018
28;Madrid;020;Berzosa del Lozoya;198;115;83;2018
28;Madrid;022;Boadilla del Monte;52626;25703;26923;2018
28;Madrid;023;Boalo, El;7399;3724;3675;2018
28;Madrid;024;Braojos;205;122;83;2018
28;Madrid;025;Brea de Tajo;525;302;223;2018
28;Madrid;026;Brunete;10596;5209;5387;2018
28;Madrid;027;Buitrago del Lozoya;1875;910;965;2018
28;Madrid;028;Bustarviejo;2486;1240;1246;2018
28;Madrid;029;Cabanillas de la Sierra;712;365;347;2018
28;Madrid;030;Cabrera, La;2613;1281;1332;2018
28;Madrid;031;Cadalso de los Vidrios;3049;1595;1454;2018
28;Madrid;032;Camarma de Esteruelas;7226;3658;3568;2018
28;Madrid;033;Campo Real;6075;3058;3017;2018
28;Madrid;034;Canencia;423;227;196;2018
28;Madrid;035;Carabaña;1905;947;958;2018
28;Madrid;036;Casarrubuelos;3707;1877;1830;2018
28;Madrid;037;Cenicientos;1980;977;1003;2018
28;Madrid;038;Cercedilla;6948;3403;3545;2018
28;Madrid;039;Cervera de Buitrago;149;89;60;2018
28;Madrid;051;Chapinería;2240;1137;1103;2018
28;Madrid;052;Chinchón;5239;2641;2598;2018
28;Madrid;040;Ciempozuelos;24087;12125;11962;2018
28;Madrid;041;Cobeña;7280;3594;3686;2018
28;Madrid;046;Collado Mediano;6781;3358;3423;2018
28;Madrid;047;Collado Villalba;63074;30723;32351;2018
28;Madrid;043;Colmenar de Oreja;7902;4002;3900;2018
28;Madrid;042;Colmenar del Arroyo;1685;881;804;2018
28;Madrid;045;Colmenar Viejo;49498;24456;25042;2018
28;Madrid;044;Colmenarejo;9124;4464;4660;2018
28;Madrid;048;Corpa;697;364;333;2018
28;Madrid;049;Coslada;81860;40106;41754;2018
28;Madrid;050;Cubas de la Sagra;6310;3128;3182;2018
28;Madrid;053;Daganzo de Arriba;10061;5009;5052;2018
28;Madrid;054;Escorial, El;15842;7821;8021;2018
28;Madrid;055;Estremera;1236;636;600;2018
28;Madrid;056;Fresnedillas de la Oliva;1554;785;769;2018
28;Madrid;057;Fresno de Torote;2181;1137;1044;2018
28;Madrid;058;Fuenlabrada;193586;95433;98153;2018
28;Madrid;059;Fuente el Saz de Jarama;6541;3319;3222;2018
28;Madrid;060;Fuentidueña de Tajo;1985;1003;982;2018
28;Madrid;061;Galapagar;33379;16373;17006;2018
28;Madrid;062;Garganta de los Montes;348;191;157;2018
28;Madrid;063;Gargantilla del Lozoya y Pinilla de Buitrago;318;174;144;2018
28;Madrid;064;Gascones;188;109;79;2018
28;Madrid;065;Getafe;180747;88464;92283;2018
28;Madrid;066;Griñón;10178;5048;5130;2018
28;Madrid;067;Guadalix de la Sierra;6119;3089;3030;2018
28;Madrid;068;Guadarrama;15785;7779;8006;2018
28;Madrid;069;Hiruela, La;48;32;16;2018
28;Madrid;070;Horcajo de la Sierra-Aoslos;148;82;66;2018
28;Madrid;071;Horcajuelo de la Sierra;89;46;43;2018
28;Madrid;072;Hoyo de Manzanares;8222;4125;4097;2018
28;Madrid;073;Humanes de Madrid;19587;9838;9749;2018
28;Madrid;074;Leganés;188425;91463;96962;2018
28;Madrid;075;Loeches;8673;4359;4314;2018
28;Madrid;076;Lozoya;559;294;265;2018
28;Madrid;901;Lozoyuela-Navas-Sieteiglesias;1266;656;610;2018
28;Madrid;078;Madarcos;47;31;16;2018
28;Madrid;079;Madrid;3223334;1500190;1723144;2018
28;Madrid;080;Majadahonda;71785;34020;37765;2018
28;Madrid;082;Manzanares el Real;8597;4358;4239;2018
28;Madrid;083;Meco;13959;7052;6907;2018
28;Madrid;084;Mejorada del Campo;23241;11551;11690;2018
28;Madrid;085;Miraflores de la Sierra;5897;3041;2856;2018
28;Madrid;086;Molar, El;8666;4384;4282;2018
28;Madrid;087;Molinos, Los;4328;2145;2183;2018
28;Madrid;088;Montejo de la Sierra;363;186;177;2018
28;Madrid;089;Moraleja de Enmedio;5021;2501;2520;2018
28;Madrid;090;Moralzarzal;12697;6342;6355;2018
28;Madrid;091;Morata de Tajuña;7553;3768;3785;2018
28;Madrid;092;Móstoles;207095;100930;106165;2018
28;Madrid;093;Navacerrada;2911;1445;1466;2018
28;Madrid;094;Navalafuente;1397;717;680;2018
28;Madrid;095;Navalagamella;2601;1342;1259;2018
28;Madrid;096;Navalcarnero;28305;14148;14157;2018
28;Madrid;097;Navarredonda y San Mamés;122;77;45;2018
28;Madrid;099;Navas del Rey;2819;1500;1319;2018
28;Madrid;100;Nuevo Baztán;6154;3124;3030;2018
28;Madrid;101;Olmeda de las Fuentes;346;183;163;2018
28;Madrid;102;Orusco de Tajuña;1202;612;590;2018
28;Madrid;104;Paracuellos de Jarama;24521;12396;12125;2018
28;Madrid;106;Parla;128256;63838;64418;2018
28;Madrid;107;Patones;523;251;272;2018
28;Madrid;108;Pedrezuela;5746;2880;2866;2018
28;Madrid;109;Pelayos de la Presa;2475;1260;1215;2018
28;Madrid;110;Perales de Tajuña;2831;1431;1400;2018
28;Madrid;111;Pezuela de las Torres;821;426;395;2018
28;Madrid;112;Pinilla del Valle;187;111;76;2018
28;Madrid;113;Pinto;51541;25524;26017;2018
28;Madrid;114;Piñuécar-Gandullas;171;91;80;2018
28;Madrid;115;Pozuelo de Alarcón;86172;41290;44882;2018
28;Madrid;116;Pozuelo del Rey;1120;592;528;2018
28;Madrid;117;Prádena del Rincón;117;68;49;2018
28;Madrid;118;Puebla de la Sierra;60;36;24;2018
28;Madrid;902;Puentes Viejas;642;348;294;2018
28;Madrid;119;Quijorna;3357;1695;1662;2018
28;Madrid;120;Rascafría;1663;913;750;2018
28;Madrid;121;Redueña;247;131;116;2018
28;Madrid;122;Ribatejada;706;358;348;2018
28;Madrid;123;Rivas-Vaciamadrid;85893;42616;43277;2018
28;Madrid;124;Robledillo de la Jara;87;46;41;2018
28;Madrid;125;Robledo de Chavela;4159;2164;1995;2018
28;Madrid;126;Robregordo;48;29;19;2018
28;Madrid;127;Rozas de Madrid, Las;95550;46246;49304;2018
28;Madrid;128;Rozas de Puerto Real;527;300;227;2018
28;Madrid;129;San Agustín del Guadalix;13273;6506;6767;2018
28;Madrid;130;San Fernando de Henares;39466;19207;20259;2018
28;Madrid;131;San Lorenzo de El Escorial;18088;8660;9428;2018
28;Madrid;132;San Martín de la Vega;18784;9569;9215;2018
28;Madrid;133;San Martín de Valdeiglesias;8318;4133;4185;2018
28;Madrid;134;San Sebastián de los Reyes;87724;42854;44870;2018
28;Madrid;135;Santa María de la Alameda;1182;619;563;2018
28;Madrid;136;Santorcaz;850;427;423;2018
28;Madrid;137;Santos de la Humosa, Los;2542;1288;1254;2018
28;Madrid;138;Serna del Monte, La;74;40;34;2018
28;Madrid;140;Serranillos del Valle;4066;2025;2041;2018
28;Madrid;141;Sevilla la Nueva;9095;4451;4644;2018
28;Madrid;143;Somosierra;80;46;34;2018
28;Madrid;144;Soto del Real;8694;4268;4426;2018
28;Madrid;145;Talamanca de Jarama;3725;1850;1875;2018
28;Madrid;146;Tielmes;2604;1333;1271;2018
28;Madrid;147;Titulcia;1304;671;633;2018
28;Madrid;148;Torrejón de Ardoz;129729;63910;65819;2018
28;Madrid;149;Torrejón de la Calzada;8582;4246;4336;2018
28;Madrid;150;Torrejón de Velasco;4298;2131;2167;2018
28;Madrid;151;Torrelaguna;4724;2389;2335;2018
28;Madrid;152;Torrelodones;23361;11239;12122;2018
28;Madrid;153;Torremocha de Jarama;975;497;478;2018
28;Madrid;154;Torres de la Alameda;7760;3956;3804;2018
28;Madrid;903;Tres Cantos;46750;22694;24056;2018
28;Madrid;155;Valdaracete;626;321;305;2018
28;Madrid;156;Valdeavero;1510;783;727;2018
28;Madrid;157;Valdelaguna;903;449;454;2018
28;Madrid;158;Valdemanco;927;496;431;2018
28;Madrid;159;Valdemaqueda;761;396;365;2018
28;Madrid;160;Valdemorillo;12280;6183;6097;2018
28;Madrid;161;Valdemoro;74745;36984;37761;2018
28;Madrid;162;Valdeolmos-Alalpardo;4039;2077;1962;2018
28;Madrid;163;Valdepiélagos;574;310;264;2018
28;Madrid;164;Valdetorres de Jarama;4384;2233;2151;2018
28;Madrid;165;Valdilecha;2840;1469;1371;2018
28;Madrid;166;Valverde de Alcalá;432;224;208;2018
28;Madrid;167;Velilla de San Antonio;12193;6146;6047;2018
28;Madrid;168;Vellón, El;1942;1013;929;2018
28;Madrid;169;Venturada;2081;1102;979;2018
28;Madrid;171;Villa del Prado;6409;3233;3176;2018
28;Madrid;170;Villaconejos;3363;1712;1651;2018
28;Madrid;172;Villalbilla;13421;6785;6636;2018
28;Madrid;173;Villamanrique de Tajo;699;353;346;2018
28;Madrid;174;Villamanta;2501;1274;1227;2018
28;Madrid;175;Villamantilla;1420;700;720;2018
28;Madrid;176;Villanueva de la Cañada;21000;10238;10762;2018
28;Madrid;178;Villanueva de Perales;1547;789;758;2018
28;Madrid;177;Villanueva del Pardillo;17127;8331;8796;2018
28;Madrid;179;Villar del Olmo;1967;983;984;2018
28;Madrid;180;Villarejo de Salvanés;7291;3674;3617;2018
28;Madrid;181;Villaviciosa de Odón;27596;13352;14244;2018
28;Madrid;182;Villavieja del Lozoya;258;141;117;2018
28;Madrid;183;Zarzalejo;1620;847;773;2018
29;Málaga;001;Alameda;5366;2716;2650;2018
29;Málaga;002;Alcaucín;2239;1148;1091;2018
29;Málaga;003;Alfarnate;1105;575;530;2018
29;Málaga;004;Alfarnatejo;394;204;190;2018
29;Málaga;005;Algarrobo;6367;3191;3176;2018
29;Málaga;006;Algatocín;778;411;367;2018
29;Málaga;007;Alhaurín de la Torre;39911;19830;20081;2018
29;Málaga;008;Alhaurín el Grande;24123;12066;12057;2018
29;Málaga;009;Almáchar;1802;930;872;2018
29;Málaga;010;Almargen;1984;1013;971;2018
29;Málaga;011;Almogía;3770;1950;1820;2018
29;Málaga;012;Álora;12951;6533;6418;2018
29;Málaga;013;Alozaina;2015;1029;986;2018
29;Málaga;014;Alpandeire;252;129;123;2018
29;Málaga;015;Antequera;41154;20161;20993;2018
29;Málaga;016;Árchez;391;200;191;2018
29;Málaga;017;Archidona;8288;4233;4055;2018
29;Málaga;018;Ardales;2493;1272;1221;2018
29;Málaga;019;Arenas;1177;619;558;2018
29;Málaga;020;Arriate;4147;2051;2096;2018
29;Málaga;021;Atajate;169;91;78;2018
29;Málaga;022;Benadalid;225;110;115;2018
29;Málaga;023;Benahavís;7989;4024;3965;2018
29;Málaga;024;Benalauría;443;227;216;2018
29;Málaga;025;Benalmádena;67746;33385;34361;2018
29;Málaga;026;Benamargosa;1496;772;724;2018
29;Málaga;027;Benamocarra;2999;1511;1488;2018
29;Málaga;028;Benaoján;1488;775;713;2018
29;Málaga;029;Benarrabá;458;229;229;2018
29;Málaga;030;Borge, El;933;490;443;2018
29;Málaga;031;Burgo, El;1823;934;889;2018
29;Málaga;032;Campillos;8517;4319;4198;2018
29;Málaga;033;Canillas de Aceituno;1620;861;759;2018
29;Málaga;034;Canillas de Albaida;732;363;369;2018
29;Málaga;035;Cañete la Real;1691;849;842;2018
29;Málaga;036;Carratraca;748;391;357;2018
29;Málaga;037;Cartajima;247;133;114;2018
29;Málaga;038;Cártama;25758;13011;12747;2018
29;Málaga;039;Casabermeja;3507;1822;1685;2018
29;Málaga;040;Casarabonela;2510;1336;1174;2018
29;Málaga;041;Casares;6121;3151;2970;2018
29;Málaga;042;Coín;21716;10911;10805;2018
29;Málaga;043;Colmenar;3392;1743;1649;2018
29;Málaga;044;Comares;1323;719;604;2018
29;Málaga;045;Cómpeta;3745;1872;1873;2018
29;Málaga;046;Cortes de la Frontera;3181;1636;1545;2018
29;Málaga;047;Cuevas Bajas;1392;694;698;2018
29;Málaga;049;Cuevas de San Marcos;3671;1849;1822;2018
29;Málaga;048;Cuevas del Becerro;1595;791;804;2018
29;Málaga;050;Cútar;614;317;297;2018
29;Málaga;051;Estepona;67012;32918;34094;2018
29;Málaga;052;Faraján;248;127;121;2018
29;Málaga;053;Frigiliana;3086;1558;1528;2018
29;Málaga;054;Fuengirola;75396;36690;38706;2018
29;Málaga;055;Fuente de Piedra;2554;1306;1248;2018
29;Málaga;056;Gaucín;1573;827;746;2018
29;Málaga;057;Genalguacil;393;199;194;2018
29;Málaga;058;Guaro;2182;1090;1092;2018
29;Málaga;059;Humilladero;3310;1647;1663;2018
29;Málaga;060;Igualeja;762;381;381;2018
29;Málaga;061;Istán;1458;729;729;2018
29;Málaga;062;Iznate;863;446;417;2018
29;Málaga;063;Jimera de Líbar;376;190;186;2018
29;Málaga;064;Jubrique;559;283;276;2018
29;Málaga;065;Júzcar;225;130;95;2018
29;Málaga;066;Macharaviaya;442;235;207;2018
29;Málaga;067;Málaga;571026;274373;296653;2018
29;Málaga;068;Manilva;14977;7651;7326;2018
29;Málaga;069;Marbella;141463;68073;73390;2018
29;Málaga;070;Mijas;80630;40267;40363;2018
29;Málaga;071;Moclinejo;1230;642;588;2018
29;Málaga;072;Mollina;5020;2526;2494;2018
29;Málaga;073;Monda;2523;1296;1227;2018
29;Málaga;903;Montecorto;585;313;272;2018
29;Málaga;074;Montejaque;970;476;494;2018
29;Málaga;075;Nerja;21061;10397;10664;2018
29;Málaga;076;Ojén;3568;1820;1748;2018
29;Málaga;077;Parauta;253;125;128;2018
29;Málaga;079;Periana;3068;1614;1454;2018
29;Málaga;080;Pizarra;9118;4600;4518;2018
29;Málaga;081;Pujerra;294;153;141;2018
29;Málaga;082;Rincón de la Victoria;46093;22646;23447;2018
29;Málaga;083;Riogordo;2701;1423;1278;2018
29;Málaga;084;Ronda;33978;16530;17448;2018
29;Málaga;085;Salares;174;89;85;2018
29;Málaga;086;Sayalonga;1658;849;809;2018
29;Málaga;087;Sedella;606;344;262;2018
29;Málaga;904;Serrato;477;241;236;2018
29;Málaga;088;Sierra de Yeguas;3356;1698;1658;2018
29;Málaga;089;Teba;3818;1927;1891;2018
29;Málaga;090;Tolox;2083;1057;1026;2018
29;Málaga;901;Torremolinos;68262;34079;34183;2018
29;Málaga;091;Torrox;16465;8374;8091;2018
29;Málaga;092;Totalán;715;376;339;2018
29;Málaga;093;Valle de Abdalajís;2568;1303;1265;2018
29;Málaga;094;Vélez-Málaga;80817;39900;40917;2018
29;Málaga;095;Villanueva de Algaidas;4218;2170;2048;2018
29;Málaga;902;Villanueva de la Concepción;3288;1609;1679;2018
29;Málaga;098;Villanueva de Tapia;1490;756;734;2018
29;Málaga;096;Villanueva del Rosario;3373;1647;1726;2018
29;Málaga;097;Villanueva del Trabuco;5300;2663;2637;2018
29;Málaga;099;Viñuela;2020;1051;969;2018
29;Málaga;100;Yunquera;2880;1467;1413;2018
30;Murcia;001;Abanilla;6063;3060;3003;2018
30;Murcia;002;Abarán;13030;6527;6503;2018
30;Murcia;003;Águilas;35031;17490;17541;2018
30;Murcia;004;Albudeite;1361;689;672;2018
30;Murcia;005;Alcantarilla;41622;20539;21083;2018
30;Murcia;902;Alcázares, Los;15674;7994;7680;2018
30;Murcia;006;Aledo;1022;508;514;2018
30;Murcia;007;Alguazas;9525;4896;4629;2018
30;Murcia;008;Alhama de Murcia;21657;10934;10723;2018
30;Murcia;009;Archena;19053;9978;9075;2018
30;Murcia;010;Beniel;11274;5819;5455;2018
30;Murcia;011;Blanca;6564;3354;3210;2018
30;Murcia;012;Bullas;11547;5804;5743;2018
30;Murcia;013;Calasparra;10165;5158;5007;2018
30;Murcia;014;Campos del Río;2045;973;1072;2018
30;Murcia;015;Caravaca de la Cruz;25730;12859;12871;2018
30;Murcia;016;Cartagena;213943;106701;107242;2018
30;Murcia;017;Cehegín;15022;7550;7472;2018
30;Murcia;018;Ceutí;11565;5824;5741;2018
30;Murcia;019;Cieza;34889;17486;17403;2018
30;Murcia;020;Fortuna;10060;5363;4697;2018
30;Murcia;021;Fuente Álamo de Murcia;16184;8459;7725;2018
30;Murcia;022;Jumilla;25547;13334;12213;2018
30;Murcia;023;Librilla;5196;2654;2542;2018
30;Murcia;024;Lorca;93079;47660;45419;2018
30;Murcia;025;Lorquí;7002;3543;3459;2018
30;Murcia;026;Mazarrón;31562;16308;15254;2018
30;Murcia;027;Molina de Segura;70964;35392;35572;2018
30;Murcia;028;Moratalla;7954;4051;3903;2018
30;Murcia;029;Mula;16790;8619;8171;2018
30;Murcia;030;Murcia;447182;218511;228671;2018
30;Murcia;031;Ojós;500;262;238;2018
30;Murcia;032;Pliego;3842;1989;1853;2018
30;Murcia;033;Puerto Lumbreras;14981;7519;7462;2018
30;Murcia;034;Ricote;1301;688;613;2018
30;Murcia;035;San Javier;31905;16033;15872;2018
30;Murcia;036;San Pedro del Pinatar;25167;12733;12434;2018
30;Murcia;901;Santomera;16105;8093;8012;2018
30;Murcia;037;Torre-Pacheco;35614;18542;17072;2018
30;Murcia;038;Torres de Cotillas, Las;21375;10868;10507;2018
30;Murcia;039;Totana;31639;16299;15340;2018
30;Murcia;040;Ulea;879;451;428;2018
30;Murcia;041;Unión, La;19907;10085;9822;2018
30;Murcia;042;Villanueva del Río Segura;2758;1387;1371;2018
30;Murcia;043;Yecla;34234;17157;17077;2018
31;Navarra;001;Abáigar;87;51;36;2018
31;Navarra;002;Abárzuza/Abartzuza;550;269;281;2018
31;Navarra;003;Abaurregaina/Abaurrea Alta;121;76;45;2018
31;Navarra;004;Abaurrepea/Abaurrea Baja;33;20;13;2018
31;Navarra;005;Aberin;356;193;163;2018
31;Navarra;006;Ablitas;2483;1260;1223;2018
31;Navarra;007;Adiós;156;87;69;2018
31;Navarra;008;Aguilar de Codés;72;40;32;2018
31;Navarra;009;Aibar/Oibar;791;421;370;2018
31;Navarra;011;Allín/Allin;850;455;395;2018
31;Navarra;012;Allo;983;490;493;2018
31;Navarra;010;Altsasu/Alsasua;7407;3740;3667;2018
31;Navarra;013;Améscoa Baja;730;391;339;2018
31;Navarra;014;Ancín/Antzin;340;192;148;2018
31;Navarra;015;Andosilla;2715;1356;1359;2018
31;Navarra;016;Ansoáin/Antsoain;10739;5285;5454;2018
31;Navarra;017;Anue;485;258;227;2018
31;Navarra;018;Añorbe;568;312;256;2018
31;Navarra;019;Aoiz/Agoitz;2624;1330;1294;2018
31;Navarra;020;Araitz;525;292;233;2018
31;Navarra;025;Arakil;949;493;456;2018
31;Navarra;021;Aranarache/Aranaratxe;70;40;30;2018
31;Navarra;023;Aranguren;10512;5296;5216;2018
31;Navarra;024;Arano;116;63;53;2018
31;Navarra;022;Arantza;614;324;290;2018
31;Navarra;026;Aras;157;84;73;2018
31;Navarra;027;Arbizu;1124;573;551;2018
31;Navarra;028;Arce/Artzi;264;143;121;2018
31;Navarra;029;Arcos, Los;1117;551;566;2018
31;Navarra;030;Arellano;157;85;72;2018
31;Navarra;031;Areso;275;143;132;2018
31;Navarra;032;Arguedas;2315;1187;1128;2018
31;Navarra;033;Aria;53;30;23;2018
31;Navarra;034;Aribe;36;19;17;2018
31;Navarra;035;Armañanzas;55;31;24;2018
31;Navarra;036;Arróniz;1047;555;492;2018
31;Navarra;037;Arruazu;106;57;49;2018
31;Navarra;038;Artajona;1669;847;822;2018
31;Navarra;039;Artazu;118;60;58;2018
31;Navarra;040;Atez/Atetz;212;119;93;2018
31;Navarra;058;Auritz/Burguete;242;120;122;2018
31;Navarra;041;Ayegui/Aiegi;2331;1214;1117;2018
31;Navarra;042;Azagra;3853;1967;1886;2018
31;Navarra;043;Azuelo;32;13;19;2018
31;Navarra;044;Bakaiku;345;180;165;2018
31;Navarra;901;Barañáin/Barañain;20039;9674;10365;2018
31;Navarra;045;Barásoain;639;346;293;2018
31;Navarra;046;Barbarin;58;28;30;2018
31;Navarra;047;Bargota;262;126;136;2018
31;Navarra;048;Barillas;219;117;102;2018
31;Navarra;049;Basaburua;839;478;361;2018
31;Navarra;050;Baztan;7749;3920;3829;2018
31;Navarra;137;Beintza-Labaien;227;132;95;2018
31;Navarra;051;Beire;275;146;129;2018
31;Navarra;052;Belascoáin;125;62;63;2018
31;Navarra;250;Bera;3761;1855;1906;2018
31;Navarra;053;Berbinzana;610;313;297;2018
31;Navarra;905;Beriáin;3941;1932;2009;2018
31;Navarra;902;Berrioplano/Berriobeiti;7011;3583;3428;2018
31;Navarra;903;Berriozar;10167;5129;5038;2018
31;Navarra;054;Bertizarana;607;295;312;2018
31;Navarra;055;Betelu;352;187;165;2018
31;Navarra;253;Bidaurreta;171;93;78;2018
31;Navarra;056;Biurrun-Olcoz;204;113;91;2018
31;Navarra;057;Buñuel;2223;1087;1136;2018
31;Navarra;059;Burgui/Burgi;208;119;89;2018
31;Navarra;060;Burlada/Burlata;18934;9152;9782;2018
31;Navarra;061;Busto, El;57;26;31;2018
31;Navarra;062;Cabanillas;1364;720;644;2018
31;Navarra;063;Cabredo;97;55;42;2018
31;Navarra;064;Cadreita;1993;1021;972;2018
31;Navarra;065;Caparroso;2702;1423;1279;2018
31;Navarra;066;Cárcar;1039;523;516;2018
31;Navarra;067;Carcastillo;2455;1245;1210;2018
31;Navarra;068;Cascante;3818;1889;1929;2018
31;Navarra;069;Cáseda;980;490;490;2018
31;Navarra;070;Castejón;4109;2041;2068;2018
31;Navarra;071;Castillonuevo;17;13;4;2018
31;Navarra;193;Cendea de Olza/Oltza Zendea;1842;915;927;2018
31;Navarra;072;Cintruénigo;7823;4013;3810;2018
31;Navarra;074;Cirauqui/Zirauki;490;260;230;2018
31;Navarra;075;Ciriza/Ziritza;141;66;75;2018
31;Navarra;076;Cizur;3850;1976;1874;2018
31;Navarra;077;Corella;7707;3884;3823;2018
31;Navarra;078;Cortes;3148;1588;1560;2018
31;Navarra;079;Desojo;75;43;32;2018
31;Navarra;080;Dicastillo;599;308;291;2018
31;Navarra;081;Donamaria;431;215;216;2018
31;Navarra;221;Doneztebe/Santesteban;1729;883;846;2018
31;Navarra;083;Echarri/Etxarri;77;37;40;2018
31;Navarra;087;Elgorriaga;219;111;108;2018
31;Navarra;089;Enériz/Eneritz;298;157;141;2018
31;Navarra;090;Eratsun;152;93;59;2018
31;Navarra;091;Ergoiena;384;205;179;2018
31;Navarra;092;Erro;789;441;348;2018
31;Navarra;094;Eslava;119;58;61;2018
31;Navarra;095;Esparza de Salazar/Espartza Zaraitzu;76;40;36;2018
31;Navarra;096;Espronceda;103;57;46;2018
31;Navarra;097;Estella-Lizarra;13673;6555;7118;2018
31;Navarra;098;Esteribar;2600;1348;1252;2018
31;Navarra;099;Etayo;65;36;29;2018
31;Navarra;082;Etxalar;805;428;377;2018
31;Navarra;084;Etxarri Aranatz;2503;1303;1200;2018
31;Navarra;085;Etxauri;633;331;302;2018
31;Navarra;100;Eulate;284;160;124;2018
31;Navarra;101;Ezcabarte;1804;935;869;2018
31;Navarra;093;Ezcároz/Ezkaroze;306;165;141;2018
31;Navarra;102;Ezkurra;150;98;52;2018
31;Navarra;103;Ezprogui;42;21;21;2018
31;Navarra;104;Falces;2306;1167;1139;2018
31;Navarra;105;Fitero;2017;1020;997;2018
31;Navarra;106;Fontellas;983;495;488;2018
31;Navarra;107;Funes;2485;1328;1157;2018
31;Navarra;108;Fustiñana;2487;1228;1259;2018
31;Navarra;109;Galar;2213;1164;1049;2018
31;Navarra;110;Gallipienzo/Galipentzu;100;56;44;2018
31;Navarra;111;Gallués/Galoze;95;63;32;2018
31;Navarra;112;Garaioa;89;52;37;2018
31;Navarra;113;Garde;146;89;57;2018
31;Navarra;114;Garínoain;479;252;227;2018
31;Navarra;115;Garralda;189;99;90;2018
31;Navarra;116;Genevilla;74;46;28;2018
31;Navarra;117;Goizueta;705;377;328;2018
31;Navarra;118;Goñi;163;107;56;2018
31;Navarra;119;Güesa/Gorza;40;23;17;2018
31;Navarra;120;Guesálaz/Gesalatz;444;263;181;2018
31;Navarra;121;Guirguillano;78;41;37;2018
31;Navarra;256;Hiriberri/Villanueva de Aezkoa;106;57;49;2018
31;Navarra;122;Huarte/Uharte;7014;3542;3472;2018
31;Navarra;124;Ibargoiti;253;148;105;2018
31;Navarra;259;Igantzi;622;325;297;2018
31;Navarra;125;Igúzquiza;325;171;154;2018
31;Navarra;126;Imotz;425;227;198;2018
31;Navarra;127;Irañeta;176;95;81;2018
31;Navarra;904;Irurtzun;2209;1138;1071;2018
31;Navarra;128;Isaba/Izaba;420;209;211;2018
31;Navarra;129;Ituren;504;258;246;2018
31;Navarra;130;Iturmendi;382;193;189;2018
31;Navarra;131;Iza/Itza;1199;649;550;2018
31;Navarra;132;Izagaondoa;176;115;61;2018
31;Navarra;133;Izalzu/Itzaltzu;44;27;17;2018
31;Navarra;134;Jaurrieta;191;107;84;2018
31;Navarra;135;Javier;106;30;76;2018
31;Navarra;136;Juslapeña;550;298;252;2018
31;Navarra;138;Lakuntza;1272;668;604;2018
31;Navarra;139;Lana;172;98;74;2018
31;Navarra;140;Lantz;147;88;59;2018
31;Navarra;141;Lapoblación;119;67;52;2018
31;Navarra;142;Larraga;2060;1087;973;2018
31;Navarra;143;Larraona;103;51;52;2018
31;Navarra;144;Larraun;967;525;442;2018
31;Navarra;145;Lazagurría;187;95;92;2018
31;Navarra;146;Leache/Leatxe;31;18;13;2018
31;Navarra;147;Legarda;113;63;50;2018
31;Navarra;148;Legaria;110;49;61;2018
31;Navarra;149;Leitza;2898;1505;1393;2018
31;Navarra;908;Lekunberri;1535;762;773;2018
31;Navarra;150;Leoz/Leotz;232;146;86;2018
31;Navarra;151;Lerga;60;38;22;2018
31;Navarra;152;Lerín;1725;891;834;2018
31;Navarra;153;Lesaka;2735;1414;1321;2018
31;Navarra;154;Lezáun;242;145;97;2018
31;Navarra;155;Liédena;291;145;146;2018
31;Navarra;156;Lizoáin-Arriasgoiti;297;173;124;2018
31;Navarra;157;Lodosa;4764;2414;2350;2018
31;Navarra;158;Lónguida/Longida;294;158;136;2018
31;Navarra;159;Lumbier;1317;716;601;2018
31;Navarra;160;Luquin;130;70;60;2018
31;Navarra;248;Luzaide/Valcarlos;358;206;152;2018
31;Navarra;161;Mañeru;437;233;204;2018
31;Navarra;162;Marañón;52;26;26;2018
31;Navarra;163;Marcilla;2862;1440;1422;2018
31;Navarra;164;Mélida;747;384;363;2018
31;Navarra;165;Mendavia;3534;1815;1719;2018
31;Navarra;166;Mendaza;292;152;140;2018
31;Navarra;167;Mendigorría;1057;554;503;2018
31;Navarra;168;Metauten;277;155;122;2018
31;Navarra;169;Milagro;3397;1766;1631;2018
31;Navarra;170;Mirafuentes;56;27;29;2018
31;Navarra;171;Miranda de Arga;850;442;408;2018
31;Navarra;172;Monreal/Elo;466;253;213;2018
31;Navarra;173;Monteagudo;1088;541;547;2018
31;Navarra;174;Morentin;120;60;60;2018
31;Navarra;175;Mues;77;41;36;2018
31;Navarra;176;Murchante;4088;2055;2033;2018
31;Navarra;177;Murieta;327;173;154;2018
31;Navarra;178;Murillo el Cuende;646;339;307;2018
31;Navarra;179;Murillo el Fruto;639;340;299;2018
31;Navarra;180;Muruzábal;239;101;138;2018
31;Navarra;181;Navascués/Nabaskoze;142;85;57;2018
31;Navarra;182;Nazar;34;20;14;2018
31;Navarra;088;Noáin (Valle de Elorz)/Noain (Elortzibar);8224;4143;4081;2018
31;Navarra;183;Obanos;912;459;453;2018
31;Navarra;185;Ochagavía/Otsagabia;530;284;246;2018
31;Navarra;184;Oco;77;39;38;2018
31;Navarra;186;Odieta;369;202;167;2018
31;Navarra;187;Oiz;121;72;49;2018
31;Navarra;188;Olaibar;363;207;156;2018
31;Navarra;189;Olazti/Olazagutía;1497;762;735;2018
31;Navarra;190;Olejua;51;28;23;2018
31;Navarra;191;Olite/Erriberri;3931;1991;1940;2018
31;Navarra;192;Olóriz/Oloritz;204;112;92;2018
31;Navarra;195;Orbaizeta;197;98;99;2018
31;Navarra;196;Orbara;36;19;17;2018
31;Navarra;197;Orísoain;79;44;35;2018
31;Navarra;906;Orkoien;3996;2008;1988;2018
31;Navarra;198;Oronz/Orontze;48;25;23;2018
31;Navarra;199;Oroz-Betelu/Orotz-Betelu;147;85;62;2018
31;Navarra;211;Orreaga/Roncesvalles;21;11;10;2018
31;Navarra;200;Oteiza;919;490;429;2018
31;Navarra;201;Pamplona/Iruña;199066;94124;104942;2018
31;Navarra;202;Peralta/Azkoien;5823;2930;2893;2018
31;Navarra;203;Petilla de Aragón;31;18;13;2018
31;Navarra;204;Piedramillera;37;24;13;2018
31;Navarra;205;Pitillas;493;248;245;2018
31;Navarra;206;Puente la Reina/Gares;2843;1437;1406;2018
31;Navarra;207;Pueyo;349;192;157;2018
31;Navarra;208;Ribaforada;3742;1956;1786;2018
31;Navarra;209;Romanzado;174;94;80;2018
31;Navarra;210;Roncal/Erronkari;208;108;100;2018
31;Navarra;212;Sada;144;79;65;2018
31;Navarra;213;Saldías;116;66;50;2018
31;Navarra;214;Salinas de Oro/Jaitz;110;62;48;2018
31;Navarra;215;San Adrián;6241;3097;3144;2018
31;Navarra;217;San Martín de Unx;398;203;195;2018
31;Navarra;216;Sangüesa/Zangoza;4960;2523;2437;2018
31;Navarra;219;Sansol;100;55;45;2018
31;Navarra;220;Santacara;886;461;425;2018
31;Navarra;222;Sarriés/Sartze;62;40;22;2018
31;Navarra;223;Sartaguda;1294;669;625;2018
31;Navarra;224;Sesma;1180;606;574;2018
31;Navarra;225;Sorlada;57;34;23;2018
31;Navarra;226;Sunbilla;671;350;321;2018
31;Navarra;227;Tafalla;10605;5222;5383;2018
31;Navarra;228;Tiebas-Muruarte de Reta;598;307;291;2018
31;Navarra;229;Tirapu;42;27;15;2018
31;Navarra;230;Torralba del Río;104;54;50;2018
31;Navarra;231;Torres del Río;122;59;63;2018
31;Navarra;232;Tudela;35593;17497;18096;2018
31;Navarra;233;Tulebras;134;59;75;2018
31;Navarra;234;Ucar;177;99;78;2018
31;Navarra;123;Uharte Arakil;805;426;379;2018
31;Navarra;235;Ujué/Uxue;177;102;75;2018
31;Navarra;236;Ultzama;1655;857;798;2018
31;Navarra;237;Unciti;212;121;91;2018
31;Navarra;238;Unzué/Untzue;137;72;65;2018
31;Navarra;239;Urdazubi/Urdax;355;175;180;2018
31;Navarra;240;Urdiain;675;347;328;2018
31;Navarra;241;Urraul Alto;133;87;46;2018
31;Navarra;242;Urraul Bajo;308;138;170;2018
31;Navarra;244;Urroz;180;103;77;2018
31;Navarra;243;Urroz-Villa;374;198;176;2018
31;Navarra;245;Urzainqui/Urzainki;88;56;32;2018
31;Navarra;246;Uterga;164;92;72;2018
31;Navarra;247;Uztárroz/Uztarroze;160;82;78;2018
31;Navarra;086;Valle de Egüés/Eguesibar;20774;10457;10317;2018
31;Navarra;194;Valle de Ollo/Ollaran;415;224;191;2018
31;Navarra;260;Valle de Yerri/Deierri;1508;785;723;2018
31;Navarra;249;Valtierra;2373;1186;1187;2018
31;Navarra;251;Viana;4156;2099;2057;2018
31;Navarra;252;Vidángoz/Bidankoze;95;52;43;2018
31;Navarra;254;Villafranca;2841;1423;1418;2018
31;Navarra;255;Villamayor de Monjardín;120;64;56;2018
31;Navarra;257;Villatuerta;1186;595;591;2018
31;Navarra;258;Villava/Atarrabia;10150;4970;5180;2018
31;Navarra;261;Yesa;297;174;123;2018
31;Navarra;262;Zabalza/Zabaltza;295;160;135;2018
31;Navarra;073;Ziordia;361;186;175;2018
31;Navarra;907;Zizur Mayor/Zizur Nagusia;14891;7285;7606;2018
31;Navarra;263;Zubieta;316;164;152;2018
31;Navarra;264;Zugarramurdi;225;112;113;2018
31;Navarra;265;Zúñiga;112;70;42;2018
32;Ourense;001;Allariz;6110;3078;3032;2018
32;Ourense;002;Amoeiro;2265;1129;1136;2018
32;Ourense;003;Arnoia, A;995;496;499;2018
32;Ourense;004;Avión;1806;831;975;2018
32;Ourense;005;Baltar;968;525;443;2018
32;Ourense;006;Bande;1591;771;820;2018
32;Ourense;007;Baños de Molgas;1547;773;774;2018
32;Ourense;008;Barbadás;10951;5343;5608;2018
32;Ourense;009;Barco de Valdeorras, O;13463;6552;6911;2018
32;Ourense;010;Beade;404;215;189;2018
32;Ourense;011;Beariz;973;428;545;2018
32;Ourense;012;Blancos, Os;809;442;367;2018
32;Ourense;013;Boborás;2299;1094;1205;2018
32;Ourense;014;Bola, A;1199;567;632;2018
32;Ourense;015;Bolo, O;917;467;450;2018
32;Ourense;016;Calvos de Randín;779;382;397;2018
32;Ourense;018;Carballeda de Avia;1317;637;680;2018
32;Ourense;017;Carballeda de Valdeorras;1574;813;761;2018
32;Ourense;019;Carballiño, O;13939;6539;7400;2018
32;Ourense;020;Cartelle;2643;1294;1349;2018
32;Ourense;022;Castrelo de Miño;1380;690;690;2018
32;Ourense;021;Castrelo do Val;1001;509;492;2018
32;Ourense;023;Castro Caldelas;1224;622;602;2018
32;Ourense;024;Celanova;5533;2626;2907;2018
32;Ourense;025;Cenlle;1140;568;572;2018
32;Ourense;029;Chandrexa de Queixa;466;262;204;2018
32;Ourense;026;Coles;3049;1534;1515;2018
32;Ourense;027;Cortegada;1105;533;572;2018
32;Ourense;028;Cualedro;1700;870;830;2018
32;Ourense;030;Entrimo;1166;551;615;2018
32;Ourense;031;Esgos;1134;577;557;2018
32;Ourense;033;Gomesende;750;361;389;2018
32;Ourense;034;Gudiña, A;1308;681;627;2018
32;Ourense;035;Irixo, O;1477;709;768;2018
32;Ourense;038;Larouco;455;220;235;2018
32;Ourense;039;Laza;1287;666;621;2018
32;Ourense;040;Leiro;1583;761;822;2018
32;Ourense;041;Lobeira;807;383;424;2018
32;Ourense;042;Lobios;1732;868;864;2018
32;Ourense;043;Maceda;2890;1417;1473;2018
32;Ourense;044;Manzaneda;890;435;455;2018
32;Ourense;045;Maside;2767;1353;1414;2018
32;Ourense;046;Melón;1227;587;640;2018
32;Ourense;047;Merca, A;1911;932;979;2018
32;Ourense;048;Mezquita, A;1039;537;502;2018
32;Ourense;049;Montederramo;722;376;346;2018
32;Ourense;050;Monterrei;2602;1337;1265;2018
32;Ourense;051;Muíños;1486;758;728;2018
32;Ourense;052;Nogueira de Ramuín;2011;1017;994;2018
32;Ourense;053;Oímbra;1766;961;805;2018
32;Ourense;054;Ourense;105505;47962;57543;2018
32;Ourense;055;Paderne de Allariz;1383;689;694;2018
32;Ourense;056;Padrenda;1759;849;910;2018
32;Ourense;057;Parada de Sil;564;307;257;2018
32;Ourense;058;Pereiro de Aguiar, O;6254;3205;3049;2018
32;Ourense;059;Peroxa, A;1871;920;951;2018
32;Ourense;060;Petín;889;435;454;2018
32;Ourense;061;Piñor;1140;576;564;2018
32;Ourense;063;Pobra de Trives, A;2118;1063;1055;2018
32;Ourense;064;Pontedeva;554;276;278;2018
32;Ourense;062;Porqueira;830;404;426;2018
32;Ourense;065;Punxín;699;344;355;2018
32;Ourense;066;Quintela de Leirado;611;268;343;2018
32;Ourense;067;Rairiz de Veiga;1282;654;628;2018
32;Ourense;068;Ramirás;1540;703;837;2018
32;Ourense;069;Ribadavia;5028;2453;2575;2018
32;Ourense;071;Riós;1568;802;766;2018
32;Ourense;072;Rúa, A;4359;2138;2221;2018
32;Ourense;073;Rubiá;1448;705;743;2018
32;Ourense;074;San Amaro;1091;532;559;2018
32;Ourense;075;San Cibrao das Viñas;5249;2660;2589;2018
32;Ourense;076;San Cristovo de Cea;2191;1075;1116;2018
32;Ourense;070;San Xoán de Río;549;271;278;2018
32;Ourense;077;Sandiás;1213;561;652;2018
32;Ourense;078;Sarreaus;1189;598;591;2018
32;Ourense;079;Taboadela;1443;741;702;2018
32;Ourense;080;Teixeira, A;332;167;165;2018
32;Ourense;081;Toén;2368;1219;1149;2018
32;Ourense;082;Trasmiras;1288;645;643;2018
32;Ourense;083;Veiga, A;904;463;441;2018
32;Ourense;084;Verea;933;447;486;2018
32;Ourense;085;Verín;13817;6634;7183;2018
32;Ourense;086;Viana do Bolo;2929;1480;1449;2018
32;Ourense;087;Vilamarín;1904;974;930;2018
32;Ourense;088;Vilamartín de Valdeorras;1746;894;852;2018
32;Ourense;089;Vilar de Barrio;1317;675;642;2018
32;Ourense;090;Vilar de Santos;829;404;425;2018
32;Ourense;091;Vilardevós;1912;999;913;2018
32;Ourense;092;Vilariño de Conso;535;311;224;2018
32;Ourense;032;Xinzo de Limia;9836;4763;5073;2018
32;Ourense;036;Xunqueira de Ambía;1418;717;701;2018
32;Ourense;037;Xunqueira de Espadanedo;741;366;375;2018
34;Palencia;001;Abarca de Campos;42;26;16;2018
34;Palencia;003;Abia de las Torres;164;91;73;2018
34;Palencia;004;Aguilar de Campoo;6842;3312;3530;2018
34;Palencia;005;Alar del Rey;928;453;475;2018
34;Palencia;006;Alba de Cerrato;86;46;40;2018
34;Palencia;009;Amayuelas de Arriba;35;22;13;2018
34;Palencia;010;Ampudia;622;319;303;2018
34;Palencia;011;Amusco;423;234;189;2018
34;Palencia;012;Antigüedad;369;196;173;2018
34;Palencia;015;Arconada;42;26;16;2018
34;Palencia;017;Astudillo;1004;506;498;2018
34;Palencia;018;Autilla del Pino;221;125;96;2018
34;Palencia;019;Autillo de Campos;131;71;60;2018
34;Palencia;020;Ayuela;52;32;20;2018
34;Palencia;022;Baltanás;1216;641;575;2018
34;Palencia;024;Baquerín de Campos;28;18;10;2018
34;Palencia;025;Bárcena de Campos;53;24;29;2018
34;Palencia;027;Barruelo de Santullán;1183;589;594;2018
34;Palencia;028;Báscones de Ojeda;144;77;67;2018
34;Palencia;029;Becerril de Campos;754;392;362;2018
34;Palencia;031;Belmonte de Campos;33;18;15;2018
34;Palencia;032;Berzosilla;41;22;19;2018
34;Palencia;033;Boada de Campos;17;13;4;2018
34;Palencia;035;Boadilla de Rioseco;111;65;46;2018
34;Palencia;034;Boadilla del Camino;115;65;50;2018
34;Palencia;036;Brañosera;246;140;106;2018
34;Palencia;037;Buenavista de Valdavia;264;147;117;2018
34;Palencia;038;Bustillo de la Vega;306;167;139;2018
34;Palencia;039;Bustillo del Páramo de Carrión;61;37;24;2018
34;Palencia;041;Calahorra de Boedo;92;43;49;2018
34;Palencia;042;Calzada de los Molinos;326;182;144;2018
34;Palencia;045;Capillas;77;40;37;2018
34;Palencia;046;Cardeñosa de Volpejera;43;25;18;2018
34;Palencia;047;Carrión de los Condes;2096;996;1100;2018
34;Palencia;048;Castil de Vela;63;30;33;2018
34;Palencia;049;Castrejón de la Peña;360;193;167;2018
34;Palencia;050;Castrillo de Don Juan;220;124;96;2018
34;Palencia;051;Castrillo de Onielo;101;53;48;2018
34;Palencia;052;Castrillo de Villavega;183;100;83;2018
34;Palencia;053;Castromocho;230;119;111;2018
34;Palencia;055;Cervatos de la Cueza;262;144;118;2018
34;Palencia;056;Cervera de Pisuerga;2316;1165;1151;2018
34;Palencia;057;Cevico de la Torre;490;243;247;2018
34;Palencia;058;Cevico Navero;198;112;86;2018
34;Palencia;059;Cisneros;448;220;228;2018
34;Palencia;060;Cobos de Cerrato;139;76;63;2018
34;Palencia;061;Collazos de Boedo;105;61;44;2018
34;Palencia;062;Congosto de Valdavia;165;101;64;2018
34;Palencia;063;Cordovilla la Real;93;55;38;2018
34;Palencia;066;Cubillas de Cerrato;63;36;27;2018
34;Palencia;067;Dehesa de Montejo;136;78;58;2018
34;Palencia;068;Dehesa de Romanos;42;25;17;2018
34;Palencia;069;Dueñas;2633;1343;1290;2018
34;Palencia;070;Espinosa de Cerrato;149;79;70;2018
34;Palencia;071;Espinosa de Villagonzalo;179;94;85;2018
34;Palencia;072;Frechilla;153;75;78;2018
34;Palencia;073;Fresno del Río;194;97;97;2018
34;Palencia;074;Frómista;770;397;373;2018
34;Palencia;076;Fuentes de Nava;659;340;319;2018
34;Palencia;077;Fuentes de Valdepero;429;226;203;2018
34;Palencia;079;Grijota;2269;1184;1085;2018
34;Palencia;080;Guardo;6153;3057;3096;2018
34;Palencia;081;Guaza de Campos;58;36;22;2018
34;Palencia;082;Hérmedes de Cerrato;78;41;37;2018
34;Palencia;083;Herrera de Pisuerga;2006;977;1029;2018
34;Palencia;084;Herrera de Valdecañas;146;83;63;2018
34;Palencia;086;Hontoria de Cerrato;103;53;50;2018
34;Palencia;087;Hornillos de Cerrato;143;78;65;2018
34;Palencia;088;Husillos;313;180;133;2018
34;Palencia;089;Itero de la Vega;157;88;69;2018
34;Palencia;091;Lagartos;136;77;59;2018
34;Palencia;092;Lantadilla;291;154;137;2018
34;Palencia;094;Ledigos;63;36;27;2018
34;Palencia;903;Loma de Ucieza;198;114;84;2018
34;Palencia;096;Lomas;51;32;19;2018
34;Palencia;098;Magaz de Pisuerga;993;528;465;2018
34;Palencia;099;Manquillos;82;44;38;2018
34;Palencia;100;Mantinos;144;81;63;2018
34;Palencia;101;Marcilla de Campos;41;19;22;2018
34;Palencia;102;Mazariegos;217;126;91;2018
34;Palencia;103;Mazuecos de Valdeginate;102;62;40;2018
34;Palencia;104;Melgar de Yuso;259;148;111;2018
34;Palencia;106;Meneses de Campos;122;66;56;2018
34;Palencia;107;Micieces de Ojeda;74;42;32;2018
34;Palencia;108;Monzón de Campos;610;318;292;2018
34;Palencia;109;Moratinos;59;35;24;2018
34;Palencia;110;Mudá;82;46;36;2018
34;Palencia;112;Nogal de las Huertas;46;25;21;2018
34;Palencia;113;Olea de Boedo;39;14;25;2018
34;Palencia;114;Olmos de Ojeda;198;121;77;2018
34;Palencia;116;Osornillo;57;32;25;2018
34;Palencia;901;Osorno la Mayor;1225;654;571;2018
34;Palencia;120;Palencia;78629;37076;41553;2018
34;Palencia;121;Palenzuela;211;120;91;2018
34;Palencia;122;Páramo de Boedo;121;68;53;2018
34;Palencia;123;Paredes de Nava;1930;986;944;2018
34;Palencia;124;Payo de Ojeda;66;39;27;2018
34;Palencia;125;Pedraza de Campos;88;43;45;2018
34;Palencia;126;Pedrosa de la Vega;324;180;144;2018
34;Palencia;127;Perales;90;49;41;2018
34;Palencia;904;Pernía, La;320;184;136;2018
34;Palencia;129;Pino del Río;179;108;71;2018
34;Palencia;130;Piña de Campos;220;114;106;2018
34;Palencia;131;Población de Arroyo;61;32;29;2018
34;Palencia;132;Población de Campos;131;72;59;2018
34;Palencia;133;Población de Cerrato;110;64;46;2018
34;Palencia;134;Polentinos;42;23;19;2018
34;Palencia;135;Pomar de Valdivia;463;260;203;2018
34;Palencia;136;Poza de la Vega;184;109;75;2018
34;Palencia;137;Pozo de Urama;24;16;8;2018
34;Palencia;139;Prádanos de Ojeda;194;102;92;2018
34;Palencia;140;Puebla de Valdavia, La;105;57;48;2018
34;Palencia;141;Quintana del Puente;252;142;110;2018
34;Palencia;143;Quintanilla de Onsoña;184;110;74;2018
34;Palencia;146;Reinoso de Cerrato;53;35;18;2018
34;Palencia;147;Renedo de la Vega;198;109;89;2018
34;Palencia;149;Requena de Campos;21;10;11;2018
34;Palencia;151;Respenda de la Peña;154;90;64;2018
34;Palencia;152;Revenga de Campos;151;82;69;2018
34;Palencia;154;Revilla de Collazos;80;46;34;2018
34;Palencia;155;Ribas de Campos;146;73;73;2018
34;Palencia;156;Riberos de la Cueza;52;34;18;2018
34;Palencia;157;Saldaña;3004;1528;1476;2018
34;Palencia;158;Salinas de Pisuerga;317;165;152;2018
34;Palencia;159;San Cebrián de Campos;433;238;195;2018
34;Palencia;160;San Cebrián de Mudá;162;88;74;2018
34;Palencia;161;San Cristóbal de Boedo;23;14;9;2018
34;Palencia;163;San Mamés de Campos;51;26;25;2018
34;Palencia;165;San Román de la Cuba;65;38;27;2018
34;Palencia;167;Santa Cecilia del Alcor;120;68;52;2018
34;Palencia;168;Santa Cruz de Boedo;52;32;20;2018
34;Palencia;169;Santervás de la Vega;459;259;200;2018
34;Palencia;170;Santibáñez de Ecla;54;30;24;2018
34;Palencia;171;Santibáñez de la Peña;1044;514;530;2018
34;Palencia;174;Santoyo;197;109;88;2018
34;Palencia;175;Serna, La;100;62;38;2018
34;Palencia;177;Soto de Cerrato;191;109;82;2018
34;Palencia;176;Sotobañado y Priorato;145;86;59;2018
34;Palencia;178;Tabanera de Cerrato;137;73;64;2018
34;Palencia;179;Tabanera de Valdavia;25;15;10;2018
34;Palencia;180;Támara de Campos;71;37;34;2018
34;Palencia;181;Tariego de Cerrato;490;260;230;2018
34;Palencia;182;Torquemada;968;526;442;2018
34;Palencia;184;Torremormojón;45;25;20;2018
34;Palencia;185;Triollo;64;35;29;2018
34;Palencia;186;Valbuena de Pisuerga;47;25;22;2018
34;Palencia;189;Valdeolmillos;61;36;25;2018
34;Palencia;190;Valderrábano;51;28;23;2018
34;Palencia;192;Valde-Ucieza;96;57;39;2018
34;Palencia;196;Valle de Cerrato;88;52;36;2018
34;Palencia;902;Valle del Retortillo;174;107;67;2018
34;Palencia;199;Velilla del Río Carrión;1299;666;633;2018
34;Palencia;023;Venta de Baños;6363;3195;3168;2018
34;Palencia;201;Vertavillo;184;99;85;2018
34;Palencia;093;Vid de Ojeda, La;98;57;41;2018
34;Palencia;202;Villabasta de Valdavia;32;18;14;2018
34;Palencia;204;Villacidaler;48;28;20;2018
34;Palencia;205;Villaconancio;63;36;27;2018
34;Palencia;206;Villada;963;491;472;2018
34;Palencia;208;Villaeles de Valdavia;58;34;24;2018
34;Palencia;210;Villahán;104;52;52;2018
34;Palencia;211;Villaherreros;193;97;96;2018
34;Palencia;213;Villalaco;57;31;26;2018
34;Palencia;214;Villalba de Guardo;196;104;92;2018
34;Palencia;215;Villalcázar de Sirga;169;88;81;2018
34;Palencia;216;Villalcón;66;39;27;2018
34;Palencia;217;Villalobón;1652;832;820;2018
34;Palencia;218;Villaluenga de la Vega;589;333;256;2018
34;Palencia;220;Villamartín de Campos;177;99;78;2018
34;Palencia;221;Villamediana;175;97;78;2018
34;Palencia;222;Villameriel;118;64;54;2018
34;Palencia;223;Villamoronta;235;138;97;2018
34;Palencia;224;Villamuera de la Cueza;45;30;15;2018
34;Palencia;225;Villamuriel de Cerrato;6503;3360;3143;2018
34;Palencia;227;Villanueva del Rebollar;75;37;38;2018
34;Palencia;228;Villanuño de Valdavia;90;51;39;2018
34;Palencia;229;Villaprovedo;62;41;21;2018
34;Palencia;230;Villarmentero de Campos;16;11;5;2018
34;Palencia;231;Villarrabé;207;111;96;2018
34;Palencia;232;Villarramiel;826;451;375;2018
34;Palencia;233;Villasarracino;143;84;59;2018
34;Palencia;234;Villasila de Valdavia;71;48;23;2018
34;Palencia;236;Villaturde;155;82;73;2018
34;Palencia;237;Villaumbrales;665;335;330;2018
34;Palencia;238;Villaviudas;365;177;188;2018
34;Palencia;240;Villerías de Campos;97;52;45;2018
34;Palencia;241;Villodre;17;10;7;2018
34;Palencia;242;Villodrigo;109;57;52;2018
34;Palencia;243;Villoldo;369;194;175;2018
34;Palencia;245;Villota del Páramo;327;183;144;2018
34;Palencia;246;Villovieco;75;39;36;2018
35;Palmas, Las;001;Agaete;5573;2783;2790;2018
35;Palmas, Las;002;Agüimes;31152;15777;15375;2018
35;Palmas, Las;020;Aldea de San Nicolás, La;7608;3882;3726;2018
35;Palmas, Las;003;Antigua;11948;6370;5578;2018
35;Palmas, Las;004;Arrecife;61351;30724;30627;2018
35;Palmas, Las;005;Artenara;1090;589;501;2018
35;Palmas, Las;006;Arucas;37691;18735;18956;2018
35;Palmas, Las;007;Betancuria;731;385;346;2018
35;Palmas, Las;008;Firgas;7491;3766;3725;2018
35;Palmas, Las;009;Gáldar;24209;12118;12091;2018
35;Palmas, Las;010;Haría;4969;2532;2437;2018
35;Palmas, Las;011;Ingenio;30831;15532;15299;2018
35;Palmas, Las;012;Mogán;19657;10146;9511;2018
35;Palmas, Las;013;Moya;7728;3933;3795;2018
35;Palmas, Las;014;Oliva, La;25884;13505;12379;2018
35;Palmas, Las;015;Pájara;20539;10661;9878;2018
35;Palmas, Las;016;Palmas de Gran Canaria, Las;378517;183034;195483;2018
35;Palmas, Las;017;Puerto del Rosario;39382;19989;19393;2018
35;Palmas, Las;018;San Bartolomé;18327;9181;9146;2018
35;Palmas, Las;019;San Bartolomé de Tirajana;53588;27932;25656;2018
35;Palmas, Las;021;Santa Brígida;18314;9102;9212;2018
35;Palmas, Las;022;Santa Lucía de Tirajana;71863;35916;35947;2018
35;Palmas, Las;023;Santa María de Guía de Gran Canaria;13924;6928;6996;2018
35;Palmas, Las;024;Teguise;22122;11179;10943;2018
35;Palmas, Las;025;Tejeda;1921;1041;880;2018
35;Palmas, Las;026;Telde;102424;50411;52013;2018
35;Palmas, Las;027;Teror;12449;6392;6057;2018
35;Palmas, Las;028;Tías;20006;10259;9747;2018
35;Palmas, Las;029;Tinajo;6119;3176;2943;2018
35;Palmas, Las;030;Tuineje;14791;7559;7232;2018
35;Palmas, Las;032;Valleseco;3784;1974;1810;2018
35;Palmas, Las;031;Valsequillo de Gran Canaria;9278;4670;4608;2018
35;Palmas, Las;033;Vega de San Mateo;7625;3938;3687;2018
35;Palmas, Las;034;Yaiza;16289;8436;7853;2018
36;Pontevedra;020;Agolada;2370;1182;1188;2018
36;Pontevedra;001;Arbo;2637;1348;1289;2018
36;Pontevedra;003;Baiona;12134;5984;6150;2018
36;Pontevedra;002;Barro;3716;1846;1870;2018
36;Pontevedra;004;Bueu;12148;5983;6165;2018
36;Pontevedra;005;Caldas de Reis;9860;4748;5112;2018
36;Pontevedra;006;Cambados;13814;6673;7141;2018
36;Pontevedra;007;Campo Lameiro;1806;848;958;2018
36;Pontevedra;008;Cangas;26487;13078;13409;2018
36;Pontevedra;009;Cañiza, A;5173;2527;2646;2018
36;Pontevedra;010;Catoira;3349;1623;1726;2018
36;Pontevedra;902;Cerdedo-Cotobade;5815;2795;3020;2018
36;Pontevedra;013;Covelo;2417;1224;1193;2018
36;Pontevedra;014;Crecente;2032;981;1051;2018
36;Pontevedra;015;Cuntis;4710;2243;2467;2018
36;Pontevedra;016;Dozón;1110;579;531;2018
36;Pontevedra;017;Estrada, A;20661;9912;10749;2018
36;Pontevedra;018;Forcarei;3451;1649;1802;2018
36;Pontevedra;019;Fornelos de Montes;1640;783;857;2018
36;Pontevedra;021;Gondomar;14236;7074;7162;2018
36;Pontevedra;022;Grove, O;10700;5289;5411;2018
36;Pontevedra;023;Guarda, A;10013;4875;5138;2018
36;Pontevedra;901;Illa de Arousa, A;4958;2459;2499;2018
36;Pontevedra;024;Lalín;20103;9743;10360;2018
36;Pontevedra;025;Lama, A;2430;1192;1238;2018
36;Pontevedra;026;Marín;24362;12175;12187;2018
36;Pontevedra;027;Meaño;5315;2595;2720;2018
36;Pontevedra;028;Meis;4776;2279;2497;2018
36;Pontevedra;029;Moaña;19448;9435;10013;2018
36;Pontevedra;030;Mondariz;4496;2232;2264;2018
36;Pontevedra;031;Mondariz-Balneario;618;317;301;2018
36;Pontevedra;032;Moraña;4200;2025;2175;2018
36;Pontevedra;033;Mos;15142;7490;7652;2018
36;Pontevedra;034;Neves, As;3892;1881;2011;2018
36;Pontevedra;035;Nigrán;17723;8701;9022;2018
36;Pontevedra;036;Oia;3018;1513;1505;2018
36;Pontevedra;037;Pazos de Borbén;2980;1461;1519;2018
36;Pontevedra;041;Poio;17018;8441;8577;2018
36;Pontevedra;043;Ponte Caldelas;5491;2642;2849;2018
36;Pontevedra;042;Ponteareas;22854;11091;11763;2018
36;Pontevedra;044;Pontecesures;3037;1505;1532;2018
36;Pontevedra;038;Pontevedra;82802;39189;43613;2018
36;Pontevedra;039;Porriño, O;19740;9735;10005;2018
36;Pontevedra;040;Portas;2984;1431;1553;2018
36;Pontevedra;045;Redondela;29194;14219;14975;2018
36;Pontevedra;046;Ribadumia;5069;2478;2591;2018
36;Pontevedra;047;Rodeiro;2509;1274;1235;2018
36;Pontevedra;048;Rosal, O;6249;3070;3179;2018
36;Pontevedra;049;Salceda de Caselas;9146;4557;4589;2018
36;Pontevedra;050;Salvaterra de Miño;9691;4846;4845;2018
36;Pontevedra;051;Sanxenxo;17212;8487;8725;2018
36;Pontevedra;052;Silleda;8698;4237;4461;2018
36;Pontevedra;053;Soutomaior;7305;3622;3683;2018
36;Pontevedra;054;Tomiño;13464;6782;6682;2018
36;Pontevedra;055;Tui;16902;8164;8738;2018
36;Pontevedra;056;Valga;5927;2914;3013;2018
36;Pontevedra;057;Vigo;293642;138980;154662;2018
36;Pontevedra;059;Vila de Cruces;5273;2589;2684;2018
36;Pontevedra;058;Vilaboa;5954;2899;3055;2018
36;Pontevedra;060;Vilagarcía de Arousa;37519;17970;19549;2018
36;Pontevedra;061;Vilanova de Arousa;10352;5035;5317;2018
26;Rioja, La;001;Ábalos;255;150;105;2018
26;Rioja, La;002;Agoncillo;1105;599;506;2018
26;Rioja, La;003;Aguilar del Río Alhama;470;233;237;2018
26;Rioja, La;004;Ajamil de Cameros;62;44;18;2018
26;Rioja, La;005;Albelda de Iregua;3462;1762;1700;2018
26;Rioja, La;006;Alberite;2433;1229;1204;2018
26;Rioja, La;007;Alcanadre;644;338;306;2018
26;Rioja, La;008;Aldeanueva de Ebro;2732;1427;1305;2018
26;Rioja, La;009;Alesanco;502;269;233;2018
26;Rioja, La;010;Alesón;102;61;41;2018
26;Rioja, La;011;Alfaro;9460;4763;4697;2018
26;Rioja, La;012;Almarza de Cameros;28;16;12;2018
26;Rioja, La;013;Anguciana;434;237;197;2018
26;Rioja, La;014;Anguiano;509;287;222;2018
26;Rioja, La;015;Arenzana de Abajo;226;117;109;2018
26;Rioja, La;016;Arenzana de Arriba;30;20;10;2018
26;Rioja, La;017;Arnedillo;426;210;216;2018
26;Rioja, La;018;Arnedo;14815;7373;7442;2018
26;Rioja, La;019;Arrúbal;488;261;227;2018
26;Rioja, La;020;Ausejo;754;399;355;2018
26;Rioja, La;021;Autol;4469;2218;2251;2018
26;Rioja, La;022;Azofra;200;106;94;2018
26;Rioja, La;023;Badarán;502;256;246;2018
26;Rioja, La;024;Bañares;234;124;110;2018
26;Rioja, La;026;Baños de Río Tobía;1590;792;798;2018
26;Rioja, La;025;Baños de Rioja;86;53;33;2018
26;Rioja, La;027;Berceo;159;101;58;2018
26;Rioja, La;028;Bergasa;142;78;64;2018
26;Rioja, La;029;Bergasillas Bajera;39;21;18;2018
26;Rioja, La;030;Bezares;19;9;10;2018
26;Rioja, La;031;Bobadilla;104;53;51;2018
26;Rioja, La;032;Brieva de Cameros;51;30;21;2018
26;Rioja, La;033;Briñas;201;89;112;2018
26;Rioja, La;034;Briones;766;409;357;2018
26;Rioja, La;035;Cabezón de Cameros;20;14;6;2018
26;Rioja, La;036;Calahorra;23923;11741;12182;2018
26;Rioja, La;037;Camprovín;151;82;69;2018
26;Rioja, La;038;Canales de la Sierra;85;57;28;2018
26;Rioja, La;039;Canillas de Río Tuerto;40;20;20;2018
26;Rioja, La;040;Cañas;97;51;46;2018
26;Rioja, La;041;Cárdenas;147;80;67;2018
26;Rioja, La;042;Casalarreina;1145;583;562;2018
26;Rioja, La;043;Castañares de Rioja;424;204;220;2018
26;Rioja, La;044;Castroviejo;50;30;20;2018
26;Rioja, La;045;Cellorigo;12;5;7;2018
26;Rioja, La;046;Cenicero;2036;1043;993;2018
26;Rioja, La;047;Cervera del Río Alhama;2298;1193;1105;2018
26;Rioja, La;048;Cidamón;24;12;12;2018
26;Rioja, La;049;Cihuri;197;106;91;2018
26;Rioja, La;050;Cirueña;142;92;50;2018
26;Rioja, La;051;Clavijo;273;162;111;2018
26;Rioja, La;052;Cordovín;157;78;79;2018
26;Rioja, La;053;Corera;252;132;120;2018
26;Rioja, La;054;Cornago;319;185;134;2018
26;Rioja, La;055;Corporales;39;23;16;2018
26;Rioja, La;056;Cuzcurrita de Río Tirón;488;266;222;2018
26;Rioja, La;057;Daroca de Rioja;47;32;15;2018
26;Rioja, La;058;Enciso;167;103;64;2018
26;Rioja, La;059;Entrena;1519;800;719;2018
26;Rioja, La;060;Estollo;93;62;31;2018
26;Rioja, La;061;Ezcaray;2027;1045;982;2018
26;Rioja, La;062;Foncea;96;55;41;2018
26;Rioja, La;063;Fonzaleche;134;85;49;2018
26;Rioja, La;064;Fuenmayor;3108;1569;1539;2018
26;Rioja, La;065;Galbárruli;50;32;18;2018
26;Rioja, La;066;Galilea;332;168;164;2018
26;Rioja, La;067;Gallinero de Cameros;18;12;6;2018
26;Rioja, La;068;Gimileo;116;63;53;2018
26;Rioja, La;069;Grañón;255;146;109;2018
26;Rioja, La;070;Grávalos;179;92;87;2018
26;Rioja, La;071;Haro;11309;5543;5766;2018
26;Rioja, La;072;Herce;330;172;158;2018
26;Rioja, La;073;Herramélluri;110;60;50;2018
26;Rioja, La;074;Hervías;120;62;58;2018
26;Rioja, La;075;Hormilla;440;236;204;2018
26;Rioja, La;076;Hormilleja;130;66;64;2018
26;Rioja, La;077;Hornillos de Cameros;18;8;10;2018
26;Rioja, La;078;Hornos de Moncalvillo;92;53;39;2018
26;Rioja, La;079;Huércanos;818;443;375;2018
26;Rioja, La;080;Igea;608;344;264;2018
26;Rioja, La;081;Jalón de Cameros;18;10;8;2018
26;Rioja, La;082;Laguna de Cameros;116;71;45;2018
26;Rioja, La;083;Lagunilla del Jubera;293;161;132;2018
26;Rioja, La;084;Lardero;10193;5124;5069;2018
26;Rioja, La;086;Ledesma de la Cogolla;15;12;3;2018
26;Rioja, La;087;Leiva;238;123;115;2018
26;Rioja, La;088;Leza de Río Leza;33;18;15;2018
26;Rioja, La;089;Logroño;151113;71860;79253;2018
26;Rioja, La;091;Lumbreras;168;111;57;2018
26;Rioja, La;092;Manjarrés;117;72;45;2018
26;Rioja, La;093;Mansilla de la Sierra;55;41;14;2018
26;Rioja, La;094;Manzanares de Rioja;72;42;30;2018
26;Rioja, La;095;Matute;93;49;44;2018
26;Rioja, La;096;Medrano;321;174;147;2018
26;Rioja, La;098;Munilla;108;61;47;2018
26;Rioja, La;099;Murillo de Río Leza;1654;847;807;2018
26;Rioja, La;100;Muro de Aguas;59;34;25;2018
26;Rioja, La;101;Muro en Cameros;39;23;16;2018
26;Rioja, La;102;Nájera;8047;3948;4099;2018
26;Rioja, La;103;Nalda;988;528;460;2018
26;Rioja, La;104;Navajún;15;10;5;2018
26;Rioja, La;105;Navarrete;2952;1500;1452;2018
26;Rioja, La;106;Nestares;86;48;38;2018
26;Rioja, La;107;Nieva de Cameros;92;61;31;2018
26;Rioja, La;109;Ochánduri;82;49;33;2018
26;Rioja, La;108;Ocón;282;173;109;2018
26;Rioja, La;110;Ojacastro;175;105;70;2018
26;Rioja, La;111;Ollauri;286;151;135;2018
26;Rioja, La;112;Ortigosa de Cameros;246;145;101;2018
26;Rioja, La;113;Pazuengos;31;24;7;2018
26;Rioja, La;114;Pedroso;76;53;23;2018
26;Rioja, La;115;Pinillos;15;9;6;2018
26;Rioja, La;117;Pradejón;3822;1954;1868;2018
26;Rioja, La;118;Pradillo;71;36;35;2018
26;Rioja, La;119;Préjano;217;121;96;2018
26;Rioja, La;120;Quel;2032;1065;967;2018
26;Rioja, La;121;Rabanera;32;23;9;2018
26;Rioja, La;122;Rasillo de Cameros, El;130;67;63;2018
26;Rioja, La;123;Redal, El;138;77;61;2018
26;Rioja, La;124;Ribafrecha;961;503;458;2018
26;Rioja, La;125;Rincón de Soto;3722;1892;1830;2018
26;Rioja, La;126;Robres del Castillo;29;19;10;2018
26;Rioja, La;127;Rodezno;229;122;107;2018
26;Rioja, La;128;Sajazarra;130;65;65;2018
26;Rioja, La;129;San Asensio;1124;598;526;2018
26;Rioja, La;130;San Millán de la Cogolla;222;149;73;2018
26;Rioja, La;131;San Millán de Yécora;35;24;11;2018
26;Rioja, La;132;San Román de Cameros;142;85;57;2018
26;Rioja, La;139;San Torcuato;64;32;32;2018
26;Rioja, La;142;San Vicente de la Sonsierra;1015;529;486;2018
26;Rioja, La;134;Santa Coloma;88;55;33;2018
26;Rioja, La;135;Santa Engracia del Jubera;154;99;55;2018
26;Rioja, La;136;Santa Eulalia Bajera;107;58;49;2018
26;Rioja, La;138;Santo Domingo de la Calzada;6231;3123;3108;2018
26;Rioja, La;140;Santurde de Rioja;288;153;135;2018
26;Rioja, La;141;Santurdejo;109;68;41;2018
26;Rioja, La;143;Sojuela;296;167;129;2018
26;Rioja, La;144;Sorzano;232;135;97;2018
26;Rioja, La;145;Sotés;297;167;130;2018
26;Rioja, La;146;Soto en Cameros;87;50;37;2018
26;Rioja, La;147;Terroba;30;16;14;2018
26;Rioja, La;148;Tirgo;186;93;93;2018
26;Rioja, La;149;Tobía;47;28;19;2018
26;Rioja, La;150;Tormantos;139;81;58;2018
26;Rioja, La;153;Torre en Cameros;10;8;2;2018
26;Rioja, La;151;Torrecilla en Cameros;464;253;211;2018
26;Rioja, La;152;Torrecilla sobre Alesanco;30;19;11;2018
26;Rioja, La;154;Torremontalbo;10;6;4;2018
26;Rioja, La;155;Treviana;168;91;77;2018
26;Rioja, La;157;Tricio;358;177;181;2018
26;Rioja, La;158;Tudelilla;359;195;164;2018
26;Rioja, La;160;Uruñuela;988;504;484;2018
26;Rioja, La;161;Valdemadera;8;5;3;2018
26;Rioja, La;162;Valgañón;133;81;52;2018
26;Rioja, La;163;Ventosa;169;87;82;2018
26;Rioja, La;164;Ventrosa;59;33;26;2018
26;Rioja, La;165;Viguera;390;220;170;2018
26;Rioja, La;166;Villalba de Rioja;154;95;59;2018
26;Rioja, La;167;Villalobar de Rioja;67;44;23;2018
26;Rioja, La;168;Villamediana de Iregua;7973;4019;3954;2018
26;Rioja, La;169;Villanueva de Cameros;72;40;32;2018
26;Rioja, La;170;Villar de Arnedo, El;597;309;288;2018
26;Rioja, La;171;Villar de Torre;163;98;65;2018
26;Rioja, La;172;Villarejo;27;21;6;2018
26;Rioja, La;173;Villarroya;5;3;2;2018
26;Rioja, La;174;Villarta-Quintana;140;83;57;2018
26;Rioja, La;175;Villavelayo;48;31;17;2018
26;Rioja, La;176;Villaverde de Rioja;57;32;25;2018
26;Rioja, La;177;Villoslada de Cameros;325;199;126;2018
26;Rioja, La;178;Viniegra de Abajo;78;45;33;2018
26;Rioja, La;179;Viniegra de Arriba;42;29;13;2018
26;Rioja, La;180;Zarratón;258;141;117;2018
26;Rioja, La;181;Zarzosa;14;10;4;2018
26;Rioja, La;183;Zorraquín;91;45;46;2018
37;Salamanca;001;Abusejo;193;102;91;2018
37;Salamanca;002;Agallas;146;75;71;2018
37;Salamanca;003;Ahigal de los Aceiteros;120;65;55;2018
37;Salamanca;004;Ahigal de Villarino;34;19;15;2018
37;Salamanca;005;Alameda de Gardón, La;76;39;37;2018
37;Salamanca;006;Alamedilla, La;138;69;69;2018
37;Salamanca;007;Alaraz;463;241;222;2018
37;Salamanca;008;Alba de Tormes;5166;2591;2575;2018
37;Salamanca;009;Alba de Yeltes;220;119;101;2018
37;Salamanca;010;Alberca, La;1107;547;560;2018
37;Salamanca;011;Alberguería de Argañán, La;116;58;58;2018
37;Salamanca;012;Alconada;155;83;72;2018
37;Salamanca;015;Aldea del Obispo;266;141;125;2018
37;Salamanca;013;Aldeacipreste;116;61;55;2018
37;Salamanca;014;Aldeadávila de la Ribera;1239;624;615;2018
37;Salamanca;016;Aldealengua;696;349;347;2018
37;Salamanca;017;Aldeanueva de Figueroa;256;136;120;2018
37;Salamanca;018;Aldeanueva de la Sierra;113;65;48;2018
37;Salamanca;019;Aldearrodrigo;141;78;63;2018
37;Salamanca;020;Aldearrubia;486;263;223;2018
37;Salamanca;021;Aldeaseca de Alba;74;35;39;2018
37;Salamanca;022;Aldeaseca de la Frontera;269;138;131;2018
37;Salamanca;023;Aldeatejada;1989;995;994;2018
37;Salamanca;024;Aldeavieja de Tormes;102;53;49;2018
37;Salamanca;025;Aldehuela de la Bóveda;290;155;135;2018
37;Salamanca;026;Aldehuela de Yeltes;195;104;91;2018
37;Salamanca;027;Almenara de Tormes;254;143;111;2018
37;Salamanca;028;Almendra;157;92;65;2018
37;Salamanca;029;Anaya de Alba;215;122;93;2018
37;Salamanca;030;Añover de Tormes;93;50;43;2018
37;Salamanca;031;Arabayona de Mógica;372;208;164;2018
37;Salamanca;032;Arapiles;644;346;298;2018
37;Salamanca;033;Arcediano;102;55;47;2018
37;Salamanca;034;Arco, El;86;42;44;2018
37;Salamanca;035;Armenteros;200;114;86;2018
37;Salamanca;037;Atalaya, La;113;64;49;2018
37;Salamanca;038;Babilafuente;911;469;442;2018
37;Salamanca;039;Bañobárez;309;158;151;2018
37;Salamanca;040;Barbadillo;410;217;193;2018
37;Salamanca;041;Barbalos;75;42;33;2018
37;Salamanca;042;Barceo;46;30;16;2018
37;Salamanca;044;Barruecopardo;442;238;204;2018
37;Salamanca;045;Bastida, La;26;14;12;2018
37;Salamanca;046;Béjar;12961;6133;6828;2018
37;Salamanca;047;Beleña;223;121;102;2018
37;Salamanca;049;Bermellar;132;66;66;2018
37;Salamanca;050;Berrocal de Huebra;69;40;29;2018
37;Salamanca;051;Berrocal de Salvatierra;85;48;37;2018
37;Salamanca;052;Boada;315;155;160;2018
37;Salamanca;054;Bodón, El;286;150;136;2018
37;Salamanca;055;Bogajo;137;74;63;2018
37;Salamanca;056;Bouza, La;53;24;29;2018
37;Salamanca;057;Bóveda del Río Almar;231;127;104;2018
37;Salamanca;058;Brincones;56;29;27;2018
37;Salamanca;059;Buenamadre;132;69;63;2018
37;Salamanca;060;Buenavista;351;189;162;2018
37;Salamanca;061;Cabaco, El;232;117;115;2018
37;Salamanca;063;Cabeza de Béjar, La;67;41;26;2018
37;Salamanca;065;Cabeza del Caballo;291;157;134;2018
37;Salamanca;062;Cabezabellosa de la Calzada;77;45;32;2018
37;Salamanca;067;Cabrerizos;4256;2129;2127;2018
37;Salamanca;068;Cabrillas;383;195;188;2018
37;Salamanca;069;Calvarrasa de Abajo;1152;610;542;2018
37;Salamanca;070;Calvarrasa de Arriba;600;324;276;2018
37;Salamanca;071;Calzada de Béjar, La;86;46;40;2018
37;Salamanca;072;Calzada de Don Diego;161;84;77;2018
37;Salamanca;073;Calzada de Valdunciel;676;340;336;2018
37;Salamanca;074;Campillo de Azaba;164;96;68;2018
37;Salamanca;077;Campo de Peñaranda, El;266;153;113;2018
37;Salamanca;078;Candelario;906;458;448;2018
37;Salamanca;079;Canillas de Abajo;77;54;23;2018
37;Salamanca;080;Cantagallo;260;139;121;2018
37;Salamanca;081;Cantalapiedra;986;518;468;2018
37;Salamanca;082;Cantalpino;878;482;396;2018
37;Salamanca;083;Cantaracillo;195;108;87;2018
37;Salamanca;085;Carbajosa de la Sagrada;6947;3456;3491;2018
37;Salamanca;086;Carpio de Azaba;100;57;43;2018
37;Salamanca;087;Carrascal de Barregas;1188;622;566;2018
37;Salamanca;088;Carrascal del Obispo;217;117;100;2018
37;Salamanca;089;Casafranca;68;37;31;2018
37;Salamanca;090;Casas del Conde, Las;61;28;33;2018
37;Salamanca;091;Casillas de Flores;191;94;97;2018
37;Salamanca;092;Castellanos de Moriscos;2615;1339;1276;2018
37;Salamanca;185;Castellanos de Villiquera;633;343;290;2018
37;Salamanca;096;Castillejo de Martín Viejo;216;127;89;2018
37;Salamanca;097;Castraz;42;27;15;2018
37;Salamanca;098;Cepeda;331;166;165;2018
37;Salamanca;099;Cereceda de la Sierra;66;34;32;2018
37;Salamanca;100;Cerezal de Peñahorcada;76;41;35;2018
37;Salamanca;101;Cerralbo;154;86;68;2018
37;Salamanca;102;Cerro, El;409;204;205;2018
37;Salamanca;103;Cespedosa de Tormes;490;262;228;2018
37;Salamanca;114;Chagarcía Medianero;78;42;36;2018
37;Salamanca;104;Cilleros de la Bastida;25;12;13;2018
37;Salamanca;106;Cipérez;279;146;133;2018
37;Salamanca;107;Ciudad Rodrigo;12513;6031;6482;2018
37;Salamanca;108;Coca de Alba;108;50;58;2018
37;Salamanca;109;Colmenar de Montemayor;182;103;79;2018
37;Salamanca;110;Cordovilla;123;63;60;2018
37;Salamanca;112;Cristóbal;155;89;66;2018
37;Salamanca;113;Cubo de Don Sancho, El;450;242;208;2018
37;Salamanca;115;Dios le Guarde;127;69;58;2018
37;Salamanca;116;Doñinos de Ledesma;73;39;34;2018
37;Salamanca;117;Doñinos de Salamanca;2050;1072;978;2018
37;Salamanca;118;Éjeme;126;72;54;2018
37;Salamanca;120;Encina de San Silvestre;110;53;57;2018
37;Salamanca;119;Encina, La;103;61;42;2018
37;Salamanca;121;Encinas de Abajo;635;337;298;2018
37;Salamanca;122;Encinas de Arriba;233;118;115;2018
37;Salamanca;123;Encinasola de los Comendadores;170;92;78;2018
37;Salamanca;124;Endrinal;225;122;103;2018
37;Salamanca;125;Escurial de la Sierra;235;136;99;2018
37;Salamanca;126;Espadaña;34;20;14;2018
37;Salamanca;127;Espeja;231;118;113;2018
37;Salamanca;128;Espino de la Orbada;279;152;127;2018
37;Salamanca;129;Florida de Liébana;272;147;125;2018
37;Salamanca;130;Forfoleda;193;106;87;2018
37;Salamanca;131;Frades de la Sierra;191;105;86;2018
37;Salamanca;132;Fregeneda, La;362;182;180;2018
37;Salamanca;133;Fresnedoso;109;64;45;2018
37;Salamanca;134;Fresno Alhándiga;217;120;97;2018
37;Salamanca;135;Fuente de San Esteban, La;1336;668;668;2018
37;Salamanca;136;Fuenteguinaldo;680;336;344;2018
37;Salamanca;137;Fuenteliante;108;54;54;2018
37;Salamanca;138;Fuenterroble de Salvatierra;248;127;121;2018
37;Salamanca;139;Fuentes de Béjar;232;116;116;2018
37;Salamanca;140;Fuentes de Oñoro;1188;626;562;2018
37;Salamanca;141;Gajates;160;74;86;2018
37;Salamanca;142;Galindo y Perahuy;690;396;294;2018
37;Salamanca;143;Galinduste;429;210;219;2018
37;Salamanca;144;Galisancho;385;208;177;2018
37;Salamanca;145;Gallegos de Argañán;280;140;140;2018
37;Salamanca;146;Gallegos de Solmirón;115;65;50;2018
37;Salamanca;147;Garcibuey;187;108;79;2018
37;Salamanca;148;Garcihernández;464;245;219;2018
37;Salamanca;149;Garcirrey;64;37;27;2018
37;Salamanca;150;Gejuelo del Barro;38;22;16;2018
37;Salamanca;151;Golpejas;154;79;75;2018
37;Salamanca;152;Gomecello;444;238;206;2018
37;Salamanca;154;Guadramiro;145;85;60;2018
37;Salamanca;155;Guijo de Ávila;68;41;27;2018
37;Salamanca;156;Guijuelo;5660;2825;2835;2018
37;Salamanca;157;Herguijuela de Ciudad Rodrigo;78;47;31;2018
37;Salamanca;158;Herguijuela de la Sierra;264;149;115;2018
37;Salamanca;159;Herguijuela del Campo;83;40;43;2018
37;Salamanca;160;Hinojosa de Duero;669;337;332;2018
37;Salamanca;161;Horcajo de Montemayor;140;75;65;2018
37;Salamanca;162;Horcajo Medianero;222;116;106;2018
37;Salamanca;163;Hoya, La;37;21;16;2018
37;Salamanca;164;Huerta;299;167;132;2018
37;Salamanca;165;Iruelos;34;15;19;2018
37;Salamanca;166;Ituero de Azaba;224;116;108;2018
37;Salamanca;167;Juzbado;191;100;91;2018
37;Salamanca;168;Lagunilla;486;262;224;2018
37;Salamanca;169;Larrodrigo;192;110;82;2018
37;Salamanca;170;Ledesma;1636;826;810;2018
37;Salamanca;171;Ledrada;478;241;237;2018
37;Salamanca;172;Linares de Riofrío;963;526;437;2018
37;Salamanca;173;Lumbrales;1619;819;800;2018
37;Salamanca;175;Machacón;459;237;222;2018
37;Salamanca;174;Macotera;1085;563;522;2018
37;Salamanca;176;Madroñal;140;77;63;2018
37;Salamanca;177;Maíllo, El;266;149;117;2018
37;Salamanca;178;Malpartida;100;56;44;2018
37;Salamanca;179;Mancera de Abajo;212;112;100;2018
37;Salamanca;180;Manzano, El;72;39;33;2018
37;Salamanca;181;Martiago;285;153;132;2018
37;Salamanca;183;Martín de Yeltes;421;218;203;2018
37;Salamanca;182;Martinamor;84;50;34;2018
37;Salamanca;184;Masueco;289;145;144;2018
37;Salamanca;186;Mata de Ledesma, La;103;57;46;2018
37;Salamanca;187;Matilla de los Caños del Río;627;314;313;2018
37;Salamanca;188;Maya, La;176;106;70;2018
37;Salamanca;189;Membribe de la Sierra;114;68;46;2018
37;Salamanca;190;Mieza;208;103;105;2018
37;Salamanca;191;Milano, El;115;68;47;2018
37;Salamanca;192;Miranda de Azán;426;224;202;2018
37;Salamanca;193;Miranda del Castañar;399;214;185;2018
37;Salamanca;194;Mogarraz;275;142;133;2018
37;Salamanca;195;Molinillo;44;26;18;2018
37;Salamanca;196;Monforte de la Sierra;70;38;32;2018
37;Salamanca;197;Monleón;91;52;39;2018
37;Salamanca;198;Monleras;226;106;120;2018
37;Salamanca;199;Monsagro;142;75;67;2018
37;Salamanca;200;Montejo;221;125;96;2018
37;Salamanca;201;Montemayor del Río;266;142;124;2018
37;Salamanca;202;Monterrubio de Armuña;1323;696;627;2018
37;Salamanca;203;Monterrubio de la Sierra;158;90;68;2018
37;Salamanca;204;Morasverdes;263;143;120;2018
37;Salamanca;205;Morille;230;125;105;2018
37;Salamanca;206;Moríñigo;100;55;45;2018
37;Salamanca;207;Moriscos;384;213;171;2018
37;Salamanca;208;Moronta;74;46;28;2018
37;Salamanca;209;Mozárbez;493;262;231;2018
37;Salamanca;211;Narros de Matalayegua;231;129;102;2018
37;Salamanca;213;Nava de Béjar;98;55;43;2018
37;Salamanca;214;Nava de Francia;131;72;59;2018
37;Salamanca;215;Nava de Sotrobal;158;91;67;2018
37;Salamanca;212;Navacarros;98;53;45;2018
37;Salamanca;216;Navales;332;182;150;2018
37;Salamanca;217;Navalmoral de Béjar;60;27;33;2018
37;Salamanca;218;Navamorales;56;37;19;2018
37;Salamanca;219;Navarredonda de la Rinconada;177;90;87;2018
37;Salamanca;221;Navasfrías;460;240;220;2018
37;Salamanca;222;Negrilla de Palencia;90;52;38;2018
37;Salamanca;223;Olmedo de Camaces;100;53;47;2018
37;Salamanca;224;Orbada, La;207;108;99;2018
37;Salamanca;225;Pajares de la Laguna;113;60;53;2018
37;Salamanca;226;Palacios del Arzobispo;161;78;83;2018
37;Salamanca;228;Palaciosrubios;354;189;165;2018
37;Salamanca;229;Palencia de Negrilla;157;90;67;2018
37;Salamanca;230;Parada de Arriba;249;127;122;2018
37;Salamanca;231;Parada de Rubiales;259;138;121;2018
37;Salamanca;232;Paradinas de San Juan;406;239;167;2018
37;Salamanca;233;Pastores;56;33;23;2018
37;Salamanca;234;Payo, El;335;164;171;2018
37;Salamanca;235;Pedraza de Alba;238;125;113;2018
37;Salamanca;236;Pedrosillo de Alba;142;82;60;2018
37;Salamanca;237;Pedrosillo de los Aires;360;201;159;2018
37;Salamanca;238;Pedrosillo el Ralo;126;66;60;2018
37;Salamanca;239;Pedroso de la Armuña, El;216;111;105;2018
37;Salamanca;240;Pelabravo;1232;660;572;2018
37;Salamanca;241;Pelarrodríguez;172;103;69;2018
37;Salamanca;242;Pelayos;85;51;34;2018
37;Salamanca;243;Peña, La;100;48;52;2018
37;Salamanca;244;Peñacaballera;146;70;76;2018
37;Salamanca;245;Peñaparda;364;182;182;2018
37;Salamanca;246;Peñaranda de Bracamonte;6308;3096;3212;2018
37;Salamanca;247;Peñarandilla;182;98;84;2018
37;Salamanca;248;Peralejos de Abajo;157;83;74;2018
37;Salamanca;249;Peralejos de Arriba;39;25;14;2018
37;Salamanca;250;Pereña de la Ribera;341;181;160;2018
37;Salamanca;251;Peromingo;122;58;64;2018
37;Salamanca;252;Pinedas;113;64;49;2018
37;Salamanca;253;Pino de Tormes, El;159;84;75;2018
37;Salamanca;254;Pitiegua;188;105;83;2018
37;Salamanca;255;Pizarral;47;30;17;2018
37;Salamanca;256;Poveda de las Cintas;223;127;96;2018
37;Salamanca;257;Pozos de Hinojo;46;25;21;2018
37;Salamanca;258;Puebla de Azaba;177;94;83;2018
37;Salamanca;259;Puebla de San Medel;38;23;15;2018
37;Salamanca;260;Puebla de Yeltes;149;77;72;2018
37;Salamanca;261;Puente del Congosto;227;127;100;2018
37;Salamanca;262;Puertas;79;44;35;2018
37;Salamanca;263;Puerto de Béjar;370;181;189;2018
37;Salamanca;264;Puerto Seguro;59;29;30;2018
37;Salamanca;265;Rágama;223;117;106;2018
37;Salamanca;266;Redonda, La;79;46;33;2018
37;Salamanca;267;Retortillo;198;110;88;2018
37;Salamanca;268;Rinconada de la Sierra, La;117;66;51;2018
37;Salamanca;269;Robleda;499;268;231;2018
37;Salamanca;270;Robliza de Cojos;196;100;96;2018
37;Salamanca;271;Rollán;376;207;169;2018
37;Salamanca;272;Saelices el Chico;147;81;66;2018
37;Salamanca;273;Sagrada, La;99;56;43;2018
37;Salamanca;303;Sahugo, El;193;106;87;2018
37;Salamanca;274;Salamanca;143978;65278;78700;2018
37;Salamanca;275;Saldeana;109;60;49;2018
37;Salamanca;276;Salmoral;137;83;54;2018
37;Salamanca;277;Salvatierra de Tormes;75;36;39;2018
37;Salamanca;278;San Cristóbal de la Cuesta;1015;538;477;2018
37;Salamanca;284;San Esteban de la Sierra;347;195;152;2018
37;Salamanca;285;San Felices de los Gallegos;413;214;199;2018
37;Salamanca;286;San Martín del Castañar;219;118;101;2018
37;Salamanca;287;San Miguel de Valero;347;180;167;2018
37;Salamanca;036;San Miguel del Robledo;56;32;24;2018
37;Salamanca;288;San Morales;337;187;150;2018
37;Salamanca;289;San Muñoz;239;122;117;2018
37;Salamanca;291;San Pedro de Rozados;301;166;135;2018
37;Salamanca;290;San Pedro del Valle;145;80;65;2018
37;Salamanca;292;San Pelayo de Guareña;89;49;40;2018
37;Salamanca;280;Sanchón de la Ribera;84;44;40;2018
37;Salamanca;281;Sanchón de la Sagrada;39;23;16;2018
37;Salamanca;282;Sanchotello;222;119;103;2018
37;Salamanca;279;Sancti-Spíritus;826;448;378;2018
37;Salamanca;283;Sando;125;76;49;2018
37;Salamanca;293;Santa María de Sando;114;59;55;2018
37;Salamanca;294;Santa Marta de Tormes;14732;7249;7483;2018
37;Salamanca;296;Santiago de la Puebla;324;170;154;2018
37;Salamanca;297;Santibáñez de Béjar;467;234;233;2018
37;Salamanca;298;Santibáñez de la Sierra;186;102;84;2018
37;Salamanca;299;Santiz;244;129;115;2018
37;Salamanca;300;Santos, Los;614;315;299;2018
37;Salamanca;301;Sardón de los Frailes;91;52;39;2018
37;Salamanca;302;Saucelle;283;145;138;2018
37;Salamanca;304;Sepulcro-Hilario;178;101;77;2018
37;Salamanca;305;Sequeros;239;116;123;2018
37;Salamanca;306;Serradilla del Arroyo;270;146;124;2018
37;Salamanca;307;Serradilla del Llano;154;80;74;2018
37;Salamanca;309;Sierpe, La;44;20;24;2018
37;Salamanca;310;Sieteiglesias de Tormes;187;91;96;2018
37;Salamanca;311;Sobradillo;232;117;115;2018
37;Salamanca;312;Sorihuela;273;142;131;2018
37;Salamanca;313;Sotoserrano;580;307;273;2018
37;Salamanca;314;Tabera de Abajo;107;62;45;2018
37;Salamanca;315;Tala, La;88;49;39;2018
37;Salamanca;316;Tamames;804;408;396;2018
37;Salamanca;317;Tarazona de Guareña;317;170;147;2018
37;Salamanca;318;Tardáguila;212;123;89;2018
37;Salamanca;319;Tejado, El;104;56;48;2018
37;Salamanca;320;Tejeda y Segoyuela;90;50;40;2018
37;Salamanca;321;Tenebrón;151;74;77;2018
37;Salamanca;322;Terradillos;3051;1537;1514;2018
37;Salamanca;323;Topas;530;287;243;2018
37;Salamanca;324;Tordillos;362;196;166;2018
37;Salamanca;325;Tornadizo, El;98;55;43;2018
37;Salamanca;327;Torresmenudas;191;96;95;2018
37;Salamanca;328;Trabanca;200;98;102;2018
37;Salamanca;329;Tremedal de Tormes;43;23;20;2018
37;Salamanca;330;Valdecarros;351;179;172;2018
37;Salamanca;331;Valdefuentes de Sangusín;203;115;88;2018
37;Salamanca;332;Valdehijaderos;79;43;36;2018
37;Salamanca;333;Valdelacasa;214;127;87;2018
37;Salamanca;334;Valdelageve;73;37;36;2018
37;Salamanca;335;Valdelosa;407;199;208;2018
37;Salamanca;336;Valdemierque;65;41;24;2018
37;Salamanca;337;Valderrodrigo;152;74;78;2018
37;Salamanca;338;Valdunciel;100;50;50;2018
37;Salamanca;339;Valero;330;184;146;2018
37;Salamanca;343;Vallejera de Riofrío;76;35;41;2018
37;Salamanca;340;Valsalabroso;149;83;66;2018
37;Salamanca;341;Valverde de Valdelacasa;74;43;31;2018
37;Salamanca;342;Valverdón;288;150;138;2018
37;Salamanca;344;Vecinos;264;133;131;2018
37;Salamanca;345;Vega de Tirados;168;91;77;2018
37;Salamanca;346;Veguillas, Las;285;134;151;2018
37;Salamanca;347;Vellés, La;554;302;252;2018
37;Salamanca;348;Ventosa del Río Almar;112;65;47;2018
37;Salamanca;349;Vídola, La;116;56;60;2018
37;Salamanca;351;Villaflores;282;145;137;2018
37;Salamanca;352;Villagonzalo de Tormes;206;120;86;2018
37;Salamanca;353;Villalba de los Llanos;133;75;58;2018
37;Salamanca;354;Villamayor;7207;3605;3602;2018
37;Salamanca;355;Villanueva del Conde;159;80;79;2018
37;Salamanca;356;Villar de Argañán;95;49;46;2018
37;Salamanca;357;Villar de Ciervo;279;142;137;2018
37;Salamanca;358;Villar de Gallimazo;201;127;74;2018
37;Salamanca;359;Villar de la Yegua;179;94;85;2018
37;Salamanca;360;Villar de Peralonso;229;115;114;2018
37;Salamanca;361;Villar de Samaniego;89;50;39;2018
37;Salamanca;362;Villares de la Reina;6316;3134;3182;2018
37;Salamanca;363;Villares de Yeltes;123;59;64;2018
37;Salamanca;364;Villarino de los Aires;805;417;388;2018
37;Salamanca;365;Villarmayor;197;111;86;2018
37;Salamanca;366;Villarmuerto;43;28;15;2018
37;Salamanca;367;Villasbuenas;191;106;85;2018
37;Salamanca;368;Villasdardo;23;8;15;2018
37;Salamanca;369;Villaseco de los Gamitos;135;79;56;2018
37;Salamanca;370;Villaseco de los Reyes;324;186;138;2018
37;Salamanca;371;Villasrubias;283;155;128;2018
37;Salamanca;372;Villaverde de Guareña;145;82;63;2018
37;Salamanca;373;Villavieja de Yeltes;785;410;375;2018
37;Salamanca;374;Villoria;1358;687;671;2018
37;Salamanca;375;Villoruela;780;392;388;2018
37;Salamanca;350;Vilvestre;422;210;212;2018
37;Salamanca;376;Vitigudino;2538;1237;1301;2018
37;Salamanca;377;Yecla de Yeltes;244;129;115;2018
37;Salamanca;378;Zamarra;98;57;41;2018
37;Salamanca;379;Zamayón;206;126;80;2018
37;Salamanca;380;Zarapicos;59;33;26;2018
37;Salamanca;381;Zarza de Pumareda, La;148;83;65;2018
37;Salamanca;382;Zorita de la Frontera;160;83;77;2018
38;Santa Cruz de Tenerife;001;Adeje;47280;23844;23436;2018
38;Santa Cruz de Tenerife;002;Agulo;1067;545;522;2018
38;Santa Cruz de Tenerife;003;Alajeró;2006;1060;946;2018
38;Santa Cruz de Tenerife;004;Arafo;5562;2733;2829;2018
38;Santa Cruz de Tenerife;005;Arico;7831;4092;3739;2018
38;Santa Cruz de Tenerife;006;Arona;79448;40638;38810;2018
38;Santa Cruz de Tenerife;007;Barlovento;1855;941;914;2018
38;Santa Cruz de Tenerife;008;Breña Alta;7154;3499;3655;2018
38;Santa Cruz de Tenerife;009;Breña Baja;5498;2790;2708;2018
38;Santa Cruz de Tenerife;010;Buenavista del Norte;4755;2405;2350;2018
38;Santa Cruz de Tenerife;011;Candelaria;27641;13426;14215;2018
38;Santa Cruz de Tenerife;012;Fasnia;2768;1444;1324;2018
38;Santa Cruz de Tenerife;013;Frontera;4018;2022;1996;2018
38;Santa Cruz de Tenerife;014;Fuencaliente de la Palma;1709;872;837;2018
38;Santa Cruz de Tenerife;015;Garachico;4819;2411;2408;2018
38;Santa Cruz de Tenerife;016;Garafía;1626;853;773;2018
38;Santa Cruz de Tenerife;017;Granadilla de Abona;48374;24156;24218;2018
38;Santa Cruz de Tenerife;018;Guancha, La;5428;2647;2781;2018
38;Santa Cruz de Tenerife;019;Guía de Isora;20991;10485;10506;2018
38;Santa Cruz de Tenerife;020;Güímar;19739;9792;9947;2018
38;Santa Cruz de Tenerife;021;Hermigua;1805;927;878;2018
38;Santa Cruz de Tenerife;022;Icod de los Vinos;22749;11198;11551;2018
38;Santa Cruz de Tenerife;024;Llanos de Aridane, Los;20171;9769;10402;2018
38;Santa Cruz de Tenerife;025;Matanza de Acentejo, La;8956;4507;4449;2018
38;Santa Cruz de Tenerife;026;Orotava, La;41833;20512;21321;2018
38;Santa Cruz de Tenerife;027;Paso, El;7543;3747;3796;2018
38;Santa Cruz de Tenerife;901;Pinar de El Hierro, El;1825;963;862;2018
38;Santa Cruz de Tenerife;028;Puerto de la Cruz;30483;14902;15581;2018
38;Santa Cruz de Tenerife;029;Puntagorda;2073;1055;1018;2018
38;Santa Cruz de Tenerife;030;Puntallana;2493;1234;1259;2018
38;Santa Cruz de Tenerife;031;Realejos, Los;36405;17868;18537;2018
38;Santa Cruz de Tenerife;032;Rosario, El;17352;8772;8580;2018
38;Santa Cruz de Tenerife;033;San Andrés y Sauces;4112;2065;2047;2018
38;Santa Cruz de Tenerife;023;San Cristóbal de La Laguna;155549;75361;80188;2018
38;Santa Cruz de Tenerife;034;San Juan de la Rambla;4799;2380;2419;2018
38;Santa Cruz de Tenerife;035;San Miguel de Abona;19672;9895;9777;2018
38;Santa Cruz de Tenerife;036;San Sebastián de la Gomera;8945;4481;4464;2018
38;Santa Cruz de Tenerife;037;Santa Cruz de la Palma;15674;7588;8086;2018
38;Santa Cruz de Tenerife;038;Santa Cruz de Tenerife;204856;97841;107015;2018
38;Santa Cruz de Tenerife;039;Santa Úrsula;14445;7223;7222;2018
38;Santa Cruz de Tenerife;040;Santiago del Teide;10755;5347;5408;2018
38;Santa Cruz de Tenerife;041;Sauzal, El;8947;4407;4540;2018
38;Santa Cruz de Tenerife;042;Silos, Los;4757;2374;2383;2018
38;Santa Cruz de Tenerife;043;Tacoronte;23961;11908;12053;2018
38;Santa Cruz de Tenerife;044;Tanque, El;2670;1293;1377;2018
38;Santa Cruz de Tenerife;045;Tazacorte;4600;2350;2250;2018
38;Santa Cruz de Tenerife;046;Tegueste;11203;5531;5672;2018
38;Santa Cruz de Tenerife;047;Tijarafe;2564;1298;1266;2018
38;Santa Cruz de Tenerife;049;Valle Gran Rey;4484;2256;2228;2018
38;Santa Cruz de Tenerife;050;Vallehermoso;2829;1471;1358;2018
38;Santa Cruz de Tenerife;048;Valverde;4955;2500;2455;2018
38;Santa Cruz de Tenerife;051;Victoria de Acentejo, La;9040;4540;4500;2018
38;Santa Cruz de Tenerife;052;Vilaflor de Chasna;1645;851;794;2018
38;Santa Cruz de Tenerife;053;Villa de Mazo;4791;2408;2383;2018
40;Segovia;001;Abades;845;420;425;2018
40;Segovia;002;Adrada de Pirón;44;23;21;2018
40;Segovia;003;Adrados;139;78;61;2018
40;Segovia;004;Aguilafuente;587;287;300;2018
40;Segovia;005;Alconada de Maderuelo;27;18;9;2018
40;Segovia;012;Aldea Real;301;159;142;2018
40;Segovia;006;Aldealcorvo;22;13;9;2018
40;Segovia;007;Aldealengua de Pedraza;76;48;28;2018
40;Segovia;008;Aldealengua de Santa María;56;30;26;2018
40;Segovia;009;Aldeanueva de la Serrezuela;48;34;14;2018
40;Segovia;010;Aldeanueva del Codonal;123;64;59;2018
40;Segovia;013;Aldeasoña;57;33;24;2018
40;Segovia;014;Aldehorno;57;33;24;2018
40;Segovia;015;Aldehuela del Codonal;25;14;11;2018
40;Segovia;016;Aldeonte;55;28;27;2018
40;Segovia;017;Anaya;131;60;71;2018
40;Segovia;018;Añe;79;45;34;2018
40;Segovia;019;Arahuetes;32;23;9;2018
40;Segovia;020;Arcones;175;83;92;2018
40;Segovia;021;Arevalillo de Cega;21;12;9;2018
40;Segovia;022;Armuña;229;131;98;2018
40;Segovia;024;Ayllón;1203;623;580;2018
40;Segovia;025;Barbolla;169;91;78;2018
40;Segovia;026;Basardilla;149;62;87;2018
40;Segovia;028;Bercial;111;60;51;2018
40;Segovia;029;Bercimuel;25;13;12;2018
40;Segovia;030;Bernardos;494;271;223;2018
40;Segovia;031;Bernuy de Porreros;760;406;354;2018
40;Segovia;032;Boceguillas;716;369;347;2018
40;Segovia;033;Brieva;86;48;38;2018
40;Segovia;034;Caballar;85;47;38;2018
40;Segovia;035;Cabañas de Polendos;186;100;86;2018
40;Segovia;036;Cabezuela;671;345;326;2018
40;Segovia;037;Calabazas de Fuentidueña;30;16;14;2018
40;Segovia;039;Campo de San Pedro;258;137;121;2018
40;Segovia;040;Cantalejo;3543;1759;1784;2018
40;Segovia;041;Cantimpalos;1321;695;626;2018
40;Segovia;161;Carabias;49;32;17;2018
40;Segovia;043;Carbonero el Mayor;2529;1309;1220;2018
40;Segovia;044;Carrascal del Río;147;78;69;2018
40;Segovia;045;Casla;157;85;72;2018
40;Segovia;046;Castillejo de Mesleón;130;72;58;2018
40;Segovia;047;Castro de Fuentidueña;29;19;10;2018
40;Segovia;048;Castrojimeno;36;19;17;2018
40;Segovia;049;Castroserna de Abajo;50;28;22;2018
40;Segovia;051;Castroserracín;45;26;19;2018
40;Segovia;052;Cedillo de la Torre;95;51;44;2018
40;Segovia;053;Cerezo de Abajo;117;62;55;2018
40;Segovia;054;Cerezo de Arriba;138;78;60;2018
40;Segovia;065;Chañe;754;380;374;2018
40;Segovia;055;Cilleruelo de San Mamés;35;22;13;2018
40;Segovia;056;Cobos de Fuentidueña;34;17;17;2018
40;Segovia;057;Coca;1774;892;882;2018
40;Segovia;058;Codorniz;334;167;167;2018
40;Segovia;059;Collado Hermoso;123;60;63;2018
40;Segovia;060;Condado de Castilnovo;95;53;42;2018
40;Segovia;061;Corral de Ayllón;78;47;31;2018
40;Segovia;902;Cozuelos de Fuentidueña;129;70;59;2018
40;Segovia;062;Cubillo;77;47;30;2018
40;Segovia;063;Cuéllar;9584;4838;4746;2018
40;Segovia;905;Cuevas de Provanco;135;75;60;2018
40;Segovia;068;Domingo García;27;17;10;2018
40;Segovia;069;Donhierro;91;51;40;2018
40;Segovia;070;Duruelo;178;106;72;2018
40;Segovia;071;Encinas;43;22;21;2018
40;Segovia;072;Encinillas;273;148;125;2018
40;Segovia;073;Escalona del Prado;501;263;238;2018
40;Segovia;074;Escarabajosa de Cabezas;300;164;136;2018
40;Segovia;075;Escobar de Polendos;173;92;81;2018
40;Segovia;076;Espinar, El;9061;4602;4459;2018
40;Segovia;077;Espirdo;1301;689;612;2018
40;Segovia;078;Fresneda de Cuéllar;166;93;73;2018
40;Segovia;079;Fresno de Cantespino;262;144;118;2018
40;Segovia;080;Fresno de la Fuente;71;39;32;2018
40;Segovia;081;Frumales;116;62;54;2018
40;Segovia;082;Fuente de Santa Cruz;119;65;54;2018
40;Segovia;083;Fuente el Olmo de Fuentidueña;172;78;94;2018
40;Segovia;084;Fuente el Olmo de Íscar;60;35;25;2018
40;Segovia;086;Fuentepelayo;852;449;403;2018
40;Segovia;087;Fuentepiñel;96;53;43;2018
40;Segovia;088;Fuenterrebollo;343;176;167;2018
40;Segovia;089;Fuentesaúco de Fuentidueña;241;128;113;2018
40;Segovia;091;Fuentesoto;103;57;46;2018
40;Segovia;092;Fuentidueña;142;82;60;2018
40;Segovia;093;Gallegos;94;52;42;2018
40;Segovia;094;Garcillán;450;233;217;2018
40;Segovia;095;Gomezserracín;688;362;326;2018
40;Segovia;097;Grajera;223;127;96;2018
40;Segovia;099;Honrubia de la Cuesta;58;34;24;2018
40;Segovia;100;Hontalbilla;308;169;139;2018
40;Segovia;101;Hontanares de Eresma;1404;733;671;2018
40;Segovia;103;Huertos, Los;179;103;76;2018
40;Segovia;104;Ituero y Lama;361;192;169;2018
40;Segovia;105;Juarros de Riomoros;43;23;20;2018
40;Segovia;106;Juarros de Voltoya;208;103;105;2018
40;Segovia;107;Labajos;116;66;50;2018
40;Segovia;108;Laguna de Contreras;111;65;46;2018
40;Segovia;109;Languilla;82;50;32;2018
40;Segovia;110;Lastras de Cuéllar;355;184;171;2018
40;Segovia;111;Lastras del Pozo;67;35;32;2018
40;Segovia;112;Lastrilla, La;3773;1911;1862;2018
40;Segovia;113;Losa, La;523;293;230;2018
40;Segovia;115;Maderuelo;97;56;41;2018
40;Segovia;903;Marazoleja;106;70;36;2018
40;Segovia;118;Marazuela;53;30;23;2018
40;Segovia;119;Martín Miguel;225;133;92;2018
40;Segovia;120;Martín Muñoz de la Dehesa;222;115;107;2018
40;Segovia;121;Martín Muñoz de las Posadas;288;149;139;2018
40;Segovia;122;Marugán;617;334;283;2018
40;Segovia;124;Mata de Cuéllar;264;139;125;2018
40;Segovia;123;Matabuena;178;97;81;2018
40;Segovia;125;Matilla, La;89;53;36;2018
40;Segovia;126;Melque de Cercos;77;40;37;2018
40;Segovia;127;Membibre de la Hoz;29;16;13;2018
40;Segovia;128;Migueláñez;137;75;62;2018
40;Segovia;129;Montejo de Arévalo;185;100;85;2018
40;Segovia;130;Montejo de la Vega de la Serrezuela;148;88;60;2018
40;Segovia;131;Monterrubio;61;35;26;2018
40;Segovia;132;Moral de Hornuez;54;31;23;2018
40;Segovia;134;Mozoncillo;904;488;416;2018
40;Segovia;135;Muñopedro;306;166;140;2018
40;Segovia;136;Muñoveros;154;75;79;2018
40;Segovia;138;Nava de la Asunción;2790;1414;1376;2018
40;Segovia;139;Navafría;291;156;135;2018
40;Segovia;140;Navalilla;106;56;50;2018
40;Segovia;141;Navalmanzano;1062;553;509;2018
40;Segovia;142;Navares de Ayuso;53;27;26;2018
40;Segovia;143;Navares de Enmedio;91;55;36;2018
40;Segovia;144;Navares de las Cuevas;25;16;9;2018
40;Segovia;145;Navas de Oro;1347;684;663;2018
40;Segovia;904;Navas de Riofrío;395;191;204;2018
40;Segovia;146;Navas de San Antonio;322;166;156;2018
40;Segovia;148;Nieva;265;138;127;2018
40;Segovia;149;Olombrada;561;298;263;2018
40;Segovia;150;Orejana;60;36;24;2018
40;Segovia;151;Ortigosa de Pestaño;54;29;25;2018
40;Segovia;901;Ortigosa del Monte;568;308;260;2018
40;Segovia;152;Otero de Herreros;963;485;478;2018
40;Segovia;154;Pajarejos;12;8;4;2018
40;Segovia;155;Palazuelos de Eresma;5308;2738;2570;2018
40;Segovia;156;Pedraza;359;204;155;2018
40;Segovia;157;Pelayos del Arroyo;46;27;19;2018
40;Segovia;158;Perosillo;15;12;3;2018
40;Segovia;159;Pinarejos;188;109;79;2018
40;Segovia;160;Pinarnegrillo;100;55;45;2018
40;Segovia;162;Prádena;520;275;245;2018
40;Segovia;163;Puebla de Pedraza;46;24;22;2018
40;Segovia;164;Rapariegos;202;103;99;2018
40;Segovia;181;Real Sitio de San Ildefonso;5267;2610;2657;2018
40;Segovia;165;Rebollo;84;45;39;2018
40;Segovia;166;Remondo;305;160;145;2018
40;Segovia;168;Riaguas de San Bartolomé;28;18;10;2018
40;Segovia;170;Riaza;2099;1120;979;2018
40;Segovia;171;Ribota;39;31;8;2018
40;Segovia;172;Riofrío de Riaza;38;25;13;2018
40;Segovia;173;Roda de Eresma;185;99;86;2018
40;Segovia;174;Sacramenia;372;196;176;2018
40;Segovia;176;Samboal;463;249;214;2018
40;Segovia;177;San Cristóbal de Cuéllar;148;81;67;2018
40;Segovia;178;San Cristóbal de la Vega;104;57;47;2018
40;Segovia;906;San Cristóbal de Segovia;3021;1519;1502;2018
40;Segovia;182;San Martín y Mudrián;239;114;125;2018
40;Segovia;183;San Miguel de Bernuy;135;68;67;2018
40;Segovia;184;San Pedro de Gaíllos;297;158;139;2018
40;Segovia;179;Sanchonuño;930;450;480;2018
40;Segovia;180;Sangarcía;321;178;143;2018
40;Segovia;185;Santa María la Real de Nieva;999;547;452;2018
40;Segovia;186;Santa Marta del Cerro;39;20;19;2018
40;Segovia;188;Santiuste de Pedraza;94;62;32;2018
40;Segovia;189;Santiuste de San Juan Bautista;556;307;249;2018
40;Segovia;190;Santo Domingo de Pirón;61;35;26;2018
40;Segovia;191;Santo Tomé del Puerto;259;142;117;2018
40;Segovia;192;Sauquillo de Cabezas;154;86;68;2018
40;Segovia;193;Sebúlcor;260;137;123;2018
40;Segovia;194;Segovia;51683;24207;27476;2018
40;Segovia;195;Sepúlveda;1065;550;515;2018
40;Segovia;196;Sequera de Fresno;34;23;11;2018
40;Segovia;198;Sotillo;25;14;11;2018
40;Segovia;199;Sotosalbos;113;60;53;2018
40;Segovia;200;Tabanera la Luenga;51;24;27;2018
40;Segovia;201;Tolocirio;50;24;26;2018
40;Segovia;206;Torre Val de San Pedro;187;96;91;2018
40;Segovia;202;Torreadrada;57;25;32;2018
40;Segovia;203;Torrecaballeros;1323;691;632;2018
40;Segovia;204;Torrecilla del Pinar;194;108;86;2018
40;Segovia;205;Torreiglesias;260;139;121;2018
40;Segovia;207;Trescasas;1052;544;508;2018
40;Segovia;208;Turégano;979;486;493;2018
40;Segovia;210;Urueñas;107;66;41;2018
40;Segovia;211;Valdeprados;70;39;31;2018
40;Segovia;212;Valdevacas de Montejo;30;15;15;2018
40;Segovia;213;Valdevacas y Guijar;91;49;42;2018
40;Segovia;218;Valle de Tabladillo;94;56;38;2018
40;Segovia;219;Vallelado;704;377;327;2018
40;Segovia;220;Valleruela de Pedraza;73;37;36;2018
40;Segovia;221;Valleruela de Sepúlveda;54;27;27;2018
40;Segovia;214;Valseca;241;136;105;2018
40;Segovia;215;Valtiendas;80;46;34;2018
40;Segovia;216;Valverde del Majano;1096;566;530;2018
40;Segovia;222;Veganzones;230;127;103;2018
40;Segovia;223;Vegas de Matute;260;156;104;2018
40;Segovia;224;Ventosilla y Tejadilla;20;12;8;2018
40;Segovia;225;Villacastín;1493;783;710;2018
40;Segovia;228;Villaverde de Íscar;621;327;294;2018
40;Segovia;229;Villaverde de Montejo;27;16;11;2018
40;Segovia;230;Villeguillo;111;65;46;2018
40;Segovia;231;Yanguas de Eresma;134;68;66;2018
40;Segovia;233;Zarzuela del Monte;505;263;242;2018
40;Segovia;234;Zarzuela del Pinar;444;231;213;2018
41;Sevilla;001;Aguadulce;2026;1006;1020;2018
41;Sevilla;002;Alanís;1746;881;865;2018
41;Sevilla;003;Albaida del Aljarafe;3193;1604;1589;2018
41;Sevilla;004;Alcalá de Guadaíra;75256;37383;37873;2018
41;Sevilla;005;Alcalá del Río;11927;6072;5855;2018
41;Sevilla;006;Alcolea del Río;3387;1690;1697;2018
41;Sevilla;007;Algaba, La;16301;8081;8220;2018
41;Sevilla;008;Algámitas;1248;642;606;2018
41;Sevilla;009;Almadén de la Plata;1379;716;663;2018
41;Sevilla;010;Almensilla;6008;2999;3009;2018
41;Sevilla;011;Arahal;19565;9682;9883;2018
41;Sevilla;012;Aznalcázar;4495;2257;2238;2018
41;Sevilla;013;Aznalcóllar;6092;3106;2986;2018
41;Sevilla;014;Badolatosa;3094;1594;1500;2018
41;Sevilla;015;Benacazón;7177;3613;3564;2018
41;Sevilla;016;Bollullos de la Mitación;10647;5336;5311;2018
41;Sevilla;017;Bormujos;21964;10895;11069;2018
41;Sevilla;018;Brenes;12608;6278;6330;2018
41;Sevilla;019;Burguillos;6618;3313;3305;2018
41;Sevilla;020;Cabezas de San Juan, Las;16379;8193;8186;2018
41;Sevilla;021;Camas;27463;13434;14029;2018
41;Sevilla;022;Campana, La;5281;2632;2649;2018
41;Sevilla;023;Cantillana;10661;5443;5218;2018
41;Sevilla;901;Cañada Rosal;3307;1632;1675;2018
41;Sevilla;024;Carmona;28620;14379;14241;2018
41;Sevilla;025;Carrión de los Céspedes;2500;1221;1279;2018
41;Sevilla;026;Casariche;5530;2821;2709;2018
41;Sevilla;027;Castilblanco de los Arroyos;4810;2420;2390;2018
41;Sevilla;028;Castilleja de Guzmán;2826;1455;1371;2018
41;Sevilla;029;Castilleja de la Cuesta;17350;8428;8922;2018
41;Sevilla;030;Castilleja del Campo;625;324;301;2018
41;Sevilla;031;Castillo de las Guardas, El;1439;741;698;2018
41;Sevilla;032;Cazalla de la Sierra;4789;2360;2429;2018
41;Sevilla;033;Constantina;5954;2943;3011;2018
41;Sevilla;034;Coria del Río;30657;15304;15353;2018
41;Sevilla;035;Coripe;1290;637;653;2018
41;Sevilla;036;Coronil, El;4807;2415;2392;2018
41;Sevilla;037;Corrales, Los;3958;2012;1946;2018
41;Sevilla;903;Cuervo de Sevilla, El;8628;4346;4282;2018
41;Sevilla;038;Dos Hermanas;133168;65541;67627;2018
41;Sevilla;039;Écija;39882;19662;20220;2018
41;Sevilla;040;Espartinas;15683;7865;7818;2018
41;Sevilla;041;Estepa;12503;6238;6265;2018
41;Sevilla;042;Fuentes de Andalucía;7139;3557;3582;2018
41;Sevilla;043;Garrobo, El;789;400;389;2018
41;Sevilla;044;Gelves;10054;5007;5047;2018
41;Sevilla;045;Gerena;7541;3791;3750;2018
41;Sevilla;046;Gilena;3790;1902;1888;2018
41;Sevilla;047;Gines;13471;6625;6846;2018
41;Sevilla;048;Guadalcanal;2646;1318;1328;2018
41;Sevilla;049;Guillena;12650;6399;6251;2018
41;Sevilla;050;Herrera;6485;3214;3271;2018
41;Sevilla;051;Huévar del Aljarafe;2944;1508;1436;2018
41;Sevilla;902;Isla Mayor;5857;2923;2934;2018
41;Sevilla;052;Lantejuela;3834;1969;1865;2018
41;Sevilla;053;Lebrija;27432;13695;13737;2018
41;Sevilla;054;Lora de Estepa;860;435;425;2018
41;Sevilla;055;Lora del Río;18861;9351;9510;2018
41;Sevilla;056;Luisiana, La;4572;2307;2265;2018
41;Sevilla;057;Madroño, El;282;141;141;2018
41;Sevilla;058;Mairena del Alcor;23473;11744;11729;2018
41;Sevilla;059;Mairena del Aljarafe;45890;22348;23542;2018
41;Sevilla;060;Marchena;19580;9781;9799;2018
41;Sevilla;061;Marinaleda;2626;1340;1286;2018
41;Sevilla;062;Martín de la Jara;2720;1405;1315;2018
41;Sevilla;063;Molares, Los;3460;1759;1701;2018
41;Sevilla;064;Montellano;7081;3542;3539;2018
41;Sevilla;065;Morón de la Frontera;27844;13728;14116;2018
41;Sevilla;066;Navas de la Concepción, Las;1581;782;799;2018
41;Sevilla;067;Olivares;9390;4710;4680;2018
41;Sevilla;068;Osuna;17622;8780;8842;2018
41;Sevilla;069;Palacios y Villafranca, Los;38246;19220;19026;2018
41;Sevilla;070;Palomares del Río;8552;4311;4241;2018
41;Sevilla;071;Paradas;6924;3446;3478;2018
41;Sevilla;072;Pedrera;5205;2579;2626;2018
41;Sevilla;073;Pedroso, El;2037;1006;1031;2018
41;Sevilla;074;Peñaflor;3669;1844;1825;2018
41;Sevilla;075;Pilas;13949;7021;6928;2018
41;Sevilla;076;Pruna;2658;1360;1298;2018
41;Sevilla;077;Puebla de Cazalla, La;11033;5492;5541;2018
41;Sevilla;078;Puebla de los Infantes, La;3013;1495;1518;2018
41;Sevilla;079;Puebla del Río, La;11879;5879;6000;2018
41;Sevilla;080;Real de la Jara, El;1507;746;761;2018
41;Sevilla;081;Rinconada, La;38406;19013;19393;2018
41;Sevilla;082;Roda de Andalucía, La;4243;2106;2137;2018
41;Sevilla;083;Ronquillo, El;1360;684;676;2018
41;Sevilla;084;Rubio, El;3445;1701;1744;2018
41;Sevilla;085;Salteras;5477;2655;2822;2018
41;Sevilla;086;San Juan de Aznalfarache;21195;10194;11001;2018
41;Sevilla;088;San Nicolás del Puerto;599;310;289;2018
41;Sevilla;087;Sanlúcar la Mayor;13683;6774;6909;2018
41;Sevilla;089;Santiponce;8442;4189;4253;2018
41;Sevilla;090;Saucejo, El;4301;2131;2170;2018
41;Sevilla;091;Sevilla;688711;326935;361776;2018
41;Sevilla;092;Tocina;9578;4755;4823;2018
41;Sevilla;093;Tomares;25220;12451;12769;2018
41;Sevilla;094;Umbrete;8768;4406;4362;2018
41;Sevilla;095;Utrera;52617;26140;26477;2018
41;Sevilla;096;Valencina de la Concepción;7803;3828;3975;2018
41;Sevilla;097;Villamanrique de la Condesa;4478;2214;2264;2018
41;Sevilla;100;Villanueva de San Juan;1155;562;593;2018
41;Sevilla;098;Villanueva del Ariscal;6571;3208;3363;2018
41;Sevilla;099;Villanueva del Río y Minas;4860;2438;2422;2018
41;Sevilla;101;Villaverde del Río;7797;3943;3854;2018
41;Sevilla;102;Viso del Alcor, El;19191;9608;9583;2018
42;Soria;001;Abejar;302;162;140;2018
42;Soria;003;Adradas;44;25;19;2018
42;Soria;004;Ágreda;3008;1535;1473;2018
42;Soria;006;Alconaba;189;119;70;2018
42;Soria;007;Alcubilla de Avellaneda;108;57;51;2018
42;Soria;008;Alcubilla de las Peñas;59;35;24;2018
42;Soria;009;Aldealafuente;87;46;41;2018
42;Soria;010;Aldealices;34;21;13;2018
42;Soria;011;Aldealpozo;18;8;10;2018
42;Soria;012;Aldealseñor;30;16;14;2018
42;Soria;013;Aldehuela de Periáñez;36;21;15;2018
42;Soria;014;Aldehuelas, Las;64;35;29;2018
42;Soria;015;Alentisque;33;20;13;2018
42;Soria;016;Aliud;18;13;5;2018
42;Soria;017;Almajano;183;96;87;2018
42;Soria;018;Almaluez;139;78;61;2018
42;Soria;019;Almarza;572;336;236;2018
42;Soria;020;Almazán;5526;2807;2719;2018
42;Soria;021;Almazul;70;42;28;2018
42;Soria;022;Almenar de Soria;236;138;98;2018
42;Soria;023;Alpanseque;63;38;25;2018
42;Soria;024;Arancón;85;58;27;2018
42;Soria;025;Arcos de Jalón;1489;789;700;2018
42;Soria;026;Arenillas;24;12;12;2018
42;Soria;027;Arévalo de la Sierra;81;50;31;2018
42;Soria;028;Ausejo de la Sierra;90;48;42;2018
42;Soria;029;Baraona;142;82;60;2018
42;Soria;030;Barca;103;63;40;2018
42;Soria;031;Barcones;23;16;7;2018
42;Soria;032;Bayubas de Abajo;147;82;65;2018
42;Soria;033;Bayubas de Arriba;51;31;20;2018
42;Soria;034;Beratón;29;18;11;2018
42;Soria;035;Berlanga de Duero;877;444;433;2018
42;Soria;036;Blacos;44;24;20;2018
42;Soria;037;Bliecos;35;19;16;2018
42;Soria;038;Borjabad;34;21;13;2018
42;Soria;039;Borobia;240;129;111;2018
42;Soria;041;Buberos;33;18;15;2018
42;Soria;042;Buitrago;59;32;27;2018
42;Soria;043;Burgo de Osma-Ciudad de Osma;4926;2452;2474;2018
42;Soria;044;Cabrejas del Campo;56;34;22;2018
42;Soria;045;Cabrejas del Pinar;357;203;154;2018
42;Soria;046;Calatañazor;51;28;23;2018
42;Soria;048;Caltojar;57;38;19;2018
42;Soria;049;Candilichera;115;68;47;2018
42;Soria;050;Cañamaque;32;24;8;2018
42;Soria;051;Carabantes;16;8;8;2018
42;Soria;052;Caracena;15;11;4;2018
42;Soria;053;Carrascosa de Abajo;23;15;8;2018
42;Soria;054;Carrascosa de la Sierra;17;12;5;2018
42;Soria;055;Casarejos;169;87;82;2018
42;Soria;056;Castilfrío de la Sierra;27;19;8;2018
42;Soria;058;Castillejo de Robledo;109;62;47;2018
42;Soria;057;Castilruiz;169;91;78;2018
42;Soria;059;Centenera de Andaluz;21;10;11;2018
42;Soria;060;Cerbón;30;20;10;2018
42;Soria;061;Cidones;298;181;117;2018
42;Soria;062;Cigudosa;18;11;7;2018
42;Soria;063;Cihuela;50;28;22;2018
42;Soria;064;Ciria;86;43;43;2018
42;Soria;065;Cirujales del Río;22;16;6;2018
42;Soria;068;Coscurita;79;49;30;2018
42;Soria;069;Covaleda;1720;890;830;2018
42;Soria;070;Cubilla;35;21;14;2018
42;Soria;071;Cubo de la Solana;198;109;89;2018
42;Soria;073;Cueva de Ágreda;72;45;27;2018
42;Soria;075;Dévanos;83;47;36;2018
42;Soria;076;Deza;216;114;102;2018
42;Soria;078;Duruelo de la Sierra;1111;568;543;2018
42;Soria;079;Escobosa de Almazán;22;15;7;2018
42;Soria;080;Espeja de San Marcelino;168;99;69;2018
42;Soria;081;Espejón;168;89;79;2018
42;Soria;082;Estepa de San Juan;6;5;1;2018
42;Soria;083;Frechilla de Almazán;24;13;11;2018
42;Soria;084;Fresno de Caracena;18;13;5;2018
42;Soria;085;Fuentearmegil;181;105;76;2018
42;Soria;086;Fuentecambrón;36;22;14;2018
42;Soria;087;Fuentecantos;53;27;26;2018
42;Soria;088;Fuentelmonge;65;38;27;2018
42;Soria;089;Fuentelsaz de Soria;65;32;33;2018
42;Soria;090;Fuentepinilla;88;57;31;2018
42;Soria;092;Fuentes de Magaña;61;36;25;2018
42;Soria;093;Fuentestrún;40;27;13;2018
42;Soria;094;Garray;736;398;338;2018
42;Soria;095;Golmayo;2568;1349;1219;2018
42;Soria;096;Gómara;317;175;142;2018
42;Soria;097;Gormaz;21;14;7;2018
42;Soria;098;Herrera de Soria;9;7;2;2018
42;Soria;100;Hinojosa del Campo;31;20;11;2018
42;Soria;103;Langa de Duero;719;399;320;2018
42;Soria;105;Liceras;52;26;26;2018
42;Soria;106;Losilla, La;14;10;4;2018
42;Soria;107;Magaña;73;43;30;2018
42;Soria;108;Maján;13;7;6;2018
42;Soria;110;Matalebreras;63;38;25;2018
42;Soria;111;Matamala de Almazán;301;156;145;2018
42;Soria;113;Medinaceli;721;358;363;2018
42;Soria;115;Miño de Medinaceli;84;50;34;2018
42;Soria;116;Miño de San Esteban;48;31;17;2018
42;Soria;117;Molinos de Duero;161;84;77;2018
42;Soria;118;Momblona;23;16;7;2018
42;Soria;119;Monteagudo de las Vicarías;193;101;92;2018
42;Soria;120;Montejo de Tiermes;153;101;52;2018
42;Soria;121;Montenegro de Cameros;57;36;21;2018
42;Soria;123;Morón de Almazán;200;104;96;2018
42;Soria;124;Muriel de la Fuente;60;35;25;2018
42;Soria;125;Muriel Viejo;86;56;30;2018
42;Soria;127;Nafría de Ucero;31;20;11;2018
42;Soria;128;Narros;49;27;22;2018
42;Soria;129;Navaleno;776;413;363;2018
42;Soria;130;Nepas;53;36;17;2018
42;Soria;131;Nolay;56;30;26;2018
42;Soria;132;Noviercas;150;80;70;2018
42;Soria;134;Ólvega;3626;1879;1747;2018
42;Soria;135;Oncala;70;41;29;2018
42;Soria;139;Pinilla del Campo;20;11;9;2018
42;Soria;140;Portillo de Soria;14;9;5;2018
42;Soria;141;Póveda de Soria, La;106;68;38;2018
42;Soria;142;Pozalmuro;57;27;30;2018
42;Soria;144;Quintana Redonda;488;274;214;2018
42;Soria;145;Quintanas de Gormaz;154;96;58;2018
42;Soria;148;Quiñonería;8;4;4;2018
42;Soria;149;Rábanos, Los;477;267;210;2018
42;Soria;151;Rebollar;38;17;21;2018
42;Soria;152;Recuerda;87;50;37;2018
42;Soria;153;Rello;14;9;5;2018
42;Soria;154;Renieblas;106;65;41;2018
42;Soria;155;Retortillo de Soria;163;96;67;2018
42;Soria;156;Reznos;30;20;10;2018
42;Soria;157;Riba de Escalote, La;9;7;2;2018
42;Soria;158;Rioseco de Soria;126;74;52;2018
42;Soria;159;Rollamienta;39;26;13;2018
42;Soria;160;Royo, El;265;146;119;2018
42;Soria;161;Salduero;144;80;64;2018
42;Soria;162;San Esteban de Gormaz;3010;1580;1430;2018
42;Soria;163;San Felices;55;33;22;2018
42;Soria;164;San Leonardo de Yagüe;2047;1037;1010;2018
42;Soria;165;San Pedro Manrique;617;341;276;2018
42;Soria;166;Santa Cruz de Yanguas;58;36;22;2018
42;Soria;167;Santa María de Huerta;267;148;119;2018
42;Soria;168;Santa María de las Hoyas;102;57;45;2018
42;Soria;171;Serón de Nágima;138;78;60;2018
42;Soria;172;Soliedra;32;17;15;2018
42;Soria;173;Soria;39112;18426;20686;2018
42;Soria;174;Sotillo del Rincón;180;96;84;2018
42;Soria;175;Suellacabras;25;15;10;2018
42;Soria;176;Tajahuerce;28;16;12;2018
42;Soria;177;Tajueco;66;37;29;2018
42;Soria;178;Talveila;118;69;49;2018
42;Soria;181;Tardelcuende;430;229;201;2018
42;Soria;182;Taroda;43;25;18;2018
42;Soria;183;Tejado;106;60;46;2018
42;Soria;184;Torlengua;58;31;27;2018
42;Soria;185;Torreblacos;25;13;12;2018
42;Soria;187;Torrubia de Soria;66;46;20;2018
42;Soria;188;Trévago;52;22;30;2018
42;Soria;189;Ucero;52;28;24;2018
42;Soria;190;Vadillo;90;49;41;2018
42;Soria;191;Valdeavellano de Tera;193;105;88;2018
42;Soria;192;Valdegeña;42;30;12;2018
42;Soria;193;Valdelagua del Cerro;20;11;9;2018
42;Soria;194;Valdemaluque;159;70;89;2018
42;Soria;195;Valdenebro;109;63;46;2018
42;Soria;196;Valdeprado;9;6;3;2018
42;Soria;197;Valderrodilla;71;40;31;2018
42;Soria;198;Valtajeros;25;15;10;2018
42;Soria;200;Velamazán;86;55;31;2018
42;Soria;201;Velilla de la Sierra;25;15;10;2018
42;Soria;202;Velilla de los Ajos;21;11;10;2018
42;Soria;204;Viana de Duero;53;39;14;2018
42;Soria;205;Villaciervos;90;55;35;2018
42;Soria;206;Villanueva de Gormaz;8;6;2;2018
42;Soria;207;Villar del Ala;50;26;24;2018
42;Soria;208;Villar del Campo;22;15;7;2018
42;Soria;209;Villar del Río;145;90;55;2018
42;Soria;211;Villares de Soria, Los;87;51;36;2018
42;Soria;212;Villasayas;70;46;24;2018
42;Soria;213;Villaseca de Arciel;34;19;15;2018
42;Soria;215;Vinuesa;874;468;406;2018
42;Soria;216;Vizmanos;27;19;8;2018
42;Soria;217;Vozmediano;36;23;13;2018
42;Soria;218;Yanguas;92;58;34;2018
42;Soria;219;Yelo;38;23;15;2018
43;Tarragona;001;Aiguamúrcia;893;457;436;2018
43;Tarragona;002;Albinyana;2371;1202;1169;2018
43;Tarragona;003;Albiol, L';464;238;226;2018
43;Tarragona;004;Alcanar;9402;4754;4648;2018
43;Tarragona;005;Alcover;5108;2533;2575;2018
43;Tarragona;904;Aldea, L';4137;2186;1951;2018
43;Tarragona;006;Aldover;838;420;418;2018
43;Tarragona;007;Aleixar, L';864;442;422;2018
43;Tarragona;008;Alfara de Carles;368;195;173;2018
43;Tarragona;009;Alforja;1788;916;872;2018
43;Tarragona;010;Alió;426;200;226;2018
43;Tarragona;011;Almoster;1342;671;671;2018
43;Tarragona;012;Altafulla;5120;2491;2629;2018
43;Tarragona;013;Ametlla de Mar, L';6801;3398;3403;2018
43;Tarragona;906;Ampolla, L';3280;1670;1610;2018
43;Tarragona;014;Amposta;20606;10351;10255;2018
43;Tarragona;016;Arboç, L';5505;2836;2669;2018
43;Tarragona;015;Arbolí;116;68;48;2018
43;Tarragona;017;Argentera, L';129;74;55;2018
43;Tarragona;018;Arnes;466;232;234;2018
43;Tarragona;019;Ascó;1674;871;803;2018
43;Tarragona;020;Banyeres del Penedès;3128;1583;1545;2018
43;Tarragona;021;Barberà de la Conca;476;258;218;2018
43;Tarragona;022;Batea;1898;944;954;2018
43;Tarragona;023;Bellmunt del Priorat;300;156;144;2018
43;Tarragona;024;Bellvei;2190;1120;1070;2018
43;Tarragona;025;Benifallet;714;342;372;2018
43;Tarragona;026;Benissanet;1142;620;522;2018
43;Tarragona;027;Bisbal de Falset, La;219;119;100;2018
43;Tarragona;028;Bisbal del Penedès, La;3464;1836;1628;2018
43;Tarragona;029;Blancafort;379;198;181;2018
43;Tarragona;030;Bonastre;687;350;337;2018
43;Tarragona;031;Borges del Camp, Les;2080;1060;1020;2018
43;Tarragona;032;Bot;601;305;296;2018
43;Tarragona;033;Botarell;1070;554;516;2018
43;Tarragona;034;Bràfim;673;333;340;2018
43;Tarragona;035;Cabacés;305;159;146;2018
43;Tarragona;036;Cabra del Camp;1141;597;544;2018
43;Tarragona;037;Calafell;25444;12767;12677;2018
43;Tarragona;903;Camarles;3278;1666;1612;2018
43;Tarragona;038;Cambrils;33362;16307;17055;2018
43;Tarragona;907;Canonja, La;5842;2858;2984;2018
43;Tarragona;039;Capafonts;96;51;45;2018
43;Tarragona;040;Capçanes;398;200;198;2018
43;Tarragona;041;Caseres;235;116;119;2018
43;Tarragona;042;Castellvell del Camp;2868;1438;1430;2018
43;Tarragona;043;Catllar, El;4344;2253;2091;2018
43;Tarragona;045;Colldejou;170;90;80;2018
43;Tarragona;046;Conesa;103;54;49;2018
43;Tarragona;047;Constantí;6516;3411;3105;2018
43;Tarragona;048;Corbera d'Ebre;1023;531;492;2018
43;Tarragona;049;Cornudella de Montsant;964;510;454;2018
43;Tarragona;050;Creixell;3526;1788;1738;2018
43;Tarragona;051;Cunit;12326;6016;6310;2018
43;Tarragona;901;Deltebre;11505;5792;5713;2018
43;Tarragona;053;Duesaigües;237;137;100;2018
43;Tarragona;054;Espluga de Francolí, L';3742;1810;1932;2018
43;Tarragona;055;Falset;2807;1405;1402;2018
43;Tarragona;056;Fatarella, La;965;475;490;2018
43;Tarragona;057;Febró, La;42;27;15;2018
43;Tarragona;058;Figuera, La;104;59;45;2018
43;Tarragona;059;Figuerola del Camp;315;156;159;2018
43;Tarragona;060;Flix;3491;1751;1740;2018
43;Tarragona;061;Forès;42;25;17;2018
43;Tarragona;062;Freginals;369;188;181;2018
43;Tarragona;063;Galera, La;719;372;347;2018
43;Tarragona;064;Gandesa;3009;1534;1475;2018
43;Tarragona;065;Garcia;525;269;256;2018
43;Tarragona;066;Garidells, Els;201;97;104;2018
43;Tarragona;067;Ginestar;762;403;359;2018
43;Tarragona;068;Godall;591;291;300;2018
43;Tarragona;069;Gratallops;226;126;100;2018
43;Tarragona;070;Guiamets, Els;270;125;145;2018
43;Tarragona;071;Horta de Sant Joan;1146;598;548;2018
43;Tarragona;072;Lloar, El;118;62;56;2018
43;Tarragona;073;Llorac;100;56;44;2018
43;Tarragona;074;Llorenç del Penedès;2327;1146;1181;2018
43;Tarragona;076;Marçà;599;320;279;2018
43;Tarragona;075;Margalef;94;57;37;2018
43;Tarragona;077;Mas de Barberans;577;285;292;2018
43;Tarragona;078;Masdenverge;1066;544;522;2018
43;Tarragona;079;Masllorenç;498;275;223;2018
43;Tarragona;080;Masó, La;276;150;126;2018
43;Tarragona;081;Maspujols;799;410;389;2018
43;Tarragona;082;Masroig, El;498;275;223;2018
43;Tarragona;083;Milà, El;183;90;93;2018
43;Tarragona;084;Miravet;706;380;326;2018
43;Tarragona;085;Molar, El;281;147;134;2018
43;Tarragona;086;Montblanc;7384;3738;3646;2018
43;Tarragona;088;Montbrió del Camp;2828;1456;1372;2018
43;Tarragona;089;Montferri;383;206;177;2018
43;Tarragona;090;Montmell, El;1437;764;673;2018
43;Tarragona;091;Mont-ral;167;98;69;2018
43;Tarragona;092;Mont-roig del Camp;11809;6140;5669;2018
43;Tarragona;093;Móra d'Ebre;5642;2798;2844;2018
43;Tarragona;094;Móra la Nova;3071;1525;1546;2018
43;Tarragona;095;Morell, El;3649;1848;1801;2018
43;Tarragona;096;Morera de Montsant, La;157;87;70;2018
43;Tarragona;097;Nou de Gaià, La;570;282;288;2018
43;Tarragona;098;Nulles;477;256;221;2018
43;Tarragona;100;Pallaresos, Els;4739;2384;2355;2018
43;Tarragona;099;Palma d'Ebre, La;353;168;185;2018
43;Tarragona;101;Passanant i Belltall;150;87;63;2018
43;Tarragona;102;Paüls;561;274;287;2018
43;Tarragona;103;Perafort;1265;657;608;2018
43;Tarragona;104;Perelló, El;2863;1478;1385;2018
43;Tarragona;105;Piles, Les;210;115;95;2018
43;Tarragona;106;Pinell de Brai, El;998;501;497;2018
43;Tarragona;107;Pira;503;268;235;2018
43;Tarragona;108;Pla de Santa Maria, El;2305;1195;1110;2018
43;Tarragona;109;Pobla de Mafumet, La;3893;1981;1912;2018
43;Tarragona;110;Pobla de Massaluca, La;328;180;148;2018
43;Tarragona;111;Pobla de Montornès, La;2828;1485;1343;2018
43;Tarragona;112;Poboleda;335;182;153;2018
43;Tarragona;113;Pont d'Armentera, El;512;259;253;2018
43;Tarragona;141;Pontils;114;63;51;2018
43;Tarragona;114;Porrera;441;232;209;2018
43;Tarragona;115;Pradell de la Teixeta;159;71;88;2018
43;Tarragona;116;Prades;589;307;282;2018
43;Tarragona;117;Prat de Comte;179;96;83;2018
43;Tarragona;118;Pratdip;709;374;335;2018
43;Tarragona;119;Puigpelat;1151;586;565;2018
43;Tarragona;120;Querol;521;296;225;2018
43;Tarragona;121;Rasquera;787;387;400;2018
43;Tarragona;122;Renau;153;80;73;2018
43;Tarragona;123;Reus;103477;50030;53447;2018
43;Tarragona;124;Riba, La;576;318;258;2018
43;Tarragona;125;Riba-roja d'Ebre;1112;589;523;2018
43;Tarragona;126;Riera de Gaià, La;1701;845;856;2018
43;Tarragona;127;Riudecanyes;1131;591;540;2018
43;Tarragona;128;Riudecols;1186;622;564;2018
43;Tarragona;129;Riudoms;6565;3375;3190;2018
43;Tarragona;130;Rocafort de Queralt;260;140;120;2018
43;Tarragona;131;Roda de Berà;6461;3305;3156;2018
43;Tarragona;132;Rodonyà;480;258;222;2018
43;Tarragona;133;Roquetes;7961;4111;3850;2018
43;Tarragona;134;Rourell, El;384;197;187;2018
43;Tarragona;135;Salomó;564;298;266;2018
43;Tarragona;905;Salou;26775;13856;12919;2018
43;Tarragona;136;Sant Carles de la Ràpita;14611;7123;7488;2018
43;Tarragona;137;Sant Jaume dels Domenys;2551;1314;1237;2018
43;Tarragona;902;Sant Jaume d'Enveja;3481;1734;1747;2018
43;Tarragona;138;Santa Bàrbara;3777;1916;1861;2018
43;Tarragona;139;Santa Coloma de Queralt;2697;1336;1361;2018
43;Tarragona;140;Santa Oliva;3328;1681;1647;2018
43;Tarragona;142;Sarral;1544;779;765;2018
43;Tarragona;143;Savallà del Comtat;60;32;28;2018
43;Tarragona;144;Secuita, La;1697;846;851;2018
43;Tarragona;145;Selva del Camp, La;5632;2824;2808;2018
43;Tarragona;146;Senan;47;32;15;2018
43;Tarragona;044;Sénia, La;5644;2840;2804;2018
43;Tarragona;147;Solivella;619;318;301;2018
43;Tarragona;148;Tarragona;132299;64282;68017;2018
43;Tarragona;149;Tivenys;882;451;431;2018
43;Tarragona;150;Tivissa;1639;816;823;2018
43;Tarragona;151;Torre de Fontaubella, La;137;71;66;2018
43;Tarragona;152;Torre de l'Espanyol, La;628;325;303;2018
43;Tarragona;153;Torredembarra;15992;7821;8171;2018
43;Tarragona;154;Torroja del Priorat;148;82;66;2018
43;Tarragona;155;Tortosa;33510;16607;16903;2018
43;Tarragona;156;Ulldecona;6240;3209;3031;2018
43;Tarragona;157;Ulldemolins;402;229;173;2018
43;Tarragona;158;Vallclara;98;59;39;2018
43;Tarragona;159;Vallfogona de Riucorb;85;51;34;2018
43;Tarragona;160;Vallmoll;1738;879;859;2018
43;Tarragona;161;Valls;24156;12031;12125;2018
43;Tarragona;162;Vandellòs i l'Hospitalet de l'Infant;6386;3195;3191;2018
43;Tarragona;163;Vendrell, El;37153;18452;18701;2018
43;Tarragona;164;Vespella de Gaià;410;229;181;2018
43;Tarragona;165;Vilabella;746;386;360;2018
43;Tarragona;175;Vilalba dels Arcs;635;321;314;2018
43;Tarragona;166;Vilallonga del Camp;2339;1185;1154;2018
43;Tarragona;168;Vilanova de Prades;117;63;54;2018
43;Tarragona;167;Vilanova d'Escornalbou;549;285;264;2018
43;Tarragona;169;Vilaplana;579;299;280;2018
43;Tarragona;170;Vila-rodona;1253;655;598;2018
43;Tarragona;171;Vila-seca;22107;11083;11024;2018
43;Tarragona;172;Vilaverd;456;237;219;2018
43;Tarragona;173;Vilella Alta, La;132;74;58;2018
43;Tarragona;174;Vilella Baixa, La;202;111;91;2018
43;Tarragona;176;Vimbodí i Poblet;917;505;412;2018
43;Tarragona;177;Vinebre;432;222;210;2018
43;Tarragona;178;Vinyols i els Arcs;1974;1030;944;2018
43;Tarragona;052;Xerta;1170;570;600;2018
44;Teruel;001;Ababuj;76;48;28;2018
44;Teruel;002;Abejuela;49;31;18;2018
44;Teruel;003;Aguatón;18;6;12;2018
44;Teruel;004;Aguaviva;522;258;264;2018
44;Teruel;005;Aguilar del Alfambra;63;36;27;2018
44;Teruel;006;Alacón;264;134;130;2018
44;Teruel;007;Alba;178;98;80;2018
44;Teruel;008;Albalate del Arzobispo;2004;1023;981;2018
44;Teruel;009;Albarracín;1016;517;499;2018
44;Teruel;010;Albentosa;257;137;120;2018
44;Teruel;011;Alcaine;63;38;25;2018
44;Teruel;012;Alcalá de la Selva;347;193;154;2018
44;Teruel;013;Alcañiz;15939;7919;8020;2018
44;Teruel;014;Alcorisa;3276;1656;1620;2018
44;Teruel;016;Alfambra;531;281;250;2018
44;Teruel;017;Aliaga;358;200;158;2018
44;Teruel;021;Allepuz;126;63;63;2018
44;Teruel;022;Alloza;582;295;287;2018
44;Teruel;023;Allueva;29;16;13;2018
44;Teruel;018;Almohaja;16;11;5;2018
44;Teruel;019;Alobras;62;37;25;2018
44;Teruel;020;Alpeñés;22;13;9;2018
44;Teruel;024;Anadón;27;17;10;2018
44;Teruel;025;Andorra;7633;3847;3786;2018
44;Teruel;026;Arcos de las Salinas;105;61;44;2018
44;Teruel;027;Arens de Lledó;206;103;103;2018
44;Teruel;028;Argente;198;96;102;2018
44;Teruel;029;Ariño;708;355;353;2018
44;Teruel;031;Azaila;94;46;48;2018
44;Teruel;032;Bádenas;20;12;8;2018
44;Teruel;033;Báguena;311;172;139;2018
44;Teruel;034;Bañón;153;86;67;2018
44;Teruel;035;Barrachina;118;64;54;2018
44;Teruel;036;Bea;31;18;13;2018
44;Teruel;037;Beceite;541;273;268;2018
44;Teruel;039;Bello;225;107;118;2018
44;Teruel;038;Belmonte de San José;113;54;59;2018
44;Teruel;040;Berge;244;125;119;2018
44;Teruel;041;Bezas;70;44;26;2018
44;Teruel;042;Blancas;125;74;51;2018
44;Teruel;043;Blesa;95;62;33;2018
44;Teruel;044;Bordón;106;57;49;2018
44;Teruel;045;Bronchales;443;252;191;2018
44;Teruel;046;Bueña;63;34;29;2018
44;Teruel;047;Burbáguena;243;130;113;2018
44;Teruel;048;Cabra de Mora;55;31;24;2018
44;Teruel;049;Calaceite;1011;503;508;2018
44;Teruel;050;Calamocha;4319;2138;2181;2018
44;Teruel;051;Calanda;3708;1842;1866;2018
44;Teruel;052;Calomarde;74;45;29;2018
44;Teruel;053;Camañas;124;69;55;2018
44;Teruel;054;Camarena de la Sierra;113;71;42;2018
44;Teruel;055;Camarillas;86;52;34;2018
44;Teruel;056;Caminreal;619;321;298;2018
44;Teruel;059;Cantavieja;714;373;341;2018
44;Teruel;060;Cañada de Benatanduz;39;25;14;2018
44;Teruel;061;Cañada de Verich, La;87;53;34;2018
44;Teruel;062;Cañada Vellida;35;25;10;2018
44;Teruel;063;Cañizar del Olivar;98;52;46;2018
44;Teruel;064;Cascante del Río;71;43;28;2018
44;Teruel;065;Castejón de Tornos;62;39;23;2018
44;Teruel;066;Castel de Cabra;104;58;46;2018
44;Teruel;070;Castellar, El;52;34;18;2018
44;Teruel;071;Castellote;676;349;327;2018
44;Teruel;067;Castelnou;160;82;78;2018
44;Teruel;068;Castelserás;831;432;399;2018
44;Teruel;074;Cedrillas;630;310;320;2018
44;Teruel;075;Celadas;396;227;169;2018
44;Teruel;076;Cella;2606;1351;1255;2018
44;Teruel;077;Cerollera, La;100;62;38;2018
44;Teruel;080;Codoñera, La;344;183;161;2018
44;Teruel;082;Corbalán;109;58;51;2018
44;Teruel;084;Cortes de Aragón;61;27;34;2018
44;Teruel;085;Cosa;52;31;21;2018
44;Teruel;086;Cretas;571;289;282;2018
44;Teruel;087;Crivillén;68;33;35;2018
44;Teruel;088;Cuba, La;41;26;15;2018
44;Teruel;089;Cubla;54;36;18;2018
44;Teruel;090;Cucalón;80;46;34;2018
44;Teruel;092;Cuervo, El;86;47;39;2018
44;Teruel;093;Cuevas de Almudén;122;69;53;2018
44;Teruel;094;Cuevas Labradas;131;70;61;2018
44;Teruel;096;Ejulve;180;91;89;2018
44;Teruel;097;Escorihuela;139;68;71;2018
44;Teruel;099;Escucha;885;472;413;2018
44;Teruel;100;Estercuel;210;115;95;2018
44;Teruel;101;Ferreruela de Huerva;63;35;28;2018
44;Teruel;102;Fonfría;28;16;12;2018
44;Teruel;103;Formiche Alto;151;86;65;2018
44;Teruel;105;Fórnoles;75;39;36;2018
44;Teruel;106;Fortanete;205;113;92;2018
44;Teruel;107;Foz-Calanda;238;130;108;2018
44;Teruel;108;Fresneda, La;443;247;196;2018
44;Teruel;109;Frías de Albarracín;116;67;49;2018
44;Teruel;110;Fuenferrada;42;24;18;2018
44;Teruel;111;Fuentes Calientes;101;58;43;2018
44;Teruel;112;Fuentes Claras;461;249;212;2018
44;Teruel;113;Fuentes de Rubielos;114;60;54;2018
44;Teruel;114;Fuentespalda;286;145;141;2018
44;Teruel;115;Galve;161;83;78;2018
44;Teruel;116;Gargallo;89;48;41;2018
44;Teruel;117;Gea de Albarracín;376;200;176;2018
44;Teruel;118;Ginebrosa, La;200;108;92;2018
44;Teruel;119;Griegos;143;85;58;2018
44;Teruel;120;Guadalaviar;242;138;104;2018
44;Teruel;121;Gúdar;72;39;33;2018
44;Teruel;122;Híjar;1709;866;843;2018
44;Teruel;123;Hinojosa de Jarque;119;67;52;2018
44;Teruel;124;Hoz de la Vieja, La;85;44;41;2018
44;Teruel;125;Huesa del Común;67;41;26;2018
44;Teruel;126;Iglesuela del Cid, La;414;216;198;2018
44;Teruel;127;Jabaloyas;65;37;28;2018
44;Teruel;128;Jarque de la Val;70;37;33;2018
44;Teruel;129;Jatiel;40;25;15;2018
44;Teruel;130;Jorcas;34;19;15;2018
44;Teruel;131;Josa;34;20;14;2018
44;Teruel;132;Lagueruela;78;42;36;2018
44;Teruel;133;Lanzuela;24;17;7;2018
44;Teruel;135;Libros;101;63;38;2018
44;Teruel;136;Lidón;55;29;26;2018
44;Teruel;137;Linares de Mora;249;144;105;2018
44;Teruel;141;Lledó;172;90;82;2018
44;Teruel;138;Loscos;129;78;51;2018
44;Teruel;142;Maicas;27;15;12;2018
44;Teruel;143;Manzanera;519;274;245;2018
44;Teruel;144;Martín del Río;417;210;207;2018
44;Teruel;145;Mas de las Matas;1272;664;608;2018
44;Teruel;146;Mata de los Olmos, La;265;131;134;2018
44;Teruel;147;Mazaleón;539;285;254;2018
44;Teruel;148;Mezquita de Jarque;98;58;40;2018
44;Teruel;149;Mirambel;116;67;49;2018
44;Teruel;150;Miravete de la Sierra;35;23;12;2018
44;Teruel;151;Molinos;243;125;118;2018
44;Teruel;152;Monforte de Moyuela;65;46;19;2018
44;Teruel;153;Monreal del Campo;2433;1208;1225;2018
44;Teruel;154;Monroyo;340;201;139;2018
44;Teruel;155;Montalbán;1243;623;620;2018
44;Teruel;156;Monteagudo del Castillo;50;27;23;2018
44;Teruel;157;Monterde de Albarracín;63;35;28;2018
44;Teruel;158;Mora de Rubielos;1541;769;772;2018
44;Teruel;159;Moscardón;55;30;25;2018
44;Teruel;160;Mosqueruela;551;300;251;2018
44;Teruel;161;Muniesa;599;311;288;2018
44;Teruel;163;Noguera de Albarracín;133;72;61;2018
44;Teruel;164;Nogueras;25;16;9;2018
44;Teruel;165;Nogueruelas;217;123;94;2018
44;Teruel;167;Obón;45;24;21;2018
44;Teruel;168;Odón;205;108;97;2018
44;Teruel;169;Ojos Negros;377;206;171;2018
44;Teruel;171;Olba;226;129;97;2018
44;Teruel;172;Oliete;364;190;174;2018
44;Teruel;173;Olmos, Los;122;67;55;2018
44;Teruel;174;Orihuela del Tremedal;487;267;220;2018
44;Teruel;175;Orrios;126;68;58;2018
44;Teruel;176;Palomar de Arroyos;169;99;70;2018
44;Teruel;177;Pancrudo;110;64;46;2018
44;Teruel;178;Parras de Castellote, Las;53;30;23;2018
44;Teruel;179;Peñarroya de Tastavins;439;242;197;2018
44;Teruel;180;Peracense;76;42;34;2018
44;Teruel;181;Peralejos;88;49;39;2018
44;Teruel;182;Perales del Alfambra;221;118;103;2018
44;Teruel;183;Pitarque;79;42;37;2018
44;Teruel;184;Plou;43;28;15;2018
44;Teruel;185;Pobo, El;114;73;41;2018
44;Teruel;187;Portellada, La;243;121;122;2018
44;Teruel;189;Pozondón;48;29;19;2018
44;Teruel;190;Pozuel del Campo;68;36;32;2018
44;Teruel;191;Puebla de Híjar, La;908;456;452;2018
44;Teruel;192;Puebla de Valverde, La;453;253;200;2018
44;Teruel;193;Puertomingalvo;112;58;54;2018
44;Teruel;194;Ráfales;143;84;59;2018
44;Teruel;195;Rillo;93;54;39;2018
44;Teruel;196;Riodeva;144;67;77;2018
44;Teruel;197;Ródenas;61;33;28;2018
44;Teruel;198;Royuela;206;113;93;2018
44;Teruel;199;Rubiales;50;28;22;2018
44;Teruel;200;Rubielos de la Cérida;38;23;15;2018
44;Teruel;201;Rubielos de Mora;627;327;300;2018
44;Teruel;203;Salcedillo;17;11;6;2018
44;Teruel;204;Saldón;26;17;9;2018
44;Teruel;205;Samper de Calanda;783;395;388;2018
44;Teruel;206;San Agustín;125;79;46;2018
44;Teruel;207;San Martín del Río;148;78;70;2018
44;Teruel;208;Santa Cruz de Nogueras;37;18;19;2018
44;Teruel;209;Santa Eulalia;1037;528;509;2018
44;Teruel;210;Sarrión;1133;591;542;2018
44;Teruel;211;Segura de los Baños;39;25;14;2018
44;Teruel;212;Seno;39;17;22;2018
44;Teruel;213;Singra;80;45;35;2018
44;Teruel;215;Terriente;183;103;80;2018
44;Teruel;216;Teruel;35691;16974;18717;2018
44;Teruel;217;Toril y Masegoso;30;25;5;2018
44;Teruel;218;Tormón;31;19;12;2018
44;Teruel;219;Tornos;213;112;101;2018
44;Teruel;220;Torralba de los Sisones;156;86;70;2018
44;Teruel;223;Torre de Arcas;89;43;46;2018
44;Teruel;224;Torre de las Arcas;28;15;13;2018
44;Teruel;225;Torre del Compte;132;63;69;2018
44;Teruel;227;Torre los Negros;88;45;43;2018
44;Teruel;221;Torrecilla de Alcañiz;423;218;205;2018
44;Teruel;222;Torrecilla del Rebollar;127;83;44;2018
44;Teruel;226;Torrelacárcel;154;81;73;2018
44;Teruel;228;Torremocha de Jiloca;107;60;47;2018
44;Teruel;229;Torres de Albarracín;183;105;78;2018
44;Teruel;230;Torrevelilla;189;95;94;2018
44;Teruel;231;Torrijas;38;15;23;2018
44;Teruel;232;Torrijo del Campo;447;237;210;2018
44;Teruel;234;Tramacastiel;64;39;25;2018
44;Teruel;235;Tramacastilla;106;53;53;2018
44;Teruel;236;Tronchón;65;32;33;2018
44;Teruel;237;Urrea de Gaén;436;217;219;2018
44;Teruel;238;Utrillas;2970;1534;1436;2018
44;Teruel;239;Valacloche;21;11;10;2018
44;Teruel;240;Valbona;174;97;77;2018
44;Teruel;241;Valdealgorfa;622;308;314;2018
44;Teruel;243;Valdecuenca;35;21;14;2018
44;Teruel;244;Valdelinares;87;50;37;2018
44;Teruel;245;Valdeltormo;279;135;144;2018
44;Teruel;246;Valderrobres;2388;1207;1181;2018
44;Teruel;247;Valjunquera;325;164;161;2018
44;Teruel;249;Vallecillo, El;48;28;20;2018
44;Teruel;250;Veguillas de la Sierra;20;12;8;2018
44;Teruel;251;Villafranca del Campo;297;153;144;2018
44;Teruel;252;Villahermosa del Campo;94;60;34;2018
44;Teruel;256;Villanueva del Rebollar de la Sierra;47;27;20;2018
44;Teruel;257;Villar del Cobo;164;96;68;2018
44;Teruel;258;Villar del Salz;60;37;23;2018
44;Teruel;260;Villarluengo;177;105;72;2018
44;Teruel;261;Villarquemado;862;448;414;2018
44;Teruel;262;Villarroya de los Pinares;160;86;74;2018
44;Teruel;263;Villastar;494;252;242;2018
44;Teruel;264;Villel;327;182;145;2018
44;Teruel;265;Vinaceite;249;133;116;2018
44;Teruel;266;Visiedo;125;54;71;2018
44;Teruel;267;Vivel del Río Martín;79;38;41;2018
44;Teruel;268;Zoma, La;16;5;11;2018
45;Toledo;001;Ajofrín;2244;1116;1128;2018
45;Toledo;002;Alameda de la Sagra;3562;1874;1688;2018
45;Toledo;003;Albarreal de Tajo;692;359;333;2018
45;Toledo;004;Alcabón;669;347;322;2018
45;Toledo;005;Alcañizo;275;139;136;2018
45;Toledo;006;Alcaudete de la Jara;1703;843;860;2018
45;Toledo;007;Alcolea de Tajo;797;394;403;2018
45;Toledo;008;Aldea en Cabo;162;87;75;2018
45;Toledo;009;Aldeanueva de Barbarroya;542;273;269;2018
45;Toledo;010;Aldeanueva de San Bartolomé;434;218;216;2018
45;Toledo;011;Almendral de la Cañada;305;160;145;2018
45;Toledo;012;Almonacid de Toledo;783;388;395;2018
45;Toledo;013;Almorox;2159;1133;1026;2018
45;Toledo;014;Añover de Tajo;5032;2571;2461;2018
45;Toledo;015;Arcicóllar;829;411;418;2018
45;Toledo;016;Argés;6341;3166;3175;2018
45;Toledo;017;Azután;289;142;147;2018
45;Toledo;018;Barcience;856;445;411;2018
45;Toledo;019;Bargas;10092;5061;5031;2018
45;Toledo;020;Belvís de la Jara;1529;763;766;2018
45;Toledo;021;Borox;3706;1936;1770;2018
45;Toledo;022;Buenaventura;430;220;210;2018
45;Toledo;023;Burguillos de Toledo;3184;1641;1543;2018
45;Toledo;024;Burujón;1308;672;636;2018
45;Toledo;025;Cabañas de la Sagra;1789;922;867;2018
45;Toledo;026;Cabañas de Yepes;240;124;116;2018
45;Toledo;027;Cabezamesada;347;187;160;2018
45;Toledo;028;Calera y Chozas;4640;2351;2289;2018
45;Toledo;029;Caleruela;210;103;107;2018
45;Toledo;030;Calzada de Oropesa;539;300;239;2018
45;Toledo;031;Camarena;3745;1950;1795;2018
45;Toledo;032;Camarenilla;556;282;274;2018
45;Toledo;033;Campillo de la Jara, El;364;190;174;2018
45;Toledo;034;Camuñas;1740;893;847;2018
45;Toledo;035;Cardiel de los Montes;342;183;159;2018
45;Toledo;036;Carmena;731;373;358;2018
45;Toledo;037;Carpio de Tajo, El;1872;944;928;2018
45;Toledo;038;Carranque;4761;2469;2292;2018
45;Toledo;039;Carriches;271;136;135;2018
45;Toledo;040;Casar de Escalona, El;1743;935;808;2018
45;Toledo;041;Casarrubios del Monte;5422;2853;2569;2018
45;Toledo;042;Casasbuenas;208;103;105;2018
45;Toledo;043;Castillo de Bayuela;917;455;462;2018
45;Toledo;045;Cazalegas;1725;898;827;2018
45;Toledo;046;Cebolla;3263;1650;1613;2018
45;Toledo;047;Cedillo del Condado;3687;1915;1772;2018
45;Toledo;048;Cerralbos, Los;418;230;188;2018
45;Toledo;049;Cervera de los Montes;509;258;251;2018
45;Toledo;056;Chozas de Canales;3765;1969;1796;2018
45;Toledo;057;Chueca;261;139;122;2018
45;Toledo;050;Ciruelos;532;281;251;2018
45;Toledo;051;Cobeja;2206;1141;1065;2018
45;Toledo;052;Cobisa;4269;2150;2119;2018
45;Toledo;053;Consuegra;10098;5101;4997;2018
45;Toledo;054;Corral de Almaguer;5355;2755;2600;2018
45;Toledo;055;Cuerva;1335;693;642;2018
45;Toledo;058;Domingo Pérez;404;209;195;2018
45;Toledo;059;Dosbarrios;2201;1132;1069;2018
45;Toledo;060;Erustes;207;107;100;2018
45;Toledo;061;Escalona;3199;1648;1551;2018
45;Toledo;062;Escalonilla;1437;715;722;2018
45;Toledo;063;Espinoso del Rey;439;244;195;2018
45;Toledo;064;Esquivias;5449;2744;2705;2018
45;Toledo;065;Estrella, La;233;122;111;2018
45;Toledo;066;Fuensalida;11032;5580;5452;2018
45;Toledo;067;Gálvez;3016;1508;1508;2018
45;Toledo;068;Garciotum;187;98;89;2018
45;Toledo;069;Gerindote;2289;1158;1131;2018
45;Toledo;070;Guadamur;1781;897;884;2018
45;Toledo;071;Guardia, La;2236;1127;1109;2018
45;Toledo;072;Herencias, Las;798;428;370;2018
45;Toledo;073;Herreruela de Oropesa;334;169;165;2018
45;Toledo;074;Hinojosa de San Vicente;394;217;177;2018
45;Toledo;075;Hontanar;152;92;60;2018
45;Toledo;076;Hormigos;680;361;319;2018
45;Toledo;077;Huecas;683;351;332;2018
45;Toledo;078;Huerta de Valdecarábanos;1681;827;854;2018
45;Toledo;079;Iglesuela, La;406;211;195;2018
45;Toledo;080;Illán de Vacas;5;4;1;2018
45;Toledo;081;Illescas;28064;14238;13826;2018
45;Toledo;082;Lagartera;1405;699;706;2018
45;Toledo;083;Layos;685;339;346;2018
45;Toledo;084;Lillo;2600;1353;1247;2018
45;Toledo;085;Lominchar;2345;1228;1117;2018
45;Toledo;086;Lucillos;573;304;269;2018
45;Toledo;087;Madridejos;10532;5281;5251;2018
45;Toledo;088;Magán;3401;1739;1662;2018
45;Toledo;089;Malpica de Tajo;1732;889;843;2018
45;Toledo;090;Manzaneque;396;191;205;2018
45;Toledo;091;Maqueda;461;227;234;2018
45;Toledo;092;Marjaliza;255;125;130;2018
45;Toledo;093;Marrupe;153;80;73;2018
45;Toledo;094;Mascaraque;439;223;216;2018
45;Toledo;095;Mata, La;853;427;426;2018
45;Toledo;096;Mazarambroz;1258;647;611;2018
45;Toledo;097;Mejorada;1265;652;613;2018
45;Toledo;098;Menasalbas;2702;1423;1279;2018
45;Toledo;099;Méntrida;4957;2545;2412;2018
45;Toledo;100;Mesegar de Tajo;222;118;104;2018
45;Toledo;101;Miguel Esteban;4908;2453;2455;2018
45;Toledo;102;Mocejón;4829;2436;2393;2018
45;Toledo;103;Mohedas de la Jara;407;226;181;2018
45;Toledo;104;Montearagón;506;268;238;2018
45;Toledo;105;Montesclaros;408;218;190;2018
45;Toledo;106;Mora;9737;4889;4848;2018
45;Toledo;107;Nambroca;4610;2361;2249;2018
45;Toledo;108;Nava de Ricomalillo, La;538;278;260;2018
45;Toledo;109;Navahermosa;3647;1882;1765;2018
45;Toledo;110;Navalcán;2042;1080;962;2018
45;Toledo;111;Navalmoralejo;62;32;30;2018
45;Toledo;112;Navalmorales, Los;2567;1351;1216;2018
45;Toledo;113;Navalucillos, Los;2171;1111;1060;2018
45;Toledo;114;Navamorcuende;626;315;311;2018
45;Toledo;115;Noblejas;3486;1771;1715;2018
45;Toledo;116;Noez;881;448;433;2018
45;Toledo;117;Nombela;883;466;417;2018
45;Toledo;118;Novés;2767;1419;1348;2018
45;Toledo;119;Numancia de la Sagra;4846;2534;2312;2018
45;Toledo;120;Nuño Gómez;131;74;57;2018
45;Toledo;121;Ocaña;11067;5593;5474;2018
45;Toledo;122;Olías del Rey;7657;3936;3721;2018
45;Toledo;123;Ontígola;4279;2269;2010;2018
45;Toledo;124;Orgaz;2624;1311;1313;2018
45;Toledo;125;Oropesa;2658;1308;1350;2018
45;Toledo;126;Otero;338;177;161;2018
45;Toledo;127;Palomeque;907;487;420;2018
45;Toledo;128;Pantoja;3238;1629;1609;2018
45;Toledo;129;Paredes de Escalona;119;58;61;2018
45;Toledo;130;Parrillas;343;184;159;2018
45;Toledo;131;Pelahustán;305;174;131;2018
45;Toledo;132;Pepino;2907;1502;1405;2018
45;Toledo;133;Polán;3788;1891;1897;2018
45;Toledo;134;Portillo de Toledo;2188;1098;1090;2018
45;Toledo;135;Puebla de Almoradiel, La;5278;2676;2602;2018
45;Toledo;136;Puebla de Montalbán, La;7811;3969;3842;2018
45;Toledo;137;Pueblanueva, La;2188;1103;1085;2018
45;Toledo;138;Puente del Arzobispo, El;1246;620;626;2018
45;Toledo;139;Puerto de San Vicente;161;86;75;2018
45;Toledo;140;Pulgar;1521;776;745;2018
45;Toledo;141;Quero;1006;513;493;2018
45;Toledo;142;Quintanar de la Orden;10918;5413;5505;2018
45;Toledo;143;Quismondo;1511;773;738;2018
45;Toledo;144;Real de San Vicente, El;945;509;436;2018
45;Toledo;145;Recas;4206;2311;1895;2018
45;Toledo;146;Retamoso de la Jara;105;54;51;2018
45;Toledo;147;Rielves;741;375;366;2018
45;Toledo;148;Robledo del Mazo;289;163;126;2018
45;Toledo;149;Romeral, El;594;295;299;2018
45;Toledo;150;San Bartolomé de las Abiertas;438;235;203;2018
45;Toledo;151;San Martín de Montalbán;726;360;366;2018
45;Toledo;152;San Martín de Pusa;694;362;332;2018
45;Toledo;153;San Pablo de los Montes;1805;907;898;2018
45;Toledo;154;San Román de los Montes;1871;996;875;2018
45;Toledo;155;Santa Ana de Pusa;365;206;159;2018
45;Toledo;156;Santa Cruz de la Zarza;4238;2142;2096;2018
45;Toledo;157;Santa Cruz del Retamar;2946;1546;1400;2018
45;Toledo;158;Santa Olalla;3217;1649;1568;2018
45;Toledo;901;Santo Domingo-Caudilla;1024;534;490;2018
45;Toledo;159;Sartajada;100;60;40;2018
45;Toledo;160;Segurilla;1353;678;675;2018
45;Toledo;161;Seseña;24255;12499;11756;2018
45;Toledo;162;Sevilleja de la Jara;698;379;319;2018
45;Toledo;163;Sonseca;11021;5558;5463;2018
45;Toledo;164;Sotillo de las Palomas;193;103;90;2018
45;Toledo;165;Talavera de la Reina;83009;39867;43142;2018
45;Toledo;166;Tembleque;1996;1014;982;2018
45;Toledo;167;Toboso, El;1783;890;893;2018
45;Toledo;168;Toledo;84282;40242;44040;2018
45;Toledo;169;Torralba de Oropesa;213;110;103;2018
45;Toledo;171;Torre de Esteban Hambrán, La;1702;866;836;2018
45;Toledo;170;Torrecilla de la Jara;225;122;103;2018
45;Toledo;172;Torrico;731;373;358;2018
45;Toledo;173;Torrijos;13278;6544;6734;2018
45;Toledo;174;Totanés;346;174;172;2018
45;Toledo;175;Turleque;768;394;374;2018
45;Toledo;176;Ugena;5336;2755;2581;2018
45;Toledo;177;Urda;2558;1274;1284;2018
45;Toledo;179;Valdeverdeja;586;283;303;2018
45;Toledo;180;Valmojado;4218;2136;2082;2018
45;Toledo;181;Velada;2865;1490;1375;2018
45;Toledo;182;Ventas con Peña Aguilera, Las;1127;572;555;2018
45;Toledo;183;Ventas de Retamosa, Las;3268;1716;1552;2018
45;Toledo;184;Ventas de San Julián, Las;229;113;116;2018
45;Toledo;186;Villa de Don Fadrique, La;3723;1853;1870;2018
45;Toledo;185;Villacañas;9689;4823;4866;2018
45;Toledo;187;Villafranca de los Caballeros;4929;2454;2475;2018
45;Toledo;188;Villaluenga de la Sagra;3769;1887;1882;2018
45;Toledo;189;Villamiel de Toledo;867;445;422;2018
45;Toledo;190;Villaminaya;539;272;267;2018
45;Toledo;191;Villamuelas;620;325;295;2018
45;Toledo;192;Villanueva de Alcardete;3298;1717;1581;2018
45;Toledo;193;Villanueva de Bogas;728;375;353;2018
45;Toledo;194;Villarejo de Montalbán;73;38;35;2018
45;Toledo;195;Villarrubia de Santiago;2582;1282;1300;2018
45;Toledo;196;Villaseca de la Sagra;1793;897;896;2018
45;Toledo;197;Villasequilla;2496;1279;1217;2018
45;Toledo;198;Villatobas;2390;1227;1163;2018
45;Toledo;199;Viso de San Juan, El;4351;2334;2017;2018
45;Toledo;200;Yébenes, Los;5983;3061;2922;2018
45;Toledo;201;Yeles;5164;2706;2458;2018
45;Toledo;202;Yepes;5083;2621;2462;2018
45;Toledo;203;Yuncler;3759;1916;1843;2018
45;Toledo;204;Yunclillos;809;419;390;2018
45;Toledo;205;Yuncos;10968;5618;5350;2018
46;Valencia/València;001;Ademuz;1046;557;489;2018
46;Valencia/València;002;Ador;1393;739;654;2018
46;Valencia/València;004;Agullent;2413;1203;1210;2018
46;Valencia/València;042;Aielo de Malferit;4646;2327;2319;2018
46;Valencia/València;043;Aielo de Rugat;155;84;71;2018
46;Valencia/València;005;Alaquàs;29341;14382;14959;2018
46;Valencia/València;006;Albaida;5908;2933;2975;2018
46;Valencia/València;007;Albal;16270;8138;8132;2018
46;Valencia/València;008;Albalat de la Ribera;3329;1669;1660;2018
46;Valencia/València;009;Albalat dels Sorells;3944;1933;2011;2018
46;Valencia/València;010;Albalat dels Tarongers;1202;632;570;2018
46;Valencia/València;011;Alberic;10556;5230;5326;2018
46;Valencia/València;012;Alborache;1127;593;534;2018
46;Valencia/València;013;Alboraia/Alboraya;24222;11838;12384;2018
46;Valencia/València;014;Albuixech;3983;1947;2036;2018
46;Valencia/València;016;Alcàntera de Xúquer;1297;646;651;2018
46;Valencia/València;015;Alcàsser;9908;4975;4933;2018
46;Valencia/València;018;Alcublas;654;350;304;2018
46;Valencia/València;020;Alcúdia de Crespins, l';5188;2586;2602;2018
46;Valencia/València;019;Alcúdia, l';11938;5850;6088;2018
46;Valencia/València;021;Aldaia;31492;15691;15801;2018
46;Valencia/València;022;Alfafar;20763;10174;10589;2018
46;Valencia/València;024;Alfara de la Baronia;539;267;272;2018
46;Valencia/València;025;Alfara del Patriarca;3314;1604;1710;2018
46;Valencia/València;026;Alfarp;1532;792;740;2018
46;Valencia/València;027;Alfarrasí;1262;625;637;2018
46;Valencia/València;023;Alfauir;440;226;214;2018
46;Valencia/València;028;Algar de Palancia;470;245;225;2018
46;Valencia/València;029;Algemesí;27285;13559;13726;2018
46;Valencia/València;030;Algimia de Alfara;1019;510;509;2018
46;Valencia/València;031;Alginet;13100;6634;6466;2018
46;Valencia/València;032;Almàssera;7295;3558;3737;2018
46;Valencia/València;033;Almiserà;258;133;125;2018
46;Valencia/València;034;Almoines;2379;1200;1179;2018
46;Valencia/València;035;Almussafes;8932;4465;4467;2018
46;Valencia/València;036;Alpuente;637;353;284;2018
46;Valencia/València;037;Alqueria de la Comtessa, l';1418;687;731;2018
46;Valencia/València;017;Alzira;44393;21685;22708;2018
46;Valencia/València;038;Andilla;303;198;105;2018
46;Valencia/València;039;Anna;2638;1321;1317;2018
46;Valencia/València;040;Antella;1209;592;617;2018
46;Valencia/València;041;Aras de los Olmos;374;211;163;2018
46;Valencia/València;003;Atzeneta d'Albaida;1162;586;576;2018
46;Valencia/València;044;Ayora;5276;2624;2652;2018
46;Valencia/València;046;Barx;1229;638;591;2018
46;Valencia/València;045;Barxeta;1604;822;782;2018
46;Valencia/València;047;Bèlgida;672;326;346;2018
46;Valencia/València;048;Bellreguard;4549;2274;2275;2018
46;Valencia/València;049;Bellús;314;165;149;2018
46;Valencia/València;050;Benagéber;190;108;82;2018
46;Valencia/València;051;Benaguasil;10878;5555;5323;2018
46;Valencia/València;052;Benavites;594;280;314;2018
46;Valencia/València;053;Beneixida;648;327;321;2018
46;Valencia/València;054;Benetússer;14668;7128;7540;2018
46;Valencia/València;055;Beniarjó;1746;880;866;2018
46;Valencia/València;056;Beniatjar;224;117;107;2018
46;Valencia/València;057;Benicolet;582;291;291;2018
46;Valencia/València;904;Benicull de Xúquer;974;483;491;2018
46;Valencia/València;060;Benifaió;11930;5918;6012;2018
46;Valencia/València;059;Benifairó de la Valldigna;1580;789;791;2018
46;Valencia/València;058;Benifairó de les Valls;2168;1084;1084;2018
46;Valencia/València;061;Beniflá;455;234;221;2018
46;Valencia/València;062;Benigànim;5899;2986;2913;2018
46;Valencia/València;063;Benimodo;2241;1137;1104;2018
46;Valencia/València;064;Benimuslem;660;346;314;2018
46;Valencia/València;065;Beniparrell;1931;985;946;2018
46;Valencia/València;066;Benirredrà;1576;769;807;2018
46;Valencia/València;067;Benissanó;2224;1113;1111;2018
46;Valencia/València;068;Benissoda;418;226;192;2018
46;Valencia/València;069;Benissuera;180;88;92;2018
46;Valencia/València;070;Bétera;23647;11817;11830;2018
46;Valencia/València;071;Bicorp;524;264;260;2018
46;Valencia/València;072;Bocairent;4214;2131;2083;2018
46;Valencia/València;073;Bolbaite;1347;677;670;2018
46;Valencia/València;074;Bonrepòs i Mirambell;3645;1792;1853;2018
46;Valencia/València;075;Bufali;159;85;74;2018
46;Valencia/València;076;Bugarra;715;367;348;2018
46;Valencia/València;077;Buñol;9517;4759;4758;2018
46;Valencia/València;078;Burjassot;37584;18125;19459;2018
46;Valencia/València;079;Calles;342;193;149;2018
46;Valencia/València;080;Camporrobles;1195;613;582;2018
46;Valencia/València;081;Canals;13588;6799;6789;2018
46;Valencia/València;082;Canet d'En Berenguer;6575;3367;3208;2018
46;Valencia/València;083;Carcaixent;20424;10107;10317;2018
46;Valencia/València;084;Càrcer;1876;889;987;2018
46;Valencia/València;085;Carlet;15514;7726;7788;2018
46;Valencia/València;086;Carrícola;93;49;44;2018
46;Valencia/València;087;Casas Altas;136;73;63;2018
46;Valencia/València;088;Casas Bajas;172;89;83;2018
46;Valencia/València;089;Casinos;2773;1429;1344;2018
46;Valencia/València;090;Castelló de Rugat;2275;1157;1118;2018
46;Valencia/València;091;Castellonet de la Conquesta;145;77;68;2018
46;Valencia/València;092;Castielfabib;306;160;146;2018
46;Valencia/València;093;Catadau;2830;1416;1414;2018
46;Valencia/València;094;Catarroja;27827;13736;14091;2018
46;Valencia/València;095;Caudete de las Fuentes;696;360;336;2018
46;Valencia/València;096;Cerdà;334;180;154;2018
46;Valencia/València;107;Chella;2469;1221;1248;2018
46;Valencia/València;106;Chelva;1498;773;725;2018
46;Valencia/València;108;Chera;494;267;227;2018
46;Valencia/València;109;Cheste;8319;4249;4070;2018
46;Valencia/València;111;Chiva;14941;7673;7268;2018
46;Valencia/València;112;Chulilla;615;325;290;2018
46;Valencia/València;097;Cofrentes;1125;573;552;2018
46;Valencia/València;098;Corbera;3160;1564;1596;2018
46;Valencia/València;099;Cortes de Pallás;818;450;368;2018
46;Valencia/València;100;Cotes;332;170;162;2018
46;Valencia/València;105;Cullera;21918;10910;11008;2018
46;Valencia/València;113;Daimús;3128;1554;1574;2018
46;Valencia/València;114;Domeño;704;362;342;2018
46;Valencia/València;115;Dos Aguas;355;203;152;2018
46;Valencia/València;116;Eliana, l';18050;8780;9270;2018
46;Valencia/València;117;Emperador;692;358;334;2018
46;Valencia/València;118;Enguera;4800;2369;2431;2018
46;Valencia/València;119;Ènova, l';903;458;445;2018
46;Valencia/València;120;Estivella;1432;693;739;2018
46;Valencia/València;121;Estubeny;122;61;61;2018
46;Valencia/València;122;Faura;3547;1783;1764;2018
46;Valencia/València;123;Favara;2490;1269;1221;2018
46;Valencia/València;126;Foios;7342;3626;3716;2018
46;Valencia/València;128;Font de la Figuera, la;2038;1021;1017;2018
46;Valencia/València;127;Font d'En Carròs, la;3790;1882;1908;2018
46;Valencia/València;124;Fontanars dels Alforins;979;496;483;2018
46;Valencia/València;125;Fortaleny;1030;513;517;2018
46;Valencia/València;129;Fuenterrobles;682;376;306;2018
46;Valencia/València;131;Gandia;73829;36295;37534;2018
46;Valencia/València;902;Gátova;392;184;208;2018
46;Valencia/València;130;Gavarda;1058;510;548;2018
46;Valencia/València;132;Genovés;2828;1427;1401;2018
46;Valencia/València;133;Gestalgar;554;297;257;2018
46;Valencia/València;134;Gilet;3276;1704;1572;2018
46;Valencia/València;135;Godella;13058;6334;6724;2018
46;Valencia/València;136;Godelleta;3462;1771;1691;2018
46;Valencia/València;137;Granja de la Costera, la;297;145;152;2018
46;Valencia/València;138;Guadasséquies;444;232;212;2018
46;Valencia/València;139;Guadassuar;5914;2904;3010;2018
46;Valencia/València;140;Guardamar de la Safor;491;257;234;2018
46;Valencia/València;141;Higueruelas;508;270;238;2018
46;Valencia/València;142;Jalance;845;433;412;2018
46;Valencia/València;144;Jarafuel;776;404;372;2018
46;Valencia/València;154;Llanera de Ranes;1049;525;524;2018
46;Valencia/València;155;Llaurí;1209;623;586;2018
46;Valencia/València;147;Llíria;22972;11633;11339;2018
46;Valencia/València;152;Llocnou de la Corona;118;62;56;2018
46;Valencia/València;153;Llocnou de Sant Jeroni;542;271;271;2018
46;Valencia/València;151;Llocnou d'En Fenollet;893;466;427;2018
46;Valencia/València;156;Llombai;2686;1344;1342;2018
46;Valencia/València;157;Llosa de Ranes, la;3585;1832;1753;2018
46;Valencia/València;150;Llutxent;2373;1221;1152;2018
46;Valencia/València;148;Loriguilla;1984;1018;966;2018
46;Valencia/València;149;Losa del Obispo;504;263;241;2018
46;Valencia/València;158;Macastre;1240;657;583;2018
46;Valencia/València;159;Manises;30693;15128;15565;2018
46;Valencia/València;160;Manuel;2439;1193;1246;2018
46;Valencia/València;161;Marines;1828;959;869;2018
46;Valencia/València;162;Massalavés;1575;833;742;2018
46;Valencia/València;163;Massalfassar;2480;1232;1248;2018
46;Valencia/València;164;Massamagrell;15752;7800;7952;2018
46;Valencia/València;165;Massanassa;9538;4741;4797;2018
46;Valencia/València;166;Meliana;10662;5231;5431;2018
46;Valencia/València;167;Millares;346;180;166;2018
46;Valencia/València;168;Miramar;2599;1342;1257;2018
46;Valencia/València;169;Mislata;43278;21001;22277;2018
46;Valencia/València;170;Mogente/Moixent;4318;2161;2157;2018
46;Valencia/València;171;Moncada;21802;10668;11134;2018
46;Valencia/València;173;Montaverner;1631;820;811;2018
46;Valencia/València;174;Montesa;1180;601;579;2018
46;Valencia/València;175;Montitxelvo/Montichelvo;605;301;304;2018
46;Valencia/València;176;Montroi/Montroy;2822;1509;1313;2018
46;Valencia/València;172;Montserrat;7583;3939;3644;2018
46;Valencia/València;177;Museros;6291;3187;3104;2018
46;Valencia/València;178;Náquera;6205;3240;2965;2018
46;Valencia/València;179;Navarrés;2975;1500;1475;2018
46;Valencia/València;180;Novelé/Novetlè;838;415;423;2018
46;Valencia/València;181;Oliva;25199;12380;12819;2018
46;Valencia/València;183;Olleria, l';8225;4124;4101;2018
46;Valencia/València;182;Olocau;1766;932;834;2018
46;Valencia/València;184;Ontinyent;35395;17493;17902;2018
46;Valencia/València;185;Otos;446;226;220;2018
46;Valencia/València;186;Paiporta;25309;12536;12773;2018
46;Valencia/València;187;Palma de Gandía;1543;797;746;2018
46;Valencia/València;188;Palmera;1047;544;503;2018
46;Valencia/València;189;Palomar, el;576;292;284;2018
46;Valencia/València;190;Paterna;69156;34254;34902;2018
46;Valencia/València;191;Pedralba;2777;1460;1317;2018
46;Valencia/València;192;Petrés;969;481;488;2018
46;Valencia/València;193;Picanya;11409;5652;5757;2018
46;Valencia/València;194;Picassent;20709;10439;10270;2018
46;Valencia/València;195;Piles;2688;1359;1329;2018
46;Valencia/València;196;Pinet;156;77;79;2018
46;Valencia/València;199;Pobla de Farnals, la;7840;3940;3900;2018
46;Valencia/València;202;Pobla de Vallbona, la;24068;12112;11956;2018
46;Valencia/València;200;Pobla del Duc, la;2537;1236;1301;2018
46;Valencia/València;203;Pobla Llarga, la;4482;2254;2228;2018
46;Valencia/València;197;Polinyà de Xúquer;2459;1237;1222;2018
46;Valencia/València;198;Potries;1014;513;501;2018
46;Valencia/València;205;Puçol;19455;9561;9894;2018
46;Valencia/València;201;Puebla de San Miguel;61;38;23;2018
46;Valencia/València;204;Puig de Santa Maria, el;8566;4180;4386;2018
46;Valencia/València;101;Quart de les Valls;992;473;519;2018
46;Valencia/València;102;Quart de Poblet;24536;11978;12558;2018
46;Valencia/València;103;Quartell;1561;746;815;2018
46;Valencia/València;104;Quatretonda;2239;1127;1112;2018
46;Valencia/València;206;Quesa;662;348;314;2018
46;Valencia/València;207;Rafelbunyol;8929;4392;4537;2018
46;Valencia/València;208;Rafelcofer;1358;668;690;2018
46;Valencia/València;209;Rafelguaraf;2370;1180;1190;2018
46;Valencia/València;210;Ráfol de Salem;440;217;223;2018
46;Valencia/València;212;Real;2152;1105;1047;2018
46;Valencia/València;211;Real de Gandia, el;2395;1170;1225;2018
46;Valencia/València;213;Requena;20227;10093;10134;2018
46;Valencia/València;214;Riba-roja de Túria;21992;11157;10835;2018
46;Valencia/València;215;Riola;1734;880;854;2018
46;Valencia/València;216;Rocafort;7160;3504;3656;2018
46;Valencia/València;217;Rotglà i Corberà;1114;560;554;2018
46;Valencia/València;218;Rótova;1262;645;617;2018
46;Valencia/València;219;Rugat;162;84;78;2018
46;Valencia/València;220;Sagunto/Sagunt;65669;32173;33496;2018
46;Valencia/València;221;Salem;433;220;213;2018
46;Valencia/València;903;San Antonio de Benagéber;8846;4374;4472;2018
46;Valencia/València;222;Sant Joanet;486;240;246;2018
46;Valencia/València;223;Sedaví;10245;4990;5255;2018
46;Valencia/València;224;Segart;158;82;76;2018
46;Valencia/València;225;Sellent;379;190;189;2018
46;Valencia/València;226;Sempere;35;18;17;2018
46;Valencia/València;227;Senyera;1143;571;572;2018
46;Valencia/València;228;Serra;3091;1585;1506;2018
46;Valencia/València;229;Siete Aguas;1171;633;538;2018
46;Valencia/València;230;Silla;18467;9170;9297;2018
46;Valencia/València;231;Simat de la Valldigna;3325;1657;1668;2018
46;Valencia/València;232;Sinarcas;1124;583;541;2018
46;Valencia/València;233;Sollana;4884;2381;2503;2018
46;Valencia/València;234;Sot de Chera;352;192;160;2018
46;Valencia/València;235;Sueca;27460;13531;13929;2018
46;Valencia/València;236;Sumacàrcer;1109;555;554;2018
46;Valencia/València;237;Tavernes Blanques;9117;4477;4640;2018
46;Valencia/València;238;Tavernes de la Valldigna;17158;8554;8604;2018
46;Valencia/València;239;Teresa de Cofrentes;650;334;316;2018
46;Valencia/València;240;Terrateig;280;144;136;2018
46;Valencia/València;241;Titaguas;459;241;218;2018
46;Valencia/València;242;Torrebaja;397;213;184;2018
46;Valencia/València;243;Torrella;148;83;65;2018
46;Valencia/València;244;Torrent;81245;40037;41208;2018
46;Valencia/València;245;Torres Torres;640;334;306;2018
46;Valencia/València;246;Tous;1254;629;625;2018
46;Valencia/València;247;Tuéjar;1132;599;533;2018
46;Valencia/València;248;Turís;6623;3470;3153;2018
46;Valencia/València;249;Utiel;11540;5759;5781;2018
46;Valencia/València;250;València;791413;376748;414665;2018
46;Valencia/València;251;Vallada;3036;1538;1498;2018
46;Valencia/València;252;Vallanca;126;65;61;2018
46;Valencia/València;253;Vallés;157;85;72;2018
46;Valencia/València;254;Venta del Moro;1242;665;577;2018
46;Valencia/València;255;Vilallonga/Villalonga;4303;2095;2208;2018
46;Valencia/València;256;Vilamarxant;9550;4952;4598;2018
46;Valencia/València;257;Villanueva de Castellón;7095;3501;3594;2018
46;Valencia/València;258;Villar del Arzobispo;3579;1815;1764;2018
46;Valencia/València;259;Villargordo del Cabriel;586;307;279;2018
46;Valencia/València;260;Vinalesa;3380;1643;1737;2018
46;Valencia/València;145;Xàtiva;29045;14194;14851;2018
46;Valencia/València;143;Xeraco;5702;2880;2822;2018
46;Valencia/València;146;Xeresa;2145;1103;1042;2018
46;Valencia/València;110;Xirivella;29108;14385;14723;2018
46;Valencia/València;261;Yátova;2073;1068;1005;2018
46;Valencia/València;262;Yesa, La;227;120;107;2018
46;Valencia/València;263;Zarra;365;200;165;2018
47;Valladolid;001;Adalia;58;36;22;2018
47;Valladolid;002;Aguasal;23;16;7;2018
47;Valladolid;003;Aguilar de Campos;244;142;102;2018
47;Valladolid;004;Alaejos;1382;740;642;2018
47;Valladolid;005;Alcazarén;640;345;295;2018
47;Valladolid;006;Aldea de San Miguel;222;120;102;2018
47;Valladolid;007;Aldeamayor de San Martín;5455;2816;2639;2018
47;Valladolid;008;Almenara de Adaja;21;10;11;2018
47;Valladolid;009;Amusquillo;105;68;37;2018
47;Valladolid;010;Arroyo de la Encomienda;19632;9884;9748;2018
47;Valladolid;011;Ataquines;549;306;243;2018
47;Valladolid;012;Bahabón;108;50;58;2018
47;Valladolid;013;Barcial de la Loma;96;54;42;2018
47;Valladolid;014;Barruelo del Valle;56;36;20;2018
47;Valladolid;015;Becilla de Valderaduey;244;134;110;2018
47;Valladolid;016;Benafarces;68;35;33;2018
47;Valladolid;017;Bercero;210;115;95;2018
47;Valladolid;018;Berceruelo;39;24;15;2018
47;Valladolid;019;Berrueces;95;53;42;2018
47;Valladolid;020;Bobadilla del Campo;298;169;129;2018
47;Valladolid;021;Bocigas;84;47;37;2018
47;Valladolid;022;Bocos de Duero;61;26;35;2018
47;Valladolid;023;Boecillo;4154;2124;2030;2018
47;Valladolid;024;Bolaños de Campos;304;164;140;2018
47;Valladolid;025;Brahojos de Medina;120;62;58;2018
47;Valladolid;026;Bustillo de Chaves;68;40;28;2018
47;Valladolid;027;Cabezón de Pisuerga;3693;1878;1815;2018
47;Valladolid;028;Cabezón de Valderaduey;36;20;16;2018
47;Valladolid;029;Cabreros del Monte;58;33;25;2018
47;Valladolid;030;Campaspero;1102;602;500;2018
47;Valladolid;031;Campillo, El;228;135;93;2018
47;Valladolid;032;Camporredondo;155;90;65;2018
47;Valladolid;033;Canalejas de Peñafiel;228;128;100;2018
47;Valladolid;034;Canillas de Esgueva;72;43;29;2018
47;Valladolid;035;Carpio;1024;542;482;2018
47;Valladolid;036;Casasola de Arión;244;137;107;2018
47;Valladolid;037;Castrejón de Trabancos;174;84;90;2018
47;Valladolid;038;Castrillo de Duero;110;65;45;2018
47;Valladolid;039;Castrillo-Tejeriego;179;102;77;2018
47;Valladolid;040;Castrobol;63;33;30;2018
47;Valladolid;041;Castrodeza;161;94;67;2018
47;Valladolid;042;Castromembibre;65;42;23;2018
47;Valladolid;043;Castromonte;309;178;131;2018
47;Valladolid;044;Castronuevo de Esgueva;372;198;174;2018
47;Valladolid;045;Castronuño;861;430;431;2018
47;Valladolid;046;Castroponce;147;82;65;2018
47;Valladolid;047;Castroverde de Cerrato;225;140;85;2018
47;Valladolid;048;Ceinos de Campos;225;123;102;2018
47;Valladolid;049;Cervillego de la Cruz;94;54;40;2018
47;Valladolid;050;Cigales;5160;2634;2526;2018
47;Valladolid;051;Ciguñuela;381;201;180;2018
47;Valladolid;052;Cistérniga;9049;4572;4477;2018
47;Valladolid;053;Cogeces de Íscar;144;71;73;2018
47;Valladolid;054;Cogeces del Monte;691;373;318;2018
47;Valladolid;055;Corcos;209;114;95;2018
47;Valladolid;056;Corrales de Duero;100;58;42;2018
47;Valladolid;057;Cubillas de Santa Marta;307;176;131;2018
47;Valladolid;058;Cuenca de Campos;226;116;110;2018
47;Valladolid;059;Curiel de Duero;126;79;47;2018
47;Valladolid;060;Encinas de Esgueva;257;151;106;2018
47;Valladolid;061;Esguevillas de Esgueva;272;145;127;2018
47;Valladolid;062;Fombellida;173;99;74;2018
47;Valladolid;063;Fompedraza;110;57;53;2018
47;Valladolid;064;Fontihoyuelo;34;20;14;2018
47;Valladolid;065;Fresno el Viejo;913;487;426;2018
47;Valladolid;066;Fuensaldaña;1640;844;796;2018
47;Valladolid;067;Fuente el Sol;156;81;75;2018
47;Valladolid;068;Fuente-Olmedo;35;17;18;2018
47;Valladolid;069;Gallegos de Hornija;129;67;62;2018
47;Valladolid;070;Gatón de Campos;34;18;16;2018
47;Valladolid;071;Geria;524;248;276;2018
47;Valladolid;073;Herrín de Campos;127;63;64;2018
47;Valladolid;074;Hornillos de Eresma;166;97;69;2018
47;Valladolid;075;Íscar;6370;3191;3179;2018
47;Valladolid;076;Laguna de Duero;22645;11251;11394;2018
47;Valladolid;077;Langayo;246;158;88;2018
47;Valladolid;079;Llano de Olmedo;61;32;29;2018
47;Valladolid;078;Lomoviejo;175;94;81;2018
47;Valladolid;080;Manzanillo;55;27;28;2018
47;Valladolid;081;Marzales;48;24;24;2018
47;Valladolid;082;Matapozuelos;1045;536;509;2018
47;Valladolid;083;Matilla de los Caños;107;63;44;2018
47;Valladolid;084;Mayorga;1590;797;793;2018
47;Valladolid;086;Medina de Rioseco;4716;2311;2405;2018
47;Valladolid;085;Medina del Campo;20583;9976;10607;2018
47;Valladolid;087;Megeces;428;224;204;2018
47;Valladolid;088;Melgar de Abajo;110;59;51;2018
47;Valladolid;089;Melgar de Arriba;157;86;71;2018
47;Valladolid;090;Mojados;3252;1708;1544;2018
47;Valladolid;091;Monasterio de Vega;78;42;36;2018
47;Valladolid;092;Montealegre de Campos;116;69;47;2018
47;Valladolid;093;Montemayor de Pililla;884;480;404;2018
47;Valladolid;094;Moral de la Reina;158;89;69;2018
47;Valladolid;095;Moraleja de las Panaderas;41;26;15;2018
47;Valladolid;096;Morales de Campos;142;74;68;2018
47;Valladolid;097;Mota del Marqués;366;193;173;2018
47;Valladolid;098;Mucientes;669;340;329;2018
47;Valladolid;099;Mudarra, La;159;80;79;2018
47;Valladolid;100;Muriel;139;78;61;2018
47;Valladolid;101;Nava del Rey;2039;1043;996;2018
47;Valladolid;102;Nueva Villa de las Torres;294;165;129;2018
47;Valladolid;103;Olivares de Duero;313;173;140;2018
47;Valladolid;104;Olmedo;3654;1797;1857;2018
47;Valladolid;105;Olmos de Esgueva;212;115;97;2018
47;Valladolid;106;Olmos de Peñafiel;57;31;26;2018
47;Valladolid;109;Palazuelo de Vedija;190;100;90;2018
47;Valladolid;110;Parrilla, La;484;244;240;2018
47;Valladolid;111;Pedraja de Portillo, La;1142;580;562;2018
47;Valladolid;112;Pedrajas de San Esteban;3322;1705;1617;2018
47;Valladolid;113;Pedrosa del Rey;185;103;82;2018
47;Valladolid;114;Peñafiel;5090;2540;2550;2018
47;Valladolid;115;Peñaflor de Hornija;298;170;128;2018
47;Valladolid;116;Pesquera de Duero;457;251;206;2018
47;Valladolid;117;Piña de Esgueva;330;170;160;2018
47;Valladolid;118;Piñel de Abajo;167;95;72;2018
47;Valladolid;119;Piñel de Arriba;91;50;41;2018
47;Valladolid;121;Pollos;593;313;280;2018
47;Valladolid;122;Portillo;2454;1291;1163;2018
47;Valladolid;123;Pozal de Gallinas;541;302;239;2018
47;Valladolid;124;Pozaldez;496;261;235;2018
47;Valladolid;125;Pozuelo de la Orden;55;31;24;2018
47;Valladolid;126;Puras;48;27;21;2018
47;Valladolid;127;Quintanilla de Arriba;158;88;70;2018
47;Valladolid;129;Quintanilla de Onésimo;1019;535;484;2018
47;Valladolid;130;Quintanilla de Trigueros;105;54;51;2018
47;Valladolid;128;Quintanilla del Molar;61;28;33;2018
47;Valladolid;131;Rábano;182;97;85;2018
47;Valladolid;132;Ramiro;47;27;20;2018
47;Valladolid;133;Renedo de Esgueva;3764;1922;1842;2018
47;Valladolid;134;Roales de Campos;161;88;73;2018
47;Valladolid;135;Robladillo;97;56;41;2018
47;Valladolid;137;Roturas;32;19;13;2018
47;Valladolid;138;Rubí de Bracamonte;235;132;103;2018
47;Valladolid;139;Rueda;1285;663;622;2018
47;Valladolid;140;Saelices de Mayorga;114;73;41;2018
47;Valladolid;141;Salvador de Zapardiel;130;74;56;2018
47;Valladolid;142;San Cebrián de Mazote;140;86;54;2018
47;Valladolid;143;San Llorente;117;65;52;2018
47;Valladolid;144;San Martín de Valvení;86;48;38;2018
47;Valladolid;145;San Miguel del Arroyo;671;355;316;2018
47;Valladolid;146;San Miguel del Pino;339;178;161;2018
47;Valladolid;147;San Pablo de la Moraleja;113;60;53;2018
47;Valladolid;148;San Pedro de Latarce;495;263;232;2018
47;Valladolid;149;San Pelayo;51;25;26;2018
47;Valladolid;150;San Román de Hornija;328;161;167;2018
47;Valladolid;151;San Salvador;29;15;14;2018
47;Valladolid;156;San Vicente del Palacio;168;89;79;2018
47;Valladolid;152;Santa Eufemia del Arroyo;91;50;41;2018
47;Valladolid;153;Santervás de Campos;115;60;55;2018
47;Valladolid;154;Santibáñez de Valcorba;158;90;68;2018
47;Valladolid;155;Santovenia de Pisuerga;4346;2231;2115;2018
47;Valladolid;157;Sardón de Duero;583;310;273;2018
47;Valladolid;158;Seca, La;1094;555;539;2018
47;Valladolid;159;Serrada;1135;595;540;2018
47;Valladolid;160;Siete Iglesias de Trabancos;431;229;202;2018
47;Valladolid;161;Simancas;5242;2659;2583;2018
47;Valladolid;162;Tamariz de Campos;55;31;24;2018
47;Valladolid;163;Tiedra;294;142;152;2018
47;Valladolid;164;Tordehumos;433;233;200;2018
47;Valladolid;165;Tordesillas;8825;4477;4348;2018
47;Valladolid;169;Torre de Esgueva;71;36;35;2018
47;Valladolid;170;Torre de Peñafiel;42;24;18;2018
47;Valladolid;166;Torrecilla de la Abadesa;275;134;141;2018
47;Valladolid;167;Torrecilla de la Orden;247;127;120;2018
47;Valladolid;168;Torrecilla de la Torre;33;21;12;2018
47;Valladolid;171;Torrelobatón;425;223;202;2018
47;Valladolid;172;Torrescárcela;150;79;71;2018
47;Valladolid;173;Traspinedo;1089;589;500;2018
47;Valladolid;174;Trigueros del Valle;298;164;134;2018
47;Valladolid;175;Tudela de Duero;8547;4364;4183;2018
47;Valladolid;176;Unión de Campos, La;238;122;116;2018
47;Valladolid;177;Urones de Castroponce;102;61;41;2018
47;Valladolid;178;Urueña;188;104;84;2018
47;Valladolid;179;Valbuena de Duero;471;251;220;2018
47;Valladolid;180;Valdearcos de la Vega;61;32;29;2018
47;Valladolid;181;Valdenebro de los Valles;197;103;94;2018
47;Valladolid;182;Valdestillas;1657;863;794;2018
47;Valladolid;183;Valdunquillo;133;67;66;2018
47;Valladolid;186;Valladolid;298866;140382;158484;2018
47;Valladolid;184;Valoria la Buena;647;348;299;2018
47;Valladolid;185;Valverde de Campos;100;60;40;2018
47;Valladolid;187;Vega de Ruiponce;94;57;37;2018
47;Valladolid;188;Vega de Valdetronco;108;59;49;2018
47;Valladolid;189;Velascálvaro;162;90;72;2018
47;Valladolid;190;Velilla;113;54;59;2018
47;Valladolid;191;Velliza;108;69;39;2018
47;Valladolid;192;Ventosa de la Cuesta;108;63;45;2018
47;Valladolid;193;Viana de Cega;2038;1065;973;2018
47;Valladolid;195;Villabáñez;504;277;227;2018
47;Valladolid;196;Villabaruz de Campos;34;15;19;2018
47;Valladolid;197;Villabrágima;1033;546;487;2018
47;Valladolid;198;Villacarralón;82;47;35;2018
47;Valladolid;199;Villacid de Campos;74;47;27;2018
47;Valladolid;200;Villaco;83;54;29;2018
47;Valladolid;203;Villafrades de Campos;65;35;30;2018
47;Valladolid;204;Villafranca de Duero;274;137;137;2018
47;Valladolid;205;Villafrechós;505;274;231;2018
47;Valladolid;206;Villafuerte;82;46;36;2018
47;Valladolid;207;Villagarcía de Campos;309;180;129;2018
47;Valladolid;208;Villagómez la Nueva;67;34;33;2018
47;Valladolid;209;Villalán de Campos;35;23;12;2018
47;Valladolid;210;Villalar de los Comuneros;458;221;237;2018
47;Valladolid;211;Villalba de la Loma;55;30;25;2018
47;Valladolid;212;Villalba de los Alcores;400;217;183;2018
47;Valladolid;213;Villalbarba;123;62;61;2018
47;Valladolid;214;Villalón de Campos;1606;791;815;2018
47;Valladolid;215;Villamuriel de Campos;53;27;26;2018
47;Valladolid;216;Villán de Tordesillas;128;75;53;2018
47;Valladolid;217;Villanubla;2692;1392;1300;2018
47;Valladolid;218;Villanueva de Duero;1170;610;560;2018
47;Valladolid;219;Villanueva de la Condesa;58;31;27;2018
47;Valladolid;220;Villanueva de los Caballeros;172;90;82;2018
47;Valladolid;221;Villanueva de los Infantes;107;65;42;2018
47;Valladolid;222;Villanueva de San Mancio;85;46;39;2018
47;Valladolid;223;Villardefrades;167;94;73;2018
47;Valladolid;224;Villarmentero de Esgueva;103;55;48;2018
47;Valladolid;225;Villasexmir;83;47;36;2018
47;Valladolid;226;Villavaquerín;167;96;71;2018
47;Valladolid;227;Villavellid;60;37;23;2018
47;Valladolid;228;Villaverde de Medina;514;273;241;2018
47;Valladolid;229;Villavicencio de los Caballeros;239;113;126;2018
47;Valladolid;194;Viloria;337;175;162;2018
47;Valladolid;230;Wamba;328;174;154;2018
47;Valladolid;231;Zaratán;6212;3181;3031;2018
47;Valladolid;232;Zarza, La;114;63;51;2018
49;Zamora;002;Abezames;60;30;30;2018
49;Zamora;003;Alcañices;1074;547;527;2018
49;Zamora;004;Alcubilla de Nogales;123;67;56;2018
49;Zamora;005;Alfaraz de Sayago;130;75;55;2018
49;Zamora;006;Algodre;145;79;66;2018
49;Zamora;007;Almaraz de Duero;402;208;194;2018
49;Zamora;008;Almeida de Sayago;462;245;217;2018
49;Zamora;009;Andavías;438;226;212;2018
49;Zamora;010;Arcenillas;405;204;201;2018
49;Zamora;011;Arcos de la Polvorosa;229;127;102;2018
49;Zamora;012;Argañín;76;36;40;2018
49;Zamora;013;Argujillo;247;121;126;2018
49;Zamora;014;Arquillinos;116;58;58;2018
49;Zamora;015;Arrabalde;232;113;119;2018
49;Zamora;016;Aspariegos;260;121;139;2018
49;Zamora;017;Asturianos;261;131;130;2018
49;Zamora;018;Ayoó de Vidriales;317;159;158;2018
49;Zamora;019;Barcial del Barco;258;137;121;2018
49;Zamora;020;Belver de los Montes;281;153;128;2018
49;Zamora;021;Benavente;18095;8752;9343;2018
49;Zamora;022;Benegiles;325;172;153;2018
49;Zamora;023;Bermillo de Sayago;1037;553;484;2018
49;Zamora;024;Bóveda de Toro, La;736;369;367;2018
49;Zamora;025;Bretó;184;109;75;2018
49;Zamora;026;Bretocino;228;121;107;2018
49;Zamora;027;Brime de Sog;134;66;68;2018
49;Zamora;028;Brime de Urz;108;64;44;2018
49;Zamora;029;Burganes de Valverde;656;341;315;2018
49;Zamora;030;Bustillo del Oro;85;44;41;2018
49;Zamora;031;Cabañas de Sayago;160;85;75;2018
49;Zamora;032;Calzadilla de Tera;305;142;163;2018
49;Zamora;033;Camarzana de Tera;813;407;406;2018
49;Zamora;034;Cañizal;455;235;220;2018
49;Zamora;035;Cañizo;236;126;110;2018
49;Zamora;036;Carbajales de Alba;556;283;273;2018
49;Zamora;037;Carbellino;202;110;92;2018
49;Zamora;038;Casaseca de Campeán;104;56;48;2018
49;Zamora;039;Casaseca de las Chanas;390;209;181;2018
49;Zamora;040;Castrillo de la Guareña;121;61;60;2018
49;Zamora;041;Castrogonzalo;478;261;217;2018
49;Zamora;042;Castronuevo;232;113;119;2018
49;Zamora;043;Castroverde de Campos;303;155;148;2018
49;Zamora;044;Cazurra;87;48;39;2018
49;Zamora;046;Cerecinos de Campos;275;152;123;2018
49;Zamora;047;Cerecinos del Carrizal;121;68;53;2018
49;Zamora;048;Cernadilla;116;60;56;2018
49;Zamora;050;Cobreros;576;306;270;2018
49;Zamora;052;Coomonte;194;107;87;2018
49;Zamora;053;Coreses;1057;543;514;2018
49;Zamora;054;Corrales del Vino;982;486;496;2018
49;Zamora;055;Cotanes del Monte;106;56;50;2018
49;Zamora;056;Cubillos;310;157;153;2018
49;Zamora;057;Cubo de Benavente;115;64;51;2018
49;Zamora;058;Cubo de Tierra del Vino, El;320;170;150;2018
49;Zamora;059;Cuelgamures;86;54;32;2018
49;Zamora;061;Entrala;156;87;69;2018
49;Zamora;062;Espadañedo;110;54;56;2018
49;Zamora;063;Faramontanos de Tábara;344;177;167;2018
49;Zamora;064;Fariza;524;274;250;2018
49;Zamora;065;Fermoselle;1225;622;603;2018
49;Zamora;066;Ferreras de Abajo;519;265;254;2018
49;Zamora;067;Ferreras de Arriba;376;205;171;2018
49;Zamora;068;Ferreruela;476;261;215;2018
49;Zamora;069;Figueruela de Arriba;339;161;178;2018
49;Zamora;071;Fonfría;761;400;361;2018
49;Zamora;075;Fresno de la Polvorosa;138;74;64;2018
49;Zamora;076;Fresno de la Ribera;375;200;175;2018
49;Zamora;077;Fresno de Sayago;180;94;86;2018
49;Zamora;078;Friera de Valverde;160;87;73;2018
49;Zamora;079;Fuente Encalada;110;60;50;2018
49;Zamora;080;Fuentelapeña;702;376;326;2018
49;Zamora;082;Fuentes de Ropel;379;192;187;2018
49;Zamora;081;Fuentesaúco;1491;741;750;2018
49;Zamora;083;Fuentesecas;51;24;27;2018
49;Zamora;084;Fuentespreadas;310;164;146;2018
49;Zamora;085;Galende;1058;536;522;2018
49;Zamora;086;Gallegos del Pan;112;66;46;2018
49;Zamora;087;Gallegos del Río;497;271;226;2018
49;Zamora;088;Gamones;96;56;40;2018
49;Zamora;090;Gema;222;108;114;2018
49;Zamora;091;Granja de Moreruela;280;145;135;2018
49;Zamora;092;Granucillo;122;59;63;2018
49;Zamora;093;Guarrate;324;166;158;2018
49;Zamora;094;Hermisende;247;129;118;2018
49;Zamora;095;Hiniesta, La;320;166;154;2018
49;Zamora;096;Jambrina;162;87;75;2018
49;Zamora;097;Justel;80;46;34;2018
49;Zamora;098;Losacino;218;120;98;2018
49;Zamora;099;Losacio;98;58;40;2018
49;Zamora;100;Lubián;302;164;138;2018
49;Zamora;101;Luelmo;159;84;75;2018
49;Zamora;102;Maderal, El;195;103;92;2018
49;Zamora;103;Madridanos;471;247;224;2018
49;Zamora;104;Mahide;316;177;139;2018
49;Zamora;105;Maire de Castroponce;151;79;72;2018
49;Zamora;107;Malva;131;58;73;2018
49;Zamora;108;Manganeses de la Lampreana;482;242;240;2018
49;Zamora;109;Manganeses de la Polvorosa;669;324;345;2018
49;Zamora;110;Manzanal de Arriba;358;192;166;2018
49;Zamora;112;Manzanal de los Infantes;128;73;55;2018
49;Zamora;111;Manzanal del Barco;126;66;60;2018
49;Zamora;113;Matilla de Arzón;169;98;71;2018
49;Zamora;114;Matilla la Seca;41;23;18;2018
49;Zamora;115;Mayalde;194;105;89;2018
49;Zamora;116;Melgar de Tera;391;201;190;2018
49;Zamora;117;Micereces de Tera;469;240;229;2018
49;Zamora;118;Milles de la Polvorosa;224;121;103;2018
49;Zamora;119;Molacillos;256;142;114;2018
49;Zamora;120;Molezuelas de la Carballeda;64;32;32;2018
49;Zamora;121;Mombuey;409;223;186;2018
49;Zamora;122;Monfarracinos;980;504;476;2018
49;Zamora;123;Montamarta;603;315;288;2018
49;Zamora;124;Moral de Sayago;261;150;111;2018
49;Zamora;126;Moraleja de Sayago;274;143;131;2018
49;Zamora;125;Moraleja del Vino;1705;871;834;2018
49;Zamora;128;Morales de Rey;576;289;287;2018
49;Zamora;129;Morales de Toro;1003;532;471;2018
49;Zamora;130;Morales de Valverde;176;91;85;2018
49;Zamora;127;Morales del Vino;2907;1516;1391;2018
49;Zamora;131;Moralina;263;137;126;2018
49;Zamora;132;Moreruela de los Infanzones;352;182;170;2018
49;Zamora;133;Moreruela de Tábara;306;161;145;2018
49;Zamora;134;Muelas de los Caballeros;179;102;77;2018
49;Zamora;135;Muelas del Pan;639;328;311;2018
49;Zamora;136;Muga de Sayago;342;165;177;2018
49;Zamora;137;Navianos de Valverde;185;104;81;2018
49;Zamora;138;Olmillos de Castro;230;126;104;2018
49;Zamora;139;Otero de Bodas;164;89;75;2018
49;Zamora;141;Pajares de la Lampreana;336;171;165;2018
49;Zamora;143;Palacios de Sanabria;238;117;121;2018
49;Zamora;142;Palacios del Pan;271;139;132;2018
49;Zamora;145;Pedralba de la Pradería;232;124;108;2018
49;Zamora;146;Pego, El;292;145;147;2018
49;Zamora;147;Peleagonzalo;255;128;127;2018
49;Zamora;148;Peleas de Abajo;274;129;145;2018
49;Zamora;149;Peñausende;399;199;200;2018
49;Zamora;150;Peque;133;57;76;2018
49;Zamora;151;Perdigón, El;692;364;328;2018
49;Zamora;152;Pereruela;540;287;253;2018
49;Zamora;153;Perilla de Castro;167;86;81;2018
49;Zamora;154;Pías;123;71;52;2018
49;Zamora;155;Piedrahita de Castro;85;45;40;2018
49;Zamora;156;Pinilla de Toro;226;117;109;2018
49;Zamora;157;Pino del Oro;200;108;92;2018
49;Zamora;158;Piñero, El;237;125;112;2018
49;Zamora;160;Pobladura de Valderaduey;37;20;17;2018
49;Zamora;159;Pobladura del Valle;288;150;138;2018
49;Zamora;162;Porto;165;90;75;2018
49;Zamora;163;Pozoantiguo;207;105;102;2018
49;Zamora;164;Pozuelo de Tábara;162;80;82;2018
49;Zamora;165;Prado;55;30;25;2018
49;Zamora;166;Puebla de Sanabria;1409;694;715;2018
49;Zamora;167;Pueblica de Valverde;194;108;86;2018
49;Zamora;170;Quintanilla de Urz;103;54;49;2018
49;Zamora;168;Quintanilla del Monte;105;55;50;2018
49;Zamora;169;Quintanilla del Olmo;38;19;19;2018
49;Zamora;171;Quiruelas de Vidriales;668;347;321;2018
49;Zamora;172;Rabanales;528;275;253;2018
49;Zamora;173;Rábano de Aliste;385;190;195;2018
49;Zamora;174;Requejo;146;70;76;2018
49;Zamora;175;Revellinos;267;138;129;2018
49;Zamora;176;Riofrío de Aliste;684;382;302;2018
49;Zamora;177;Rionegro del Puente;278;145;133;2018
49;Zamora;178;Roales;923;487;436;2018
49;Zamora;179;Robleda-Cervantes;417;226;191;2018
49;Zamora;180;Roelos de Sayago;156;76;80;2018
49;Zamora;181;Rosinos de la Requejada;365;196;169;2018
49;Zamora;183;Salce;103;47;56;2018
49;Zamora;184;Samir de los Caños;180;99;81;2018
49;Zamora;185;San Agustín del Pozo;185;95;90;2018
49;Zamora;186;San Cebrián de Castro;250;122;128;2018
49;Zamora;187;San Cristóbal de Entreviñas;1401;734;667;2018
49;Zamora;188;San Esteban del Molar;133;77;56;2018
49;Zamora;189;San Justo;219;120;99;2018
49;Zamora;190;San Martín de Valderaduey;52;28;24;2018
49;Zamora;191;San Miguel de la Ribera;286;142;144;2018
49;Zamora;192;San Miguel del Valle;141;69;72;2018
49;Zamora;193;San Pedro de Ceque;463;240;223;2018
49;Zamora;194;San Pedro de la Nave-Almendra;347;178;169;2018
49;Zamora;208;San Vicente de la Cabeza;395;209;186;2018
49;Zamora;209;San Vitero;520;291;229;2018
49;Zamora;197;Santa Clara de Avedillo;170;86;84;2018
49;Zamora;199;Santa Colomba de las Monjas;262;126;136;2018
49;Zamora;200;Santa Cristina de la Polvorosa;1075;551;524;2018
49;Zamora;201;Santa Croya de Tera;307;154;153;2018
49;Zamora;202;Santa Eufemia del Barco;184;107;77;2018
49;Zamora;203;Santa María de la Vega;308;160;148;2018
49;Zamora;204;Santa María de Valverde;55;25;30;2018
49;Zamora;205;Santibáñez de Tera;389;200;189;2018
49;Zamora;206;Santibáñez de Vidriales;977;490;487;2018
49;Zamora;207;Santovenia;259;129;130;2018
49;Zamora;210;Sanzoles;506;254;252;2018
49;Zamora;214;Tábara;762;393;369;2018
49;Zamora;216;Tapioles;158;93;65;2018
49;Zamora;219;Toro;8789;4302;4487;2018
49;Zamora;220;Torre del Valle, La;146;78;68;2018
49;Zamora;221;Torregamones;277;144;133;2018
49;Zamora;222;Torres del Carrizal;403;205;198;2018
49;Zamora;223;Trabazos;872;455;417;2018
49;Zamora;224;Trefacio;187;92;95;2018
49;Zamora;225;Uña de Quintana;140;74;66;2018
49;Zamora;226;Vadillo de la Guareña;264;141;123;2018
49;Zamora;227;Valcabado;353;183;170;2018
49;Zamora;228;Valdefinjas;47;28;19;2018
49;Zamora;229;Valdescorriel;134;66;68;2018
49;Zamora;230;Vallesa de la Guareña;89;48;41;2018
49;Zamora;231;Vega de Tera;346;166;180;2018
49;Zamora;232;Vega de Villalobos;107;50;57;2018
49;Zamora;233;Vegalatrave;92;52;40;2018
49;Zamora;234;Venialbo;429;231;198;2018
49;Zamora;235;Vezdemarbán;383;195;188;2018
49;Zamora;236;Vidayanes;89;47;42;2018
49;Zamora;237;Videmala;156;82;74;2018
49;Zamora;238;Villabrázaro;205;107;98;2018
49;Zamora;239;Villabuena del Puente;705;362;343;2018
49;Zamora;240;Villadepera;205;110;95;2018
49;Zamora;241;Villaescusa;254;140;114;2018
49;Zamora;242;Villafáfila;483;252;231;2018
49;Zamora;243;Villaferrueña;109;56;53;2018
49;Zamora;244;Villageriz;48;29;19;2018
49;Zamora;245;Villalazán;278;137;141;2018
49;Zamora;246;Villalba de la Lampreana;233;130;103;2018
49;Zamora;247;Villalcampo;444;218;226;2018
49;Zamora;248;Villalobos;253;123;130;2018
49;Zamora;249;Villalonso;75;41;34;2018
49;Zamora;250;Villalpando;1519;755;764;2018
49;Zamora;251;Villalube;158;85;73;2018
49;Zamora;252;Villamayor de Campos;324;162;162;2018
49;Zamora;255;Villamor de los Escuderos;398;211;187;2018
49;Zamora;256;Villanázar;280;144;136;2018
49;Zamora;257;Villanueva de Azoague;336;168;168;2018
49;Zamora;258;Villanueva de Campeán;115;67;48;2018
49;Zamora;259;Villanueva de las Peras;77;41;36;2018
49;Zamora;260;Villanueva del Campo;857;425;432;2018
49;Zamora;263;Villar de Fallaves;44;24;20;2018
49;Zamora;264;Villar del Buey;579;298;281;2018
49;Zamora;261;Villaralbo;1858;942;916;2018
49;Zamora;262;Villardeciervos;418;211;207;2018
49;Zamora;265;Villardiegua de la Ribera;126;65;61;2018
49;Zamora;266;Villárdiga;75;42;33;2018
49;Zamora;267;Villardondiego;104;58;46;2018
49;Zamora;268;Villarrín de Campos;404;217;187;2018
49;Zamora;269;Villaseco del Pan;238;111;127;2018
49;Zamora;270;Villavendimio;168;103;65;2018
49;Zamora;272;Villaveza de Valverde;82;42;40;2018
49;Zamora;271;Villaveza del Agua;194;108;86;2018
49;Zamora;273;Viñas;190;97;93;2018
49;Zamora;275;Zamora;61827;28759;33068;2018
50;Zaragoza;001;Abanto;97;58;39;2018
50;Zaragoza;002;Acered;165;96;69;2018
50;Zaragoza;003;Agón;146;81;65;2018
50;Zaragoza;004;Aguarón;631;332;299;2018
50;Zaragoza;005;Aguilón;235;128;107;2018
50;Zaragoza;006;Ainzón;1085;545;540;2018
50;Zaragoza;007;Aladrén;52;34;18;2018
50;Zaragoza;008;Alagón;7094;3526;3568;2018
50;Zaragoza;009;Alarba;133;77;56;2018
50;Zaragoza;010;Alberite de San Juan;72;41;31;2018
50;Zaragoza;011;Albeta;132;68;64;2018
50;Zaragoza;012;Alborge;108;57;51;2018
50;Zaragoza;013;Alcalá de Ebro;251;122;129;2018
50;Zaragoza;014;Alcalá de Moncayo;144;83;61;2018
50;Zaragoza;015;Alconchel de Ariza;63;36;27;2018
50;Zaragoza;016;Aldehuela de Liestos;49;32;17;2018
50;Zaragoza;017;Alfajarín;2312;1190;1122;2018
50;Zaragoza;018;Alfamén;1441;760;681;2018
50;Zaragoza;019;Alforque;62;33;29;2018
50;Zaragoza;020;Alhama de Aragón;1036;545;491;2018
50;Zaragoza;021;Almochuel;29;12;17;2018
50;Zaragoza;022;Almolda, La;567;289;278;2018
50;Zaragoza;023;Almonacid de la Cuba;252;124;128;2018
50;Zaragoza;024;Almonacid de la Sierra;691;382;309;2018
50;Zaragoza;025;Almunia de Doña Godina, La;7819;3978;3841;2018
50;Zaragoza;026;Alpartir;579;288;291;2018
50;Zaragoza;027;Ambel;256;123;133;2018
50;Zaragoza;028;Anento;95;62;33;2018
50;Zaragoza;029;Aniñón;708;383;325;2018
50;Zaragoza;030;Añón de Moncayo;213;129;84;2018
50;Zaragoza;031;Aranda de Moncayo;160;99;61;2018
50;Zaragoza;032;Arándiga;309;166;143;2018
50;Zaragoza;033;Ardisa;72;45;27;2018
50;Zaragoza;034;Ariza;1139;579;560;2018
50;Zaragoza;035;Artieda;73;43;30;2018
50;Zaragoza;036;Asín;96;52;44;2018
50;Zaragoza;037;Atea;156;96;60;2018
50;Zaragoza;038;Ateca;1793;925;868;2018
50;Zaragoza;039;Azuara;543;310;233;2018
50;Zaragoza;040;Badules;83;47;36;2018
50;Zaragoza;041;Bagüés;12;8;4;2018
50;Zaragoza;042;Balconchán;17;7;10;2018
50;Zaragoza;043;Bárboles;300;164;136;2018
50;Zaragoza;044;Bardallur;261;123;138;2018
50;Zaragoza;045;Belchite;1528;768;760;2018
50;Zaragoza;046;Belmonte de Gracián;198;110;88;2018
50;Zaragoza;047;Berdejo;47;33;14;2018
50;Zaragoza;048;Berrueco;33;18;15;2018
50;Zaragoza;901;Biel;140;87;53;2018
50;Zaragoza;050;Bijuesca;98;61;37;2018
50;Zaragoza;051;Biota;948;480;468;2018
50;Zaragoza;052;Bisimbre;97;58;39;2018
50;Zaragoza;053;Boquiñeni;808;407;401;2018
50;Zaragoza;054;Bordalba;56;36;20;2018
50;Zaragoza;055;Borja;4922;2509;2413;2018
50;Zaragoza;056;Botorrita;498;271;227;2018
50;Zaragoza;057;Brea de Aragón;1665;847;818;2018
50;Zaragoza;058;Bubierca;63;33;30;2018
50;Zaragoza;059;Bujaraloz;1005;527;478;2018
50;Zaragoza;060;Bulbuente;217;119;98;2018
50;Zaragoza;061;Bureta;217;111;106;2018
50;Zaragoza;062;Burgo de Ebro, El;2432;1233;1199;2018
50;Zaragoza;063;Buste, El;72;41;31;2018
50;Zaragoza;064;Cabañas de Ebro;498;263;235;2018
50;Zaragoza;065;Cabolafuente;32;19;13;2018
50;Zaragoza;066;Cadrete;3891;2055;1836;2018
50;Zaragoza;067;Calatayud;20035;9865;10170;2018
50;Zaragoza;068;Calatorao;2861;1500;1361;2018
50;Zaragoza;069;Calcena;75;44;31;2018
50;Zaragoza;070;Calmarza;59;33;26;2018
50;Zaragoza;071;Campillo de Aragón;149;80;69;2018
50;Zaragoza;072;Carenas;177;93;84;2018
50;Zaragoza;073;Cariñena;3276;1655;1621;2018
50;Zaragoza;074;Caspe;9525;4918;4607;2018
50;Zaragoza;075;Castejón de Alarba;92;58;34;2018
50;Zaragoza;076;Castejón de las Armas;90;51;39;2018
50;Zaragoza;077;Castejón de Valdejasa;221;114;107;2018
50;Zaragoza;078;Castiliscar;265;140;125;2018
50;Zaragoza;079;Cervera de la Cañada;271;150;121;2018
50;Zaragoza;080;Cerveruela;35;22;13;2018
50;Zaragoza;081;Cetina;592;310;282;2018
50;Zaragoza;092;Chiprana;508;265;243;2018
50;Zaragoza;093;Chodes;113;62;51;2018
50;Zaragoza;082;Cimballa;93;51;42;2018
50;Zaragoza;083;Cinco Olivas;112;53;59;2018
50;Zaragoza;084;Clarés de Ribota;65;38;27;2018
50;Zaragoza;085;Codo;198;103;95;2018
50;Zaragoza;086;Codos;183;115;68;2018
50;Zaragoza;087;Contamina;37;21;16;2018
50;Zaragoza;088;Cosuenda;367;195;172;2018
50;Zaragoza;089;Cuarte de Huerva;13055;6674;6381;2018
50;Zaragoza;090;Cubel;168;82;86;2018
50;Zaragoza;091;Cuerlas, Las;39;20;19;2018
50;Zaragoza;094;Daroca;1996;983;1013;2018
50;Zaragoza;095;Ejea de los Caballeros;16605;8453;8152;2018
50;Zaragoza;096;Embid de Ariza;36;19;17;2018
50;Zaragoza;098;Encinacorba;189;96;93;2018
50;Zaragoza;099;Épila;4402;2277;2125;2018
50;Zaragoza;100;Erla;345;175;170;2018
50;Zaragoza;101;Escatrón;1026;512;514;2018
50;Zaragoza;102;Fabara;1152;619;533;2018
50;Zaragoza;104;Farlete;386;188;198;2018
50;Zaragoza;105;Fayón;354;179;175;2018
50;Zaragoza;106;Fayos, Los;141;80;61;2018
50;Zaragoza;107;Figueruelas;1240;615;625;2018
50;Zaragoza;108;Fombuena;54;35;19;2018
50;Zaragoza;109;Frago, El;99;61;38;2018
50;Zaragoza;110;Frasno, El;384;211;173;2018
50;Zaragoza;111;Fréscano;202;111;91;2018
50;Zaragoza;113;Fuendejalón;793;422;371;2018
50;Zaragoza;114;Fuendetodos;121;68;53;2018
50;Zaragoza;115;Fuentes de Ebro;4543;2353;2190;2018
50;Zaragoza;116;Fuentes de Jiloca;229;122;107;2018
50;Zaragoza;117;Gallocanta;154;86;68;2018
50;Zaragoza;118;Gallur;2628;1324;1304;2018
50;Zaragoza;119;Gelsa;995;524;471;2018
50;Zaragoza;120;Godojos;54;30;24;2018
50;Zaragoza;121;Gotor;306;161;145;2018
50;Zaragoza;122;Grisel;67;40;27;2018
50;Zaragoza;123;Grisén;597;310;287;2018
50;Zaragoza;124;Herrera de los Navarros;506;274;232;2018
50;Zaragoza;125;Ibdes;404;212;192;2018
50;Zaragoza;126;Illueca;2964;1460;1504;2018
50;Zaragoza;128;Isuerre;31;19;12;2018
50;Zaragoza;129;Jaraba;280;147;133;2018
50;Zaragoza;130;Jarque;436;241;195;2018
50;Zaragoza;131;Jaulín;237;128;109;2018
50;Zaragoza;132;Joyosa, La;1072;558;514;2018
50;Zaragoza;133;Lagata;111;59;52;2018
50;Zaragoza;134;Langa del Castillo;132;67;65;2018
50;Zaragoza;135;Layana;100;53;47;2018
50;Zaragoza;136;Lécera;661;362;299;2018
50;Zaragoza;138;Lechón;53;31;22;2018
50;Zaragoza;137;Leciñena;1162;585;577;2018
50;Zaragoza;139;Letux;342;190;152;2018
50;Zaragoza;140;Litago;166;92;74;2018
50;Zaragoza;141;Lituénigo;127;64;63;2018
50;Zaragoza;142;Lobera de Onsella;28;14;14;2018
50;Zaragoza;143;Longares;763;440;323;2018
50;Zaragoza;144;Longás;35;24;11;2018
50;Zaragoza;146;Lucena de Jalón;237;129;108;2018
50;Zaragoza;147;Luceni;945;473;472;2018
50;Zaragoza;148;Luesia;310;168;142;2018
50;Zaragoza;149;Luesma;34;21;13;2018
50;Zaragoza;150;Lumpiaque;827;423;404;2018
50;Zaragoza;151;Luna;701;368;333;2018
50;Zaragoza;152;Maella;2007;1078;929;2018
50;Zaragoza;153;Magallón;1133;587;546;2018
50;Zaragoza;154;Mainar;151;84;67;2018
50;Zaragoza;155;Malanquilla;100;63;37;2018
50;Zaragoza;156;Maleján;259;134;125;2018
50;Zaragoza;160;Mallén;3083;1612;1471;2018
50;Zaragoza;157;Malón;323;168;155;2018
50;Zaragoza;159;Maluenda;942;461;481;2018
50;Zaragoza;161;Manchones;98;55;43;2018
50;Zaragoza;162;Mara;181;91;90;2018
50;Zaragoza;163;María de Huerva;5663;2894;2769;2018
50;Zaragoza;902;Marracos;86;50;36;2018
50;Zaragoza;164;Mediana de Aragón;465;229;236;2018
50;Zaragoza;165;Mequinenza;2301;1167;1134;2018
50;Zaragoza;166;Mesones de Isuela;271;138;133;2018
50;Zaragoza;167;Mezalocha;240;137;103;2018
50;Zaragoza;168;Mianos;32;19;13;2018
50;Zaragoza;169;Miedes de Aragón;432;231;201;2018
50;Zaragoza;170;Monegrillo;413;231;182;2018
50;Zaragoza;171;Moneva;94;58;36;2018
50;Zaragoza;172;Monreal de Ariza;212;121;91;2018
50;Zaragoza;173;Monterde;159;101;58;2018
50;Zaragoza;174;Montón;94;53;41;2018
50;Zaragoza;175;Morata de Jalón;1097;537;560;2018
50;Zaragoza;176;Morata de Jiloca;282;162;120;2018
50;Zaragoza;177;Morés;334;178;156;2018
50;Zaragoza;178;Moros;362;186;176;2018
50;Zaragoza;179;Moyuela;245;132;113;2018
50;Zaragoza;180;Mozota;130;64;66;2018
50;Zaragoza;181;Muel;1333;684;649;2018
50;Zaragoza;182;Muela, La;5479;2855;2624;2018
50;Zaragoza;183;Munébrega;385;209;176;2018
50;Zaragoza;184;Murero;107;62;45;2018
50;Zaragoza;185;Murillo de Gállego;174;104;70;2018
50;Zaragoza;186;Navardún;40;25;15;2018
50;Zaragoza;187;Nigüella;66;41;25;2018
50;Zaragoza;188;Nombrevilla;29;18;11;2018
50;Zaragoza;189;Nonaspe;962;521;441;2018
50;Zaragoza;190;Novallas;850;449;401;2018
50;Zaragoza;191;Novillas;540;269;271;2018
50;Zaragoza;192;Nuévalos;325;177;148;2018
50;Zaragoza;193;Nuez de Ebro;827;413;414;2018
50;Zaragoza;194;Olvés;106;64;42;2018
50;Zaragoza;195;Orcajo;59;38;21;2018
50;Zaragoza;196;Orera;118;62;56;2018
50;Zaragoza;197;Orés;104;63;41;2018
50;Zaragoza;198;Oseja;52;33;19;2018
50;Zaragoza;199;Osera de Ebro;395;201;194;2018
50;Zaragoza;200;Paniza;634;333;301;2018
50;Zaragoza;201;Paracuellos de Jiloca;601;310;291;2018
50;Zaragoza;202;Paracuellos de la Ribera;158;83;75;2018
50;Zaragoza;203;Pastriz;1293;625;668;2018
50;Zaragoza;204;Pedrola;3509;1787;1722;2018
50;Zaragoza;205;Pedrosas, Las;90;44;46;2018
50;Zaragoza;206;Perdiguera;577;308;269;2018
50;Zaragoza;207;Piedratajada;97;49;48;2018
50;Zaragoza;208;Pina de Ebro;2373;1217;1156;2018
50;Zaragoza;209;Pinseque;3908;2009;1899;2018
50;Zaragoza;210;Pintanos, Los;37;23;14;2018
50;Zaragoza;211;Plasencia de Jalón;303;172;131;2018
50;Zaragoza;212;Pleitas;36;14;22;2018
50;Zaragoza;213;Plenas;101;54;47;2018
50;Zaragoza;214;Pomer;22;15;7;2018
50;Zaragoza;215;Pozuel de Ariza;21;12;9;2018
50;Zaragoza;216;Pozuelo de Aragón;284;152;132;2018
50;Zaragoza;217;Pradilla de Ebro;574;301;273;2018
50;Zaragoza;218;Puebla de Albortón;120;74;46;2018
50;Zaragoza;219;Puebla de Alfindén, La;6173;3162;3011;2018
50;Zaragoza;220;Puendeluna;44;26;18;2018
50;Zaragoza;221;Purujosa;36;26;10;2018
50;Zaragoza;222;Quinto;1948;990;958;2018
50;Zaragoza;223;Remolinos;1081;551;530;2018
50;Zaragoza;224;Retascón;74;45;29;2018
50;Zaragoza;225;Ricla;2815;1486;1329;2018
50;Zaragoza;227;Romanos;119;59;60;2018
50;Zaragoza;228;Rueda de Jalón;325;174;151;2018
50;Zaragoza;229;Ruesca;72;37;35;2018
50;Zaragoza;241;Sabiñán;691;374;317;2018
50;Zaragoza;230;Sádaba;1324;663;661;2018
50;Zaragoza;231;Salillas de Jalón;304;155;149;2018
50;Zaragoza;232;Salvatierra de Esca;198;95;103;2018
50;Zaragoza;233;Samper del Salz;112;63;49;2018
50;Zaragoza;234;San Martín de la Virgen de Moncayo;286;161;125;2018
50;Zaragoza;235;San Mateo de Gállego;3134;1605;1529;2018
50;Zaragoza;236;Santa Cruz de Grío;108;63;45;2018
50;Zaragoza;237;Santa Cruz de Moncayo;125;67;58;2018
50;Zaragoza;238;Santa Eulalia de Gállego;98;53;45;2018
50;Zaragoza;239;Santed;61;39;22;2018
50;Zaragoza;240;Sástago;1170;589;581;2018
50;Zaragoza;242;Sediles;95;58;37;2018
50;Zaragoza;243;Sestrica;370;208;162;2018
50;Zaragoza;244;Sierra de Luna;253;136;117;2018
50;Zaragoza;245;Sigüés;88;47;41;2018
50;Zaragoza;246;Sisamón;31;20;11;2018
50;Zaragoza;247;Sobradiel;1089;523;566;2018
50;Zaragoza;248;Sos del Rey Católico;588;312;276;2018
50;Zaragoza;249;Tabuenca;323;187;136;2018
50;Zaragoza;250;Talamantes;63;32;31;2018
50;Zaragoza;251;Tarazona;10509;5203;5306;2018
50;Zaragoza;252;Tauste;6914;3447;3467;2018
50;Zaragoza;253;Terrer;485;261;224;2018
50;Zaragoza;254;Tierga;192;104;88;2018
50;Zaragoza;255;Tobed;214;113;101;2018
50;Zaragoza;256;Torralba de los Frailes;86;46;40;2018
50;Zaragoza;257;Torralba de Ribota;172;97;75;2018
50;Zaragoza;258;Torralbilla;61;35;26;2018
50;Zaragoza;259;Torrehermosa;63;35;28;2018
50;Zaragoza;260;Torrelapaja;32;21;11;2018
50;Zaragoza;261;Torrellas;250;130;120;2018
50;Zaragoza;262;Torres de Berrellén;1446;745;701;2018
50;Zaragoza;263;Torrijo de la Cañada;206;118;88;2018
50;Zaragoza;264;Tosos;180;102;78;2018
50;Zaragoza;265;Trasmoz;89;53;36;2018
50;Zaragoza;266;Trasobares;120;74;46;2018
50;Zaragoza;267;Uncastillo;650;307;343;2018
50;Zaragoza;268;Undués de Lerda;55;32;23;2018
50;Zaragoza;269;Urrea de Jalón;418;231;187;2018
50;Zaragoza;270;Urriés;38;20;18;2018
50;Zaragoza;271;Used;271;148;123;2018
50;Zaragoza;272;Utebo;18602;9258;9344;2018
50;Zaragoza;274;Val de San Martín;64;36;28;2018
50;Zaragoza;273;Valdehorna;30;15;15;2018
50;Zaragoza;275;Valmadrid;112;69;43;2018
50;Zaragoza;276;Valpalmas;142;68;74;2018
50;Zaragoza;277;Valtorres;68;33;35;2018
50;Zaragoza;278;Velilla de Ebro;215;114;101;2018
50;Zaragoza;279;Velilla de Jiloca;90;43;47;2018
50;Zaragoza;280;Vera de Moncayo;360;183;177;2018
50;Zaragoza;281;Vierlas;74;40;34;2018
50;Zaragoza;283;Villadoz;88;51;37;2018
50;Zaragoza;284;Villafeliche;170;94;76;2018
50;Zaragoza;285;Villafranca de Ebro;830;404;426;2018
50;Zaragoza;286;Villalba de Perejil;99;48;51;2018
50;Zaragoza;287;Villalengua;319;175;144;2018
50;Zaragoza;903;Villamayor de Gállego;2696;1350;1346;2018
50;Zaragoza;288;Villanueva de Gállego;4661;2350;2311;2018
50;Zaragoza;290;Villanueva de Huerva;463;239;224;2018
50;Zaragoza;289;Villanueva de Jiloca;46;24;22;2018
50;Zaragoza;291;Villar de los Navarros;102;56;46;2018
50;Zaragoza;292;Villarreal de Huerva;274;154;120;2018
50;Zaragoza;293;Villarroya de la Sierra;466;246;220;2018
50;Zaragoza;294;Villarroya del Campo;68;36;32;2018
50;Zaragoza;282;Vilueña, La;77;39;38;2018
50;Zaragoza;295;Vistabella;49;28;21;2018
50;Zaragoza;296;Zaida, La;455;228;227;2018
50;Zaragoza;297;Zaragoza;666880;319177;347703;2018
50;Zaragoza;298;Zuera;8365;4330;4035;2018
51;Ceuta;001;Ceuta;85144;43177;41967;2018
52;Melilla;001;Melilla;86384;43765;42619;2018
02;Albacete;001;Abengibre;790;379;411;2019
02;Albacete;002;Alatoz;519;291;228;2019
02;Albacete;003;Albacete;173329;84687;88642;2019
02;Albacete;004;Albatana;692;356;336;2019
02;Albacete;005;Alborea;658;337;321;2019
02;Albacete;006;Alcadozo;654;363;291;2019
02;Albacete;007;Alcalá del Júcar;1170;618;552;2019
02;Albacete;008;Alcaraz;1351;703;648;2019
02;Albacete;009;Almansa;24419;12167;12252;2019
02;Albacete;010;Alpera;2265;1174;1091;2019
02;Albacete;011;Ayna;616;327;289;2019
02;Albacete;012;Balazote;2334;1189;1145;2019
02;Albacete;014;Ballestero, El;405;207;198;2019
02;Albacete;013;Balsa de Ves;158;91;67;2019
02;Albacete;015;Barrax;1833;939;894;2019
02;Albacete;016;Bienservida;603;326;277;2019
02;Albacete;017;Bogarra;842;443;399;2019
02;Albacete;018;Bonete;1049;540;509;2019
02;Albacete;019;Bonillo, El;2779;1415;1364;2019
02;Albacete;020;Carcelén;501;271;230;2019
02;Albacete;021;Casas de Juan Núñez;1307;686;621;2019
02;Albacete;022;Casas de Lázaro;363;205;158;2019
02;Albacete;023;Casas de Ves;572;301;271;2019
02;Albacete;024;Casas-Ibáñez;4538;2294;2244;2019
02;Albacete;025;Caudete;9963;5073;4890;2019
02;Albacete;026;Cenizate;1181;597;584;2019
02;Albacete;029;Chinchilla de Monte-Aragón;4206;2196;2010;2019
02;Albacete;027;Corral-Rubio;324;174;150;2019
02;Albacete;028;Cotillas;123;64;59;2019
02;Albacete;030;Elche de la Sierra;3585;1787;1798;2019
02;Albacete;031;Férez;643;317;326;2019
02;Albacete;032;Fuensanta;297;168;129;2019
02;Albacete;033;Fuente-Álamo;2489;1307;1182;2019
02;Albacete;034;Fuentealbilla;1792;914;878;2019
02;Albacete;035;Gineta, La;2512;1304;1208;2019
02;Albacete;036;Golosalvo;104;55;49;2019
02;Albacete;037;Hellín;30306;15162;15144;2019
02;Albacete;038;Herrera, La;326;167;159;2019
02;Albacete;039;Higueruela;1158;602;556;2019
02;Albacete;040;Hoya-Gonzalo;647;345;302;2019
02;Albacete;041;Jorquera;355;193;162;2019
02;Albacete;042;Letur;919;449;470;2019
02;Albacete;043;Lezuza;1358;705;653;2019
02;Albacete;044;Liétor;1175;610;565;2019
02;Albacete;045;Madrigueras;4652;2380;2272;2019
02;Albacete;046;Mahora;1383;706;677;2019
02;Albacete;047;Masegoso;110;59;51;2019
02;Albacete;048;Minaya;1501;774;727;2019
02;Albacete;049;Molinicos;852;441;411;2019
02;Albacete;050;Montalvos;97;52;45;2019
02;Albacete;051;Montealegre del Castillo;2051;1043;1008;2019
02;Albacete;052;Motilleja;571;307;264;2019
02;Albacete;053;Munera;3435;1763;1672;2019
02;Albacete;054;Navas de Jorquera;517;266;251;2019
02;Albacete;055;Nerpio;1191;660;531;2019
02;Albacete;056;Ontur;1987;1009;978;2019
02;Albacete;057;Ossa de Montiel;2307;1154;1153;2019
02;Albacete;058;Paterna del Madera;348;190;158;2019
02;Albacete;060;Peñas de San Pedro;1399;817;582;2019
02;Albacete;059;Peñascosa;334;184;150;2019
02;Albacete;061;Pétrola;692;350;342;2019
02;Albacete;062;Povedilla;430;241;189;2019
02;Albacete;901;Pozo Cañada;2797;1418;1379;2019
02;Albacete;063;Pozohondo;1585;826;759;2019
02;Albacete;064;Pozo-Lorente;409;208;201;2019
02;Albacete;065;Pozuelo;481;255;226;2019
02;Albacete;066;Recueja, La;242;133;109;2019
02;Albacete;067;Riópar;1332;687;645;2019
02;Albacete;068;Robledo;367;200;167;2019
02;Albacete;069;Roda, La;15476;7818;7658;2019
02;Albacete;070;Salobre;480;258;222;2019
02;Albacete;071;San Pedro;1242;627;615;2019
02;Albacete;072;Socovos;1787;920;867;2019
02;Albacete;073;Tarazona de la Mancha;6235;3197;3038;2019
02;Albacete;074;Tobarra;7684;3931;3753;2019
02;Albacete;075;Valdeganga;2028;1038;990;2019
02;Albacete;076;Vianos;346;174;172;2019
02;Albacete;077;Villa de Ves;56;32;24;2019
02;Albacete;078;Villalgordo del Júcar;1094;576;518;2019
02;Albacete;079;Villamalea;4027;2034;1993;2019
02;Albacete;080;Villapalacios;583;304;279;2019
02;Albacete;081;Villarrobledo;25184;12456;12728;2019
02;Albacete;082;Villatoya;109;65;44;2019
02;Albacete;083;Villavaliente;224;136;88;2019
02;Albacete;084;Villaverde de Guadalimar;338;173;165;2019
02;Albacete;085;Viveros;337;176;161;2019
02;Albacete;086;Yeste;2657;1375;1282;2019
03;Alicante/Alacant;002;Agost;4758;2357;2401;2019
03;Alicante/Alacant;003;Agres;565;306;259;2019
03;Alicante/Alacant;004;Aigües;963;505;458;2019
03;Alicante/Alacant;005;Albatera;12279;6260;6019;2019
03;Alicante/Alacant;006;Alcalalí;1278;640;638;2019
03;Alicante/Alacant;007;Alcocer de Planes;230;117;113;2019
03;Alicante/Alacant;008;Alcoleja;173;93;80;2019
03;Alicante/Alacant;009;Alcoy/Alcoi;58994;28866;30128;2019
03;Alicante/Alacant;010;Alfafara;410;202;208;2019
03;Alicante/Alacant;011;Alfàs del Pi, l';20482;10187;10295;2019
03;Alicante/Alacant;012;Algorfa;2935;1461;1474;2019
03;Alicante/Alacant;013;Algueña;1336;668;668;2019
03;Alicante/Alacant;014;Alicante/Alacant;334887;162191;172696;2019
03;Alicante/Alacant;015;Almoradí;20803;10510;10293;2019
03;Alicante/Alacant;016;Almudaina;113;57;56;2019
03;Alicante/Alacant;017;Alqueria d'Asnar, l';493;238;255;2019
03;Alicante/Alacant;018;Altea;22290;10911;11379;2019
03;Alicante/Alacant;019;Aspe;20714;10435;10279;2019
03;Alicante/Alacant;001;Atzúbia, l';632;325;307;2019
03;Alicante/Alacant;020;Balones;131;73;58;2019
03;Alicante/Alacant;021;Banyeres de Mariola;7068;3538;3530;2019
03;Alicante/Alacant;022;Benasau;151;74;77;2019
03;Alicante/Alacant;023;Beneixama;1685;852;833;2019
03;Alicante/Alacant;024;Benejúzar;5402;2699;2703;2019
03;Alicante/Alacant;025;Benferri;1942;1001;941;2019
03;Alicante/Alacant;026;Beniarbeig;2092;1061;1031;2019
03;Alicante/Alacant;027;Beniardá;232;106;126;2019
03;Alicante/Alacant;028;Beniarrés;1118;571;547;2019
03;Alicante/Alacant;030;Benidoleig;1095;545;550;2019
03;Alicante/Alacant;031;Benidorm;68721;34250;34471;2019
03;Alicante/Alacant;032;Benifallim;105;60;45;2019
03;Alicante/Alacant;033;Benifato;140;73;67;2019
03;Alicante/Alacant;029;Benigembla;490;253;237;2019
03;Alicante/Alacant;034;Benijófar;3322;1615;1707;2019
03;Alicante/Alacant;035;Benilloba;724;377;347;2019
03;Alicante/Alacant;036;Benillup;97;47;50;2019
03;Alicante/Alacant;037;Benimantell;483;242;241;2019
03;Alicante/Alacant;038;Benimarfull;409;207;202;2019
03;Alicante/Alacant;039;Benimassot;106;59;47;2019
03;Alicante/Alacant;040;Benimeli;418;187;231;2019
03;Alicante/Alacant;041;Benissa;11005;5415;5590;2019
03;Alicante/Alacant;042;Benitachell/Poble Nou de Benitatxell, el;4276;2106;2170;2019
03;Alicante/Alacant;043;Biar;3671;1799;1872;2019
03;Alicante/Alacant;044;Bigastro;6733;3382;3351;2019
03;Alicante/Alacant;045;Bolulla;420;220;200;2019
03;Alicante/Alacant;046;Busot;2978;1516;1462;2019
03;Alicante/Alacant;049;Callosa de Segura;19038;9714;9324;2019
03;Alicante/Alacant;048;Callosa d'en Sarrià;7373;3762;3611;2019
03;Alicante/Alacant;047;Calp;22725;11480;11245;2019
03;Alicante/Alacant;050;Campello, el;28349;13796;14553;2019
03;Alicante/Alacant;051;Campo de Mirra/Camp de Mirra, el;415;211;204;2019
03;Alicante/Alacant;052;Cañada;1220;606;614;2019
03;Alicante/Alacant;053;Castalla;10124;5149;4975;2019
03;Alicante/Alacant;054;Castell de Castells;449;236;213;2019
03;Alicante/Alacant;075;Castell de Guadalest, el;217;111;106;2019
03;Alicante/Alacant;055;Catral;8639;4307;4332;2019
03;Alicante/Alacant;056;Cocentaina;11511;5868;5643;2019
03;Alicante/Alacant;057;Confrides;187;106;81;2019
03;Alicante/Alacant;058;Cox;7297;3722;3575;2019
03;Alicante/Alacant;059;Crevillent;28952;14627;14325;2019
03;Alicante/Alacant;061;Daya Nueva;1737;852;885;2019
03;Alicante/Alacant;062;Daya Vieja;690;354;336;2019
03;Alicante/Alacant;063;Dénia;42166;20419;21747;2019
03;Alicante/Alacant;064;Dolores;7470;3740;3730;2019
03;Alicante/Alacant;065;Elche/Elx;232517;115151;117366;2019
03;Alicante/Alacant;066;Elda;52618;25639;26979;2019
03;Alicante/Alacant;067;Facheca;106;52;54;2019
03;Alicante/Alacant;068;Famorca;47;24;23;2019
03;Alicante/Alacant;069;Finestrat;6715;3440;3275;2019
03;Alicante/Alacant;077;Fondó de les Neus, el/Hondón de las Nieves;2544;1306;1238;2019
03;Alicante/Alacant;070;Formentera del Segura;4191;2105;2086;2019
03;Alicante/Alacant;072;Gaianes;452;227;225;2019
03;Alicante/Alacant;071;Gata de Gorgos;6049;3082;2967;2019
03;Alicante/Alacant;073;Gorga;249;140;109;2019
03;Alicante/Alacant;074;Granja de Rocamora;2580;1362;1218;2019
03;Alicante/Alacant;076;Guardamar del Segura;15348;7492;7856;2019
03;Alicante/Alacant;078;Hondón de los Frailes;1198;616;582;2019
03;Alicante/Alacant;079;Ibi;23489;11747;11742;2019
03;Alicante/Alacant;080;Jacarilla;2022;1030;992;2019
03;Alicante/Alacant;082;Jávea/Xàbia;27604;13681;13923;2019
03;Alicante/Alacant;083;Jijona/Xixona;6865;3342;3523;2019
03;Alicante/Alacant;085;Llíber;935;474;461;2019
03;Alicante/Alacant;084;Lorcha/Orxa, l';578;284;294;2019
03;Alicante/Alacant;086;Millena;237;127;110;2019
03;Alicante/Alacant;088;Monforte del Cid;8165;4292;3873;2019
03;Alicante/Alacant;089;Monóvar/Monòver;12167;6069;6098;2019
03;Alicante/Alacant;903;Montesinos, Los;4968;2520;2448;2019
03;Alicante/Alacant;091;Murla;470;220;250;2019
03;Alicante/Alacant;092;Muro de Alcoy;9324;4637;4687;2019
03;Alicante/Alacant;090;Mutxamel;25352;12662;12690;2019
03;Alicante/Alacant;093;Novelda;25651;12770;12881;2019
03;Alicante/Alacant;094;Nucia, la;18603;9425;9178;2019
03;Alicante/Alacant;095;Ondara;6894;3460;3434;2019
03;Alicante/Alacant;096;Onil;7507;3757;3750;2019
03;Alicante/Alacant;097;Orba;2174;1074;1100;2019
03;Alicante/Alacant;099;Orihuela;77414;38360;39054;2019
03;Alicante/Alacant;098;Orxeta;736;379;357;2019
03;Alicante/Alacant;100;Parcent;929;446;483;2019
03;Alicante/Alacant;101;Pedreguer;7699;3809;3890;2019
03;Alicante/Alacant;102;Pego;10128;5057;5071;2019
03;Alicante/Alacant;103;Penàguila;292;152;140;2019
03;Alicante/Alacant;104;Petrer;34276;17039;17237;2019
03;Alicante/Alacant;902;Pilar de la Horadada;21905;11236;10669;2019
03;Alicante/Alacant;105;Pinós, el/Pinoso;7966;4026;3940;2019
03;Alicante/Alacant;106;Planes;693;375;318;2019
03;Alicante/Alacant;901;Poblets, els;2705;1276;1429;2019
03;Alicante/Alacant;107;Polop;4965;2541;2424;2019
03;Alicante/Alacant;060;Quatretondeta;122;66;56;2019
03;Alicante/Alacant;109;Rafal;4498;2240;2258;2019
03;Alicante/Alacant;110;Ràfol d'Almúnia, el;653;334;319;2019
03;Alicante/Alacant;111;Redován;7869;4069;3800;2019
03;Alicante/Alacant;112;Relleu;1160;599;561;2019
03;Alicante/Alacant;113;Rojales;16963;8617;8346;2019
03;Alicante/Alacant;114;Romana, la;2434;1263;1171;2019
03;Alicante/Alacant;115;Sagra;408;198;210;2019
03;Alicante/Alacant;116;Salinas;1601;826;775;2019
03;Alicante/Alacant;118;San Fulgencio;7855;3964;3891;2019
03;Alicante/Alacant;904;San Isidro;1986;1024;962;2019
03;Alicante/Alacant;120;San Miguel de Salinas;6034;3044;2990;2019
03;Alicante/Alacant;122;San Vicente del Raspeig/Sant Vicent del Raspeig;58385;28864;29521;2019
03;Alicante/Alacant;117;Sanet y Negrals;667;341;326;2019
03;Alicante/Alacant;119;Sant Joan d'Alacant;23915;11538;12377;2019
03;Alicante/Alacant;121;Santa Pola;32306;16225;16081;2019
03;Alicante/Alacant;123;Sax;9845;4968;4877;2019
03;Alicante/Alacant;124;Sella;580;306;274;2019
03;Alicante/Alacant;125;Senija;584;302;282;2019
03;Alicante/Alacant;127;Tàrbena;646;335;311;2019
03;Alicante/Alacant;128;Teulada;11112;5541;5571;2019
03;Alicante/Alacant;129;Tibi;1614;851;763;2019
03;Alicante/Alacant;130;Tollos;57;30;27;2019
03;Alicante/Alacant;131;Tormos;340;163;177;2019
03;Alicante/Alacant;132;Torremanzanas/Torre de les Maçanes, la;661;352;309;2019
03;Alicante/Alacant;133;Torrevieja;83337;41269;42068;2019
03;Alicante/Alacant;134;Vall d'Alcalà, la;167;92;75;2019
03;Alicante/Alacant;136;Vall de Gallinera;571;304;267;2019
03;Alicante/Alacant;137;Vall de Laguar, la;846;427;419;2019
03;Alicante/Alacant;135;Vall d'Ebo, la;216;111;105;2019
03;Alicante/Alacant;138;Verger, el;4640;2302;2338;2019
03;Alicante/Alacant;139;Villajoyosa/Vila Joiosa, la;34673;17296;17377;2019
03;Alicante/Alacant;140;Villena;33964;17056;16908;2019
03;Alicante/Alacant;081;Xaló;2739;1378;1361;2019
04;Almería;001;Abla;1249;635;614;2019
04;Almería;002;Abrucena;1202;637;565;2019
04;Almería;003;Adra;25148;12833;12315;2019
04;Almería;004;Albanchez;741;379;362;2019
04;Almería;005;Alboloduy;616;302;314;2019
04;Almería;006;Albox;11805;6031;5774;2019
04;Almería;007;Alcolea;825;428;397;2019
04;Almería;008;Alcóntar;505;278;227;2019
04;Almería;009;Alcudia de Monteagud;152;73;79;2019
04;Almería;010;Alhabia;671;351;320;2019
04;Almería;011;Alhama de Almería;3641;1829;1812;2019
04;Almería;012;Alicún;206;110;96;2019
04;Almería;013;Almería;198533;96995;101538;2019
04;Almería;014;Almócita;169;88;81;2019
04;Almería;015;Alsodux;125;75;50;2019
04;Almería;016;Antas;3182;1614;1568;2019
04;Almería;017;Arboleas;4596;2312;2284;2019
04;Almería;018;Armuña de Almanzora;302;144;158;2019
04;Almería;019;Bacares;246;130;116;2019
04;Almería;904;Balanegra;3009;1583;1426;2019
04;Almería;020;Bayárcal;317;171;146;2019
04;Almería;021;Bayarque;215;102;113;2019
04;Almería;022;Bédar;971;491;480;2019
04;Almería;023;Beires;110;56;54;2019
04;Almería;024;Benahadux;4382;2160;2222;2019
04;Almería;026;Benitagla;58;32;26;2019
04;Almería;027;Benizalón;254;135;119;2019
04;Almería;028;Bentarique;238;133;105;2019
04;Almería;029;Berja;12415;6293;6122;2019
04;Almería;030;Canjáyar;1214;641;573;2019
04;Almería;031;Cantoria;3204;1625;1579;2019
04;Almería;032;Carboneras;8004;4120;3884;2019
04;Almería;033;Castro de Filabres;123;61;62;2019
04;Almería;036;Chercos;278;142;136;2019
04;Almería;037;Chirivel;1472;748;724;2019
04;Almería;034;Cóbdar;171;99;72;2019
04;Almería;035;Cuevas del Almanzora;14081;7343;6738;2019
04;Almería;038;Dalías;4006;1988;2018;2019
04;Almería;902;Ejido, El;83594;43596;39998;2019
04;Almería;041;Enix;466;259;207;2019
04;Almería;043;Felix;628;357;271;2019
04;Almería;044;Fines;2079;1093;986;2019
04;Almería;045;Fiñana;1994;1002;992;2019
04;Almería;046;Fondón;989;514;475;2019
04;Almería;047;Gádor;3012;1569;1443;2019
04;Almería;048;Gallardos, Los;2794;1408;1386;2019
04;Almería;049;Garrucha;9212;4763;4449;2019
04;Almería;050;Gérgal;1030;543;487;2019
04;Almería;051;Huécija;480;233;247;2019
04;Almería;052;Huércal de Almería;17651;8959;8692;2019
04;Almería;053;Huércal-Overa;19127;9514;9613;2019
04;Almería;054;Íllar;394;211;183;2019
04;Almería;055;Instinción;448;233;215;2019
04;Almería;056;Laroya;192;111;81;2019
04;Almería;057;Láujar de Andarax;1536;766;770;2019
04;Almería;058;Líjar;390;207;183;2019
04;Almería;059;Lubrín;1477;736;741;2019
04;Almería;060;Lucainena de las Torres;538;287;251;2019
04;Almería;061;Lúcar;763;373;390;2019
04;Almería;062;Macael;5482;2803;2679;2019
04;Almería;063;María;1238;637;601;2019
04;Almería;064;Mojácar;6403;3132;3271;2019
04;Almería;903;Mojonera, La;9021;5075;3946;2019
04;Almería;065;Nacimiento;495;255;240;2019
04;Almería;066;Níjar;30663;17075;13588;2019
04;Almería;067;Ohanes;580;292;288;2019
04;Almería;068;Olula de Castro;196;109;87;2019
04;Almería;069;Olula del Río;6210;3182;3028;2019
04;Almería;070;Oria;2249;1170;1079;2019
04;Almería;071;Padules;410;208;202;2019
04;Almería;072;Partaloa;1110;564;546;2019
04;Almería;073;Paterna del Río;371;215;156;2019
04;Almería;074;Pechina;4037;2043;1994;2019
04;Almería;075;Pulpí;10055;5283;4772;2019
04;Almería;076;Purchena;1618;851;767;2019
04;Almería;077;Rágol;316;166;150;2019
04;Almería;078;Rioja;1417;720;697;2019
04;Almería;079;Roquetas de Mar;96800;50110;46690;2019
04;Almería;080;Santa Cruz de Marchena;208;103;105;2019
04;Almería;081;Santa Fe de Mondújar;452;234;218;2019
04;Almería;082;Senés;295;156;139;2019
04;Almería;083;Serón;2041;1044;997;2019
04;Almería;084;Sierro;381;204;177;2019
04;Almería;085;Somontín;446;228;218;2019
04;Almería;086;Sorbas;2388;1254;1134;2019
04;Almería;087;Suflí;204;109;95;2019
04;Almería;088;Tabernas;3688;1898;1790;2019
04;Almería;089;Taberno;925;450;475;2019
04;Almería;090;Tahal;362;177;185;2019
04;Almería;091;Terque;377;198;179;2019
04;Almería;092;Tíjola;3541;1763;1778;2019
04;Almería;901;Tres Villas, Las;568;307;261;2019
04;Almería;093;Turre;3549;1819;1730;2019
04;Almería;094;Turrillas;240;138;102;2019
04;Almería;095;Uleila del Campo;833;418;415;2019
04;Almería;096;Urrácal;350;182;168;2019
04;Almería;097;Velefique;242;133;109;2019
04;Almería;098;Vélez-Blanco;1904;981;923;2019
04;Almería;099;Vélez-Rubio;6555;3207;3348;2019
04;Almería;100;Vera;16452;8396;8056;2019
04;Almería;101;Viator;5885;3004;2881;2019
04;Almería;102;Vícar;26028;14017;12011;2019
04;Almería;103;Zurgena;3005;1490;1515;2019
01;Araba/Álava;051;Agurain/Salvatierra;5062;2526;2536;2019
01;Araba/Álava;001;Alegría-Dulantzi;2876;1501;1375;2019
01;Araba/Álava;002;Amurrio;10350;5100;5250;2019
01;Araba/Álava;049;Añana;156;95;61;2019
01;Araba/Álava;003;Aramaio;1467;764;703;2019
01;Araba/Álava;006;Armiñón;227;119;108;2019
01;Araba/Álava;037;Arraia-Maeztu;726;403;323;2019
01;Araba/Álava;008;Arratzua-Ubarrundia;980;529;451;2019
01;Araba/Álava;004;Artziniega;1821;906;915;2019
01;Araba/Álava;009;Asparrena;1614;826;788;2019
01;Araba/Álava;010;Ayala/Aiara;2974;1500;1474;2019
01;Araba/Álava;011;Baños de Ebro/Mañueta;291;163;128;2019
01;Araba/Álava;013;Barrundia;883;491;392;2019
01;Araba/Álava;014;Berantevilla;453;243;210;2019
01;Araba/Álava;016;Bernedo;494;299;195;2019
01;Araba/Álava;017;Campezo/Kanpezu;1040;546;494;2019
01;Araba/Álava;021;Elburgo/Burgelu;599;320;279;2019
01;Araba/Álava;022;Elciego;1005;502;503;2019
01;Araba/Álava;023;Elvillar/Bilar;333;162;171;2019
01;Araba/Álava;047;Erriberabeitia;1350;724;626;2019
01;Araba/Álava;046;Erriberagoitia/Ribera Alta;785;453;332;2019
01;Araba/Álava;056;Harana/Valle de Arana;221;124;97;2019
01;Araba/Álava;901;Iruña Oka/Iruña de Oca;3411;1769;1642;2019
01;Araba/Álava;027;Iruraiz-Gauna;517;281;236;2019
01;Araba/Álava;019;Kripan;180;94;86;2019
01;Araba/Álava;020;Kuartango;376;220;156;2019
01;Araba/Álava;028;Labastida/Bastida;1452;751;701;2019
01;Araba/Álava;030;Lagrán;157;87;70;2019
01;Araba/Álava;031;Laguardia;1494;767;727;2019
01;Araba/Álava;032;Lanciego/Lantziego;691;367;324;2019
01;Araba/Álava;902;Lantarón;875;494;381;2019
01;Araba/Álava;033;Lapuebla de Labarca;865;439;426;2019
01;Araba/Álava;036;Laudio/Llodio;18102;8868;9234;2019
01;Araba/Álava;058;Legutio;1885;995;890;2019
01;Araba/Álava;034;Leza;203;100;103;2019
01;Araba/Álava;039;Moreda de Álava/Moreda Araba;221;108;113;2019
01;Araba/Álava;041;Navaridas;200;112;88;2019
01;Araba/Álava;042;Okondo;1188;611;577;2019
01;Araba/Álava;043;Oyón-Oion;3386;1708;1678;2019
01;Araba/Álava;044;Peñacerrada-Urizaharra;261;152;109;2019
01;Araba/Álava;052;Samaniego;316;158;158;2019
01;Araba/Álava;053;San Millán/Donemiliaga;715;393;322;2019
01;Araba/Álava;054;Urkabustaiz;1371;716;655;2019
01;Araba/Álava;055;Valdegovía/Gaubea;996;553;443;2019
01;Araba/Álava;057;Villabuena de Álava/Eskuernaga;296;149;147;2019
01;Araba/Álava;059;Vitoria-Gasteiz;251774;122711;129063;2019
01;Araba/Álava;060;Yécora/Iekora;268;140;128;2019
01;Araba/Álava;061;Zalduondo;183;103;80;2019
01;Araba/Álava;062;Zambrana;410;223;187;2019
01;Araba/Álava;018;Zigoitia;1747;944;803;2019
01;Araba/Álava;063;Zuia;2302;1190;1112;2019
33;Asturias;001;Allande;1648;833;815;2019
33;Asturias;002;Aller;10613;5248;5365;2019
33;Asturias;003;Amieva;661;378;283;2019
33;Asturias;004;Avilés;78182;36993;41189;2019
33;Asturias;005;Belmonte de Miranda;1489;787;702;2019
33;Asturias;006;Bimenes;1681;803;878;2019
33;Asturias;007;Boal;1505;755;750;2019
33;Asturias;008;Cabrales;1960;1001;959;2019
33;Asturias;009;Cabranes;1034;519;515;2019
33;Asturias;010;Candamo;1947;950;997;2019
33;Asturias;012;Cangas de Onís;6163;2997;3166;2019
33;Asturias;011;Cangas del Narcea;12347;6070;6277;2019
33;Asturias;013;Caravia;477;246;231;2019
33;Asturias;014;Carreño;10337;4977;5360;2019
33;Asturias;015;Caso;1507;873;634;2019
33;Asturias;016;Castrillón;22376;10849;11527;2019
33;Asturias;017;Castropol;3402;1661;1741;2019
33;Asturias;018;Coaña;3315;1607;1708;2019
33;Asturias;019;Colunga;3257;1599;1658;2019
33;Asturias;020;Corvera de Asturias;15549;7622;7927;2019
33;Asturias;021;Cudillero;4987;2448;2539;2019
33;Asturias;022;Degaña;921;478;443;2019
33;Asturias;023;Franco, El;3796;1865;1931;2019
33;Asturias;024;Gijón;271780;128128;143652;2019
33;Asturias;025;Gozón;10333;5047;5286;2019
33;Asturias;026;Grado;9784;4746;5038;2019
33;Asturias;027;Grandas de Salime;835;426;409;2019
33;Asturias;028;Ibias;1251;718;533;2019
33;Asturias;029;Illano;346;173;173;2019
33;Asturias;030;Illas;1014;512;502;2019
33;Asturias;031;Langreo;39420;18787;20633;2019
33;Asturias;032;Laviana;12977;6214;6763;2019
33;Asturias;033;Lena;10890;5223;5667;2019
33;Asturias;035;Llanera;13702;6792;6910;2019
33;Asturias;036;Llanes;13568;6584;6984;2019
33;Asturias;037;Mieres;37959;18015;19944;2019
33;Asturias;038;Morcín;2594;1303;1291;2019
33;Asturias;039;Muros de Nalón;1871;898;973;2019
33;Asturias;040;Nava;5321;2616;2705;2019
33;Asturias;041;Navia;8380;4033;4347;2019
33;Asturias;042;Noreña;5179;2478;2701;2019
33;Asturias;043;Onís;743;402;341;2019
33;Asturias;044;Oviedo;219686;101732;117954;2019
33;Asturias;045;Parres;5336;2588;2748;2019
33;Asturias;046;Peñamellera Alta;514;271;243;2019
33;Asturias;047;Peñamellera Baja;1226;606;620;2019
33;Asturias;048;Pesoz;147;82;65;2019
33;Asturias;049;Piloña;6973;3436;3537;2019
33;Asturias;050;Ponga;586;343;243;2019
33;Asturias;051;Pravia;8113;3918;4195;2019
33;Asturias;052;Proaza;744;431;313;2019
33;Asturias;053;Quirós;1158;671;487;2019
33;Asturias;054;Regueras, Las;1826;941;885;2019
33;Asturias;055;Ribadedeva;1756;848;908;2019
33;Asturias;056;Ribadesella;5746;2731;3015;2019
33;Asturias;057;Ribera de Arriba;1854;926;928;2019
33;Asturias;058;Riosa;1858;931;927;2019
33;Asturias;059;Salas;4959;2449;2510;2019
33;Asturias;061;San Martín de Oscos;377;193;184;2019
33;Asturias;060;San Martín del Rey Aurelio;16074;7688;8386;2019
33;Asturias;063;San Tirso de Abres;410;203;207;2019
33;Asturias;062;Santa Eulalia de Oscos;450;234;216;2019
33;Asturias;064;Santo Adriano;288;144;144;2019
33;Asturias;065;Sariego;1252;604;648;2019
33;Asturias;066;Siero;51667;25255;26412;2019
33;Asturias;067;Sobrescobio;811;433;378;2019
33;Asturias;068;Somiedo;1153;676;477;2019
33;Asturias;069;Soto del Barco;3866;1916;1950;2019
33;Asturias;070;Tapia de Casariego;3786;1841;1945;2019
33;Asturias;071;Taramundi;623;297;326;2019
33;Asturias;072;Teverga;1572;856;716;2019
33;Asturias;073;Tineo;9389;4748;4641;2019
33;Asturias;034;Valdés;11504;5619;5885;2019
33;Asturias;074;Vegadeo;3926;1884;2042;2019
33;Asturias;075;Villanueva de Oscos;292;146;146;2019
33;Asturias;076;Villaviciosa;14439;7146;7293;2019
33;Asturias;077;Villayón;1206;623;583;2019
33;Asturias;078;Yernes y Tameza;132;73;59;2019
05;Ávila;001;Adanero;196;111;85;2019
05;Ávila;002;Adrada, La;2480;1286;1194;2019
05;Ávila;005;Albornos;183;98;85;2019
05;Ávila;007;Aldeanueva de Santa Cruz;118;62;56;2019
05;Ávila;008;Aldeaseca;238;116;122;2019
05;Ávila;010;Aldehuela, La;162;83;79;2019
05;Ávila;012;Amavida;132;70;62;2019
05;Ávila;013;Arenal, El;973;497;476;2019
05;Ávila;014;Arenas de San Pedro;6377;3105;3272;2019
05;Ávila;015;Arevalillo;73;35;38;2019
05;Ávila;016;Arévalo;7986;3877;4109;2019
05;Ávila;017;Aveinte;86;50;36;2019
05;Ávila;018;Avellaneda;24;14;10;2019
05;Ávila;019;Ávila;57744;27474;30270;2019
05;Ávila;021;Barco de Ávila, El;2312;1123;1189;2019
05;Ávila;022;Barraco, El;1861;955;906;2019
05;Ávila;023;Barromán;185;100;85;2019
05;Ávila;024;Becedas;196;105;91;2019
05;Ávila;025;Becedillas;84;46;38;2019
05;Ávila;026;Bercial de Zapardiel;200;106;94;2019
05;Ávila;027;Berlanas, Las;319;168;151;2019
05;Ávila;029;Bernuy-Zapardiel;102;60;42;2019
05;Ávila;030;Berrocalejo de Aragona;46;24;22;2019
05;Ávila;033;Blascomillán;193;103;90;2019
05;Ávila;034;Blasconuño de Matacabras;16;8;8;2019
05;Ávila;035;Blascosancho;105;53;52;2019
05;Ávila;036;Bohodón, El;120;60;60;2019
05;Ávila;037;Bohoyo;237;135;102;2019
05;Ávila;038;Bonilla de la Sierra;120;71;49;2019
05;Ávila;039;Brabos;46;29;17;2019
05;Ávila;040;Bularros;66;43;23;2019
05;Ávila;041;Burgohondo;1195;622;573;2019
05;Ávila;042;Cabezas de Alambre;157;78;79;2019
05;Ávila;043;Cabezas del Pozo;75;41;34;2019
05;Ávila;044;Cabezas del Villar;260;142;118;2019
05;Ávila;045;Cabizuela;84;43;41;2019
05;Ávila;046;Canales;45;25;20;2019
05;Ávila;047;Candeleda;5018;2536;2482;2019
05;Ávila;048;Cantiveros;103;59;44;2019
05;Ávila;049;Cardeñosa;447;240;207;2019
05;Ávila;051;Carrera, La;175;96;79;2019
05;Ávila;052;Casas del Puerto;89;47;42;2019
05;Ávila;053;Casasola;75;45;30;2019
05;Ávila;054;Casavieja;1424;736;688;2019
05;Ávila;055;Casillas;638;334;304;2019
05;Ávila;056;Castellanos de Zapardiel;97;54;43;2019
05;Ávila;057;Cebreros;3120;1614;1506;2019
05;Ávila;058;Cepeda la Mora;74;42;32;2019
05;Ávila;067;Chamartín;76;45;31;2019
05;Ávila;059;Cillán;93;56;37;2019
05;Ávila;060;Cisla;102;50;52;2019
05;Ávila;061;Colilla, La;336;175;161;2019
05;Ávila;062;Collado de Contreras;168;85;83;2019
05;Ávila;063;Collado del Mirón;32;21;11;2019
05;Ávila;064;Constanzana;108;63;45;2019
05;Ávila;065;Crespos;495;265;230;2019
05;Ávila;066;Cuevas del Valle;484;267;217;2019
05;Ávila;903;Diego del Carpio;139;79;60;2019
05;Ávila;069;Donjimeno;78;44;34;2019
05;Ávila;070;Donvidas;34;18;16;2019
05;Ávila;072;Espinosa de los Caballeros;114;62;52;2019
05;Ávila;073;Flores de Ávila;306;168;138;2019
05;Ávila;074;Fontiveros;748;387;361;2019
05;Ávila;075;Fresnedilla;116;58;58;2019
05;Ávila;076;Fresno, El;589;310;279;2019
05;Ávila;077;Fuente el Saúz;170;91;79;2019
05;Ávila;078;Fuentes de Año;100;58;42;2019
05;Ávila;079;Gallegos de Altamiros;70;39;31;2019
05;Ávila;080;Gallegos de Sobrinos;42;21;21;2019
05;Ávila;081;Garganta del Villar;39;27;12;2019
05;Ávila;082;Gavilanes;586;312;274;2019
05;Ávila;083;Gemuño;156;81;75;2019
05;Ávila;085;Gil García;35;17;18;2019
05;Ávila;084;Gilbuena;64;37;27;2019
05;Ávila;086;Gimialcón;75;47;28;2019
05;Ávila;087;Gotarrendura;162;56;106;2019
05;Ávila;088;Grandes y San Martín;27;13;14;2019
05;Ávila;089;Guisando;497;249;248;2019
05;Ávila;090;Gutierre-Muñoz;78;39;39;2019
05;Ávila;092;Hernansancho;159;93;66;2019
05;Ávila;093;Herradón de Pinares;413;228;185;2019
05;Ávila;094;Herreros de Suso;126;69;57;2019
05;Ávila;095;Higuera de las Dueñas;262;148;114;2019
05;Ávila;096;Hija de Dios, La;80;49;31;2019
05;Ávila;097;Horcajada, La;508;265;243;2019
05;Ávila;099;Horcajo de las Torres;505;281;224;2019
05;Ávila;100;Hornillo, El;290;153;137;2019
05;Ávila;102;Hoyo de Pinares, El;2131;1101;1030;2019
05;Ávila;101;Hoyocasero;293;173;120;2019
05;Ávila;103;Hoyorredondo;63;33;30;2019
05;Ávila;106;Hoyos de Miguel Muñoz;28;15;13;2019
05;Ávila;104;Hoyos del Collado;33;19;14;2019
05;Ávila;105;Hoyos del Espino;383;211;172;2019
05;Ávila;107;Hurtumpascual;51;32;19;2019
05;Ávila;108;Junciana;38;20;18;2019
05;Ávila;109;Langa;478;253;225;2019
05;Ávila;110;Lanzahíta;828;423;405;2019
05;Ávila;113;Llanos de Tormes, Los;60;27;33;2019
05;Ávila;112;Losar del Barco, El;105;53;52;2019
05;Ávila;114;Madrigal de las Altas Torres;1415;717;698;2019
05;Ávila;115;Maello;594;308;286;2019
05;Ávila;116;Malpartida de Corneja;99;50;49;2019
05;Ávila;117;Mamblas;204;117;87;2019
05;Ávila;118;Mancera de Arriba;74;38;36;2019
05;Ávila;119;Manjabálago y Ortigosa de Rioalmar;24;15;9;2019
05;Ávila;120;Marlín;30;19;11;2019
05;Ávila;121;Martiherrero;312;158;154;2019
05;Ávila;122;Martínez;116;60;56;2019
05;Ávila;123;Mediana de Voltoya;112;55;57;2019
05;Ávila;124;Medinilla;95;43;52;2019
05;Ávila;125;Mengamuñoz;59;29;30;2019
05;Ávila;126;Mesegar de Corneja;62;36;26;2019
05;Ávila;127;Mijares;701;383;318;2019
05;Ávila;128;Mingorría;387;204;183;2019
05;Ávila;129;Mirón, El;122;72;50;2019
05;Ávila;130;Mironcillo;102;53;49;2019
05;Ávila;131;Mirueña de los Infanzones;95;54;41;2019
05;Ávila;132;Mombeltrán;991;507;484;2019
05;Ávila;133;Monsalupe;71;36;35;2019
05;Ávila;134;Moraleja de Matacabras;52;30;22;2019
05;Ávila;135;Muñana;375;201;174;2019
05;Ávila;136;Muñico;89;47;42;2019
05;Ávila;138;Muñogalindo;326;167;159;2019
05;Ávila;139;Muñogrande;66;38;28;2019
05;Ávila;140;Muñomer del Peco;118;64;54;2019
05;Ávila;141;Muñopepe;100;56;44;2019
05;Ávila;142;Muñosancho;92;44;48;2019
05;Ávila;143;Muñotello;62;31;31;2019
05;Ávila;144;Narrillos del Álamo;72;37;35;2019
05;Ávila;145;Narrillos del Rebollar;48;27;21;2019
05;Ávila;149;Narros de Saldueña;103;61;42;2019
05;Ávila;147;Narros del Castillo;155;85;70;2019
05;Ávila;148;Narros del Puerto;24;12;12;2019
05;Ávila;152;Nava de Arévalo;735;386;349;2019
05;Ávila;153;Nava del Barco;84;45;39;2019
05;Ávila;151;Navacepedilla de Corneja;92;46;46;2019
05;Ávila;154;Navadijos;37;25;12;2019
05;Ávila;155;Navaescurial;51;31;20;2019
05;Ávila;156;Navahondilla;304;178;126;2019
05;Ávila;157;Navalacruz;247;137;110;2019
05;Ávila;158;Navalmoral;326;175;151;2019
05;Ávila;159;Navalonguilla;226;114;112;2019
05;Ávila;160;Navalosa;308;173;135;2019
05;Ávila;161;Navalperal de Pinares;770;401;369;2019
05;Ávila;162;Navalperal de Tormes;82;42;40;2019
05;Ávila;163;Navaluenga;1954;970;984;2019
05;Ávila;164;Navaquesera;16;8;8;2019
05;Ávila;165;Navarredonda de Gredos;434;217;217;2019
05;Ávila;166;Navarredondilla;172;87;85;2019
05;Ávila;167;Navarrevisca;261;146;115;2019
05;Ávila;168;Navas del Marqués, Las;5119;2608;2511;2019
05;Ávila;169;Navatalgordo;233;133;100;2019
05;Ávila;170;Navatejares;55;25;30;2019
05;Ávila;171;Neila de San Miguel;65;34;31;2019
05;Ávila;172;Niharra;180;104;76;2019
05;Ávila;173;Ojos-Albos;82;50;32;2019
05;Ávila;174;Orbita;75;39;36;2019
05;Ávila;175;Oso, El;160;92;68;2019
05;Ávila;176;Padiernos;271;149;122;2019
05;Ávila;177;Pajares de Adaja;149;81;68;2019
05;Ávila;178;Palacios de Goda;400;207;193;2019
05;Ávila;179;Papatrigo;226;113;113;2019
05;Ávila;180;Parral, El;67;36;31;2019
05;Ávila;181;Pascualcobo;45;29;16;2019
05;Ávila;182;Pedro Bernardo;817;432;385;2019
05;Ávila;183;Pedro-Rodríguez;134;71;63;2019
05;Ávila;184;Peguerinos;272;155;117;2019
05;Ávila;185;Peñalba de Ávila;102;55;47;2019
05;Ávila;186;Piedrahíta;1822;882;940;2019
05;Ávila;187;Piedralaves;2061;1024;1037;2019
05;Ávila;188;Poveda;42;27;15;2019
05;Ávila;189;Poyales del Hoyo;453;242;211;2019
05;Ávila;190;Pozanco;49;30;19;2019
05;Ávila;191;Pradosegar;124;62;62;2019
05;Ávila;192;Puerto Castilla;106;64;42;2019
05;Ávila;193;Rasueros;182;101;81;2019
05;Ávila;194;Riocabado;140;79;61;2019
05;Ávila;195;Riofrío;215;126;89;2019
05;Ávila;196;Rivilla de Barajas;62;28;34;2019
05;Ávila;197;Salobral;113;62;51;2019
05;Ávila;198;Salvadiós;73;34;39;2019
05;Ávila;199;San Bartolomé de Béjar;37;19;18;2019
05;Ávila;200;San Bartolomé de Corneja;46;23;23;2019
05;Ávila;201;San Bartolomé de Pinares;541;294;247;2019
05;Ávila;206;San Esteban de los Patos;31;20;11;2019
05;Ávila;208;San Esteban de Zapardiel;37;23;14;2019
05;Ávila;207;San Esteban del Valle;720;372;348;2019
05;Ávila;209;San García de Ingelmos;75;47;28;2019
05;Ávila;901;San Juan de Gredos;256;139;117;2019
05;Ávila;210;San Juan de la Encinilla;82;40;42;2019
05;Ávila;211;San Juan de la Nava;468;251;217;2019
05;Ávila;212;San Juan del Molinillo;197;114;83;2019
05;Ávila;213;San Juan del Olmo;97;61;36;2019
05;Ávila;214;San Lorenzo de Tormes;31;17;14;2019
05;Ávila;215;San Martín de la Vega del Alberche;168;97;71;2019
05;Ávila;216;San Martín del Pimpollar;189;112;77;2019
05;Ávila;217;San Miguel de Corneja;57;32;25;2019
05;Ávila;218;San Miguel de Serrezuela;115;62;53;2019
05;Ávila;219;San Pascual;44;26;18;2019
05;Ávila;220;San Pedro del Arroyo;431;231;200;2019
05;Ávila;231;San Vicente de Arévalo;169;99;70;2019
05;Ávila;204;Sanchidrián;716;365;351;2019
05;Ávila;205;Sanchorreja;84;42;42;2019
05;Ávila;222;Santa Cruz de Pinares;159;83;76;2019
05;Ávila;221;Santa Cruz del Valle;341;177;164;2019
05;Ávila;226;Santa María de los Caballeros;66;39;27;2019
05;Ávila;224;Santa María del Arroyo;105;55;50;2019
05;Ávila;225;Santa María del Berrocal;392;208;184;2019
05;Ávila;902;Santa María del Cubillo;317;183;134;2019
05;Ávila;227;Santa María del Tiétar;445;232;213;2019
05;Ávila;228;Santiago del Collado;173;110;63;2019
05;Ávila;904;Santiago del Tormes;118;68;50;2019
05;Ávila;229;Santo Domingo de las Posadas;86;44;42;2019
05;Ávila;230;Santo Tomé de Zabarcos;65;35;30;2019
05;Ávila;232;Serrada, La;117;60;57;2019
05;Ávila;233;Serranillos;247;139;108;2019
05;Ávila;234;Sigeres;46;23;23;2019
05;Ávila;235;Sinlabajos;142;73;69;2019
05;Ávila;236;Solana de Ávila;110;64;46;2019
05;Ávila;237;Solana de Rioalmar;159;93;66;2019
05;Ávila;238;Solosancho;827;437;390;2019
05;Ávila;239;Sotalbo;256;141;115;2019
05;Ávila;240;Sotillo de la Adrada;4590;2269;2321;2019
05;Ávila;241;Tiemblo, El;4109;2086;2023;2019
05;Ávila;242;Tiñosillos;787;405;382;2019
05;Ávila;243;Tolbaños;82;45;37;2019
05;Ávila;244;Tormellas;40;26;14;2019
05;Ávila;245;Tornadizos de Ávila;417;212;205;2019
05;Ávila;247;Torre, La;239;132;107;2019
05;Ávila;246;Tórtoles;51;30;21;2019
05;Ávila;249;Umbrías;99;53;46;2019
05;Ávila;251;Vadillo de la Sierra;60;39;21;2019
05;Ávila;252;Valdecasa;61;36;25;2019
05;Ávila;253;Vega de Santa María;83;41;42;2019
05;Ávila;254;Velayos;211;109;102;2019
05;Ávila;256;Villaflor;113;60;53;2019
05;Ávila;257;Villafranca de la Sierra;134;77;57;2019
05;Ávila;905;Villanueva de Ávila;226;118;108;2019
05;Ávila;258;Villanueva de Gómez;115;65;50;2019
05;Ávila;259;Villanueva del Aceral;118;59;59;2019
05;Ávila;260;Villanueva del Campillo;101;56;45;2019
05;Ávila;261;Villar de Corneja;33;19;14;2019
05;Ávila;262;Villarejo del Valle;347;183;164;2019
05;Ávila;263;Villatoro;162;94;68;2019
05;Ávila;264;Viñegra de Moraña;57;32;25;2019
05;Ávila;265;Vita;84;49;35;2019
05;Ávila;266;Zapardiel de la Cañada;94;50;44;2019
05;Ávila;267;Zapardiel de la Ribera;116;60;56;2019
06;Badajoz;001;Acedera;807;416;391;2019
06;Badajoz;002;Aceuchal;5449;2711;2738;2019
06;Badajoz;003;Ahillones;871;430;441;2019
06;Badajoz;004;Alange;1848;935;913;2019
06;Badajoz;005;Albuera, La;2028;1064;964;2019
06;Badajoz;006;Alburquerque;5343;2659;2684;2019
06;Badajoz;007;Alconchel;1680;846;834;2019
06;Badajoz;008;Alconera;744;366;378;2019
06;Badajoz;009;Aljucén;264;146;118;2019
06;Badajoz;010;Almendral;1232;606;626;2019
06;Badajoz;011;Almendralejo;33474;16595;16879;2019
06;Badajoz;012;Arroyo de San Serván;4107;2085;2022;2019
06;Badajoz;013;Atalaya;301;154;147;2019
06;Badajoz;014;Azuaga;7853;3893;3960;2019
06;Badajoz;015;Badajoz;150702;73078;77624;2019
06;Badajoz;016;Barcarrota;3510;1777;1733;2019
06;Badajoz;017;Baterno;283;151;132;2019
06;Badajoz;018;Benquerencia de la Serena;829;413;416;2019
06;Badajoz;019;Berlanga;2343;1165;1178;2019
06;Badajoz;020;Bienvenida;2087;1071;1016;2019
06;Badajoz;021;Bodonal de la Sierra;1049;542;507;2019
06;Badajoz;022;Burguillos del Cerro;3057;1508;1549;2019
06;Badajoz;023;Cabeza del Buey;4864;2407;2457;2019
06;Badajoz;024;Cabeza la Vaca;1309;669;640;2019
06;Badajoz;025;Calamonte;6162;3058;3104;2019
06;Badajoz;026;Calera de León;960;486;474;2019
06;Badajoz;027;Calzadilla de los Barros;755;375;380;2019
06;Badajoz;028;Campanario;4896;2403;2493;2019
06;Badajoz;029;Campillo de Llerena;1360;689;671;2019
06;Badajoz;030;Capilla;182;96;86;2019
06;Badajoz;031;Carmonita;540;274;266;2019
06;Badajoz;032;Carrascalejo, El;83;42;41;2019
06;Badajoz;033;Casas de Don Pedro;1439;745;694;2019
06;Badajoz;034;Casas de Reina;196;95;101;2019
06;Badajoz;035;Castilblanco;951;484;467;2019
06;Badajoz;036;Castuera;5880;2898;2982;2019
06;Badajoz;042;Cheles;1176;570;606;2019
06;Badajoz;037;Codosera, La;2075;1097;978;2019
06;Badajoz;038;Cordobilla de Lácara;909;472;437;2019
06;Badajoz;039;Coronada, La;2162;1057;1105;2019
06;Badajoz;040;Corte de Peleas;1222;602;620;2019
06;Badajoz;041;Cristina;552;283;269;2019
06;Badajoz;043;Don Álvaro;788;405;383;2019
06;Badajoz;044;Don Benito;37151;18362;18789;2019
06;Badajoz;045;Entrín Bajo;551;280;271;2019
06;Badajoz;046;Esparragalejo;1462;722;740;2019
06;Badajoz;047;Esparragosa de la Serena;1019;517;502;2019
06;Badajoz;048;Esparragosa de Lares;925;451;474;2019
06;Badajoz;049;Feria;1144;559;585;2019
06;Badajoz;050;Fregenal de la Sierra;4847;2377;2470;2019
06;Badajoz;051;Fuenlabrada de los Montes;1845;908;937;2019
06;Badajoz;052;Fuente de Cantos;4721;2335;2386;2019
06;Badajoz;053;Fuente del Arco;688;353;335;2019
06;Badajoz;054;Fuente del Maestre;6743;3349;3394;2019
06;Badajoz;055;Fuentes de León;2302;1136;1166;2019
06;Badajoz;056;Garbayuela;508;267;241;2019
06;Badajoz;057;Garlitos;587;305;282;2019
06;Badajoz;058;Garrovilla, La;2346;1166;1180;2019
06;Badajoz;059;Granja de Torrehermosa;2014;1001;1013;2019
06;Badajoz;903;Guadiana del Caudillo;2485;1224;1261;2019
06;Badajoz;060;Guareña;6964;3495;3469;2019
06;Badajoz;061;Haba, La;1243;626;617;2019
06;Badajoz;062;Helechosa de los Montes;647;363;284;2019
06;Badajoz;063;Herrera del Duque;3482;1748;1734;2019
06;Badajoz;064;Higuera de la Serena;948;494;454;2019
06;Badajoz;065;Higuera de Llerena;347;178;169;2019
06;Badajoz;066;Higuera de Vargas;1955;982;973;2019
06;Badajoz;067;Higuera la Real;2253;1132;1121;2019
06;Badajoz;068;Hinojosa del Valle;483;231;252;2019
06;Badajoz;069;Hornachos;3595;1807;1788;2019
06;Badajoz;070;Jerez de los Caballeros;9303;4580;4723;2019
06;Badajoz;071;Lapa, La;281;143;138;2019
06;Badajoz;073;Llera;836;426;410;2019
06;Badajoz;074;Llerena;5804;2878;2926;2019
06;Badajoz;072;Lobón;2746;1408;1338;2019
06;Badajoz;075;Magacela;530;272;258;2019
06;Badajoz;076;Maguilla;974;480;494;2019
06;Badajoz;077;Malcocinado;365;198;167;2019
06;Badajoz;078;Malpartida de la Serena;556;290;266;2019
06;Badajoz;079;Manchita;765;385;380;2019
06;Badajoz;080;Medellín;2263;1132;1131;2019
06;Badajoz;081;Medina de las Torres;1184;613;571;2019
06;Badajoz;082;Mengabril;475;260;215;2019
06;Badajoz;083;Mérida;59335;28918;30417;2019
06;Badajoz;084;Mirandilla;1267;641;626;2019
06;Badajoz;085;Monesterio;4226;2165;2061;2019
06;Badajoz;086;Montemolín;1343;646;697;2019
06;Badajoz;087;Monterrubio de la Serena;2372;1168;1204;2019
06;Badajoz;088;Montijo;15457;7640;7817;2019
06;Badajoz;089;Morera, La;715;365;350;2019
06;Badajoz;090;Nava de Santiago, La;932;471;461;2019
06;Badajoz;091;Navalvillar de Pela;4424;2240;2184;2019
06;Badajoz;092;Nogales;652;329;323;2019
06;Badajoz;093;Oliva de la Frontera;5137;2571;2566;2019
06;Badajoz;094;Oliva de Mérida;1729;874;855;2019
06;Badajoz;095;Olivenza;11963;5967;5996;2019
06;Badajoz;096;Orellana de la Sierra;228;113;115;2019
06;Badajoz;097;Orellana la Vieja;2693;1389;1304;2019
06;Badajoz;098;Palomas;678;341;337;2019
06;Badajoz;099;Parra, La;1346;699;647;2019
06;Badajoz;100;Peñalsordo;918;439;479;2019
06;Badajoz;101;Peraleda del Zaucejo;513;259;254;2019
06;Badajoz;102;Puebla de Alcocer;1184;591;593;2019
06;Badajoz;103;Puebla de la Calzada;5845;2917;2928;2019
06;Badajoz;104;Puebla de la Reina;741;370;371;2019
06;Badajoz;107;Puebla de Obando;1836;931;905;2019
06;Badajoz;108;Puebla de Sancho Pérez;2709;1367;1342;2019
06;Badajoz;105;Puebla del Maestre;685;351;334;2019
06;Badajoz;106;Puebla del Prior;490;256;234;2019
06;Badajoz;902;Pueblonuevo del Guadiana;2021;1018;1003;2019
06;Badajoz;109;Quintana de la Serena;4597;2322;2275;2019
06;Badajoz;110;Reina;153;76;77;2019
06;Badajoz;111;Rena;616;316;300;2019
06;Badajoz;112;Retamal de Llerena;443;227;216;2019
06;Badajoz;113;Ribera del Fresno;3348;1662;1686;2019
06;Badajoz;114;Risco;140;70;70;2019
06;Badajoz;115;Roca de la Sierra, La;1464;718;746;2019
06;Badajoz;116;Salvaleón;1755;877;878;2019
06;Badajoz;117;Salvatierra de los Barros;1645;799;846;2019
06;Badajoz;119;San Pedro de Mérida;843;435;408;2019
06;Badajoz;123;San Vicente de Alcántara;5408;2729;2679;2019
06;Badajoz;118;Sancti-Spíritus;167;96;71;2019
06;Badajoz;120;Santa Amalia;4021;2033;1988;2019
06;Badajoz;121;Santa Marta;4122;2078;2044;2019
06;Badajoz;122;Santos de Maimona, Los;8091;4087;4004;2019
06;Badajoz;124;Segura de León;1889;942;947;2019
06;Badajoz;125;Siruela;1903;962;941;2019
06;Badajoz;126;Solana de los Barros;2623;1308;1315;2019
06;Badajoz;127;Talarrubias;3412;1700;1712;2019
06;Badajoz;128;Talavera la Real;5314;2651;2663;2019
06;Badajoz;129;Táliga;665;334;331;2019
06;Badajoz;130;Tamurejo;214;113;101;2019
06;Badajoz;131;Torre de Miguel Sesmero;1250;641;609;2019
06;Badajoz;132;Torremayor;957;465;492;2019
06;Badajoz;133;Torremejía;2250;1163;1087;2019
06;Badajoz;134;Trasierra;622;328;294;2019
06;Badajoz;135;Trujillanos;1387;710;677;2019
06;Badajoz;136;Usagre;1763;873;890;2019
06;Badajoz;137;Valdecaballeros;1077;558;519;2019
06;Badajoz;901;Valdelacalzada;2711;1384;1327;2019
06;Badajoz;138;Valdetorres;1173;573;600;2019
06;Badajoz;139;Valencia de las Torres;564;296;268;2019
06;Badajoz;140;Valencia del Mombuey;744;379;365;2019
06;Badajoz;141;Valencia del Ventoso;1973;975;998;2019
06;Badajoz;146;Valle de la Serena;1191;600;591;2019
06;Badajoz;147;Valle de Matamoros;367;179;188;2019
06;Badajoz;148;Valle de Santa Ana;1139;559;580;2019
06;Badajoz;142;Valverde de Burguillos;273;145;128;2019
06;Badajoz;143;Valverde de Leganés;4159;2093;2066;2019
06;Badajoz;144;Valverde de Llerena;585;293;292;2019
06;Badajoz;145;Valverde de Mérida;1055;535;520;2019
06;Badajoz;149;Villafranca de los Barros;12835;6311;6524;2019
06;Badajoz;150;Villagarcía de la Torre;907;468;439;2019
06;Badajoz;151;Villagonzalo;1234;601;633;2019
06;Badajoz;152;Villalba de los Barros;1477;746;731;2019
06;Badajoz;153;Villanueva de la Serena;25667;12486;13181;2019
06;Badajoz;154;Villanueva del Fresno;3397;1697;1700;2019
06;Badajoz;156;Villar de Rena;1379;709;670;2019
06;Badajoz;155;Villar del Rey;2117;1125;992;2019
06;Badajoz;157;Villarta de los Montes;437;221;216;2019
06;Badajoz;158;Zafra;16797;8094;8703;2019
06;Badajoz;159;Zahínos;2803;1391;1412;2019
06;Badajoz;160;Zalamea de la Serena;3555;1788;1767;2019
06;Badajoz;162;Zarza, La;3472;1749;1723;2019
06;Badajoz;161;Zarza-Capilla;311;155;156;2019
07;Balears, Illes;002;Alaior;9065;4576;4489;2019
07;Balears, Illes;001;Alaró;5572;2689;2883;2019
07;Balears, Illes;003;Alcúdia;20241;10252;9989;2019
07;Balears, Illes;004;Algaida;5642;2882;2760;2019
07;Balears, Illes;005;Andratx;11271;5625;5646;2019
07;Balears, Illes;901;Ariany;868;453;415;2019
07;Balears, Illes;006;Artà;7845;3949;3896;2019
07;Balears, Illes;007;Banyalbufar;515;272;243;2019
07;Balears, Illes;008;Binissalem;8567;4246;4321;2019
07;Balears, Illes;009;Búger;1050;551;499;2019
07;Balears, Illes;010;Bunyola;6809;3333;3476;2019
07;Balears, Illes;011;Calvià;50559;25395;25164;2019
07;Balears, Illes;012;Campanet;2640;1352;1288;2019
07;Balears, Illes;013;Campos;10862;5433;5429;2019
07;Balears, Illes;014;Capdepera;11868;6059;5809;2019
07;Balears, Illes;064;Castell, Es;7434;3785;3649;2019
07;Balears, Illes;015;Ciutadella de Menorca;29840;14802;15038;2019
07;Balears, Illes;016;Consell;4053;2024;2029;2019
07;Balears, Illes;017;Costitx;1288;638;650;2019
07;Balears, Illes;018;Deià;617;299;318;2019
07;Balears, Illes;026;Eivissa;49783;25031;24752;2019
07;Balears, Illes;019;Escorca;212;129;83;2019
07;Balears, Illes;020;Esporles;5062;2503;2559;2019
07;Balears, Illes;021;Estellencs;315;174;141;2019
07;Balears, Illes;022;Felanitx;17780;8956;8824;2019
07;Balears, Illes;023;Ferreries;4777;2384;2393;2019
07;Balears, Illes;024;Formentera;12111;6365;5746;2019
07;Balears, Illes;025;Fornalutx;660;330;330;2019
07;Balears, Illes;027;Inca;33319;16831;16488;2019
07;Balears, Illes;028;Lloret de Vistalegre;1372;694;678;2019
07;Balears, Illes;029;Lloseta;5988;3009;2979;2019
07;Balears, Illes;030;Llubí;2273;1140;1133;2019
07;Balears, Illes;031;Llucmajor;36914;18702;18212;2019
07;Balears, Illes;033;Manacor;43808;21927;21881;2019
07;Balears, Illes;034;Mancor de la Vall;1509;763;746;2019
07;Balears, Illes;032;Maó-Mahón;29040;14147;14893;2019
07;Balears, Illes;035;Maria de la Salut;2227;1156;1071;2019
07;Balears, Illes;036;Marratxí;37193;18735;18458;2019
07;Balears, Illes;037;Mercadal, Es;5038;2542;2496;2019
07;Balears, Illes;902;Migjorn Gran, Es;1405;696;709;2019
07;Balears, Illes;038;Montuïri;2912;1465;1447;2019
07;Balears, Illes;039;Muro;7085;3574;3511;2019
07;Balears, Illes;040;Palma ;416065;203195;212870;2019
07;Balears, Illes;041;Petra;2860;1419;1441;2019
07;Balears, Illes;044;Pobla, Sa;13475;6845;6630;2019
07;Balears, Illes;042;Pollença;16283;8088;8195;2019
07;Balears, Illes;043;Porreres;5502;2823;2679;2019
07;Balears, Illes;045;Puigpunyent;2012;997;1015;2019
07;Balears, Illes;059;Salines, Ses;4960;2525;2435;2019
07;Balears, Illes;046;Sant Antoni de Portmany;26306;13788;12518;2019
07;Balears, Illes;049;Sant Joan;2108;1039;1069;2019
07;Balears, Illes;050;Sant Joan de Labritja;6397;3282;3115;2019
07;Balears, Illes;048;Sant Josep de sa Talaia;27413;14114;13299;2019
07;Balears, Illes;051;Sant Llorenç des Cardassar;8431;4167;4264;2019
07;Balears, Illes;052;Sant Lluís;6798;3458;3340;2019
07;Balears, Illes;053;Santa Eugènia;1561;769;792;2019
07;Balears, Illes;054;Santa Eulària des Riu;38015;19254;18761;2019
07;Balears, Illes;055;Santa Margalida;12485;6391;6094;2019
07;Balears, Illes;056;Santa María del Camí;7375;3664;3711;2019
07;Balears, Illes;057;Santanyí;12237;6163;6074;2019
07;Balears, Illes;058;Selva;4014;1991;2023;2019
07;Balears, Illes;047;Sencelles;3290;1654;1636;2019
07;Balears, Illes;060;Sineu;3862;1913;1949;2019
07;Balears, Illes;061;Sóller;13705;6850;6855;2019
07;Balears, Illes;062;Son Servera;11568;5776;5792;2019
07;Balears, Illes;063;Valldemossa;1969;991;978;2019
07;Balears, Illes;065;Vilafranca de Bonany;3380;1733;1647;2019
08;Barcelona;001;Abrera;12489;6326;6163;2019
08;Barcelona;002;Aguilar de Segarra;288;155;133;2019
08;Barcelona;014;Aiguafreda;2504;1208;1296;2019
08;Barcelona;003;Alella;9801;4762;5039;2019
08;Barcelona;004;Alpens;266;144;122;2019
08;Barcelona;005;Ametlla del Vallès, L';8462;4277;4185;2019
08;Barcelona;006;Arenys de Mar;15776;7683;8093;2019
08;Barcelona;007;Arenys de Munt;8931;4483;4448;2019
08;Barcelona;008;Argençola;217;110;107;2019
08;Barcelona;009;Argentona;12452;6132;6320;2019
08;Barcelona;010;Artés;5698;2868;2830;2019
08;Barcelona;011;Avià;2226;1121;1105;2019
08;Barcelona;012;Avinyó;2275;1127;1148;2019
08;Barcelona;013;Avinyonet del Penedès;1701;903;798;2019
08;Barcelona;015;Badalona;220440;108509;111931;2019
08;Barcelona;904;Badia del Vallès;13380;6567;6813;2019
08;Barcelona;016;Bagà;2138;1064;1074;2019
08;Barcelona;017;Balenyà;3821;1928;1893;2019
08;Barcelona;018;Balsareny;3159;1562;1597;2019
08;Barcelona;252;Barberà del Vallès;33091;16300;16791;2019
08;Barcelona;019;Barcelona;1636762;775619;861143;2019
08;Barcelona;020;Begues;7098;3528;3570;2019
08;Barcelona;021;Bellprat;64;41;23;2019
08;Barcelona;022;Berga;16494;8166;8328;2019
08;Barcelona;023;Bigues i Riells;9092;4645;4447;2019
08;Barcelona;024;Borredà;445;253;192;2019
08;Barcelona;025;Bruc, El;2050;1107;943;2019
08;Barcelona;026;Brull, El;263;145;118;2019
08;Barcelona;027;Cabanyes, Les;964;488;476;2019
08;Barcelona;028;Cabrera d'Anoia;1410;769;641;2019
08;Barcelona;029;Cabrera de Mar;4680;2348;2332;2019
08;Barcelona;030;Cabrils;7439;3682;3757;2019
08;Barcelona;031;Calaf;3535;1775;1760;2019
08;Barcelona;034;Calders;970;499;471;2019
08;Barcelona;033;Caldes de Montbui;17554;8745;8809;2019
08;Barcelona;032;Caldes d'Estrac;2982;1426;1556;2019
08;Barcelona;035;Calella;19069;9339;9730;2019
08;Barcelona;037;Calldetenes;2489;1259;1230;2019
08;Barcelona;038;Callús;2140;1061;1079;2019
08;Barcelona;036;Calonge de Segarra;188;92;96;2019
08;Barcelona;039;Campins;529;277;252;2019
08;Barcelona;040;Canet de Mar;14526;7068;7458;2019
08;Barcelona;041;Canovelles;16629;8613;8016;2019
08;Barcelona;042;Cànoves i Samalús;3117;1581;1536;2019
08;Barcelona;043;Canyelles;4647;2414;2233;2019
08;Barcelona;044;Capellades;5293;2636;2657;2019
08;Barcelona;045;Capolat;94;44;50;2019
08;Barcelona;046;Cardedeu;18357;8957;9400;2019
08;Barcelona;047;Cardona;4636;2273;2363;2019
08;Barcelona;048;Carme;765;396;369;2019
08;Barcelona;049;Casserres;1608;813;795;2019
08;Barcelona;057;Castell de l'Areny;68;38;30;2019
08;Barcelona;052;Castellar de n'Hug;159;85;74;2019
08;Barcelona;050;Castellar del Riu;169;94;75;2019
08;Barcelona;051;Castellar del Vallès;24187;11948;12239;2019
08;Barcelona;053;Castellbell i el Vilar;3647;1863;1784;2019
08;Barcelona;054;Castellbisbal;12390;6238;6152;2019
08;Barcelona;055;Castellcir;752;392;360;2019
08;Barcelona;056;Castelldefels;67004;33018;33986;2019
08;Barcelona;058;Castellet i la Gornal;2292;1180;1112;2019
08;Barcelona;060;Castellfollit de Riubregós;151;86;65;2019
08;Barcelona;059;Castellfollit del Boix;436;222;214;2019
08;Barcelona;061;Castellgalí;2062;1062;1000;2019
08;Barcelona;062;Castellnou de Bages;1397;732;665;2019
08;Barcelona;063;Castellolí;619;302;317;2019
08;Barcelona;064;Castellterçol;2463;1236;1227;2019
08;Barcelona;065;Castellví de la Marca;1535;771;764;2019
08;Barcelona;066;Castellví de Rosanes;1884;931;953;2019
08;Barcelona;067;Centelles;7404;3630;3774;2019
08;Barcelona;268;Cercs;1145;577;568;2019
08;Barcelona;266;Cerdanyola del Vallès;57403;28038;29365;2019
08;Barcelona;068;Cervelló;9054;4529;4525;2019
08;Barcelona;069;Collbató;4466;2320;2146;2019
08;Barcelona;070;Collsuspina;342;174;168;2019
08;Barcelona;071;Copons;310;152;158;2019
08;Barcelona;072;Corbera de Llobregat;14822;7449;7373;2019
08;Barcelona;073;Cornellà de Llobregat;88592;42945;45647;2019
08;Barcelona;074;Cubelles;15329;7687;7642;2019
08;Barcelona;075;Dosrius;5481;2780;2701;2019
08;Barcelona;076;Esparreguera;22251;11249;11002;2019
08;Barcelona;077;Esplugues de Llobregat;46680;22300;24380;2019
08;Barcelona;078;Espunyola, L';254;126;128;2019
08;Barcelona;254;Esquirol, L';2181;1105;1076;2019
08;Barcelona;079;Estany, L';406;205;201;2019
08;Barcelona;134;Figaró-Montmany;1114;547;567;2019
08;Barcelona;080;Fígols;42;25;17;2019
08;Barcelona;082;Fogars de la Selva;1451;748;703;2019
08;Barcelona;081;Fogars de Montclús;470;245;225;2019
08;Barcelona;083;Folgueroles;2267;1159;1108;2019
08;Barcelona;084;Fonollosa;1453;750;703;2019
08;Barcelona;085;Font-rubí;1327;688;639;2019
08;Barcelona;086;Franqueses del Vallès, Les;20092;10210;9882;2019
08;Barcelona;090;Gaià;175;97;78;2019
08;Barcelona;087;Gallifa;172;95;77;2019
08;Barcelona;088;Garriga, La;16514;7987;8527;2019
08;Barcelona;089;Gavà;46771;22876;23895;2019
08;Barcelona;091;Gelida;7533;3778;3755;2019
08;Barcelona;092;Gironella;4826;2384;2442;2019
08;Barcelona;093;Gisclareny;25;15;10;2019
08;Barcelona;094;Granada, La;2157;1092;1065;2019
08;Barcelona;095;Granera;69;53;16;2019
08;Barcelona;096;Granollers;61275;30199;31076;2019
08;Barcelona;097;Gualba;1500;769;731;2019
08;Barcelona;099;Guardiola de Berguedà;908;464;444;2019
08;Barcelona;100;Gurb;2681;1386;1295;2019
08;Barcelona;101;Hospitalet de Llobregat, L';264923;127981;136942;2019
08;Barcelona;162;Hostalets de Pierola, Els;2973;1518;1455;2019
08;Barcelona;102;Igualada;39967;19636;20331;2019
08;Barcelona;103;Jorba;835;424;411;2019
08;Barcelona;104;Llacuna, La;870;475;395;2019
08;Barcelona;105;Llagosta, La;13480;6675;6805;2019
08;Barcelona;107;Lliçà d'Amunt;15256;7819;7437;2019
08;Barcelona;108;Lliçà de Vall;6542;3335;3207;2019
08;Barcelona;106;Llinars del Vallès;9938;4946;4992;2019
08;Barcelona;109;Lluçà;273;134;139;2019
08;Barcelona;110;Malgrat de Mar;18579;9280;9299;2019
08;Barcelona;111;Malla;273;139;134;2019
08;Barcelona;112;Manlleu;20573;10314;10259;2019
08;Barcelona;113;Manresa;77714;38066;39648;2019
08;Barcelona;242;Marganell;266;131;135;2019
08;Barcelona;114;Martorell;28189;14329;13860;2019
08;Barcelona;115;Martorelles;4801;2422;2379;2019
08;Barcelona;116;Masies de Roda, Les;700;355;345;2019
08;Barcelona;117;Masies de Voltregà, Les;3141;1551;1590;2019
08;Barcelona;118;Masnou, El;23515;11357;12158;2019
08;Barcelona;119;Masquefa;9211;4641;4570;2019
08;Barcelona;120;Matadepera;9326;4657;4669;2019
08;Barcelona;121;Mataró;128265;63637;64628;2019
08;Barcelona;122;Mediona;2322;1159;1163;2019
08;Barcelona;138;Moià;6267;3190;3077;2019
08;Barcelona;123;Molins de Rei;25868;12612;13256;2019
08;Barcelona;124;Mollet del Vallès;51318;25222;26096;2019
08;Barcelona;128;Monistrol de Calders;682;357;325;2019
08;Barcelona;127;Monistrol de Montserrat;3034;1551;1483;2019
08;Barcelona;125;Montcada i Reixac;36239;17901;18338;2019
08;Barcelona;130;Montclar;136;71;65;2019
08;Barcelona;131;Montesquiu;998;501;497;2019
08;Barcelona;126;Montgat;12041;5938;6103;2019
08;Barcelona;132;Montmajor;464;231;233;2019
08;Barcelona;133;Montmaneu;150;83;67;2019
08;Barcelona;135;Montmeló;8755;4275;4480;2019
08;Barcelona;136;Montornès del Vallès;16393;8251;8142;2019
08;Barcelona;137;Montseny;342;179;163;2019
08;Barcelona;129;Muntanyola;634;321;313;2019
08;Barcelona;139;Mura;224;122;102;2019
08;Barcelona;140;Navarcles;5977;2914;3063;2019
08;Barcelona;141;Navàs;6020;2998;3022;2019
08;Barcelona;142;Nou de Berguedà, La;161;83;78;2019
08;Barcelona;143;Òdena;3643;1848;1795;2019
08;Barcelona;145;Olèrdola;3692;1900;1792;2019
08;Barcelona;146;Olesa de Bonesvalls;1810;949;861;2019
08;Barcelona;147;Olesa de Montserrat;23904;11913;11991;2019
08;Barcelona;148;Olivella;3799;1985;1814;2019
08;Barcelona;149;Olost;1198;588;610;2019
08;Barcelona;144;Olvan;854;416;438;2019
08;Barcelona;150;Orís;315;159;156;2019
08;Barcelona;151;Oristà;541;274;267;2019
08;Barcelona;152;Orpí;147;80;67;2019
08;Barcelona;153;Òrrius;739;381;358;2019
08;Barcelona;154;Pacs del Penedès;922;469;453;2019
08;Barcelona;155;Palafolls;9405;4690;4715;2019
08;Barcelona;156;Palau-solità i Plegamans;14771;7246;7525;2019
08;Barcelona;157;Pallejà;11508;5728;5780;2019
08;Barcelona;905;Palma de Cervelló, La;2954;1460;1494;2019
08;Barcelona;158;Papiol, El;4145;2052;2093;2019
08;Barcelona;159;Parets del Vallès;19082;9541;9541;2019
08;Barcelona;160;Perafita;395;202;193;2019
08;Barcelona;161;Piera;15603;7976;7627;2019
08;Barcelona;163;Pineda de Mar;27272;13588;13684;2019
08;Barcelona;164;Pla del Penedès, El;1256;636;620;2019
08;Barcelona;165;Pobla de Claramunt, La;2193;1104;1089;2019
08;Barcelona;166;Pobla de Lillet, La;1095;528;567;2019
08;Barcelona;167;Polinyà;8479;4295;4184;2019
08;Barcelona;182;Pont de Vilomara i Rocafort, El;3830;1969;1861;2019
08;Barcelona;168;Pontons;532;289;243;2019
08;Barcelona;169;Prat de Llobregat, El;64599;31621;32978;2019
08;Barcelona;171;Prats de Lluçanès;2569;1280;1289;2019
08;Barcelona;170;Prats de Rei, Els;532;283;249;2019
08;Barcelona;230;Premià de Dalt;10448;5207;5241;2019
08;Barcelona;172;Premià de Mar;28119;13704;14415;2019
08;Barcelona;174;Puigdàlber;526;256;270;2019
08;Barcelona;175;Puig-reig;4178;2086;2092;2019
08;Barcelona;176;Pujalt;210;119;91;2019
08;Barcelona;177;Quar, La;53;29;24;2019
08;Barcelona;178;Rajadell;548;275;273;2019
08;Barcelona;179;Rellinars;780;403;377;2019
08;Barcelona;180;Ripollet;38665;19080;19585;2019
08;Barcelona;181;Roca del Vallès, La;10650;5319;5331;2019
08;Barcelona;183;Roda de Ter;6301;3118;3183;2019
08;Barcelona;184;Rubí;77464;38358;39106;2019
08;Barcelona;185;Rubió;239;133;106;2019
08;Barcelona;901;Rupit i Pruit;279;139;140;2019
08;Barcelona;187;Sabadell;213644;103847;109797;2019
08;Barcelona;188;Sagàs;148;80;68;2019
08;Barcelona;190;Saldes;274;159;115;2019
08;Barcelona;191;Sallent;6658;3211;3447;2019
08;Barcelona;194;Sant Adrià de Besòs;37097;18251;18846;2019
08;Barcelona;195;Sant Agustí de Lluçanès;85;42;43;2019
08;Barcelona;196;Sant Andreu de la Barca;27558;13679;13879;2019
08;Barcelona;197;Sant Andreu de Llavaneres;10968;5424;5544;2019
08;Barcelona;198;Sant Antoni de Vilamajor;6135;3031;3104;2019
08;Barcelona;199;Sant Bartomeu del Grau;858;460;398;2019
08;Barcelona;200;Sant Boi de Llobregat;83605;40877;42728;2019
08;Barcelona;201;Sant Boi de Lluçanès;541;269;272;2019
08;Barcelona;203;Sant Cebrià de Vallalta;3385;1764;1621;2019
08;Barcelona;202;Sant Celoni;17904;8939;8965;2019
08;Barcelona;204;Sant Climent de Llobregat;4129;2075;2054;2019
08;Barcelona;205;Sant Cugat del Vallès;91006;44197;46809;2019
08;Barcelona;206;Sant Cugat Sesgarrigues;1007;488;519;2019
08;Barcelona;207;Sant Esteve de Palautordera;2820;1391;1429;2019
08;Barcelona;208;Sant Esteve Sesrovires;7612;3835;3777;2019
08;Barcelona;210;Sant Feliu de Codines;6259;3168;3091;2019
08;Barcelona;211;Sant Feliu de Llobregat;44860;21767;23093;2019
08;Barcelona;212;Sant Feliu Sasserra;602;312;290;2019
08;Barcelona;209;Sant Fost de Campsentelles;8737;4352;4385;2019
08;Barcelona;213;Sant Fruitós de Bages;8703;4295;4408;2019
08;Barcelona;215;Sant Hipòlit de Voltregà;3484;1729;1755;2019
08;Barcelona;193;Sant Iscle de Vallalta;1332;687;645;2019
08;Barcelona;216;Sant Jaume de Frontanyà;30;18;12;2019
08;Barcelona;218;Sant Joan de Vilatorrada;10936;5490;5446;2019
08;Barcelona;217;Sant Joan Despí;34123;16585;17538;2019
08;Barcelona;903;Sant Julià de Cerdanyola;228;125;103;2019
08;Barcelona;220;Sant Julià de Vilatorta;3114;1539;1575;2019
08;Barcelona;221;Sant Just Desvern;17805;8544;9261;2019
08;Barcelona;222;Sant Llorenç d'Hortons;2413;1226;1187;2019
08;Barcelona;223;Sant Llorenç Savall;2373;1197;1176;2019
08;Barcelona;225;Sant Martí d'Albars;112;56;56;2019
08;Barcelona;224;Sant Martí de Centelles;1167;600;567;2019
08;Barcelona;226;Sant Martí de Tous;1235;637;598;2019
08;Barcelona;227;Sant Martí Sarroca;3264;1608;1656;2019
08;Barcelona;228;Sant Martí Sesgueioles;343;176;167;2019
08;Barcelona;229;Sant Mateu de Bages;603;302;301;2019
08;Barcelona;231;Sant Pere de Ribes;30719;15268;15451;2019
08;Barcelona;232;Sant Pere de Riudebitlles;2368;1181;1187;2019
08;Barcelona;233;Sant Pere de Torelló;2419;1242;1177;2019
08;Barcelona;234;Sant Pere de Vilamajor;4472;2239;2233;2019
08;Barcelona;189;Sant Pere Sallavinera;152;82;70;2019
08;Barcelona;235;Sant Pol de Mar;5299;2604;2695;2019
08;Barcelona;236;Sant Quintí de Mediona;2254;1154;1100;2019
08;Barcelona;237;Sant Quirze de Besora;2167;1054;1113;2019
08;Barcelona;238;Sant Quirze del Vallès;20141;9865;10276;2019
08;Barcelona;239;Sant Quirze Safaja;627;336;291;2019
08;Barcelona;240;Sant Sadurní d'Anoia;12887;6348;6539;2019
08;Barcelona;241;Sant Sadurní d'Osormort;78;47;31;2019
08;Barcelona;098;Sant Salvador de Guardiola;3179;1630;1549;2019
08;Barcelona;262;Sant Vicenç de Castellet;9523;4760;4763;2019
08;Barcelona;264;Sant Vicenç de Montalt;6407;3199;3208;2019
08;Barcelona;265;Sant Vicenç de Torelló;2058;1019;1039;2019
08;Barcelona;263;Sant Vicenç dels Horts;28117;13959;14158;2019
08;Barcelona;243;Santa Cecília de Voltregà;187;99;88;2019
08;Barcelona;244;Santa Coloma de Cervelló;8218;4026;4192;2019
08;Barcelona;245;Santa Coloma de Gramenet;119215;58895;60320;2019
08;Barcelona;246;Santa Eugènia de Berga;2248;1142;1106;2019
08;Barcelona;247;Santa Eulàlia de Riuprimer;1345;686;659;2019
08;Barcelona;248;Santa Eulàlia de Ronçana;7288;3639;3649;2019
08;Barcelona;249;Santa Fe del Penedès;374;185;189;2019
08;Barcelona;250;Santa Margarida de Montbui;9980;4993;4987;2019
08;Barcelona;251;Santa Margarida i els Monjos;7611;3856;3755;2019
08;Barcelona;253;Santa Maria de Besora;150;78;72;2019
08;Barcelona;256;Santa Maria de Martorelles;893;449;444;2019
08;Barcelona;255;Santa Maria de Merlès;184;89;95;2019
08;Barcelona;257;Santa Maria de Miralles;126;68;58;2019
08;Barcelona;259;Santa Maria de Palautordera;9423;4760;4663;2019
08;Barcelona;258;Santa Maria d'Oló;1025;521;504;2019
08;Barcelona;260;Santa Perpètua de Mogoda;25799;12958;12841;2019
08;Barcelona;261;Santa Susanna;3446;1721;1725;2019
08;Barcelona;192;Santpedor;7554;3755;3799;2019
08;Barcelona;267;Sentmenat;9078;4611;4467;2019
08;Barcelona;269;Seva;3519;1784;1735;2019
08;Barcelona;270;Sitges;29307;14708;14599;2019
08;Barcelona;271;Sobremunt;79;36;43;2019
08;Barcelona;272;Sora;209;117;92;2019
08;Barcelona;273;Subirats;3044;1577;1467;2019
08;Barcelona;274;Súria;5942;2897;3045;2019
08;Barcelona;276;Tagamanent;323;169;154;2019
08;Barcelona;277;Talamanca;206;115;91;2019
08;Barcelona;278;Taradell;6489;3238;3251;2019
08;Barcelona;275;Tavèrnoles;316;159;157;2019
08;Barcelona;280;Tavertet;111;57;54;2019
08;Barcelona;281;Teià;6397;3134;3263;2019
08;Barcelona;279;Terrassa;220556;108469;112087;2019
08;Barcelona;282;Tiana;8840;4233;4607;2019
08;Barcelona;283;Tona;8241;4099;4142;2019
08;Barcelona;284;Tordera;17216;8722;8494;2019
08;Barcelona;285;Torelló;14347;7137;7210;2019
08;Barcelona;286;Torre de Claramunt, La;3714;1923;1791;2019
08;Barcelona;287;Torrelavit;1419;723;696;2019
08;Barcelona;288;Torrelles de Foix;2348;1267;1081;2019
08;Barcelona;289;Torrelles de Llobregat;6041;3003;3038;2019
08;Barcelona;290;Ullastrell;2093;1052;1041;2019
08;Barcelona;291;Vacarisses;6688;3436;3252;2019
08;Barcelona;292;Vallbona d'Anoia;1373;719;654;2019
08;Barcelona;293;Vallcebre;250;142;108;2019
08;Barcelona;294;Vallgorguina;2891;1451;1440;2019
08;Barcelona;295;Vallirana;15006;7523;7483;2019
08;Barcelona;296;Vallromanes;2579;1328;1251;2019
08;Barcelona;297;Veciana;182;99;83;2019
08;Barcelona;298;Vic;46214;23306;22908;2019
08;Barcelona;299;Vilada;416;217;199;2019
08;Barcelona;301;Viladecans;66611;32930;33681;2019
08;Barcelona;300;Viladecavalls;7512;3724;3788;2019
08;Barcelona;305;Vilafranca del Penedès;39746;19341;20405;2019
08;Barcelona;306;Vilalba Sasserra;716;357;359;2019
08;Barcelona;303;Vilanova de Sau;299;142;157;2019
08;Barcelona;302;Vilanova del Camí;12458;6227;6231;2019
08;Barcelona;902;Vilanova del Vallès;5432;2760;2672;2019
08;Barcelona;307;Vilanova i la Geltrú;67086;32456;34630;2019
08;Barcelona;214;Vilassar de Dalt;9043;4462;4581;2019
08;Barcelona;219;Vilassar de Mar;20837;10068;10769;2019
08;Barcelona;304;Vilobí del Penedès;1107;569;538;2019
08;Barcelona;308;Viver i Serrateix;168;87;81;2019
48;Bizkaia;001;Abadiño;7599;3815;3784;2019
48;Bizkaia;002;Abanto y Ciérvana-Abanto Zierbena;9444;4668;4776;2019
48;Bizkaia;911;Ajangiz;477;249;228;2019
48;Bizkaia;912;Alonsotegi;2907;1427;1480;2019
48;Bizkaia;003;Amorebieta-Etxano;19339;9531;9808;2019
48;Bizkaia;004;Amoroto;410;208;202;2019
48;Bizkaia;005;Arakaldo;159;79;80;2019
48;Bizkaia;006;Arantzazu;395;191;204;2019
48;Bizkaia;093;Areatza;1201;578;623;2019
48;Bizkaia;009;Arrankudiaga;968;479;489;2019
48;Bizkaia;914;Arratzu;418;203;215;2019
48;Bizkaia;010;Arrieta;586;300;286;2019
48;Bizkaia;011;Arrigorriaga;12160;5923;6237;2019
48;Bizkaia;023;Artea;736;366;370;2019
48;Bizkaia;008;Artzentales;721;385;336;2019
48;Bizkaia;091;Atxondo;1366;685;681;2019
48;Bizkaia;070;Aulesti;654;323;331;2019
48;Bizkaia;012;Bakio;2688;1357;1331;2019
48;Bizkaia;090;Balmaseda;7697;3717;3980;2019
48;Bizkaia;013;Barakaldo;100881;48681;52200;2019
48;Bizkaia;014;Barrika;1529;747;782;2019
48;Bizkaia;015;Basauri;40589;19639;20950;2019
48;Bizkaia;092;Bedia;1067;508;559;2019
48;Bizkaia;016;Berango;7195;3530;3665;2019
48;Bizkaia;017;Bermeo;16765;8254;8511;2019
48;Bizkaia;018;Berriatua;1245;686;559;2019
48;Bizkaia;019;Berriz;4623;2295;2328;2019
48;Bizkaia;020;Bilbao;346843;163563;183280;2019
48;Bizkaia;021;Busturia;1616;807;809;2019
48;Bizkaia;901;Derio;6631;3256;3375;2019
48;Bizkaia;026;Dima;1436;741;695;2019
48;Bizkaia;027;Durango;29791;14554;15237;2019
48;Bizkaia;028;Ea;823;431;392;2019
48;Bizkaia;031;Elantxobe;350;176;174;2019
48;Bizkaia;032;Elorrio;7372;3634;3738;2019
48;Bizkaia;902;Erandio;24350;11808;12542;2019
48;Bizkaia;033;Ereño;245;140;105;2019
48;Bizkaia;034;Ermua;15880;7909;7971;2019
48;Bizkaia;079;Errigoiti;479;263;216;2019
48;Bizkaia;029;Etxebarri;11563;5792;5771;2019
48;Bizkaia;030;Etxebarria;788;394;394;2019
48;Bizkaia;906;Forua;920;449;471;2019
48;Bizkaia;035;Fruiz;536;272;264;2019
48;Bizkaia;036;Galdakao;29326;14454;14872;2019
48;Bizkaia;037;Galdames;831;442;389;2019
48;Bizkaia;038;Gamiz-Fika;1379;678;701;2019
48;Bizkaia;039;Garai;327;163;164;2019
48;Bizkaia;040;Gatika;1663;837;826;2019
48;Bizkaia;041;Gautegiz Arteaga;836;421;415;2019
48;Bizkaia;046;Gernika-Lumo;17016;8171;8845;2019
48;Bizkaia;044;Getxo;77946;36461;41485;2019
48;Bizkaia;047;Gizaburuaga;208;105;103;2019
48;Bizkaia;042;Gordexola;1710;875;835;2019
48;Bizkaia;043;Gorliz;5785;2849;2936;2019
48;Bizkaia;045;Güeñes;6734;3254;3480;2019
48;Bizkaia;048;Ibarrangelu;632;321;311;2019
48;Bizkaia;094;Igorre;4284;2107;2177;2019
48;Bizkaia;049;Ispaster;735;389;346;2019
48;Bizkaia;910;Iurreta;3662;1810;1852;2019
48;Bizkaia;050;Izurtza;255;159;96;2019
48;Bizkaia;022;Karrantza Harana/Valle de Carranza;2778;1437;1341;2019
48;Bizkaia;907;Kortezubi;441;220;221;2019
48;Bizkaia;051;Lanestosa;251;136;115;2019
48;Bizkaia;052;Larrabetzu;2033;981;1052;2019
48;Bizkaia;053;Laukiz;1194;598;596;2019
48;Bizkaia;054;Leioa;31795;15498;16297;2019
48;Bizkaia;057;Lekeitio;7307;3609;3698;2019
48;Bizkaia;055;Lemoa;3486;1741;1745;2019
48;Bizkaia;056;Lemoiz;1238;654;584;2019
48;Bizkaia;081;Lezama;2412;1197;1215;2019
48;Bizkaia;903;Loiu;2433;1239;1194;2019
48;Bizkaia;058;Mallabia;1158;592;566;2019
48;Bizkaia;059;Mañaria;515;263;252;2019
48;Bizkaia;060;Markina-Xemein;5006;2542;2464;2019
48;Bizkaia;061;Maruri-Jatabe;991;511;480;2019
48;Bizkaia;062;Mendata;383;197;186;2019
48;Bizkaia;063;Mendexa;438;220;218;2019
48;Bizkaia;064;Meñaka;761;396;365;2019
48;Bizkaia;066;Morga;410;219;191;2019
48;Bizkaia;068;Mundaka;1852;898;954;2019
48;Bizkaia;069;Mungia;17691;8618;9073;2019
48;Bizkaia;007;Munitibar-Arbatzegi Gerrikaitz;468;257;211;2019
48;Bizkaia;908;Murueta;308;155;153;2019
48;Bizkaia;071;Muskiz;7507;3691;3816;2019
48;Bizkaia;067;Muxika;1465;761;704;2019
48;Bizkaia;909;Nabarniz;253;126;127;2019
48;Bizkaia;073;Ondarroa;8400;4209;4191;2019
48;Bizkaia;075;Orozko;2636;1294;1342;2019
48;Bizkaia;083;Ortuella;8395;4091;4304;2019
48;Bizkaia;072;Otxandio;1314;670;644;2019
48;Bizkaia;077;Plentzia;4331;2114;2217;2019
48;Bizkaia;078;Portugalete;45766;21884;23882;2019
48;Bizkaia;082;Santurtzi;45853;22023;23830;2019
48;Bizkaia;084;Sestao;27296;13195;14101;2019
48;Bizkaia;904;Sondika;4502;2173;2329;2019
48;Bizkaia;085;Sopela;13878;6844;7034;2019
48;Bizkaia;086;Sopuerta;2527;1247;1280;2019
48;Bizkaia;076;Sukarrieta;332;169;163;2019
48;Bizkaia;087;Trucios-Turtzioz;501;265;236;2019
48;Bizkaia;088;Ubide;160;83;77;2019
48;Bizkaia;065;Ugao-Miraballes;4152;2101;2051;2019
48;Bizkaia;089;Urduliz;4456;2236;2220;2019
48;Bizkaia;074;Urduña/Orduña;4232;2195;2037;2019
48;Bizkaia;080;Valle de Trápaga-Trapagaran;11985;5826;6159;2019
48;Bizkaia;095;Zaldibar;3043;1526;1517;2019
48;Bizkaia;096;Zalla;8447;4189;4258;2019
48;Bizkaia;905;Zamudio;3260;1608;1652;2019
48;Bizkaia;097;Zaratamo;1614;805;809;2019
48;Bizkaia;024;Zeanuri;1250;639;611;2019
48;Bizkaia;025;Zeberio;1073;557;516;2019
48;Bizkaia;913;Zierbena;1490;785;705;2019
48;Bizkaia;915;Ziortza-Bolibar;413;219;194;2019
09;Burgos;001;Abajas;31;21;10;2019
09;Burgos;003;Adrada de Haza;203;101;102;2019
09;Burgos;006;Aguas Cándidas;56;35;21;2019
09;Burgos;007;Aguilar de Bureba;58;38;20;2019
09;Burgos;009;Albillos;209;109;100;2019
09;Burgos;010;Alcocero de Mola;32;23;9;2019
09;Burgos;011;Alfoz de Bricia;76;47;29;2019
09;Burgos;907;Alfoz de Quintanadueñas;2114;1123;991;2019
09;Burgos;012;Alfoz de Santa Gadea;101;58;43;2019
09;Burgos;013;Altable;51;31;20;2019
09;Burgos;014;Altos, Los;195;111;84;2019
09;Burgos;016;Ameyugo;107;55;52;2019
09;Burgos;017;Anguix;136;77;59;2019
09;Burgos;018;Aranda de Duero;32856;15941;16915;2019
09;Burgos;019;Arandilla;160;101;59;2019
09;Burgos;020;Arauzo de Miel;306;168;138;2019
09;Burgos;021;Arauzo de Salce;58;35;23;2019
09;Burgos;022;Arauzo de Torre;71;43;28;2019
09;Burgos;023;Arcos;1734;911;823;2019
09;Burgos;024;Arenillas de Riopisuerga;180;104;76;2019
09;Burgos;025;Arija;129;68;61;2019
09;Burgos;026;Arlanzón;400;243;157;2019
09;Burgos;027;Arraya de Oca;49;29;20;2019
09;Burgos;029;Atapuerca;162;91;71;2019
09;Burgos;030;Ausines, Los;133;80;53;2019
09;Burgos;032;Avellanosa de Muñó;108;60;48;2019
09;Burgos;033;Bahabón de Esgueva;81;45;36;2019
09;Burgos;034;Balbases, Los;324;177;147;2019
09;Burgos;035;Baños de Valdearados;324;192;132;2019
09;Burgos;036;Bañuelos de Bureba;37;22;15;2019
09;Burgos;037;Barbadillo de Herreros;107;67;40;2019
09;Burgos;038;Barbadillo del Mercado;142;78;64;2019
09;Burgos;039;Barbadillo del Pez;68;40;28;2019
09;Burgos;041;Barrio de Muñó;33;19;14;2019
09;Burgos;043;Barrios de Bureba, Los;198;113;85;2019
09;Burgos;044;Barrios de Colina;56;31;25;2019
09;Burgos;045;Basconcillos del Tozo;293;164;129;2019
09;Burgos;046;Bascuñana;24;16;8;2019
09;Burgos;047;Belbimbre;61;34;27;2019
09;Burgos;048;Belorado;1781;914;867;2019
09;Burgos;050;Berberana;54;31;23;2019
09;Burgos;051;Berlangas de Roa;184;100;84;2019
09;Burgos;052;Berzosa de Bureba;29;22;7;2019
09;Burgos;054;Bozoó;95;58;37;2019
09;Burgos;055;Brazacorta;56;32;24;2019
09;Burgos;056;Briviesca;6595;3290;3305;2019
09;Burgos;057;Bugedo;186;120;66;2019
09;Burgos;058;Buniel;546;300;246;2019
09;Burgos;059;Burgos;175821;83713;92108;2019
09;Burgos;060;Busto de Bureba;139;74;65;2019
09;Burgos;061;Cabañes de Esgueva;164;94;70;2019
09;Burgos;062;Cabezón de la Sierra;40;17;23;2019
09;Burgos;064;Caleruega;423;215;208;2019
09;Burgos;065;Campillo de Aranda;182;110;72;2019
09;Burgos;066;Campolara;57;41;16;2019
09;Burgos;067;Canicosa de la Sierra;449;237;212;2019
09;Burgos;068;Cantabrana;25;15;10;2019
09;Burgos;070;Carazo;33;23;10;2019
09;Burgos;071;Carcedo de Bureba;42;23;19;2019
09;Burgos;072;Carcedo de Burgos;399;212;187;2019
09;Burgos;073;Cardeñadijo;1341;735;606;2019
09;Burgos;074;Cardeñajimeno;1105;570;535;2019
09;Burgos;075;Cardeñuela Riopico;115;67;48;2019
09;Burgos;076;Carrias;26;20;6;2019
09;Burgos;077;Cascajares de Bureba;32;14;18;2019
09;Burgos;078;Cascajares de la Sierra;37;20;17;2019
09;Burgos;079;Castellanos de Castro;51;31;20;2019
09;Burgos;083;Castil de Peones;27;14;13;2019
09;Burgos;082;Castildelgado;36;21;15;2019
09;Burgos;084;Castrillo de la Reina;177;114;63;2019
09;Burgos;085;Castrillo de la Vega;621;340;281;2019
09;Burgos;088;Castrillo de Riopisuerga;61;37;24;2019
09;Burgos;086;Castrillo del Val;796;456;340;2019
09;Burgos;090;Castrillo Mota de Judíos;51;27;24;2019
09;Burgos;091;Castrojeriz;796;417;379;2019
09;Burgos;063;Cavia;242;141;101;2019
09;Burgos;093;Cayuela;184;99;85;2019
09;Burgos;094;Cebrecos;53;33;20;2019
09;Burgos;095;Celada del Camino;123;59;64;2019
09;Burgos;098;Cerezo de Río Tirón;555;304;251;2019
09;Burgos;100;Cerratón de Juarros;62;40;22;2019
09;Burgos;101;Ciadoncha;75;44;31;2019
09;Burgos;102;Cillaperlata;32;22;10;2019
09;Burgos;103;Cilleruelo de Abajo;218;123;95;2019
09;Burgos;104;Cilleruelo de Arriba;44;23;21;2019
09;Burgos;105;Ciruelos de Cervera;99;58;41;2019
09;Burgos;108;Cogollos;557;302;255;2019
09;Burgos;109;Condado de Treviño;1342;745;597;2019
09;Burgos;110;Contreras;77;49;28;2019
09;Burgos;112;Coruña del Conde;109;68;41;2019
09;Burgos;113;Covarrubias;552;296;256;2019
09;Burgos;114;Cubillo del Campo;92;51;41;2019
09;Burgos;115;Cubo de Bureba;98;54;44;2019
09;Burgos;117;Cueva de Roa, La;122;61;61;2019
09;Burgos;119;Cuevas de San Clemente;46;18;28;2019
09;Burgos;120;Encío;39;20;19;2019
09;Burgos;122;Espinosa de Cervera;100;63;37;2019
09;Burgos;124;Espinosa de los Monteros;1681;877;804;2019
09;Burgos;123;Espinosa del Camino;45;27;18;2019
09;Burgos;125;Estépar;589;355;234;2019
09;Burgos;127;Fontioso;54;33;21;2019
09;Burgos;128;Frandovínez;94;54;40;2019
09;Burgos;129;Fresneda de la Sierra Tirón;95;61;34;2019
09;Burgos;130;Fresneña;68;45;23;2019
09;Burgos;131;Fresnillo de las Dueñas;660;340;320;2019
09;Burgos;132;Fresno de Río Tirón;186;113;73;2019
09;Burgos;133;Fresno de Rodilla;44;25;19;2019
09;Burgos;134;Frías;252;131;121;2019
09;Burgos;135;Fuentebureba;45;25;20;2019
09;Burgos;136;Fuentecén;212;117;95;2019
09;Burgos;137;Fuentelcésped;238;121;117;2019
09;Burgos;138;Fuentelisendo;96;51;45;2019
09;Burgos;139;Fuentemolinos;100;67;33;2019
09;Burgos;140;Fuentenebro;119;73;46;2019
09;Burgos;141;Fuentespina;757;391;366;2019
09;Burgos;143;Galbarros;29;18;11;2019
09;Burgos;144;Gallega, La;45;29;16;2019
09;Burgos;148;Grijalba;111;56;55;2019
09;Burgos;149;Grisaleña;37;27;10;2019
09;Burgos;151;Gumiel de Izán;556;314;242;2019
09;Burgos;152;Gumiel de Mercado;363;198;165;2019
09;Burgos;154;Hacinas;143;86;57;2019
09;Burgos;155;Haza;30;19;11;2019
09;Burgos;159;Hontanas;71;44;27;2019
09;Burgos;160;Hontangas;90;60;30;2019
09;Burgos;162;Hontoria de la Cantera;146;76;70;2019
09;Burgos;164;Hontoria de Valdearados;180;107;73;2019
09;Burgos;163;Hontoria del Pinar;661;369;292;2019
09;Burgos;166;Hormazas, Las;102;58;44;2019
09;Burgos;167;Hornillos del Camino;59;32;27;2019
09;Burgos;168;Horra, La;340;184;156;2019
09;Burgos;169;Hortigüela;105;71;34;2019
09;Burgos;170;Hoyales de Roa;233;121;112;2019
09;Burgos;172;Huérmeces;185;100;85;2019
09;Burgos;173;Huerta de Arriba;131;77;54;2019
09;Burgos;174;Huerta de Rey;923;499;424;2019
09;Burgos;175;Humada;118;80;38;2019
09;Burgos;176;Hurones;65;44;21;2019
09;Burgos;177;Ibeas de Juarros;1404;753;651;2019
09;Burgos;178;Ibrillos;40;26;14;2019
09;Burgos;179;Iglesiarrubia;38;21;17;2019
09;Burgos;180;Iglesias;145;79;66;2019
09;Burgos;181;Isar;294;151;143;2019
09;Burgos;182;Itero del Castillo;80;45;35;2019
09;Burgos;183;Jaramillo de la Fuente;48;30;18;2019
09;Burgos;184;Jaramillo Quemado;7;6;1;2019
09;Burgos;189;Junta de Traslaloma;132;73;59;2019
09;Burgos;190;Junta de Villalba de Losa;88;49;39;2019
09;Burgos;191;Jurisdicción de Lara;33;19;14;2019
09;Burgos;192;Jurisdicción de San Zadornil;56;32;24;2019
09;Burgos;194;Lerma;2529;1270;1259;2019
09;Burgos;195;Llano de Bureba;58;37;21;2019
09;Burgos;196;Madrigal del Monte;143;88;55;2019
09;Burgos;197;Madrigalejo del Monte;166;110;56;2019
09;Burgos;198;Mahamud;109;60;49;2019
09;Burgos;199;Mambrilla de Castrejón;103;61;42;2019
09;Burgos;200;Mambrillas de Lara;58;35;23;2019
09;Burgos;201;Mamolar;28;21;7;2019
09;Burgos;202;Manciles;22;14;8;2019
09;Burgos;206;Mazuela;57;33;24;2019
09;Burgos;208;Mecerreyes;200;106;94;2019
09;Burgos;209;Medina de Pomar;5728;2914;2814;2019
09;Burgos;211;Melgar de Fernamental;1559;840;719;2019
09;Burgos;213;Merindad de Cuesta-Urria;297;163;134;2019
09;Burgos;214;Merindad de Montija;725;432;293;2019
09;Burgos;906;Merindad de Río Ubierna;1444;804;640;2019
09;Burgos;215;Merindad de Sotoscueva;409;225;184;2019
09;Burgos;216;Merindad de Valdeporres;423;220;203;2019
09;Burgos;217;Merindad de Valdivielso;388;223;165;2019
09;Burgos;218;Milagros;439;240;199;2019
09;Burgos;219;Miranda de Ebro;35522;17469;18053;2019
09;Burgos;220;Miraveche;71;45;26;2019
09;Burgos;221;Modúbar de la Emparedada;695;376;319;2019
09;Burgos;223;Monasterio de la Sierra;44;28;16;2019
09;Burgos;224;Monasterio de Rodilla;178;101;77;2019
09;Burgos;225;Moncalvillo;85;50;35;2019
09;Burgos;226;Monterrubio de la Demanda;56;35;21;2019
09;Burgos;227;Montorio;149;78;71;2019
09;Burgos;228;Moradillo de Roa;171;93;78;2019
09;Burgos;229;Nava de Roa;227;121;106;2019
09;Burgos;230;Navas de Bureba;33;16;17;2019
09;Burgos;231;Nebreda;58;42;16;2019
09;Burgos;232;Neila;154;89;65;2019
09;Burgos;235;Olmedillo de Roa;179;104;75;2019
09;Burgos;236;Olmillos de Muñó;35;20;15;2019
09;Burgos;238;Oña;1017;540;477;2019
09;Burgos;239;Oquillas;53;31;22;2019
09;Burgos;241;Orbaneja Riopico;336;181;155;2019
09;Burgos;242;Padilla de Abajo;75;45;30;2019
09;Burgos;243;Padilla de Arriba;75;47;28;2019
09;Burgos;244;Padrones de Bureba;50;23;27;2019
09;Burgos;246;Palacios de la Sierra;725;368;357;2019
09;Burgos;247;Palacios de Riopisuerga;25;12;13;2019
09;Burgos;248;Palazuelos de la Sierra;80;47;33;2019
09;Burgos;249;Palazuelos de Muñó;53;30;23;2019
09;Burgos;250;Pampliega;291;156;135;2019
09;Burgos;251;Pancorbo;434;235;199;2019
09;Burgos;253;Pardilla;117;70;47;2019
09;Burgos;255;Partido de la Sierra en Tobalina;86;52;34;2019
09;Burgos;256;Pedrosa de Duero;484;276;208;2019
09;Burgos;259;Pedrosa de Río Úrbel;240;141;99;2019
09;Burgos;257;Pedrosa del Páramo;89;53;36;2019
09;Burgos;258;Pedrosa del Príncipe;175;95;80;2019
09;Burgos;261;Peñaranda de Duero;528;263;265;2019
09;Burgos;262;Peral de Arlanza;169;89;80;2019
09;Burgos;265;Piérnigas;51;33;18;2019
09;Burgos;266;Pineda de la Sierra;106;66;40;2019
09;Burgos;267;Pineda Trasmonte;113;65;48;2019
09;Burgos;268;Pinilla de los Barruecos;95;54;41;2019
09;Burgos;269;Pinilla de los Moros;35;20;15;2019
09;Burgos;270;Pinilla Trasmonte;171;97;74;2019
09;Burgos;272;Poza de la Sal;287;152;135;2019
09;Burgos;273;Prádanos de Bureba;55;34;21;2019
09;Burgos;274;Pradoluengo;1163;589;574;2019
09;Burgos;275;Presencio;162;100;62;2019
09;Burgos;276;Puebla de Arganzón, La;506;274;232;2019
09;Burgos;277;Puentedura;110;76;34;2019
09;Burgos;279;Quemada;231;137;94;2019
09;Burgos;281;Quintana del Pidio;151;79;72;2019
09;Burgos;280;Quintanabureba;27;15;12;2019
09;Burgos;283;Quintanaélez;46;24;22;2019
09;Burgos;287;Quintanaortuño;263;149;114;2019
09;Burgos;288;Quintanapalla;112;64;48;2019
09;Burgos;289;Quintanar de la Sierra;1658;879;779;2019
09;Burgos;292;Quintanavides;76;47;29;2019
09;Burgos;294;Quintanilla de la Mata;112;67;45;2019
09;Burgos;901;Quintanilla del Agua y Tordueles;373;198;175;2019
09;Burgos;295;Quintanilla del Coco;54;26;28;2019
09;Burgos;298;Quintanilla San García;81;49;32;2019
09;Burgos;301;Quintanilla Vivar;813;430;383;2019
09;Burgos;297;Quintanillas, Las;370;218;152;2019
09;Burgos;302;Rabanera del Pinar;105;65;40;2019
09;Burgos;303;Rábanos;81;49;32;2019
09;Burgos;304;Rabé de las Calzadas;220;110;110;2019
09;Burgos;306;Rebolledo de la Torre;102;56;46;2019
09;Burgos;307;Redecilla del Camino;115;73;42;2019
09;Burgos;308;Redecilla del Campo;66;37;29;2019
09;Burgos;309;Regumiel de la Sierra;340;181;159;2019
09;Burgos;310;Reinoso;15;10;5;2019
09;Burgos;311;Retuerta;63;39;24;2019
09;Burgos;314;Revilla del Campo;95;59;36;2019
09;Burgos;316;Revilla Vallejera;108;66;42;2019
09;Burgos;312;Revilla y Ahedo, La;103;58;45;2019
09;Burgos;315;Revillarruz;532;273;259;2019
09;Burgos;317;Rezmondo;19;6;13;2019
09;Burgos;318;Riocavado de la Sierra;60;39;21;2019
09;Burgos;321;Roa;2183;1099;1084;2019
09;Burgos;323;Rojas;67;47;20;2019
09;Burgos;325;Royuela de Río Franco;181;109;72;2019
09;Burgos;326;Rubena;191;113;78;2019
09;Burgos;327;Rublacedo de Abajo;34;18;16;2019
09;Burgos;328;Rucandio;74;36;38;2019
09;Burgos;329;Salas de Bureba;130;73;57;2019
09;Burgos;330;Salas de los Infantes;1965;1016;949;2019
09;Burgos;332;Saldaña de Burgos;182;99;83;2019
09;Burgos;334;Salinillas de Bureba;49;40;9;2019
09;Burgos;335;San Adrián de Juarros;89;56;33;2019
09;Burgos;337;San Juan del Monte;151;83;68;2019
09;Burgos;338;San Mamés de Burgos;288;163;125;2019
09;Burgos;339;San Martín de Rubiales;143;83;60;2019
09;Burgos;340;San Millán de Lara;76;54;22;2019
09;Burgos;360;San Vicente del Valle;24;19;5;2019
09;Burgos;343;Santa Cecilia;102;63;39;2019
09;Burgos;345;Santa Cruz de la Salceda;145;87;58;2019
09;Burgos;346;Santa Cruz del Valle Urbión;97;63;34;2019
09;Burgos;347;Santa Gadea del Cid;148;76;72;2019
09;Burgos;348;Santa Inés;142;80;62;2019
09;Burgos;350;Santa María del Campo;527;286;241;2019
09;Burgos;351;Santa María del Invierno;63;46;17;2019
09;Burgos;352;Santa María del Mercadillo;104;69;35;2019
09;Burgos;353;Santa María Rivarredonda;90;57;33;2019
09;Burgos;354;Santa Olalla de Bureba;35;26;9;2019
09;Burgos;355;Santibáñez de Esgueva;83;46;37;2019
09;Burgos;356;Santibáñez del Val;48;31;17;2019
09;Burgos;358;Santo Domingo de Silos;279;173;106;2019
09;Burgos;361;Sargentes de la Lora;117;66;51;2019
09;Burgos;362;Sarracín;252;135;117;2019
09;Burgos;363;Sasamón;983;561;422;2019
09;Burgos;365;Sequera de Haza, La;31;22;9;2019
09;Burgos;366;Solarana;74;42;32;2019
09;Burgos;368;Sordillos;28;17;11;2019
09;Burgos;369;Sotillo de la Ribera;490;250;240;2019
09;Burgos;372;Sotragero;273;147;126;2019
09;Burgos;373;Sotresgudo;440;253;187;2019
09;Burgos;374;Susinos del Páramo;103;64;39;2019
09;Burgos;375;Tamarón;43;23;20;2019
09;Burgos;377;Tardajos;771;409;362;2019
09;Burgos;378;Tejada;31;17;14;2019
09;Burgos;380;Terradillos de Esgueva;78;37;41;2019
09;Burgos;381;Tinieblas de la Sierra;36;21;15;2019
09;Burgos;382;Tobar;25;18;7;2019
09;Burgos;384;Tordómar;336;186;150;2019
09;Burgos;386;Torrecilla del Monte;67;38;29;2019
09;Burgos;387;Torregalindo;125;80;45;2019
09;Burgos;388;Torrelara;33;18;15;2019
09;Burgos;389;Torrepadre;69;42;27;2019
09;Burgos;390;Torresandino;634;340;294;2019
09;Burgos;391;Tórtoles de Esgueva;448;237;211;2019
09;Burgos;392;Tosantos;54;30;24;2019
09;Burgos;394;Trespaderne;783;394;389;2019
09;Burgos;395;Tubilla del Agua;135;83;52;2019
09;Burgos;396;Tubilla del Lago;164;89;75;2019
09;Burgos;398;Úrbel del Castillo;74;50;24;2019
09;Burgos;400;Vadocondes;353;200;153;2019
09;Burgos;403;Valdeande;106;62;44;2019
09;Burgos;405;Valdezate;142;81;61;2019
09;Burgos;406;Valdorros;313;179;134;2019
09;Burgos;408;Vallarta de Bureba;42;26;16;2019
09;Burgos;904;Valle de las Navas;520;302;218;2019
09;Burgos;908;Valle de Losa;490;291;199;2019
09;Burgos;409;Valle de Manzanedo;120;66;54;2019
09;Burgos;410;Valle de Mena;3726;1906;1820;2019
09;Burgos;411;Valle de Oca;163;98;65;2019
09;Burgos;902;Valle de Santibáñez;500;282;218;2019
09;Burgos;905;Valle de Sedano;436;246;190;2019
09;Burgos;412;Valle de Tobalina;954;516;438;2019
09;Burgos;413;Valle de Valdebezana;475;247;228;2019
09;Burgos;414;Valle de Valdelaguna;187;111;76;2019
09;Burgos;415;Valle de Valdelucio;326;179;147;2019
09;Burgos;416;Valle de Zamanzas;66;36;30;2019
09;Burgos;417;Vallejera;43;24;19;2019
09;Burgos;418;Valles de Palenzuela;81;42;39;2019
09;Burgos;419;Valluércanes;72;46;26;2019
09;Burgos;407;Valmala;28;14;14;2019
09;Burgos;422;Vid de Bureba, La;33;19;14;2019
09;Burgos;421;Vid y Barrios, La;259;149;110;2019
09;Burgos;423;Vileña;28;18;10;2019
09;Burgos;427;Villadiego;1492;824;668;2019
09;Burgos;428;Villaescusa de Roa;107;60;47;2019
09;Burgos;429;Villaescusa la Sombría;58;42;16;2019
09;Burgos;430;Villaespasa;23;14;9;2019
09;Burgos;431;Villafranca Montes de Oca;122;74;48;2019
09;Burgos;432;Villafruela;186;109;77;2019
09;Burgos;433;Villagalijo;62;37;25;2019
09;Burgos;434;Villagonzalo Pedernales;1827;959;868;2019
09;Burgos;437;Villahoz;293;158;135;2019
09;Burgos;438;Villalba de Duero;699;362;337;2019
09;Burgos;439;Villalbilla de Burgos;1407;767;640;2019
09;Burgos;440;Villalbilla de Gumiel;81;50;31;2019
09;Burgos;441;Villaldemiro;94;54;40;2019
09;Burgos;442;Villalmanzo;427;233;194;2019
09;Burgos;443;Villamayor de los Montes;170;81;89;2019
09;Burgos;444;Villamayor de Treviño;63;32;31;2019
09;Burgos;445;Villambistia;44;32;12;2019
09;Burgos;446;Villamedianilla;12;7;5;2019
09;Burgos;447;Villamiel de la Sierra;45;27;18;2019
09;Burgos;448;Villangómez;214;132;82;2019
09;Burgos;449;Villanueva de Argaño;119;65;54;2019
09;Burgos;450;Villanueva de Carazo;27;16;11;2019
09;Burgos;451;Villanueva de Gumiel;279;146;133;2019
09;Burgos;454;Villanueva de Teba;43;28;15;2019
09;Burgos;455;Villaquirán de la Puebla;45;28;17;2019
09;Burgos;456;Villaquirán de los Infantes;158;82;76;2019
09;Burgos;903;Villarcayo de Merindad de Castilla la Vieja;4097;2098;1999;2019
09;Burgos;458;Villariezo;644;357;287;2019
09;Burgos;460;Villasandino;185;108;77;2019
09;Burgos;463;Villasur de Herreros;268;164;104;2019
09;Burgos;464;Villatuelda;41;21;20;2019
09;Burgos;466;Villaverde del Monte;115;66;49;2019
09;Burgos;467;Villaverde-Mogina;74;50;24;2019
09;Burgos;471;Villayerno Morquillas;186;95;91;2019
09;Burgos;472;Villazopeque;54;33;21;2019
09;Burgos;473;Villegas;87;49;38;2019
09;Burgos;476;Villoruebo;72;47;25;2019
09;Burgos;424;Viloria de Rioja;41;24;17;2019
09;Burgos;425;Vilviestre del Pinar;520;287;233;2019
09;Burgos;478;Vizcaínos;46;32;14;2019
09;Burgos;480;Zael;112;59;53;2019
09;Burgos;482;Zarzosa de Río Pisuerga;35;21;14;2019
09;Burgos;483;Zazuar;210;110;100;2019
09;Burgos;485;Zuñeda;56;33;23;2019
10;Cáceres;001;Abadía;331;184;147;2019
10;Cáceres;002;Abertura;407;205;202;2019
10;Cáceres;003;Acebo;579;292;287;2019
10;Cáceres;004;Acehúche;801;405;396;2019
10;Cáceres;005;Aceituna;607;312;295;2019
10;Cáceres;006;Ahigal;1372;706;666;2019
10;Cáceres;903;Alagón del Río;932;464;468;2019
10;Cáceres;007;Albalá;689;364;325;2019
10;Cáceres;008;Alcántara;1468;736;732;2019
10;Cáceres;009;Alcollarín;289;146;143;2019
10;Cáceres;010;Alcuéscar;2593;1351;1242;2019
10;Cáceres;012;Aldea del Cano;600;286;314;2019
10;Cáceres;013;Aldea del Obispo, La;303;162;141;2019
10;Cáceres;011;Aldeacentenera;578;296;282;2019
10;Cáceres;014;Aldeanueva de la Vera;2066;1015;1051;2019
10;Cáceres;015;Aldeanueva del Camino;735;361;374;2019
10;Cáceres;016;Aldehuela de Jerte;364;192;172;2019
10;Cáceres;017;Alía;834;421;413;2019
10;Cáceres;018;Aliseda;1835;934;901;2019
10;Cáceres;019;Almaraz;1744;895;849;2019
10;Cáceres;020;Almoharín;1811;894;917;2019
10;Cáceres;021;Arroyo de la Luz;5811;2889;2922;2019
10;Cáceres;023;Arroyomolinos;797;413;384;2019
10;Cáceres;022;Arroyomolinos de la Vera;443;223;220;2019
10;Cáceres;024;Baños de Montemayor;759;354;405;2019
10;Cáceres;025;Barrado;401;207;194;2019
10;Cáceres;026;Belvís de Monroy;725;381;344;2019
10;Cáceres;027;Benquerencia;81;47;34;2019
10;Cáceres;028;Berrocalejo;100;55;45;2019
10;Cáceres;029;Berzocana;423;229;194;2019
10;Cáceres;030;Bohonal de Ibor;500;258;242;2019
10;Cáceres;031;Botija;175;93;82;2019
10;Cáceres;032;Brozas;1826;912;914;2019
10;Cáceres;033;Cabañas del Castillo;431;225;206;2019
10;Cáceres;034;Cabezabellosa;344;174;170;2019
10;Cáceres;035;Cabezuela del Valle;2194;1121;1073;2019
10;Cáceres;036;Cabrero;326;179;147;2019
10;Cáceres;037;Cáceres;96126;46067;50059;2019
10;Cáceres;038;Cachorrilla;82;40;42;2019
10;Cáceres;039;Cadalso;431;218;213;2019
10;Cáceres;040;Calzadilla;475;243;232;2019
10;Cáceres;041;Caminomorisco;1194;623;571;2019
10;Cáceres;042;Campillo de Deleitosa;79;35;44;2019
10;Cáceres;043;Campo Lugar;833;415;418;2019
10;Cáceres;044;Cañamero;1614;838;776;2019
10;Cáceres;045;Cañaveral;1031;510;521;2019
10;Cáceres;046;Carbajo;200;104;96;2019
10;Cáceres;047;Carcaboso;1100;547;553;2019
10;Cáceres;048;Carrascalejo;216;108;108;2019
10;Cáceres;049;Casar de Cáceres;4469;2187;2282;2019
10;Cáceres;050;Casar de Palomero;1133;578;555;2019
10;Cáceres;051;Casares de las Hurdes;417;209;208;2019
10;Cáceres;052;Casas de Don Antonio;174;86;88;2019
10;Cáceres;053;Casas de Don Gómez;289;155;134;2019
10;Cáceres;056;Casas de Millán;567;289;278;2019
10;Cáceres;057;Casas de Miravete;132;83;49;2019
10;Cáceres;054;Casas del Castañar;568;279;289;2019
10;Cáceres;055;Casas del Monte;820;424;396;2019
10;Cáceres;058;Casatejada;1360;717;643;2019
10;Cáceres;059;Casillas de Coria;349;170;179;2019
10;Cáceres;060;Castañar de Ibor;1054;549;505;2019
10;Cáceres;061;Ceclavín;1840;933;907;2019
10;Cáceres;062;Cedillo;440;231;209;2019
10;Cáceres;063;Cerezo;165;81;84;2019
10;Cáceres;064;Cilleros;1624;818;806;2019
10;Cáceres;065;Collado de la Vera;195;106;89;2019
10;Cáceres;066;Conquista de la Sierra;185;108;77;2019
10;Cáceres;067;Coria;12478;6134;6344;2019
10;Cáceres;068;Cuacos de Yuste;841;439;402;2019
10;Cáceres;069;Cumbre, La;848;430;418;2019
10;Cáceres;070;Deleitosa;709;355;354;2019
10;Cáceres;071;Descargamaría;123;72;51;2019
10;Cáceres;072;Eljas;908;469;439;2019
10;Cáceres;073;Escurial;855;453;402;2019
10;Cáceres;075;Fresnedoso de Ibor;268;145;123;2019
10;Cáceres;076;Galisteo;918;457;461;2019
10;Cáceres;077;Garciaz;709;365;344;2019
10;Cáceres;079;Garganta la Olla;957;504;453;2019
10;Cáceres;078;Garganta, La;378;208;170;2019
10;Cáceres;080;Gargantilla;389;204;185;2019
10;Cáceres;081;Gargüera;127;72;55;2019
10;Cáceres;082;Garrovillas de Alconétar;2034;1005;1029;2019
10;Cáceres;083;Garvín;95;52;43;2019
10;Cáceres;084;Gata;1447;751;696;2019
10;Cáceres;085;Gordo, El;367;193;174;2019
10;Cáceres;086;Granja, La;328;168;160;2019
10;Cáceres;087;Guadalupe;1862;926;936;2019
10;Cáceres;088;Guijo de Coria;197;105;92;2019
10;Cáceres;089;Guijo de Galisteo;1513;769;744;2019
10;Cáceres;090;Guijo de Granadilla;530;274;256;2019
10;Cáceres;091;Guijo de Santa Bárbara;387;204;183;2019
10;Cáceres;092;Herguijuela;286;150;136;2019
10;Cáceres;093;Hernán-Pérez;448;219;229;2019
10;Cáceres;094;Herrera de Alcántara;253;128;125;2019
10;Cáceres;095;Herreruela;333;171;162;2019
10;Cáceres;096;Hervás;3976;1952;2024;2019
10;Cáceres;097;Higuera;113;71;42;2019
10;Cáceres;098;Hinojal;401;208;193;2019
10;Cáceres;099;Holguera;641;321;320;2019
10;Cáceres;100;Hoyos;874;426;448;2019
10;Cáceres;101;Huélaga;220;109;111;2019
10;Cáceres;102;Ibahernando;544;272;272;2019
10;Cáceres;103;Jaraicejo;465;228;237;2019
10;Cáceres;104;Jaraíz de la Vera;6478;3240;3238;2019
10;Cáceres;105;Jarandilla de la Vera;2828;1415;1413;2019
10;Cáceres;106;Jarilla;136;65;71;2019
10;Cáceres;107;Jerte;1261;623;638;2019
10;Cáceres;108;Ladrillar;201;109;92;2019
10;Cáceres;109;Logrosán;1994;1006;988;2019
10;Cáceres;110;Losar de la Vera;2699;1380;1319;2019
10;Cáceres;111;Madrigal de la Vera;1579;818;761;2019
10;Cáceres;112;Madrigalejo;1751;881;870;2019
10;Cáceres;113;Madroñera;2533;1256;1277;2019
10;Cáceres;114;Majadas;1323;664;659;2019
10;Cáceres;115;Malpartida de Cáceres;4122;2079;2043;2019
10;Cáceres;116;Malpartida de Plasencia;4602;2276;2326;2019
10;Cáceres;117;Marchagaz;207;105;102;2019
10;Cáceres;118;Mata de Alcántara;305;157;148;2019
10;Cáceres;119;Membrío;622;306;316;2019
10;Cáceres;120;Mesas de Ibor;162;86;76;2019
10;Cáceres;121;Miajadas;9607;4800;4807;2019
10;Cáceres;122;Millanes;248;127;121;2019
10;Cáceres;123;Mirabel;660;323;337;2019
10;Cáceres;124;Mohedas de Granadilla;836;422;414;2019
10;Cáceres;125;Monroy;954;490;464;2019
10;Cáceres;126;Montánchez;1682;854;828;2019
10;Cáceres;127;Montehermoso;5739;2917;2822;2019
10;Cáceres;128;Moraleja;6750;3341;3409;2019
10;Cáceres;129;Morcillo;371;171;200;2019
10;Cáceres;130;Navaconcejo;1990;1005;985;2019
10;Cáceres;131;Navalmoral de la Mata;17129;8252;8877;2019
10;Cáceres;132;Navalvillar de Ibor;408;204;204;2019
10;Cáceres;133;Navas del Madroño;1292;647;645;2019
10;Cáceres;134;Navezuelas;637;323;314;2019
10;Cáceres;135;Nuñomoral;1272;676;596;2019
10;Cáceres;136;Oliva de Plasencia;303;173;130;2019
10;Cáceres;137;Palomero;406;215;191;2019
10;Cáceres;138;Pasarón de la Vera;632;304;328;2019
10;Cáceres;139;Pedroso de Acim;80;43;37;2019
10;Cáceres;140;Peraleda de la Mata;1369;697;672;2019
10;Cáceres;141;Peraleda de San Román;310;162;148;2019
10;Cáceres;142;Perales del Puerto;952;480;472;2019
10;Cáceres;143;Pescueza;148;66;82;2019
10;Cáceres;144;Pesga, La;1034;543;491;2019
10;Cáceres;145;Piedras Albas;147;69;78;2019
10;Cáceres;146;Pinofranqueado;1736;927;809;2019
10;Cáceres;147;Piornal;1519;767;752;2019
10;Cáceres;148;Plasencia;39913;19254;20659;2019
10;Cáceres;149;Plasenzuela;492;251;241;2019
10;Cáceres;150;Portaje;355;183;172;2019
10;Cáceres;151;Portezuelo;218;115;103;2019
10;Cáceres;152;Pozuelo de Zarzón;475;240;235;2019
10;Cáceres;905;Pueblonuevo de Miramontes;791;402;389;2019
10;Cáceres;153;Puerto de Santa Cruz;317;167;150;2019
10;Cáceres;154;Rebollar;214;108;106;2019
10;Cáceres;155;Riolobos;1231;635;596;2019
10;Cáceres;156;Robledillo de Gata;91;50;41;2019
10;Cáceres;157;Robledillo de la Vera;265;134;131;2019
10;Cáceres;158;Robledillo de Trujillo;366;183;183;2019
10;Cáceres;159;Robledollano;310;166;144;2019
10;Cáceres;160;Romangordo;259;129;130;2019
10;Cáceres;901;Rosalejo;1397;719;678;2019
10;Cáceres;161;Ruanes;83;43;40;2019
10;Cáceres;162;Salorino;565;294;271;2019
10;Cáceres;163;Salvatierra de Santiago;312;155;157;2019
10;Cáceres;164;San Martín de Trevejo;778;382;396;2019
10;Cáceres;165;Santa Ana;262;140;122;2019
10;Cáceres;166;Santa Cruz de la Sierra;327;167;160;2019
10;Cáceres;167;Santa Cruz de Paniagua;323;180;143;2019
10;Cáceres;168;Santa Marta de Magasca;282;140;142;2019
10;Cáceres;169;Santiago de Alcántara;523;255;268;2019
10;Cáceres;170;Santiago del Campo;252;126;126;2019
10;Cáceres;171;Santibáñez el Alto;370;203;167;2019
10;Cáceres;172;Santibáñez el Bajo;756;385;371;2019
10;Cáceres;173;Saucedilla;851;443;408;2019
10;Cáceres;174;Segura de Toro;183;90;93;2019
10;Cáceres;175;Serradilla;1537;777;760;2019
10;Cáceres;176;Serrejón;409;213;196;2019
10;Cáceres;177;Sierra de Fuentes;1998;1017;981;2019
10;Cáceres;178;Talaván;814;422;392;2019
10;Cáceres;179;Talaveruela de la Vera;319;169;150;2019
10;Cáceres;180;Talayuela;7371;3965;3406;2019
10;Cáceres;181;Tejeda de Tiétar;788;415;373;2019
10;Cáceres;904;Tiétar;902;481;421;2019
10;Cáceres;182;Toril;148;96;52;2019
10;Cáceres;183;Tornavacas;1132;603;529;2019
10;Cáceres;184;Torno, El;860;448;412;2019
10;Cáceres;187;Torre de Don Miguel;484;258;226;2019
10;Cáceres;188;Torre de Santa María;534;265;269;2019
10;Cáceres;185;Torrecilla de los Ángeles;624;336;288;2019
10;Cáceres;186;Torrecillas de la Tiesa;1067;541;526;2019
10;Cáceres;190;Torrejón el Rubio;565;283;282;2019
10;Cáceres;189;Torrejoncillo;2935;1439;1496;2019
10;Cáceres;191;Torremenga;599;321;278;2019
10;Cáceres;192;Torremocha;798;399;399;2019
10;Cáceres;193;Torreorgaz;1676;819;857;2019
10;Cáceres;194;Torrequemada;565;268;297;2019
10;Cáceres;195;Trujillo;9012;4394;4618;2019
10;Cáceres;196;Valdastillas;321;166;155;2019
10;Cáceres;197;Valdecañas de Tajo;110;59;51;2019
10;Cáceres;198;Valdefuentes;1174;577;597;2019
10;Cáceres;199;Valdehúncar;175;95;80;2019
10;Cáceres;200;Valdelacasa de Tajo;348;184;164;2019
10;Cáceres;201;Valdemorales;200;98;102;2019
10;Cáceres;202;Valdeobispo;656;322;334;2019
10;Cáceres;203;Valencia de Alcántara;5397;2643;2754;2019
10;Cáceres;204;Valverde de la Vera;483;249;234;2019
10;Cáceres;205;Valverde del Fresno;2309;1164;1145;2019
10;Cáceres;902;Vegaviana;864;444;420;2019
10;Cáceres;206;Viandar de la Vera;225;115;110;2019
10;Cáceres;207;Villa del Campo;487;229;258;2019
10;Cáceres;208;Villa del Rey;128;64;64;2019
10;Cáceres;209;Villamesías;261;136;125;2019
10;Cáceres;210;Villamiel;407;205;202;2019
10;Cáceres;211;Villanueva de la Sierra;456;231;225;2019
10;Cáceres;212;Villanueva de la Vera;2021;1013;1008;2019
10;Cáceres;214;Villar de Plasencia;235;127;108;2019
10;Cáceres;213;Villar del Pedroso;599;310;289;2019
10;Cáceres;215;Villasbuenas de Gata;354;173;181;2019
10;Cáceres;216;Zarza de Granadilla;1805;915;890;2019
10;Cáceres;217;Zarza de Montánchez;571;287;284;2019
10;Cáceres;218;Zarza la Mayor;1228;610;618;2019
10;Cáceres;219;Zorita;1367;699;668;2019
11;Cádiz;001;Alcalá de los Gazules;5219;2684;2535;2019
11;Cádiz;002;Alcalá del Valle;5046;2538;2508;2019
11;Cádiz;003;Algar;1413;721;692;2019
11;Cádiz;004;Algeciras;121957;60120;61837;2019
11;Cádiz;005;Algodonales;5550;2824;2726;2019
11;Cádiz;006;Arcos de la Frontera;30700;15318;15382;2019
11;Cádiz;007;Barbate;22518;11303;11215;2019
11;Cádiz;008;Barrios, Los;23642;11825;11817;2019
11;Cádiz;901;Benalup-Casas Viejas;6929;3518;3411;2019
11;Cádiz;009;Benaocaz;671;356;315;2019
11;Cádiz;010;Bornos;7670;3824;3846;2019
11;Cádiz;011;Bosque, El;2145;1083;1062;2019
11;Cádiz;012;Cádiz;116027;54918;61109;2019
11;Cádiz;013;Castellar de la Frontera;3049;1528;1521;2019
11;Cádiz;015;Chiclana de la Frontera;84489;42289;42200;2019
11;Cádiz;016;Chipiona;19123;9586;9537;2019
11;Cádiz;014;Conil de la Frontera;22529;11345;11184;2019
11;Cádiz;017;Espera;3860;1939;1921;2019
11;Cádiz;018;Gastor, El;1752;905;847;2019
11;Cádiz;019;Grazalema;2027;1006;1021;2019
11;Cádiz;020;Jerez de la Frontera;212749;103897;108852;2019
11;Cádiz;021;Jimena de la Frontera;6951;3568;3383;2019
11;Cádiz;022;Línea de la Concepción, La;63147;30978;32169;2019
11;Cádiz;023;Medina Sidonia;11708;5950;5758;2019
11;Cádiz;024;Olvera;8113;3971;4142;2019
11;Cádiz;025;Paterna de Rivera;5470;2820;2650;2019
11;Cádiz;026;Prado del Rey;5605;2807;2798;2019
11;Cádiz;027;Puerto de Santa María, El;88405;43295;45110;2019
11;Cádiz;028;Puerto Real;41627;20926;20701;2019
11;Cádiz;029;Puerto Serrano;6941;3515;3426;2019
11;Cádiz;030;Rota;29109;14505;14604;2019
11;Cádiz;031;San Fernando;94979;46427;48552;2019
11;Cádiz;902;San José del Valle;4418;2257;2161;2019
11;Cádiz;903;San Martín del Tesorillo;2753;1430;1323;2019
11;Cádiz;033;San Roque;31218;15579;15639;2019
11;Cádiz;032;Sanlúcar de Barrameda;68684;34209;34475;2019
11;Cádiz;034;Setenil de las Bodegas;2769;1430;1339;2019
11;Cádiz;035;Tarifa;18162;9152;9010;2019
11;Cádiz;036;Torre Alháquime;790;391;399;2019
11;Cádiz;037;Trebujena;7028;3501;3527;2019
11;Cádiz;038;Ubrique;16597;8203;8394;2019
11;Cádiz;039;Vejer de la Frontera;12624;6289;6335;2019
11;Cádiz;040;Villaluenga del Rosario;455;243;212;2019
11;Cádiz;041;Villamartín;12150;6109;6041;2019
11;Cádiz;042;Zahara;1387;709;678;2019
39;Cantabria;001;Alfoz de Lloredo;2416;1249;1167;2019
39;Cantabria;002;Ampuero;4288;2166;2122;2019
39;Cantabria;003;Anievas;267;141;126;2019
39;Cantabria;004;Arenas de Iguña;1679;856;823;2019
39;Cantabria;005;Argoños;1748;898;850;2019
39;Cantabria;006;Arnuero;2103;1062;1041;2019
39;Cantabria;007;Arredondo;452;253;199;2019
39;Cantabria;008;Astillero, El;18111;8853;9258;2019
39;Cantabria;009;Bárcena de Cicero;4246;2187;2059;2019
39;Cantabria;010;Bárcena de Pie de Concha;678;341;337;2019
39;Cantabria;011;Bareyo;1950;985;965;2019
39;Cantabria;012;Cabezón de la Sal;8301;3983;4318;2019
39;Cantabria;013;Cabezón de Liébana;616;350;266;2019
39;Cantabria;014;Cabuérniga;1000;537;463;2019
39;Cantabria;015;Camaleño;936;534;402;2019
39;Cantabria;016;Camargo;30260;14806;15454;2019
39;Cantabria;027;Campoo de Enmedio;3714;1902;1812;2019
39;Cantabria;017;Campoo de Yuso;669;364;305;2019
39;Cantabria;018;Cartes;5747;2884;2863;2019
39;Cantabria;019;Castañeda;2914;1482;1432;2019
39;Cantabria;020;Castro-Urdiales;32069;15866;16203;2019
39;Cantabria;021;Cieza;538;275;263;2019
39;Cantabria;022;Cillorigo de Liébana;1305;680;625;2019
39;Cantabria;023;Colindres;8484;4178;4306;2019
39;Cantabria;024;Comillas;2141;1010;1131;2019
39;Cantabria;025;Corrales de Buelna, Los;10841;5290;5551;2019
39;Cantabria;026;Corvera de Toranzo;2039;1036;1003;2019
39;Cantabria;028;Entrambasaguas;5163;2590;2573;2019
39;Cantabria;029;Escalante;779;399;380;2019
39;Cantabria;030;Guriezo;2354;1218;1136;2019
39;Cantabria;031;Hazas de Cesto;1569;773;796;2019
39;Cantabria;032;Hermandad de Campoo de Suso;1603;894;709;2019
39;Cantabria;033;Herrerías;605;341;264;2019
39;Cantabria;034;Lamasón;272;173;99;2019
39;Cantabria;035;Laredo;11025;5217;5808;2019
39;Cantabria;036;Liendo;1204;621;583;2019
39;Cantabria;037;Liérganes;2379;1168;1211;2019
39;Cantabria;038;Limpias;1879;926;953;2019
39;Cantabria;039;Luena;593;321;272;2019
39;Cantabria;040;Marina de Cudeyo;5125;2547;2578;2019
39;Cantabria;041;Mazcuerras;2105;1082;1023;2019
39;Cantabria;042;Medio Cudeyo;7556;3663;3893;2019
39;Cantabria;043;Meruelo;2028;1013;1015;2019
39;Cantabria;044;Miengo;4741;2407;2334;2019
39;Cantabria;045;Miera;380;198;182;2019
39;Cantabria;046;Molledo;1504;746;758;2019
39;Cantabria;047;Noja;2556;1274;1282;2019
39;Cantabria;048;Penagos;2142;1078;1064;2019
39;Cantabria;049;Peñarrubia;319;172;147;2019
39;Cantabria;050;Pesaguero;292;169;123;2019
39;Cantabria;051;Pesquera;78;47;31;2019
39;Cantabria;052;Piélagos;25559;12669;12890;2019
39;Cantabria;053;Polaciones;232;147;85;2019
39;Cantabria;054;Polanco;5896;2912;2984;2019
39;Cantabria;055;Potes;1343;650;693;2019
39;Cantabria;056;Puente Viesgo;2854;1450;1404;2019
39;Cantabria;057;Ramales de la Victoria;2876;1437;1439;2019
39;Cantabria;058;Rasines;931;478;453;2019
39;Cantabria;059;Reinosa;9003;4235;4768;2019
39;Cantabria;060;Reocín;8384;4142;4242;2019
39;Cantabria;061;Ribamontán al Mar;4437;2250;2187;2019
39;Cantabria;062;Ribamontán al Monte;2276;1181;1095;2019
39;Cantabria;063;Rionansa;1047;581;466;2019
39;Cantabria;064;Riotuerto;1601;772;829;2019
39;Cantabria;065;Rozas de Valdearroyo, Las;260;147;113;2019
39;Cantabria;066;Ruente;1016;552;464;2019
39;Cantabria;067;Ruesga;839;461;378;2019
39;Cantabria;068;Ruiloba;740;378;362;2019
39;Cantabria;069;San Felices de Buelna;2361;1192;1169;2019
39;Cantabria;070;San Miguel de Aguayo;140;73;67;2019
39;Cantabria;071;San Pedro del Romeral;507;283;224;2019
39;Cantabria;072;San Roque de Riomiera;356;213;143;2019
39;Cantabria;080;San Vicente de la Barquera;4124;2037;2087;2019
39;Cantabria;073;Santa Cruz de Bezana;13095;6443;6652;2019
39;Cantabria;074;Santa María de Cayón;9159;4575;4584;2019
39;Cantabria;075;Santander;172539;79555;92984;2019
39;Cantabria;076;Santillana del Mar;4207;2056;2151;2019
39;Cantabria;077;Santiurde de Reinosa;255;147;108;2019
39;Cantabria;078;Santiurde de Toranzo;1629;847;782;2019
39;Cantabria;079;Santoña;11024;5374;5650;2019
39;Cantabria;081;Saro;504;262;242;2019
39;Cantabria;082;Selaya;1891;951;940;2019
39;Cantabria;083;Soba;1180;655;525;2019
39;Cantabria;084;Solórzano;1047;563;484;2019
39;Cantabria;085;Suances;8782;4314;4468;2019
39;Cantabria;086;Tojos, Los;387;227;160;2019
39;Cantabria;087;Torrelavega;51494;24302;27192;2019
39;Cantabria;088;Tresviso;62;44;18;2019
39;Cantabria;089;Tudanca;141;99;42;2019
39;Cantabria;090;Udías;934;472;462;2019
39;Cantabria;095;Val de San Vicente;2728;1403;1325;2019
39;Cantabria;091;Valdáliga;2182;1129;1053;2019
39;Cantabria;092;Valdeolea;947;502;445;2019
39;Cantabria;093;Valdeprado del Río;337;188;149;2019
39;Cantabria;094;Valderredible;989;555;434;2019
39;Cantabria;101;Valle de Villaverde;283;154;129;2019
39;Cantabria;096;Vega de Liébana;736;387;349;2019
39;Cantabria;097;Vega de Pas;763;403;360;2019
39;Cantabria;098;Villacarriedo;1612;845;767;2019
39;Cantabria;099;Villaescusa;3899;1921;1978;2019
39;Cantabria;100;Villafufre;1003;527;476;2019
39;Cantabria;102;Voto;2724;1456;1268;2019
12;Castellón/Castelló;002;Aín;127;64;63;2019
12;Castellón/Castelló;003;Albocàsser;1241;630;611;2019
12;Castellón/Castelló;004;Alcalà de Xivert;6680;3412;3268;2019
12;Castellón/Castelló;005;Alcora, l';10405;5255;5150;2019
12;Castellón/Castelló;006;Alcudia de Veo;190;103;87;2019
12;Castellón/Castelló;007;Alfondeguilla;866;440;426;2019
12;Castellón/Castelló;008;Algimia de Almonacid;263;149;114;2019
12;Castellón/Castelló;009;Almassora;26270;13224;13046;2019
12;Castellón/Castelló;010;Almedíjar;254;141;113;2019
12;Castellón/Castelló;011;Almenara;5998;3013;2985;2019
12;Castellón/Castelló;901;Alqueries, les/Alquerías del Niño Perdido;4449;2209;2240;2019
12;Castellón/Castelló;012;Altura;3528;1822;1706;2019
12;Castellón/Castelló;013;Arañuel;150;78;72;2019
12;Castellón/Castelló;014;Ares del Maestrat;186;107;79;2019
12;Castellón/Castelló;015;Argelita;118;72;46;2019
12;Castellón/Castelló;016;Artana;1947;992;955;2019
12;Castellón/Castelló;001;Atzeneta del Maestrat;1276;649;627;2019
12;Castellón/Castelló;017;Ayódar;159;86;73;2019
12;Castellón/Castelló;018;Azuébar;315;165;150;2019
12;Castellón/Castelló;020;Barracas;162;93;69;2019
12;Castellón/Castelló;022;Bejís;380;215;165;2019
12;Castellón/Castelló;024;Benafer;152;81;71;2019
12;Castellón/Castelló;025;Benafigos;142;80;62;2019
12;Castellón/Castelló;026;Benassal;1068;550;518;2019
12;Castellón/Castelló;027;Benicarló;26912;13408;13504;2019
12;Castellón/Castelló;028;Benicasim/Benicàssim;18192;9046;9146;2019
12;Castellón/Castelló;029;Benlloc;1033;518;515;2019
12;Castellón/Castelló;021;Betxí;5645;2792;2853;2019
12;Castellón/Castelló;032;Borriana/Burriana;34683;17224;17459;2019
12;Castellón/Castelló;031;Borriol;5360;2736;2624;2019
12;Castellón/Castelló;033;Cabanes;2958;1509;1449;2019
12;Castellón/Castelló;034;Càlig;1950;989;961;2019
12;Castellón/Castelló;036;Canet lo Roig;674;330;344;2019
12;Castellón/Castelló;037;Castell de Cabres;17;9;8;2019
12;Castellón/Castelló;038;Castellfort;183;100;83;2019
12;Castellón/Castelló;039;Castellnovo;917;461;456;2019
12;Castellón/Castelló;040;Castellón de la Plana/Castelló de la Plana;171728;83072;88656;2019
12;Castellón/Castelló;041;Castillo de Villamalefa;107;72;35;2019
12;Castellón/Castelló;042;Catí;721;362;359;2019
12;Castellón/Castelló;043;Caudiel;664;340;324;2019
12;Castellón/Castelló;044;Cervera del Maestre;575;286;289;2019
12;Castellón/Castelló;053;Chilches/Xilxes;2679;1383;1296;2019
12;Castellón/Castelló;055;Chodos/Xodos;112;69;43;2019
12;Castellón/Castelló;056;Chóvar;288;150;138;2019
12;Castellón/Castelló;045;Cinctorres;391;192;199;2019
12;Castellón/Castelló;046;Cirat;201;109;92;2019
12;Castellón/Castelló;048;Cortes de Arenoso;318;172;146;2019
12;Castellón/Castelló;049;Costur;524;277;247;2019
12;Castellón/Castelló;050;Coves de Vinromà, les;1823;921;902;2019
12;Castellón/Castelló;051;Culla;495;252;243;2019
12;Castellón/Castelló;057;Eslida;759;383;376;2019
12;Castellón/Castelló;058;Espadilla;71;42;29;2019
12;Castellón/Castelló;059;Fanzara;267;137;130;2019
12;Castellón/Castelló;060;Figueroles;523;261;262;2019
12;Castellón/Castelló;061;Forcall;465;230;235;2019
12;Castellón/Castelló;063;Fuente la Reina;52;28;24;2019
12;Castellón/Castelló;064;Fuentes de Ayódar;87;50;37;2019
12;Castellón/Castelló;065;Gaibiel;188;102;86;2019
12;Castellón/Castelló;067;Geldo;635;316;319;2019
12;Castellón/Castelló;068;Herbés;42;24;18;2019
12;Castellón/Castelló;069;Higueras;54;31;23;2019
12;Castellón/Castelló;070;Jana, la;675;341;334;2019
12;Castellón/Castelló;071;Jérica;1548;798;750;2019
12;Castellón/Castelló;074;Llosa, la;951;467;484;2019
12;Castellón/Castelló;072;Llucena/Lucena del Cid;1302;653;649;2019
12;Castellón/Castelló;073;Ludiente;141;78;63;2019
12;Castellón/Castelló;075;Mata de Morella, la;166;90;76;2019
12;Castellón/Castelló;076;Matet;84;43;41;2019
12;Castellón/Castelló;077;Moncofa;6525;3374;3151;2019
12;Castellón/Castelló;078;Montán;370;186;184;2019
12;Castellón/Castelló;079;Montanejos;572;305;267;2019
12;Castellón/Castelló;080;Morella;2430;1192;1238;2019
12;Castellón/Castelló;081;Navajas;716;378;338;2019
12;Castellón/Castelló;082;Nules;13103;6549;6554;2019
12;Castellón/Castelló;083;Olocau del Rey;119;65;54;2019
12;Castellón/Castelló;084;Onda;24859;12484;12375;2019
12;Castellón/Castelló;085;Oropesa del Mar/Orpesa;9076;4660;4416;2019
12;Castellón/Castelló;087;Palanques;30;18;12;2019
12;Castellón/Castelló;088;Pavías;61;39;22;2019
12;Castellón/Castelló;089;Peníscola/Peñíscola;7612;3849;3763;2019
12;Castellón/Castelló;090;Pina de Montalgrao;111;59;52;2019
12;Castellón/Castelló;093;Pobla de Benifassà, la;202;114;88;2019
12;Castellón/Castelló;094;Pobla Tornesa, la;1211;618;593;2019
12;Castellón/Castelló;091;Portell de Morella;197;101;96;2019
12;Castellón/Castelló;092;Puebla de Arenoso;158;84;74;2019
12;Castellón/Castelló;095;Ribesalbes;1174;610;564;2019
12;Castellón/Castelló;096;Rossell;937;494;443;2019
12;Castellón/Castelló;097;Sacañet;67;45;22;2019
12;Castellón/Castelló;098;Salzadella, la;704;360;344;2019
12;Castellón/Castelló;101;San Rafael del Río;469;233;236;2019
12;Castellón/Castelló;902;Sant Joan de Moró;3159;1646;1513;2019
12;Castellón/Castelló;099;Sant Jordi/San Jorge;972;520;452;2019
12;Castellón/Castelló;100;Sant Mateu;1963;971;992;2019
12;Castellón/Castelló;102;Santa Magdalena de Pulpis;768;405;363;2019
12;Castellón/Castelló;104;Segorbe;8978;4427;4551;2019
12;Castellón/Castelló;103;Serratella, la;101;52;49;2019
12;Castellón/Castelló;105;Sierra Engarcerán;976;513;463;2019
12;Castellón/Castelló;106;Soneja;1447;712;735;2019
12;Castellón/Castelló;107;Sot de Ferrer;415;212;203;2019
12;Castellón/Castelló;108;Sueras/Suera;525;279;246;2019
12;Castellón/Castelló;109;Tales;825;416;409;2019
12;Castellón/Castelló;110;Teresa;242;128;114;2019
12;Castellón/Castelló;111;Tírig;419;213;206;2019
12;Castellón/Castelló;112;Todolella;155;92;63;2019
12;Castellón/Castelló;113;Toga;100;52;48;2019
12;Castellón/Castelló;114;Torás;223;121;102;2019
12;Castellón/Castelló;115;Toro, El;256;146;110;2019
12;Castellón/Castelló;116;Torralba del Pinar;69;32;37;2019
12;Castellón/Castelló;119;Torre d'En Besora, la;158;88;70;2019
12;Castellón/Castelló;120;Torre d'en Doménec, la;180;92;88;2019
12;Castellón/Castelló;117;Torreblanca;5528;2797;2731;2019
12;Castellón/Castelló;118;Torrechiva;81;46;35;2019
12;Castellón/Castelló;121;Traiguera;1378;695;683;2019
12;Castellón/Castelló;122;Useras/Useres, les;962;500;462;2019
12;Castellón/Castelló;124;Vall d'Alba;2807;1468;1339;2019
12;Castellón/Castelló;125;Vall de Almonacid;269;133;136;2019
12;Castellón/Castelló;126;Vall d'Uixó, la;31660;15631;16029;2019
12;Castellón/Castelló;123;Vallat;49;21;28;2019
12;Castellón/Castelló;127;Vallibona;69;39;30;2019
12;Castellón/Castelló;128;Vilafamés;1842;997;845;2019
12;Castellón/Castelló;129;Vilafranca/Villafranca del Cid;2200;1087;1113;2019
12;Castellón/Castelló;132;Vilanova d'Alcolea;584;300;284;2019
12;Castellón/Castelló;134;Vilar de Canes;169;88;81;2019
12;Castellón/Castelló;135;Vila-real;50893;25282;25611;2019
12;Castellón/Castelló;136;Vilavella, la;3157;1569;1588;2019
12;Castellón/Castelló;130;Villahermosa del Río;489;268;221;2019
12;Castellón/Castelló;131;Villamalur;62;37;25;2019
12;Castellón/Castelló;133;Villanueva de Viver;61;34;27;2019
12;Castellón/Castelló;137;Villores;39;19;20;2019
12;Castellón/Castelló;138;Vinaròs;28682;14169;14513;2019
12;Castellón/Castelló;139;Vistabella del Maestrat;339;186;153;2019
12;Castellón/Castelló;140;Viver;1536;800;736;2019
12;Castellón/Castelló;052;Xert;701;338;363;2019
12;Castellón/Castelló;141;Zorita del Maestrazgo;114;59;55;2019
12;Castellón/Castelló;142;Zucaina;171;97;74;2019
51;Ceuta;001;Ceuta;84777;42912;41865;2019
13;Ciudad Real;001;Abenójar;1375;711;664;2019
13;Ciudad Real;002;Agudo;1659;830;829;2019
13;Ciudad Real;003;Alamillo;486;249;237;2019
13;Ciudad Real;004;Albaladejo;1158;601;557;2019
13;Ciudad Real;005;Alcázar de San Juan;30576;14908;15668;2019
13;Ciudad Real;006;Alcoba;583;297;286;2019
13;Ciudad Real;007;Alcolea de Calatrava;1409;714;695;2019
13;Ciudad Real;008;Alcubillas;477;239;238;2019
13;Ciudad Real;009;Aldea del Rey;1657;843;814;2019
13;Ciudad Real;010;Alhambra;1002;506;496;2019
13;Ciudad Real;011;Almadén;5312;2536;2776;2019
13;Ciudad Real;012;Almadenejos;415;217;198;2019
13;Ciudad Real;013;Almagro;8896;4377;4519;2019
13;Ciudad Real;014;Almedina;516;274;242;2019
13;Ciudad Real;015;Almodóvar del Campo;6027;3027;3000;2019
13;Ciudad Real;016;Almuradiel;772;383;389;2019
13;Ciudad Real;017;Anchuras;327;164;163;2019
13;Ciudad Real;903;Arenales de San Gregorio;589;300;289;2019
13;Ciudad Real;018;Arenas de San Juan;1011;515;496;2019
13;Ciudad Real;019;Argamasilla de Alba;6838;3418;3420;2019
13;Ciudad Real;020;Argamasilla de Calatrava;5943;2994;2949;2019
13;Ciudad Real;021;Arroba de los Montes;446;241;205;2019
13;Ciudad Real;022;Ballesteros de Calatrava;373;186;187;2019
13;Ciudad Real;023;Bolaños de Calatrava;11934;6090;5844;2019
13;Ciudad Real;024;Brazatortas;1005;523;482;2019
13;Ciudad Real;025;Cabezarados;322;173;149;2019
13;Ciudad Real;026;Cabezarrubias del Puerto;481;252;229;2019
13;Ciudad Real;027;Calzada de Calatrava;3719;1849;1870;2019
13;Ciudad Real;028;Campo de Criptana;13414;6684;6730;2019
13;Ciudad Real;029;Cañada de Calatrava;102;60;42;2019
13;Ciudad Real;030;Caracuel de Calatrava;134;77;57;2019
13;Ciudad Real;031;Carrión de Calatrava;3082;1542;1540;2019
13;Ciudad Real;032;Carrizosa;1212;619;593;2019
13;Ciudad Real;033;Castellar de Santiago;1897;962;935;2019
13;Ciudad Real;038;Chillón;1816;877;939;2019
13;Ciudad Real;034;Ciudad Real;74746;35401;39345;2019
13;Ciudad Real;035;Corral de Calatrava;1123;545;578;2019
13;Ciudad Real;036;Cortijos, Los;884;468;416;2019
13;Ciudad Real;037;Cózar;969;482;487;2019
13;Ciudad Real;039;Daimiel;17929;8970;8959;2019
13;Ciudad Real;040;Fernán Caballero;1001;506;495;2019
13;Ciudad Real;041;Fontanarejo;275;152;123;2019
13;Ciudad Real;042;Fuencaliente;1036;538;498;2019
13;Ciudad Real;043;Fuenllana;217;111;106;2019
13;Ciudad Real;044;Fuente el Fresno;3220;1658;1562;2019
13;Ciudad Real;045;Granátula de Calatrava;714;346;368;2019
13;Ciudad Real;046;Guadalmez;725;350;375;2019
13;Ciudad Real;047;Herencia;8390;4277;4113;2019
13;Ciudad Real;048;Hinojosas de Calatrava;536;274;262;2019
13;Ciudad Real;049;Horcajo de los Montes;883;444;439;2019
13;Ciudad Real;050;Labores, Las;569;282;287;2019
13;Ciudad Real;904;Llanos del Caudillo;719;354;365;2019
13;Ciudad Real;051;Luciana;366;196;170;2019
13;Ciudad Real;052;Malagón;7998;3939;4059;2019
13;Ciudad Real;053;Manzanares;17997;8919;9078;2019
13;Ciudad Real;054;Membrilla;6005;3009;2996;2019
13;Ciudad Real;055;Mestanza;667;337;330;2019
13;Ciudad Real;056;Miguelturra;15368;7742;7626;2019
13;Ciudad Real;057;Montiel;1315;689;626;2019
13;Ciudad Real;058;Moral de Calatrava;5271;2672;2599;2019
13;Ciudad Real;059;Navalpino;228;118;110;2019
13;Ciudad Real;060;Navas de Estena;298;161;137;2019
13;Ciudad Real;061;Pedro Muñoz;7293;3650;3643;2019
13;Ciudad Real;062;Picón;658;338;320;2019
13;Ciudad Real;063;Piedrabuena;4395;2239;2156;2019
13;Ciudad Real;064;Poblete;2626;1347;1279;2019
13;Ciudad Real;065;Porzuna;3532;1810;1722;2019
13;Ciudad Real;066;Pozuelo de Calatrava;3553;1816;1737;2019
13;Ciudad Real;067;Pozuelos de Calatrava, Los;372;193;179;2019
13;Ciudad Real;068;Puebla de Don Rodrigo;1178;650;528;2019
13;Ciudad Real;069;Puebla del Príncipe;694;359;335;2019
13;Ciudad Real;070;Puerto Lápice;924;460;464;2019
13;Ciudad Real;071;Puertollano;47035;22753;24282;2019
13;Ciudad Real;072;Retuerta del Bullaque;941;520;421;2019
13;Ciudad Real;901;Robledo, El;1081;568;513;2019
13;Ciudad Real;902;Ruidera;553;272;281;2019
13;Ciudad Real;073;Saceruela;559;297;262;2019
13;Ciudad Real;074;San Carlos del Valle;1120;574;546;2019
13;Ciudad Real;075;San Lorenzo de Calatrava;213;117;96;2019
13;Ciudad Real;076;Santa Cruz de los Cáñamos;522;250;272;2019
13;Ciudad Real;077;Santa Cruz de Mudela;4107;2034;2073;2019
13;Ciudad Real;078;Socuéllamos;12139;6103;6036;2019
13;Ciudad Real;080;Solana del Pino;324;171;153;2019
13;Ciudad Real;079;Solana, La;15479;7832;7647;2019
13;Ciudad Real;081;Terrinches;678;346;332;2019
13;Ciudad Real;082;Tomelloso;35873;17745;18128;2019
13;Ciudad Real;083;Torralba de Calatrava;2977;1495;1482;2019
13;Ciudad Real;084;Torre de Juan Abad;995;483;512;2019
13;Ciudad Real;085;Torrenueva;2702;1357;1345;2019
13;Ciudad Real;086;Valdemanco del Esteras;170;90;80;2019
13;Ciudad Real;087;Valdepeñas;30077;14644;15433;2019
13;Ciudad Real;088;Valenzuela de Calatrava;688;321;367;2019
13;Ciudad Real;089;Villahermosa;1826;891;935;2019
13;Ciudad Real;090;Villamanrique;1148;560;588;2019
13;Ciudad Real;091;Villamayor de Calatrava;634;313;321;2019
13;Ciudad Real;092;Villanueva de la Fuente;2078;1062;1016;2019
13;Ciudad Real;093;Villanueva de los Infantes;4935;2446;2489;2019
13;Ciudad Real;094;Villanueva de San Carlos;290;155;135;2019
13;Ciudad Real;095;Villar del Pozo;75;41;34;2019
13;Ciudad Real;096;Villarrubia de los Ojos;9814;4878;4936;2019
13;Ciudad Real;097;Villarta de San Juan;2791;1410;1381;2019
13;Ciudad Real;098;Viso del Marqués;2298;1109;1189;2019
14;Córdoba;001;Adamuz;4192;2157;2035;2019
14;Córdoba;002;Aguilar de la Frontera;13328;6678;6650;2019
14;Córdoba;003;Alcaracejos;1486;723;763;2019
14;Córdoba;004;Almedinilla;2391;1191;1200;2019
14;Córdoba;005;Almodóvar del Río;7937;3963;3974;2019
14;Córdoba;006;Añora;1527;752;775;2019
14;Córdoba;007;Baena;19284;9829;9455;2019
14;Córdoba;008;Belalcázar;3255;1572;1683;2019
14;Córdoba;009;Belmez;2923;1418;1505;2019
14;Córdoba;010;Benamejí;4966;2478;2488;2019
14;Córdoba;011;Blázquez, Los;661;338;323;2019
14;Córdoba;012;Bujalance;7417;3691;3726;2019
14;Córdoba;013;Cabra;20341;9905;10436;2019
14;Córdoba;014;Cañete de las Torres;2933;1512;1421;2019
14;Córdoba;015;Carcabuey;2412;1226;1186;2019
14;Córdoba;016;Cardeña;1490;740;750;2019
14;Córdoba;017;Carlota, La;14061;7033;7028;2019
14;Córdoba;018;Carpio, El;4383;2166;2217;2019
14;Córdoba;019;Castro del Río;7809;3869;3940;2019
14;Córdoba;020;Conquista;379;186;193;2019
14;Córdoba;021;Córdoba;325701;156355;169346;2019
14;Córdoba;022;Doña Mencía;4638;2249;2389;2019
14;Córdoba;023;Dos Torres;2411;1202;1209;2019
14;Córdoba;024;Encinas Reales;2254;1115;1139;2019
14;Córdoba;025;Espejo;3329;1671;1658;2019
14;Córdoba;026;Espiel;2397;1207;1190;2019
14;Córdoba;027;Fernán-Núñez;9663;4840;4823;2019
14;Córdoba;901;Fuente Carreteros;1131;578;553;2019
14;Córdoba;028;Fuente la Lancha;351;182;169;2019
14;Córdoba;029;Fuente Obejuna;4604;2374;2230;2019
14;Córdoba;030;Fuente Palmera;9783;4886;4897;2019
14;Córdoba;031;Fuente-Tójar;672;325;347;2019
14;Córdoba;032;Granjuela, La;461;236;225;2019
14;Córdoba;033;Guadalcázar;1583;794;789;2019
14;Córdoba;902;Guijarrosa, La;1399;714;685;2019
14;Córdoba;034;Guijo, El;355;185;170;2019
14;Córdoba;035;Hinojosa del Duque;6788;3328;3460;2019
14;Córdoba;036;Hornachuelos;4497;2239;2258;2019
14;Córdoba;037;Iznájar;4261;2133;2128;2019
14;Córdoba;038;Lucena;42605;21251;21354;2019
14;Córdoba;039;Luque;2994;1503;1491;2019
14;Córdoba;040;Montalbán de Córdoba;4489;2219;2270;2019
14;Córdoba;041;Montemayor;3855;1938;1917;2019
14;Córdoba;042;Montilla;22859;11353;11506;2019
14;Córdoba;043;Montoro;9364;4616;4748;2019
14;Córdoba;044;Monturque;1958;967;991;2019
14;Córdoba;045;Moriles;3717;1866;1851;2019
14;Córdoba;046;Nueva Carteya;5379;2732;2647;2019
14;Córdoba;047;Obejo;2011;1048;963;2019
14;Córdoba;048;Palenciana;1478;748;730;2019
14;Córdoba;049;Palma del Río;21064;10456;10608;2019
14;Córdoba;050;Pedro Abad;2837;1435;1402;2019
14;Córdoba;051;Pedroche;1516;738;778;2019
14;Córdoba;052;Peñarroya-Pueblonuevo;10695;5180;5515;2019
14;Córdoba;053;Posadas;7325;3635;3690;2019
14;Córdoba;054;Pozoblanco;17210;8371;8839;2019
14;Córdoba;055;Priego de Córdoba;22408;10929;11479;2019
14;Córdoba;056;Puente Genil;30048;14938;15110;2019
14;Córdoba;057;Rambla, La;7493;3713;3780;2019
14;Córdoba;058;Rute;9845;4892;4953;2019
14;Córdoba;059;San Sebastián de los Ballesteros;808;406;402;2019
14;Córdoba;061;Santa Eufemia;755;383;372;2019
14;Córdoba;060;Santaella;4629;2327;2302;2019
14;Córdoba;062;Torrecampo;1059;519;540;2019
14;Córdoba;063;Valenzuela;1131;562;569;2019
14;Córdoba;064;Valsequillo;356;168;188;2019
14;Córdoba;065;Victoria, La;2271;1131;1140;2019
14;Córdoba;066;Villa del Río;7104;3527;3577;2019
14;Córdoba;067;Villafranca de Córdoba;4871;2486;2385;2019
14;Córdoba;068;Villaharta;619;301;318;2019
14;Córdoba;069;Villanueva de Córdoba;8729;4331;4398;2019
14;Córdoba;070;Villanueva del Duque;1461;743;718;2019
14;Córdoba;071;Villanueva del Rey;1046;513;533;2019
14;Córdoba;072;Villaralto;1131;569;562;2019
14;Córdoba;073;Villaviciosa de Córdoba;3229;1663;1566;2019
14;Córdoba;074;Viso, El;2536;1265;1271;2019
14;Córdoba;075;Zuheros;641;328;313;2019
15;Coruña, A;001;Abegondo;5406;2655;2751;2019
15;Coruña, A;002;Ames;31793;15236;16557;2019
15;Coruña, A;003;Aranga;1849;964;885;2019
15;Coruña, A;004;Ares;5732;2825;2907;2019
15;Coruña, A;005;Arteixo;32262;15976;16286;2019
15;Coruña, A;006;Arzúa;6041;3012;3029;2019
15;Coruña, A;007;Baña, A;3450;1628;1822;2019
15;Coruña, A;008;Bergondo;6633;3232;3401;2019
15;Coruña, A;009;Betanzos;12959;6155;6804;2019
15;Coruña, A;010;Boimorto;1985;1003;982;2019
15;Coruña, A;011;Boiro;18838;9177;9661;2019
15;Coruña, A;012;Boqueixón;4220;2091;2129;2019
15;Coruña, A;013;Brión;7837;3773;4064;2019
15;Coruña, A;014;Cabana de Bergantiños;4248;2054;2194;2019
15;Coruña, A;015;Cabanas;3281;1606;1675;2019
15;Coruña, A;016;Camariñas;5272;2577;2695;2019
15;Coruña, A;017;Cambre;24648;12024;12624;2019
15;Coruña, A;018;Capela, A;1232;612;620;2019
15;Coruña, A;019;Carballo;31349;15342;16007;2019
15;Coruña, A;901;Cariño;3838;1901;1937;2019
15;Coruña, A;020;Carnota;3957;1871;2086;2019
15;Coruña, A;021;Carral;6408;3151;3257;2019
15;Coruña, A;022;Cedeira;6640;3292;3348;2019
15;Coruña, A;023;Cee;7546;3605;3941;2019
15;Coruña, A;024;Cerceda;5001;2457;2544;2019
15;Coruña, A;025;Cerdido;1113;547;566;2019
15;Coruña, A;027;Coirós;1824;906;918;2019
15;Coruña, A;028;Corcubión;1589;769;820;2019
15;Coruña, A;029;Coristanco;6074;2895;3179;2019
15;Coruña, A;030;Coruña, A;245711;113900;131811;2019
15;Coruña, A;031;Culleredo;30402;14685;15717;2019
15;Coruña, A;032;Curtis;3983;1981;2002;2019
15;Coruña, A;033;Dodro;2768;1344;1424;2019
15;Coruña, A;034;Dumbría;2983;1434;1549;2019
15;Coruña, A;035;Fene;12944;6170;6774;2019
15;Coruña, A;036;Ferrol;66065;31027;35038;2019
15;Coruña, A;037;Fisterra;4708;2380;2328;2019
15;Coruña, A;038;Frades;2339;1162;1177;2019
15;Coruña, A;039;Irixoa;1334;663;671;2019
15;Coruña, A;041;Laracha, A;11347;5591;5756;2019
15;Coruña, A;040;Laxe;3016;1515;1501;2019
15;Coruña, A;042;Lousame;3338;1647;1691;2019
15;Coruña, A;043;Malpica de Bergantiños;5391;2631;2760;2019
15;Coruña, A;044;Mañón;1356;665;691;2019
15;Coruña, A;045;Mazaricos;3885;1855;2030;2019
15;Coruña, A;046;Melide;7406;3654;3752;2019
15;Coruña, A;047;Mesía;2530;1260;1270;2019
15;Coruña, A;048;Miño;6200;3082;3118;2019
15;Coruña, A;049;Moeche;1226;586;640;2019
15;Coruña, A;050;Monfero;1932;994;938;2019
15;Coruña, A;051;Mugardos;5245;2541;2704;2019
15;Coruña, A;053;Muros;8556;4123;4433;2019
15;Coruña, A;052;Muxía;4657;2260;2397;2019
15;Coruña, A;054;Narón;39080;18904;20176;2019
15;Coruña, A;055;Neda;5079;2464;2615;2019
15;Coruña, A;056;Negreira;6827;3302;3525;2019
15;Coruña, A;057;Noia;14263;6839;7424;2019
15;Coruña, A;058;Oleiros;36075;17381;18694;2019
15;Coruña, A;059;Ordes;12674;6190;6484;2019
15;Coruña, A;060;Oroso;7500;3708;3792;2019
15;Coruña, A;061;Ortigueira;5671;2708;2963;2019
15;Coruña, A;062;Outes;6282;3018;3264;2019
15;Coruña, A;902;Oza-Cesuras;5101;2562;2539;2019
15;Coruña, A;064;Paderne;2394;1173;1221;2019
15;Coruña, A;065;Padrón;8384;4030;4354;2019
15;Coruña, A;066;Pino, O;4641;2333;2308;2019
15;Coruña, A;067;Pobra do Caramiñal, A;9338;4563;4775;2019
15;Coruña, A;068;Ponteceso;5502;2756;2746;2019
15;Coruña, A;069;Pontedeume;7777;3711;4066;2019
15;Coruña, A;070;Pontes de García Rodríguez, As;10138;4934;5204;2019
15;Coruña, A;071;Porto do Son;9171;4562;4609;2019
15;Coruña, A;072;Rianxo;11033;5395;5638;2019
15;Coruña, A;073;Ribeira;26886;13263;13623;2019
15;Coruña, A;074;Rois;4512;2144;2368;2019
15;Coruña, A;075;Sada;15841;7741;8100;2019
15;Coruña, A;076;San Sadurniño;2822;1396;1426;2019
15;Coruña, A;077;Santa Comba;9426;4553;4873;2019
15;Coruña, A;078;Santiago de Compostela;97260;45179;52081;2019
15;Coruña, A;079;Santiso;1584;816;768;2019
15;Coruña, A;080;Sobrado;1758;909;849;2019
15;Coruña, A;081;Somozas, As;1098;550;548;2019
15;Coruña, A;082;Teo;18579;9127;9452;2019
15;Coruña, A;083;Toques;1124;584;540;2019
15;Coruña, A;084;Tordoia;3299;1558;1741;2019
15;Coruña, A;085;Touro;3574;1780;1794;2019
15;Coruña, A;086;Trazo;3113;1538;1575;2019
15;Coruña, A;088;Val do Dubra;3876;1854;2022;2019
15;Coruña, A;087;Valdoviño;6563;3181;3382;2019
15;Coruña, A;089;Vedra;5036;2475;2561;2019
15;Coruña, A;091;Vilarmaior;1226;627;599;2019
15;Coruña, A;090;Vilasantar;1213;642;571;2019
15;Coruña, A;092;Vimianzo;7057;3380;3677;2019
15;Coruña, A;093;Zas;4472;2154;2318;2019
16;Cuenca;001;Abia de la Obispalía;65;40;25;2019
16;Cuenca;002;Acebrón, El;234;115;119;2019
16;Cuenca;003;Alarcón;148;67;81;2019
16;Cuenca;004;Albaladejo del Cuende;245;127;118;2019
16;Cuenca;005;Albalate de las Nogueras;253;132;121;2019
16;Cuenca;006;Albendea;121;57;64;2019
16;Cuenca;007;Alberca de Záncara, La;1590;807;783;2019
16;Cuenca;008;Alcalá de la Vega;93;55;38;2019
16;Cuenca;009;Alcantud;51;28;23;2019
16;Cuenca;010;Alcázar del Rey;152;78;74;2019
16;Cuenca;011;Alcohujate;28;15;13;2019
16;Cuenca;012;Alconchel de la Estrella;88;51;37;2019
16;Cuenca;013;Algarra;26;13;13;2019
16;Cuenca;014;Aliaguilla;642;331;311;2019
16;Cuenca;015;Almarcha, La;365;201;164;2019
16;Cuenca;016;Almendros;247;139;108;2019
16;Cuenca;017;Almodóvar del Pinar;390;216;174;2019
16;Cuenca;018;Almonacid del Marquesado;425;218;207;2019
16;Cuenca;019;Altarejos;190;101;89;2019
16;Cuenca;020;Arandilla del Arroyo;7;3;4;2019
16;Cuenca;905;Arcas;1716;866;850;2019
16;Cuenca;022;Arcos de la Sierra;83;47;36;2019
16;Cuenca;024;Arguisuelas;136;74;62;2019
16;Cuenca;025;Arrancacepas;25;13;12;2019
16;Cuenca;026;Atalaya del Cañavate;112;58;54;2019
16;Cuenca;027;Barajas de Melo;932;491;441;2019
16;Cuenca;029;Barchín del Hoyo;89;57;32;2019
16;Cuenca;030;Bascuñana de San Pedro;18;15;3;2019
16;Cuenca;031;Beamud;37;18;19;2019
16;Cuenca;032;Belinchón;334;173;161;2019
16;Cuenca;033;Belmonte;1903;954;949;2019
16;Cuenca;034;Belmontejo;160;92;68;2019
16;Cuenca;035;Beteta;262;125;137;2019
16;Cuenca;036;Boniches;146;71;75;2019
16;Cuenca;038;Buciegas;36;25;11;2019
16;Cuenca;039;Buenache de Alarcón;459;239;220;2019
16;Cuenca;040;Buenache de la Sierra;97;56;41;2019
16;Cuenca;041;Buendía;400;213;187;2019
16;Cuenca;042;Campillo de Altobuey;1322;655;667;2019
16;Cuenca;043;Campillos-Paravientos;105;60;45;2019
16;Cuenca;044;Campillos-Sierra;38;17;21;2019
16;Cuenca;901;Campos del Paraíso;737;374;363;2019
16;Cuenca;045;Canalejas del Arroyo;186;102;84;2019
16;Cuenca;046;Cañada del Hoyo;243;125;118;2019
16;Cuenca;047;Cañada Juncosa;240;130;110;2019
16;Cuenca;048;Cañamares;466;254;212;2019
16;Cuenca;049;Cañavate, El;146;73;73;2019
16;Cuenca;050;Cañaveras;258;127;131;2019
16;Cuenca;051;Cañaveruelas;132;67;65;2019
16;Cuenca;052;Cañete;739;377;362;2019
16;Cuenca;053;Cañizares;439;240;199;2019
16;Cuenca;055;Carboneras de Guadazaón;811;417;394;2019
16;Cuenca;056;Cardenete;496;267;229;2019
16;Cuenca;057;Carrascosa;70;42;28;2019
16;Cuenca;058;Carrascosa de Haro;106;56;50;2019
16;Cuenca;060;Casas de Benítez;852;424;428;2019
16;Cuenca;061;Casas de Fernando Alonso;1169;608;561;2019
16;Cuenca;062;Casas de Garcimolina;29;19;10;2019
16;Cuenca;063;Casas de Guijarro;117;63;54;2019
16;Cuenca;064;Casas de Haro;823;437;386;2019
16;Cuenca;065;Casas de los Pinos;440;218;222;2019
16;Cuenca;066;Casasimarro;3084;1590;1494;2019
16;Cuenca;067;Castejón;144;79;65;2019
16;Cuenca;068;Castillejo de Iniesta;159;85;74;2019
16;Cuenca;070;Castillejo-Sierra;28;15;13;2019
16;Cuenca;072;Castillo de Garcimuñoz;134;78;56;2019
16;Cuenca;071;Castillo-Albaráñez;22;10;12;2019
16;Cuenca;073;Cervera del Llano;221;116;105;2019
16;Cuenca;023;Chillarón de Cuenca;617;322;295;2019
16;Cuenca;081;Chumillas;57;32;25;2019
16;Cuenca;074;Cierva, La;28;16;12;2019
16;Cuenca;078;Cuenca;54690;26049;28641;2019
16;Cuenca;079;Cueva del Hierro;29;21;8;2019
16;Cuenca;082;Enguídanos;317;167;150;2019
16;Cuenca;083;Fresneda de Altarejos;40;20;20;2019
16;Cuenca;084;Fresneda de la Sierra;48;28;20;2019
16;Cuenca;085;Frontera, La;155;82;73;2019
16;Cuenca;086;Fuente de Pedro Naharro;1205;624;581;2019
16;Cuenca;087;Fuentelespino de Haro;274;142;132;2019
16;Cuenca;088;Fuentelespino de Moya;109;60;49;2019
16;Cuenca;904;Fuentenava de Jábaga;513;268;245;2019
16;Cuenca;089;Fuentes;455;241;214;2019
16;Cuenca;091;Fuertescusa;63;35;28;2019
16;Cuenca;092;Gabaldón;183;111;72;2019
16;Cuenca;093;Garaballa;59;33;26;2019
16;Cuenca;094;Gascueña;153;86;67;2019
16;Cuenca;095;Graja de Campalbo;91;50;41;2019
16;Cuenca;096;Graja de Iniesta;361;185;176;2019
16;Cuenca;097;Henarejos;139;73;66;2019
16;Cuenca;098;Herrumblar, El;664;338;326;2019
16;Cuenca;099;Hinojosa, La;188;96;92;2019
16;Cuenca;100;Hinojosos, Los;771;380;391;2019
16;Cuenca;101;Hito, El;141;77;64;2019
16;Cuenca;102;Honrubia;1566;786;780;2019
16;Cuenca;103;Hontanaya;253;143;110;2019
16;Cuenca;104;Hontecillas;61;33;28;2019
16;Cuenca;106;Horcajo de Santiago;3493;1770;1723;2019
16;Cuenca;107;Huélamo;99;55;44;2019
16;Cuenca;108;Huelves;57;30;27;2019
16;Cuenca;109;Huérguina;44;24;20;2019
16;Cuenca;110;Huerta de la Obispalía;114;67;47;2019
16;Cuenca;111;Huerta del Marquesado;194;108;86;2019
16;Cuenca;112;Huete;1765;913;852;2019
16;Cuenca;113;Iniesta;4305;2129;2176;2019
16;Cuenca;115;Laguna del Marquesado;50;28;22;2019
16;Cuenca;116;Lagunaseca;77;45;32;2019
16;Cuenca;117;Landete;1234;633;601;2019
16;Cuenca;118;Ledaña;1563;772;791;2019
16;Cuenca;119;Leganiel;190;98;92;2019
16;Cuenca;121;Majadas, Las;241;126;115;2019
16;Cuenca;122;Mariana;304;157;147;2019
16;Cuenca;123;Masegosa;64;37;27;2019
16;Cuenca;124;Mesas, Las;2336;1188;1148;2019
16;Cuenca;125;Minglanilla;2221;1137;1084;2019
16;Cuenca;126;Mira;905;462;443;2019
16;Cuenca;128;Monreal del Llano;56;31;25;2019
16;Cuenca;129;Montalbanejo;103;54;49;2019
16;Cuenca;130;Montalbo;643;337;306;2019
16;Cuenca;131;Monteagudo de las Salinas;129;75;54;2019
16;Cuenca;132;Mota de Altarejos;34;22;12;2019
16;Cuenca;133;Mota del Cuervo;5990;2993;2997;2019
16;Cuenca;134;Motilla del Palancar;5869;2908;2961;2019
16;Cuenca;135;Moya;139;84;55;2019
16;Cuenca;137;Narboneta;37;19;18;2019
16;Cuenca;139;Olivares de Júcar;325;169;156;2019
16;Cuenca;140;Olmeda de la Cuesta;20;11;9;2019
16;Cuenca;141;Olmeda del Rey;132;67;65;2019
16;Cuenca;142;Olmedilla de Alarcón;149;85;64;2019
16;Cuenca;143;Olmedilla de Eliz;15;10;5;2019
16;Cuenca;145;Osa de la Vega;479;249;230;2019
16;Cuenca;146;Pajarón;82;39;43;2019
16;Cuenca;147;Pajaroncillo;65;40;25;2019
16;Cuenca;148;Palomares del Campo;602;308;294;2019
16;Cuenca;149;Palomera;171;85;86;2019
16;Cuenca;150;Paracuellos;94;50;44;2019
16;Cuenca;151;Paredes;66;37;29;2019
16;Cuenca;152;Parra de las Vegas, La;33;23;10;2019
16;Cuenca;153;Pedernoso, El;1124;561;563;2019
16;Cuenca;154;Pedroñeras, Las;6638;3406;3232;2019
16;Cuenca;155;Peral, El;632;353;279;2019
16;Cuenca;156;Peraleja, La;97;60;37;2019
16;Cuenca;157;Pesquera, La;215;119;96;2019
16;Cuenca;158;Picazo, El;666;336;330;2019
16;Cuenca;159;Pinarejo;212;109;103;2019
16;Cuenca;160;Pineda de Gigüela;60;37;23;2019
16;Cuenca;161;Piqueras del Castillo;48;27;21;2019
16;Cuenca;162;Portalrubio de Guadamejud;22;10;12;2019
16;Cuenca;163;Portilla;59;32;27;2019
16;Cuenca;165;Poyatos;56;29;27;2019
16;Cuenca;166;Pozoamargo;292;154;138;2019
16;Cuenca;908;Pozorrubielos de la Mancha;180;92;88;2019
16;Cuenca;167;Pozorrubio de Santiago;323;155;168;2019
16;Cuenca;169;Pozuelo, El;49;31;18;2019
16;Cuenca;170;Priego;896;455;441;2019
16;Cuenca;171;Provencio, El;2437;1200;1237;2019
16;Cuenca;172;Puebla de Almenara;384;199;185;2019
16;Cuenca;174;Puebla del Salvador;181;100;81;2019
16;Cuenca;175;Quintanar del Rey;7586;3901;3685;2019
16;Cuenca;176;Rada de Haro;44;23;21;2019
16;Cuenca;177;Reíllo;118;62;56;2019
16;Cuenca;181;Rozalén del Monte;67;31;36;2019
16;Cuenca;185;Saceda-Trasierra;41;30;11;2019
16;Cuenca;186;Saelices;483;252;231;2019
16;Cuenca;187;Salinas del Manzano;68;40;28;2019
16;Cuenca;188;Salmeroncillos;102;58;44;2019
16;Cuenca;189;Salvacañete;303;158;145;2019
16;Cuenca;190;San Clemente;6988;3511;3477;2019
16;Cuenca;191;San Lorenzo de la Parrilla;1042;524;518;2019
16;Cuenca;192;San Martín de Boniches;44;23;21;2019
16;Cuenca;193;San Pedro Palmiches;57;32;25;2019
16;Cuenca;194;Santa Cruz de Moya;218;117;101;2019
16;Cuenca;196;Santa María de los Llanos;676;352;324;2019
16;Cuenca;195;Santa María del Campo Rus;571;293;278;2019
16;Cuenca;197;Santa María del Val;67;39;28;2019
16;Cuenca;198;Sisante;1642;826;816;2019
16;Cuenca;199;Solera de Gabaldón;28;15;13;2019
16;Cuenca;909;Sotorribas;732;378;354;2019
16;Cuenca;202;Talayuelas;878;467;411;2019
16;Cuenca;203;Tarancón;15271;7550;7721;2019
16;Cuenca;204;Tébar;286;146;140;2019
16;Cuenca;205;Tejadillos;118;57;61;2019
16;Cuenca;206;Tinajas;201;110;91;2019
16;Cuenca;209;Torralba;112;67;45;2019
16;Cuenca;211;Torrejoncillo del Rey;341;180;161;2019
16;Cuenca;212;Torrubia del Campo;257;129;128;2019
16;Cuenca;213;Torrubia del Castillo;38;24;14;2019
16;Cuenca;215;Tragacete;249;139;110;2019
16;Cuenca;216;Tresjuncos;293;155;138;2019
16;Cuenca;217;Tribaldos;107;57;50;2019
16;Cuenca;218;Uclés;222;117;105;2019
16;Cuenca;219;Uña;82;43;39;2019
16;Cuenca;906;Valdecolmenas, Los;72;47;25;2019
16;Cuenca;224;Valdemeca;84;47;37;2019
16;Cuenca;225;Valdemorillo de la Sierra;59;35;24;2019
16;Cuenca;227;Valdemoro-Sierra;110;65;45;2019
16;Cuenca;228;Valdeolivas;202;125;77;2019
16;Cuenca;902;Valdetórtola;133;75;58;2019
16;Cuenca;903;Valeras, Las;1496;789;707;2019
16;Cuenca;231;Valhermoso de la Fuente;57;30;27;2019
16;Cuenca;173;Valle de Altomira, El;211;117;94;2019
16;Cuenca;234;Valsalobre;23;12;11;2019
16;Cuenca;236;Valverde de Júcar;1082;534;548;2019
16;Cuenca;237;Valverdejo;93;51;42;2019
16;Cuenca;238;Vara de Rey;496;254;242;2019
16;Cuenca;239;Vega del Codorno;129;80;49;2019
16;Cuenca;240;Vellisca;102;59;43;2019
16;Cuenca;242;Villaconejos de Trabaque;344;172;172;2019
16;Cuenca;243;Villaescusa de Haro;470;239;231;2019
16;Cuenca;244;Villagarcía del Llano;759;383;376;2019
16;Cuenca;245;Villalba de la Sierra;456;225;231;2019
16;Cuenca;246;Villalba del Rey;516;282;234;2019
16;Cuenca;247;Villalgordo del Marquesado;80;42;38;2019
16;Cuenca;248;Villalpardo;1018;504;514;2019
16;Cuenca;249;Villamayor de Santiago;2481;1258;1223;2019
16;Cuenca;250;Villanueva de Guadamejud;65;39;26;2019
16;Cuenca;251;Villanueva de la Jara;2249;1133;1116;2019
16;Cuenca;253;Villar de Cañas;374;204;170;2019
16;Cuenca;254;Villar de Domingo García;220;109;111;2019
16;Cuenca;255;Villar de la Encina;154;84;70;2019
16;Cuenca;263;Villar de Olalla;1270;682;588;2019
16;Cuenca;258;Villar del Humo;184;102;82;2019
16;Cuenca;259;Villar del Infantado;43;23;20;2019
16;Cuenca;910;Villar y Velasco;77;44;33;2019
16;Cuenca;264;Villarejo de Fuentes;429;215;214;2019
16;Cuenca;265;Villarejo de la Peñuela;20;9;11;2019
16;Cuenca;266;Villarejo-Periesteban;380;190;190;2019
16;Cuenca;269;Villares del Saz;443;226;217;2019
16;Cuenca;270;Villarrubio;194;109;85;2019
16;Cuenca;271;Villarta;793;393;400;2019
16;Cuenca;272;Villas de la Ventosa;211;123;88;2019
16;Cuenca;273;Villaverde y Pasaconsol;332;176;156;2019
16;Cuenca;274;Víllora;114;60;54;2019
16;Cuenca;275;Vindel;11;7;4;2019
16;Cuenca;276;Yémeda;21;13;8;2019
16;Cuenca;277;Zafra de Záncara;122;68;54;2019
16;Cuenca;278;Zafrilla;58;29;29;2019
16;Cuenca;279;Zarza de Tajo;239;138;101;2019
16;Cuenca;280;Zarzuela;170;91;79;2019
20;Gipuzkoa;001;Abaltzisketa;333;181;152;2019
20;Gipuzkoa;002;Aduna;469;253;216;2019
20;Gipuzkoa;016;Aia;2054;1092;962;2019
20;Gipuzkoa;003;Aizarnazabal;772;391;381;2019
20;Gipuzkoa;004;Albiztur;304;159;145;2019
20;Gipuzkoa;005;Alegia;1722;890;832;2019
20;Gipuzkoa;006;Alkiza;367;178;189;2019
20;Gipuzkoa;906;Altzaga;183;90;93;2019
20;Gipuzkoa;007;Altzo;435;226;209;2019
20;Gipuzkoa;008;Amezketa;921;497;424;2019
20;Gipuzkoa;009;Andoain;14637;7248;7389;2019
20;Gipuzkoa;010;Anoeta;2090;1088;1002;2019
20;Gipuzkoa;011;Antzuola;2126;1059;1067;2019
20;Gipuzkoa;012;Arama;200;99;101;2019
20;Gipuzkoa;013;Aretxabaleta;7128;3577;3551;2019
20;Gipuzkoa;055;Arrasate/Mondragón;22001;10814;11187;2019
20;Gipuzkoa;014;Asteasu;1551;808;743;2019
20;Gipuzkoa;903;Astigarraga;6532;3312;3220;2019
20;Gipuzkoa;015;Ataun;1693;879;814;2019
20;Gipuzkoa;017;Azkoitia;11633;5783;5850;2019
20;Gipuzkoa;018;Azpeitia;14936;7468;7468;2019
20;Gipuzkoa;904;Baliarrain;138;74;64;2019
20;Gipuzkoa;019;Beasain;13880;6976;6904;2019
20;Gipuzkoa;020;Beizama;143;86;57;2019
20;Gipuzkoa;021;Belauntza;241;125;116;2019
20;Gipuzkoa;022;Berastegi;1076;555;521;2019
20;Gipuzkoa;074;Bergara;14637;7260;7377;2019
20;Gipuzkoa;023;Berrobi;603;315;288;2019
20;Gipuzkoa;024;Bidania-Goiatz;520;284;236;2019
20;Gipuzkoa;029;Deba;5459;2711;2748;2019
20;Gipuzkoa;069;Donostia/San Sebastián;187415;88306;99109;2019
20;Gipuzkoa;030;Eibar;27522;13391;14131;2019
20;Gipuzkoa;031;Elduain;250;125;125;2019
20;Gipuzkoa;033;Elgeta;1136;581;555;2019
20;Gipuzkoa;032;Elgoibar;11613;5739;5874;2019
20;Gipuzkoa;067;Errenteria;39471;19110;20361;2019
20;Gipuzkoa;066;Errezil;585;307;278;2019
20;Gipuzkoa;034;Eskoriatza;4065;2033;2032;2019
20;Gipuzkoa;035;Ezkio-Itsaso;611;321;290;2019
20;Gipuzkoa;038;Gabiria;488;258;230;2019
20;Gipuzkoa;037;Gaintza;128;75;53;2019
20;Gipuzkoa;907;Gaztelu;152;82;70;2019
20;Gipuzkoa;039;Getaria;2821;1430;1391;2019
20;Gipuzkoa;040;Hernani;20354;9964;10390;2019
20;Gipuzkoa;041;Hernialde;303;159;144;2019
20;Gipuzkoa;036;Hondarribia;16828;8370;8458;2019
20;Gipuzkoa;042;Ibarra;4199;2094;2105;2019
20;Gipuzkoa;043;Idiazabal;2312;1174;1138;2019
20;Gipuzkoa;044;Ikaztegieta;498;251;247;2019
20;Gipuzkoa;045;Irun;62401;30494;31907;2019
20;Gipuzkoa;046;Irura;1852;962;890;2019
20;Gipuzkoa;047;Itsasondo;658;343;315;2019
20;Gipuzkoa;048;Larraul;251;138;113;2019
20;Gipuzkoa;902;Lasarte-Oria;18380;8899;9481;2019
20;Gipuzkoa;049;Lazkao;5742;2887;2855;2019
20;Gipuzkoa;050;Leaburu;372;199;173;2019
20;Gipuzkoa;051;Legazpi;8371;4227;4144;2019
20;Gipuzkoa;052;Legorreta;1417;716;701;2019
20;Gipuzkoa;068;Leintz-Gatzaga;234;126;108;2019
20;Gipuzkoa;053;Lezo;6122;3051;3071;2019
20;Gipuzkoa;054;Lizartza;603;312;291;2019
20;Gipuzkoa;901;Mendaro;1999;1002;997;2019
20;Gipuzkoa;057;Mutiloa;249;136;113;2019
20;Gipuzkoa;056;Mutriku;5333;2688;2645;2019
20;Gipuzkoa;063;Oiartzun;10293;5081;5212;2019
20;Gipuzkoa;058;Olaberria;953;480;473;2019
20;Gipuzkoa;059;Oñati;11380;5617;5763;2019
20;Gipuzkoa;076;Ordizia;10394;5151;5243;2019
20;Gipuzkoa;905;Orendain;218;112;106;2019
20;Gipuzkoa;060;Orexa;121;67;54;2019
20;Gipuzkoa;061;Orio;6022;3020;3002;2019
20;Gipuzkoa;062;Ormaiztegi;1276;641;635;2019
20;Gipuzkoa;064;Pasaia;16156;7794;8362;2019
20;Gipuzkoa;070;Segura;1467;742;725;2019
20;Gipuzkoa;065;Soraluze-Placencia de las Armas;3883;1945;1938;2019
20;Gipuzkoa;071;Tolosa;19667;9502;10165;2019
20;Gipuzkoa;072;Urnieta;6168;3088;3080;2019
20;Gipuzkoa;077;Urretxu;6756;3327;3429;2019
20;Gipuzkoa;073;Usurbil;6174;3090;3084;2019
20;Gipuzkoa;075;Villabona;5867;2939;2928;2019
20;Gipuzkoa;078;Zaldibia;1613;824;789;2019
20;Gipuzkoa;079;Zarautz;23323;11357;11966;2019
20;Gipuzkoa;025;Zegama;1528;773;755;2019
20;Gipuzkoa;026;Zerain;259;124;135;2019
20;Gipuzkoa;027;Zestoa;3711;1939;1772;2019
20;Gipuzkoa;028;Zizurkil;3002;1512;1490;2019
20;Gipuzkoa;081;Zumaia;10098;5019;5079;2019
20;Gipuzkoa;080;Zumarraga;9728;4791;4937;2019
17;Girona;001;Agullana;831;411;420;2019
17;Girona;002;Aiguaviva;756;383;373;2019
17;Girona;003;Albanyà;157;80;77;2019
17;Girona;004;Albons;776;401;375;2019
17;Girona;006;Alp;1580;828;752;2019
17;Girona;007;Amer;2298;1122;1176;2019
17;Girona;008;Anglès;5599;2780;2819;2019
17;Girona;009;Arbúcies;6556;3390;3166;2019
17;Girona;010;Argelaguer;397;205;192;2019
17;Girona;011;Armentera, L';930;461;469;2019
17;Girona;012;Avinyonet de Puigventós;1610;796;814;2019
17;Girona;015;Banyoles;19826;9873;9953;2019
17;Girona;016;Bàscara;1004;520;484;2019
17;Girona;013;Begur;3925;1964;1961;2019
17;Girona;018;Bellcaire d'Empordà;693;336;357;2019
17;Girona;019;Besalú;2492;1170;1322;2019
17;Girona;020;Bescanó;4960;2505;2455;2019
17;Girona;021;Beuda;190;100;90;2019
17;Girona;022;Bisbal d'Empordà, La;10974;5446;5528;2019
17;Girona;234;Biure;232;118;114;2019
17;Girona;023;Blanes;39028;19356;19672;2019
17;Girona;029;Boadella i les Escaules;252;130;122;2019
17;Girona;024;Bolvir;369;191;178;2019
17;Girona;025;Bordils;1779;887;892;2019
17;Girona;026;Borrassà;714;374;340;2019
17;Girona;027;Breda;3740;1836;1904;2019
17;Girona;028;Brunyola i Sant Martí Sapresa;383;195;188;2019
17;Girona;031;Cabanelles;279;154;125;2019
17;Girona;030;Cabanes;948;500;448;2019
17;Girona;032;Cadaqués;2712;1322;1390;2019
17;Girona;033;Caldes de Malavella;7641;3828;3813;2019
17;Girona;034;Calonge i Sant Antoni;11092;5571;5521;2019
17;Girona;035;Camós;693;341;352;2019
17;Girona;036;Campdevànol;3223;1566;1657;2019
17;Girona;037;Campelles;139;71;68;2019
17;Girona;038;Campllong;547;272;275;2019
17;Girona;039;Camprodon;2281;1117;1164;2019
17;Girona;040;Canet d'Adri;723;371;352;2019
17;Girona;041;Cantallops;313;153;160;2019
17;Girona;042;Capmany;613;307;306;2019
17;Girona;044;Cassà de la Selva;10380;5301;5079;2019
17;Girona;046;Castellfollit de la Roca;961;493;468;2019
17;Girona;047;Castelló d'Empúries;10906;5508;5398;2019
17;Girona;048;Castell-Platja d'Aro;10860;5357;5503;2019
17;Girona;189;Cellera de Ter, La;1946;965;981;2019
17;Girona;049;Celrà;5452;2722;2730;2019
17;Girona;050;Cervià de Ter;968;492;476;2019
17;Girona;051;Cistella;282;138;144;2019
17;Girona;054;Colera;448;223;225;2019
17;Girona;055;Colomers;176;87;89;2019
17;Girona;057;Corçà;1267;646;621;2019
17;Girona;056;Cornellà del Terri;2364;1197;1167;2019
17;Girona;058;Crespià;246;127;119;2019
17;Girona;901;Cruïlles, Monells i Sant Sadurní de l'Heura;1279;640;639;2019
17;Girona;060;Darnius;546;273;273;2019
17;Girona;061;Das;253;131;122;2019
17;Girona;062;Escala, L';10339;5267;5072;2019
17;Girona;063;Espinelves;215;110;105;2019
17;Girona;064;Espolla;416;203;213;2019
17;Girona;065;Esponellà;438;224;214;2019
17;Girona;005;Far d'Empordà, El;599;305;294;2019
17;Girona;066;Figueres;46654;23092;23562;2019
17;Girona;067;Flaçà;1093;528;565;2019
17;Girona;068;Foixà;297;150;147;2019
17;Girona;069;Fontanals de Cerdanya;444;220;224;2019
17;Girona;070;Fontanilles;139;80;59;2019
17;Girona;071;Fontcoberta;1468;738;730;2019
17;Girona;902;Forallac;1687;828;859;2019
17;Girona;073;Fornells de la Selva;2650;1322;1328;2019
17;Girona;074;Fortià;763;389;374;2019
17;Girona;075;Garrigàs;437;231;206;2019
17;Girona;076;Garrigoles;162;84;78;2019
17;Girona;077;Garriguella;855;421;434;2019
17;Girona;078;Ger;448;222;226;2019
17;Girona;079;Girona;101852;48931;52921;2019
17;Girona;080;Gombrèn;188;96;92;2019
17;Girona;081;Gualta;397;229;168;2019
17;Girona;082;Guils de Cerdanya;537;288;249;2019
17;Girona;083;Hostalric;4221;2130;2091;2019
17;Girona;084;Isòvol;281;161;120;2019
17;Girona;085;Jafre;380;206;174;2019
17;Girona;086;Jonquera, La;3290;1637;1653;2019
17;Girona;087;Juià;323;174;149;2019
17;Girona;088;Lladó;818;398;420;2019
17;Girona;089;Llagostera;8453;4303;4150;2019
17;Girona;090;Llambilles;696;359;337;2019
17;Girona;091;Llanars;505;259;246;2019
17;Girona;092;Llançà;4836;2394;2442;2019
17;Girona;093;Llers;1239;617;622;2019
17;Girona;094;Llívia;1417;748;669;2019
17;Girona;095;Lloret de Mar;38373;19528;18845;2019
17;Girona;096;Llosses, Les;218;121;97;2019
17;Girona;102;Maçanet de Cabrenys;688;340;348;2019
17;Girona;103;Maçanet de la Selva;7006;3598;3408;2019
17;Girona;097;Madremanya;283;138;145;2019
17;Girona;098;Maià de Montcal;449;251;198;2019
17;Girona;100;Masarac;288;150;138;2019
17;Girona;101;Massanes;761;405;356;2019
17;Girona;099;Meranges;104;58;46;2019
17;Girona;105;Mieres;318;160;158;2019
17;Girona;106;Mollet de Peralada;189;96;93;2019
17;Girona;107;Molló;337;162;175;2019
17;Girona;109;Montagut i Oix;916;475;441;2019
17;Girona;110;Mont-ras;1679;846;833;2019
17;Girona;111;Navata;1381;671;710;2019
17;Girona;112;Ogassa;234;130;104;2019
17;Girona;114;Olot;35228;17569;17659;2019
17;Girona;115;Ordis;371;199;172;2019
17;Girona;116;Osor;428;227;201;2019
17;Girona;117;Palafrugell;22974;11377;11597;2019
17;Girona;118;Palamós;17910;8766;9144;2019
17;Girona;119;Palau de Santa Eulàlia;91;52;39;2019
17;Girona;121;Palau-sator;310;166;144;2019
17;Girona;120;Palau-saverdera;1476;741;735;2019
17;Girona;123;Palol de Revardit;455;228;227;2019
17;Girona;124;Pals;2411;1222;1189;2019
17;Girona;125;Pardines;162;89;73;2019
17;Girona;126;Parlavà;394;199;195;2019
17;Girona;128;Pau;560;285;275;2019
17;Girona;129;Pedret i Marzà;198;101;97;2019
17;Girona;130;Pera, La;446;221;225;2019
17;Girona;132;Peralada;1850;906;944;2019
17;Girona;133;Planes d'Hostoles, Les;1683;851;832;2019
17;Girona;134;Planoles;288;157;131;2019
17;Girona;135;Pont de Molins;529;267;262;2019
17;Girona;136;Pontós;266;141;125;2019
17;Girona;137;Porqueres;4621;2288;2333;2019
17;Girona;140;Port de la Selva, El;970;501;469;2019
17;Girona;138;Portbou;1075;528;547;2019
17;Girona;139;Preses, Les;1788;890;898;2019
17;Girona;141;Puigcerdà;9258;4585;4673;2019
17;Girona;142;Quart;3724;1855;1869;2019
17;Girona;043;Queralbs;191;104;87;2019
17;Girona;143;Rabós;178;89;89;2019
17;Girona;144;Regencós;269;141;128;2019
17;Girona;145;Ribes de Freser;1754;882;872;2019
17;Girona;146;Riells i Viabrea;4124;2113;2011;2019
17;Girona;147;Ripoll;10686;5273;5413;2019
17;Girona;148;Riudarenes;2182;1125;1057;2019
17;Girona;149;Riudaura;478;232;246;2019
17;Girona;150;Riudellots de la Selva;2076;1053;1023;2019
17;Girona;151;Riumors;258;126;132;2019
17;Girona;152;Roses;19550;9862;9688;2019
17;Girona;153;Rupià;272;138;134;2019
17;Girona;154;Sales de Llierca;154;77;77;2019
17;Girona;155;Salt;31362;16454;14908;2019
17;Girona;157;Sant Andreu Salou;155;79;76;2019
17;Girona;183;Sant Aniol de Finestres;341;177;164;2019
17;Girona;158;Sant Climent Sescebes;626;364;262;2019
17;Girona;159;Sant Feliu de Buixalleu;783;410;373;2019
17;Girona;160;Sant Feliu de Guíxols;21925;10802;11123;2019
17;Girona;161;Sant Feliu de Pallerols;1371;667;704;2019
17;Girona;162;Sant Ferriol;243;124;119;2019
17;Girona;163;Sant Gregori;3817;1959;1858;2019
17;Girona;164;Sant Hilari Sacalm;5627;2843;2784;2019
17;Girona;165;Sant Jaume de Llierca;865;416;449;2019
17;Girona;167;Sant Joan de les Abadesses;3232;1604;1628;2019
17;Girona;168;Sant Joan de Mollet;507;248;259;2019
17;Girona;185;Sant Joan les Fonts;3006;1541;1465;2019
17;Girona;166;Sant Jordi Desvalls;761;380;381;2019
17;Girona;169;Sant Julià de Ramis;3515;1780;1735;2019
17;Girona;903;Sant Julià del Llor i Bonmatí;1286;651;635;2019
17;Girona;171;Sant Llorenç de la Muga;264;135;129;2019
17;Girona;172;Sant Martí de Llémena;633;330;303;2019
17;Girona;173;Sant Martí Vell;252;131;121;2019
17;Girona;174;Sant Miquel de Campmajor;231;127;104;2019
17;Girona;175;Sant Miquel de Fluvià;764;397;367;2019
17;Girona;176;Sant Mori;177;90;87;2019
17;Girona;177;Sant Pau de Segúries;697;347;350;2019
17;Girona;178;Sant Pere Pescador;2042;1084;958;2019
17;Girona;180;Santa Coloma de Farners;13143;6621;6522;2019
17;Girona;181;Santa Cristina d'Aro;5223;2624;2599;2019
17;Girona;182;Santa Llogaia d'Àlguema;370;189;181;2019
17;Girona;184;Santa Pau;1565;792;773;2019
17;Girona;186;Sarrià de Ter;5170;2530;2640;2019
17;Girona;187;Saus, Camallera i Llampaies;837;424;413;2019
17;Girona;188;Selva de Mar, La;196;108;88;2019
17;Girona;190;Serinyà;1136;576;560;2019
17;Girona;191;Serra de Daró;221;122;99;2019
17;Girona;192;Setcases;177;98;79;2019
17;Girona;193;Sils;6093;3108;2985;2019
17;Girona;052;Siurana;168;84;84;2019
17;Girona;194;Susqueda;101;60;41;2019
17;Girona;195;Tallada d'Empordà, La;463;241;222;2019
17;Girona;196;Terrades;329;162;167;2019
17;Girona;197;Torrent;175;92;83;2019
17;Girona;198;Torroella de Fluvià;694;354;340;2019
17;Girona;199;Torroella de Montgrí;11645;5900;5745;2019
17;Girona;200;Tortellà;809;393;416;2019
17;Girona;201;Toses;171;102;69;2019
17;Girona;202;Tossa de Mar;5683;2861;2822;2019
17;Girona;204;Ullà;1153;632;521;2019
17;Girona;205;Ullastret;290;140;150;2019
17;Girona;203;Ultramort;223;118;105;2019
17;Girona;206;Urús;189;93;96;2019
17;Girona;014;Vajol, La;89;48;41;2019
17;Girona;208;Vall de Bianya, La;1264;639;625;2019
17;Girona;207;Vall d'en Bas, La;3072;1553;1519;2019
17;Girona;170;Vallfogona de Ripollès;206;109;97;2019
17;Girona;209;Vall-llobrega;899;446;453;2019
17;Girona;210;Ventalló;859;438;421;2019
17;Girona;211;Verges;1171;572;599;2019
17;Girona;212;Vidrà;167;83;84;2019
17;Girona;213;Vidreres;7797;4048;3749;2019
17;Girona;214;Vilabertran;979;489;490;2019
17;Girona;215;Vilablareix;2897;1438;1459;2019
17;Girona;217;Viladamat;468;241;227;2019
17;Girona;216;Viladasens;200;107;93;2019
17;Girona;218;Vilademuls;815;424;391;2019
17;Girona;220;Viladrau;1040;509;531;2019
17;Girona;221;Vilafant;5394;2636;2758;2019
17;Girona;223;Vilajuïga;1104;549;555;2019
17;Girona;224;Vilallonga de Ter;398;212;186;2019
17;Girona;225;Vilamacolum;348;193;155;2019
17;Girona;226;Vilamalla;1181;586;595;2019
17;Girona;227;Vilamaniscle;200;116;84;2019
17;Girona;228;Vilanant;392;197;195;2019
17;Girona;230;Vila-sacra;760;372;388;2019
17;Girona;222;Vilaür;157;81;76;2019
17;Girona;233;Vilobí d'Onyar;3291;1711;1580;2019
17;Girona;232;Vilopriu;202;107;95;2019
18;Granada;001;Agrón;274;134;140;2019
18;Granada;002;Alamedilla;574;288;286;2019
18;Granada;003;Albolote;18808;9304;9504;2019
18;Granada;004;Albondón;728;408;320;2019
18;Granada;005;Albuñán;406;208;198;2019
18;Granada;006;Albuñol;7233;3952;3281;2019
18;Granada;007;Albuñuelas;821;408;413;2019
18;Granada;010;Aldeire;615;322;293;2019
18;Granada;011;Alfacar;5400;2751;2649;2019
18;Granada;012;Algarinejo;2520;1290;1230;2019
18;Granada;013;Alhama de Granada;5979;3204;2775;2019
18;Granada;014;Alhendín;9349;4721;4628;2019
18;Granada;015;Alicún de Ortega;480;238;242;2019
18;Granada;016;Almegíjar;365;184;181;2019
18;Granada;017;Almuñécar;26514;13079;13435;2019
18;Granada;904;Alpujarra de la Sierra;989;563;426;2019
18;Granada;018;Alquife;601;304;297;2019
18;Granada;020;Arenas del Rey;666;366;300;2019
18;Granada;021;Armilla;24174;11987;12187;2019
18;Granada;022;Atarfe;18706;9320;9386;2019
18;Granada;023;Baza;20412;10137;10275;2019
18;Granada;024;Beas de Granada;977;519;458;2019
18;Granada;025;Beas de Guadix;329;169;160;2019
18;Granada;027;Benalúa;3318;1644;1674;2019
18;Granada;028;Benalúa de las Villas;1066;556;510;2019
18;Granada;029;Benamaurel;2293;1157;1136;2019
18;Granada;030;Bérchules;716;386;330;2019
18;Granada;032;Bubión;296;150;146;2019
18;Granada;033;Busquístar;289;149;140;2019
18;Granada;034;Cacín;569;289;280;2019
18;Granada;035;Cádiar;1453;766;687;2019
18;Granada;036;Cájar;5129;2468;2661;2019
18;Granada;114;Calahorra, La;673;343;330;2019
18;Granada;037;Calicasas;617;306;311;2019
18;Granada;038;Campotéjar;1237;631;606;2019
18;Granada;039;Caniles;4047;2076;1971;2019
18;Granada;040;Cáñar;350;190;160;2019
18;Granada;042;Capileira;554;277;277;2019
18;Granada;043;Carataunas;194;102;92;2019
18;Granada;044;Cástaras;249;145;104;2019
18;Granada;045;Castilléjar;1318;678;640;2019
18;Granada;046;Castril;2070;1076;994;2019
18;Granada;047;Cenes de la Vega;8002;3999;4003;2019
18;Granada;059;Chauchina;5565;2754;2811;2019
18;Granada;061;Chimeneas;1257;657;600;2019
18;Granada;062;Churriana de la Vega;15200;7531;7669;2019
18;Granada;048;Cijuela;3322;1700;1622;2019
18;Granada;049;Cogollos de Guadix;673;375;298;2019
18;Granada;050;Cogollos de la Vega;2031;1018;1013;2019
18;Granada;051;Colomera;1309;677;632;2019
18;Granada;053;Cortes de Baza;1869;931;938;2019
18;Granada;054;Cortes y Graena;996;528;468;2019
18;Granada;912;Cuevas del Campo;1735;873;862;2019
18;Granada;056;Cúllar;4129;2054;2075;2019
18;Granada;057;Cúllar Vega;7429;3779;3650;2019
18;Granada;063;Darro;1599;814;785;2019
18;Granada;064;Dehesas de Guadix;419;206;213;2019
18;Granada;065;Dehesas Viejas;705;363;342;2019
18;Granada;066;Deifontes;2627;1325;1302;2019
18;Granada;067;Diezma;764;402;362;2019
18;Granada;068;Dílar;2054;1032;1022;2019
18;Granada;069;Dólar;622;333;289;2019
18;Granada;915;Domingo Pérez de Granada;890;464;426;2019
18;Granada;070;Dúdar;330;173;157;2019
18;Granada;071;Dúrcal;7015;3482;3533;2019
18;Granada;072;Escúzar;791;408;383;2019
18;Granada;074;Ferreira;299;157;142;2019
18;Granada;076;Fonelas;978;505;473;2019
18;Granada;077;Fornes;555;280;275;2019
18;Granada;078;Freila;918;472;446;2019
18;Granada;079;Fuente Vaqueros;4406;2210;2196;2019
18;Granada;905;Gabias, Las;21115;10738;10377;2019
18;Granada;082;Galera;1075;541;534;2019
18;Granada;083;Gobernador;233;116;117;2019
18;Granada;084;Gójar;5795;2947;2848;2019
18;Granada;085;Gor;733;382;351;2019
18;Granada;086;Gorafe;381;195;186;2019
18;Granada;087;Granada;232462;107555;124907;2019
18;Granada;088;Guadahortuna;1935;992;943;2019
18;Granada;089;Guadix;18422;9120;9302;2019
18;Granada;906;Guájares, Los;1057;556;501;2019
18;Granada;093;Gualchos;5193;2794;2399;2019
18;Granada;094;Güéjar Sierra;2820;1516;1304;2019
18;Granada;095;Güevéjar;2595;1360;1235;2019
18;Granada;096;Huélago;403;208;195;2019
18;Granada;097;Huéneja;1184;667;517;2019
18;Granada;098;Huéscar;7253;3586;3667;2019
18;Granada;099;Huétor de Santillán;1877;964;913;2019
18;Granada;100;Huétor Tájar;10352;5204;5148;2019
18;Granada;101;Huétor Vega;12039;6043;5996;2019
18;Granada;102;Íllora;10054;5057;4997;2019
18;Granada;103;Ítrabo;988;496;492;2019
18;Granada;105;Iznalloz;5134;2641;2493;2019
18;Granada;106;Játar;614;339;275;2019
18;Granada;107;Jayena;1060;550;510;2019
18;Granada;108;Jérez del Marquesado;968;499;469;2019
18;Granada;109;Jete;919;492;427;2019
18;Granada;111;Jun;3833;1958;1875;2019
18;Granada;112;Juviles;153;76;77;2019
18;Granada;115;Láchar;3471;1782;1689;2019
18;Granada;116;Lanjarón;3507;1757;1750;2019
18;Granada;117;Lanteira;588;316;272;2019
18;Granada;119;Lecrín;2134;1076;1058;2019
18;Granada;120;Lentegí;326;169;157;2019
18;Granada;121;Lobras;145;75;70;2019
18;Granada;122;Loja;20342;10117;10225;2019
18;Granada;123;Lugros;323;171;152;2019
18;Granada;124;Lújar;488;263;225;2019
18;Granada;126;Malahá, La;1781;897;884;2019
18;Granada;127;Maracena;22116;10858;11258;2019
18;Granada;128;Marchal;417;196;221;2019
18;Granada;132;Moclín;3651;1821;1830;2019
18;Granada;133;Molvízar;2794;1426;1368;2019
18;Granada;134;Monachil;7939;4094;3845;2019
18;Granada;135;Montefrío;5433;2754;2679;2019
18;Granada;136;Montejícar;2113;1087;1026;2019
18;Granada;137;Montillana;1189;618;571;2019
18;Granada;138;Moraleda de Zafayona;3153;1596;1557;2019
18;Granada;909;Morelábor;607;329;278;2019
18;Granada;140;Motril;58020;28522;29498;2019
18;Granada;141;Murtas;467;265;202;2019
18;Granada;903;Nevada;1050;543;507;2019
18;Granada;143;Nigüelas;1173;594;579;2019
18;Granada;144;Nívar;994;519;475;2019
18;Granada;145;Ogíjares;14160;7008;7152;2019
18;Granada;146;Orce;1190;605;585;2019
18;Granada;147;Órgiva;5725;2872;2853;2019
18;Granada;148;Otívar;1034;524;510;2019
18;Granada;150;Padul;8420;4223;4197;2019
18;Granada;151;Pampaneira;321;156;165;2019
18;Granada;152;Pedro Martínez;1107;539;568;2019
18;Granada;153;Peligros;11394;5642;5752;2019
18;Granada;154;Peza, La;1178;600;578;2019
18;Granada;910;Pinar, El;877;460;417;2019
18;Granada;157;Pinos Genil;1457;758;699;2019
18;Granada;158;Pinos Puente;9930;4994;4936;2019
18;Granada;159;Píñar;1138;623;515;2019
18;Granada;161;Polícar;276;147;129;2019
18;Granada;162;Polopos;1756;976;780;2019
18;Granada;163;Pórtugos;382;197;185;2019
18;Granada;164;Puebla de Don Fadrique;2250;1142;1108;2019
18;Granada;165;Pulianas;5429;2696;2733;2019
18;Granada;167;Purullena;2293;1166;1127;2019
18;Granada;168;Quéntar;933;480;453;2019
18;Granada;170;Rubite;394;213;181;2019
18;Granada;171;Salar;2631;1319;1312;2019
18;Granada;173;Salobreña;12381;6161;6220;2019
18;Granada;174;Santa Cruz del Comercio;528;273;255;2019
18;Granada;175;Santa Fe;15157;7427;7730;2019
18;Granada;176;Soportújar;268;147;121;2019
18;Granada;177;Sorvilán;538;297;241;2019
18;Granada;901;Taha, La;653;337;316;2019
18;Granada;178;Torre-Cardela;736;393;343;2019
18;Granada;916;Torrenueva Costa;2682;1397;1285;2019
18;Granada;179;Torvizcón;648;349;299;2019
18;Granada;180;Trevélez;732;383;349;2019
18;Granada;181;Turón;239;142;97;2019
18;Granada;182;Ugíjar;2523;1253;1270;2019
18;Granada;914;Valderrubio;2086;1024;1062;2019
18;Granada;907;Valle del Zalabí;2128;1083;1045;2019
18;Granada;902;Valle, El;914;455;459;2019
18;Granada;183;Válor;675;347;328;2019
18;Granada;911;Vegas del Genil;11166;5704;5462;2019
18;Granada;184;Vélez de Benaudalla;2841;1414;1427;2019
18;Granada;185;Ventas de Huelma;640;350;290;2019
18;Granada;149;Villa de Otura;6952;3507;3445;2019
18;Granada;908;Villamena;948;479;469;2019
18;Granada;187;Villanueva de las Torres;582;311;271;2019
18;Granada;188;Villanueva Mesía;2021;994;1027;2019
18;Granada;189;Víznar;976;508;468;2019
18;Granada;192;Zafarraya;2137;1129;1008;2019
18;Granada;913;Zagra;834;420;414;2019
18;Granada;193;Zubia, La;19155;9460;9695;2019
18;Granada;194;Zújar;2548;1287;1261;2019
19;Guadalajara;001;Abánades;48;26;22;2019
19;Guadalajara;002;Ablanque;59;31;28;2019
19;Guadalajara;003;Adobes;29;16;13;2019
19;Guadalajara;004;Alaminos;60;28;32;2019
19;Guadalajara;005;Alarilla;163;104;59;2019
19;Guadalajara;006;Albalate de Zorita;943;520;423;2019
19;Guadalajara;007;Albares;513;264;249;2019
19;Guadalajara;008;Albendiego;49;30;19;2019
19;Guadalajara;009;Alcocer;313;157;156;2019
19;Guadalajara;010;Alcolea de las Peñas;13;8;5;2019
19;Guadalajara;011;Alcolea del Pinar;320;172;148;2019
19;Guadalajara;013;Alcoroches;126;79;47;2019
19;Guadalajara;015;Aldeanueva de Guadalajara;86;51;35;2019
19;Guadalajara;016;Algar de Mesa;55;39;16;2019
19;Guadalajara;017;Algora;70;45;25;2019
19;Guadalajara;018;Alhóndiga;157;91;66;2019
19;Guadalajara;019;Alique;14;7;7;2019
19;Guadalajara;020;Almadrones;57;38;19;2019
19;Guadalajara;021;Almoguera;1289;667;622;2019
19;Guadalajara;022;Almonacid de Zorita;685;344;341;2019
19;Guadalajara;023;Alocén;172;84;88;2019
19;Guadalajara;024;Alovera;12735;6498;6237;2019
19;Guadalajara;027;Alustante;153;90;63;2019
19;Guadalajara;031;Angón;10;8;2;2019
19;Guadalajara;032;Anguita;156;79;77;2019
19;Guadalajara;033;Anquela del Ducado;50;31;19;2019
19;Guadalajara;034;Anquela del Pedregal;24;16;8;2019
19;Guadalajara;036;Aranzueque;380;204;176;2019
19;Guadalajara;037;Arbancón;150;89;61;2019
19;Guadalajara;038;Arbeteta;22;17;5;2019
19;Guadalajara;039;Argecilla;64;44;20;2019
19;Guadalajara;040;Armallones;59;32;27;2019
19;Guadalajara;041;Armuña de Tajuña;246;134;112;2019
19;Guadalajara;042;Arroyo de las Fraguas;22;12;10;2019
19;Guadalajara;043;Atanzón;100;66;34;2019
19;Guadalajara;044;Atienza;405;228;177;2019
19;Guadalajara;045;Auñón;142;80;62;2019
19;Guadalajara;046;Azuqueca de Henares;35009;17744;17265;2019
19;Guadalajara;047;Baides;56;29;27;2019
19;Guadalajara;048;Baños de Tajo;19;14;5;2019
19;Guadalajara;049;Bañuelos;14;12;2;2019
19;Guadalajara;050;Barriopedro;15;11;4;2019
19;Guadalajara;051;Berninches;49;32;17;2019
19;Guadalajara;052;Bodera, La;22;14;8;2019
19;Guadalajara;053;Brihuega;2410;1247;1163;2019
19;Guadalajara;054;Budia;196;116;80;2019
19;Guadalajara;055;Bujalaro;47;22;25;2019
19;Guadalajara;057;Bustares;79;49;30;2019
19;Guadalajara;058;Cabanillas del Campo;10442;5274;5168;2019
19;Guadalajara;059;Campillo de Dueñas;78;45;33;2019
19;Guadalajara;060;Campillo de Ranas;171;105;66;2019
19;Guadalajara;061;Campisábalos;57;44;13;2019
19;Guadalajara;064;Canredondo;67;44;23;2019
19;Guadalajara;065;Cantalojas;151;90;61;2019
19;Guadalajara;066;Cañizar;54;31;23;2019
19;Guadalajara;067;Cardoso de la Sierra, El;60;37;23;2019
19;Guadalajara;070;Casa de Uceda;89;48;41;2019
19;Guadalajara;071;Casar, El;12062;6120;5942;2019
19;Guadalajara;073;Casas de San Galindo;16;13;3;2019
19;Guadalajara;074;Caspueñas;81;49;32;2019
19;Guadalajara;075;Castejón de Henares;65;40;25;2019
19;Guadalajara;076;Castellar de la Muela;22;13;9;2019
19;Guadalajara;078;Castilforte;55;36;19;2019
19;Guadalajara;079;Castilnuevo;8;5;3;2019
19;Guadalajara;080;Cendejas de Enmedio;72;39;33;2019
19;Guadalajara;081;Cendejas de la Torre;24;16;8;2019
19;Guadalajara;082;Centenera;117;64;53;2019
19;Guadalajara;103;Checa;282;172;110;2019
19;Guadalajara;104;Chequilla;18;9;9;2019
19;Guadalajara;106;Chillarón del Rey;88;49;39;2019
19;Guadalajara;105;Chiloeches;3579;1862;1717;2019
19;Guadalajara;086;Cifuentes;1645;851;794;2019
19;Guadalajara;087;Cincovillas;22;10;12;2019
19;Guadalajara;088;Ciruelas;122;68;54;2019
19;Guadalajara;089;Ciruelos del Pinar;29;18;11;2019
19;Guadalajara;090;Cobeta;114;58;56;2019
19;Guadalajara;091;Cogollor;25;16;9;2019
19;Guadalajara;092;Cogolludo;540;314;226;2019
19;Guadalajara;095;Condemios de Abajo;14;9;5;2019
19;Guadalajara;096;Condemios de Arriba;123;69;54;2019
19;Guadalajara;097;Congostrina;17;13;4;2019
19;Guadalajara;098;Copernal;28;18;10;2019
19;Guadalajara;099;Corduente;349;191;158;2019
19;Guadalajara;102;Cubillo de Uceda, El;121;65;56;2019
19;Guadalajara;107;Driebes;366;198;168;2019
19;Guadalajara;108;Durón;106;56;50;2019
19;Guadalajara;109;Embid;33;18;15;2019
19;Guadalajara;110;Escamilla;63;35;28;2019
19;Guadalajara;111;Escariche;185;113;72;2019
19;Guadalajara;112;Escopete;57;24;33;2019
19;Guadalajara;113;Espinosa de Henares;628;325;303;2019
19;Guadalajara;114;Esplegares;38;23;15;2019
19;Guadalajara;115;Establés;37;24;13;2019
19;Guadalajara;116;Estriégana;14;9;5;2019
19;Guadalajara;117;Fontanar;2370;1237;1133;2019
19;Guadalajara;118;Fuembellida;10;7;3;2019
19;Guadalajara;119;Fuencemillán;86;56;30;2019
19;Guadalajara;120;Fuentelahiguera de Albatages;136;77;59;2019
19;Guadalajara;121;Fuentelencina;325;176;149;2019
19;Guadalajara;122;Fuentelsaz;94;51;43;2019
19;Guadalajara;123;Fuentelviejo;46;25;21;2019
19;Guadalajara;124;Fuentenovilla;517;286;231;2019
19;Guadalajara;125;Gajanejos;47;32;15;2019
19;Guadalajara;126;Galápagos;2403;1264;1139;2019
19;Guadalajara;127;Galve de Sorbe;100;55;45;2019
19;Guadalajara;129;Gascueña de Bornova;28;16;12;2019
19;Guadalajara;130;Guadalajara;85871;41272;44599;2019
19;Guadalajara;132;Henche;104;57;47;2019
19;Guadalajara;133;Heras de Ayuso;270;164;106;2019
19;Guadalajara;134;Herrería;30;15;15;2019
19;Guadalajara;135;Hiendelaencina;115;68;47;2019
19;Guadalajara;136;Hijes;19;10;9;2019
19;Guadalajara;138;Hita;294;162;132;2019
19;Guadalajara;139;Hombrados;33;22;11;2019
19;Guadalajara;142;Hontoba;318;180;138;2019
19;Guadalajara;143;Horche;2535;1285;1250;2019
19;Guadalajara;145;Hortezuela de Océn;42;26;16;2019
19;Guadalajara;146;Huerce, La;51;32;19;2019
19;Guadalajara;147;Huérmeces del Cerro;42;30;12;2019
19;Guadalajara;148;Huertahernando;53;34;19;2019
19;Guadalajara;150;Hueva;143;89;54;2019
19;Guadalajara;151;Humanes;1496;751;745;2019
19;Guadalajara;152;Illana;686;377;309;2019
19;Guadalajara;153;Iniéstola;22;14;8;2019
19;Guadalajara;154;Inviernas, Las;59;40;19;2019
19;Guadalajara;155;Irueste;68;46;22;2019
19;Guadalajara;156;Jadraque;1413;743;670;2019
19;Guadalajara;157;Jirueque;59;41;18;2019
19;Guadalajara;159;Ledanca;98;50;48;2019
19;Guadalajara;160;Loranca de Tajuña;1249;681;568;2019
19;Guadalajara;161;Lupiana;257;135;122;2019
19;Guadalajara;162;Luzaga;69;38;31;2019
19;Guadalajara;163;Luzón;68;33;35;2019
19;Guadalajara;165;Majaelrayo;51;29;22;2019
19;Guadalajara;166;Málaga del Fresno;180;97;83;2019
19;Guadalajara;167;Malaguilla;152;82;70;2019
19;Guadalajara;168;Mandayona;294;143;151;2019
19;Guadalajara;169;Mantiel;34;22;12;2019
19;Guadalajara;170;Maranchón;229;121;108;2019
19;Guadalajara;171;Marchamalo;7474;3723;3751;2019
19;Guadalajara;172;Masegoso de Tajuña;52;29;23;2019
19;Guadalajara;173;Matarrubia;70;43;27;2019
19;Guadalajara;174;Matillas;105;58;47;2019
19;Guadalajara;175;Mazarete;38;18;20;2019
19;Guadalajara;176;Mazuecos;268;148;120;2019
19;Guadalajara;177;Medranda;66;36;30;2019
19;Guadalajara;178;Megina;32;18;14;2019
19;Guadalajara;179;Membrillera;98;54;44;2019
19;Guadalajara;181;Miedes de Atienza;59;37;22;2019
19;Guadalajara;182;Mierla, La;41;28;13;2019
19;Guadalajara;184;Millana;110;67;43;2019
19;Guadalajara;183;Milmarcos;73;47;26;2019
19;Guadalajara;185;Miñosa, La;28;19;9;2019
19;Guadalajara;186;Mirabueno;80;49;31;2019
19;Guadalajara;187;Miralrío;51;29;22;2019
19;Guadalajara;188;Mochales;46;25;21;2019
19;Guadalajara;189;Mohernando;173;85;88;2019
19;Guadalajara;190;Molina de Aragón;3275;1636;1639;2019
19;Guadalajara;191;Monasterio;14;6;8;2019
19;Guadalajara;192;Mondéjar;2645;1362;1283;2019
19;Guadalajara;193;Montarrón;23;14;9;2019
19;Guadalajara;194;Moratilla de los Meleros;103;57;46;2019
19;Guadalajara;195;Morenilla;38;23;15;2019
19;Guadalajara;196;Muduex;100;54;46;2019
19;Guadalajara;197;Navas de Jadraque, Las;27;18;9;2019
19;Guadalajara;198;Negredo;17;9;8;2019
19;Guadalajara;199;Ocentejo;21;15;6;2019
19;Guadalajara;200;Olivar, El;71;41;30;2019
19;Guadalajara;201;Olmeda de Cobeta;66;36;30;2019
19;Guadalajara;202;Olmeda de Jadraque, La;17;10;7;2019
19;Guadalajara;203;Ordial, El;29;17;12;2019
19;Guadalajara;204;Orea;180;107;73;2019
19;Guadalajara;208;Pálmaces de Jadraque;41;26;15;2019
19;Guadalajara;209;Pardos;43;24;19;2019
19;Guadalajara;210;Paredes de Sigüenza;19;9;10;2019
19;Guadalajara;211;Pareja;393;235;158;2019
19;Guadalajara;212;Pastrana;850;435;415;2019
19;Guadalajara;213;Pedregal, El;74;47;27;2019
19;Guadalajara;214;Peñalén;73;43;30;2019
19;Guadalajara;215;Peñalver;144;94;50;2019
19;Guadalajara;216;Peralejos de las Truchas;143;76;67;2019
19;Guadalajara;217;Peralveche;45;29;16;2019
19;Guadalajara;218;Pinilla de Jadraque;50;27;23;2019
19;Guadalajara;219;Pinilla de Molina;10;8;2;2019
19;Guadalajara;220;Pioz;4052;2117;1935;2019
19;Guadalajara;221;Piqueras;55;37;18;2019
19;Guadalajara;222;Pobo de Dueñas, El;109;56;53;2019
19;Guadalajara;223;Poveda de la Sierra;114;59;55;2019
19;Guadalajara;224;Pozo de Almoguera;105;65;40;2019
19;Guadalajara;225;Pozo de Guadalajara;1303;691;612;2019
19;Guadalajara;226;Prádena de Atienza;49;35;14;2019
19;Guadalajara;227;Prados Redondos;73;48;25;2019
19;Guadalajara;228;Puebla de Beleña;40;24;16;2019
19;Guadalajara;229;Puebla de Valles;58;32;26;2019
19;Guadalajara;230;Quer;814;423;391;2019
19;Guadalajara;231;Rebollosa de Jadraque;11;7;4;2019
19;Guadalajara;232;Recuenco, El;58;37;21;2019
19;Guadalajara;233;Renera;90;55;35;2019
19;Guadalajara;234;Retiendas;48;33;15;2019
19;Guadalajara;235;Riba de Saelices;105;63;42;2019
19;Guadalajara;237;Rillo de Gallo;43;25;18;2019
19;Guadalajara;238;Riofrío del Llano;55;31;24;2019
19;Guadalajara;239;Robledillo de Mohernando;115;60;55;2019
19;Guadalajara;240;Robledo de Corpes;52;30;22;2019
19;Guadalajara;241;Romanillos de Atienza;36;24;12;2019
19;Guadalajara;242;Romanones;99;50;49;2019
19;Guadalajara;243;Rueda de la Sierra;38;28;10;2019
19;Guadalajara;244;Sacecorbo;91;50;41;2019
19;Guadalajara;245;Sacedón;1533;790;743;2019
19;Guadalajara;246;Saelices de la Sal;43;23;20;2019
19;Guadalajara;247;Salmerón;157;89;68;2019
19;Guadalajara;248;San Andrés del Congosto;76;48;28;2019
19;Guadalajara;249;San Andrés del Rey;29;16;13;2019
19;Guadalajara;250;Santiuste;14;8;6;2019
19;Guadalajara;251;Saúca;52;31;21;2019
19;Guadalajara;252;Sayatón;78;46;32;2019
19;Guadalajara;254;Selas;46;23;23;2019
19;Guadalajara;901;Semillas;36;21;15;2019
19;Guadalajara;255;Setiles;80;47;33;2019
19;Guadalajara;256;Sienes;50;29;21;2019
19;Guadalajara;257;Sigüenza;4309;2157;2152;2019
19;Guadalajara;258;Solanillos del Extremo;91;53;38;2019
19;Guadalajara;259;Somolinos;30;15;15;2019
19;Guadalajara;260;Sotillo, El;42;22;20;2019
19;Guadalajara;261;Sotodosos;33;17;16;2019
19;Guadalajara;262;Tamajón;126;71;55;2019
19;Guadalajara;263;Taragudo;49;28;21;2019
19;Guadalajara;264;Taravilla;38;26;12;2019
19;Guadalajara;265;Tartanedo;140;81;59;2019
19;Guadalajara;266;Tendilla;307;170;137;2019
19;Guadalajara;267;Terzaga;23;13;10;2019
19;Guadalajara;268;Tierzo;49;30;19;2019
19;Guadalajara;269;Toba, La;96;57;39;2019
19;Guadalajara;271;Tordellego;48;27;21;2019
19;Guadalajara;270;Tordelrábano;26;19;7;2019
19;Guadalajara;272;Tordesilos;92;50;42;2019
19;Guadalajara;274;Torija;1448;756;692;2019
19;Guadalajara;279;Torre del Burgo;592;314;278;2019
19;Guadalajara;277;Torrecuadrada de Molina;18;13;5;2019
19;Guadalajara;278;Torrecuadradilla;24;14;10;2019
19;Guadalajara;280;Torrejón del Rey;5434;2833;2601;2019
19;Guadalajara;281;Torremocha de Jadraque;21;11;10;2019
19;Guadalajara;282;Torremocha del Campo;166;94;72;2019
19;Guadalajara;283;Torremocha del Pinar;40;19;21;2019
19;Guadalajara;284;Torremochuela;10;7;3;2019
19;Guadalajara;285;Torrubia;19;11;8;2019
19;Guadalajara;286;Tórtola de Henares;1044;571;473;2019
19;Guadalajara;287;Tortuera;194;103;91;2019
19;Guadalajara;288;Tortuero;18;13;5;2019
19;Guadalajara;289;Traíd;23;15;8;2019
19;Guadalajara;290;Trijueque;1201;636;565;2019
19;Guadalajara;291;Trillo;1319;690;629;2019
19;Guadalajara;293;Uceda;2616;1358;1258;2019
19;Guadalajara;294;Ujados;28;16;12;2019
19;Guadalajara;296;Utande;31;23;8;2019
19;Guadalajara;297;Valdarachas;40;20;20;2019
19;Guadalajara;298;Valdearenas;76;52;24;2019
19;Guadalajara;299;Valdeavellano;114;62;52;2019
19;Guadalajara;300;Valdeaveruelo;1072;558;514;2019
19;Guadalajara;301;Valdeconcha;40;22;18;2019
19;Guadalajara;302;Valdegrudas;56;35;21;2019
19;Guadalajara;303;Valdelcubo;45;31;14;2019
19;Guadalajara;304;Valdenuño Fernández;257;140;117;2019
19;Guadalajara;305;Valdepeñas de la Sierra;152;90;62;2019
19;Guadalajara;306;Valderrebollo;23;12;11;2019
19;Guadalajara;307;Valdesotos;26;17;9;2019
19;Guadalajara;308;Valfermoso de Tajuña;60;41;19;2019
19;Guadalajara;309;Valhermoso;23;12;11;2019
19;Guadalajara;310;Valtablado del Río;7;4;3;2019
19;Guadalajara;311;Valverde de los Arroyos;94;48;46;2019
19;Guadalajara;314;Viana de Jadraque;46;32;14;2019
19;Guadalajara;317;Villanueva de Alcorón;149;82;67;2019
19;Guadalajara;318;Villanueva de Argecilla;31;19;12;2019
19;Guadalajara;319;Villanueva de la Torre;6573;3308;3265;2019
19;Guadalajara;321;Villares de Jadraque;45;28;17;2019
19;Guadalajara;322;Villaseca de Henares;27;13;14;2019
19;Guadalajara;323;Villaseca de Uceda;39;21;18;2019
19;Guadalajara;324;Villel de Mesa;182;102;80;2019
19;Guadalajara;325;Viñuelas;148;75;73;2019
19;Guadalajara;326;Yebes;3791;1957;1834;2019
19;Guadalajara;327;Yebra;444;240;204;2019
19;Guadalajara;329;Yélamos de Abajo;71;39;32;2019
19;Guadalajara;330;Yélamos de Arriba;78;47;31;2019
19;Guadalajara;331;Yunquera de Henares;4044;2052;1992;2019
19;Guadalajara;332;Yunta, La;89;53;36;2019
19;Guadalajara;333;Zaorejas;116;77;39;2019
19;Guadalajara;334;Zarzuela de Jadraque;44;27;17;2019
19;Guadalajara;335;Zorita de los Canes;78;43;35;2019
21;Huelva;001;Alájar;756;386;370;2019
21;Huelva;002;Aljaraque;21260;10594;10666;2019
21;Huelva;003;Almendro, El;826;438;388;2019
21;Huelva;004;Almonaster la Real;1819;978;841;2019
21;Huelva;005;Almonte;24191;11686;12505;2019
21;Huelva;006;Alosno;3923;1929;1994;2019
21;Huelva;007;Aracena;8107;3984;4123;2019
21;Huelva;008;Aroche;3073;1528;1545;2019
21;Huelva;009;Arroyomolinos de León;953;493;460;2019
21;Huelva;010;Ayamonte;20946;10492;10454;2019
21;Huelva;011;Beas;4257;2136;2121;2019
21;Huelva;012;Berrocal;312;157;155;2019
21;Huelva;013;Bollullos Par del Condado;14272;7092;7180;2019
21;Huelva;014;Bonares;6058;3012;3046;2019
21;Huelva;015;Cabezas Rubias;730;383;347;2019
21;Huelva;016;Cala;1167;587;580;2019
21;Huelva;017;Calañas;2791;1422;1369;2019
21;Huelva;018;Campillo, El;2023;980;1043;2019
21;Huelva;019;Campofrío;675;343;332;2019
21;Huelva;020;Cañaveral de León;403;205;198;2019
21;Huelva;021;Cartaya;19974;10228;9746;2019
21;Huelva;022;Castaño del Robledo;223;121;102;2019
21;Huelva;023;Cerro de Andévalo, El;2364;1167;1197;2019
21;Huelva;030;Chucena;2222;1131;1091;2019
21;Huelva;024;Corteconcepción;548;287;261;2019
21;Huelva;025;Cortegana;4666;2368;2298;2019
21;Huelva;026;Cortelazor;299;140;159;2019
21;Huelva;027;Cumbres de Enmedio;56;34;22;2019
21;Huelva;028;Cumbres de San Bartolomé;381;186;195;2019
21;Huelva;029;Cumbres Mayores;1755;871;884;2019
21;Huelva;031;Encinasola;1305;655;650;2019
21;Huelva;032;Escacena del Campo;2284;1112;1172;2019
21;Huelva;033;Fuenteheridos;678;338;340;2019
21;Huelva;034;Galaroza;1379;681;698;2019
21;Huelva;035;Gibraleón;12607;6274;6333;2019
21;Huelva;036;Granada de Río-Tinto, La;239;124;115;2019
21;Huelva;037;Granado, El;516;274;242;2019
21;Huelva;038;Higuera de la Sierra;1287;666;621;2019
21;Huelva;039;Hinojales;325;163;162;2019
21;Huelva;040;Hinojos;3976;1994;1982;2019
21;Huelva;041;Huelva;143663;69003;74660;2019
21;Huelva;042;Isla Cristina;21264;10639;10625;2019
21;Huelva;043;Jabugo;2250;1132;1118;2019
21;Huelva;044;Lepe;27431;14027;13404;2019
21;Huelva;045;Linares de la Sierra;263;127;136;2019
21;Huelva;046;Lucena del Puerto;3371;1757;1614;2019
21;Huelva;047;Manzanilla;2135;1092;1043;2019
21;Huelva;048;Marines, Los;396;212;184;2019
21;Huelva;049;Minas de Riotinto;3848;1866;1982;2019
21;Huelva;050;Moguer;22088;11022;11066;2019
21;Huelva;051;Nava, La;266;137;129;2019
21;Huelva;052;Nerva;5235;2517;2718;2019
21;Huelva;053;Niebla;4117;2074;2043;2019
21;Huelva;054;Palma del Condado, La;10761;5361;5400;2019
21;Huelva;055;Palos de la Frontera;11289;5737;5552;2019
21;Huelva;056;Paterna del Campo;3509;1784;1725;2019
21;Huelva;057;Paymogo;1159;583;576;2019
21;Huelva;058;Puebla de Guzmán;3073;1581;1492;2019
21;Huelva;059;Puerto Moral;282;136;146;2019
21;Huelva;060;Punta Umbría;15242;7764;7478;2019
21;Huelva;061;Rociana del Condado;7855;3944;3911;2019
21;Huelva;062;Rosal de la Frontera;1697;842;855;2019
21;Huelva;063;San Bartolomé de la Torre;3736;1864;1872;2019
21;Huelva;064;San Juan del Puerto;9300;4674;4626;2019
21;Huelva;066;San Silvestre de Guzmán;623;326;297;2019
21;Huelva;065;Sanlúcar de Guadiana;409;203;206;2019
21;Huelva;067;Santa Ana la Real;476;222;254;2019
21;Huelva;068;Santa Bárbara de Casa;1035;511;524;2019
21;Huelva;069;Santa Olalla del Cala;2001;1035;966;2019
21;Huelva;070;Trigueros;7713;3849;3864;2019
21;Huelva;071;Valdelarco;239;112;127;2019
21;Huelva;072;Valverde del Camino;12820;6311;6509;2019
21;Huelva;073;Villablanca;2848;1389;1459;2019
21;Huelva;074;Villalba del Alcor;3338;1644;1694;2019
21;Huelva;075;Villanueva de las Cruces;373;176;197;2019
21;Huelva;076;Villanueva de los Castillejos;2820;1411;1409;2019
21;Huelva;077;Villarrasa;2176;1103;1073;2019
21;Huelva;078;Zalamea la Real;3068;1545;1523;2019
21;Huelva;902;Zarza-Perrunal, La;1267;640;627;2019
21;Huelva;079;Zufre;808;422;386;2019
22;Huesca;001;Abiego;248;130;118;2019
22;Huesca;002;Abizanda;150;76;74;2019
22;Huesca;003;Adahuesca;177;96;81;2019
22;Huesca;004;Agüero;129;76;53;2019
22;Huesca;907;Aínsa-Sobrarbe;2201;1120;1081;2019
22;Huesca;006;Aisa;320;176;144;2019
22;Huesca;007;Albalate de Cinca;1103;592;511;2019
22;Huesca;008;Albalatillo;176;93;83;2019
22;Huesca;009;Albelda;698;364;334;2019
22;Huesca;011;Albero Alto;117;67;50;2019
22;Huesca;012;Albero Bajo;135;72;63;2019
22;Huesca;013;Alberuela de Tubo;301;151;150;2019
22;Huesca;014;Alcalá de Gurrea;248;131;117;2019
22;Huesca;015;Alcalá del Obispo;318;173;145;2019
22;Huesca;016;Alcampell;631;310;321;2019
22;Huesca;017;Alcolea de Cinca;1155;622;533;2019
22;Huesca;018;Alcubierre;360;196;164;2019
22;Huesca;019;Alerre;199;101;98;2019
22;Huesca;020;Alfántega;130;66;64;2019
22;Huesca;021;Almudévar;2379;1214;1165;2019
22;Huesca;022;Almunia de San Juan;658;339;319;2019
22;Huesca;023;Almuniente;460;238;222;2019
22;Huesca;024;Alquézar;303;164;139;2019
22;Huesca;025;Altorricón;1417;756;661;2019
22;Huesca;027;Angüés;354;189;165;2019
22;Huesca;028;Ansó;405;204;201;2019
22;Huesca;029;Antillón;140;70;70;2019
22;Huesca;032;Aragüés del Puerto;115;65;50;2019
22;Huesca;035;Arén;313;172;141;2019
22;Huesca;036;Argavieso;95;56;39;2019
22;Huesca;037;Arguis;127;72;55;2019
22;Huesca;039;Ayerbe;1009;500;509;2019
22;Huesca;040;Azanuy-Alins;168;80;88;2019
22;Huesca;041;Azara;171;86;85;2019
22;Huesca;042;Azlor;143;65;78;2019
22;Huesca;043;Baélls;104;59;45;2019
22;Huesca;044;Bailo;267;160;107;2019
22;Huesca;045;Baldellou;76;44;32;2019
22;Huesca;046;Ballobar;812;423;389;2019
22;Huesca;047;Banastás;295;153;142;2019
22;Huesca;048;Barbastro;16979;8256;8723;2019
22;Huesca;049;Barbués;78;47;31;2019
22;Huesca;050;Barbuñales;96;48;48;2019
22;Huesca;051;Bárcabo;103;57;46;2019
22;Huesca;052;Belver de Cinca;1275;742;533;2019
22;Huesca;053;Benabarre;1124;590;534;2019
22;Huesca;054;Benasque;2155;1151;1004;2019
22;Huesca;246;Beranuy;82;49;33;2019
22;Huesca;055;Berbegal;347;178;169;2019
22;Huesca;057;Bielsa;457;242;215;2019
22;Huesca;058;Bierge;239;132;107;2019
22;Huesca;059;Biescas;1463;768;695;2019
22;Huesca;060;Binaced;1575;852;723;2019
22;Huesca;061;Binéfar;9561;5003;4558;2019
22;Huesca;062;Bisaurri;167;90;77;2019
22;Huesca;063;Biscarrués;182;97;85;2019
22;Huesca;064;Blecua y Torres;182;106;76;2019
22;Huesca;066;Boltaña;1016;546;470;2019
22;Huesca;067;Bonansa;88;50;38;2019
22;Huesca;068;Borau;74;43;31;2019
22;Huesca;069;Broto;522;292;230;2019
22;Huesca;072;Caldearenas;229;136;93;2019
22;Huesca;074;Campo;278;149;129;2019
22;Huesca;075;Camporrélls;134;71;63;2019
22;Huesca;076;Canal de Berdún;314;176;138;2019
22;Huesca;077;Candasnos;462;255;207;2019
22;Huesca;078;Canfranc;540;300;240;2019
22;Huesca;079;Capdesaso;198;83;115;2019
22;Huesca;080;Capella;349;182;167;2019
22;Huesca;081;Casbas de Huesca;270;146;124;2019
22;Huesca;083;Castejón de Monegros;522;283;239;2019
22;Huesca;084;Castejón de Sos;747;381;366;2019
22;Huesca;082;Castejón del Puente;318;167;151;2019
22;Huesca;085;Castelflorite;106;54;52;2019
22;Huesca;086;Castiello de Jaca;243;136;107;2019
22;Huesca;087;Castigaleu;84;51;33;2019
22;Huesca;088;Castillazuelo;162;80;82;2019
22;Huesca;089;Castillonroy;313;164;149;2019
22;Huesca;094;Chalamera;106;56;50;2019
22;Huesca;095;Chía;83;54;29;2019
22;Huesca;096;Chimillas;393;200;193;2019
22;Huesca;090;Colungo;110;62;48;2019
22;Huesca;099;Esplús;581;290;291;2019
22;Huesca;102;Estada;208;122;86;2019
22;Huesca;103;Estadilla;800;385;415;2019
22;Huesca;105;Estopiñán del Castillo;120;65;55;2019
22;Huesca;106;Fago;22;12;10;2019
22;Huesca;107;Fanlo;101;63;38;2019
22;Huesca;109;Fiscal;330;182;148;2019
22;Huesca;110;Fonz;859;434;425;2019
22;Huesca;111;Foradada del Toscar;172;91;81;2019
22;Huesca;112;Fraga;15033;7643;7390;2019
22;Huesca;113;Fueva, La;587;312;275;2019
22;Huesca;114;Gistaín;142;75;67;2019
22;Huesca;115;Grado, El;400;210;190;2019
22;Huesca;116;Grañén;1762;913;849;2019
22;Huesca;117;Graus;3395;1666;1729;2019
22;Huesca;119;Gurrea de Gállego;1467;744;723;2019
22;Huesca;122;Hoz de Jaca;70;35;35;2019
22;Huesca;908;Hoz y Costean;223;129;94;2019
22;Huesca;124;Huerto;206;112;94;2019
22;Huesca;125;Huesca;53132;25352;27780;2019
22;Huesca;126;Ibieca;96;55;41;2019
22;Huesca;127;Igriés;723;382;341;2019
22;Huesca;128;Ilche;211;104;107;2019
22;Huesca;129;Isábena;235;119;116;2019
22;Huesca;130;Jaca;12988;6357;6631;2019
22;Huesca;131;Jasa;92;52;40;2019
22;Huesca;133;Labuerda;162;87;75;2019
22;Huesca;135;Laluenga;197;103;94;2019
22;Huesca;136;Lalueza;892;465;427;2019
22;Huesca;137;Lanaja;1174;621;553;2019
22;Huesca;139;Laperdiguera;91;47;44;2019
22;Huesca;141;Lascellas-Ponzano;129;82;47;2019
22;Huesca;142;Lascuarre;132;68;64;2019
22;Huesca;143;Laspaúles;230;135;95;2019
22;Huesca;144;Laspuña;298;161;137;2019
22;Huesca;149;Loarre;338;189;149;2019
22;Huesca;150;Loporzano;530;300;230;2019
22;Huesca;151;Loscorrales;99;50;49;2019
22;Huesca;905;Lupiñén-Ortilla;342;171;171;2019
22;Huesca;155;Monesma y Cajigar;76;43;33;2019
22;Huesca;156;Monflorite-Lascasas;404;215;189;2019
22;Huesca;157;Montanuy;212;123;89;2019
22;Huesca;158;Monzón;17236;8683;8553;2019
22;Huesca;160;Naval;275;143;132;2019
22;Huesca;162;Novales;156;75;81;2019
22;Huesca;163;Nueno;537;295;242;2019
22;Huesca;164;Olvena;55;29;26;2019
22;Huesca;165;Ontiñena;518;261;257;2019
22;Huesca;167;Osso de Cinca;681;376;305;2019
22;Huesca;168;Palo;27;14;13;2019
22;Huesca;170;Panticosa;784;409;375;2019
22;Huesca;172;Peñalba;611;314;297;2019
22;Huesca;173;Peñas de Riglos, Las;248;158;90;2019
22;Huesca;174;Peralta de Alcofea;556;291;265;2019
22;Huesca;175;Peralta de Calasanz;210;122;88;2019
22;Huesca;176;Peraltilla;196;98;98;2019
22;Huesca;177;Perarrúa;111;59;52;2019
22;Huesca;178;Pertusa;113;65;48;2019
22;Huesca;181;Piracés;102;54;48;2019
22;Huesca;182;Plan;283;143;140;2019
22;Huesca;184;Poleñino;200;107;93;2019
22;Huesca;186;Pozán de Vero;228;111;117;2019
22;Huesca;187;Puebla de Castro, La;383;196;187;2019
22;Huesca;188;Puente de Montañana;89;38;51;2019
22;Huesca;902;Puente la Reina de Jaca;255;133;122;2019
22;Huesca;189;Puértolas;212;117;95;2019
22;Huesca;190;Pueyo de Araguás, El;161;89;72;2019
22;Huesca;193;Pueyo de Santa Cruz;318;162;156;2019
22;Huesca;195;Quicena;280;139;141;2019
22;Huesca;197;Robres;527;268;259;2019
22;Huesca;199;Sabiñánigo;9238;4610;4628;2019
22;Huesca;200;Sahún;312;160;152;2019
22;Huesca;201;Salas Altas;316;161;155;2019
22;Huesca;202;Salas Bajas;175;86;89;2019
22;Huesca;203;Salillas;94;53;41;2019
22;Huesca;204;Sallent de Gállego;1478;732;746;2019
22;Huesca;205;San Esteban de Litera;535;270;265;2019
22;Huesca;207;San Juan de Plan;153;84;69;2019
22;Huesca;903;San Miguel del Cinca;795;406;389;2019
22;Huesca;206;Sangarrén;223;121;102;2019
22;Huesca;208;Santa Cilia;240;123;117;2019
22;Huesca;209;Santa Cruz de la Serós;183;109;74;2019
22;Huesca;906;Santa María de Dulcis;209;113;96;2019
22;Huesca;212;Santaliestra y San Quílez;82;41;41;2019
22;Huesca;213;Sariñena;4160;2160;2000;2019
22;Huesca;214;Secastilla;140;62;78;2019
22;Huesca;215;Seira;148;83;65;2019
22;Huesca;217;Sena;495;265;230;2019
22;Huesca;218;Senés de Alcubierre;41;22;19;2019
22;Huesca;220;Sesa;161;90;71;2019
22;Huesca;221;Sesué;122;63;59;2019
22;Huesca;222;Siétamo;679;369;310;2019
22;Huesca;223;Sopeira;91;51;40;2019
22;Huesca;904;Sotonera, La;872;469;403;2019
22;Huesca;225;Tamarite de Litera;3476;1789;1687;2019
22;Huesca;226;Tardienta;961;477;484;2019
22;Huesca;227;Tella-Sin;232;136;96;2019
22;Huesca;228;Tierz;771;390;381;2019
22;Huesca;229;Tolva;121;66;55;2019
22;Huesca;230;Torla-Ordesa;304;158;146;2019
22;Huesca;232;Torralba de Aragón;101;59;42;2019
22;Huesca;233;Torre la Ribera;101;53;48;2019
22;Huesca;234;Torrente de Cinca;1154;591;563;2019
22;Huesca;235;Torres de Alcanadre;86;53;33;2019
22;Huesca;236;Torres de Barbués;252;125;127;2019
22;Huesca;239;Tramaced;104;66;38;2019
22;Huesca;242;Valfarta;67;41;26;2019
22;Huesca;243;Valle de Bardají;30;18;12;2019
22;Huesca;901;Valle de Hecho;822;428;394;2019
22;Huesca;244;Valle de Lierp;39;20;19;2019
22;Huesca;245;Velilla de Cinca;461;244;217;2019
22;Huesca;909;Vencillón;389;207;182;2019
22;Huesca;247;Viacamp y Litera;36;24;12;2019
22;Huesca;248;Vicién;113;66;47;2019
22;Huesca;249;Villanova;168;81;87;2019
22;Huesca;250;Villanúa;432;224;208;2019
22;Huesca;251;Villanueva de Sigena;390;201;189;2019
22;Huesca;252;Yebra de Basa;143;86;57;2019
22;Huesca;253;Yésero;57;34;23;2019
22;Huesca;254;Zaidín;1763;929;834;2019
23;Jaén;001;Albanchez de Mágina;1024;532;492;2019
23;Jaén;002;Alcalá la Real;21605;10612;10993;2019
23;Jaén;003;Alcaudete;10498;5166;5332;2019
23;Jaén;004;Aldeaquemada;481;265;216;2019
23;Jaén;005;Andújar;36793;17978;18815;2019
23;Jaén;006;Arjona;5542;2730;2812;2019
23;Jaén;007;Arjonilla;3575;1812;1763;2019
23;Jaén;008;Arquillos;1734;866;868;2019
23;Jaén;905;Arroyo del Ojanco;2288;1158;1130;2019
23;Jaén;009;Baeza;15841;7841;8000;2019
23;Jaén;010;Bailén;17667;8773;8894;2019
23;Jaén;011;Baños de la Encina;2582;1332;1250;2019
23;Jaén;012;Beas de Segura;5130;2683;2447;2019
23;Jaén;902;Bedmar y Garcíez;2642;1341;1301;2019
23;Jaén;014;Begíjar;3029;1526;1503;2019
23;Jaén;015;Bélmez de la Moraleda;1567;795;772;2019
23;Jaén;016;Benatae;448;229;219;2019
23;Jaén;017;Cabra del Santo Cristo;1779;930;849;2019
23;Jaén;018;Cambil;2703;1411;1292;2019
23;Jaén;019;Campillo de Arenas;1760;896;864;2019
23;Jaén;020;Canena;1831;935;896;2019
23;Jaén;021;Carboneros;615;318;297;2019
23;Jaén;901;Cárcheles;1363;716;647;2019
23;Jaén;024;Carolina, La;15261;7546;7715;2019
23;Jaén;025;Castellar;3314;1670;1644;2019
23;Jaén;026;Castillo de Locubín;4058;2011;2047;2019
23;Jaén;027;Cazalilla;824;404;420;2019
23;Jaén;028;Cazorla;7441;3606;3835;2019
23;Jaén;029;Chiclana de Segura;965;489;476;2019
23;Jaén;030;Chilluévar;1434;692;742;2019
23;Jaén;031;Escañuela;950;468;482;2019
23;Jaén;032;Espeluy;619;304;315;2019
23;Jaén;033;Frailes;1575;783;792;2019
23;Jaén;034;Fuensanta de Martos;3074;1539;1535;2019
23;Jaén;035;Fuerte del Rey;1357;688;669;2019
23;Jaén;037;Génave;611;335;276;2019
23;Jaén;038;Guardia de Jaén, La;5011;2526;2485;2019
23;Jaén;039;Guarromán;2724;1363;1361;2019
23;Jaén;041;Higuera de Calatrava;619;332;287;2019
23;Jaén;042;Hinojares;401;215;186;2019
23;Jaén;043;Hornos;601;301;300;2019
23;Jaén;044;Huelma;5776;2871;2905;2019
23;Jaén;045;Huesa;2489;1251;1238;2019
23;Jaén;046;Ibros;2832;1422;1410;2019
23;Jaén;047;Iruela, La;1899;948;951;2019
23;Jaén;048;Iznatoraf;960;496;464;2019
23;Jaén;049;Jabalquinto;2039;1025;1014;2019
23;Jaén;050;Jaén;112999;54420;58579;2019
23;Jaén;051;Jamilena;3293;1668;1625;2019
23;Jaén;052;Jimena;1284;624;660;2019
23;Jaén;053;Jódar;11667;5822;5845;2019
23;Jaén;040;Lahiguera;1710;840;870;2019
23;Jaén;054;Larva;472;243;229;2019
23;Jaén;055;Linares;57414;28059;29355;2019
23;Jaén;056;Lopera;3665;1855;1810;2019
23;Jaén;057;Lupión;842;413;429;2019
23;Jaén;058;Mancha Real;11264;5584;5680;2019
23;Jaén;059;Marmolejo;6812;3394;3418;2019
23;Jaén;060;Martos;24215;12012;12203;2019
23;Jaén;061;Mengíbar;9941;4946;4995;2019
23;Jaén;062;Montizón;1725;894;831;2019
23;Jaén;063;Navas de San Juan;4517;2260;2257;2019
23;Jaén;064;Noalejo;1970;996;974;2019
23;Jaén;065;Orcera;1811;914;897;2019
23;Jaén;066;Peal de Becerro;5266;2602;2664;2019
23;Jaén;067;Pegalajar;2919;1470;1449;2019
23;Jaén;069;Porcuna;6235;3144;3091;2019
23;Jaén;070;Pozo Alcón;4673;2398;2275;2019
23;Jaén;071;Puente de Génave;2159;1080;1079;2019
23;Jaén;072;Puerta de Segura, La;2268;1136;1132;2019
23;Jaén;073;Quesada;5209;2645;2564;2019
23;Jaén;074;Rus;3547;1814;1733;2019
23;Jaén;075;Sabiote;3918;1932;1986;2019
23;Jaén;076;Santa Elena;888;464;424;2019
23;Jaén;077;Santiago de Calatrava;699;371;328;2019
23;Jaén;904;Santiago-Pontones;2956;1521;1435;2019
23;Jaén;079;Santisteban del Puerto;4472;2304;2168;2019
23;Jaén;080;Santo Tomé;2139;1087;1052;2019
23;Jaén;081;Segura de la Sierra;1790;874;916;2019
23;Jaén;082;Siles;2241;1115;1126;2019
23;Jaén;084;Sorihuela del Guadalimar;1100;572;528;2019
23;Jaén;085;Torreblascopedro;2546;1292;1254;2019
23;Jaén;086;Torredelcampo;14247;7143;7104;2019
23;Jaén;087;Torredonjimeno;13696;6734;6962;2019
23;Jaén;088;Torreperogil;7276;3552;3724;2019
23;Jaén;090;Torres;1406;721;685;2019
23;Jaén;091;Torres de Albánchez;787;401;386;2019
23;Jaén;092;Úbeda;34345;16813;17532;2019
23;Jaén;093;Valdepeñas de Jaén;3714;1841;1873;2019
23;Jaén;094;Vilches;4436;2216;2220;2019
23;Jaén;095;Villacarrillo;10726;5391;5335;2019
23;Jaén;096;Villanueva de la Reina;3081;1544;1537;2019
23;Jaén;097;Villanueva del Arzobispo;8193;4214;3979;2019
23;Jaén;098;Villardompardo;965;488;477;2019
23;Jaén;099;Villares, Los;6014;3004;3010;2019
23;Jaén;101;Villarrodrigo;405;215;190;2019
23;Jaén;903;Villatorres;4316;2184;2132;2019
24;León;001;Acebedo;187;107;80;2019
24;León;002;Algadefe;289;151;138;2019
24;León;003;Alija del Infantado;647;323;324;2019
24;León;004;Almanza;574;327;247;2019
24;León;005;Antigua, La;360;208;152;2019
24;León;006;Ardón;560;303;257;2019
24;León;007;Arganza;816;407;409;2019
24;León;008;Astorga;10867;5113;5754;2019
24;León;009;Balboa;290;158;132;2019
24;León;010;Bañeza, La;10338;4977;5361;2019
24;León;011;Barjas;190;101;89;2019
24;León;012;Barrios de Luna, Los;314;179;135;2019
24;León;014;Bembibre;8705;4220;4485;2019
24;León;015;Benavides;2455;1215;1240;2019
24;León;016;Benuza;530;309;221;2019
24;León;017;Bercianos del Páramo;562;288;274;2019
24;León;018;Bercianos del Real Camino;193;99;94;2019
24;León;019;Berlanga del Bierzo;360;164;196;2019
24;León;020;Boca de Huérgano;464;280;184;2019
24;León;021;Boñar;1832;927;905;2019
24;León;022;Borrenes;315;168;147;2019
24;León;023;Brazuelo;295;161;134;2019
24;León;024;Burgo Ranero, El;715;377;338;2019
24;León;025;Burón;308;176;132;2019
24;León;026;Bustillo del Páramo;1165;599;566;2019
24;León;027;Cabañas Raras;1356;698;658;2019
24;León;028;Cabreros del Río;413;223;190;2019
24;León;029;Cabrillanes;759;395;364;2019
24;León;030;Cacabelos;5118;2543;2575;2019
24;León;031;Calzada del Coto;223;133;90;2019
24;León;032;Campazas;119;55;64;2019
24;León;033;Campo de Villavidel;209;114;95;2019
24;León;034;Camponaraya;4096;2022;2074;2019
24;León;036;Candín;274;151;123;2019
24;León;037;Cármenes;352;196;156;2019
24;León;038;Carracedelo;3425;1713;1712;2019
24;León;039;Carrizo;2228;1130;1098;2019
24;León;040;Carrocera;451;249;202;2019
24;León;041;Carucedo;562;284;278;2019
24;León;042;Castilfalé;69;40;29;2019
24;León;043;Castrillo de Cabrera;119;69;50;2019
24;León;044;Castrillo de la Valduerna;158;70;88;2019
24;León;046;Castrocalbón;964;499;465;2019
24;León;047;Castrocontrigo;765;412;353;2019
24;León;049;Castropodame;1628;842;786;2019
24;León;050;Castrotierra de Valmadrigal;115;60;55;2019
24;León;051;Cea;413;219;194;2019
24;León;052;Cebanico;147;92;55;2019
24;León;053;Cebrones del Río;451;248;203;2019
24;León;065;Chozas de Abajo;2581;1347;1234;2019
24;León;054;Cimanes de la Vega;463;244;219;2019
24;León;055;Cimanes del Tejar;724;390;334;2019
24;León;056;Cistierna;3135;1548;1587;2019
24;León;057;Congosto;1475;743;732;2019
24;León;058;Corbillos de los Oteros;199;112;87;2019
24;León;059;Corullón;887;447;440;2019
24;León;060;Crémenes;544;292;252;2019
24;León;061;Cuadros;2001;1007;994;2019
24;León;062;Cubillas de los Oteros;141;81;60;2019
24;León;063;Cubillas de Rueda;388;206;182;2019
24;León;064;Cubillos del Sil;1816;952;864;2019
24;León;066;Destriana;479;224;255;2019
24;León;067;Encinedo;709;375;334;2019
24;León;068;Ercina, La;457;240;217;2019
24;León;069;Escobar de Campos;39;22;17;2019
24;León;070;Fabero;4493;2194;2299;2019
24;León;071;Folgoso de la Ribera;1080;524;556;2019
24;León;073;Fresno de la Vega;496;256;240;2019
24;León;074;Fuentes de Carbajal;98;53;45;2019
24;León;076;Garrafe de Torío;1504;811;693;2019
24;León;077;Gordaliza del Pino;252;124;128;2019
24;León;078;Gordoncillo;409;209;200;2019
24;León;079;Gradefes;954;521;433;2019
24;León;080;Grajal de Campos;227;113;114;2019
24;León;081;Gusendos de los Oteros;124;64;60;2019
24;León;082;Hospital de Órbigo;998;498;500;2019
24;León;083;Igüeña;1145;598;547;2019
24;León;084;Izagre;159;80;79;2019
24;León;086;Joarilla de las Matas;296;159;137;2019
24;León;087;Laguna Dalga;645;346;299;2019
24;León;088;Laguna de Negrillos;1058;545;513;2019
24;León;089;León;124303;56307;67996;2019
24;León;092;Llamas de la Ribera;825;437;388;2019
24;León;090;Lucillo;376;199;177;2019
24;León;091;Luyego;628;336;292;2019
24;León;093;Magaz de Cepeda;359;187;172;2019
24;León;094;Mansilla de las Mulas;1733;868;865;2019
24;León;095;Mansilla Mayor;334;181;153;2019
24;León;096;Maraña;115;67;48;2019
24;León;097;Matadeón de los Oteros;228;118;110;2019
24;León;098;Matallana de Torío;1270;667;603;2019
24;León;099;Matanza;165;89;76;2019
24;León;100;Molinaseca;884;488;396;2019
24;León;101;Murias de Paredes;399;201;198;2019
24;León;102;Noceda del Bierzo;672;345;327;2019
24;León;103;Oencia;274;161;113;2019
24;León;104;Omañas, Las;266;144;122;2019
24;León;105;Onzonilla;1835;940;895;2019
24;León;106;Oseja de Sajambre;232;135;97;2019
24;León;107;Pajares de los Oteros;266;162;104;2019
24;León;108;Palacios de la Valduerna;379;183;196;2019
24;León;109;Palacios del Sil;941;501;440;2019
24;León;110;Páramo del Sil;1259;646;613;2019
24;León;112;Peranzanes;300;177;123;2019
24;León;113;Pobladura de Pelayo García;373;193;180;2019
24;León;114;Pola de Gordón, La;3224;1628;1596;2019
24;León;115;Ponferrada;64674;30671;34003;2019
24;León;116;Posada de Valdeón;415;241;174;2019
24;León;117;Pozuelo del Páramo;431;212;219;2019
24;León;118;Prado de la Guzpeña;107;60;47;2019
24;León;119;Priaranza del Bierzo;788;401;387;2019
24;León;120;Prioro;340;198;142;2019
24;León;121;Puebla de Lillo;681;394;287;2019
24;León;122;Puente de Domingo Flórez;1500;790;710;2019
24;León;123;Quintana del Castillo;735;412;323;2019
24;León;124;Quintana del Marco;362;196;166;2019
24;León;125;Quintana y Congosto;351;180;171;2019
24;León;127;Regueras de Arriba;280;151;129;2019
24;León;129;Reyero;116;64;52;2019
24;León;130;Riaño;463;264;199;2019
24;León;131;Riego de la Vega;742;399;343;2019
24;León;132;Riello;647;364;283;2019
24;León;133;Rioseco de Tapia;374;211;163;2019
24;León;134;Robla, La;3783;1878;1905;2019
24;León;136;Roperuelos del Páramo;524;265;259;2019
24;León;137;Sabero;1140;586;554;2019
24;León;139;Sahagún;2493;1226;1267;2019
24;León;141;San Adrián del Valle;103;57;46;2019
24;León;142;San Andrés del Rabanedo;30615;14574;16041;2019
24;León;144;San Cristóbal de la Polantera;689;358;331;2019
24;León;145;San Emiliano;646;361;285;2019
24;León;146;San Esteban de Nogales;256;132;124;2019
24;León;148;San Justo de la Vega;1843;942;901;2019
24;León;149;San Millán de los Caballeros;167;87;80;2019
24;León;150;San Pedro Bercianos;238;132;106;2019
24;León;143;Sancedo;556;277;279;2019
24;León;151;Santa Colomba de Curueño;479;255;224;2019
24;León;152;Santa Colomba de Somoza;511;275;236;2019
24;León;153;Santa Cristina de Valmadrigal;267;142;125;2019
24;León;154;Santa Elena de Jamuz;1066;562;504;2019
24;León;155;Santa María de la Isla;475;247;228;2019
24;León;158;Santa María de Ordás;318;166;152;2019
24;León;156;Santa María del Monte de Cea;227;125;102;2019
24;León;157;Santa María del Páramo;3089;1519;1570;2019
24;León;159;Santa Marina del Rey;1916;956;960;2019
24;León;160;Santas Martas;743;400;343;2019
24;León;161;Santiago Millas;338;186;152;2019
24;León;162;Santovenia de la Valdoncina;2126;1083;1043;2019
24;León;163;Sariegos;5050;2528;2522;2019
24;León;164;Sena de Luna;383;189;194;2019
24;León;165;Sobrado;312;159;153;2019
24;León;166;Soto de la Vega;1529;805;724;2019
24;León;167;Soto y Amío;783;408;375;2019
24;León;168;Toral de los Guzmanes;500;273;227;2019
24;León;206;Toral de los Vados;1846;907;939;2019
24;León;169;Toreno;3105;1539;1566;2019
24;León;170;Torre del Bierzo;2164;1112;1052;2019
24;León;171;Trabadelo;357;195;162;2019
24;León;172;Truchas;443;231;212;2019
24;León;173;Turcia;993;509;484;2019
24;León;174;Urdiales del Páramo;510;272;238;2019
24;León;185;Val de San Lorenzo;505;253;252;2019
24;León;175;Valdefresno;2187;1131;1056;2019
24;León;176;Valdefuentes del Páramo;321;171;150;2019
24;León;177;Valdelugueros;508;290;218;2019
24;León;178;Valdemora;82;36;46;2019
24;León;179;Valdepiélago;344;197;147;2019
24;León;180;Valdepolo;1219;654;565;2019
24;León;181;Valderas;1623;822;801;2019
24;León;182;Valderrey;446;224;222;2019
24;León;183;Valderrueda;832;438;394;2019
24;León;184;Valdesamario;194;109;85;2019
24;León;187;Valdevimbre;978;505;473;2019
24;León;188;Valencia de Don Juan;5351;2628;2723;2019
24;León;191;Vallecillo;128;78;50;2019
24;León;189;Valverde de la Virgen;7328;3777;3551;2019
24;León;190;Valverde-Enrique;155;78;77;2019
24;León;193;Vecilla, La;386;206;180;2019
24;León;196;Vega de Espinareda;2069;1054;1015;2019
24;León;197;Vega de Infanzones;854;436;418;2019
24;León;198;Vega de Valcarce;606;317;289;2019
24;León;194;Vegacervera;279;144;135;2019
24;León;199;Vegaquemada;439;244;195;2019
24;León;201;Vegas del Condado;1114;650;464;2019
24;León;202;Villablino;8620;4241;4379;2019
24;León;203;Villabraz;97;56;41;2019
24;León;205;Villadangos del Páramo;1132;588;544;2019
24;León;207;Villademor de la Vega;327;172;155;2019
24;León;209;Villafranca del Bierzo;2899;1385;1514;2019
24;León;210;Villagatón;613;324;289;2019
24;León;211;Villamandos;294;159;135;2019
24;León;901;Villamanín;949;483;466;2019
24;León;212;Villamañán;1126;568;558;2019
24;León;213;Villamartín de Don Sancho;176;96;80;2019
24;León;214;Villamejil;687;368;319;2019
24;León;215;Villamol;164;85;79;2019
24;León;216;Villamontán de la Valduerna;715;378;337;2019
24;León;217;Villamoratiel de las Matas;143;81;62;2019
24;León;218;Villanueva de las Manzanas;488;258;230;2019
24;León;219;Villaobispo de Otero;541;296;245;2019
24;León;902;Villaornate y Castro;356;183;173;2019
24;León;221;Villaquejida;870;446;424;2019
24;León;222;Villaquilambre;18638;9230;9408;2019
24;León;223;Villarejo de Órbigo;2974;1459;1515;2019
24;León;224;Villares de Órbigo;611;325;286;2019
24;León;225;Villasabariego;1121;588;533;2019
24;León;226;Villaselán;199;116;83;2019
24;León;227;Villaturiel;1852;975;877;2019
24;León;228;Villazala;665;353;312;2019
24;León;229;Villazanzo de Valderaduey;419;244;175;2019
24;León;230;Zotes del Páramo;427;240;187;2019
25;Lleida;001;Abella de la Conca;179;96;83;2019
25;Lleida;002;Àger;588;320;268;2019
25;Lleida;003;Agramunt;5371;2689;2682;2019
25;Lleida;038;Aitona;2591;1358;1233;2019
25;Lleida;004;Alamús, Els;819;412;407;2019
25;Lleida;005;Alàs i Cerc;329;171;158;2019
25;Lleida;006;Albagés, L';369;194;175;2019
25;Lleida;007;Albatàrrec;2221;1150;1071;2019
25;Lleida;008;Albesa;1556;855;701;2019
25;Lleida;009;Albi, L';764;389;375;2019
25;Lleida;010;Alcanó;235;119;116;2019
25;Lleida;011;Alcarràs;9514;4957;4557;2019
25;Lleida;012;Alcoletge;3420;1775;1645;2019
25;Lleida;013;Alfarràs;2797;1459;1338;2019
25;Lleida;014;Alfés;312;162;150;2019
25;Lleida;015;Algerri;386;206;180;2019
25;Lleida;016;Alguaire;2971;1562;1409;2019
25;Lleida;017;Alins;276;144;132;2019
25;Lleida;019;Almacelles;6791;3584;3207;2019
25;Lleida;020;Almatret;307;172;135;2019
25;Lleida;021;Almenar;3398;1791;1607;2019
25;Lleida;022;Alòs de Balaguer;130;74;56;2019
25;Lleida;023;Alpicat;6255;3134;3121;2019
25;Lleida;024;Alt Àneu;405;231;174;2019
25;Lleida;027;Anglesola;1363;682;681;2019
25;Lleida;029;Arbeca;2144;1100;1044;2019
25;Lleida;031;Arres;65;42;23;2019
25;Lleida;032;Arsèguel;84;48;36;2019
25;Lleida;033;Artesa de Lleida;1504;789;715;2019
25;Lleida;034;Artesa de Segre;3432;1766;1666;2019
25;Lleida;036;Aspa;224;113;111;2019
25;Lleida;037;Avellanes i Santa Linya, Les;449;259;190;2019
25;Lleida;039;Baix Pallars;335;182;153;2019
25;Lleida;040;Balaguer;17162;8746;8416;2019
25;Lleida;041;Barbens;878;467;411;2019
25;Lleida;042;Baronia de Rialb, La;237;121;116;2019
25;Lleida;044;Bassella;224;112;112;2019
25;Lleida;045;Bausen;58;30;28;2019
25;Lleida;046;Belianes;525;269;256;2019
25;Lleida;170;Bellaguarda;287;152;135;2019
25;Lleida;047;Bellcaire d'Urgell;1230;627;603;2019
25;Lleida;048;Bell-lloc d'Urgell;2315;1139;1176;2019
25;Lleida;049;Bellmunt d'Urgell;185;89;96;2019
25;Lleida;050;Bellpuig;5133;2705;2428;2019
25;Lleida;051;Bellver de Cerdanya;1937;1009;928;2019
25;Lleida;052;Bellvís;2255;1149;1106;2019
25;Lleida;053;Benavent de Segrià;1499;781;718;2019
25;Lleida;055;Biosca;176;94;82;2019
25;Lleida;057;Bòrdes, Es;259;144;115;2019
25;Lleida;058;Borges Blanques, Les;6087;3105;2982;2019
25;Lleida;059;Bossòst;1109;542;567;2019
25;Lleida;056;Bovera;247;133;114;2019
25;Lleida;060;Cabanabona;75;36;39;2019
25;Lleida;061;Cabó;92;49;43;2019
25;Lleida;062;Camarasa;817;410;407;2019
25;Lleida;063;Canejan;107;57;50;2019
25;Lleida;904;Castell de Mur;183;104;79;2019
25;Lleida;064;Castellar de la Ribera;134;67;67;2019
25;Lleida;067;Castelldans;960;511;449;2019
25;Lleida;068;Castellnou de Seana;683;361;322;2019
25;Lleida;069;Castelló de Farfanya;536;288;248;2019
25;Lleida;070;Castellserà;1003;506;497;2019
25;Lleida;071;Cava;47;29;18;2019
25;Lleida;072;Cervera;9180;4670;4510;2019
25;Lleida;073;Cervià de les Garrigues;640;336;304;2019
25;Lleida;074;Ciutadilla;208;111;97;2019
25;Lleida;075;Clariana de Cardener;157;82;75;2019
25;Lleida;076;Cogul, El;158;88;70;2019
25;Lleida;077;Coll de Nargó;550;285;265;2019
25;Lleida;163;Coma i la Pedra, La;265;157;108;2019
25;Lleida;161;Conca de Dalt;418;213;205;2019
25;Lleida;078;Corbins;1444;787;657;2019
25;Lleida;079;Cubells;343;180;163;2019
25;Lleida;081;Espluga Calba, L';341;171;170;2019
25;Lleida;082;Espot;364;193;171;2019
25;Lleida;088;Estamariu;118;68;50;2019
25;Lleida;085;Estaràs;162;85;77;2019
25;Lleida;086;Esterri d'Àneu;772;364;408;2019
25;Lleida;087;Esterri de Cardós;70;37;33;2019
25;Lleida;089;Farrera;116;65;51;2019
25;Lleida;908;Fígols i Alinyà;252;145;107;2019
25;Lleida;092;Floresta, La;147;79;68;2019
25;Lleida;093;Fondarella;784;387;397;2019
25;Lleida;094;Foradada;186;108;78;2019
25;Lleida;096;Fuliola, La;1248;619;629;2019
25;Lleida;097;Fulleda;85;44;41;2019
25;Lleida;098;Gavet de la Conca;261;129;132;2019
25;Lleida;912;Gimenells i el Pla de la Font;1111;595;516;2019
25;Lleida;099;Golmés;1840;917;923;2019
25;Lleida;100;Gósol;206;118;88;2019
25;Lleida;101;Granadella, La;712;387;325;2019
25;Lleida;102;Granja d'Escarp, La;936;514;422;2019
25;Lleida;103;Granyanella;148;82;66;2019
25;Lleida;105;Granyena de les Garrigues;132;78;54;2019
25;Lleida;104;Granyena de Segarra;142;76;66;2019
25;Lleida;109;Guimerà;265;140;125;2019
25;Lleida;903;Guingueta d'Àneu, La;297;159;138;2019
25;Lleida;110;Guissona;7136;3810;3326;2019
25;Lleida;111;Guixers;134;84;50;2019
25;Lleida;115;Isona i Conca Dellà;1019;548;471;2019
25;Lleida;112;Ivars de Noguera;334;171;163;2019
25;Lleida;113;Ivars d'Urgell;1531;801;730;2019
25;Lleida;114;Ivorra;104;57;47;2019
25;Lleida;910;Josa i Tuixén;106;58;48;2019
25;Lleida;118;Juncosa;386;204;182;2019
25;Lleida;119;Juneda;3475;1854;1621;2019
25;Lleida;121;Les;946;463;483;2019
25;Lleida;122;Linyola;2700;1365;1335;2019
25;Lleida;123;Lladorre;230;116;114;2019
25;Lleida;124;Lladurs;176;91;85;2019
25;Lleida;125;Llardecans;451;236;215;2019
25;Lleida;126;Llavorsí;352;180;172;2019
25;Lleida;120;Lleida;138956;68657;70299;2019
25;Lleida;127;Lles de Cerdanya;253;148;105;2019
25;Lleida;128;Llimiana;145;88;57;2019
25;Lleida;129;Llobera;188;104;84;2019
25;Lleida;133;Maials;920;517;403;2019
25;Lleida;130;Maldà;220;109;111;2019
25;Lleida;131;Massalcoreig;598;338;260;2019
25;Lleida;132;Massoteres;218;119;99;2019
25;Lleida;134;Menàrguens;806;440;366;2019
25;Lleida;135;Miralcamp;1351;677;674;2019
25;Lleida;137;Mollerussa;14683;7543;7140;2019
25;Lleida;136;Molsosa, La;107;53;54;2019
25;Lleida;139;Montellà i Martinet;579;324;255;2019
25;Lleida;140;Montferrer i Castellbò;1041;566;475;2019
25;Lleida;138;Montgai;625;329;296;2019
25;Lleida;142;Montoliu de Lleida;489;251;238;2019
25;Lleida;141;Montoliu de Segarra;179;100;79;2019
25;Lleida;143;Montornès de Segarra;100;47;53;2019
25;Lleida;145;Nalec;87;45;42;2019
25;Lleida;025;Naut Aran;1803;935;868;2019
25;Lleida;146;Navès;280;147;133;2019
25;Lleida;148;Odèn;249;149;100;2019
25;Lleida;149;Oliana;1810;906;904;2019
25;Lleida;150;Oliola;197;106;91;2019
25;Lleida;151;Olius;986;527;459;2019
25;Lleida;152;Oluges, Les;167;88;79;2019
25;Lleida;153;Omellons, Els;211;111;100;2019
25;Lleida;154;Omells de na Gaia, Els;131;72;59;2019
25;Lleida;155;Organyà;784;388;396;2019
25;Lleida;156;Os de Balaguer;994;507;487;2019
25;Lleida;157;Ossó de Sió;204;98;106;2019
25;Lleida;158;Palau d'Anglesola, El;2166;1061;1105;2019
25;Lleida;164;Penelles;452;262;190;2019
25;Lleida;165;Peramola;347;177;170;2019
25;Lleida;166;Pinell de Solsonès;200;118;82;2019
25;Lleida;167;Pinós;287;151;136;2019
25;Lleida;911;Plans de Sió, Els;506;272;234;2019
25;Lleida;168;Poal, El;648;340;308;2019
25;Lleida;169;Pobla de Cérvoles, La;191;107;84;2019
25;Lleida;171;Pobla de Segur, La;2984;1469;1515;2019
25;Lleida;030;Pont de Bar, El;157;87;70;2019
25;Lleida;173;Pont de Suert, El;2220;1107;1113;2019
25;Lleida;172;Ponts;2601;1305;1296;2019
25;Lleida;174;Portella, La;728;412;316;2019
25;Lleida;175;Prats i Sansor;219;114;105;2019
25;Lleida;176;Preixana;385;199;186;2019
25;Lleida;177;Preixens;432;218;214;2019
25;Lleida;179;Prullans;231;109;122;2019
25;Lleida;180;Puiggròs;276;138;138;2019
25;Lleida;181;Puigverd d'Agramunt;255;146;109;2019
25;Lleida;182;Puigverd de Lleida;1355;701;654;2019
25;Lleida;183;Rialp;661;330;331;2019
25;Lleida;905;Ribera d'Ondara;426;213;213;2019
25;Lleida;185;Ribera d'Urgellet;935;488;447;2019
25;Lleida;186;Riner;263;132;131;2019
25;Lleida;913;Riu de Cerdanya;93;55;38;2019
25;Lleida;189;Rosselló;3145;1602;1543;2019
25;Lleida;190;Salàs de Pallars;320;174;146;2019
25;Lleida;191;Sanaüja;380;202;178;2019
25;Lleida;196;Sant Esteve de la Sarga;124;72;52;2019
25;Lleida;192;Sant Guim de Freixenet;1025;538;487;2019
25;Lleida;197;Sant Guim de la Plana;185;106;79;2019
25;Lleida;193;Sant Llorenç de Morunys;949;457;492;2019
25;Lleida;902;Sant Martí de Riucorb;646;334;312;2019
25;Lleida;194;Sant Ramon;491;254;237;2019
25;Lleida;201;Sarroca de Bellera;121;68;53;2019
25;Lleida;200;Sarroca de Lleida;363;200;163;2019
25;Lleida;202;Senterada;137;80;57;2019
25;Lleida;035;Sentiu de Sió, La;406;216;190;2019
25;Lleida;204;Seròs;1922;1029;893;2019
25;Lleida;203;Seu d'Urgell, La;12089;5842;6247;2019
25;Lleida;205;Sidamon;734;383;351;2019
25;Lleida;206;Soleràs, El;332;173;159;2019
25;Lleida;207;Solsona;9094;4488;4606;2019
25;Lleida;208;Soriguera;410;220;190;2019
25;Lleida;209;Sort;2149;1077;1072;2019
25;Lleida;210;Soses;1763;923;840;2019
25;Lleida;211;Sudanell;853;465;388;2019
25;Lleida;212;Sunyer;352;205;147;2019
25;Lleida;215;Talarn;585;387;198;2019
25;Lleida;216;Talavera;283;158;125;2019
25;Lleida;217;Tàrrega;17098;8489;8609;2019
25;Lleida;218;Tarrés;106;56;50;2019
25;Lleida;219;Tarroja de Segarra;187;104;83;2019
25;Lleida;220;Térmens;1333;678;655;2019
25;Lleida;221;Tírvia;131;63;68;2019
25;Lleida;222;Tiurana;73;33;40;2019
25;Lleida;223;Torà;1255;639;616;2019
25;Lleida;224;Torms, Els;144;77;67;2019
25;Lleida;225;Tornabous;858;461;397;2019
25;Lleida;227;Torre de Cabdella, La;760;383;377;2019
25;Lleida;226;Torrebesses;282;150;132;2019
25;Lleida;228;Torrefarrera;4605;2328;2277;2019
25;Lleida;907;Torrefeta i Florejacs;602;322;280;2019
25;Lleida;230;Torregrossa;2202;1140;1062;2019
25;Lleida;231;Torrelameu;743;433;310;2019
25;Lleida;232;Torres de Segre;2277;1179;1098;2019
25;Lleida;233;Torre-serona;397;208;189;2019
25;Lleida;234;Tremp;5844;2884;2960;2019
25;Lleida;043;Vall de Boí, La;1021;546;475;2019
25;Lleida;901;Vall de Cardós;364;195;169;2019
25;Lleida;238;Vallbona de les Monges;233;120;113;2019
25;Lleida;240;Vallfogona de Balaguer;1876;937;939;2019
25;Lleida;906;Valls d'Aguilar, Les;260;145;115;2019
25;Lleida;239;Valls de Valira, Les;791;412;379;2019
25;Lleida;909;Vansa i Fórnols, La;161;84;77;2019
25;Lleida;242;Verdú;919;441;478;2019
25;Lleida;243;Vielha e Mijaran;5559;2837;2722;2019
25;Lleida;244;Vilagrassa;541;278;263;2019
25;Lleida;245;Vilaller;561;294;267;2019
25;Lleida;247;Vilamòs;187;100;87;2019
25;Lleida;248;Vilanova de Bellpuig;1181;599;582;2019
25;Lleida;254;Vilanova de la Barca;1036;535;501;2019
25;Lleida;249;Vilanova de l'Aguda;197;97;100;2019
25;Lleida;250;Vilanova de Meià;389;223;166;2019
25;Lleida;251;Vilanova de Segrià;977;518;459;2019
25;Lleida;252;Vila-sana;742;376;366;2019
25;Lleida;253;Vilosell, El;169;88;81;2019
25;Lleida;255;Vinaixa;470;249;221;2019
27;Lugo;001;Abadín;2367;1157;1210;2019
27;Lugo;002;Alfoz;1688;812;876;2019
27;Lugo;003;Antas de Ulla;1976;966;1010;2019
27;Lugo;004;Baleira;1241;660;581;2019
27;Lugo;901;Baralla;2556;1351;1205;2019
27;Lugo;005;Barreiros;2934;1405;1529;2019
27;Lugo;006;Becerreá;2818;1419;1399;2019
27;Lugo;007;Begonte;3026;1516;1510;2019
27;Lugo;008;Bóveda;1481;768;713;2019
27;Lugo;902;Burela;9588;4754;4834;2019
27;Lugo;009;Carballedo;2193;1102;1091;2019
27;Lugo;010;Castro de Rei;5052;2496;2556;2019
27;Lugo;011;Castroverde;2617;1355;1262;2019
27;Lugo;012;Cervantes;1338;762;576;2019
27;Lugo;013;Cervo;4227;2076;2151;2019
27;Lugo;016;Chantada;8192;3943;4249;2019
27;Lugo;014;Corgo, O;3481;1773;1708;2019
27;Lugo;015;Cospeito;4484;2180;2304;2019
27;Lugo;017;Folgoso do Courel;1024;530;494;2019
27;Lugo;018;Fonsagrada, A;3465;1816;1649;2019
27;Lugo;019;Foz;9980;4863;5117;2019
27;Lugo;020;Friol;3744;1888;1856;2019
27;Lugo;022;Guitiriz;5484;2730;2754;2019
27;Lugo;023;Guntín;2690;1381;1309;2019
27;Lugo;024;Incio, O;1570;791;779;2019
27;Lugo;026;Láncara;2605;1332;1273;2019
27;Lugo;027;Lourenzá;2140;1040;1100;2019
27;Lugo;028;Lugo;98276;45508;52768;2019
27;Lugo;029;Meira;1725;865;860;2019
27;Lugo;030;Mondoñedo;3568;1681;1887;2019
27;Lugo;031;Monforte de Lemos;18433;8751;9682;2019
27;Lugo;032;Monterroso;3616;1812;1804;2019
27;Lugo;033;Muras;642;316;326;2019
27;Lugo;034;Navia de Suarna;1081;600;481;2019
27;Lugo;035;Negueira de Muñiz;215;114;101;2019
27;Lugo;037;Nogais, As;1079;575;504;2019
27;Lugo;038;Ourol;1018;521;497;2019
27;Lugo;039;Outeiro de Rei;5151;2655;2496;2019
27;Lugo;040;Palas de Rei;3388;1712;1676;2019
27;Lugo;041;Pantón;2542;1246;1296;2019
27;Lugo;042;Paradela;1779;885;894;2019
27;Lugo;043;Páramo, O;1366;681;685;2019
27;Lugo;044;Pastoriza, A;3002;1513;1489;2019
27;Lugo;045;Pedrafita do Cebreiro;1001;545;456;2019
27;Lugo;047;Pobra do Brollón, A;1648;815;833;2019
27;Lugo;046;Pol;1609;808;801;2019
27;Lugo;048;Pontenova, A;2264;1082;1182;2019
27;Lugo;049;Portomarín;1471;761;710;2019
27;Lugo;050;Quiroga;3207;1523;1684;2019
27;Lugo;056;Rábade;1501;749;752;2019
27;Lugo;051;Ribadeo;9854;4696;5158;2019
27;Lugo;052;Ribas de Sil;947;474;473;2019
27;Lugo;053;Ribeira de Piquín;528;274;254;2019
27;Lugo;054;Riotorto;1262;621;641;2019
27;Lugo;055;Samos;1278;681;597;2019
27;Lugo;057;Sarria;13330;6492;6838;2019
27;Lugo;058;Saviñao, O;3735;1892;1843;2019
27;Lugo;059;Sober;2312;1137;1175;2019
27;Lugo;060;Taboada;2756;1311;1445;2019
27;Lugo;061;Trabada;1118;546;572;2019
27;Lugo;062;Triacastela;641;317;324;2019
27;Lugo;063;Valadouro, O;1991;957;1034;2019
27;Lugo;064;Vicedo, O;1675;821;854;2019
27;Lugo;065;Vilalba;14072;6817;7255;2019
27;Lugo;066;Viveiro;15466;7559;7907;2019
27;Lugo;021;Xermade;1806;882;924;2019
27;Lugo;025;Xove;3273;1625;1648;2019
28;Madrid;001;Acebeda, La;84;44;40;2019
28;Madrid;002;Ajalvir;4712;2438;2274;2019
28;Madrid;003;Alameda del Valle;200;119;81;2019
28;Madrid;004;Álamo, El;9470;4696;4774;2019
28;Madrid;005;Alcalá de Henares;195649;95234;100415;2019
28;Madrid;006;Alcobendas;117040;55954;61086;2019
28;Madrid;007;Alcorcón;170514;82139;88375;2019
28;Madrid;008;Aldea del Fresno;2838;1457;1381;2019
28;Madrid;009;Algete;20611;10106;10505;2019
28;Madrid;010;Alpedrete;14575;7160;7415;2019
28;Madrid;011;Ambite;592;296;296;2019
28;Madrid;012;Anchuelo;1271;657;614;2019
28;Madrid;013;Aranjuez;59607;28978;30629;2019
28;Madrid;014;Arganda del Rey;55389;27771;27618;2019
28;Madrid;015;Arroyomolinos;31396;15701;15695;2019
28;Madrid;016;Atazar, El;89;48;41;2019
28;Madrid;017;Batres;1684;861;823;2019
28;Madrid;018;Becerril de la Sierra;5714;2877;2837;2019
28;Madrid;019;Belmonte de Tajo;1664;865;799;2019
28;Madrid;021;Berrueco, El;760;384;376;2019
28;Madrid;020;Berzosa del Lozoya;205;115;90;2019
28;Madrid;022;Boadilla del Monte;54570;26660;27910;2019
28;Madrid;023;Boalo, El;7508;3757;3751;2019
28;Madrid;024;Braojos;205;121;84;2019
28;Madrid;025;Brea de Tajo;524;301;223;2019
28;Madrid;026;Brunete;10736;5283;5453;2019
28;Madrid;027;Buitrago del Lozoya;1884;898;986;2019
28;Madrid;028;Bustarviejo;2503;1256;1247;2019
28;Madrid;029;Cabanillas de la Sierra;756;392;364;2019
28;Madrid;030;Cabrera, La;2667;1313;1354;2019
28;Madrid;031;Cadalso de los Vidrios;3039;1593;1446;2019
28;Madrid;032;Camarma de Esteruelas;7336;3726;3610;2019
28;Madrid;033;Campo Real;6210;3138;3072;2019
28;Madrid;034;Canencia;447;245;202;2019
28;Madrid;035;Carabaña;2010;1002;1008;2019
28;Madrid;036;Casarrubuelos;3778;1923;1855;2019
28;Madrid;037;Cenicientos;2033;1004;1029;2019
28;Madrid;038;Cercedilla;7026;3463;3563;2019
28;Madrid;039;Cervera de Buitrago;150;92;58;2019
28;Madrid;051;Chapinería;2328;1181;1147;2019
28;Madrid;052;Chinchón;5331;2682;2649;2019
28;Madrid;040;Ciempozuelos;24592;12363;12229;2019
28;Madrid;041;Cobeña;7428;3623;3805;2019
28;Madrid;046;Collado Mediano;6958;3441;3517;2019
28;Madrid;047;Collado Villalba;63679;30947;32732;2019
28;Madrid;043;Colmenar de Oreja;8032;4052;3980;2019
28;Madrid;042;Colmenar del Arroyo;1725;893;832;2019
28;Madrid;045;Colmenar Viejo;50752;25045;25707;2019
28;Madrid;044;Colmenarejo;9130;4471;4659;2019
28;Madrid;048;Corpa;713;372;341;2019
28;Madrid;049;Coslada;81661;39988;41673;2019
28;Madrid;050;Cubas de la Sagra;6413;3202;3211;2019
28;Madrid;053;Daganzo de Arriba;10205;5079;5126;2019
28;Madrid;054;Escorial, El;16162;8004;8158;2019
28;Madrid;055;Estremera;1260;637;623;2019
28;Madrid;056;Fresnedillas de la Oliva;1572;797;775;2019
28;Madrid;057;Fresno de Torote;2221;1164;1057;2019
28;Madrid;058;Fuenlabrada;193700;95409;98291;2019
28;Madrid;059;Fuente el Saz de Jarama;6696;3379;3317;2019
28;Madrid;060;Fuentidueña de Tajo;2053;1023;1030;2019
28;Madrid;061;Galapagar;33742;16470;17272;2019
28;Madrid;062;Garganta de los Montes;347;189;158;2019
28;Madrid;063;Gargantilla del Lozoya y Pinilla de Buitrago;316;170;146;2019
28;Madrid;064;Gascones;193;110;83;2019
28;Madrid;065;Getafe;183374;89701;93673;2019
28;Madrid;066;Griñón;10319;5157;5162;2019
28;Madrid;067;Guadalix de la Sierra;6214;3136;3078;2019
28;Madrid;068;Guadarrama;16032;7921;8111;2019
28;Madrid;069;Hiruela, La;57;39;18;2019
28;Madrid;070;Horcajo de la Sierra-Aoslos;145;78;67;2019
28;Madrid;071;Horcajuelo de la Sierra;86;47;39;2019
28;Madrid;072;Hoyo de Manzanares;8434;4226;4208;2019
28;Madrid;073;Humanes de Madrid;19743;9893;9850;2019
28;Madrid;074;Leganés;189861;91999;97862;2019
28;Madrid;075;Loeches;8791;4400;4391;2019
28;Madrid;076;Lozoya;581;309;272;2019
28;Madrid;901;Lozoyuela-Navas-Sieteiglesias;1299;670;629;2019
28;Madrid;078;Madarcos;48;30;18;2019
28;Madrid;079;Madrid;3266126;1520153;1745973;2019
28;Madrid;080;Majadahonda;71826;34018;37808;2019
28;Madrid;082;Manzanares el Real;8840;4474;4366;2019
28;Madrid;083;Meco;14305;7211;7094;2019
28;Madrid;084;Mejorada del Campo;23274;11540;11734;2019
28;Madrid;085;Miraflores de la Sierra;6108;3133;2975;2019
28;Madrid;086;Molar, El;8938;4557;4381;2019
28;Madrid;087;Molinos, Los;4389;2160;2229;2019
28;Madrid;088;Montejo de la Sierra;353;178;175;2019
28;Madrid;089;Moraleja de Enmedio;5136;2548;2588;2019
28;Madrid;090;Moralzarzal;13026;6527;6499;2019
28;Madrid;091;Morata de Tajuña;7683;3836;3847;2019
28;Madrid;092;Móstoles;209184;101905;107279;2019
28;Madrid;093;Navacerrada;2972;1493;1479;2019
28;Madrid;094;Navalafuente;1449;744;705;2019
28;Madrid;095;Navalagamella;2610;1350;1260;2019
28;Madrid;096;Navalcarnero;29298;14585;14713;2019
28;Madrid;097;Navarredonda y San Mamés;129;84;45;2019
28;Madrid;099;Navas del Rey;2918;1535;1383;2019
28;Madrid;100;Nuevo Baztán;6276;3191;3085;2019
28;Madrid;101;Olmeda de las Fuentes;348;185;163;2019
28;Madrid;102;Orusco de Tajuña;1244;637;607;2019
28;Madrid;104;Paracuellos de Jarama;25269;12703;12566;2019
28;Madrid;106;Parla;130124;64802;65322;2019
28;Madrid;107;Patones;541;254;287;2019
28;Madrid;108;Pedrezuela;5892;2936;2956;2019
28;Madrid;109;Pelayos de la Presa;2596;1316;1280;2019
28;Madrid;110;Perales de Tajuña;2935;1480;1455;2019
28;Madrid;111;Pezuela de las Torres;842;449;393;2019
28;Madrid;112;Pinilla del Valle;191;109;82;2019
28;Madrid;113;Pinto;52526;25964;26562;2019
28;Madrid;114;Piñuécar-Gandullas;185;95;90;2019
28;Madrid;115;Pozuelo de Alarcón;86422;41354;45068;2019
28;Madrid;116;Pozuelo del Rey;1147;603;544;2019
28;Madrid;117;Prádena del Rincón;117;65;52;2019
28;Madrid;118;Puebla de la Sierra;65;38;27;2019
28;Madrid;902;Puentes Viejas;679;378;301;2019
28;Madrid;119;Quijorna;3439;1720;1719;2019
28;Madrid;120;Rascafría;1664;918;746;2019
28;Madrid;121;Redueña;260;141;119;2019
28;Madrid;122;Ribatejada;783;399;384;2019
28;Madrid;123;Rivas-Vaciamadrid;88150;43696;44454;2019
28;Madrid;124;Robledillo de la Jara;80;44;36;2019
28;Madrid;125;Robledo de Chavela;4270;2213;2057;2019
28;Madrid;126;Robregordo;58;35;23;2019
28;Madrid;127;Rozas de Madrid, Las;95814;46285;49529;2019
28;Madrid;128;Rozas de Puerto Real;530;306;224;2019
28;Madrid;129;San Agustín del Guadalix;13379;6565;6814;2019
28;Madrid;130;San Fernando de Henares;39432;19180;20252;2019
28;Madrid;131;San Lorenzo de El Escorial;18369;8803;9566;2019
28;Madrid;132;San Martín de la Vega;19170;9808;9362;2019
28;Madrid;133;San Martín de Valdeiglesias;8459;4204;4255;2019
28;Madrid;134;San Sebastián de los Reyes;89276;43550;45726;2019
28;Madrid;135;Santa María de la Alameda;1254;665;589;2019
28;Madrid;136;Santorcaz;886;467;419;2019
28;Madrid;137;Santos de la Humosa, Los;2590;1320;1270;2019
28;Madrid;138;Serna del Monte, La;81;42;39;2019
28;Madrid;140;Serranillos del Valle;4165;2060;2105;2019
28;Madrid;141;Sevilla la Nueva;9318;4546;4772;2019
28;Madrid;143;Somosierra;86;50;36;2019
28;Madrid;144;Soto del Real;8799;4302;4497;2019
28;Madrid;145;Talamanca de Jarama;3857;1906;1951;2019
28;Madrid;146;Tielmes;2650;1353;1297;2019
28;Madrid;147;Titulcia;1313;686;627;2019
28;Madrid;148;Torrejón de Ardoz;131376;64749;66627;2019
28;Madrid;149;Torrejón de la Calzada;8872;4385;4487;2019
28;Madrid;150;Torrejón de Velasco;4382;2181;2201;2019
28;Madrid;151;Torrelaguna;4760;2388;2372;2019
28;Madrid;152;Torrelodones;23717;11465;12252;2019
28;Madrid;153;Torremocha de Jarama;1019;514;505;2019
28;Madrid;154;Torres de la Alameda;7779;3973;3806;2019
28;Madrid;903;Tres Cantos;47722;23141;24581;2019
28;Madrid;155;Valdaracete;609;313;296;2019
28;Madrid;156;Valdeavero;1554;806;748;2019
28;Madrid;157;Valdelaguna;937;469;468;2019
28;Madrid;158;Valdemanco;914;480;434;2019
28;Madrid;159;Valdemaqueda;781;405;376;2019
28;Madrid;160;Valdemorillo;12518;6306;6212;2019
28;Madrid;161;Valdemoro;75983;37493;38490;2019
28;Madrid;162;Valdeolmos-Alalpardo;4136;2130;2006;2019
28;Madrid;163;Valdepiélagos;584;315;269;2019
28;Madrid;164;Valdetorres de Jarama;4497;2277;2220;2019
28;Madrid;165;Valdilecha;2933;1517;1416;2019
28;Madrid;166;Valverde de Alcalá;465;239;226;2019
28;Madrid;167;Velilla de San Antonio;12236;6178;6058;2019
28;Madrid;168;Vellón, El;1958;1022;936;2019
28;Madrid;169;Venturada;2163;1135;1028;2019
28;Madrid;171;Villa del Prado;6520;3309;3211;2019
28;Madrid;170;Villaconejos;3388;1745;1643;2019
28;Madrid;172;Villalbilla;13878;7002;6876;2019
28;Madrid;173;Villamanrique de Tajo;703;352;351;2019
28;Madrid;174;Villamanta;2555;1299;1256;2019
28;Madrid;175;Villamantilla;1441;709;732;2019
28;Madrid;176;Villanueva de la Cañada;21445;10430;11015;2019
28;Madrid;178;Villanueva de Perales;1563;801;762;2019
28;Madrid;177;Villanueva del Pardillo;17180;8389;8791;2019
28;Madrid;179;Villar del Olmo;2011;1003;1008;2019
28;Madrid;180;Villarejo de Salvanés;7335;3692;3643;2019
28;Madrid;181;Villaviciosa de Odón;27835;13493;14342;2019
28;Madrid;182;Villavieja del Lozoya;253;136;117;2019
28;Madrid;183;Zarzalejo;1658;853;805;2019
29;Málaga;001;Alameda;5372;2735;2637;2019
29;Málaga;002;Alcaucín;2230;1140;1090;2019
29;Málaga;003;Alfarnate;1069;546;523;2019
29;Málaga;004;Alfarnatejo;377;193;184;2019
29;Málaga;005;Algarrobo;6444;3238;3206;2019
29;Málaga;006;Algatocín;793;410;383;2019
29;Málaga;007;Alhaurín de la Torre;40345;20047;20298;2019
29;Málaga;008;Alhaurín el Grande;24705;12344;12361;2019
29;Málaga;009;Almáchar;1811;944;867;2019
29;Málaga;010;Almargen;1954;995;959;2019
29;Málaga;011;Almogía;3715;1922;1793;2019
29;Málaga;012;Álora;12985;6572;6413;2019
29;Málaga;013;Alozaina;2051;1050;1001;2019
29;Málaga;014;Alpandeire;260;131;129;2019
29;Málaga;015;Antequera;41239;20180;21059;2019
29;Málaga;016;Árchez;385;202;183;2019
29;Málaga;017;Archidona;8238;4213;4025;2019
29;Málaga;018;Ardales;2500;1273;1227;2019
29;Málaga;019;Arenas;1156;611;545;2019
29;Málaga;020;Arriate;4102;2033;2069;2019
29;Málaga;021;Atajate;168;91;77;2019
29;Málaga;022;Benadalid;215;108;107;2019
29;Málaga;023;Benahavís;8085;4043;4042;2019
29;Málaga;024;Benalauría;438;231;207;2019
29;Málaga;025;Benalmádena;68128;33521;34607;2019
29;Málaga;026;Benamargosa;1514;788;726;2019
29;Málaga;027;Benamocarra;3011;1509;1502;2019
29;Málaga;028;Benaoján;1476;765;711;2019
29;Málaga;029;Benarrabá;455;230;225;2019
29;Málaga;030;Borge, El;930;483;447;2019
29;Málaga;031;Burgo, El;1800;929;871;2019
29;Málaga;032;Campillos;8444;4270;4174;2019
29;Málaga;033;Canillas de Aceituno;1677;890;787;2019
29;Málaga;034;Canillas de Albaida;716;355;361;2019
29;Málaga;035;Cañete la Real;1665;846;819;2019
29;Málaga;036;Carratraca;731;383;348;2019
29;Málaga;037;Cartajima;253;136;117;2019
29;Málaga;038;Cártama;26259;13266;12993;2019
29;Málaga;039;Casabermeja;3522;1844;1678;2019
29;Málaga;040;Casarabonela;2502;1336;1166;2019
29;Málaga;041;Casares;6515;3355;3160;2019
29;Málaga;042;Coín;22147;11094;11053;2019
29;Málaga;043;Colmenar;3376;1728;1648;2019
29;Málaga;044;Comares;1315;704;611;2019
29;Málaga;045;Cómpeta;3922;1958;1964;2019
29;Málaga;046;Cortes de la Frontera;3101;1592;1509;2019
29;Málaga;047;Cuevas Bajas;1395;696;699;2019
29;Málaga;049;Cuevas de San Marcos;3648;1838;1810;2019
29;Málaga;048;Cuevas del Becerro;1589;785;804;2019
29;Málaga;050;Cútar;607;309;298;2019
29;Málaga;051;Estepona;68286;33508;34778;2019
29;Málaga;052;Faraján;253;124;129;2019
29;Málaga;053;Frigiliana;3009;1503;1506;2019
29;Málaga;054;Fuengirola;80309;39217;41092;2019
29;Málaga;055;Fuente de Piedra;2596;1330;1266;2019
29;Málaga;056;Gaucín;1576;820;756;2019
29;Málaga;057;Genalguacil;410;205;205;2019
29;Málaga;058;Guaro;2260;1137;1123;2019
29;Málaga;059;Humilladero;3286;1630;1656;2019
29;Málaga;060;Igualeja;763;381;382;2019
29;Málaga;061;Istán;1469;732;737;2019
29;Málaga;062;Iznate;868;453;415;2019
29;Málaga;063;Jimera de Líbar;372;192;180;2019
29;Málaga;064;Jubrique;528;266;262;2019
29;Málaga;065;Júzcar;232;133;99;2019
29;Málaga;066;Macharaviaya;480;259;221;2019
29;Málaga;067;Málaga;574654;276001;298653;2019
29;Málaga;068;Manilva;15528;7856;7672;2019
29;Málaga;069;Marbella;143386;68944;74442;2019
29;Málaga;070;Mijas;82742;41196;41546;2019
29;Málaga;071;Moclinejo;1271;657;614;2019
29;Málaga;072;Mollina;5149;2585;2564;2019
29;Málaga;073;Monda;2594;1336;1258;2019
29;Málaga;903;Montecorto;593;317;276;2019
29;Málaga;074;Montejaque;964;478;486;2019
29;Málaga;075;Nerja;21091;10410;10681;2019
29;Málaga;076;Ojén;3702;1888;1814;2019
29;Málaga;077;Parauta;251;126;125;2019
29;Málaga;079;Periana;3048;1602;1446;2019
29;Málaga;080;Pizarra;9226;4636;4590;2019
29;Málaga;081;Pujerra;301;158;143;2019
29;Málaga;082;Rincón de la Victoria;47179;23163;24016;2019
29;Málaga;083;Riogordo;2724;1429;1295;2019
29;Málaga;084;Ronda;33877;16427;17450;2019
29;Málaga;085;Salares;169;87;82;2019
29;Málaga;086;Sayalonga;1681;863;818;2019
29;Málaga;087;Sedella;606;341;265;2019
29;Málaga;904;Serrato;477;240;237;2019
29;Málaga;088;Sierra de Yeguas;3346;1690;1656;2019
29;Málaga;089;Teba;3760;1887;1873;2019
29;Málaga;090;Tolox;2107;1061;1046;2019
29;Málaga;901;Torremolinos;68661;34276;34385;2019
29;Málaga;091;Torrox;17234;8704;8530;2019
29;Málaga;092;Totalán;746;380;366;2019
29;Málaga;093;Valle de Abdalajís;2542;1292;1250;2019
29;Málaga;094;Vélez-Málaga;81643;40239;41404;2019
29;Málaga;095;Villanueva de Algaidas;4176;2143;2033;2019
29;Málaga;902;Villanueva de la Concepción;3296;1612;1684;2019
29;Málaga;098;Villanueva de Tapia;1476;744;732;2019
29;Málaga;096;Villanueva del Rosario;3356;1649;1707;2019
29;Málaga;097;Villanueva del Trabuco;5299;2659;2640;2019
29;Málaga;099;Viñuela;2034;1061;973;2019
29;Málaga;100;Yunquera;2864;1460;1404;2019
52;Melilla;001;Melilla;86487;43894;42593;2019
30;Murcia;001;Abanilla;6127;3112;3015;2019
30;Murcia;002;Abarán;12964;6479;6485;2019
30;Murcia;003;Águilas;35301;17620;17681;2019
30;Murcia;004;Albudeite;1373;694;679;2019
30;Murcia;005;Alcantarilla;42048;20794;21254;2019
30;Murcia;902;Alcázares, Los;16138;8238;7900;2019
30;Murcia;006;Aledo;1022;505;517;2019
30;Murcia;007;Alguazas;9638;4957;4681;2019
30;Murcia;008;Alhama de Murcia;22077;11168;10909;2019
30;Murcia;009;Archena;19301;10155;9146;2019
30;Murcia;010;Beniel;11318;5848;5470;2019
30;Murcia;011;Blanca;6539;3328;3211;2019
30;Murcia;012;Bullas;11530;5795;5735;2019
30;Murcia;013;Calasparra;10178;5147;5031;2019
30;Murcia;014;Campos del Río;2028;956;1072;2019
30;Murcia;015;Caravaca de la Cruz;25760;12903;12857;2019
30;Murcia;016;Cartagena;214802;106951;107851;2019
30;Murcia;017;Cehegín;14983;7537;7446;2019
30;Murcia;018;Ceutí;11787;5938;5849;2019
30;Murcia;019;Cieza;34988;17533;17455;2019
30;Murcia;020;Fortuna;10112;5412;4700;2019
30;Murcia;021;Fuente Álamo de Murcia;16583;8611;7972;2019
30;Murcia;022;Jumilla;25600;13305;12295;2019
30;Murcia;023;Librilla;5305;2728;2577;2019
30;Murcia;024;Lorca;94404;48331;46073;2019
30;Murcia;025;Lorquí;7141;3611;3530;2019
30;Murcia;026;Mazarrón;32209;16654;15555;2019
30;Murcia;027;Molina de Segura;71890;35862;36028;2019
30;Murcia;028;Moratalla;7839;3978;3861;2019
30;Murcia;029;Mula;16883;8671;8212;2019
30;Murcia;030;Murcia;453258;221543;231715;2019
30;Murcia;031;Ojós;500;260;240;2019
30;Murcia;032;Pliego;3847;1991;1856;2019
30;Murcia;033;Puerto Lumbreras;15394;7778;7616;2019
30;Murcia;034;Ricote;1264;675;589;2019
30;Murcia;035;San Javier;32489;16318;16171;2019
30;Murcia;036;San Pedro del Pinatar;25476;12828;12648;2019
30;Murcia;901;Santomera;16206;8124;8082;2019
30;Murcia;037;Torre-Pacheco;35676;18477;17199;2019
30;Murcia;038;Torres de Cotillas, Las;21471;10909;10562;2019
30;Murcia;039;Totana;32008;16455;15553;2019
30;Murcia;040;Ulea;874;453;421;2019
30;Murcia;041;Unión, La;20225;10271;9954;2019
30;Murcia;042;Villanueva del Río Segura;2910;1445;1465;2019
30;Murcia;043;Yecla;34432;17267;17165;2019
31;Navarra;001;Abáigar;83;48;35;2019
31;Navarra;002;Abárzuza/Abartzuza;538;265;273;2019
31;Navarra;003;Abaurregaina/Abaurrea Alta;126;77;49;2019
31;Navarra;004;Abaurrepea/Abaurrea Baja;32;19;13;2019
31;Navarra;005;Aberin;359;193;166;2019
31;Navarra;006;Ablitas;2481;1252;1229;2019
31;Navarra;007;Adiós;155;87;68;2019
31;Navarra;008;Aguilar de Codés;67;39;28;2019
31;Navarra;009;Aibar/Oibar;805;425;380;2019
31;Navarra;011;Allín/Allin;872;465;407;2019
31;Navarra;012;Allo;968;481;487;2019
31;Navarra;010;Altsasu/Alsasua;7443;3761;3682;2019
31;Navarra;013;Améscoa Baja;724;393;331;2019
31;Navarra;014;Ancín/Antzin;337;192;145;2019
31;Navarra;015;Andosilla;2743;1397;1346;2019
31;Navarra;016;Ansoáin/Antsoain;10833;5312;5521;2019
31;Navarra;017;Anue;482;257;225;2019
31;Navarra;018;Añorbe;581;317;264;2019
31;Navarra;019;Aoiz/Agoitz;2695;1376;1319;2019
31;Navarra;020;Araitz;512;285;227;2019
31;Navarra;025;Arakil;933;487;446;2019
31;Navarra;021;Aranarache/Aranaratxe;72;42;30;2019
31;Navarra;023;Aranguren;10859;5468;5391;2019
31;Navarra;024;Arano;116;63;53;2019
31;Navarra;022;Arantza;597;316;281;2019
31;Navarra;026;Aras;153;81;72;2019
31;Navarra;027;Arbizu;1104;565;539;2019
31;Navarra;028;Arce/Artzi;262;138;124;2019
31;Navarra;029;Arcos, Los;1134;558;576;2019
31;Navarra;030;Arellano;157;85;72;2019
31;Navarra;031;Areso;279;142;137;2019
31;Navarra;032;Arguedas;2272;1155;1117;2019
31;Navarra;033;Aria;51;29;22;2019
31;Navarra;034;Aribe;33;19;14;2019
31;Navarra;035;Armañanzas;53;28;25;2019
31;Navarra;036;Arróniz;1051;559;492;2019
31;Navarra;037;Arruazu;110;58;52;2019
31;Navarra;038;Artajona;1675;854;821;2019
31;Navarra;039;Artazu;116;61;55;2019
31;Navarra;040;Atez/Atetz;215;119;96;2019
31;Navarra;058;Auritz/Burguete;231;118;113;2019
31;Navarra;041;Ayegui/Aiegi;2366;1230;1136;2019
31;Navarra;042;Azagra;3843;1947;1896;2019
31;Navarra;043;Azuelo;31;12;19;2019
31;Navarra;044;Bakaiku;362;188;174;2019
31;Navarra;901;Barañáin/Barañain;20199;9772;10427;2019
31;Navarra;045;Barásoain;621;329;292;2019
31;Navarra;046;Barbarin;55;27;28;2019
31;Navarra;047;Bargota;257;123;134;2019
31;Navarra;048;Barillas;214;115;99;2019
31;Navarra;049;Basaburua;834;479;355;2019
31;Navarra;050;Baztan;7777;3929;3848;2019
31;Navarra;137;Beintza-Labaien;220;128;92;2019
31;Navarra;051;Beire;286;151;135;2019
31;Navarra;052;Belascoáin;122;62;60;2019
31;Navarra;250;Bera;3736;1830;1906;2019
31;Navarra;053;Berbinzana;655;332;323;2019
31;Navarra;905;Beriáin;4069;2018;2051;2019
31;Navarra;902;Berrioplano/Berriobeiti;7256;3696;3560;2019
31;Navarra;903;Berriozar;10426;5251;5175;2019
31;Navarra;054;Bertizarana;612;302;310;2019
31;Navarra;055;Betelu;366;191;175;2019
31;Navarra;253;Bidaurreta;163;89;74;2019
31;Navarra;056;Biurrun-Olcoz;214;120;94;2019
31;Navarra;057;Buñuel;2219;1081;1138;2019
31;Navarra;059;Burgui/Burgi;207;119;88;2019
31;Navarra;060;Burlada/Burlata;19096;9223;9873;2019
31;Navarra;061;Busto, El;56;27;29;2019
31;Navarra;062;Cabanillas;1357;717;640;2019
31;Navarra;063;Cabredo;91;49;42;2019
31;Navarra;064;Cadreita;1964;1008;956;2019
31;Navarra;065;Caparroso;2766;1458;1308;2019
31;Navarra;066;Cárcar;1069;541;528;2019
31;Navarra;067;Carcastillo;2495;1269;1226;2019
31;Navarra;068;Cascante;3864;1937;1927;2019
31;Navarra;069;Cáseda;974;489;485;2019
31;Navarra;070;Castejón;4163;2090;2073;2019
31;Navarra;071;Castillonuevo;16;11;5;2019
31;Navarra;193;Cendea de Olza/Oltza Zendea;1831;901;930;2019
31;Navarra;072;Cintruénigo;7903;4071;3832;2019
31;Navarra;074;Cirauqui/Zirauki;487;254;233;2019
31;Navarra;075;Ciriza/Ziritza;155;72;83;2019
31;Navarra;076;Cizur;3888;1999;1889;2019
31;Navarra;077;Corella;7971;4007;3964;2019
31;Navarra;078;Cortes;3151;1598;1553;2019
31;Navarra;079;Desojo;79;44;35;2019
31;Navarra;080;Dicastillo;604;305;299;2019
31;Navarra;081;Donamaria;433;218;215;2019
31;Navarra;221;Doneztebe/Santesteban;1726;880;846;2019
31;Navarra;083;Echarri/Etxarri;75;36;39;2019
31;Navarra;087;Elgorriaga;220;111;109;2019
31;Navarra;089;Enériz/Eneritz;286;147;139;2019
31;Navarra;090;Eratsun;151;92;59;2019
31;Navarra;091;Ergoiena;372;202;170;2019
31;Navarra;092;Erro;800;449;351;2019
31;Navarra;094;Eslava;111;51;60;2019
31;Navarra;095;Esparza de Salazar/Espartza Zaraitzu;74;40;34;2019
31;Navarra;096;Espronceda;104;58;46;2019
31;Navarra;097;Estella-Lizarra;13810;6608;7202;2019
31;Navarra;098;Esteribar;2702;1396;1306;2019
31;Navarra;099;Etayo;58;31;27;2019
31;Navarra;082;Etxalar;813;427;386;2019
31;Navarra;084;Etxarri Aranatz;2483;1290;1193;2019
31;Navarra;085;Etxauri;650;331;319;2019
31;Navarra;100;Eulate;284;158;126;2019
31;Navarra;101;Ezcabarte;1805;944;861;2019
31;Navarra;093;Ezcároz/Ezkaroze;306;166;140;2019
31;Navarra;102;Ezkurra;146;95;51;2019
31;Navarra;103;Ezprogui;43;23;20;2019
31;Navarra;104;Falces;2315;1185;1130;2019
31;Navarra;105;Fitero;2011;1005;1006;2019
31;Navarra;106;Fontellas;996;501;495;2019
31;Navarra;107;Funes;2440;1285;1155;2019
31;Navarra;108;Fustiñana;2490;1236;1254;2019
31;Navarra;109;Galar;2273;1193;1080;2019
31;Navarra;110;Gallipienzo/Galipentzu;98;55;43;2019
31;Navarra;111;Gallués/Galoze;93;63;30;2019
31;Navarra;112;Garaioa;91;51;40;2019
31;Navarra;113;Garde;139;83;56;2019
31;Navarra;114;Garínoain;499;263;236;2019
31;Navarra;115;Garralda;190;100;90;2019
31;Navarra;116;Genevilla;70;43;27;2019
31;Navarra;117;Goizueta;704;379;325;2019
31;Navarra;118;Goñi;158;103;55;2019
31;Navarra;119;Güesa/Gorza;38;22;16;2019
31;Navarra;120;Guesálaz/Gesalatz;432;254;178;2019
31;Navarra;121;Guirguillano;78;43;35;2019
31;Navarra;256;Hiriberri/Villanueva de Aezkoa;102;54;48;2019
31;Navarra;122;Huarte/Uharte;7101;3580;3521;2019
31;Navarra;124;Ibargoiti;249;148;101;2019
31;Navarra;259;Igantzi;639;339;300;2019
31;Navarra;125;Igúzquiza;325;170;155;2019
31;Navarra;126;Imotz;423;223;200;2019
31;Navarra;127;Irañeta;172;91;81;2019
31;Navarra;904;Irurtzun;2233;1153;1080;2019
31;Navarra;128;Isaba/Izaba;395;196;199;2019
31;Navarra;129;Ituren;511;259;252;2019
31;Navarra;130;Iturmendi;403;208;195;2019
31;Navarra;131;Iza/Itza;1235;666;569;2019
31;Navarra;132;Izagaondoa;176;114;62;2019
31;Navarra;133;Izalzu/Itzaltzu;40;23;17;2019
31;Navarra;134;Jaurrieta;189;107;82;2019
31;Navarra;135;Javier;110;28;82;2019
31;Navarra;136;Juslapeña;563;308;255;2019
31;Navarra;138;Lakuntza;1279;678;601;2019
31;Navarra;139;Lana;169;98;71;2019
31;Navarra;140;Lantz;148;88;60;2019
31;Navarra;141;Lapoblación;120;68;52;2019
31;Navarra;142;Larraga;2075;1088;987;2019
31;Navarra;143;Larraona;102;49;53;2019
31;Navarra;144;Larraun;951;522;429;2019
31;Navarra;145;Lazagurría;189;97;92;2019
31;Navarra;146;Leache/Leatxe;30;17;13;2019
31;Navarra;147;Legarda;117;65;52;2019
31;Navarra;148;Legaria;111;50;61;2019
31;Navarra;149;Leitza;2913;1513;1400;2019
31;Navarra;908;Lekunberri;1536;769;767;2019
31;Navarra;150;Leoz/Leotz;220;142;78;2019
31;Navarra;151;Lerga;55;35;20;2019
31;Navarra;152;Lerín;1725;887;838;2019
31;Navarra;153;Lesaka;2741;1407;1334;2019
31;Navarra;154;Lezaun;242;146;96;2019
31;Navarra;155;Liédena;292;144;148;2019
31;Navarra;156;Lizoáin-Arriasgoiti;295;172;123;2019
31;Navarra;157;Lodosa;4816;2442;2374;2019
31;Navarra;158;Lónguida/Longida;298;159;139;2019
31;Navarra;159;Lumbier;1318;716;602;2019
31;Navarra;160;Luquin;132;70;62;2019
31;Navarra;248;Luzaide/Valcarlos;329;178;151;2019
31;Navarra;161;Mañeru;434;229;205;2019
31;Navarra;162;Marañón;52;26;26;2019
31;Navarra;163;Marcilla;2858;1447;1411;2019
31;Navarra;164;Mélida;733;374;359;2019
31;Navarra;165;Mendavia;3547;1824;1723;2019
31;Navarra;166;Mendaza;287;149;138;2019
31;Navarra;167;Mendigorría;1086;563;523;2019
31;Navarra;168;Metauten;288;156;132;2019
31;Navarra;169;Milagro;3416;1773;1643;2019
31;Navarra;170;Mirafuentes;57;28;29;2019
31;Navarra;171;Miranda de Arga;839;437;402;2019
31;Navarra;172;Monreal/Elo;478;258;220;2019
31;Navarra;173;Monteagudo;1092;545;547;2019
31;Navarra;174;Morentin;129;62;67;2019
31;Navarra;175;Mues;75;43;32;2019
31;Navarra;176;Murchante;4154;2096;2058;2019
31;Navarra;177;Murieta;335;177;158;2019
31;Navarra;178;Murillo el Cuende;665;343;322;2019
31;Navarra;179;Murillo el Fruto;639;346;293;2019
31;Navarra;180;Muruzábal;233;101;132;2019
31;Navarra;181;Navascués/Nabaskoze;132;80;52;2019
31;Navarra;182;Nazar;34;20;14;2019
31;Navarra;088;Noáin (Valle de Elorz)/Noain (Elortzibar);8320;4185;4135;2019
31;Navarra;183;Obanos;935;467;468;2019
31;Navarra;185;Ochagavía/Otsagabia;521;281;240;2019
31;Navarra;184;Oco;77;39;38;2019
31;Navarra;186;Odieta;362;202;160;2019
31;Navarra;187;Oiz;129;79;50;2019
31;Navarra;188;Olaibar;378;220;158;2019
31;Navarra;189;Olazti/Olazagutía;1489;753;736;2019
31;Navarra;190;Olejua;50;27;23;2019
31;Navarra;191;Olite/Erriberri;3946;2001;1945;2019
31;Navarra;192;Olóriz/Oloritz;203;115;88;2019
31;Navarra;195;Orbaizeta;195;97;98;2019
31;Navarra;196;Orbara;33;17;16;2019
31;Navarra;197;Orísoain;79;43;36;2019
31;Navarra;906;Orkoien;4057;2057;2000;2019
31;Navarra;198;Oronz/Orontze;47;24;23;2019
31;Navarra;199;Oroz-Betelu/Orotz-Betelu;146;85;61;2019
31;Navarra;211;Orreaga/Roncesvalles;22;12;10;2019
31;Navarra;200;Oteiza;918;489;429;2019
31;Navarra;201;Pamplona/Iruña;201653;95316;106337;2019
31;Navarra;202;Peralta/Azkoien;5893;2979;2914;2019
31;Navarra;203;Petilla de Aragón;31;17;14;2019
31;Navarra;204;Piedramillera;37;24;13;2019
31;Navarra;205;Pitillas;484;242;242;2019
31;Navarra;206;Puente la Reina/Gares;2840;1424;1416;2019
31;Navarra;207;Pueyo;351;192;159;2019
31;Navarra;208;Ribaforada;3750;1953;1797;2019
31;Navarra;209;Romanzado;175;92;83;2019
31;Navarra;210;Roncal/Erronkari;211;108;103;2019
31;Navarra;212;Sada;133;75;58;2019
31;Navarra;213;Saldías;122;68;54;2019
31;Navarra;214;Salinas de Oro/Jaitz;109;62;47;2019
31;Navarra;215;San Adrián;6292;3116;3176;2019
31;Navarra;217;San Martín de Unx;392;207;185;2019
31;Navarra;216;Sangüesa/Zangoza;4962;2519;2443;2019
31;Navarra;219;Sansol;102;55;47;2019
31;Navarra;220;Santacara;874;456;418;2019
31;Navarra;222;Sarriés/Sartze;58;38;20;2019
31;Navarra;223;Sartaguda;1315;677;638;2019
31;Navarra;224;Sesma;1164;596;568;2019
31;Navarra;225;Sorlada;57;35;22;2019
31;Navarra;226;Sunbilla;675;347;328;2019
31;Navarra;227;Tafalla;10595;5224;5371;2019
31;Navarra;228;Tiebas-Muruarte de Reta;606;315;291;2019
31;Navarra;229;Tirapu;40;25;15;2019
31;Navarra;230;Torralba del Río;103;55;48;2019
31;Navarra;231;Torres del Río;126;62;64;2019
31;Navarra;232;Tudela;36258;17840;18418;2019
31;Navarra;233;Tulebras;128;51;77;2019
31;Navarra;234;Ucar;184;102;82;2019
31;Navarra;123;Uharte Arakil;805;429;376;2019
31;Navarra;235;Ujué/Uxue;182;104;78;2019
31;Navarra;236;Ultzama;1653;851;802;2019
31;Navarra;237;Unciti;211;120;91;2019
31;Navarra;238;Unzué/Untzue;144;78;66;2019
31;Navarra;239;Urdazubi/Urdax;349;170;179;2019
31;Navarra;240;Urdiain;653;335;318;2019
31;Navarra;241;Urraul Alto;133;87;46;2019
31;Navarra;242;Urraul Bajo;322;140;182;2019
31;Navarra;244;Urroz;183;103;80;2019
31;Navarra;243;Urroz-Villa;377;194;183;2019
31;Navarra;245;Urzainqui/Urzainki;84;54;30;2019
31;Navarra;246;Uterga;153;88;65;2019
31;Navarra;247;Uztárroz/Uztarroze;151;79;72;2019
31;Navarra;086;Valle de Egüés/Eguesibar;21128;10611;10517;2019
31;Navarra;194;Valle de Ollo/Ollaran;421;233;188;2019
31;Navarra;260;Valle de Yerri/Deierri;1506;790;716;2019
31;Navarra;249;Valtierra;2412;1216;1196;2019
31;Navarra;251;Viana;4209;2130;2079;2019
31;Navarra;252;Vidángoz/Bidankoze;90;51;39;2019
31;Navarra;254;Villafranca;2847;1438;1409;2019
31;Navarra;255;Villamayor de Monjardín;119;61;58;2019
31;Navarra;257;Villatuerta;1191;597;594;2019
31;Navarra;258;Villava/Atarrabia;10204;4965;5239;2019
31;Navarra;261;Yesa;292;172;120;2019
31;Navarra;262;Zabalza/Zabaltza;297;160;137;2019
31;Navarra;073;Ziordia;348;182;166;2019
31;Navarra;907;Zizur Mayor/Zizur Nagusia;14894;7256;7638;2019
31;Navarra;263;Zubieta;303;157;146;2019
31;Navarra;264;Zugarramurdi;219;108;111;2019
31;Navarra;265;Zúñiga;109;69;40;2019
32;Ourense;001;Allariz;6188;3109;3079;2019
32;Ourense;002;Amoeiro;2280;1140;1140;2019
32;Ourense;003;Arnoia, A;1000;497;503;2019
32;Ourense;004;Avión;1795;825;970;2019
32;Ourense;005;Baltar;962;521;441;2019
32;Ourense;006;Bande;1528;748;780;2019
32;Ourense;007;Baños de Molgas;1519;761;758;2019
32;Ourense;008;Barbadás;11037;5367;5670;2019
32;Ourense;009;Barco de Valdeorras, O;13395;6512;6883;2019
32;Ourense;010;Beade;397;207;190;2019
32;Ourense;011;Beariz;971;431;540;2019
32;Ourense;012;Blancos, Os;766;411;355;2019
32;Ourense;013;Boborás;2285;1091;1194;2019
32;Ourense;014;Bola, A;1156;545;611;2019
32;Ourense;015;Bolo, O;884;448;436;2019
32;Ourense;016;Calvos de Randín;770;383;387;2019
32;Ourense;018;Carballeda de Avia;1286;627;659;2019
32;Ourense;017;Carballeda de Valdeorras;1545;793;752;2019
32;Ourense;019;Carballiño, O;14027;6505;7522;2019
32;Ourense;020;Cartelle;2642;1298;1344;2019
32;Ourense;022;Castrelo de Miño;1349;683;666;2019
32;Ourense;021;Castrelo do Val;984;499;485;2019
32;Ourense;023;Castro Caldelas;1224;625;599;2019
32;Ourense;024;Celanova;5649;2676;2973;2019
32;Ourense;025;Cenlle;1120;561;559;2019
32;Ourense;029;Chandrexa de Queixa;456;259;197;2019
32;Ourense;026;Coles;3050;1536;1514;2019
32;Ourense;027;Cortegada;1085;539;546;2019
32;Ourense;028;Cualedro;1679;866;813;2019
32;Ourense;030;Entrimo;1140;538;602;2019
32;Ourense;031;Esgos;1116;577;539;2019
32;Ourense;033;Gomesende;732;356;376;2019
32;Ourense;034;Gudiña, A;1254;638;616;2019
32;Ourense;035;Irixo, O;1466;716;750;2019
32;Ourense;038;Larouco;429;207;222;2019
32;Ourense;039;Laza;1228;641;587;2019
32;Ourense;040;Leiro;1568;763;805;2019
32;Ourense;041;Lobeira;798;390;408;2019
32;Ourense;042;Lobios;1708;863;845;2019
32;Ourense;043;Maceda;2872;1408;1464;2019
32;Ourense;044;Manzaneda;870;422;448;2019
32;Ourense;045;Maside;2705;1337;1368;2019
32;Ourense;046;Melón;1184;565;619;2019
32;Ourense;047;Merca, A;1913;943;970;2019
32;Ourense;048;Mezquita, A;1023;530;493;2019
32;Ourense;049;Montederramo;711;368;343;2019
32;Ourense;050;Monterrei;2529;1293;1236;2019
32;Ourense;051;Muíños;1502;761;741;2019
32;Ourense;052;Nogueira de Ramuín;1998;1020;978;2019
32;Ourense;053;Oímbra;1712;934;778;2019
32;Ourense;054;Ourense;105233;47695;57538;2019
32;Ourense;055;Paderne de Allariz;1384;693;691;2019
32;Ourense;056;Padrenda;1748;860;888;2019
32;Ourense;057;Parada de Sil;538;287;251;2019
32;Ourense;058;Pereiro de Aguiar, O;6275;3211;3064;2019
32;Ourense;059;Peroxa, A;1819;897;922;2019
32;Ourense;060;Petín;861;420;441;2019
32;Ourense;061;Piñor;1176;595;581;2019
32;Ourense;063;Pobra de Trives, A;2067;1030;1037;2019
32;Ourense;064;Pontedeva;511;252;259;2019
32;Ourense;062;Porqueira;815;397;418;2019
32;Ourense;065;Punxín;693;342;351;2019
32;Ourense;066;Quintela de Leirado;619;274;345;2019
32;Ourense;067;Rairiz de Veiga;1266;648;618;2019
32;Ourense;068;Ramirás;1584;734;850;2019
32;Ourense;069;Ribadavia;5024;2459;2565;2019
32;Ourense;071;Riós;1516;774;742;2019
32;Ourense;072;Rúa, A;4314;2125;2189;2019
32;Ourense;073;Rubiá;1393;676;717;2019
32;Ourense;074;San Amaro;1089;537;552;2019
32;Ourense;075;San Cibrao das Viñas;5405;2752;2653;2019
32;Ourense;076;San Cristovo de Cea;2137;1050;1087;2019
32;Ourense;070;San Xoán de Río;531;270;261;2019
32;Ourense;077;Sandiás;1206;558;648;2019
32;Ourense;078;Sarreaus;1162;574;588;2019
32;Ourense;079;Taboadela;1429;734;695;2019
32;Ourense;080;Teixeira, A;316;159;157;2019
32;Ourense;081;Toén;2355;1209;1146;2019
32;Ourense;082;Trasmiras;1286;651;635;2019
32;Ourense;083;Veiga, A;889;453;436;2019
32;Ourense;084;Verea;943;453;490;2019
32;Ourense;085;Verín;13723;6580;7143;2019
32;Ourense;086;Viana do Bolo;2886;1458;1428;2019
32;Ourense;087;Vilamarín;1854;952;902;2019
32;Ourense;088;Vilamartín de Valdeorras;1790;914;876;2019
32;Ourense;089;Vilar de Barrio;1307;661;646;2019
32;Ourense;090;Vilar de Santos;820;401;419;2019
32;Ourense;091;Vilardevós;1846;948;898;2019
32;Ourense;092;Vilariño de Conso;519;303;216;2019
32;Ourense;032;Xinzo de Limia;9715;4744;4971;2019
32;Ourense;036;Xunqueira de Ambía;1375;689;686;2019
32;Ourense;037;Xunqueira de Espadanedo;745;370;375;2019
34;Palencia;001;Abarca de Campos;44;27;17;2019
34;Palencia;003;Abia de las Torres;165;89;76;2019
34;Palencia;004;Aguilar de Campoo;6744;3262;3482;2019
34;Palencia;005;Alar del Rey;934;454;480;2019
34;Palencia;006;Alba de Cerrato;87;47;40;2019
34;Palencia;009;Amayuelas de Arriba;35;22;13;2019
34;Palencia;010;Ampudia;605;310;295;2019
34;Palencia;011;Amusco;423;237;186;2019
34;Palencia;012;Antigüedad;363;191;172;2019
34;Palencia;015;Arconada;41;25;16;2019
34;Palencia;017;Astudillo;995;502;493;2019
34;Palencia;018;Autilla del Pino;222;119;103;2019
34;Palencia;019;Autillo de Campos;128;69;59;2019
34;Palencia;020;Ayuela;52;33;19;2019
34;Palencia;022;Baltanás;1191;623;568;2019
34;Palencia;024;Baquerín de Campos;30;18;12;2019
34;Palencia;025;Bárcena de Campos;59;26;33;2019
34;Palencia;027;Barruelo de Santullán;1186;589;597;2019
34;Palencia;028;Báscones de Ojeda;143;75;68;2019
34;Palencia;029;Becerril de Campos;727;373;354;2019
34;Palencia;031;Belmonte de Campos;30;15;15;2019
34;Palencia;032;Berzosilla;40;21;19;2019
34;Palencia;033;Boada de Campos;17;13;4;2019
34;Palencia;035;Boadilla de Rioseco;107;61;46;2019
34;Palencia;034;Boadilla del Camino;121;66;55;2019
34;Palencia;036;Brañosera;271;147;124;2019
34;Palencia;037;Buenavista de Valdavia;245;139;106;2019
34;Palencia;038;Bustillo de la Vega;293;159;134;2019
34;Palencia;039;Bustillo del Páramo de Carrión;60;37;23;2019
34;Palencia;041;Calahorra de Boedo;90;44;46;2019
34;Palencia;042;Calzada de los Molinos;330;183;147;2019
34;Palencia;045;Capillas;75;40;35;2019
34;Palencia;046;Cardeñosa de Volpejera;50;26;24;2019
34;Palencia;047;Carrión de los Condes;2069;985;1084;2019
34;Palencia;048;Castil de Vela;64;29;35;2019
34;Palencia;049;Castrejón de la Peña;345;188;157;2019
34;Palencia;050;Castrillo de Don Juan;207;117;90;2019
34;Palencia;051;Castrillo de Onielo;98;52;46;2019
34;Palencia;052;Castrillo de Villavega;174;96;78;2019
34;Palencia;053;Castromocho;225;116;109;2019
34;Palencia;055;Cervatos de la Cueza;280;153;127;2019
34;Palencia;056;Cervera de Pisuerga;2333;1161;1172;2019
34;Palencia;057;Cevico de la Torre;491;246;245;2019
34;Palencia;058;Cevico Navero;194;110;84;2019
34;Palencia;059;Cisneros;435;213;222;2019
34;Palencia;060;Cobos de Cerrato;143;80;63;2019
34;Palencia;061;Collazos de Boedo;102;60;42;2019
34;Palencia;062;Congosto de Valdavia;153;91;62;2019
34;Palencia;063;Cordovilla la Real;109;63;46;2019
34;Palencia;066;Cubillas de Cerrato;61;36;25;2019
34;Palencia;067;Dehesa de Montejo;133;78;55;2019
34;Palencia;068;Dehesa de Romanos;50;30;20;2019
34;Palencia;069;Dueñas;2612;1329;1283;2019
34;Palencia;070;Espinosa de Cerrato;144;77;67;2019
34;Palencia;071;Espinosa de Villagonzalo;172;91;81;2019
34;Palencia;072;Frechilla;147;71;76;2019
34;Palencia;073;Fresno del Río;189;93;96;2019
34;Palencia;074;Frómista;767;401;366;2019
34;Palencia;076;Fuentes de Nava;637;322;315;2019
34;Palencia;077;Fuentes de Valdepero;451;237;214;2019
34;Palencia;079;Grijota;2319;1214;1105;2019
34;Palencia;080;Guardo;5995;2980;3015;2019
34;Palencia;081;Guaza de Campos;60;37;23;2019
34;Palencia;082;Hérmedes de Cerrato;80;42;38;2019
34;Palencia;083;Herrera de Pisuerga;1966;959;1007;2019
34;Palencia;084;Herrera de Valdecañas;161;90;71;2019
34;Palencia;086;Hontoria de Cerrato;105;54;51;2019
34;Palencia;087;Hornillos de Cerrato;141;81;60;2019
34;Palencia;088;Husillos;320;181;139;2019
34;Palencia;089;Itero de la Vega;152;90;62;2019
34;Palencia;091;Lagartos;132;75;57;2019
34;Palencia;092;Lantadilla;283;151;132;2019
34;Palencia;094;Ledigos;64;31;33;2019
34;Palencia;903;Loma de Ucieza;195;113;82;2019
34;Palencia;096;Lomas;51;32;19;2019
34;Palencia;098;Magaz de Pisuerga;1005;530;475;2019
34;Palencia;099;Manquillos;66;36;30;2019
34;Palencia;100;Mantinos;141;79;62;2019
34;Palencia;101;Marcilla de Campos;46;21;25;2019
34;Palencia;102;Mazariegos;220;131;89;2019
34;Palencia;103;Mazuecos de Valdeginate;98;61;37;2019
34;Palencia;104;Melgar de Yuso;251;145;106;2019
34;Palencia;106;Meneses de Campos;124;67;57;2019
34;Palencia;107;Micieces de Ojeda;73;41;32;2019
34;Palencia;108;Monzón de Campos;592;309;283;2019
34;Palencia;109;Moratinos;65;37;28;2019
34;Palencia;110;Mudá;86;47;39;2019
34;Palencia;112;Nogal de las Huertas;41;21;20;2019
34;Palencia;113;Olea de Boedo;40;15;25;2019
34;Palencia;114;Olmos de Ojeda;197;120;77;2019
34;Palencia;116;Osornillo;56;30;26;2019
34;Palencia;901;Osorno la Mayor;1205;638;567;2019
34;Palencia;120;Palencia;78412;36990;41422;2019
34;Palencia;121;Palenzuela;206;116;90;2019
34;Palencia;122;Páramo de Boedo;126;72;54;2019
34;Palencia;123;Paredes de Nava;1885;969;916;2019
34;Palencia;124;Payo de Ojeda;67;39;28;2019
34;Palencia;125;Pedraza de Campos;82;41;41;2019
34;Palencia;126;Pedrosa de la Vega;300;168;132;2019
34;Palencia;127;Perales;87;49;38;2019
34;Palencia;904;Pernía, La;320;189;131;2019
34;Palencia;129;Pino del Río;174;106;68;2019
34;Palencia;130;Piña de Campos;217;109;108;2019
34;Palencia;131;Población de Arroyo;60;32;28;2019
34;Palencia;132;Población de Campos;129;73;56;2019
34;Palencia;133;Población de Cerrato;109;65;44;2019
34;Palencia;134;Polentinos;38;21;17;2019
34;Palencia;135;Pomar de Valdivia;470;260;210;2019
34;Palencia;136;Poza de la Vega;174;101;73;2019
34;Palencia;137;Pozo de Urama;24;16;8;2019
34;Palencia;139;Prádanos de Ojeda;191;102;89;2019
34;Palencia;140;Puebla de Valdavia, La;100;55;45;2019
34;Palencia;141;Quintana del Puente;263;143;120;2019
34;Palencia;143;Quintanilla de Onsoña;179;105;74;2019
34;Palencia;146;Reinoso de Cerrato;53;35;18;2019
34;Palencia;147;Renedo de la Vega;187;103;84;2019
34;Palencia;149;Requena de Campos;18;8;10;2019
34;Palencia;151;Respenda de la Peña;151;89;62;2019
34;Palencia;152;Revenga de Campos;152;79;73;2019
34;Palencia;154;Revilla de Collazos;77;43;34;2019
34;Palencia;155;Ribas de Campos;143;72;71;2019
34;Palencia;156;Riberos de la Cueza;54;34;20;2019
34;Palencia;157;Saldaña;2961;1512;1449;2019
34;Palencia;158;Salinas de Pisuerga;319;168;151;2019
34;Palencia;159;San Cebrián de Campos;415;232;183;2019
34;Palencia;160;San Cebrián de Mudá;156;88;68;2019
34;Palencia;161;San Cristóbal de Boedo;22;14;8;2019
34;Palencia;163;San Mamés de Campos;52;27;25;2019
34;Palencia;165;San Román de la Cuba;61;36;25;2019
34;Palencia;167;Santa Cecilia del Alcor;118;69;49;2019
34;Palencia;168;Santa Cruz de Boedo;48;30;18;2019
34;Palencia;169;Santervás de la Vega;442;253;189;2019
34;Palencia;170;Santibáñez de Ecla;52;29;23;2019
34;Palencia;171;Santibáñez de la Peña;1035;510;525;2019
34;Palencia;174;Santoyo;189;101;88;2019
34;Palencia;175;Serna, La;96;62;34;2019
34;Palencia;177;Soto de Cerrato;185;106;79;2019
34;Palencia;176;Sotobañado y Priorato;142;83;59;2019
34;Palencia;178;Tabanera de Cerrato;135;72;63;2019
34;Palencia;179;Tabanera de Valdavia;27;16;11;2019
34;Palencia;180;Támara de Campos;67;34;33;2019
34;Palencia;181;Tariego de Cerrato;481;255;226;2019
34;Palencia;182;Torquemada;954;526;428;2019
34;Palencia;184;Torremormojón;44;25;19;2019
34;Palencia;185;Triollo;67;36;31;2019
34;Palencia;186;Valbuena de Pisuerga;47;25;22;2019
34;Palencia;189;Valdeolmillos;57;32;25;2019
34;Palencia;190;Valderrábano;50;27;23;2019
34;Palencia;192;Valde-Ucieza;91;55;36;2019
34;Palencia;196;Valle de Cerrato;90;53;37;2019
34;Palencia;902;Valle del Retortillo;164;98;66;2019
34;Palencia;199;Velilla del Río Carrión;1268;653;615;2019
34;Palencia;023;Venta de Baños;6360;3199;3161;2019
34;Palencia;201;Vertavillo;179;97;82;2019
34;Palencia;093;Vid de Ojeda, La;94;57;37;2019
34;Palencia;202;Villabasta de Valdavia;32;18;14;2019
34;Palencia;204;Villacidaler;53;30;23;2019
34;Palencia;205;Villaconancio;61;35;26;2019
34;Palencia;206;Villada;934;481;453;2019
34;Palencia;208;Villaeles de Valdavia;49;29;20;2019
34;Palencia;210;Villahán;106;56;50;2019
34;Palencia;211;Villaherreros;201;104;97;2019
34;Palencia;213;Villalaco;56;32;24;2019
34;Palencia;214;Villalba de Guardo;187;101;86;2019
34;Palencia;215;Villalcázar de Sirga;172;88;84;2019
34;Palencia;216;Villalcón;61;36;25;2019
34;Palencia;217;Villalobón;1690;853;837;2019
34;Palencia;218;Villaluenga de la Vega;595;340;255;2019
34;Palencia;220;Villamartín de Campos;176;100;76;2019
34;Palencia;221;Villamediana;175;97;78;2019
34;Palencia;222;Villameriel;112;62;50;2019
34;Palencia;223;Villamoronta;237;139;98;2019
34;Palencia;224;Villamuera de la Cueza;43;28;15;2019
34;Palencia;225;Villamuriel de Cerrato;6469;3345;3124;2019
34;Palencia;227;Villanueva del Rebollar;75;37;38;2019
34;Palencia;228;Villanuño de Valdavia;88;51;37;2019
34;Palencia;229;Villaprovedo;59;40;19;2019
34;Palencia;230;Villarmentero de Campos;17;12;5;2019
34;Palencia;231;Villarrabé;208;107;101;2019
34;Palencia;232;Villarramiel;820;446;374;2019
34;Palencia;233;Villasarracino;141;86;55;2019
34;Palencia;234;Villasila de Valdavia;72;49;23;2019
34;Palencia;236;Villaturde;159;85;74;2019
34;Palencia;237;Villaumbrales;648;322;326;2019
34;Palencia;238;Villaviudas;357;174;183;2019
34;Palencia;240;Villerías de Campos;90;49;41;2019
34;Palencia;241;Villodre;18;11;7;2019
34;Palencia;242;Villodrigo;114;61;53;2019
34;Palencia;243;Villoldo;362;190;172;2019
34;Palencia;245;Villota del Páramo;333;186;147;2019
34;Palencia;246;Villovieco;76;39;37;2019
35;Palmas, Las;001;Agaete;5586;2792;2794;2019
35;Palmas, Las;002;Agüimes;31619;15984;15635;2019
35;Palmas, Las;020;Aldea de San Nicolás, La;7504;3846;3658;2019
35;Palmas, Las;003;Antigua;12461;6601;5860;2019
35;Palmas, Las;004;Arrecife;62988;31512;31476;2019
35;Palmas, Las;005;Artenara;1069;589;480;2019
35;Palmas, Las;006;Arucas;38138;19000;19138;2019
35;Palmas, Las;007;Betancuria;758;396;362;2019
35;Palmas, Las;008;Firgas;7455;3755;3700;2019
35;Palmas, Las;009;Gáldar;24242;12099;12143;2019
35;Palmas, Las;010;Haría;5123;2641;2482;2019
35;Palmas, Las;011;Ingenio;31321;15769;15552;2019
35;Palmas, Las;012;Mogán;20072;10371;9701;2019
35;Palmas, Las;013;Moya;7696;3913;3783;2019
35;Palmas, Las;014;Oliva, La;26580;13825;12755;2019
35;Palmas, Las;015;Pájara;21093;10977;10116;2019
35;Palmas, Las;016;Palmas de Gran Canaria, Las;379925;183417;196508;2019
35;Palmas, Las;017;Puerto del Rosario;40753;20640;20113;2019
35;Palmas, Las;018;San Bartolomé;18816;9418;9398;2019
35;Palmas, Las;019;San Bartolomé de Tirajana;53443;27888;25555;2019
35;Palmas, Las;021;Santa Brígida;18263;9080;9183;2019
35;Palmas, Las;022;Santa Lucía de Tirajana;73328;36623;36705;2019
35;Palmas, Las;023;Santa María de Guía de Gran Canaria;13850;6907;6943;2019
35;Palmas, Las;024;Teguise;22342;11264;11078;2019
35;Palmas, Las;025;Tejeda;1909;1031;878;2019
35;Palmas, Las;026;Telde;102647;50446;52201;2019
35;Palmas, Las;027;Teror;12519;6428;6091;2019
35;Palmas, Las;028;Tías;20170;10354;9816;2019
35;Palmas, Las;029;Tinajo;6279;3232;3047;2019
35;Palmas, Las;030;Tuineje;15241;7811;7430;2019
35;Palmas, Las;032;Valleseco;3749;1964;1785;2019
35;Palmas, Las;031;Valsequillo de Gran Canaria;9340;4689;4651;2019
35;Palmas, Las;033;Vega de San Mateo;7556;3905;3651;2019
35;Palmas, Las;034;Yaiza;16571;8607;7964;2019
36;Pontevedra;020;Agolada;2344;1175;1169;2019
36;Pontevedra;001;Arbo;2580;1328;1252;2019
36;Pontevedra;003;Baiona;12122;5974;6148;2019
36;Pontevedra;002;Barro;3680;1824;1856;2019
36;Pontevedra;004;Bueu;12009;5924;6085;2019
36;Pontevedra;005;Caldas de Reis;9785;4706;5079;2019
36;Pontevedra;006;Cambados;13744;6614;7130;2019
36;Pontevedra;007;Campo Lameiro;1817;858;959;2019
36;Pontevedra;008;Cangas;26542;13135;13407;2019
36;Pontevedra;009;Cañiza, A;5180;2535;2645;2019
36;Pontevedra;010;Catoira;3335;1615;1720;2019
36;Pontevedra;902;Cerdedo-Cotobade;5699;2759;2940;2019
36;Pontevedra;013;Covelo;2396;1214;1182;2019
36;Pontevedra;014;Crecente;2012;974;1038;2019
36;Pontevedra;015;Cuntis;4677;2218;2459;2019
36;Pontevedra;016;Dozón;1082;566;516;2019
36;Pontevedra;017;Estrada, A;20479;9811;10668;2019
36;Pontevedra;018;Forcarei;3388;1617;1771;2019
36;Pontevedra;019;Fornelos de Montes;1616;770;846;2019
36;Pontevedra;021;Gondomar;14286;7091;7195;2019
36;Pontevedra;022;Grove, O;10650;5252;5398;2019
36;Pontevedra;023;Guarda, A;9977;4877;5100;2019
36;Pontevedra;901;Illa de Arousa, A;4926;2458;2468;2019
36;Pontevedra;024;Lalín;20218;9846;10372;2019
36;Pontevedra;025;Lama, A;2445;1199;1246;2019
36;Pontevedra;026;Marín;24319;12153;12166;2019
36;Pontevedra;027;Meaño;5272;2570;2702;2019
36;Pontevedra;028;Meis;4791;2290;2501;2019
36;Pontevedra;029;Moaña;19399;9431;9968;2019
36;Pontevedra;030;Mondariz;4440;2199;2241;2019
36;Pontevedra;031;Mondariz-Balneario;644;327;317;2019
36;Pontevedra;032;Moraña;4179;2024;2155;2019
36;Pontevedra;033;Mos;15078;7453;7625;2019
36;Pontevedra;034;Neves, As;3841;1862;1979;2019
36;Pontevedra;035;Nigrán;17675;8680;8995;2019
36;Pontevedra;036;Oia;3053;1521;1532;2019
36;Pontevedra;037;Pazos de Borbén;2999;1471;1528;2019
36;Pontevedra;041;Poio;17082;8487;8595;2019
36;Pontevedra;043;Ponte Caldelas;5494;2670;2824;2019
36;Pontevedra;042;Ponteareas;22877;11068;11809;2019
36;Pontevedra;044;Pontecesures;3052;1512;1540;2019
36;Pontevedra;038;Pontevedra;83029;39300;43729;2019
36;Pontevedra;039;Porriño, O;19848;9806;10042;2019
36;Pontevedra;040;Portas;2940;1417;1523;2019
36;Pontevedra;045;Redondela;29218;14208;15010;2019
36;Pontevedra;046;Ribadumia;5052;2459;2593;2019
36;Pontevedra;047;Rodeiro;2437;1236;1201;2019
36;Pontevedra;048;Rosal, O;6234;3062;3172;2019
36;Pontevedra;049;Salceda de Caselas;9164;4566;4598;2019
36;Pontevedra;050;Salvaterra de Miño;9819;4905;4914;2019
36;Pontevedra;051;Sanxenxo;17347;8565;8782;2019
36;Pontevedra;052;Silleda;8687;4212;4475;2019
36;Pontevedra;053;Soutomaior;7395;3677;3718;2019
36;Pontevedra;054;Tomiño;13499;6815;6684;2019
36;Pontevedra;055;Tui;16701;8046;8655;2019
36;Pontevedra;056;Valga;5869;2890;2979;2019
36;Pontevedra;057;Vigo;295364;139699;155665;2019
36;Pontevedra;059;Vila de Cruces;5246;2578;2668;2019
36;Pontevedra;058;Vilaboa;5874;2859;3015;2019
36;Pontevedra;060;Vilagarcía de Arousa;37456;17930;19526;2019
36;Pontevedra;061;Vilanova de Arousa;10302;4998;5304;2019
26;Rioja, La;001;Ábalos;257;149;108;2019
26;Rioja, La;002;Agoncillo;1102;606;496;2019
26;Rioja, La;003;Aguilar del Río Alhama;460;234;226;2019
26;Rioja, La;004;Ajamil de Cameros;66;45;21;2019
26;Rioja, La;005;Albelda de Iregua;3446;1763;1683;2019
26;Rioja, La;006;Alberite;2422;1225;1197;2019
26;Rioja, La;007;Alcanadre;643;338;305;2019
26;Rioja, La;008;Aldeanueva de Ebro;2761;1438;1323;2019
26;Rioja, La;009;Alesanco;505;267;238;2019
26;Rioja, La;010;Alesón;99;60;39;2019
26;Rioja, La;011;Alfaro;9476;4751;4725;2019
26;Rioja, La;012;Almarza de Cameros;36;21;15;2019
26;Rioja, La;013;Anguciana;433;236;197;2019
26;Rioja, La;014;Anguiano;497;282;215;2019
26;Rioja, La;015;Arenzana de Abajo;230;118;112;2019
26;Rioja, La;016;Arenzana de Arriba;29;20;9;2019
26;Rioja, La;017;Arnedillo;419;201;218;2019
26;Rioja, La;018;Arnedo;14875;7415;7460;2019
26;Rioja, La;019;Arrúbal;506;271;235;2019
26;Rioja, La;020;Ausejo;780;414;366;2019
26;Rioja, La;021;Autol;4512;2231;2281;2019
26;Rioja, La;022;Azofra;215;117;98;2019
26;Rioja, La;023;Badarán;482;249;233;2019
26;Rioja, La;024;Bañares;241;128;113;2019
26;Rioja, La;026;Baños de Río Tobía;1579;783;796;2019
26;Rioja, La;025;Baños de Rioja;91;53;38;2019
26;Rioja, La;027;Berceo;157;96;61;2019
26;Rioja, La;028;Bergasa;148;82;66;2019
26;Rioja, La;029;Bergasillas Bajera;37;19;18;2019
26;Rioja, La;030;Bezares;22;10;12;2019
26;Rioja, La;031;Bobadilla;100;51;49;2019
26;Rioja, La;032;Brieva de Cameros;44;29;15;2019
26;Rioja, La;033;Briñas;193;90;103;2019
26;Rioja, La;034;Briones;745;392;353;2019
26;Rioja, La;035;Cabezón de Cameros;18;12;6;2019
26;Rioja, La;036;Calahorra;24220;11900;12320;2019
26;Rioja, La;037;Camprovín;151;82;69;2019
26;Rioja, La;038;Canales de la Sierra;91;57;34;2019
26;Rioja, La;039;Canillas de Río Tuerto;40;22;18;2019
26;Rioja, La;040;Cañas;102;53;49;2019
26;Rioja, La;041;Cárdenas;136;72;64;2019
26;Rioja, La;042;Casalarreina;1098;556;542;2019
26;Rioja, La;043;Castañares de Rioja;415;199;216;2019
26;Rioja, La;044;Castroviejo;54;33;21;2019
26;Rioja, La;045;Cellorigo;11;4;7;2019
26;Rioja, La;046;Cenicero;2076;1061;1015;2019
26;Rioja, La;047;Cervera del Río Alhama;2294;1182;1112;2019
26;Rioja, La;048;Cidamón;25;13;12;2019
26;Rioja, La;049;Cihuri;178;93;85;2019
26;Rioja, La;050;Cirueña;153;98;55;2019
26;Rioja, La;051;Clavijo;260;156;104;2019
26;Rioja, La;052;Cordovín;156;76;80;2019
26;Rioja, La;053;Corera;257;132;125;2019
26;Rioja, La;054;Cornago;312;181;131;2019
26;Rioja, La;055;Corporales;41;25;16;2019
26;Rioja, La;056;Cuzcurrita de Río Tirón;493;271;222;2019
26;Rioja, La;057;Daroca de Rioja;52;34;18;2019
26;Rioja, La;058;Enciso;160;100;60;2019
26;Rioja, La;059;Entrena;1536;801;735;2019
26;Rioja, La;060;Estollo;85;56;29;2019
26;Rioja, La;061;Ezcaray;2024;1051;973;2019
26;Rioja, La;062;Foncea;93;54;39;2019
26;Rioja, La;063;Fonzaleche;135;85;50;2019
26;Rioja, La;064;Fuenmayor;3134;1585;1549;2019
26;Rioja, La;065;Galbárruli;62;42;20;2019
26;Rioja, La;066;Galilea;351;177;174;2019
26;Rioja, La;067;Gallinero de Cameros;22;15;7;2019
26;Rioja, La;068;Gimileo;112;61;51;2019
26;Rioja, La;069;Grañón;254;144;110;2019
26;Rioja, La;070;Grávalos;185;100;85;2019
26;Rioja, La;071;Haro;11408;5611;5797;2019
26;Rioja, La;072;Herce;336;175;161;2019
26;Rioja, La;073;Herramélluri;114;62;52;2019
26;Rioja, La;074;Hervías;121;62;59;2019
26;Rioja, La;075;Hormilla;416;226;190;2019
26;Rioja, La;076;Hormilleja;133;65;68;2019
26;Rioja, La;077;Hornillos de Cameros;17;9;8;2019
26;Rioja, La;078;Hornos de Moncalvillo;98;58;40;2019
26;Rioja, La;079;Huércanos;817;451;366;2019
26;Rioja, La;080;Igea;595;341;254;2019
26;Rioja, La;081;Jalón de Cameros;21;10;11;2019
26;Rioja, La;082;Laguna de Cameros;104;64;40;2019
26;Rioja, La;083;Lagunilla del Jubera;375;209;166;2019
26;Rioja, La;084;Lardero;10500;5262;5238;2019
26;Rioja, La;086;Ledesma de la Cogolla;15;12;3;2019
26;Rioja, La;087;Leiva;221;109;112;2019
26;Rioja, La;088;Leza de Río Leza;42;25;17;2019
26;Rioja, La;089;Logroño;151136;71718;79418;2019
26;Rioja, La;091;Lumbreras;154;105;49;2019
26;Rioja, La;092;Manjarrés;121;72;49;2019
26;Rioja, La;093;Mansilla de la Sierra;56;41;15;2019
26;Rioja, La;094;Manzanares de Rioja;69;40;29;2019
26;Rioja, La;095;Matute;98;56;42;2019
26;Rioja, La;096;Medrano;338;181;157;2019
26;Rioja, La;098;Munilla;115;64;51;2019
26;Rioja, La;099;Murillo de Río Leza;1629;838;791;2019
26;Rioja, La;100;Muro de Aguas;62;36;26;2019
26;Rioja, La;101;Muro en Cameros;36;20;16;2019
26;Rioja, La;102;Nájera;8045;3949;4096;2019
26;Rioja, La;103;Nalda;1023;555;468;2019
26;Rioja, La;104;Navajún;10;8;2;2019
26;Rioja, La;105;Navarrete;2941;1490;1451;2019
26;Rioja, La;106;Nestares;84;46;38;2019
26;Rioja, La;107;Nieva de Cameros;90;62;28;2019
26;Rioja, La;109;Ochánduri;78;47;31;2019
26;Rioja, La;108;Ocón;301;184;117;2019
26;Rioja, La;110;Ojacastro;182;109;73;2019
26;Rioja, La;111;Ollauri;291;154;137;2019
26;Rioja, La;112;Ortigosa de Cameros;229;138;91;2019
26;Rioja, La;113;Pazuengos;30;23;7;2019
26;Rioja, La;114;Pedroso;74;51;23;2019
26;Rioja, La;115;Pinillos;23;13;10;2019
26;Rioja, La;117;Pradejón;3871;1985;1886;2019
26;Rioja, La;118;Pradillo;75;40;35;2019
26;Rioja, La;119;Préjano;214;115;99;2019
26;Rioja, La;120;Quel;2058;1081;977;2019
26;Rioja, La;121;Rabanera;32;21;11;2019
26;Rioja, La;122;Rasillo de Cameros, El;144;78;66;2019
26;Rioja, La;123;Redal, El;143;77;66;2019
26;Rioja, La;124;Ribafrecha;967;501;466;2019
26;Rioja, La;125;Rincón de Soto;3783;1927;1856;2019
26;Rioja, La;126;Robres del Castillo;29;19;10;2019
26;Rioja, La;127;Rodezno;229;125;104;2019
26;Rioja, La;128;Sajazarra;124;63;61;2019
26;Rioja, La;129;San Asensio;1114;589;525;2019
26;Rioja, La;130;San Millán de la Cogolla;230;151;79;2019
26;Rioja, La;131;San Millán de Yécora;34;24;10;2019
26;Rioja, La;132;San Román de Cameros;128;78;50;2019
26;Rioja, La;139;San Torcuato;61;31;30;2019
26;Rioja, La;142;San Vicente de la Sonsierra;990;520;470;2019
26;Rioja, La;134;Santa Coloma;94;58;36;2019
26;Rioja, La;135;Santa Engracia del Jubera;161;106;55;2019
26;Rioja, La;136;Santa Eulalia Bajera;112;61;51;2019
26;Rioja, La;138;Santo Domingo de la Calzada;6238;3095;3143;2019
26;Rioja, La;140;Santurde de Rioja;286;151;135;2019
26;Rioja, La;141;Santurdejo;106;68;38;2019
26;Rioja, La;143;Sojuela;313;179;134;2019
26;Rioja, La;144;Sorzano;222;125;97;2019
26;Rioja, La;145;Sotés;294;165;129;2019
26;Rioja, La;146;Soto en Cameros;89;52;37;2019
26;Rioja, La;147;Terroba;34;20;14;2019
26;Rioja, La;148;Tirgo;180;89;91;2019
26;Rioja, La;149;Tobía;50;30;20;2019
26;Rioja, La;150;Tormantos;131;79;52;2019
26;Rioja, La;153;Torre en Cameros;10;8;2;2019
26;Rioja, La;151;Torrecilla en Cameros;456;252;204;2019
26;Rioja, La;152;Torrecilla sobre Alesanco;32;19;13;2019
26;Rioja, La;154;Torremontalbo;10;7;3;2019
26;Rioja, La;155;Treviana;154;81;73;2019
26;Rioja, La;157;Tricio;380;182;198;2019
26;Rioja, La;158;Tudelilla;361;198;163;2019
26;Rioja, La;160;Uruñuela;976;489;487;2019
26;Rioja, La;161;Valdemadera;8;5;3;2019
26;Rioja, La;162;Valgañón;126;77;49;2019
26;Rioja, La;163;Ventosa;159;83;76;2019
26;Rioja, La;164;Ventrosa;56;32;24;2019
26;Rioja, La;165;Viguera;387;222;165;2019
26;Rioja, La;166;Villalba de Rioja;160;100;60;2019
26;Rioja, La;167;Villalobar de Rioja;58;42;16;2019
26;Rioja, La;168;Villamediana de Iregua;8070;4078;3992;2019
26;Rioja, La;169;Villanueva de Cameros;74;41;33;2019
26;Rioja, La;170;Villar de Arnedo, El;593;306;287;2019
26;Rioja, La;171;Villar de Torre;158;97;61;2019
26;Rioja, La;172;Villarejo;27;20;7;2019
26;Rioja, La;173;Villarroya;5;3;2;2019
26;Rioja, La;174;Villarta-Quintana;140;83;57;2019
26;Rioja, La;175;Villavelayo;50;33;17;2019
26;Rioja, La;176;Villaverde de Rioja;56;32;24;2019
26;Rioja, La;177;Villoslada de Cameros;324;200;124;2019
26;Rioja, La;178;Viniegra de Abajo;77;48;29;2019
26;Rioja, La;179;Viniegra de Arriba;42;28;14;2019
26;Rioja, La;180;Zarratón;264;139;125;2019
26;Rioja, La;181;Zarzosa;14;10;4;2019
26;Rioja, La;183;Zorraquín;93;43;50;2019
37;Salamanca;001;Abusejo;183;98;85;2019
37;Salamanca;002;Agallas;136;70;66;2019
37;Salamanca;003;Ahigal de los Aceiteros;114;64;50;2019
37;Salamanca;004;Ahigal de Villarino;31;17;14;2019
37;Salamanca;005;Alameda de Gardón, La;70;36;34;2019
37;Salamanca;006;Alamedilla, La;126;63;63;2019
37;Salamanca;007;Alaraz;439;230;209;2019
37;Salamanca;008;Alba de Tormes;5186;2603;2583;2019
37;Salamanca;009;Alba de Yeltes;207;111;96;2019
37;Salamanca;010;Alberca, La;1081;527;554;2019
37;Salamanca;011;Alberguería de Argañán, La;112;57;55;2019
37;Salamanca;012;Alconada;149;79;70;2019
37;Salamanca;015;Aldea del Obispo;243;126;117;2019
37;Salamanca;013;Aldeacipreste;109;57;52;2019
37;Salamanca;014;Aldeadávila de la Ribera;1224;616;608;2019
37;Salamanca;016;Aldealengua;664;328;336;2019
37;Salamanca;017;Aldeanueva de Figueroa;254;134;120;2019
37;Salamanca;018;Aldeanueva de la Sierra;115;66;49;2019
37;Salamanca;019;Aldearrodrigo;143;78;65;2019
37;Salamanca;020;Aldearrubia;480;259;221;2019
37;Salamanca;021;Aldeaseca de Alba;70;34;36;2019
37;Salamanca;022;Aldeaseca de la Frontera;261;137;124;2019
37;Salamanca;023;Aldeatejada;2064;1043;1021;2019
37;Salamanca;024;Aldeavieja de Tormes;104;56;48;2019
37;Salamanca;025;Aldehuela de la Bóveda;275;147;128;2019
37;Salamanca;026;Aldehuela de Yeltes;190;103;87;2019
37;Salamanca;027;Almenara de Tormes;262;146;116;2019
37;Salamanca;028;Almendra;146;85;61;2019
37;Salamanca;029;Anaya de Alba;201;118;83;2019
37;Salamanca;030;Añover de Tormes;86;46;40;2019
37;Salamanca;031;Arabayona de Mógica;357;202;155;2019
37;Salamanca;032;Arapiles;660;355;305;2019
37;Salamanca;033;Arcediano;107;58;49;2019
37;Salamanca;034;Arco, El;86;42;44;2019
37;Salamanca;035;Armenteros;198;111;87;2019
37;Salamanca;037;Atalaya, La;114;63;51;2019
37;Salamanca;038;Babilafuente;885;467;418;2019
37;Salamanca;039;Bañobárez;305;156;149;2019
37;Salamanca;040;Barbadillo;402;215;187;2019
37;Salamanca;041;Barbalos;73;41;32;2019
37;Salamanca;042;Barceo;46;29;17;2019
37;Salamanca;044;Barruecopardo;450;250;200;2019
37;Salamanca;045;Bastida, La;28;16;12;2019
37;Salamanca;046;Béjar;12739;6026;6713;2019
37;Salamanca;047;Beleña;256;129;127;2019
37;Salamanca;049;Bermellar;134;68;66;2019
37;Salamanca;050;Berrocal de Huebra;70;39;31;2019
37;Salamanca;051;Berrocal de Salvatierra;84;45;39;2019
37;Salamanca;052;Boada;302;152;150;2019
37;Salamanca;054;Bodón, El;270;147;123;2019
37;Salamanca;055;Bogajo;134;74;60;2019
37;Salamanca;056;Bouza, La;55;24;31;2019
37;Salamanca;057;Bóveda del Río Almar;229;125;104;2019
37;Salamanca;058;Brincones;58;29;29;2019
37;Salamanca;059;Buenamadre;127;66;61;2019
37;Salamanca;060;Buenavista;360;198;162;2019
37;Salamanca;061;Cabaco, El;221;114;107;2019
37;Salamanca;063;Cabeza de Béjar, La;62;38;24;2019
37;Salamanca;065;Cabeza del Caballo;279;149;130;2019
37;Salamanca;062;Cabezabellosa de la Calzada;77;46;31;2019
37;Salamanca;067;Cabrerizos;4263;2121;2142;2019
37;Salamanca;068;Cabrillas;370;188;182;2019
37;Salamanca;069;Calvarrasa de Abajo;1163;617;546;2019
37;Salamanca;070;Calvarrasa de Arriba;586;315;271;2019
37;Salamanca;071;Calzada de Béjar, La;86;46;40;2019
37;Salamanca;072;Calzada de Don Diego;152;82;70;2019
37;Salamanca;073;Calzada de Valdunciel;703;349;354;2019
37;Salamanca;074;Campillo de Azaba;159;94;65;2019
37;Salamanca;077;Campo de Peñaranda, El;261;153;108;2019
37;Salamanca;078;Candelario;879;447;432;2019
37;Salamanca;079;Canillas de Abajo;86;59;27;2019
37;Salamanca;080;Cantagallo;255;135;120;2019
37;Salamanca;081;Cantalapiedra;953;499;454;2019
37;Salamanca;082;Cantalpino;851;463;388;2019
37;Salamanca;083;Cantaracillo;190;104;86;2019
37;Salamanca;085;Carbajosa de la Sagrada;7116;3541;3575;2019
37;Salamanca;086;Carpio de Azaba;112;63;49;2019
37;Salamanca;087;Carrascal de Barregas;1206;630;576;2019
37;Salamanca;088;Carrascal del Obispo;209;113;96;2019
37;Salamanca;089;Casafranca;65;35;30;2019
37;Salamanca;090;Casas del Conde, Las;69;32;37;2019
37;Salamanca;091;Casillas de Flores;178;89;89;2019
37;Salamanca;092;Castellanos de Moriscos;2677;1384;1293;2019
37;Salamanca;185;Castellanos de Villiquera;617;337;280;2019
37;Salamanca;096;Castillejo de Martín Viejo;222;134;88;2019
37;Salamanca;097;Castraz;44;29;15;2019
37;Salamanca;098;Cepeda;311;155;156;2019
37;Salamanca;099;Cereceda de la Sierra;64;33;31;2019
37;Salamanca;100;Cerezal de Peñahorcada;78;40;38;2019
37;Salamanca;101;Cerralbo;146;81;65;2019
37;Salamanca;102;Cerro, El;407;205;202;2019
37;Salamanca;103;Cespedosa de Tormes;495;267;228;2019
37;Salamanca;114;Chagarcía Medianero;82;45;37;2019
37;Salamanca;104;Cilleros de la Bastida;26;12;14;2019
37;Salamanca;106;Cipérez;271;142;129;2019
37;Salamanca;107;Ciudad Rodrigo;12344;5932;6412;2019
37;Salamanca;108;Coca de Alba;109;52;57;2019
37;Salamanca;109;Colmenar de Montemayor;182;105;77;2019
37;Salamanca;110;Cordovilla;118;61;57;2019
37;Salamanca;112;Cristóbal;157;90;67;2019
37;Salamanca;113;Cubo de Don Sancho, El;440;233;207;2019
37;Salamanca;115;Dios le Guarde;121;68;53;2019
37;Salamanca;116;Doñinos de Ledesma;71;37;34;2019
37;Salamanca;117;Doñinos de Salamanca;2097;1105;992;2019
37;Salamanca;118;Éjeme;126;72;54;2019
37;Salamanca;120;Encina de San Silvestre;112;55;57;2019
37;Salamanca;119;Encina, La;99;59;40;2019
37;Salamanca;121;Encinas de Abajo;633;339;294;2019
37;Salamanca;122;Encinas de Arriba;237;120;117;2019
37;Salamanca;123;Encinasola de los Comendadores;164;92;72;2019
37;Salamanca;124;Endrinal;218;118;100;2019
37;Salamanca;125;Escurial de la Sierra;239;135;104;2019
37;Salamanca;126;Espadaña;31;19;12;2019
37;Salamanca;127;Espeja;222;114;108;2019
37;Salamanca;128;Espino de la Orbada;262;145;117;2019
37;Salamanca;129;Florida de Liébana;270;144;126;2019
37;Salamanca;130;Forfoleda;193;108;85;2019
37;Salamanca;131;Frades de la Sierra;183;104;79;2019
37;Salamanca;132;Fregeneda, La;348;171;177;2019
37;Salamanca;133;Fresnedoso;106;61;45;2019
37;Salamanca;134;Fresno Alhándiga;213;116;97;2019
37;Salamanca;135;Fuente de San Esteban, La;1299;657;642;2019
37;Salamanca;136;Fuenteguinaldo;677;333;344;2019
37;Salamanca;137;Fuenteliante;101;51;50;2019
37;Salamanca;138;Fuenterroble de Salvatierra;268;139;129;2019
37;Salamanca;139;Fuentes de Béjar;216;106;110;2019
37;Salamanca;140;Fuentes de Oñoro;1134;601;533;2019
37;Salamanca;141;Gajates;163;75;88;2019
37;Salamanca;142;Galindo y Perahuy;684;397;287;2019
37;Salamanca;143;Galinduste;427;209;218;2019
37;Salamanca;144;Galisancho;378;203;175;2019
37;Salamanca;145;Gallegos de Argañán;283;139;144;2019
37;Salamanca;146;Gallegos de Solmirón;110;63;47;2019
37;Salamanca;147;Garcibuey;183;108;75;2019
37;Salamanca;148;Garcihernández;449;236;213;2019
37;Salamanca;149;Garcirrey;61;36;25;2019
37;Salamanca;150;Gejuelo del Barro;38;22;16;2019
37;Salamanca;151;Golpejas;151;74;77;2019
37;Salamanca;152;Gomecello;442;235;207;2019
37;Salamanca;154;Guadramiro;140;84;56;2019
37;Salamanca;155;Guijo de Ávila;76;42;34;2019
37;Salamanca;156;Guijuelo;5633;2821;2812;2019
37;Salamanca;157;Herguijuela de Ciudad Rodrigo;78;46;32;2019
37;Salamanca;158;Herguijuela de la Sierra;250;139;111;2019
37;Salamanca;159;Herguijuela del Campo;80;41;39;2019
37;Salamanca;160;Hinojosa de Duero;659;330;329;2019
37;Salamanca;161;Horcajo de Montemayor;138;75;63;2019
37;Salamanca;162;Horcajo Medianero;225;115;110;2019
37;Salamanca;163;Hoya, La;36;20;16;2019
37;Salamanca;164;Huerta;284;161;123;2019
37;Salamanca;165;Iruelos;33;15;18;2019
37;Salamanca;166;Ituero de Azaba;214;112;102;2019
37;Salamanca;167;Juzbado;194;99;95;2019
37;Salamanca;168;Lagunilla;466;252;214;2019
37;Salamanca;169;Larrodrigo;187;108;79;2019
37;Salamanca;170;Ledesma;1599;799;800;2019
37;Salamanca;171;Ledrada;481;241;240;2019
37;Salamanca;172;Linares de Riofrío;949;517;432;2019
37;Salamanca;173;Lumbrales;1590;801;789;2019
37;Salamanca;175;Machacón;454;238;216;2019
37;Salamanca;174;Macotera;1037;529;508;2019
37;Salamanca;176;Madroñal;142;77;65;2019
37;Salamanca;177;Maíllo, El;260;146;114;2019
37;Salamanca;178;Malpartida;98;52;46;2019
37;Salamanca;179;Mancera de Abajo;202;107;95;2019
37;Salamanca;180;Manzano, El;68;36;32;2019
37;Salamanca;181;Martiago;263;140;123;2019
37;Salamanca;183;Martín de Yeltes;415;215;200;2019
37;Salamanca;182;Martinamor;85;53;32;2019
37;Salamanca;184;Masueco;272;139;133;2019
37;Salamanca;186;Mata de Ledesma, La;98;55;43;2019
37;Salamanca;187;Matilla de los Caños del Río;635;320;315;2019
37;Salamanca;188;Maya, La;162;99;63;2019
37;Salamanca;189;Membribe de la Sierra;119;72;47;2019
37;Salamanca;190;Mieza;196;102;94;2019
37;Salamanca;191;Milano, El;106;62;44;2019
37;Salamanca;192;Miranda de Azán;433;227;206;2019
37;Salamanca;193;Miranda del Castañar;402;215;187;2019
37;Salamanca;194;Mogarraz;277;141;136;2019
37;Salamanca;195;Molinillo;39;23;16;2019
37;Salamanca;196;Monforte de la Sierra;70;38;32;2019
37;Salamanca;197;Monleón;93;53;40;2019
37;Salamanca;198;Monleras;226;108;118;2019
37;Salamanca;199;Monsagro;137;74;63;2019
37;Salamanca;200;Montejo;216;124;92;2019
37;Salamanca;201;Montemayor del Río;263;141;122;2019
37;Salamanca;202;Monterrubio de Armuña;1343;703;640;2019
37;Salamanca;203;Monterrubio de la Sierra;156;86;70;2019
37;Salamanca;204;Morasverdes;254;134;120;2019
37;Salamanca;205;Morille;233;128;105;2019
37;Salamanca;206;Moríñigo;95;53;42;2019
37;Salamanca;207;Moriscos;429;234;195;2019
37;Salamanca;208;Moronta;71;45;26;2019
37;Salamanca;209;Mozárbez;499;261;238;2019
37;Salamanca;211;Narros de Matalayegua;223;124;99;2019
37;Salamanca;213;Nava de Béjar;94;54;40;2019
37;Salamanca;214;Nava de Francia;126;68;58;2019
37;Salamanca;215;Nava de Sotrobal;155;88;67;2019
37;Salamanca;212;Navacarros;112;57;55;2019
37;Salamanca;216;Navales;325;176;149;2019
37;Salamanca;217;Navalmoral de Béjar;59;27;32;2019
37;Salamanca;218;Navamorales;51;32;19;2019
37;Salamanca;219;Navarredonda de la Rinconada;169;85;84;2019
37;Salamanca;221;Navasfrías;436;230;206;2019
37;Salamanca;222;Negrilla de Palencia;88;53;35;2019
37;Salamanca;223;Olmedo de Camaces;112;59;53;2019
37;Salamanca;224;Orbada, La;199;104;95;2019
37;Salamanca;225;Pajares de la Laguna;110;59;51;2019
37;Salamanca;226;Palacios del Arzobispo;165;80;85;2019
37;Salamanca;228;Palaciosrubios;335;174;161;2019
37;Salamanca;229;Palencia de Negrilla;154;91;63;2019
37;Salamanca;230;Parada de Arriba;251;129;122;2019
37;Salamanca;231;Parada de Rubiales;252;132;120;2019
37;Salamanca;232;Paradinas de San Juan;396;232;164;2019
37;Salamanca;233;Pastores;59;36;23;2019
37;Salamanca;234;Payo, El;338;163;175;2019
37;Salamanca;235;Pedraza de Alba;235;124;111;2019
37;Salamanca;236;Pedrosillo de Alba;136;81;55;2019
37;Salamanca;237;Pedrosillo de los Aires;350;198;152;2019
37;Salamanca;238;Pedrosillo el Ralo;124;66;58;2019
37;Salamanca;239;Pedroso de la Armuña, El;214;112;102;2019
37;Salamanca;240;Pelabravo;1191;633;558;2019
37;Salamanca;241;Pelarrodríguez;168;102;66;2019
37;Salamanca;242;Pelayos;81;49;32;2019
37;Salamanca;243;Peña, La;92;44;48;2019
37;Salamanca;244;Peñacaballera;139;70;69;2019
37;Salamanca;245;Peñaparda;353;176;177;2019
37;Salamanca;246;Peñaranda de Bracamonte;6260;3076;3184;2019
37;Salamanca;247;Peñarandilla;182;99;83;2019
37;Salamanca;248;Peralejos de Abajo;164;86;78;2019
37;Salamanca;249;Peralejos de Arriba;38;25;13;2019
37;Salamanca;250;Pereña de la Ribera;345;187;158;2019
37;Salamanca;251;Peromingo;118;55;63;2019
37;Salamanca;252;Pinedas;107;60;47;2019
37;Salamanca;253;Pino de Tormes, El;155;83;72;2019
37;Salamanca;254;Pitiegua;184;102;82;2019
37;Salamanca;255;Pizarral;46;30;16;2019
37;Salamanca;256;Poveda de las Cintas;211;122;89;2019
37;Salamanca;257;Pozos de Hinojo;51;28;23;2019
37;Salamanca;258;Puebla de Azaba;162;88;74;2019
37;Salamanca;259;Puebla de San Medel;39;22;17;2019
37;Salamanca;260;Puebla de Yeltes;149;78;71;2019
37;Salamanca;261;Puente del Congosto;230;129;101;2019
37;Salamanca;262;Puertas;79;45;34;2019
37;Salamanca;263;Puerto de Béjar;370;176;194;2019
37;Salamanca;264;Puerto Seguro;57;27;30;2019
37;Salamanca;265;Rágama;218;115;103;2019
37;Salamanca;266;Redonda, La;75;43;32;2019
37;Salamanca;267;Retortillo;194;106;88;2019
37;Salamanca;268;Rinconada de la Sierra, La;112;63;49;2019
37;Salamanca;269;Robleda;492;269;223;2019
37;Salamanca;270;Robliza de Cojos;198;102;96;2019
37;Salamanca;271;Rollán;371;203;168;2019
37;Salamanca;272;Saelices el Chico;150;86;64;2019
37;Salamanca;273;Sagrada, La;95;55;40;2019
37;Salamanca;303;Sahugo, El;186;103;83;2019
37;Salamanca;274;Salamanca;144228;65359;78869;2019
37;Salamanca;275;Saldeana;105;62;43;2019
37;Salamanca;276;Salmoral;127;78;49;2019
37;Salamanca;277;Salvatierra de Tormes;79;38;41;2019
37;Salamanca;278;San Cristóbal de la Cuesta;1039;552;487;2019
37;Salamanca;284;San Esteban de la Sierra;343;194;149;2019
37;Salamanca;285;San Felices de los Gallegos;395;206;189;2019
37;Salamanca;286;San Martín del Castañar;223;121;102;2019
37;Salamanca;287;San Miguel de Valero;334;173;161;2019
37;Salamanca;036;San Miguel del Robledo;56;33;23;2019
37;Salamanca;288;San Morales;334;182;152;2019
37;Salamanca;289;San Muñoz;233;116;117;2019
37;Salamanca;291;San Pedro de Rozados;291;164;127;2019
37;Salamanca;290;San Pedro del Valle;138;76;62;2019
37;Salamanca;292;San Pelayo de Guareña;89;51;38;2019
37;Salamanca;280;Sanchón de la Ribera;80;42;38;2019
37;Salamanca;281;Sanchón de la Sagrada;39;23;16;2019
37;Salamanca;282;Sanchotello;217;115;102;2019
37;Salamanca;279;Sancti-Spíritus;804;434;370;2019
37;Salamanca;283;Sando;123;75;48;2019
37;Salamanca;293;Santa María de Sando;110;58;52;2019
37;Salamanca;294;Santa Marta de Tormes;14805;7271;7534;2019
37;Salamanca;296;Santiago de la Puebla;310;161;149;2019
37;Salamanca;297;Santibáñez de Béjar;461;233;228;2019
37;Salamanca;298;Santibáñez de la Sierra;180;102;78;2019
37;Salamanca;299;Santiz;249;134;115;2019
37;Salamanca;300;Santos, Los;610;313;297;2019
37;Salamanca;301;Sardón de los Frailes;88;49;39;2019
37;Salamanca;302;Saucelle;276;140;136;2019
37;Salamanca;304;Sepulcro-Hilario;176;100;76;2019
37;Salamanca;305;Sequeros;237;117;120;2019
37;Salamanca;306;Serradilla del Arroyo;261;144;117;2019
37;Salamanca;307;Serradilla del Llano;155;79;76;2019
37;Salamanca;309;Sierpe, La;40;20;20;2019
37;Salamanca;310;Sieteiglesias de Tormes;187;89;98;2019
37;Salamanca;311;Sobradillo;219;112;107;2019
37;Salamanca;312;Sorihuela;261;138;123;2019
37;Salamanca;313;Sotoserrano;573;308;265;2019
37;Salamanca;314;Tabera de Abajo;106;60;46;2019
37;Salamanca;315;Tala, La;84;48;36;2019
37;Salamanca;316;Tamames;781;397;384;2019
37;Salamanca;317;Tarazona de Guareña;305;166;139;2019
37;Salamanca;318;Tardáguila;208;123;85;2019
37;Salamanca;319;Tejado, El;96;52;44;2019
37;Salamanca;320;Tejeda y Segoyuela;92;52;40;2019
37;Salamanca;321;Tenebrón;140;72;68;2019
37;Salamanca;322;Terradillos;3046;1522;1524;2019
37;Salamanca;323;Topas;530;286;244;2019
37;Salamanca;324;Tordillos;347;186;161;2019
37;Salamanca;325;Tornadizo, El;93;52;41;2019
37;Salamanca;327;Torresmenudas;190;97;93;2019
37;Salamanca;328;Trabanca;184;90;94;2019
37;Salamanca;329;Tremedal de Tormes;43;22;21;2019
37;Salamanca;330;Valdecarros;338;171;167;2019
37;Salamanca;331;Valdefuentes de Sangusín;196;110;86;2019
37;Salamanca;332;Valdehijaderos;79;42;37;2019
37;Salamanca;333;Valdelacasa;215;125;90;2019
37;Salamanca;334;Valdelageve;76;39;37;2019
37;Salamanca;335;Valdelosa;409;203;206;2019
37;Salamanca;336;Valdemierque;63;40;23;2019
37;Salamanca;337;Valderrodrigo;150;74;76;2019
37;Salamanca;338;Valdunciel;98;49;49;2019
37;Salamanca;339;Valero;330;180;150;2019
37;Salamanca;343;Vallejera de Riofrío;73;33;40;2019
37;Salamanca;340;Valsalabroso;145;82;63;2019
37;Salamanca;341;Valverde de Valdelacasa;71;38;33;2019
37;Salamanca;342;Valverdón;285;151;134;2019
37;Salamanca;344;Vecinos;253;124;129;2019
37;Salamanca;345;Vega de Tirados;163;91;72;2019
37;Salamanca;346;Veguillas, Las;281;137;144;2019
37;Salamanca;347;Vellés, La;537;297;240;2019
37;Salamanca;348;Ventosa del Río Almar;106;60;46;2019
37;Salamanca;349;Vídola, La;111;55;56;2019
37;Salamanca;351;Villaflores;277;139;138;2019
37;Salamanca;352;Villagonzalo de Tormes;216;128;88;2019
37;Salamanca;353;Villalba de los Llanos;126;71;55;2019
37;Salamanca;354;Villamayor;7202;3622;3580;2019
37;Salamanca;355;Villanueva del Conde;173;85;88;2019
37;Salamanca;356;Villar de Argañán;98;53;45;2019
37;Salamanca;357;Villar de Ciervo;277;146;131;2019
37;Salamanca;358;Villar de Gallimazo;192;118;74;2019
37;Salamanca;359;Villar de la Yegua;174;91;83;2019
37;Salamanca;360;Villar de Peralonso;231;119;112;2019
37;Salamanca;361;Villar de Samaniego;88;49;39;2019
37;Salamanca;362;Villares de la Reina;6351;3147;3204;2019
37;Salamanca;363;Villares de Yeltes;113;52;61;2019
37;Salamanca;364;Villarino de los Aires;796;416;380;2019
37;Salamanca;365;Villarmayor;185;104;81;2019
37;Salamanca;366;Villarmuerto;40;27;13;2019
37;Salamanca;367;Villasbuenas;190;104;86;2019
37;Salamanca;368;Villasdardo;21;6;15;2019
37;Salamanca;369;Villaseco de los Gamitos;135;77;58;2019
37;Salamanca;370;Villaseco de los Reyes;331;189;142;2019
37;Salamanca;371;Villasrubias;271;149;122;2019
37;Salamanca;372;Villaverde de Guareña;141;80;61;2019
37;Salamanca;373;Villavieja de Yeltes;764;401;363;2019
37;Salamanca;374;Villoria;1351;692;659;2019
37;Salamanca;375;Villoruela;760;384;376;2019
37;Salamanca;350;Vilvestre;429;210;219;2019
37;Salamanca;376;Vitigudino;2499;1210;1289;2019
37;Salamanca;377;Yecla de Yeltes;235;124;111;2019
37;Salamanca;378;Zamarra;94;58;36;2019
37;Salamanca;379;Zamayón;200;121;79;2019
37;Salamanca;380;Zarapicos;58;34;24;2019
37;Salamanca;381;Zarza de Pumareda, La;144;82;62;2019
37;Salamanca;382;Zorita de la Frontera;164;83;81;2019
38;Santa Cruz de Tenerife;001;Adeje;47869;24110;23759;2019
38;Santa Cruz de Tenerife;002;Agulo;1096;547;549;2019
38;Santa Cruz de Tenerife;003;Alajeró;2017;1061;956;2019
38;Santa Cruz de Tenerife;004;Arafo;5551;2731;2820;2019
38;Santa Cruz de Tenerife;005;Arico;7988;4151;3837;2019
38;Santa Cruz de Tenerife;006;Arona;81216;41283;39933;2019
38;Santa Cruz de Tenerife;007;Barlovento;1876;956;920;2019
38;Santa Cruz de Tenerife;008;Breña Alta;7204;3540;3664;2019
38;Santa Cruz de Tenerife;009;Breña Baja;5690;2857;2833;2019
38;Santa Cruz de Tenerife;010;Buenavista del Norte;4778;2405;2373;2019
38;Santa Cruz de Tenerife;011;Candelaria;27985;13619;14366;2019
38;Santa Cruz de Tenerife;012;Fasnia;2786;1458;1328;2019
38;Santa Cruz de Tenerife;013;Frontera;4093;2050;2043;2019
38;Santa Cruz de Tenerife;014;Fuencaliente de la Palma;1722;857;865;2019
38;Santa Cruz de Tenerife;015;Garachico;4871;2442;2429;2019
38;Santa Cruz de Tenerife;016;Garafía;1667;881;786;2019
38;Santa Cruz de Tenerife;017;Granadilla de Abona;50146;25076;25070;2019
38;Santa Cruz de Tenerife;018;Guancha, La;5520;2687;2833;2019
38;Santa Cruz de Tenerife;019;Guía de Isora;21368;10653;10715;2019
38;Santa Cruz de Tenerife;020;Güímar;20190;10010;10180;2019
38;Santa Cruz de Tenerife;021;Hermigua;1832;943;889;2019
38;Santa Cruz de Tenerife;022;Icod de los Vinos;23254;11427;11827;2019
38;Santa Cruz de Tenerife;024;Llanos de Aridane, Los;20467;9908;10559;2019
38;Santa Cruz de Tenerife;025;Matanza de Acentejo, La;9061;4585;4476;2019
38;Santa Cruz de Tenerife;026;Orotava, La;42029;20564;21465;2019
38;Santa Cruz de Tenerife;027;Paso, El;7622;3795;3827;2019
38;Santa Cruz de Tenerife;901;Pinar de El Hierro, El;1870;987;883;2019
38;Santa Cruz de Tenerife;028;Puerto de la Cruz;30468;14889;15579;2019
38;Santa Cruz de Tenerife;029;Puntagorda;2110;1070;1040;2019
38;Santa Cruz de Tenerife;030;Puntallana;2506;1244;1262;2019
38;Santa Cruz de Tenerife;031;Realejos, Los;36402;17862;18540;2019
38;Santa Cruz de Tenerife;032;Rosario, El;17370;8792;8578;2019
38;Santa Cruz de Tenerife;033;San Andrés y Sauces;4141;2074;2067;2019
38;Santa Cruz de Tenerife;023;San Cristóbal de La Laguna;157503;76211;81292;2019
38;Santa Cruz de Tenerife;034;San Juan de la Rambla;4828;2395;2433;2019
38;Santa Cruz de Tenerife;035;San Miguel de Abona;20886;10563;10323;2019
38;Santa Cruz de Tenerife;036;San Sebastián de la Gomera;9093;4560;4533;2019
38;Santa Cruz de Tenerife;037;Santa Cruz de la Palma;15716;7595;8121;2019
38;Santa Cruz de Tenerife;038;Santa Cruz de Tenerife;207312;98991;108321;2019
38;Santa Cruz de Tenerife;039;Santa Úrsula;14679;7319;7360;2019
38;Santa Cruz de Tenerife;040;Santiago del Teide;11111;5538;5573;2019
38;Santa Cruz de Tenerife;041;Sauzal, El;8934;4409;4525;2019
38;Santa Cruz de Tenerife;042;Silos, Los;4693;2348;2345;2019
38;Santa Cruz de Tenerife;043;Tacoronte;24134;11990;12144;2019
38;Santa Cruz de Tenerife;044;Tanque, El;2763;1338;1425;2019
38;Santa Cruz de Tenerife;045;Tazacorte;4575;2342;2233;2019
38;Santa Cruz de Tenerife;046;Tegueste;11294;5561;5733;2019
38;Santa Cruz de Tenerife;047;Tijarafe;2532;1292;1240;2019
38;Santa Cruz de Tenerife;049;Valle Gran Rey;4564;2301;2263;2019
38;Santa Cruz de Tenerife;050;Vallehermoso;2901;1505;1396;2019
38;Santa Cruz de Tenerife;048;Valverde;5005;2511;2494;2019
38;Santa Cruz de Tenerife;051;Victoria de Acentejo, La;9185;4604;4581;2019
38;Santa Cruz de Tenerife;052;Vilaflor de Chasna;1667;857;810;2019
38;Santa Cruz de Tenerife;053;Villa de Mazo;4843;2453;2390;2019
40;Segovia;001;Abades;848;417;431;2019
40;Segovia;002;Adrada de Pirón;39;21;18;2019
40;Segovia;003;Adrados;126;73;53;2019
40;Segovia;004;Aguilafuente;573;286;287;2019
40;Segovia;005;Alconada de Maderuelo;25;16;9;2019
40;Segovia;012;Aldea Real;282;149;133;2019
40;Segovia;006;Aldealcorvo;22;13;9;2019
40;Segovia;007;Aldealengua de Pedraza;72;45;27;2019
40;Segovia;008;Aldealengua de Santa María;63;31;32;2019
40;Segovia;009;Aldeanueva de la Serrezuela;44;32;12;2019
40;Segovia;010;Aldeanueva del Codonal;117;64;53;2019
40;Segovia;013;Aldeasoña;56;33;23;2019
40;Segovia;014;Aldehorno;53;32;21;2019
40;Segovia;015;Aldehuela del Codonal;26;14;12;2019
40;Segovia;016;Aldeonte;55;30;25;2019
40;Segovia;017;Anaya;129;62;67;2019
40;Segovia;018;Añe;77;45;32;2019
40;Segovia;019;Arahuetes;30;22;8;2019
40;Segovia;020;Arcones;166;80;86;2019
40;Segovia;021;Arevalillo de Cega;20;12;8;2019
40;Segovia;022;Armuña;219;121;98;2019
40;Segovia;024;Ayllón;1196;617;579;2019
40;Segovia;025;Barbolla;158;87;71;2019
40;Segovia;026;Basardilla;153;68;85;2019
40;Segovia;028;Bercial;111;60;51;2019
40;Segovia;029;Bercimuel;24;13;11;2019
40;Segovia;030;Bernardos;476;262;214;2019
40;Segovia;031;Bernuy de Porreros;747;406;341;2019
40;Segovia;032;Boceguillas;723;374;349;2019
40;Segovia;033;Brieva;96;52;44;2019
40;Segovia;034;Caballar;83;48;35;2019
40;Segovia;035;Cabañas de Polendos;177;94;83;2019
40;Segovia;036;Cabezuela;664;343;321;2019
40;Segovia;037;Calabazas de Fuentidueña;28;15;13;2019
40;Segovia;039;Campo de San Pedro;238;129;109;2019
40;Segovia;040;Cantalejo;3523;1757;1766;2019
40;Segovia;041;Cantimpalos;1325;694;631;2019
40;Segovia;161;Carabias;57;38;19;2019
40;Segovia;043;Carbonero el Mayor;2519;1305;1214;2019
40;Segovia;044;Carrascal del Río;147;79;68;2019
40;Segovia;045;Casla;165;85;80;2019
40;Segovia;046;Castillejo de Mesleón;136;75;61;2019
40;Segovia;047;Castro de Fuentidueña;31;20;11;2019
40;Segovia;048;Castrojimeno;35;18;17;2019
40;Segovia;049;Castroserna de Abajo;40;23;17;2019
40;Segovia;051;Castroserracín;42;24;18;2019
40;Segovia;052;Cedillo de la Torre;89;48;41;2019
40;Segovia;053;Cerezo de Abajo;112;59;53;2019
40;Segovia;054;Cerezo de Arriba;136;77;59;2019
40;Segovia;065;Chañe;736;375;361;2019
40;Segovia;055;Cilleruelo de San Mamés;33;20;13;2019
40;Segovia;056;Cobos de Fuentidueña;34;16;18;2019
40;Segovia;057;Coca;1763;891;872;2019
40;Segovia;058;Codorniz;327;166;161;2019
40;Segovia;059;Collado Hermoso;125;63;62;2019
40;Segovia;060;Condado de Castilnovo;90;50;40;2019
40;Segovia;061;Corral de Ayllón;77;45;32;2019
40;Segovia;902;Cozuelos de Fuentidueña;131;72;59;2019
40;Segovia;062;Cubillo;73;44;29;2019
40;Segovia;063;Cuéllar;9583;4843;4740;2019
40;Segovia;905;Cuevas de Provanco;136;77;59;2019
40;Segovia;068;Domingo García;25;16;9;2019
40;Segovia;069;Donhierro;91;47;44;2019
40;Segovia;070;Duruelo;180;108;72;2019
40;Segovia;071;Encinas;44;22;22;2019
40;Segovia;072;Encinillas;304;168;136;2019
40;Segovia;073;Escalona del Prado;499;260;239;2019
40;Segovia;074;Escarabajosa de Cabezas;298;163;135;2019
40;Segovia;075;Escobar de Polendos;167;88;79;2019
40;Segovia;076;Espinar, El;8986;4557;4429;2019
40;Segovia;077;Espirdo;1344;706;638;2019
40;Segovia;078;Fresneda de Cuéllar;165;92;73;2019
40;Segovia;079;Fresno de Cantespino;265;148;117;2019
40;Segovia;080;Fresno de la Fuente;67;37;30;2019
40;Segovia;081;Frumales;112;60;52;2019
40;Segovia;082;Fuente de Santa Cruz;116;63;53;2019
40;Segovia;083;Fuente el Olmo de Fuentidueña;176;78;98;2019
40;Segovia;084;Fuente el Olmo de Íscar;56;31;25;2019
40;Segovia;086;Fuentepelayo;836;442;394;2019
40;Segovia;087;Fuentepiñel;96;53;43;2019
40;Segovia;088;Fuenterrebollo;341;177;164;2019
40;Segovia;089;Fuentesaúco de Fuentidueña;240;123;117;2019
40;Segovia;091;Fuentesoto;108;59;49;2019
40;Segovia;092;Fuentidueña;147;86;61;2019
40;Segovia;093;Gallegos;104;57;47;2019
40;Segovia;094;Garcillán;463;244;219;2019
40;Segovia;095;Gomezserracín;683;359;324;2019
40;Segovia;097;Grajera;238;137;101;2019
40;Segovia;099;Honrubia de la Cuesta;58;34;24;2019
40;Segovia;100;Hontalbilla;307;170;137;2019
40;Segovia;101;Hontanares de Eresma;1464;762;702;2019
40;Segovia;103;Huertos, Los;170;94;76;2019
40;Segovia;104;Ituero y Lama;378;201;177;2019
40;Segovia;105;Juarros de Riomoros;42;24;18;2019
40;Segovia;106;Juarros de Voltoya;200;98;102;2019
40;Segovia;107;Labajos;106;63;43;2019
40;Segovia;108;Laguna de Contreras;114;66;48;2019
40;Segovia;109;Languilla;84;51;33;2019
40;Segovia;110;Lastras de Cuéllar;358;186;172;2019
40;Segovia;111;Lastras del Pozo;64;34;30;2019
40;Segovia;112;Lastrilla, La;3891;1976;1915;2019
40;Segovia;113;Losa, La;521;291;230;2019
40;Segovia;115;Maderuelo;168;99;69;2019
40;Segovia;903;Marazoleja;101;65;36;2019
40;Segovia;118;Marazuela;50;29;21;2019
40;Segovia;119;Martín Miguel;212;128;84;2019
40;Segovia;120;Martín Muñoz de la Dehesa;235;123;112;2019
40;Segovia;121;Martín Muñoz de las Posadas;279;148;131;2019
40;Segovia;122;Marugán;623;337;286;2019
40;Segovia;124;Mata de Cuéllar;266;139;127;2019
40;Segovia;123;Matabuena;157;87;70;2019
40;Segovia;125;Matilla, La;84;50;34;2019
40;Segovia;126;Melque de Cercos;68;36;32;2019
40;Segovia;127;Membibre de la Hoz;36;19;17;2019
40;Segovia;128;Migueláñez;131;71;60;2019
40;Segovia;129;Montejo de Arévalo;177;97;80;2019
40;Segovia;130;Montejo de la Vega de la Serrezuela;146;87;59;2019
40;Segovia;131;Monterrubio;61;34;27;2019
40;Segovia;132;Moral de Hornuez;49;29;20;2019
40;Segovia;134;Mozoncillo;902;492;410;2019
40;Segovia;135;Muñopedro;303;165;138;2019
40;Segovia;136;Muñoveros;145;69;76;2019
40;Segovia;138;Nava de la Asunción;2774;1400;1374;2019
40;Segovia;139;Navafría;281;155;126;2019
40;Segovia;140;Navalilla;103;56;47;2019
40;Segovia;141;Navalmanzano;1049;546;503;2019
40;Segovia;142;Navares de Ayuso;53;27;26;2019
40;Segovia;143;Navares de Enmedio;94;57;37;2019
40;Segovia;144;Navares de las Cuevas;23;15;8;2019
40;Segovia;145;Navas de Oro;1338;677;661;2019
40;Segovia;904;Navas de Riofrío;394;185;209;2019
40;Segovia;146;Navas de San Antonio;328;170;158;2019
40;Segovia;148;Nieva;264;132;132;2019
40;Segovia;149;Olombrada;536;288;248;2019
40;Segovia;150;Orejana;58;35;23;2019
40;Segovia;151;Ortigosa de Pestaño;55;29;26;2019
40;Segovia;901;Ortigosa del Monte;561;299;262;2019
40;Segovia;152;Otero de Herreros;959;486;473;2019
40;Segovia;154;Pajarejos;25;13;12;2019
40;Segovia;155;Palazuelos de Eresma;5416;2801;2615;2019
40;Segovia;156;Pedraza;344;196;148;2019
40;Segovia;157;Pelayos del Arroyo;45;27;18;2019
40;Segovia;158;Perosillo;16;12;4;2019
40;Segovia;159;Pinarejos;186;109;77;2019
40;Segovia;160;Pinarnegrillo;96;53;43;2019
40;Segovia;162;Prádena;523;277;246;2019
40;Segovia;163;Puebla de Pedraza;43;22;21;2019
40;Segovia;164;Rapariegos;205;105;100;2019
40;Segovia;181;Real Sitio de San Ildefonso;5241;2568;2673;2019
40;Segovia;165;Rebollo;81;43;38;2019
40;Segovia;166;Remondo;300;159;141;2019
40;Segovia;168;Riaguas de San Bartolomé;28;19;9;2019
40;Segovia;170;Riaza;2098;1118;980;2019
40;Segovia;171;Ribota;48;35;13;2019
40;Segovia;172;Riofrío de Riaza;45;26;19;2019
40;Segovia;173;Roda de Eresma;188;99;89;2019
40;Segovia;174;Sacramenia;365;187;178;2019
40;Segovia;176;Samboal;457;244;213;2019
40;Segovia;177;San Cristóbal de Cuéllar;151;82;69;2019
40;Segovia;178;San Cristóbal de la Vega;101;54;47;2019
40;Segovia;906;San Cristóbal de Segovia;3051;1528;1523;2019
40;Segovia;182;San Martín y Mudrián;245;114;131;2019
40;Segovia;183;San Miguel de Bernuy;140;70;70;2019
40;Segovia;184;San Pedro de Gaíllos;285;156;129;2019
40;Segovia;179;Sanchonuño;940;457;483;2019
40;Segovia;180;Sangarcía;314;176;138;2019
40;Segovia;185;Santa María la Real de Nieva;972;529;443;2019
40;Segovia;186;Santa Marta del Cerro;35;19;16;2019
40;Segovia;188;Santiuste de Pedraza;92;59;33;2019
40;Segovia;189;Santiuste de San Juan Bautista;545;302;243;2019
40;Segovia;190;Santo Domingo de Pirón;58;33;25;2019
40;Segovia;191;Santo Tomé del Puerto;252;140;112;2019
40;Segovia;192;Sauquillo de Cabezas;150;83;67;2019
40;Segovia;193;Sebúlcor;273;143;130;2019
40;Segovia;194;Segovia;51674;24181;27493;2019
40;Segovia;195;Sepúlveda;1003;515;488;2019
40;Segovia;196;Sequera de Fresno;35;23;12;2019
40;Segovia;198;Sotillo;27;15;12;2019
40;Segovia;199;Sotosalbos;120;61;59;2019
40;Segovia;200;Tabanera la Luenga;56;27;29;2019
40;Segovia;201;Tolocirio;47;23;24;2019
40;Segovia;206;Torre Val de San Pedro;184;98;86;2019
40;Segovia;202;Torreadrada;55;28;27;2019
40;Segovia;203;Torrecaballeros;1347;700;647;2019
40;Segovia;204;Torrecilla del Pinar;191;103;88;2019
40;Segovia;205;Torreiglesias;245;125;120;2019
40;Segovia;207;Trescasas;1071;550;521;2019
40;Segovia;208;Turégano;979;489;490;2019
40;Segovia;210;Urueñas;106;65;41;2019
40;Segovia;211;Valdeprados;67;37;30;2019
40;Segovia;212;Valdevacas de Montejo;30;15;15;2019
40;Segovia;213;Valdevacas y Guijar;99;53;46;2019
40;Segovia;218;Valle de Tabladillo;86;51;35;2019
40;Segovia;219;Vallelado;694;368;326;2019
40;Segovia;220;Valleruela de Pedraza;71;37;34;2019
40;Segovia;221;Valleruela de Sepúlveda;51;25;26;2019
40;Segovia;214;Valseca;233;129;104;2019
40;Segovia;215;Valtiendas;88;51;37;2019
40;Segovia;216;Valverde del Majano;1095;566;529;2019
40;Segovia;222;Veganzones;219;118;101;2019
40;Segovia;223;Vegas de Matute;273;161;112;2019
40;Segovia;224;Ventosilla y Tejadilla;19;13;6;2019
40;Segovia;225;Villacastín;1481;775;706;2019
40;Segovia;228;Villaverde de Íscar;604;315;289;2019
40;Segovia;229;Villaverde de Montejo;27;17;10;2019
40;Segovia;230;Villeguillo;110;61;49;2019
40;Segovia;231;Yanguas de Eresma;128;66;62;2019
40;Segovia;233;Zarzuela del Monte;479;252;227;2019
40;Segovia;234;Zarzuela del Pinar;429;220;209;2019
41;Sevilla;001;Aguadulce;2020;1003;1017;2019
41;Sevilla;002;Alanís;1723;867;856;2019
41;Sevilla;003;Albaida del Aljarafe;3197;1601;1596;2019
41;Sevilla;004;Alcalá de Guadaíra;75279;37379;37900;2019
41;Sevilla;005;Alcalá del Río;12029;6116;5913;2019
41;Sevilla;006;Alcolea del Río;3373;1683;1690;2019
41;Sevilla;007;Algaba, La;16374;8123;8251;2019
41;Sevilla;008;Algámitas;1255;643;612;2019
41;Sevilla;009;Almadén de la Plata;1355;696;659;2019
41;Sevilla;010;Almensilla;6080;3043;3037;2019
41;Sevilla;011;Arahal;19526;9677;9849;2019
41;Sevilla;012;Aznalcázar;4586;2318;2268;2019
41;Sevilla;013;Aznalcóllar;6091;3102;2989;2019
41;Sevilla;014;Badolatosa;3078;1589;1489;2019
41;Sevilla;015;Benacazón;7241;3660;3581;2019
41;Sevilla;016;Bollullos de la Mitación;10787;5406;5381;2019
41;Sevilla;017;Bormujos;21972;10879;11093;2019
41;Sevilla;018;Brenes;12471;6181;6290;2019
41;Sevilla;019;Burguillos;6716;3388;3328;2019
41;Sevilla;020;Cabezas de San Juan, Las;16417;8217;8200;2019
41;Sevilla;021;Camas;27509;13425;14084;2019
41;Sevilla;022;Campana, La;5276;2643;2633;2019
41;Sevilla;023;Cantillana;10684;5454;5230;2019
41;Sevilla;901;Cañada Rosal;3320;1641;1679;2019
41;Sevilla;024;Carmona;28531;14349;14182;2019
41;Sevilla;025;Carrión de los Céspedes;2544;1248;1296;2019
41;Sevilla;026;Casariche;5456;2798;2658;2019
41;Sevilla;027;Castilblanco de los Arroyos;4864;2443;2421;2019
41;Sevilla;028;Castilleja de Guzmán;2821;1447;1374;2019
41;Sevilla;029;Castilleja de la Cuesta;17418;8442;8976;2019
41;Sevilla;030;Castilleja del Campo;629;323;306;2019
41;Sevilla;031;Castillo de las Guardas, El;1443;752;691;2019
41;Sevilla;032;Cazalla de la Sierra;4718;2335;2383;2019
41;Sevilla;033;Constantina;5896;2916;2980;2019
41;Sevilla;034;Coria del Río;30777;15336;15441;2019
41;Sevilla;035;Coripe;1251;611;640;2019
41;Sevilla;036;Coronil, El;4746;2386;2360;2019
41;Sevilla;037;Corrales, Los;3941;2013;1928;2019
41;Sevilla;903;Cuervo de Sevilla, El;8610;4329;4281;2019
41;Sevilla;038;Dos Hermanas;133968;65828;68140;2019
41;Sevilla;039;Écija;39873;19707;20166;2019
41;Sevilla;040;Espartinas;15791;7898;7893;2019
41;Sevilla;041;Estepa;12505;6229;6276;2019
41;Sevilla;042;Fuentes de Andalucía;7111;3546;3565;2019
41;Sevilla;043;Garrobo, El;790;400;390;2019
41;Sevilla;044;Gelves;10184;5082;5102;2019
41;Sevilla;045;Gerena;7585;3808;3777;2019
41;Sevilla;046;Gilena;3727;1866;1861;2019
41;Sevilla;047;Gines;13420;6605;6815;2019
41;Sevilla;048;Guadalcanal;2627;1316;1311;2019
41;Sevilla;049;Guillena;12788;6440;6348;2019
41;Sevilla;050;Herrera;6461;3203;3258;2019
41;Sevilla;051;Huévar del Aljarafe;3015;1547;1468;2019
41;Sevilla;902;Isla Mayor;5839;2905;2934;2019
41;Sevilla;052;Lantejuela;3814;1945;1869;2019
41;Sevilla;053;Lebrija;27524;13735;13789;2019
41;Sevilla;054;Lora de Estepa;862;441;421;2019
41;Sevilla;055;Lora del Río;18662;9233;9429;2019
41;Sevilla;056;Luisiana, La;4576;2313;2263;2019
41;Sevilla;057;Madroño, El;278;140;138;2019
41;Sevilla;058;Mairena del Alcor;23550;11781;11769;2019
41;Sevilla;059;Mairena del Aljarafe;46089;22428;23661;2019
41;Sevilla;060;Marchena;19457;9689;9768;2019
41;Sevilla;061;Marinaleda;2627;1330;1297;2019
41;Sevilla;062;Martín de la Jara;2704;1387;1317;2019
41;Sevilla;063;Molares, Los;3480;1775;1705;2019
41;Sevilla;064;Montellano;7056;3519;3537;2019
41;Sevilla;065;Morón de la Frontera;27627;13628;13999;2019
41;Sevilla;066;Navas de la Concepción, Las;1559;775;784;2019
41;Sevilla;067;Olivares;9394;4711;4683;2019
41;Sevilla;068;Osuna;17560;8741;8819;2019
41;Sevilla;069;Palacios y Villafranca, Los;38354;19244;19110;2019
41;Sevilla;904;Palmar de Troya, El;2340;1165;1175;2019
41;Sevilla;070;Palomares del Río;8767;4395;4372;2019
41;Sevilla;071;Paradas;6908;3430;3478;2019
41;Sevilla;072;Pedrera;5194;2576;2618;2019
41;Sevilla;073;Pedroso, El;2018;996;1022;2019
41;Sevilla;074;Peñaflor;3656;1845;1811;2019
41;Sevilla;075;Pilas;13974;7041;6933;2019
41;Sevilla;076;Pruna;2603;1327;1276;2019
41;Sevilla;077;Puebla de Cazalla, La;10979;5469;5510;2019
41;Sevilla;078;Puebla de los Infantes, La;2991;1486;1505;2019
41;Sevilla;079;Puebla del Río, La;11868;5869;5999;2019
41;Sevilla;080;Real de la Jara, El;1503;742;761;2019
41;Sevilla;081;Rinconada, La;38628;19049;19579;2019
41;Sevilla;082;Roda de Andalucía, La;4183;2062;2121;2019
41;Sevilla;083;Ronquillo, El;1364;685;679;2019
41;Sevilla;084;Rubio, El;3408;1690;1718;2019
41;Sevilla;085;Salteras;5530;2679;2851;2019
41;Sevilla;086;San Juan de Aznalfarache;21416;10309;11107;2019
41;Sevilla;088;San Nicolás del Puerto;596;309;287;2019
41;Sevilla;087;Sanlúcar la Mayor;13808;6833;6975;2019
41;Sevilla;089;Santiponce;8554;4248;4306;2019
41;Sevilla;090;Saucejo, El;4284;2121;2163;2019
41;Sevilla;091;Sevilla;688592;326634;361958;2019
41;Sevilla;092;Tocina;9501;4700;4801;2019
41;Sevilla;093;Tomares;25359;12511;12848;2019
41;Sevilla;094;Umbrete;8894;4452;4442;2019
41;Sevilla;095;Utrera;50728;25161;25567;2019
41;Sevilla;096;Valencina de la Concepción;7751;3792;3959;2019
41;Sevilla;097;Villamanrique de la Condesa;4459;2201;2258;2019
41;Sevilla;100;Villanueva de San Juan;1120;550;570;2019
41;Sevilla;098;Villanueva del Ariscal;6610;3209;3401;2019
41;Sevilla;099;Villanueva del Río y Minas;4858;2459;2399;2019
41;Sevilla;101;Villaverde del Río;7818;3932;3886;2019
41;Sevilla;102;Viso del Alcor, El;19266;9628;9638;2019
42;Soria;001;Abejar;297;155;142;2019
42;Soria;003;Adradas;69;36;33;2019
42;Soria;004;Ágreda;3001;1535;1466;2019
42;Soria;006;Alconaba;176;114;62;2019
42;Soria;007;Alcubilla de Avellaneda;104;56;48;2019
42;Soria;008;Alcubilla de las Peñas;57;35;22;2019
42;Soria;009;Aldealafuente;92;53;39;2019
42;Soria;010;Aldealices;36;22;14;2019
42;Soria;011;Aldealpozo;17;8;9;2019
42;Soria;012;Aldealseñor;31;16;15;2019
42;Soria;013;Aldehuela de Periáñez;41;23;18;2019
42;Soria;014;Aldehuelas, Las;64;34;30;2019
42;Soria;015;Alentisque;33;20;13;2019
42;Soria;016;Aliud;20;15;5;2019
42;Soria;017;Almajano;187;98;89;2019
42;Soria;018;Almaluez;132;74;58;2019
42;Soria;019;Almarza;591;345;246;2019
42;Soria;020;Almazán;5489;2784;2705;2019
42;Soria;021;Almazul;67;41;26;2019
42;Soria;022;Almenar de Soria;228;135;93;2019
42;Soria;023;Alpanseque;62;38;24;2019
42;Soria;024;Arancón;88;59;29;2019
42;Soria;025;Arcos de Jalón;1469;761;708;2019
42;Soria;026;Arenillas;21;11;10;2019
42;Soria;027;Arévalo de la Sierra;78;49;29;2019
42;Soria;028;Ausejo de la Sierra;89;47;42;2019
42;Soria;029;Baraona;135;76;59;2019
42;Soria;030;Barca;98;62;36;2019
42;Soria;031;Barcones;22;15;7;2019
42;Soria;032;Bayubas de Abajo;142;77;65;2019
42;Soria;033;Bayubas de Arriba;57;34;23;2019
42;Soria;034;Beratón;47;26;21;2019
42;Soria;035;Berlanga de Duero;856;436;420;2019
42;Soria;036;Blacos;39;21;18;2019
42;Soria;037;Bliecos;33;19;14;2019
42;Soria;038;Borjabad;33;20;13;2019
42;Soria;039;Borobia;239;127;112;2019
42;Soria;041;Buberos;31;17;14;2019
42;Soria;042;Buitrago;65;34;31;2019
42;Soria;043;Burgo de Osma-Ciudad de Osma;4940;2463;2477;2019
42;Soria;044;Cabrejas del Campo;53;34;19;2019
42;Soria;045;Cabrejas del Pinar;347;198;149;2019
42;Soria;046;Calatañazor;51;29;22;2019
42;Soria;048;Caltojar;52;36;16;2019
42;Soria;049;Candilichera;113;66;47;2019
42;Soria;050;Cañamaque;30;19;11;2019
42;Soria;051;Carabantes;15;8;7;2019
42;Soria;052;Caracena;17;11;6;2019
42;Soria;053;Carrascosa de Abajo;21;14;7;2019
42;Soria;054;Carrascosa de la Sierra;19;14;5;2019
42;Soria;055;Casarejos;169;88;81;2019
42;Soria;056;Castilfrío de la Sierra;29;20;9;2019
42;Soria;058;Castillejo de Robledo;103;60;43;2019
42;Soria;057;Castilruiz;162;84;78;2019
42;Soria;059;Centenera de Andaluz;20;10;10;2019
42;Soria;060;Cerbón;28;19;9;2019
42;Soria;061;Cidones;301;183;118;2019
42;Soria;062;Cigudosa;19;12;7;2019
42;Soria;063;Cihuela;51;28;23;2019
42;Soria;064;Ciria;88;45;43;2019
42;Soria;065;Cirujales del Río;22;16;6;2019
42;Soria;068;Coscurita;79;49;30;2019
42;Soria;069;Covaleda;1680;868;812;2019
42;Soria;070;Cubilla;33;20;13;2019
42;Soria;071;Cubo de la Solana;184;101;83;2019
42;Soria;073;Cueva de Ágreda;73;46;27;2019
42;Soria;075;Dévanos;79;45;34;2019
42;Soria;076;Deza;214;112;102;2019
42;Soria;078;Duruelo de la Sierra;1090;556;534;2019
42;Soria;079;Escobosa de Almazán;21;14;7;2019
42;Soria;080;Espeja de San Marcelino;155;91;64;2019
42;Soria;081;Espejón;161;86;75;2019
42;Soria;082;Estepa de San Juan;7;6;1;2019
42;Soria;083;Frechilla de Almazán;24;13;11;2019
42;Soria;084;Fresno de Caracena;21;14;7;2019
42;Soria;085;Fuentearmegil;178;102;76;2019
42;Soria;086;Fuentecambrón;34;21;13;2019
42;Soria;087;Fuentecantos;61;31;30;2019
42;Soria;088;Fuentelmonge;61;36;25;2019
42;Soria;089;Fuentelsaz de Soria;66;33;33;2019
42;Soria;090;Fuentepinilla;88;57;31;2019
42;Soria;092;Fuentes de Magaña;64;38;26;2019
42;Soria;093;Fuentestrún;43;29;14;2019
42;Soria;094;Garray;732;395;337;2019
42;Soria;095;Golmayo;2626;1369;1257;2019
42;Soria;096;Gómara;310;169;141;2019
42;Soria;097;Gormaz;16;12;4;2019
42;Soria;098;Herrera de Soria;9;7;2;2019
42;Soria;100;Hinojosa del Campo;31;20;11;2019
42;Soria;103;Langa de Duero;704;387;317;2019
42;Soria;105;Liceras;49;25;24;2019
42;Soria;106;Losilla, La;14;10;4;2019
42;Soria;107;Magaña;69;39;30;2019
42;Soria;108;Maján;10;6;4;2019
42;Soria;110;Matalebreras;66;40;26;2019
42;Soria;111;Matamala de Almazán;288;152;136;2019
42;Soria;113;Medinaceli;713;363;350;2019
42;Soria;115;Miño de Medinaceli;100;63;37;2019
42;Soria;116;Miño de San Esteban;46;30;16;2019
42;Soria;117;Molinos de Duero;162;89;73;2019
42;Soria;118;Momblona;22;15;7;2019
42;Soria;119;Monteagudo de las Vicarías;185;93;92;2019
42;Soria;120;Montejo de Tiermes;155;100;55;2019
42;Soria;121;Montenegro de Cameros;57;36;21;2019
42;Soria;123;Morón de Almazán;193;100;93;2019
42;Soria;124;Muriel de la Fuente;61;35;26;2019
42;Soria;125;Muriel Viejo;85;56;29;2019
42;Soria;127;Nafría de Ucero;36;21;15;2019
42;Soria;128;Narros;50;28;22;2019
42;Soria;129;Navaleno;769;407;362;2019
42;Soria;130;Nepas;51;36;15;2019
42;Soria;131;Nolay;57;31;26;2019
42;Soria;132;Noviercas;156;88;68;2019
42;Soria;134;Ólvega;3656;1902;1754;2019
42;Soria;135;Oncala;75;43;32;2019
42;Soria;139;Pinilla del Campo;21;12;9;2019
42;Soria;140;Portillo de Soria;14;9;5;2019
42;Soria;141;Póveda de Soria, La;123;74;49;2019
42;Soria;142;Pozalmuro;56;27;29;2019
42;Soria;144;Quintana Redonda;489;274;215;2019
42;Soria;145;Quintanas de Gormaz;146;90;56;2019
42;Soria;148;Quiñonería;9;5;4;2019
42;Soria;149;Rábanos, Los;453;257;196;2019
42;Soria;151;Rebollar;42;20;22;2019
42;Soria;152;Recuerda;79;46;33;2019
42;Soria;153;Rello;14;9;5;2019
42;Soria;154;Renieblas;104;63;41;2019
42;Soria;155;Retortillo de Soria;149;87;62;2019
42;Soria;156;Reznos;32;22;10;2019
42;Soria;157;Riba de Escalote, La;9;7;2;2019
42;Soria;158;Rioseco de Soria;123;73;50;2019
42;Soria;159;Rollamienta;40;27;13;2019
42;Soria;160;Royo, El;265;144;121;2019
42;Soria;161;Salduero;143;78;65;2019
42;Soria;162;San Esteban de Gormaz;3005;1576;1429;2019
42;Soria;163;San Felices;51;32;19;2019
42;Soria;164;San Leonardo de Yagüe;2044;1038;1006;2019
42;Soria;165;San Pedro Manrique;620;348;272;2019
42;Soria;166;Santa Cruz de Yanguas;61;38;23;2019
42;Soria;167;Santa María de Huerta;266;147;119;2019
42;Soria;168;Santa María de las Hoyas;97;57;40;2019
42;Soria;171;Serón de Nágima;124;73;51;2019
42;Soria;172;Soliedra;32;18;14;2019
42;Soria;173;Soria;39398;18579;20819;2019
42;Soria;174;Sotillo del Rincón;190;100;90;2019
42;Soria;175;Suellacabras;25;15;10;2019
42;Soria;176;Tajahuerce;27;15;12;2019
42;Soria;177;Tajueco;64;35;29;2019
42;Soria;178;Talveila;105;63;42;2019
42;Soria;181;Tardelcuende;431;229;202;2019
42;Soria;182;Taroda;50;28;22;2019
42;Soria;183;Tejado;108;62;46;2019
42;Soria;184;Torlengua;59;33;26;2019
42;Soria;185;Torreblacos;25;13;12;2019
42;Soria;187;Torrubia de Soria;65;46;19;2019
42;Soria;188;Trévago;43;18;25;2019
42;Soria;189;Ucero;50;26;24;2019
42;Soria;190;Vadillo;96;50;46;2019
42;Soria;191;Valdeavellano de Tera;191;104;87;2019
42;Soria;192;Valdegeña;38;28;10;2019
42;Soria;193;Valdelagua del Cerro;18;11;7;2019
42;Soria;194;Valdemaluque;151;68;83;2019
42;Soria;195;Valdenebro;106;59;47;2019
42;Soria;196;Valdeprado;8;5;3;2019
42;Soria;197;Valderrodilla;68;36;32;2019
42;Soria;198;Valtajeros;19;13;6;2019
42;Soria;200;Velamazán;76;50;26;2019
42;Soria;201;Velilla de la Sierra;24;15;9;2019
42;Soria;202;Velilla de los Ajos;20;10;10;2019
42;Soria;204;Viana de Duero;54;39;15;2019
42;Soria;205;Villaciervos;87;53;34;2019
42;Soria;206;Villanueva de Gormaz;8;6;2;2019
42;Soria;207;Villar del Ala;51;27;24;2019
42;Soria;208;Villar del Campo;22;14;8;2019
42;Soria;209;Villar del Río;139;85;54;2019
42;Soria;211;Villares de Soria, Los;88;49;39;2019
42;Soria;212;Villasayas;67;44;23;2019
42;Soria;213;Villaseca de Arciel;28;16;12;2019
42;Soria;215;Vinuesa;855;459;396;2019
42;Soria;216;Vizmanos;25;17;8;2019
42;Soria;217;Vozmediano;38;24;14;2019
42;Soria;218;Yanguas;113;75;38;2019
42;Soria;219;Yelo;40;24;16;2019
43;Tarragona;001;Aiguamúrcia;901;465;436;2019
43;Tarragona;002;Albinyana;2438;1243;1195;2019
43;Tarragona;003;Albiol, L';485;253;232;2019
43;Tarragona;004;Alcanar;9418;4748;4670;2019
43;Tarragona;005;Alcover;5064;2499;2565;2019
43;Tarragona;904;Aldea, L';4160;2197;1963;2019
43;Tarragona;006;Aldover;882;445;437;2019
43;Tarragona;007;Aleixar, L';873;450;423;2019
43;Tarragona;008;Alfara de Carles;377;199;178;2019
43;Tarragona;009;Alforja;1801;921;880;2019
43;Tarragona;010;Alió;439;208;231;2019
43;Tarragona;011;Almoster;1351;680;671;2019
43;Tarragona;012;Altafulla;5243;2555;2688;2019
43;Tarragona;013;Ametlla de Mar, L';6787;3384;3403;2019
43;Tarragona;906;Ampolla, L';3205;1631;1574;2019
43;Tarragona;014;Amposta;20738;10449;10289;2019
43;Tarragona;016;Arboç, L';5517;2852;2665;2019
43;Tarragona;015;Arbolí;137;79;58;2019
43;Tarragona;017;Argentera, L';124;70;54;2019
43;Tarragona;018;Arnes;455;224;231;2019
43;Tarragona;019;Ascó;1660;856;804;2019
43;Tarragona;020;Banyeres del Penedès;3170;1612;1558;2019
43;Tarragona;021;Barberà de la Conca;473;257;216;2019
43;Tarragona;022;Batea;1890;944;946;2019
43;Tarragona;023;Bellmunt del Priorat;280;145;135;2019
43;Tarragona;024;Bellvei;2203;1132;1071;2019
43;Tarragona;025;Benifallet;739;348;391;2019
43;Tarragona;026;Benissanet;1161;646;515;2019
43;Tarragona;027;Bisbal de Falset, La;216;116;100;2019
43;Tarragona;028;Bisbal del Penedès, La;3528;1862;1666;2019
43;Tarragona;029;Blancafort;389;198;191;2019
43;Tarragona;030;Bonastre;688;357;331;2019
43;Tarragona;031;Borges del Camp, Les;2037;1050;987;2019
43;Tarragona;032;Bot;573;295;278;2019
43;Tarragona;033;Botarell;1068;549;519;2019
43;Tarragona;034;Bràfim;692;357;335;2019
43;Tarragona;035;Cabacés;298;155;143;2019
43;Tarragona;036;Cabra del Camp;1163;608;555;2019
43;Tarragona;037;Calafell;26538;13362;13176;2019
43;Tarragona;903;Camarles;3224;1638;1586;2019
43;Tarragona;038;Cambrils;33898;16553;17345;2019
43;Tarragona;907;Canonja, La;5893;2892;3001;2019
43;Tarragona;039;Capafonts;121;62;59;2019
43;Tarragona;040;Capçanes;398;202;196;2019
43;Tarragona;041;Caseres;259;129;130;2019
43;Tarragona;042;Castellvell del Camp;2857;1438;1419;2019
43;Tarragona;043;Catllar, El;4451;2309;2142;2019
43;Tarragona;045;Colldejou;176;93;83;2019
43;Tarragona;046;Conesa;103;54;49;2019
43;Tarragona;047;Constantí;6540;3398;3142;2019
43;Tarragona;048;Corbera d'Ebre;1016;531;485;2019
43;Tarragona;049;Cornudella de Montsant;941;505;436;2019
43;Tarragona;050;Creixell;3642;1845;1797;2019
43;Tarragona;051;Cunit;12952;6347;6605;2019
43;Tarragona;901;Deltebre;11482;5788;5694;2019
43;Tarragona;053;Duesaigües;245;140;105;2019
43;Tarragona;054;Espluga de Francolí, L';3755;1824;1931;2019
43;Tarragona;055;Falset;2834;1412;1422;2019
43;Tarragona;056;Fatarella, La;941;458;483;2019
43;Tarragona;057;Febró, La;40;25;15;2019
43;Tarragona;058;Figuera, La;111;63;48;2019
43;Tarragona;059;Figuerola del Camp;320;159;161;2019
43;Tarragona;060;Flix;3408;1717;1691;2019
43;Tarragona;061;Forès;43;25;18;2019
43;Tarragona;062;Freginals;346;175;171;2019
43;Tarragona;063;Galera, La;731;375;356;2019
43;Tarragona;064;Gandesa;3064;1563;1501;2019
43;Tarragona;065;Garcia;527;264;263;2019
43;Tarragona;066;Garidells, Els;187;94;93;2019
43;Tarragona;067;Ginestar;753;403;350;2019
43;Tarragona;068;Godall;575;289;286;2019
43;Tarragona;069;Gratallops;229;125;104;2019
43;Tarragona;070;Guiamets, Els;270;128;142;2019
43;Tarragona;071;Horta de Sant Joan;1149;602;547;2019
43;Tarragona;072;Lloar, El;107;58;49;2019
43;Tarragona;073;Llorac;100;52;48;2019
43;Tarragona;074;Llorenç del Penedès;2393;1172;1221;2019
43;Tarragona;076;Marçà;594;314;280;2019
43;Tarragona;075;Margalef;97;59;38;2019
43;Tarragona;077;Mas de Barberans;578;288;290;2019
43;Tarragona;078;Masdenverge;1070;546;524;2019
43;Tarragona;079;Masllorenç;504;283;221;2019
43;Tarragona;080;Masó, La;276;146;130;2019
43;Tarragona;081;Maspujols;827;426;401;2019
43;Tarragona;082;Masroig, El;497;270;227;2019
43;Tarragona;083;Milà, El;178;85;93;2019
43;Tarragona;084;Miravet;691;369;322;2019
43;Tarragona;085;Molar, El;297;158;139;2019
43;Tarragona;086;Montblanc;7364;3737;3627;2019
43;Tarragona;088;Montbrió del Camp;2890;1485;1405;2019
43;Tarragona;089;Montferri;387;202;185;2019
43;Tarragona;090;Montmell, El;1512;808;704;2019
43;Tarragona;091;Mont-ral;162;94;68;2019
43;Tarragona;092;Mont-roig del Camp;12136;6260;5876;2019
43;Tarragona;093;Móra d'Ebre;5690;2845;2845;2019
43;Tarragona;094;Móra la Nova;3087;1541;1546;2019
43;Tarragona;095;Morell, El;3704;1881;1823;2019
43;Tarragona;096;Morera de Montsant, La;152;85;67;2019
43;Tarragona;097;Nou de Gaià, La;603;300;303;2019
43;Tarragona;098;Nulles;492;267;225;2019
43;Tarragona;100;Pallaresos, Els;4777;2404;2373;2019
43;Tarragona;099;Palma d'Ebre, La;340;166;174;2019
43;Tarragona;101;Passanant i Belltall;163;95;68;2019
43;Tarragona;102;Paüls;556;277;279;2019
43;Tarragona;103;Perafort;1261;654;607;2019
43;Tarragona;104;Perelló, El;2770;1421;1349;2019
43;Tarragona;105;Piles, Les;212;120;92;2019
43;Tarragona;106;Pinell de Brai, El;1017;516;501;2019
43;Tarragona;107;Pira;493;261;232;2019
43;Tarragona;108;Pla de Santa Maria, El;2327;1215;1112;2019
43;Tarragona;109;Pobla de Mafumet, La;3904;1982;1922;2019
43;Tarragona;110;Pobla de Massaluca, La;318;181;137;2019
43;Tarragona;111;Pobla de Montornès, La;2839;1486;1353;2019
43;Tarragona;112;Poboleda;313;166;147;2019
43;Tarragona;113;Pont d'Armentera, El;505;258;247;2019
43;Tarragona;141;Pontils;117;66;51;2019
43;Tarragona;114;Porrera;439;229;210;2019
43;Tarragona;115;Pradell de la Teixeta;152;70;82;2019
43;Tarragona;116;Prades;589;309;280;2019
43;Tarragona;117;Prat de Comte;183;98;85;2019
43;Tarragona;118;Pratdip;738;395;343;2019
43;Tarragona;119;Puigpelat;1149;590;559;2019
43;Tarragona;120;Querol;507;285;222;2019
43;Tarragona;121;Rasquera;781;384;397;2019
43;Tarragona;122;Renau;157;82;75;2019
43;Tarragona;123;Reus;104373;50415;53958;2019
43;Tarragona;124;Riba, La;585;321;264;2019
43;Tarragona;125;Riba-roja d'Ebre;1126;593;533;2019
43;Tarragona;126;Riera de Gaià, La;1744;867;877;2019
43;Tarragona;127;Riudecanyes;1124;590;534;2019
43;Tarragona;128;Riudecols;1180;611;569;2019
43;Tarragona;129;Riudoms;6594;3380;3214;2019
43;Tarragona;130;Rocafort de Queralt;225;122;103;2019
43;Tarragona;131;Roda de Berà;6567;3341;3226;2019
43;Tarragona;132;Rodonyà;490;262;228;2019
43;Tarragona;133;Roquetes;7973;4126;3847;2019
43;Tarragona;134;Rourell, El;366;191;175;2019
43;Tarragona;135;Salomó;557;295;262;2019
43;Tarragona;905;Salou;27476;14141;13335;2019
43;Tarragona;136;Sant Carles de la Ràpita;14789;7238;7551;2019
43;Tarragona;137;Sant Jaume dels Domenys;2622;1342;1280;2019
43;Tarragona;902;Sant Jaume d'Enveja;3503;1765;1738;2019
43;Tarragona;138;Santa Bàrbara;3707;1881;1826;2019
43;Tarragona;139;Santa Coloma de Queralt;2673;1328;1345;2019
43;Tarragona;140;Santa Oliva;3320;1685;1635;2019
43;Tarragona;142;Sarral;1548;789;759;2019
43;Tarragona;143;Savallà del Comtat;58;31;27;2019
43;Tarragona;144;Secuita, La;1687;851;836;2019
43;Tarragona;145;Selva del Camp, La;5652;2836;2816;2019
43;Tarragona;146;Senan;48;33;15;2019
43;Tarragona;044;Sénia, La;5681;2844;2837;2019
43;Tarragona;147;Solivella;633;333;300;2019
43;Tarragona;148;Tarragona;134515;65505;69010;2019
43;Tarragona;149;Tivenys;899;458;441;2019
43;Tarragona;150;Tivissa;1602;799;803;2019
43;Tarragona;151;Torre de Fontaubella, La;138;68;70;2019
43;Tarragona;152;Torre de l'Espanyol, La;611;311;300;2019
43;Tarragona;153;Torredembarra;16184;7925;8259;2019
43;Tarragona;154;Torroja del Priorat;149;81;68;2019
43;Tarragona;155;Tortosa;33372;16496;16876;2019
43;Tarragona;156;Ulldecona;6300;3286;3014;2019
43;Tarragona;157;Ulldemolins;396;229;167;2019
43;Tarragona;158;Vallclara;98;57;41;2019
43;Tarragona;159;Vallfogona de Riucorb;91;55;36;2019
43;Tarragona;160;Vallmoll;1756;890;866;2019
43;Tarragona;161;Valls;24359;12210;12149;2019
43;Tarragona;162;Vandellòs i l'Hospitalet de l'Infant;6482;3246;3236;2019
43;Tarragona;163;Vendrell, El;37606;18631;18975;2019
43;Tarragona;164;Vespella de Gaià;410;232;178;2019
43;Tarragona;165;Vilabella;736;378;358;2019
43;Tarragona;175;Vilalba dels Arcs;625;318;307;2019
43;Tarragona;166;Vilallonga del Camp;2389;1206;1183;2019
43;Tarragona;168;Vilanova de Prades;112;60;52;2019
43;Tarragona;167;Vilanova d'Escornalbou;545;288;257;2019
43;Tarragona;169;Vilaplana;574;302;272;2019
43;Tarragona;170;Vila-rodona;1255;660;595;2019
43;Tarragona;171;Vila-seca;22187;11113;11074;2019
43;Tarragona;172;Vilaverd;452;240;212;2019
43;Tarragona;173;Vilella Alta, La;135;73;62;2019
43;Tarragona;174;Vilella Baixa, La;202;113;89;2019
43;Tarragona;176;Vimbodí i Poblet;892;488;404;2019
43;Tarragona;177;Vinebre;428;221;207;2019
43;Tarragona;178;Vinyols i els Arcs;2056;1070;986;2019
43;Tarragona;052;Xerta;1170;571;599;2019
44;Teruel;001;Ababuj;73;45;28;2019
44;Teruel;002;Abejuela;48;31;17;2019
44;Teruel;003;Aguatón;18;6;12;2019
44;Teruel;004;Aguaviva;514;247;267;2019
44;Teruel;005;Aguilar del Alfambra;63;36;27;2019
44;Teruel;006;Alacón;252;129;123;2019
44;Teruel;007;Alba;170;94;76;2019
44;Teruel;008;Albalate del Arzobispo;1980;1013;967;2019
44;Teruel;009;Albarracín;1025;521;504;2019
44;Teruel;010;Albentosa;276;149;127;2019
44;Teruel;011;Alcaine;59;36;23;2019
44;Teruel;012;Alcalá de la Selva;343;188;155;2019
44;Teruel;013;Alcañiz;15947;7911;8036;2019
44;Teruel;014;Alcorisa;3266;1661;1605;2019
44;Teruel;016;Alfambra;508;264;244;2019
44;Teruel;017;Aliaga;341;188;153;2019
44;Teruel;021;Allepuz;125;63;62;2019
44;Teruel;022;Alloza;558;292;266;2019
44;Teruel;023;Allueva;26;17;9;2019
44;Teruel;018;Almohaja;16;11;5;2019
44;Teruel;019;Alobras;64;40;24;2019
44;Teruel;020;Alpeñés;22;13;9;2019
44;Teruel;024;Anadón;28;18;10;2019
44;Teruel;025;Andorra;7472;3773;3699;2019
44;Teruel;026;Arcos de las Salinas;119;68;51;2019
44;Teruel;027;Arens de Lledó;211;108;103;2019
44;Teruel;028;Argente;195;96;99;2019
44;Teruel;029;Ariño;724;365;359;2019
44;Teruel;031;Azaila;90;46;44;2019
44;Teruel;032;Bádenas;19;12;7;2019
44;Teruel;033;Báguena;287;161;126;2019
44;Teruel;034;Bañón;144;79;65;2019
44;Teruel;035;Barrachina;112;60;52;2019
44;Teruel;036;Bea;31;18;13;2019
44;Teruel;037;Beceite;541;273;268;2019
44;Teruel;039;Bello;224;111;113;2019
44;Teruel;038;Belmonte de San José;113;53;60;2019
44;Teruel;040;Berge;235;119;116;2019
44;Teruel;041;Bezas;70;45;25;2019
44;Teruel;042;Blancas;126;75;51;2019
44;Teruel;043;Blesa;94;60;34;2019
44;Teruel;044;Bordón;100;56;44;2019
44;Teruel;045;Bronchales;432;248;184;2019
44;Teruel;046;Bueña;50;27;23;2019
44;Teruel;047;Burbáguena;249;131;118;2019
44;Teruel;048;Cabra de Mora;54;34;20;2019
44;Teruel;049;Calaceite;994;488;506;2019
44;Teruel;050;Calamocha;4339;2166;2173;2019
44;Teruel;051;Calanda;3748;1852;1896;2019
44;Teruel;052;Calomarde;75;44;31;2019
44;Teruel;053;Camañas;134;78;56;2019
44;Teruel;054;Camarena de la Sierra;105;65;40;2019
44;Teruel;055;Camarillas;100;61;39;2019
44;Teruel;056;Caminreal;620;324;296;2019
44;Teruel;059;Cantavieja;709;368;341;2019
44;Teruel;060;Cañada de Benatanduz;36;24;12;2019
44;Teruel;061;Cañada de Verich, La;89;55;34;2019
44;Teruel;062;Cañada Vellida;31;22;9;2019
44;Teruel;063;Cañizar del Olivar;100;53;47;2019
44;Teruel;064;Cascante del Río;67;42;25;2019
44;Teruel;065;Castejón de Tornos;60;38;22;2019
44;Teruel;066;Castel de Cabra;96;53;43;2019
44;Teruel;070;Castellar, El;58;38;20;2019
44;Teruel;071;Castellote;681;348;333;2019
44;Teruel;067;Castelnou;141;74;67;2019
44;Teruel;068;Castelserás;815;430;385;2019
44;Teruel;074;Cedrillas;664;325;339;2019
44;Teruel;075;Celadas;388;221;167;2019
44;Teruel;076;Cella;2574;1329;1245;2019
44;Teruel;077;Cerollera, La;93;58;35;2019
44;Teruel;080;Codoñera, La;336;177;159;2019
44;Teruel;082;Corbalán;107;56;51;2019
44;Teruel;084;Cortes de Aragón;61;28;33;2019
44;Teruel;085;Cosa;50;32;18;2019
44;Teruel;086;Cretas;567;290;277;2019
44;Teruel;087;Crivillén;62;32;30;2019
44;Teruel;088;Cuba, La;43;26;17;2019
44;Teruel;089;Cubla;58;39;19;2019
44;Teruel;090;Cucalón;78;47;31;2019
44;Teruel;092;Cuervo, El;78;42;36;2019
44;Teruel;093;Cuevas de Almudén;126;71;55;2019
44;Teruel;094;Cuevas Labradas;132;72;60;2019
44;Teruel;096;Ejulve;175;90;85;2019
44;Teruel;097;Escorihuela;136;67;69;2019
44;Teruel;099;Escucha;852;448;404;2019
44;Teruel;100;Estercuel;203;111;92;2019
44;Teruel;101;Ferreruela de Huerva;56;33;23;2019
44;Teruel;102;Fonfría;27;15;12;2019
44;Teruel;103;Formiche Alto;141;80;61;2019
44;Teruel;105;Fórnoles;80;43;37;2019
44;Teruel;106;Fortanete;205;119;86;2019
44;Teruel;107;Foz-Calanda;245;128;117;2019
44;Teruel;108;Fresneda, La;438;245;193;2019
44;Teruel;109;Frías de Albarracín;115;69;46;2019
44;Teruel;110;Fuenferrada;37;22;15;2019
44;Teruel;111;Fuentes Calientes;92;53;39;2019
44;Teruel;112;Fuentes Claras;461;252;209;2019
44;Teruel;113;Fuentes de Rubielos;118;61;57;2019
44;Teruel;114;Fuentespalda;284;143;141;2019
44;Teruel;115;Galve;162;84;78;2019
44;Teruel;116;Gargallo;93;51;42;2019
44;Teruel;117;Gea de Albarracín;360;194;166;2019
44;Teruel;118;Ginebrosa, La;194;106;88;2019
44;Teruel;119;Griegos;136;80;56;2019
44;Teruel;120;Guadalaviar;241;134;107;2019
44;Teruel;121;Gúdar;76;47;29;2019
44;Teruel;122;Híjar;1721;866;855;2019
44;Teruel;123;Hinojosa de Jarque;111;63;48;2019
44;Teruel;124;Hoz de la Vieja, La;83;42;41;2019
44;Teruel;125;Huesa del Común;73;46;27;2019
44;Teruel;126;Iglesuela del Cid, La;410;216;194;2019
44;Teruel;127;Jabaloyas;63;38;25;2019
44;Teruel;128;Jarque de la Val;66;35;31;2019
44;Teruel;129;Jatiel;37;23;14;2019
44;Teruel;130;Jorcas;30;18;12;2019
44;Teruel;131;Josa;34;21;13;2019
44;Teruel;132;Lagueruela;73;38;35;2019
44;Teruel;133;Lanzuela;22;16;6;2019
44;Teruel;135;Libros;102;64;38;2019
44;Teruel;136;Lidón;57;31;26;2019
44;Teruel;137;Linares de Mora;234;137;97;2019
44;Teruel;141;Lledó;159;82;77;2019
44;Teruel;138;Loscos;122;74;48;2019
44;Teruel;142;Maicas;28;15;13;2019
44;Teruel;143;Manzanera;531;285;246;2019
44;Teruel;144;Martín del Río;401;195;206;2019
44;Teruel;145;Mas de las Matas;1262;657;605;2019
44;Teruel;146;Mata de los Olmos, La;257;130;127;2019
44;Teruel;147;Mazaleón;522;277;245;2019
44;Teruel;148;Mezquita de Jarque;96;57;39;2019
44;Teruel;149;Mirambel;116;67;49;2019
44;Teruel;150;Miravete de la Sierra;31;21;10;2019
44;Teruel;151;Molinos;239;125;114;2019
44;Teruel;152;Monforte de Moyuela;67;45;22;2019
44;Teruel;153;Monreal del Campo;2434;1208;1226;2019
44;Teruel;154;Monroyo;340;200;140;2019
44;Teruel;155;Montalbán;1233;622;611;2019
44;Teruel;156;Monteagudo del Castillo;54;30;24;2019
44;Teruel;157;Monterde de Albarracín;64;40;24;2019
44;Teruel;158;Mora de Rubielos;1548;766;782;2019
44;Teruel;159;Moscardón;54;30;24;2019
44;Teruel;160;Mosqueruela;537;293;244;2019
44;Teruel;161;Muniesa;583;308;275;2019
44;Teruel;163;Noguera de Albarracín;140;81;59;2019
44;Teruel;164;Nogueras;22;16;6;2019
44;Teruel;165;Nogueruelas;217;123;94;2019
44;Teruel;167;Obón;44;23;21;2019
44;Teruel;168;Odón;206;107;99;2019
44;Teruel;169;Ojos Negros;360;198;162;2019
44;Teruel;171;Olba;228;128;100;2019
44;Teruel;172;Oliete;351;183;168;2019
44;Teruel;173;Olmos, Los;120;65;55;2019
44;Teruel;174;Orihuela del Tremedal;463;251;212;2019
44;Teruel;175;Orrios;125;67;58;2019
44;Teruel;176;Palomar de Arroyos;168;99;69;2019
44;Teruel;177;Pancrudo;113;65;48;2019
44;Teruel;178;Parras de Castellote, Las;55;31;24;2019
44;Teruel;179;Peñarroya de Tastavins;439;241;198;2019
44;Teruel;180;Peracense;77;42;35;2019
44;Teruel;181;Peralejos;79;47;32;2019
44;Teruel;182;Perales del Alfambra;229;123;106;2019
44;Teruel;183;Pitarque;73;38;35;2019
44;Teruel;184;Plou;43;27;16;2019
44;Teruel;185;Pobo, El;110;70;40;2019
44;Teruel;187;Portellada, La;235;118;117;2019
44;Teruel;189;Pozondón;50;30;20;2019
44;Teruel;190;Pozuel del Campo;65;35;30;2019
44;Teruel;191;Puebla de Híjar, La;897;450;447;2019
44;Teruel;192;Puebla de Valverde, La;457;253;204;2019
44;Teruel;193;Puertomingalvo;109;55;54;2019
44;Teruel;194;Ráfales;138;81;57;2019
44;Teruel;195;Rillo;88;53;35;2019
44;Teruel;196;Riodeva;142;69;73;2019
44;Teruel;197;Ródenas;63;35;28;2019
44;Teruel;198;Royuela;204;117;87;2019
44;Teruel;199;Rubiales;52;30;22;2019
44;Teruel;200;Rubielos de la Cérida;39;24;15;2019
44;Teruel;201;Rubielos de Mora;621;326;295;2019
44;Teruel;203;Salcedillo;14;9;5;2019
44;Teruel;204;Saldón;27;18;9;2019
44;Teruel;205;Samper de Calanda;755;387;368;2019
44;Teruel;206;San Agustín;119;72;47;2019
44;Teruel;207;San Martín del Río;137;72;65;2019
44;Teruel;208;Santa Cruz de Nogueras;29;13;16;2019
44;Teruel;209;Santa Eulalia;1061;544;517;2019
44;Teruel;210;Sarrión;1128;590;538;2019
44;Teruel;211;Segura de los Baños;38;24;14;2019
44;Teruel;212;Seno;43;19;24;2019
44;Teruel;213;Singra;75;44;31;2019
44;Teruel;215;Terriente;183;103;80;2019
44;Teruel;216;Teruel;35890;17080;18810;2019
44;Teruel;217;Toril y Masegoso;32;26;6;2019
44;Teruel;218;Tormón;30;17;13;2019
44;Teruel;219;Tornos;206;108;98;2019
44;Teruel;220;Torralba de los Sisones;155;86;69;2019
44;Teruel;223;Torre de Arcas;90;44;46;2019
44;Teruel;224;Torre de las Arcas;28;15;13;2019
44;Teruel;225;Torre del Compte;120;58;62;2019
44;Teruel;227;Torre los Negros;84;44;40;2019
44;Teruel;221;Torrecilla de Alcañiz;433;224;209;2019
44;Teruel;222;Torrecilla del Rebollar;124;81;43;2019
44;Teruel;226;Torrelacárcel;151;82;69;2019
44;Teruel;228;Torremocha de Jiloca;109;63;46;2019
44;Teruel;229;Torres de Albarracín;180;103;77;2019
44;Teruel;230;Torrevelilla;186;92;94;2019
44;Teruel;231;Torrijas;41;19;22;2019
44;Teruel;232;Torrijo del Campo;455;234;221;2019
44;Teruel;234;Tramacastiel;72;42;30;2019
44;Teruel;235;Tramacastilla;103;52;51;2019
44;Teruel;236;Tronchón;67;33;34;2019
44;Teruel;237;Urrea de Gaén;435;218;217;2019
44;Teruel;238;Utrillas;2978;1545;1433;2019
44;Teruel;239;Valacloche;22;12;10;2019
44;Teruel;240;Valbona;167;93;74;2019
44;Teruel;241;Valdealgorfa;612;301;311;2019
44;Teruel;243;Valdecuenca;34;20;14;2019
44;Teruel;244;Valdelinares;88;54;34;2019
44;Teruel;245;Valdeltormo;283;136;147;2019
44;Teruel;246;Valderrobres;2425;1240;1185;2019
44;Teruel;247;Valjunquera;330;171;159;2019
44;Teruel;249;Vallecillo, El;47;27;20;2019
44;Teruel;250;Veguillas de la Sierra;19;12;7;2019
44;Teruel;251;Villafranca del Campo;298;155;143;2019
44;Teruel;252;Villahermosa del Campo;89;57;32;2019
44;Teruel;256;Villanueva del Rebollar de la Sierra;39;24;15;2019
44;Teruel;257;Villar del Cobo;164;97;67;2019
44;Teruel;258;Villar del Salz;55;34;21;2019
44;Teruel;260;Villarluengo;170;99;71;2019
44;Teruel;261;Villarquemado;863;447;416;2019
44;Teruel;262;Villarroya de los Pinares;172;92;80;2019
44;Teruel;263;Villastar;505;252;253;2019
44;Teruel;264;Villel;329;183;146;2019
44;Teruel;265;Vinaceite;251;136;115;2019
44;Teruel;266;Visiedo;119;53;66;2019
44;Teruel;267;Vivel del Río Martín;73;37;36;2019
44;Teruel;268;Zoma, La;33;18;15;2019
45;Toledo;001;Ajofrín;2264;1135;1129;2019
45;Toledo;002;Alameda de la Sagra;3623;1912;1711;2019
45;Toledo;003;Albarreal de Tajo;683;353;330;2019
45;Toledo;004;Alcabón;686;351;335;2019
45;Toledo;005;Alcañizo;274;139;135;2019
45;Toledo;006;Alcaudete de la Jara;1648;833;815;2019
45;Toledo;007;Alcolea de Tajo;810;399;411;2019
45;Toledo;008;Aldea en Cabo;163;86;77;2019
45;Toledo;009;Aldeanueva de Barbarroya;520;267;253;2019
45;Toledo;010;Aldeanueva de San Bartolomé;427;213;214;2019
45;Toledo;011;Almendral de la Cañada;313;162;151;2019
45;Toledo;012;Almonacid de Toledo;790;388;402;2019
45;Toledo;013;Almorox;2105;1104;1001;2019
45;Toledo;014;Añover de Tajo;5154;2620;2534;2019
45;Toledo;015;Arcicóllar;883;437;446;2019
45;Toledo;016;Argés;6418;3197;3221;2019
45;Toledo;017;Azután;288;144;144;2019
45;Toledo;018;Barcience;872;458;414;2019
45;Toledo;019;Bargas;10332;5174;5158;2019
45;Toledo;020;Belvís de la Jara;1522;764;758;2019
45;Toledo;021;Borox;3825;2002;1823;2019
45;Toledo;022;Buenaventura;424;216;208;2019
45;Toledo;023;Burguillos de Toledo;3172;1636;1536;2019
45;Toledo;024;Burujón;1319;670;649;2019
45;Toledo;025;Cabañas de la Sagra;1799;922;877;2019
45;Toledo;026;Cabañas de Yepes;257;135;122;2019
45;Toledo;027;Cabezamesada;346;189;157;2019
45;Toledo;028;Calera y Chozas;4646;2341;2305;2019
45;Toledo;029;Caleruela;208;100;108;2019
45;Toledo;030;Calzada de Oropesa;529;291;238;2019
45;Toledo;031;Camarena;3960;2058;1902;2019
45;Toledo;032;Camarenilla;565;283;282;2019
45;Toledo;033;Campillo de la Jara, El;344;180;164;2019
45;Toledo;034;Camuñas;1726;887;839;2019
45;Toledo;035;Cardiel de los Montes;355;194;161;2019
45;Toledo;036;Carmena;743;376;367;2019
45;Toledo;037;Carpio de Tajo, El;1838;920;918;2019
45;Toledo;038;Carranque;4846;2526;2320;2019
45;Toledo;039;Carriches;262;131;131;2019
45;Toledo;040;Casar de Escalona, El;1725;931;794;2019
45;Toledo;041;Casarrubios del Monte;5681;2984;2697;2019
45;Toledo;042;Casasbuenas;201;98;103;2019
45;Toledo;043;Castillo de Bayuela;938;465;473;2019
45;Toledo;045;Cazalegas;1750;905;845;2019
45;Toledo;046;Cebolla;3235;1615;1620;2019
45;Toledo;047;Cedillo del Condado;3762;1945;1817;2019
45;Toledo;048;Cerralbos, Los;421;233;188;2019
45;Toledo;049;Cervera de los Montes;517;260;257;2019
45;Toledo;056;Chozas de Canales;3966;2065;1901;2019
45;Toledo;057;Chueca;257;134;123;2019
45;Toledo;050;Ciruelos;551;293;258;2019
45;Toledo;051;Cobeja;2255;1163;1092;2019
45;Toledo;052;Cobisa;4310;2164;2146;2019
45;Toledo;053;Consuegra;9998;5061;4937;2019
45;Toledo;054;Corral de Almaguer;5352;2763;2589;2019
45;Toledo;055;Cuerva;1291;670;621;2019
45;Toledo;058;Domingo Pérez;372;192;180;2019
45;Toledo;059;Dosbarrios;2223;1137;1086;2019
45;Toledo;060;Erustes;193;101;92;2019
45;Toledo;061;Escalona;3241;1679;1562;2019
45;Toledo;062;Escalonilla;1427;716;711;2019
45;Toledo;063;Espinoso del Rey;436;247;189;2019
45;Toledo;064;Esquivias;5549;2822;2727;2019
45;Toledo;065;Estrella, La;225;117;108;2019
45;Toledo;066;Fuensalida;11370;5768;5602;2019
45;Toledo;067;Gálvez;3016;1501;1515;2019
45;Toledo;068;Garciotum;206;108;98;2019
45;Toledo;069;Gerindote;2300;1170;1130;2019
45;Toledo;070;Guadamur;1792;900;892;2019
45;Toledo;071;Guardia, La;2246;1133;1113;2019
45;Toledo;072;Herencias, Las;785;419;366;2019
45;Toledo;073;Herreruela de Oropesa;333;171;162;2019
45;Toledo;074;Hinojosa de San Vicente;383;210;173;2019
45;Toledo;075;Hontanar;141;83;58;2019
45;Toledo;076;Hormigos;709;391;318;2019
45;Toledo;077;Huecas;710;369;341;2019
45;Toledo;078;Huerta de Valdecarábanos;1649;817;832;2019
45;Toledo;079;Iglesuela del Tiétar, La;411;215;196;2019
45;Toledo;080;Illán de Vacas;3;3;0;2019
45;Toledo;081;Illescas;28894;14584;14310;2019
45;Toledo;082;Lagartera;1369;683;686;2019
45;Toledo;083;Layos;754;370;384;2019
45;Toledo;084;Lillo;2577;1333;1244;2019
45;Toledo;085;Lominchar;2387;1258;1129;2019
45;Toledo;086;Lucillos;589;312;277;2019
45;Toledo;087;Madridejos;10453;5228;5225;2019
45;Toledo;088;Magán;3544;1786;1758;2019
45;Toledo;089;Malpica de Tajo;1705;881;824;2019
45;Toledo;090;Manzaneque;383;184;199;2019
45;Toledo;091;Maqueda;438;219;219;2019
45;Toledo;092;Marjaliza;247;120;127;2019
45;Toledo;093;Marrupe;159;78;81;2019
45;Toledo;094;Mascaraque;442;230;212;2019
45;Toledo;095;Mata, La;838;415;423;2019
45;Toledo;096;Mazarambroz;1241;641;600;2019
45;Toledo;097;Mejorada;1275;661;614;2019
45;Toledo;098;Menasalbas;2651;1399;1252;2019
45;Toledo;099;Méntrida;5099;2614;2485;2019
45;Toledo;100;Mesegar de Tajo;214;112;102;2019
45;Toledo;101;Miguel Esteban;4856;2421;2435;2019
45;Toledo;102;Mocejón;4875;2456;2419;2019
45;Toledo;103;Mohedas de la Jara;402;222;180;2019
45;Toledo;104;Montearagón;525;279;246;2019
45;Toledo;105;Montesclaros;406;217;189;2019
45;Toledo;106;Mora;9718;4875;4843;2019
45;Toledo;107;Nambroca;4732;2439;2293;2019
45;Toledo;108;Nava de Ricomalillo, La;535;274;261;2019
45;Toledo;109;Navahermosa;3609;1866;1743;2019
45;Toledo;110;Navalcán;1985;1044;941;2019
45;Toledo;111;Navalmoralejo;54;28;26;2019
45;Toledo;112;Navalmorales, Los;2518;1327;1191;2019
45;Toledo;113;Navalucillos, Los;2106;1080;1026;2019
45;Toledo;114;Navamorcuende;623;313;310;2019
45;Toledo;115;Noblejas;3585;1818;1767;2019
45;Toledo;116;Noez;878;446;432;2019
45;Toledo;117;Nombela;858;452;406;2019
45;Toledo;118;Novés;2905;1482;1423;2019
45;Toledo;119;Numancia de la Sagra;4902;2570;2332;2019
45;Toledo;120;Nuño Gómez;133;76;57;2019
45;Toledo;121;Ocaña;11597;5849;5748;2019
45;Toledo;122;Olías del Rey;7880;4043;3837;2019
45;Toledo;123;Ontígola;4387;2336;2051;2019
45;Toledo;124;Orgaz;2602;1293;1309;2019
45;Toledo;125;Oropesa;2662;1296;1366;2019
45;Toledo;126;Otero;331;176;155;2019
45;Toledo;127;Palomeque;971;522;449;2019
45;Toledo;128;Pantoja;3317;1660;1657;2019
45;Toledo;129;Paredes de Escalona;111;54;57;2019
45;Toledo;130;Parrillas;352;187;165;2019
45;Toledo;131;Pelahustán;311;176;135;2019
45;Toledo;132;Pepino;3055;1564;1491;2019
45;Toledo;133;Polán;3848;1931;1917;2019
45;Toledo;134;Portillo de Toledo;2209;1109;1100;2019
45;Toledo;135;Puebla de Almoradiel, La;5168;2619;2549;2019
45;Toledo;136;Puebla de Montalbán, La;7861;3989;3872;2019
45;Toledo;137;Pueblanueva, La;2140;1077;1063;2019
45;Toledo;138;Puente del Arzobispo, El;1246;621;625;2019
45;Toledo;139;Puerto de San Vicente;156;83;73;2019
45;Toledo;140;Pulgar;1508;771;737;2019
45;Toledo;141;Quero;986;510;476;2019
45;Toledo;142;Quintanar de la Orden;11030;5471;5559;2019
45;Toledo;143;Quismondo;1527;780;747;2019
45;Toledo;144;Real de San Vicente, El;922;494;428;2019
45;Toledo;145;Recas;4262;2362;1900;2019
45;Toledo;146;Retamoso de la Jara;104;56;48;2019
45;Toledo;147;Rielves;752;381;371;2019
45;Toledo;148;Robledo del Mazo;281;158;123;2019
45;Toledo;149;Romeral, El;622;307;315;2019
45;Toledo;150;San Bartolomé de las Abiertas;447;235;212;2019
45;Toledo;151;San Martín de Montalbán;712;358;354;2019
45;Toledo;152;San Martín de Pusa;642;338;304;2019
45;Toledo;153;San Pablo de los Montes;1768;887;881;2019
45;Toledo;154;San Román de los Montes;1881;999;882;2019
45;Toledo;155;Santa Ana de Pusa;353;203;150;2019
45;Toledo;156;Santa Cruz de la Zarza;4129;2097;2032;2019
45;Toledo;157;Santa Cruz del Retamar;3079;1625;1454;2019
45;Toledo;158;Santa Olalla;3251;1654;1597;2019
45;Toledo;901;Santo Domingo-Caudilla;1038;551;487;2019
45;Toledo;159;Sartajada;96;58;38;2019
45;Toledo;160;Segurilla;1324;666;658;2019
45;Toledo;161;Seseña;25835;13283;12552;2019
45;Toledo;162;Sevilleja de la Jara;682;371;311;2019
45;Toledo;163;Sonseca;11067;5585;5482;2019
45;Toledo;164;Sotillo de las Palomas;183;92;91;2019
45;Toledo;165;Talavera de la Reina;83417;40081;43336;2019
45;Toledo;166;Tembleque;1986;1008;978;2019
45;Toledo;167;Toboso, El;1764;874;890;2019
45;Toledo;168;Toledo;84873;40527;44346;2019
45;Toledo;169;Torralba de Oropesa;211;108;103;2019
45;Toledo;171;Torre de Esteban Hambrán, La;1637;828;809;2019
45;Toledo;170;Torrecilla de la Jara;224;119;105;2019
45;Toledo;172;Torrico;709;364;345;2019
45;Toledo;173;Torrijos;13466;6588;6878;2019
45;Toledo;174;Totanés;348;172;176;2019
45;Toledo;175;Turleque;749;377;372;2019
45;Toledo;176;Ugena;5411;2793;2618;2019
45;Toledo;177;Urda;2529;1262;1267;2019
45;Toledo;179;Valdeverdeja;564;280;284;2019
45;Toledo;180;Valmojado;4303;2162;2141;2019
45;Toledo;181;Velada;2910;1506;1404;2019
45;Toledo;182;Ventas con Peña Aguilera, Las;1109;569;540;2019
45;Toledo;183;Ventas de Retamosa, Las;3365;1768;1597;2019
45;Toledo;184;Ventas de San Julián, Las;228;111;117;2019
45;Toledo;186;Villa de Don Fadrique, La;3664;1810;1854;2019
45;Toledo;185;Villacañas;9548;4735;4813;2019
45;Toledo;187;Villafranca de los Caballeros;4896;2421;2475;2019
45;Toledo;188;Villaluenga de la Sagra;3815;1905;1910;2019
45;Toledo;189;Villamiel de Toledo;873;447;426;2019
45;Toledo;190;Villaminaya;527;264;263;2019
45;Toledo;191;Villamuelas;612;322;290;2019
45;Toledo;192;Villanueva de Alcardete;3250;1675;1575;2019
45;Toledo;193;Villanueva de Bogas;712;370;342;2019
45;Toledo;194;Villarejo de Montalbán;74;39;35;2019
45;Toledo;195;Villarrubia de Santiago;2536;1264;1272;2019
45;Toledo;196;Villaseca de la Sagra;1820;904;916;2019
45;Toledo;197;Villasequilla;2478;1277;1201;2019
45;Toledo;198;Villatobas;2403;1228;1175;2019
45;Toledo;199;Viso de San Juan, El;4416;2364;2052;2019
45;Toledo;200;Yébenes, Los;5901;3016;2885;2019
45;Toledo;201;Yeles;5329;2804;2525;2019
45;Toledo;202;Yepes;5198;2684;2514;2019
45;Toledo;203;Yuncler;3940;2026;1914;2019
45;Toledo;204;Yunclillos;809;421;388;2019
45;Toledo;205;Yuncos;11222;5736;5486;2019
46;Valencia/València;001;Ademuz;1042;568;474;2019
46;Valencia/València;002;Ador;1508;804;704;2019
46;Valencia/València;004;Agullent;2410;1191;1219;2019
46;Valencia/València;042;Aielo de Malferit;4618;2324;2294;2019
46;Valencia/València;043;Aielo de Rugat;155;85;70;2019
46;Valencia/València;005;Alaquàs;29561;14527;15034;2019
46;Valencia/València;006;Albaida;5900;2921;2979;2019
46;Valencia/València;007;Albal;16399;8213;8186;2019
46;Valencia/València;008;Albalat de la Ribera;3360;1689;1671;2019
46;Valencia/València;009;Albalat dels Sorells;3977;1950;2027;2019
46;Valencia/València;010;Albalat dels Tarongers;1232;644;588;2019
46;Valencia/València;011;Alberic;10526;5190;5336;2019
46;Valencia/València;012;Alborache;1160;608;552;2019
46;Valencia/València;013;Alboraia/Alboraya;24454;11976;12478;2019
46;Valencia/València;014;Albuixech;4017;1975;2042;2019
46;Valencia/València;016;Alcàntera de Xúquer;1291;646;645;2019
46;Valencia/València;015;Alcàsser;10039;5043;4996;2019
46;Valencia/València;018;Alcublas;628;338;290;2019
46;Valencia/València;020;Alcúdia de Crespins, l';5157;2561;2596;2019
46;Valencia/València;019;Alcúdia, l';12009;5896;6113;2019
46;Valencia/València;021;Aldaia;31864;15858;16006;2019
46;Valencia/València;022;Alfafar;20890;10230;10660;2019
46;Valencia/València;024;Alfara de la Baronia;557;272;285;2019
46;Valencia/València;025;Alfara del Patriarca;3310;1604;1706;2019
46;Valencia/València;026;Alfarp;1544;801;743;2019
46;Valencia/València;027;Alfarrasí;1225;607;618;2019
46;Valencia/València;023;Alfauir;437;223;214;2019
46;Valencia/València;028;Algar de Palancia;481;255;226;2019
46;Valencia/València;029;Algemesí;27331;13552;13779;2019
46;Valencia/València;030;Algímia d'Alfara;1011;507;504;2019
46;Valencia/València;031;Alginet;13380;6755;6625;2019
46;Valencia/València;032;Almàssera;7349;3575;3774;2019
46;Valencia/València;033;Almiserà;262;137;125;2019
46;Valencia/València;034;Almoines;2414;1228;1186;2019
46;Valencia/València;035;Almussafes;8967;4458;4509;2019
46;Valencia/València;036;Alpuente;633;347;286;2019
46;Valencia/València;037;Alqueria de la Comtessa, l';1476;716;760;2019
46;Valencia/València;017;Alzira;44352;21608;22744;2019
46;Valencia/València;038;Andilla;319;202;117;2019
46;Valencia/València;039;Anna;2628;1322;1306;2019
46;Valencia/València;040;Antella;1175;571;604;2019
46;Valencia/València;041;Aras de los Olmos;381;215;166;2019
46;Valencia/València;003;Atzeneta d'Albaida;1165;584;581;2019
46;Valencia/València;044;Ayora;5312;2629;2683;2019
46;Valencia/València;046;Barx;1277;672;605;2019
46;Valencia/València;045;Barxeta;1601;825;776;2019
46;Valencia/València;047;Bèlgida;673;330;343;2019
46;Valencia/València;048;Bellreguard;4608;2292;2316;2019
46;Valencia/València;049;Bellús;304;160;144;2019
46;Valencia/València;050;Benagéber;192;110;82;2019
46;Valencia/València;051;Benaguasil;10988;5625;5363;2019
46;Valencia/València;052;Benavites;619;290;329;2019
46;Valencia/València;053;Beneixida;651;323;328;2019
46;Valencia/València;054;Benetússer;14799;7180;7619;2019
46;Valencia/València;055;Beniarjó;1765;892;873;2019
46;Valencia/València;056;Beniatjar;223;116;107;2019
46;Valencia/València;057;Benicolet;569;283;286;2019
46;Valencia/València;904;Benicull de Xúquer;1012;514;498;2019
46;Valencia/València;060;Benifaió;11962;5928;6034;2019
46;Valencia/València;059;Benifairó de la Valldigna;1571;780;791;2019
46;Valencia/València;058;Benifairó de les Valls;2186;1085;1101;2019
46;Valencia/València;061;Beniflá;457;236;221;2019
46;Valencia/València;062;Benigànim;5841;2981;2860;2019
46;Valencia/València;063;Benimodo;2268;1137;1131;2019
46;Valencia/València;064;Benimuslem;653;352;301;2019
46;Valencia/València;065;Beniparrell;1952;982;970;2019
46;Valencia/València;066;Benirredrà;1592;779;813;2019
46;Valencia/València;067;Benissanó;2260;1130;1130;2019
46;Valencia/València;068;Benissoda;430;238;192;2019
46;Valencia/València;069;Benissuera;194;95;99;2019
46;Valencia/València;070;Bétera;24272;12101;12171;2019
46;Valencia/València;071;Bicorp;533;262;271;2019
46;Valencia/València;072;Bocairent;4195;2132;2063;2019
46;Valencia/València;073;Bolbaite;1356;685;671;2019
46;Valencia/València;074;Bonrepòs i Mirambell;3691;1815;1876;2019
46;Valencia/València;075;Bufali;161;86;75;2019
46;Valencia/València;076;Bugarra;727;374;353;2019
46;Valencia/València;077;Buñol;9408;4693;4715;2019
46;Valencia/València;078;Burjassot;38024;18332;19692;2019
46;Valencia/València;079;Calles;355;204;151;2019
46;Valencia/València;080;Camporrobles;1191;611;580;2019
46;Valencia/València;081;Canals;13587;6807;6780;2019
46;Valencia/València;082;Canet d'En Berenguer;6697;3426;3271;2019
46;Valencia/València;083;Carcaixent;20358;10071;10287;2019
46;Valencia/València;084;Càrcer;1862;885;977;2019
46;Valencia/València;085;Carlet;15598;7769;7829;2019
46;Valencia/València;086;Carrícola;94;47;47;2019
46;Valencia/València;087;Casas Altas;131;74;57;2019
46;Valencia/València;088;Casas Bajas;164;88;76;2019
46;Valencia/València;089;Casinos;2777;1428;1349;2019
46;Valencia/València;090;Castelló de Rugat;2274;1163;1111;2019
46;Valencia/València;091;Castellonet de la Conquesta;147;80;67;2019
46;Valencia/València;092;Castielfabib;317;168;149;2019
46;Valencia/València;093;Catadau;2777;1378;1399;2019
46;Valencia/València;094;Catarroja;28120;13885;14235;2019
46;Valencia/València;095;Caudete de las Fuentes;700;370;330;2019
46;Valencia/València;096;Cerdà;331;177;154;2019
46;Valencia/València;107;Chella;2435;1205;1230;2019
46;Valencia/València;106;Chelva;1489;766;723;2019
46;Valencia/València;108;Chera;474;256;218;2019
46;Valencia/València;109;Cheste;8494;4339;4155;2019
46;Valencia/València;111;Chiva;15123;7740;7383;2019
46;Valencia/València;112;Chulilla;665;355;310;2019
46;Valencia/València;097;Cofrentes;1130;574;556;2019
46;Valencia/València;098;Corbera;3100;1547;1553;2019
46;Valencia/València;099;Cortes de Pallás;814;447;367;2019
46;Valencia/València;100;Cotes;333;171;162;2019
46;Valencia/València;105;Cullera;22145;11037;11108;2019
46;Valencia/València;113;Daimús;3117;1538;1579;2019
46;Valencia/València;114;Domeño;708;357;351;2019
46;Valencia/València;115;Dos Aguas;376;209;167;2019
46;Valencia/València;116;Eliana, l';18235;8875;9360;2019
46;Valencia/València;117;Emperador;687;359;328;2019
46;Valencia/València;118;Enguera;4752;2366;2386;2019
46;Valencia/València;119;Ènova, l';887;453;434;2019
46;Valencia/València;120;Estivella;1456;703;753;2019
46;Valencia/València;121;Estubeny;121;61;60;2019
46;Valencia/València;122;Faura;3538;1791;1747;2019
46;Valencia/València;123;Favara;2518;1286;1232;2019
46;Valencia/València;126;Foios;7367;3632;3735;2019
46;Valencia/València;128;Font de la Figuera, la;2038;1020;1018;2019
46;Valencia/València;127;Font d'En Carròs, la;3794;1889;1905;2019
46;Valencia/València;124;Fontanars dels Alforins;971;500;471;2019
46;Valencia/València;125;Fortaleny;1026;508;518;2019
46;Valencia/València;129;Fuenterrobles;682;379;303;2019
46;Valencia/València;131;Gandia;74562;36665;37897;2019
46;Valencia/València;902;Gátova;378;180;198;2019
46;Valencia/València;130;Gavarda;1038;498;540;2019
46;Valencia/València;132;Genovés, el;2842;1428;1414;2019
46;Valencia/València;133;Gestalgar;556;295;261;2019
46;Valencia/València;134;Gilet;3324;1719;1605;2019
46;Valencia/València;135;Godella;13088;6317;6771;2019
46;Valencia/València;136;Godelleta;3533;1819;1714;2019
46;Valencia/València;137;Granja de la Costera, la;285;142;143;2019
46;Valencia/València;138;Guadasséquies;468;239;229;2019
46;Valencia/València;139;Guadassuar;5893;2882;3011;2019
46;Valencia/València;140;Guardamar de la Safor;526;283;243;2019
46;Valencia/València;141;Higueruelas;500;271;229;2019
46;Valencia/València;142;Jalance;830;425;405;2019
46;Valencia/València;144;Jarafuel;754;394;360;2019
46;Valencia/València;154;Llanera de Ranes;1055;529;526;2019
46;Valencia/València;155;Llaurí;1170;607;563;2019
46;Valencia/València;147;Llíria;23253;11767;11486;2019
46;Valencia/València;152;Llocnou de la Corona;118;64;54;2019
46;Valencia/València;153;Llocnou de Sant Jeroni;546;276;270;2019
46;Valencia/València;151;Llocnou d'En Fenollet;916;476;440;2019
46;Valencia/València;156;Llombai;2685;1351;1334;2019
46;Valencia/València;157;Llosa de Ranes, la;3575;1833;1742;2019
46;Valencia/València;150;Llutxent;2345;1200;1145;2019
46;Valencia/València;148;Loriguilla;2025;1036;989;2019
46;Valencia/València;149;Losa del Obispo;507;261;246;2019
46;Valencia/València;158;Macastre;1283;681;602;2019
46;Valencia/València;159;Manises;30919;15266;15653;2019
46;Valencia/València;160;Manuel;2428;1196;1232;2019
46;Valencia/València;161;Marines;1828;966;862;2019
46;Valencia/València;162;Massalavés;1596;843;753;2019
46;Valencia/València;163;Massalfassar;2469;1230;1239;2019
46;Valencia/València;164;Massamagrell;15952;7889;8063;2019
46;Valencia/València;165;Massanassa;9667;4794;4873;2019
46;Valencia/València;166;Meliana;10822;5309;5513;2019
46;Valencia/València;167;Millares;345;183;162;2019
46;Valencia/València;168;Miramar;2634;1355;1279;2019
46;Valencia/València;169;Mislata;43691;21246;22445;2019
46;Valencia/València;170;Mogente/Moixent;4302;2155;2147;2019
46;Valencia/València;171;Moncada;21935;10706;11229;2019
46;Valencia/València;173;Montaverner;1630;809;821;2019
46;Valencia/València;174;Montesa;1164;585;579;2019
46;Valencia/València;175;Montitxelvo/Montichelvo;584;289;295;2019
46;Valencia/València;176;Montroi/Montroy;2867;1533;1334;2019
46;Valencia/València;172;Montserrat;7878;4053;3825;2019
46;Valencia/València;177;Museros;6458;3253;3205;2019
46;Valencia/València;178;Nàquera/Náquera;6577;3410;3167;2019
46;Valencia/València;179;Navarrés;2968;1503;1465;2019
46;Valencia/València;180;Novelé/Novetlè;837;411;426;2019
46;Valencia/València;181;Oliva;25101;12312;12789;2019
46;Valencia/València;183;Olleria, l';8281;4132;4149;2019
46;Valencia/València;182;Olocau;1771;931;840;2019
46;Valencia/València;184;Ontinyent;35347;17441;17906;2019
46;Valencia/València;185;Otos;434;219;215;2019
46;Valencia/València;186;Paiporta;26088;12884;13204;2019
46;Valencia/València;187;Palma de Gandía;1631;843;788;2019
46;Valencia/València;188;Palmera;1024;523;501;2019
46;Valencia/València;189;Palomar, el;590;297;293;2019
46;Valencia/València;190;Paterna;70195;34697;35498;2019
46;Valencia/València;191;Pedralba;2778;1453;1325;2019
46;Valencia/València;192;Petrés;997;504;493;2019
46;Valencia/València;193;Picanya;11513;5709;5804;2019
46;Valencia/València;194;Picassent;20942;10540;10402;2019
46;Valencia/València;195;Piles;2685;1346;1339;2019
46;Valencia/València;196;Pinet;157;76;81;2019
46;Valencia/València;199;Pobla de Farnals, la;7978;4038;3940;2019
46;Valencia/València;202;Pobla de Vallbona, la;24433;12312;12121;2019
46;Valencia/València;200;Pobla del Duc, la;2543;1238;1305;2019
46;Valencia/València;203;Pobla Llarga, la;4452;2242;2210;2019
46;Valencia/València;197;Polinyà de Xúquer;2472;1250;1222;2019
46;Valencia/València;198;Potries;1046;528;518;2019
46;Valencia/València;205;Puçol;19495;9590;9905;2019
46;Valencia/València;201;Puebla de San Miguel;62;39;23;2019
46;Valencia/València;204;Puig de Santa Maria, el;8630;4216;4414;2019
46;Valencia/València;101;Quart de les Valls;988;470;518;2019
46;Valencia/València;102;Quart de Poblet;24760;12053;12707;2019
46;Valencia/València;103;Quartell;1636;784;852;2019
46;Valencia/València;104;Quatretonda;2212;1108;1104;2019
46;Valencia/València;206;Quesa;670;348;322;2019
46;Valencia/València;207;Rafelbunyol;8941;4390;4551;2019
46;Valencia/València;208;Rafelcofer;1345;659;686;2019
46;Valencia/València;209;Rafelguaraf;2335;1156;1179;2019
46;Valencia/València;210;Ráfol de Salem;462;224;238;2019
46;Valencia/València;212;Real;2154;1103;1051;2019
46;Valencia/València;211;Real de Gandia, el;2461;1204;1257;2019
46;Valencia/València;213;Requena;20254;10129;10125;2019
46;Valencia/València;214;Riba-roja de Túria;22264;11271;10993;2019
46;Valencia/València;215;Riola;1759;884;875;2019
46;Valencia/València;216;Rocafort;7240;3537;3703;2019
46;Valencia/València;217;Rotglà i Corberà;1138;572;566;2019
46;Valencia/València;218;Rótova;1294;677;617;2019
46;Valencia/València;219;Rugat;158;83;75;2019
46;Valencia/València;220;Sagunto/Sagunt;66140;32366;33774;2019
46;Valencia/València;221;Salem;424;218;206;2019
46;Valencia/València;903;San Antonio de Benagéber;9089;4477;4612;2019
46;Valencia/València;222;Sant Joanet;504;250;254;2019
46;Valencia/València;223;Sedaví;10333;5040;5293;2019
46;Valencia/València;224;Segart;163;84;79;2019
46;Valencia/València;225;Sellent;389;191;198;2019
46;Valencia/València;226;Sempere;34;19;15;2019
46;Valencia/València;227;Senyera;1136;563;573;2019
46;Valencia/València;228;Serra;3124;1618;1506;2019
46;Valencia/València;229;Siete Aguas;1154;611;543;2019
46;Valencia/València;230;Silla;18771;9325;9446;2019
46;Valencia/València;231;Simat de la Valldigna;3329;1658;1671;2019
46;Valencia/València;232;Sinarcas;1125;581;544;2019
46;Valencia/València;233;Sollana;4861;2376;2485;2019
46;Valencia/València;234;Sot de Chera;369;202;167;2019
46;Valencia/València;235;Sueca;27479;13548;13931;2019
46;Valencia/València;236;Sumacàrcer;1096;540;556;2019
46;Valencia/València;237;Tavernes Blanques;9120;4463;4657;2019
46;Valencia/València;238;Tavernes de la Valldigna;17201;8571;8630;2019
46;Valencia/València;239;Teresa de Cofrentes;636;329;307;2019
46;Valencia/València;240;Terrateig;278;147;131;2019
46;Valencia/València;241;Titaguas;453;238;215;2019
46;Valencia/València;242;Torrebaja;411;222;189;2019
46;Valencia/València;243;Torrella;146;81;65;2019
46;Valencia/València;244;Torrent;82208;40482;41726;2019
46;Valencia/València;245;Torres Torres;637;342;295;2019
46;Valencia/València;246;Tous;1263;638;625;2019
46;Valencia/València;247;Tuéjar;1116;591;525;2019
46;Valencia/València;248;Turís;6646;3480;3166;2019
46;Valencia/València;249;Utiel;11531;5763;5768;2019
46;Valencia/València;250;València;794288;377504;416784;2019
46;Valencia/València;251;Vallada;3039;1544;1495;2019
46;Valencia/València;252;Vallanca;139;76;63;2019
46;Valencia/València;253;Vallés;157;84;73;2019
46;Valencia/València;254;Venta del Moro;1207;644;563;2019
46;Valencia/València;255;Vilallonga/Villalonga;4270;2076;2194;2019
46;Valencia/València;256;Vilamarxant;9717;5024;4693;2019
46;Valencia/València;257;Villanueva de Castellón;7049;3474;3575;2019
46;Valencia/València;258;Villar del Arzobispo;3554;1803;1751;2019
46;Valencia/València;259;Villargordo del Cabriel;589;304;285;2019
46;Valencia/València;260;Vinalesa;3420;1657;1763;2019
46;Valencia/València;145;Xàtiva;29231;14288;14943;2019
46;Valencia/València;143;Xeraco;5655;2853;2802;2019
46;Valencia/València;146;Xeresa;2168;1109;1059;2019
46;Valencia/València;110;Xirivella;29623;14658;14965;2019
46;Valencia/València;261;Yátova;2067;1068;999;2019
46;Valencia/València;262;Yesa, La;229;122;107;2019
46;Valencia/València;263;Zarra;359;200;159;2019
47;Valladolid;001;Adalia;53;33;20;2019
47;Valladolid;002;Aguasal;19;12;7;2019
47;Valladolid;003;Aguilar de Campos;243;140;103;2019
47;Valladolid;004;Alaejos;1369;732;637;2019
47;Valladolid;005;Alcazarén;635;343;292;2019
47;Valladolid;006;Aldea de San Miguel;224;123;101;2019
47;Valladolid;007;Aldeamayor de San Martín;5524;2859;2665;2019
47;Valladolid;008;Almenara de Adaja;22;11;11;2019
47;Valladolid;009;Amusquillo;103;65;38;2019
47;Valladolid;010;Arroyo de la Encomienda;20179;10171;10008;2019
47;Valladolid;011;Ataquines;583;318;265;2019
47;Valladolid;012;Bahabón;108;50;58;2019
47;Valladolid;013;Barcial de la Loma;92;52;40;2019
47;Valladolid;014;Barruelo del Valle;52;33;19;2019
47;Valladolid;015;Becilla de Valderaduey;238;136;102;2019
47;Valladolid;016;Benafarces;72;35;37;2019
47;Valladolid;017;Bercero;207;112;95;2019
47;Valladolid;018;Berceruelo;36;22;14;2019
47;Valladolid;019;Berrueces;109;62;47;2019
47;Valladolid;020;Bobadilla del Campo;293;163;130;2019
47;Valladolid;021;Bocigas;80;45;35;2019
47;Valladolid;022;Bocos de Duero;75;38;37;2019
47;Valladolid;023;Boecillo;4206;2143;2063;2019
47;Valladolid;024;Bolaños de Campos;291;160;131;2019
47;Valladolid;025;Brahojos de Medina;117;61;56;2019
47;Valladolid;026;Bustillo de Chaves;69;43;26;2019
47;Valladolid;027;Cabezón de Pisuerga;3713;1893;1820;2019
47;Valladolid;028;Cabezón de Valderaduey;33;19;14;2019
47;Valladolid;029;Cabreros del Monte;62;36;26;2019
47;Valladolid;030;Campaspero;1079;600;479;2019
47;Valladolid;031;Campillo, El;222;133;89;2019
47;Valladolid;032;Camporredondo;157;89;68;2019
47;Valladolid;033;Canalejas de Peñafiel;231;128;103;2019
47;Valladolid;034;Canillas de Esgueva;75;44;31;2019
47;Valladolid;035;Carpio;1016;545;471;2019
47;Valladolid;036;Casasola de Arión;249;136;113;2019
47;Valladolid;037;Castrejón de Trabancos;174;85;89;2019
47;Valladolid;038;Castrillo de Duero;111;66;45;2019
47;Valladolid;039;Castrillo-Tejeriego;171;96;75;2019
47;Valladolid;040;Castrobol;61;32;29;2019
47;Valladolid;041;Castrodeza;160;98;62;2019
47;Valladolid;042;Castromembibre;54;38;16;2019
47;Valladolid;043;Castromonte;320;175;145;2019
47;Valladolid;044;Castronuevo de Esgueva;369;197;172;2019
47;Valladolid;045;Castronuño;828;418;410;2019
47;Valladolid;046;Castroponce;143;78;65;2019
47;Valladolid;047;Castroverde de Cerrato;221;139;82;2019
47;Valladolid;048;Ceinos de Campos;211;116;95;2019
47;Valladolid;049;Cervillego de la Cruz;90;52;38;2019
47;Valladolid;050;Cigales;5235;2662;2573;2019
47;Valladolid;051;Ciguñuela;369;194;175;2019
47;Valladolid;052;Cistérniga;9034;4569;4465;2019
47;Valladolid;053;Cogeces de Íscar;141;69;72;2019
47;Valladolid;054;Cogeces del Monte;685;370;315;2019
47;Valladolid;055;Corcos;201;111;90;2019
47;Valladolid;056;Corrales de Duero;105;60;45;2019
47;Valladolid;057;Cubillas de Santa Marta;326;191;135;2019
47;Valladolid;058;Cuenca de Campos;224;115;109;2019
47;Valladolid;059;Curiel de Duero;123;77;46;2019
47;Valladolid;060;Encinas de Esgueva;248;147;101;2019
47;Valladolid;061;Esguevillas de Esgueva;271;146;125;2019
47;Valladolid;062;Fombellida;173;100;73;2019
47;Valladolid;063;Fompedraza;99;51;48;2019
47;Valladolid;064;Fontihoyuelo;38;22;16;2019
47;Valladolid;065;Fresno el Viejo;885;472;413;2019
47;Valladolid;066;Fuensaldaña;1773;909;864;2019
47;Valladolid;067;Fuente el Sol;156;82;74;2019
47;Valladolid;068;Fuente-Olmedo;34;17;17;2019
47;Valladolid;069;Gallegos de Hornija;122;63;59;2019
47;Valladolid;070;Gatón de Campos;33;17;16;2019
47;Valladolid;071;Geria;509;242;267;2019
47;Valladolid;073;Herrín de Campos;122;60;62;2019
47;Valladolid;074;Hornillos de Eresma;165;97;68;2019
47;Valladolid;075;Íscar;6344;3201;3143;2019
47;Valladolid;076;Laguna de Duero;22725;11315;11410;2019
47;Valladolid;077;Langayo;248;156;92;2019
47;Valladolid;079;Llano de Olmedo;59;32;27;2019
47;Valladolid;078;Lomoviejo;176;94;82;2019
47;Valladolid;080;Manzanillo;52;26;26;2019
47;Valladolid;081;Marzales;45;22;23;2019
47;Valladolid;082;Matapozuelos;1058;539;519;2019
47;Valladolid;083;Matilla de los Caños;102;60;42;2019
47;Valladolid;084;Mayorga;1509;748;761;2019
47;Valladolid;086;Medina de Rioseco;4647;2286;2361;2019
47;Valladolid;085;Medina del Campo;20510;9958;10552;2019
47;Valladolid;087;Megeces;430;230;200;2019
47;Valladolid;088;Melgar de Abajo;112;61;51;2019
47;Valladolid;089;Melgar de Arriba;147;82;65;2019
47;Valladolid;090;Mojados;3210;1680;1530;2019
47;Valladolid;091;Monasterio de Vega;77;41;36;2019
47;Valladolid;092;Montealegre de Campos;109;66;43;2019
47;Valladolid;093;Montemayor de Pililla;868;472;396;2019
47;Valladolid;094;Moral de la Reina;148;85;63;2019
47;Valladolid;095;Moraleja de las Panaderas;42;23;19;2019
47;Valladolid;096;Morales de Campos;138;72;66;2019
47;Valladolid;097;Mota del Marqués;351;186;165;2019
47;Valladolid;098;Mucientes;662;336;326;2019
47;Valladolid;099;Mudarra, La;158;80;78;2019
47;Valladolid;100;Muriel;123;65;58;2019
47;Valladolid;101;Nava del Rey;1986;1018;968;2019
47;Valladolid;102;Nueva Villa de las Torres;280;162;118;2019
47;Valladolid;103;Olivares de Duero;296;162;134;2019
47;Valladolid;104;Olmedo;3643;1806;1837;2019
47;Valladolid;105;Olmos de Esgueva;201;111;90;2019
47;Valladolid;106;Olmos de Peñafiel;52;28;24;2019
47;Valladolid;109;Palazuelo de Vedija;191;102;89;2019
47;Valladolid;110;Parrilla, La;480;241;239;2019
47;Valladolid;111;Pedraja de Portillo, La;1139;587;552;2019
47;Valladolid;112;Pedrajas de San Esteban;3327;1703;1624;2019
47;Valladolid;113;Pedrosa del Rey;168;96;72;2019
47;Valladolid;114;Peñafiel;5037;2522;2515;2019
47;Valladolid;115;Peñaflor de Hornija;297;170;127;2019
47;Valladolid;116;Pesquera de Duero;448;243;205;2019
47;Valladolid;117;Piña de Esgueva;324;170;154;2019
47;Valladolid;118;Piñel de Abajo;161;91;70;2019
47;Valladolid;119;Piñel de Arriba;89;48;41;2019
47;Valladolid;121;Pollos;597;317;280;2019
47;Valladolid;122;Portillo;2432;1270;1162;2019
47;Valladolid;123;Pozal de Gallinas;539;300;239;2019
47;Valladolid;124;Pozaldez;482;255;227;2019
47;Valladolid;125;Pozuelo de la Orden;49;29;20;2019
47;Valladolid;126;Puras;46;26;20;2019
47;Valladolid;127;Quintanilla de Arriba;163;92;71;2019
47;Valladolid;129;Quintanilla de Onésimo;1028;543;485;2019
47;Valladolid;130;Quintanilla de Trigueros;108;54;54;2019
47;Valladolid;128;Quintanilla del Molar;65;31;34;2019
47;Valladolid;131;Rábano;177;92;85;2019
47;Valladolid;132;Ramiro;43;24;19;2019
47;Valladolid;133;Renedo de Esgueva;3788;1941;1847;2019
47;Valladolid;134;Roales de Campos;157;88;69;2019
47;Valladolid;135;Robladillo;92;54;38;2019
47;Valladolid;137;Roturas;33;20;13;2019
47;Valladolid;138;Rubí de Bracamonte;228;129;99;2019
47;Valladolid;139;Rueda;1254;645;609;2019
47;Valladolid;140;Saelices de Mayorga;113;70;43;2019
47;Valladolid;141;Salvador de Zapardiel;120;71;49;2019
47;Valladolid;142;San Cebrián de Mazote;135;82;53;2019
47;Valladolid;143;San Llorente;113;62;51;2019
47;Valladolid;144;San Martín de Valvení;83;45;38;2019
47;Valladolid;145;San Miguel del Arroyo;668;355;313;2019
47;Valladolid;146;San Miguel del Pino;350;180;170;2019
47;Valladolid;147;San Pablo de la Moraleja;109;61;48;2019
47;Valladolid;148;San Pedro de Latarce;483;258;225;2019
47;Valladolid;149;San Pelayo;49;25;24;2019
47;Valladolid;150;San Román de Hornija;312;151;161;2019
47;Valladolid;151;San Salvador;26;15;11;2019
47;Valladolid;156;San Vicente del Palacio;161;85;76;2019
47;Valladolid;152;Santa Eufemia del Arroyo;75;42;33;2019
47;Valladolid;153;Santervás de Campos;118;61;57;2019
47;Valladolid;154;Santibáñez de Valcorba;164;92;72;2019
47;Valladolid;155;Santovenia de Pisuerga;4480;2310;2170;2019
47;Valladolid;157;Sardón de Duero;580;313;267;2019
47;Valladolid;158;Seca, La;1077;548;529;2019
47;Valladolid;159;Serrada;1136;593;543;2019
47;Valladolid;160;Siete Iglesias de Trabancos;428;229;199;2019
47;Valladolid;161;Simancas;5276;2678;2598;2019
47;Valladolid;162;Tamariz de Campos;80;45;35;2019
47;Valladolid;163;Tiedra;288;139;149;2019
47;Valladolid;164;Tordehumos;417;224;193;2019
47;Valladolid;165;Tordesillas;8750;4417;4333;2019
47;Valladolid;169;Torre de Esgueva;65;33;32;2019
47;Valladolid;170;Torre de Peñafiel;48;29;19;2019
47;Valladolid;166;Torrecilla de la Abadesa;273;134;139;2019
47;Valladolid;167;Torrecilla de la Orden;253;128;125;2019
47;Valladolid;168;Torrecilla de la Torre;35;22;13;2019
47;Valladolid;171;Torrelobatón;408;216;192;2019
47;Valladolid;172;Torrescárcela;154;81;73;2019
47;Valladolid;173;Traspinedo;1109;592;517;2019
47;Valladolid;174;Trigueros del Valle;314;172;142;2019
47;Valladolid;175;Tudela de Duero;8564;4366;4198;2019
47;Valladolid;176;Unión de Campos, La;228;117;111;2019
47;Valladolid;177;Urones de Castroponce;110;64;46;2019
47;Valladolid;178;Urueña;182;102;80;2019
47;Valladolid;179;Valbuena de Duero;468;252;216;2019
47;Valladolid;180;Valdearcos de la Vega;57;31;26;2019
47;Valladolid;181;Valdenebro de los Valles;192;102;90;2019
47;Valladolid;182;Valdestillas;1643;851;792;2019
47;Valladolid;183;Valdunquillo;147;72;75;2019
47;Valladolid;186;Valladolid;298412;140059;158353;2019
47;Valladolid;184;Valoria la Buena;629;339;290;2019
47;Valladolid;185;Valverde de Campos;95;56;39;2019
47;Valladolid;187;Vega de Ruiponce;90;53;37;2019
47;Valladolid;188;Vega de Valdetronco;118;64;54;2019
47;Valladolid;189;Velascálvaro;163;90;73;2019
47;Valladolid;190;Velilla;110;54;56;2019
47;Valladolid;191;Velliza;118;74;44;2019
47;Valladolid;192;Ventosa de la Cuesta;103;61;42;2019
47;Valladolid;193;Viana de Cega;2032;1054;978;2019
47;Valladolid;195;Villabáñez;490;269;221;2019
47;Valladolid;196;Villabaruz de Campos;29;15;14;2019
47;Valladolid;197;Villabrágima;1036;547;489;2019
47;Valladolid;198;Villacarralón;79;47;32;2019
47;Valladolid;199;Villacid de Campos;70;45;25;2019
47;Valladolid;200;Villaco;76;51;25;2019
47;Valladolid;203;Villafrades de Campos;66;37;29;2019
47;Valladolid;204;Villafranca de Duero;258;135;123;2019
47;Valladolid;205;Villafrechós;490;266;224;2019
47;Valladolid;206;Villafuerte;80;45;35;2019
47;Valladolid;207;Villagarcía de Campos;307;184;123;2019
47;Valladolid;208;Villagómez la Nueva;68;35;33;2019
47;Valladolid;209;Villalán de Campos;33;21;12;2019
47;Valladolid;210;Villalar de los Comuneros;468;225;243;2019
47;Valladolid;211;Villalba de la Loma;55;30;25;2019
47;Valladolid;212;Villalba de los Alcores;379;206;173;2019
47;Valladolid;213;Villalbarba;121;60;61;2019
47;Valladolid;214;Villalón de Campos;1602;791;811;2019
47;Valladolid;215;Villamuriel de Campos;52;27;25;2019
47;Valladolid;216;Villán de Tordesillas;127;75;52;2019
47;Valladolid;217;Villanubla;2713;1401;1312;2019
47;Valladolid;218;Villanueva de Duero;1184;619;565;2019
47;Valladolid;219;Villanueva de la Condesa;61;34;27;2019
47;Valladolid;220;Villanueva de los Caballeros;175;93;82;2019
47;Valladolid;221;Villanueva de los Infantes;102;62;40;2019
47;Valladolid;222;Villanueva de San Mancio;87;48;39;2019
47;Valladolid;223;Villardefrades;170;96;74;2019
47;Valladolid;224;Villarmentero de Esgueva;111;61;50;2019
47;Valladolid;225;Villasexmir;75;42;33;2019
47;Valladolid;226;Villavaquerín;159;91;68;2019
47;Valladolid;227;Villavellid;57;37;20;2019
47;Valladolid;228;Villaverde de Medina;533;289;244;2019
47;Valladolid;229;Villavicencio de los Caballeros;245;116;129;2019
47;Valladolid;194;Viloria;340;177;163;2019
47;Valladolid;230;Wamba;323;172;151;2019
47;Valladolid;231;Zaratán;6233;3184;3049;2019
47;Valladolid;232;Zarza, La;111;60;51;2019
49;Zamora;002;Abezames;61;30;31;2019
49;Zamora;003;Alcañices;1076;560;516;2019
49;Zamora;004;Alcubilla de Nogales;117;64;53;2019
49;Zamora;005;Alfaraz de Sayago;129;74;55;2019
49;Zamora;006;Algodre;148;78;70;2019
49;Zamora;007;Almaraz de Duero;407;210;197;2019
49;Zamora;008;Almeida de Sayago;452;240;212;2019
49;Zamora;009;Andavías;444;227;217;2019
49;Zamora;010;Arcenillas;420;214;206;2019
49;Zamora;011;Arcos de la Polvorosa;221;122;99;2019
49;Zamora;012;Argañín;80;40;40;2019
49;Zamora;013;Argujillo;242;122;120;2019
49;Zamora;014;Arquillinos;117;59;58;2019
49;Zamora;015;Arrabalde;216;107;109;2019
49;Zamora;016;Aspariegos;247;115;132;2019
49;Zamora;017;Asturianos;271;137;134;2019
49;Zamora;018;Ayoó de Vidriales;308;157;151;2019
49;Zamora;019;Barcial del Barco;249;132;117;2019
49;Zamora;020;Belver de los Montes;275;151;124;2019
49;Zamora;021;Benavente;17935;8683;9252;2019
49;Zamora;022;Benegiles;305;162;143;2019
49;Zamora;023;Bermillo de Sayago;1015;540;475;2019
49;Zamora;024;Bóveda de Toro, La;709;357;352;2019
49;Zamora;025;Bretó;166;97;69;2019
49;Zamora;026;Bretocino;213;115;98;2019
49;Zamora;027;Brime de Sog;130;62;68;2019
49;Zamora;028;Brime de Urz;104;62;42;2019
49;Zamora;029;Burganes de Valverde;663;348;315;2019
49;Zamora;030;Bustillo del Oro;84;44;40;2019
49;Zamora;031;Cabañas de Sayago;151;80;71;2019
49;Zamora;032;Calzadilla de Tera;300;144;156;2019
49;Zamora;033;Camarzana de Tera;776;386;390;2019
49;Zamora;034;Cañizal;456;236;220;2019
49;Zamora;035;Cañizo;233;129;104;2019
49;Zamora;036;Carbajales de Alba;525;266;259;2019
49;Zamora;037;Carbellino;189;102;87;2019
49;Zamora;038;Casaseca de Campeán;99;58;41;2019
49;Zamora;039;Casaseca de las Chanas;390;205;185;2019
49;Zamora;040;Castrillo de la Guareña;125;65;60;2019
49;Zamora;041;Castrogonzalo;471;257;214;2019
49;Zamora;042;Castronuevo;228;112;116;2019
49;Zamora;043;Castroverde de Campos;287;150;137;2019
49;Zamora;044;Cazurra;79;42;37;2019
49;Zamora;046;Cerecinos de Campos;259;143;116;2019
49;Zamora;047;Cerecinos del Carrizal;112;65;47;2019
49;Zamora;048;Cernadilla;114;60;54;2019
49;Zamora;050;Cobreros;579;313;266;2019
49;Zamora;052;Coomonte;187;102;85;2019
49;Zamora;053;Coreses;1047;543;504;2019
49;Zamora;054;Corrales del Vino;961;474;487;2019
49;Zamora;055;Cotanes del Monte;103;57;46;2019
49;Zamora;056;Cubillos;313;154;159;2019
49;Zamora;057;Cubo de Benavente;114;63;51;2019
49;Zamora;058;Cubo de Tierra del Vino, El;320;168;152;2019
49;Zamora;059;Cuelgamures;85;53;32;2019
49;Zamora;061;Entrala;156;85;71;2019
49;Zamora;062;Espadañedo;107;53;54;2019
49;Zamora;063;Faramontanos de Tábara;330;173;157;2019
49;Zamora;064;Fariza;506;264;242;2019
49;Zamora;065;Fermoselle;1206;608;598;2019
49;Zamora;066;Ferreras de Abajo;499;252;247;2019
49;Zamora;067;Ferreras de Arriba;365;203;162;2019
49;Zamora;068;Ferreruela;466;257;209;2019
49;Zamora;069;Figueruela de Arriba;332;157;175;2019
49;Zamora;071;Fonfría;756;397;359;2019
49;Zamora;075;Fresno de la Polvorosa;138;76;62;2019
49;Zamora;076;Fresno de la Ribera;377;195;182;2019
49;Zamora;077;Fresno de Sayago;167;86;81;2019
49;Zamora;078;Friera de Valverde;152;83;69;2019
49;Zamora;079;Fuente Encalada;106;59;47;2019
49;Zamora;080;Fuentelapeña;684;359;325;2019
49;Zamora;082;Fuentes de Ropel;374;192;182;2019
49;Zamora;081;Fuentesaúco;1475;733;742;2019
49;Zamora;083;Fuentesecas;50;25;25;2019
49;Zamora;084;Fuentespreadas;286;153;133;2019
49;Zamora;085;Galende;1004;507;497;2019
49;Zamora;086;Gallegos del Pan;113;66;47;2019
49;Zamora;087;Gallegos del Río;490;272;218;2019
49;Zamora;088;Gamones;93;55;38;2019
49;Zamora;090;Gema;217;107;110;2019
49;Zamora;091;Granja de Moreruela;277;142;135;2019
49;Zamora;092;Granucillo;122;60;62;2019
49;Zamora;093;Guarrate;327;168;159;2019
49;Zamora;094;Hermisende;228;118;110;2019
49;Zamora;095;Hiniesta, La;316;166;150;2019
49;Zamora;096;Jambrina;159;84;75;2019
49;Zamora;097;Justel;75;46;29;2019
49;Zamora;098;Losacino;215;121;94;2019
49;Zamora;099;Losacio;101;56;45;2019
49;Zamora;100;Lubián;307;160;147;2019
49;Zamora;101;Luelmo;154;84;70;2019
49;Zamora;102;Maderal, El;187;100;87;2019
49;Zamora;103;Madridanos;458;241;217;2019
49;Zamora;104;Mahide;336;190;146;2019
49;Zamora;105;Maire de Castroponce;146;75;71;2019
49;Zamora;107;Malva;123;55;68;2019
49;Zamora;108;Manganeses de la Lampreana;478;239;239;2019
49;Zamora;109;Manganeses de la Polvorosa;633;309;324;2019
49;Zamora;110;Manzanal de Arriba;364;190;174;2019
49;Zamora;112;Manzanal de los Infantes;123;68;55;2019
49;Zamora;111;Manzanal del Barco;126;66;60;2019
49;Zamora;113;Matilla de Arzón;169;98;71;2019
49;Zamora;114;Matilla la Seca;42;24;18;2019
49;Zamora;115;Mayalde;182;99;83;2019
49;Zamora;116;Melgar de Tera;373;193;180;2019
49;Zamora;117;Micereces de Tera;457;233;224;2019
49;Zamora;118;Milles de la Polvorosa;215;116;99;2019
49;Zamora;119;Molacillos;257;139;118;2019
49;Zamora;120;Molezuelas de la Carballeda;56;31;25;2019
49;Zamora;121;Mombuey;407;221;186;2019
49;Zamora;122;Monfarracinos;967;504;463;2019
49;Zamora;123;Montamarta;593;308;285;2019
49;Zamora;124;Moral de Sayago;257;145;112;2019
49;Zamora;126;Moraleja de Sayago;284;146;138;2019
49;Zamora;125;Moraleja del Vino;1721;872;849;2019
49;Zamora;128;Morales de Rey;577;290;287;2019
49;Zamora;129;Morales de Toro;976;513;463;2019
49;Zamora;130;Morales de Valverde;162;82;80;2019
49;Zamora;127;Morales del Vino;2947;1537;1410;2019
49;Zamora;131;Moralina;248;128;120;2019
49;Zamora;132;Moreruela de los Infanzones;341;180;161;2019
49;Zamora;133;Moreruela de Tábara;315;169;146;2019
49;Zamora;134;Muelas de los Caballeros;172;96;76;2019
49;Zamora;135;Muelas del Pan;634;329;305;2019
49;Zamora;136;Muga de Sayago;353;172;181;2019
49;Zamora;137;Navianos de Valverde;182;104;78;2019
49;Zamora;138;Olmillos de Castro;219;118;101;2019
49;Zamora;139;Otero de Bodas;155;85;70;2019
49;Zamora;141;Pajares de la Lampreana;315;159;156;2019
49;Zamora;143;Palacios de Sanabria;225;112;113;2019
49;Zamora;142;Palacios del Pan;261;134;127;2019
49;Zamora;145;Pedralba de la Pradería;237;131;106;2019
49;Zamora;146;Pego, El;296;150;146;2019
49;Zamora;147;Peleagonzalo;266;135;131;2019
49;Zamora;148;Peleas de Abajo;283;132;151;2019
49;Zamora;149;Peñausende;385;194;191;2019
49;Zamora;150;Peque;130;56;74;2019
49;Zamora;151;Perdigón, El;671;354;317;2019
49;Zamora;152;Pereruela;530;285;245;2019
49;Zamora;153;Perilla de Castro;161;83;78;2019
49;Zamora;154;Pías;113;65;48;2019
49;Zamora;155;Piedrahita de Castro;87;47;40;2019
49;Zamora;156;Pinilla de Toro;232;125;107;2019
49;Zamora;157;Pino del Oro;195;105;90;2019
49;Zamora;158;Piñero, El;227;118;109;2019
49;Zamora;160;Pobladura de Valderaduey;40;22;18;2019
49;Zamora;159;Pobladura del Valle;295;156;139;2019
49;Zamora;162;Porto;178;99;79;2019
49;Zamora;163;Pozoantiguo;224;114;110;2019
49;Zamora;164;Pozuelo de Tábara;163;80;83;2019
49;Zamora;165;Prado;53;30;23;2019
49;Zamora;166;Puebla de Sanabria;1373;670;703;2019
49;Zamora;167;Pueblica de Valverde;184;101;83;2019
49;Zamora;170;Quintanilla de Urz;101;53;48;2019
49;Zamora;168;Quintanilla del Monte;103;58;45;2019
49;Zamora;169;Quintanilla del Olmo;32;16;16;2019
49;Zamora;171;Quiruelas de Vidriales;656;343;313;2019
49;Zamora;172;Rabanales;521;272;249;2019
49;Zamora;173;Rábano de Aliste;369;184;185;2019
49;Zamora;174;Requejo;156;74;82;2019
49;Zamora;175;Revellinos;249;131;118;2019
49;Zamora;176;Riofrío de Aliste;646;360;286;2019
49;Zamora;177;Rionegro del Puente;278;148;130;2019
49;Zamora;178;Roales;931;493;438;2019
49;Zamora;179;Robleda-Cervantes;405;223;182;2019
49;Zamora;180;Roelos de Sayago;149;73;76;2019
49;Zamora;181;Rosinos de la Requejada;357;195;162;2019
49;Zamora;183;Salce;96;43;53;2019
49;Zamora;184;Samir de los Caños;174;100;74;2019
49;Zamora;185;San Agustín del Pozo;183;95;88;2019
49;Zamora;186;San Cebrián de Castro;239;117;122;2019
49;Zamora;187;San Cristóbal de Entreviñas;1385;724;661;2019
49;Zamora;188;San Esteban del Molar;128;74;54;2019
49;Zamora;189;San Justo;208;113;95;2019
49;Zamora;190;San Martín de Valderaduey;53;27;26;2019
49;Zamora;191;San Miguel de la Ribera;291;143;148;2019
49;Zamora;192;San Miguel del Valle;140;69;71;2019
49;Zamora;193;San Pedro de Ceque;449;233;216;2019
49;Zamora;194;San Pedro de la Nave-Almendra;347;178;169;2019
49;Zamora;208;San Vicente de la Cabeza;378;200;178;2019
49;Zamora;209;San Vitero;516;287;229;2019
49;Zamora;197;Santa Clara de Avedillo;168;83;85;2019
49;Zamora;199;Santa Colomba de las Monjas;261;127;134;2019
49;Zamora;200;Santa Cristina de la Polvorosa;1069;545;524;2019
49;Zamora;201;Santa Croya de Tera;299;152;147;2019
49;Zamora;202;Santa Eufemia del Barco;177;102;75;2019
49;Zamora;203;Santa María de la Vega;311;162;149;2019
49;Zamora;204;Santa María de Valverde;56;28;28;2019
49;Zamora;205;Santibáñez de Tera;383;191;192;2019
49;Zamora;206;Santibáñez de Vidriales;958;485;473;2019
49;Zamora;207;Santovenia;241;118;123;2019
49;Zamora;210;Sanzoles;492;249;243;2019
49;Zamora;214;Tábara;747;383;364;2019
49;Zamora;216;Tapioles;150;88;62;2019
49;Zamora;219;Toro;8713;4278;4435;2019
49;Zamora;220;Torre del Valle, La;144;77;67;2019
49;Zamora;221;Torregamones;258;134;124;2019
49;Zamora;222;Torres del Carrizal;410;209;201;2019
49;Zamora;223;Trabazos;878;467;411;2019
49;Zamora;224;Trefacio;189;99;90;2019
49;Zamora;225;Uña de Quintana;133;72;61;2019
49;Zamora;226;Vadillo de la Guareña;248;132;116;2019
49;Zamora;227;Valcabado;372;191;181;2019
49;Zamora;228;Valdefinjas;55;33;22;2019
49;Zamora;229;Valdescorriel;125;61;64;2019
49;Zamora;230;Vallesa de la Guareña;83;45;38;2019
49;Zamora;231;Vega de Tera;328;156;172;2019
49;Zamora;232;Vega de Villalobos;99;44;55;2019
49;Zamora;233;Vegalatrave;88;45;43;2019
49;Zamora;234;Venialbo;443;242;201;2019
49;Zamora;235;Vezdemarbán;449;230;219;2019
49;Zamora;236;Vidayanes;85;45;40;2019
49;Zamora;237;Videmala;147;76;71;2019
49;Zamora;238;Villabrázaro;252;130;122;2019
49;Zamora;239;Villabuena del Puente;675;343;332;2019
49;Zamora;240;Villadepera;198;107;91;2019
49;Zamora;241;Villaescusa;249;136;113;2019
49;Zamora;242;Villafáfila;478;249;229;2019
49;Zamora;243;Villaferrueña;110;56;54;2019
49;Zamora;244;Villageriz;56;34;22;2019
49;Zamora;245;Villalazán;267;132;135;2019
49;Zamora;246;Villalba de la Lampreana;227;126;101;2019
49;Zamora;247;Villalcampo;432;212;220;2019
49;Zamora;248;Villalobos;239;117;122;2019
49;Zamora;249;Villalonso;81;46;35;2019
49;Zamora;250;Villalpando;1475;720;755;2019
49;Zamora;251;Villalube;169;90;79;2019
49;Zamora;252;Villamayor de Campos;333;167;166;2019
49;Zamora;255;Villamor de los Escuderos;384;203;181;2019
49;Zamora;256;Villanázar;274;143;131;2019
49;Zamora;257;Villanueva de Azoague;350;177;173;2019
49;Zamora;258;Villanueva de Campeán;112;63;49;2019
49;Zamora;259;Villanueva de las Peras;78;38;40;2019
49;Zamora;260;Villanueva del Campo;818;403;415;2019
49;Zamora;263;Villar de Fallaves;45;25;20;2019
49;Zamora;264;Villar del Buey;571;296;275;2019
49;Zamora;261;Villaralbo;1821;919;902;2019
49;Zamora;262;Villardeciervos;413;207;206;2019
49;Zamora;265;Villardiegua de la Ribera;127;68;59;2019
49;Zamora;266;Villárdiga;77;44;33;2019
49;Zamora;267;Villardondiego;107;60;47;2019
49;Zamora;268;Villarrín de Campos;383;206;177;2019
49;Zamora;269;Villaseco del Pan;231;108;123;2019
49;Zamora;270;Villavendimio;162;100;62;2019
49;Zamora;272;Villaveza de Valverde;77;39;38;2019
49;Zamora;271;Villaveza del Agua;187;103;84;2019
49;Zamora;273;Viñas;180;95;85;2019
49;Zamora;275;Zamora;61406;28524;32882;2019
50;Zaragoza;001;Abanto;100;59;41;2019
50;Zaragoza;002;Acered;166;98;68;2019
50;Zaragoza;003;Agón;137;80;57;2019
50;Zaragoza;004;Aguarón;636;337;299;2019
50;Zaragoza;005;Aguilón;251;136;115;2019
50;Zaragoza;006;Ainzón;1077;542;535;2019
50;Zaragoza;007;Aladrén;52;34;18;2019
50;Zaragoza;008;Alagón;7163;3572;3591;2019
50;Zaragoza;009;Alarba;124;71;53;2019
50;Zaragoza;010;Alberite de San Juan;69;40;29;2019
50;Zaragoza;011;Albeta;133;70;63;2019
50;Zaragoza;012;Alborge;107;56;51;2019
50;Zaragoza;013;Alcalá de Ebro;246;118;128;2019
50;Zaragoza;014;Alcalá de Moncayo;143;84;59;2019
50;Zaragoza;015;Alconchel de Ariza;62;37;25;2019
50;Zaragoza;016;Aldehuela de Liestos;48;29;19;2019
50;Zaragoza;017;Alfajarín;2315;1191;1124;2019
50;Zaragoza;018;Alfamén;1446;756;690;2019
50;Zaragoza;019;Alforque;68;35;33;2019
50;Zaragoza;020;Alhama de Aragón;1020;537;483;2019
50;Zaragoza;021;Almochuel;25;12;13;2019
50;Zaragoza;022;Almolda, La;553;277;276;2019
50;Zaragoza;023;Almonacid de la Cuba;243;120;123;2019
50;Zaragoza;024;Almonacid de la Sierra;735;404;331;2019
50;Zaragoza;025;Almunia de Doña Godina, La;7951;4089;3862;2019
50;Zaragoza;026;Alpartir;555;284;271;2019
50;Zaragoza;027;Ambel;254;124;130;2019
50;Zaragoza;028;Anento;106;68;38;2019
50;Zaragoza;029;Aniñón;706;383;323;2019
50;Zaragoza;030;Añón de Moncayo;212;129;83;2019
50;Zaragoza;031;Aranda de Moncayo;152;96;56;2019
50;Zaragoza;032;Arándiga;302;159;143;2019
50;Zaragoza;033;Ardisa;70;43;27;2019
50;Zaragoza;034;Ariza;1115;575;540;2019
50;Zaragoza;035;Artieda;80;47;33;2019
50;Zaragoza;036;Asín;110;58;52;2019
50;Zaragoza;037;Atea;151;93;58;2019
50;Zaragoza;038;Ateca;1762;916;846;2019
50;Zaragoza;039;Azuara;540;303;237;2019
50;Zaragoza;040;Badules;85;47;38;2019
50;Zaragoza;041;Bagüés;17;10;7;2019
50;Zaragoza;042;Balconchán;16;6;10;2019
50;Zaragoza;043;Bárboles;293;157;136;2019
50;Zaragoza;044;Bardallur;254;122;132;2019
50;Zaragoza;045;Belchite;1505;756;749;2019
50;Zaragoza;046;Belmonte de Gracián;197;111;86;2019
50;Zaragoza;047;Berdejo;47;32;15;2019
50;Zaragoza;048;Berrueco;34;21;13;2019
50;Zaragoza;901;Biel;154;96;58;2019
50;Zaragoza;050;Bijuesca;94;63;31;2019
50;Zaragoza;051;Biota;941;476;465;2019
50;Zaragoza;052;Bisimbre;92;52;40;2019
50;Zaragoza;053;Boquiñeni;787;398;389;2019
50;Zaragoza;054;Bordalba;56;36;20;2019
50;Zaragoza;055;Borja;4969;2534;2435;2019
50;Zaragoza;056;Botorrita;488;269;219;2019
50;Zaragoza;057;Brea de Aragón;1609;823;786;2019
50;Zaragoza;058;Bubierca;66;34;32;2019
50;Zaragoza;059;Bujaraloz;985;504;481;2019
50;Zaragoza;060;Bulbuente;221;120;101;2019
50;Zaragoza;061;Bureta;214;109;105;2019
50;Zaragoza;062;Burgo de Ebro, El;2436;1233;1203;2019
50;Zaragoza;063;Buste, El;66;36;30;2019
50;Zaragoza;064;Cabañas de Ebro;505;269;236;2019
50;Zaragoza;065;Cabolafuente;33;19;14;2019
50;Zaragoza;066;Cadrete;4032;2137;1895;2019
50;Zaragoza;067;Calatayud;20024;9902;10122;2019
50;Zaragoza;068;Calatorao;2881;1493;1388;2019
50;Zaragoza;069;Calcena;72;42;30;2019
50;Zaragoza;070;Calmarza;57;31;26;2019
50;Zaragoza;071;Campillo de Aragón;147;82;65;2019
50;Zaragoza;072;Carenas;213;116;97;2019
50;Zaragoza;073;Cariñena;3302;1676;1626;2019
50;Zaragoza;074;Caspe;9748;5093;4655;2019
50;Zaragoza;075;Castejón de Alarba;91;58;33;2019
50;Zaragoza;076;Castejón de las Armas;87;49;38;2019
50;Zaragoza;077;Castejón de Valdejasa;210;105;105;2019
50;Zaragoza;078;Castiliscar;263;137;126;2019
50;Zaragoza;079;Cervera de la Cañada;271;151;120;2019
50;Zaragoza;080;Cerveruela;33;22;11;2019
50;Zaragoza;081;Cetina;593;309;284;2019
50;Zaragoza;092;Chiprana;523;277;246;2019
50;Zaragoza;093;Chodes;104;58;46;2019
50;Zaragoza;082;Cimballa;97;48;49;2019
50;Zaragoza;083;Cinco Olivas;106;51;55;2019
50;Zaragoza;084;Clarés de Ribota;66;37;29;2019
50;Zaragoza;085;Codo;201;106;95;2019
50;Zaragoza;086;Codos;234;150;84;2019
50;Zaragoza;087;Contamina;37;21;16;2019
50;Zaragoza;088;Cosuenda;364;193;171;2019
50;Zaragoza;089;Cuarte de Huerva;13303;6792;6511;2019
50;Zaragoza;090;Cubel;155;75;80;2019
50;Zaragoza;091;Cuerlas, Las;41;21;20;2019
50;Zaragoza;094;Daroca;1983;972;1011;2019
50;Zaragoza;095;Ejea de los Caballeros;16783;8562;8221;2019
50;Zaragoza;096;Embid de Ariza;37;20;17;2019
50;Zaragoza;098;Encinacorba;178;97;81;2019
50;Zaragoza;099;Épila;4386;2282;2104;2019
50;Zaragoza;100;Erla;342;175;167;2019
50;Zaragoza;101;Escatrón;1051;522;529;2019
50;Zaragoza;102;Fabara;1125;612;513;2019
50;Zaragoza;104;Farlete;379;183;196;2019
50;Zaragoza;105;Fayón;379;197;182;2019
50;Zaragoza;106;Fayos, Los;139;74;65;2019
50;Zaragoza;107;Figueruelas;1259;629;630;2019
50;Zaragoza;108;Fombuena;56;36;20;2019
50;Zaragoza;109;Frago, El;99;61;38;2019
50;Zaragoza;110;Frasno, El;380;216;164;2019
50;Zaragoza;111;Fréscano;204;113;91;2019
50;Zaragoza;113;Fuendejalón;778;422;356;2019
50;Zaragoza;114;Fuendetodos;145;80;65;2019
50;Zaragoza;115;Fuentes de Ebro;4504;2325;2179;2019
50;Zaragoza;116;Fuentes de Jiloca;231;122;109;2019
50;Zaragoza;117;Gallocanta;152;87;65;2019
50;Zaragoza;118;Gallur;2596;1301;1295;2019
50;Zaragoza;119;Gelsa;1013;535;478;2019
50;Zaragoza;120;Godojos;54;30;24;2019
50;Zaragoza;121;Gotor;318;165;153;2019
50;Zaragoza;122;Grisel;74;43;31;2019
50;Zaragoza;123;Grisén;589;302;287;2019
50;Zaragoza;124;Herrera de los Navarros;506;278;228;2019
50;Zaragoza;125;Ibdes;404;208;196;2019
50;Zaragoza;126;Illueca;2924;1451;1473;2019
50;Zaragoza;128;Isuerre;31;19;12;2019
50;Zaragoza;129;Jaraba;280;152;128;2019
50;Zaragoza;130;Jarque de Moncayo;435;231;204;2019
50;Zaragoza;131;Jaulín;235;128;107;2019
50;Zaragoza;132;Joyosa, La;1073;552;521;2019
50;Zaragoza;133;Lagata;111;59;52;2019
50;Zaragoza;134;Langa del Castillo;121;63;58;2019
50;Zaragoza;135;Layana;97;52;45;2019
50;Zaragoza;136;Lécera;633;345;288;2019
50;Zaragoza;138;Lechón;51;29;22;2019
50;Zaragoza;137;Leciñena;1155;588;567;2019
50;Zaragoza;139;Letux;364;199;165;2019
50;Zaragoza;140;Litago;161;92;69;2019
50;Zaragoza;141;Lituénigo;120;62;58;2019
50;Zaragoza;142;Lobera de Onsella;28;15;13;2019
50;Zaragoza;143;Longares;811;478;333;2019
50;Zaragoza;144;Longás;31;21;10;2019
50;Zaragoza;146;Lucena de Jalón;240;130;110;2019
50;Zaragoza;147;Luceni;956;488;468;2019
50;Zaragoza;148;Luesia;288;160;128;2019
50;Zaragoza;149;Luesma;35;21;14;2019
50;Zaragoza;150;Lumpiaque;814;422;392;2019
50;Zaragoza;151;Luna;698;367;331;2019
50;Zaragoza;152;Maella;1985;1076;909;2019
50;Zaragoza;153;Magallón;1128;576;552;2019
50;Zaragoza;154;Mainar;155;88;67;2019
50;Zaragoza;155;Malanquilla;92;60;32;2019
50;Zaragoza;156;Maleján;259;133;126;2019
50;Zaragoza;160;Mallén;3035;1577;1458;2019
50;Zaragoza;157;Malón;356;180;176;2019
50;Zaragoza;159;Maluenda;922;452;470;2019
50;Zaragoza;161;Manchones;114;61;53;2019
50;Zaragoza;162;Mara;168;83;85;2019
50;Zaragoza;163;María de Huerva;5812;2961;2851;2019
50;Zaragoza;902;Marracos;86;53;33;2019
50;Zaragoza;164;Mediana de Aragón;461;231;230;2019
50;Zaragoza;165;Mequinenza;2324;1180;1144;2019
50;Zaragoza;166;Mesones de Isuela;264;133;131;2019
50;Zaragoza;167;Mezalocha;238;138;100;2019
50;Zaragoza;168;Mianos;30;17;13;2019
50;Zaragoza;169;Miedes de Aragón;433;234;199;2019
50;Zaragoza;170;Monegrillo;405;227;178;2019
50;Zaragoza;171;Moneva;97;56;41;2019
50;Zaragoza;172;Monreal de Ariza;200;117;83;2019
50;Zaragoza;173;Monterde;157;102;55;2019
50;Zaragoza;174;Montón;94;54;40;2019
50;Zaragoza;175;Morata de Jalón;1079;531;548;2019
50;Zaragoza;176;Morata de Jiloca;302;172;130;2019
50;Zaragoza;177;Morés;323;172;151;2019
50;Zaragoza;178;Moros;343;178;165;2019
50;Zaragoza;179;Moyuela;280;156;124;2019
50;Zaragoza;180;Mozota;122;61;61;2019
50;Zaragoza;181;Muel;1378;701;677;2019
50;Zaragoza;182;Muela, La;5784;3022;2762;2019
50;Zaragoza;183;Munébrega;371;201;170;2019
50;Zaragoza;184;Murero;98;58;40;2019
50;Zaragoza;185;Murillo de Gállego;183;107;76;2019
50;Zaragoza;186;Navardún;38;23;15;2019
50;Zaragoza;187;Nigüella;62;38;24;2019
50;Zaragoza;188;Nombrevilla;31;19;12;2019
50;Zaragoza;189;Nonaspe;961;519;442;2019
50;Zaragoza;190;Novallas;830;440;390;2019
50;Zaragoza;191;Novillas;532;268;264;2019
50;Zaragoza;192;Nuévalos;310;173;137;2019
50;Zaragoza;193;Nuez de Ebro;837;419;418;2019
50;Zaragoza;194;Olvés;104;62;42;2019
50;Zaragoza;195;Orcajo;58;36;22;2019
50;Zaragoza;196;Orera;114;60;54;2019
50;Zaragoza;197;Orés;114;69;45;2019
50;Zaragoza;198;Oseja;53;33;20;2019
50;Zaragoza;199;Osera de Ebro;386;193;193;2019
50;Zaragoza;200;Paniza;609;327;282;2019
50;Zaragoza;201;Paracuellos de Jiloca;592;314;278;2019
50;Zaragoza;202;Paracuellos de la Ribera;143;73;70;2019
50;Zaragoza;203;Pastriz;1297;620;677;2019
50;Zaragoza;204;Pedrola;3568;1863;1705;2019
50;Zaragoza;205;Pedrosas, Las;87;44;43;2019
50;Zaragoza;206;Perdiguera;572;305;267;2019
50;Zaragoza;207;Piedratajada;95;51;44;2019
50;Zaragoza;208;Pina de Ebro;2362;1212;1150;2019
50;Zaragoza;209;Pinseque;3973;2050;1923;2019
50;Zaragoza;210;Pintanos, Los;37;23;14;2019
50;Zaragoza;211;Plasencia de Jalón;306;174;132;2019
50;Zaragoza;212;Pleitas;34;14;20;2019
50;Zaragoza;213;Plenas;106;54;52;2019
50;Zaragoza;214;Pomer;22;14;8;2019
50;Zaragoza;215;Pozuel de Ariza;21;12;9;2019
50;Zaragoza;216;Pozuelo de Aragón;296;159;137;2019
50;Zaragoza;217;Pradilla de Ebro;563;298;265;2019
50;Zaragoza;218;Puebla de Albortón;118;73;45;2019
50;Zaragoza;219;Puebla de Alfindén, La;6303;3224;3079;2019
50;Zaragoza;220;Puendeluna;44;27;17;2019
50;Zaragoza;221;Purujosa;35;25;10;2019
50;Zaragoza;222;Quinto;1939;977;962;2019
50;Zaragoza;223;Remolinos;1086;554;532;2019
50;Zaragoza;224;Retascón;67;40;27;2019
50;Zaragoza;225;Ricla;2847;1517;1330;2019
50;Zaragoza;227;Romanos;128;65;63;2019
50;Zaragoza;228;Rueda de Jalón;310;170;140;2019
50;Zaragoza;229;Ruesca;78;39;39;2019
50;Zaragoza;241;Sabiñán;723;388;335;2019
50;Zaragoza;230;Sádaba;1324;671;653;2019
50;Zaragoza;231;Salillas de Jalón;315;155;160;2019
50;Zaragoza;232;Salvatierra de Esca;199;93;106;2019
50;Zaragoza;233;Samper del Salz;110;62;48;2019
50;Zaragoza;234;San Martín de la Virgen de Moncayo;277;155;122;2019
50;Zaragoza;235;San Mateo de Gállego;3234;1668;1566;2019
50;Zaragoza;236;Santa Cruz de Grío;116;70;46;2019
50;Zaragoza;237;Santa Cruz de Moncayo;130;70;60;2019
50;Zaragoza;238;Santa Eulalia de Gállego;95;52;43;2019
50;Zaragoza;239;Santed;63;39;24;2019
50;Zaragoza;240;Sástago;1154;578;576;2019
50;Zaragoza;242;Sediles;102;59;43;2019
50;Zaragoza;243;Sestrica;352;202;150;2019
50;Zaragoza;244;Sierra de Luna;268;139;129;2019
50;Zaragoza;245;Sigüés;83;44;39;2019
50;Zaragoza;246;Sisamón;29;18;11;2019
50;Zaragoza;247;Sobradiel;1096;523;573;2019
50;Zaragoza;248;Sos del Rey Católico;590;312;278;2019
50;Zaragoza;249;Tabuenca;314;181;133;2019
50;Zaragoza;250;Talamantes;64;30;34;2019
50;Zaragoza;251;Tarazona;10533;5256;5277;2019
50;Zaragoza;252;Tauste;6912;3451;3461;2019
50;Zaragoza;253;Terrer;447;240;207;2019
50;Zaragoza;254;Tierga;186;101;85;2019
50;Zaragoza;255;Tobed;214;112;102;2019
50;Zaragoza;256;Torralba de los Frailes;79;43;36;2019
50;Zaragoza;257;Torralba de Ribota;174;98;76;2019
50;Zaragoza;258;Torralbilla;55;34;21;2019
50;Zaragoza;259;Torrehermosa;59;33;26;2019
50;Zaragoza;260;Torrelapaja;32;21;11;2019
50;Zaragoza;261;Torrellas;250;128;122;2019
50;Zaragoza;262;Torres de Berrellén;1446;739;707;2019
50;Zaragoza;263;Torrijo de la Cañada;199;116;83;2019
50;Zaragoza;264;Tosos;183;104;79;2019
50;Zaragoza;265;Trasmoz;86;51;35;2019
50;Zaragoza;266;Trasobares;122;76;46;2019
50;Zaragoza;267;Uncastillo;636;301;335;2019
50;Zaragoza;268;Undués de Lerda;50;28;22;2019
50;Zaragoza;269;Urrea de Jalón;418;234;184;2019
50;Zaragoza;270;Urriés;39;21;18;2019
50;Zaragoza;271;Used;269;145;124;2019
50;Zaragoza;272;Utebo;18691;9287;9404;2019
50;Zaragoza;274;Val de San Martín;66;39;27;2019
50;Zaragoza;273;Valdehorna;33;18;15;2019
50;Zaragoza;275;Valmadrid;117;71;46;2019
50;Zaragoza;276;Valpalmas;140;68;72;2019
50;Zaragoza;277;Valtorres;61;27;34;2019
50;Zaragoza;278;Velilla de Ebro;215;116;99;2019
50;Zaragoza;279;Velilla de Jiloca;87;42;45;2019
50;Zaragoza;280;Vera de Moncayo;338;174;164;2019
50;Zaragoza;281;Vierlas;77;40;37;2019
50;Zaragoza;283;Villadoz;92;51;41;2019
50;Zaragoza;284;Villafeliche;166;90;76;2019
50;Zaragoza;285;Villafranca de Ebro;833;416;417;2019
50;Zaragoza;286;Villalba de Perejil;96;48;48;2019
50;Zaragoza;287;Villalengua;313;172;141;2019
50;Zaragoza;903;Villamayor de Gállego;2720;1361;1359;2019
50;Zaragoza;288;Villanueva de Gállego;4720;2368;2352;2019
50;Zaragoza;290;Villanueva de Huerva;443;229;214;2019
50;Zaragoza;289;Villanueva de Jiloca;54;27;27;2019
50;Zaragoza;291;Villar de los Navarros;106;60;46;2019
50;Zaragoza;292;Villarreal de Huerva;274;152;122;2019
50;Zaragoza;293;Villarroya de la Sierra;446;234;212;2019
50;Zaragoza;294;Villarroya del Campo;74;40;34;2019
50;Zaragoza;282;Vilueña, La;72;35;37;2019
50;Zaragoza;295;Vistabella;49;28;21;2019
50;Zaragoza;296;Zaida, La;435;219;216;2019
50;Zaragoza;297;Zaragoza;674997;322626;352371;2019
50;Zaragoza;298;Zuera;8565;4442;4123;2019
02;Albacete;001;Abengibre;761;365;396;2020
02;Albacete;002;Alatoz;506;283;223;2020
02;Albacete;003;Albacete;174336;85214;89122;2020
02;Albacete;004;Albatana;679;351;328;2020
02;Albacete;005;Alborea;664;346;318;2020
02;Albacete;006;Alcadozo;647;350;297;2020
02;Albacete;007;Alcalá del Júcar;1194;640;554;2020
02;Albacete;008;Alcaraz;1324;687;637;2020
02;Albacete;009;Almansa;24511;12208;12303;2020
02;Albacete;010;Alpera;2261;1170;1091;2020
02;Albacete;011;Ayna;591;311;280;2020
02;Albacete;012;Balazote;2327;1187;1140;2020
02;Albacete;014;Ballestero, El;396;203;193;2020
02;Albacete;013;Balsa de Ves;131;77;54;2020
02;Albacete;015;Barrax;1799;923;876;2020
02;Albacete;016;Bienservida;579;313;266;2020
02;Albacete;017;Bogarra;807;426;381;2020
02;Albacete;018;Bonete;1029;530;499;2020
02;Albacete;019;Bonillo, El;2723;1386;1337;2020
02;Albacete;020;Carcelén;495;265;230;2020
02;Albacete;021;Casas de Juan Núñez;1326;713;613;2020
02;Albacete;022;Casas de Lázaro;348;196;152;2020
02;Albacete;023;Casas de Ves;563;293;270;2020
02;Albacete;024;Casas-Ibáñez;4544;2281;2263;2020
02;Albacete;025;Caudete;10005;5098;4907;2020
02;Albacete;026;Cenizate;1194;601;593;2020
02;Albacete;029;Chinchilla de Monte-Aragón;4205;2199;2006;2020
02;Albacete;027;Corral-Rubio;311;167;144;2020
02;Albacete;028;Cotillas;118;62;56;2020
02;Albacete;030;Elche de la Sierra;3520;1747;1773;2020
02;Albacete;031;Férez;629;316;313;2020
02;Albacete;032;Fuensanta;291;170;121;2020
02;Albacete;033;Fuente-Álamo;2474;1290;1184;2020
02;Albacete;034;Fuentealbilla;1831;941;890;2020
02;Albacete;035;Gineta, La;2548;1322;1226;2020
02;Albacete;036;Golosalvo;98;52;46;2020
02;Albacete;037;Hellín;30200;15119;15081;2020
02;Albacete;038;Herrera, La;322;164;158;2020
02;Albacete;039;Higueruela;1135;589;546;2020
02;Albacete;040;Hoya-Gonzalo;630;339;291;2020
02;Albacete;041;Jorquera;342;186;156;2020
02;Albacete;042;Letur;892;434;458;2020
02;Albacete;043;Lezuza;1332;692;640;2020
02;Albacete;044;Liétor;1150;591;559;2020
02;Albacete;045;Madrigueras;4634;2367;2267;2020
02;Albacete;046;Mahora;1362;702;660;2020
02;Albacete;047;Masegoso;104;57;47;2020
02;Albacete;048;Minaya;1475;756;719;2020
02;Albacete;049;Molinicos;813;421;392;2020
02;Albacete;050;Montalvos;88;47;41;2020
02;Albacete;051;Montealegre del Castillo;2041;1045;996;2020
02;Albacete;052;Motilleja;578;313;265;2020
02;Albacete;053;Munera;3429;1768;1661;2020
02;Albacete;054;Navas de Jorquera;521;274;247;2020
02;Albacete;055;Nerpio;1178;654;524;2020
02;Albacete;056;Ontur;1976;1001;975;2020
02;Albacete;057;Ossa de Montiel;2262;1134;1128;2020
02;Albacete;058;Paterna del Madera;329;178;151;2020
02;Albacete;060;Peñas de San Pedro;1394;815;579;2020
02;Albacete;059;Peñascosa;333;186;147;2020
02;Albacete;061;Pétrola;681;352;329;2020
02;Albacete;062;Povedilla;405;225;180;2020
02;Albacete;901;Pozo Cañada;2791;1413;1378;2020
02;Albacete;063;Pozohondo;1593;830;763;2020
02;Albacete;064;Pozo-Lorente;408;208;200;2020
02;Albacete;065;Pozuelo;469;251;218;2020
02;Albacete;066;Recueja, La;231;126;105;2020
02;Albacete;067;Riópar;1341;687;654;2020
02;Albacete;068;Robledo;376;206;170;2020
02;Albacete;069;Roda, La;15527;7853;7674;2020
02;Albacete;070;Salobre;470;251;219;2020
02;Albacete;071;San Pedro;1171;598;573;2020
02;Albacete;072;Socovos;1778;919;859;2020
02;Albacete;073;Tarazona de la Mancha;6187;3165;3022;2020
02;Albacete;074;Tobarra;7709;3958;3751;2020
02;Albacete;075;Valdeganga;1990;1023;967;2020
02;Albacete;076;Vianos;329;170;159;2020
02;Albacete;077;Villa de Ves;61;35;26;2020
02;Albacete;078;Villalgordo del Júcar;1102;583;519;2020
02;Albacete;079;Villamalea;4070;2078;1992;2020
02;Albacete;080;Villapalacios;583;307;276;2020
02;Albacete;081;Villarrobledo;25116;12434;12682;2020
02;Albacete;082;Villatoya;109;64;45;2020
02;Albacete;083;Villavaliente;220;134;86;2020
02;Albacete;084;Villaverde de Guadalimar;325;171;154;2020
02;Albacete;085;Viveros;329;171;158;2020
02;Albacete;086;Yeste;2614;1354;1260;2020
03;Alicante/Alacant;002;Agost;4794;2398;2396;2020
03;Alicante/Alacant;003;Agres;564;309;255;2020
03;Alicante/Alacant;004;Aigües;986;506;480;2020
03;Alicante/Alacant;005;Albatera;12474;6356;6118;2020
03;Alicante/Alacant;006;Alcalalí;1302;653;649;2020
03;Alicante/Alacant;007;Alcocer de Planes;226;113;113;2020
03;Alicante/Alacant;008;Alcoleja;177;98;79;2020
03;Alicante/Alacant;009;Alcoy/Alcoi;59354;29107;30247;2020
03;Alicante/Alacant;010;Alfafara;406;198;208;2020
03;Alicante/Alacant;011;Alfàs del Pi, l';20042;9945;10097;2020
03;Alicante/Alacant;012;Algorfa;3125;1595;1530;2020
03;Alicante/Alacant;013;Algueña;1326;668;658;2020
03;Alicante/Alacant;014;Alicante/Alacant;337482;163385;174097;2020
03;Alicante/Alacant;015;Almoradí;21208;10694;10514;2020
03;Alicante/Alacant;016;Almudaina;109;53;56;2020
03;Alicante/Alacant;017;Alqueria d'Asnar, l';493;241;252;2020
03;Alicante/Alacant;018;Altea;22558;11045;11513;2020
03;Alicante/Alacant;019;Aspe;20804;10471;10333;2020
03;Alicante/Alacant;001;Atzúbia, l';611;314;297;2020
03;Alicante/Alacant;020;Balones;128;71;57;2020
03;Alicante/Alacant;021;Banyeres de Mariola;7090;3548;3542;2020
03;Alicante/Alacant;022;Benasau;156;75;81;2020
03;Alicante/Alacant;023;Beneixama;1690;845;845;2020
03;Alicante/Alacant;024;Benejúzar;5435;2711;2724;2020
03;Alicante/Alacant;025;Benferri;1965;1016;949;2020
03;Alicante/Alacant;026;Beniarbeig;2159;1096;1063;2020
03;Alicante/Alacant;027;Beniardá;200;97;103;2020
03;Alicante/Alacant;028;Beniarrés;1099;563;536;2020
03;Alicante/Alacant;030;Benidoleig;1078;536;542;2020
03;Alicante/Alacant;031;Benidorm;70450;35214;35236;2020
03;Alicante/Alacant;032;Benifallim;104;57;47;2020
03;Alicante/Alacant;033;Benifato;136;71;65;2020
03;Alicante/Alacant;029;Benigembla;443;227;216;2020
03;Alicante/Alacant;034;Benijófar;3293;1604;1689;2020
03;Alicante/Alacant;035;Benilloba;726;384;342;2020
03;Alicante/Alacant;036;Benillup;100;52;48;2020
03;Alicante/Alacant;037;Benimantell;497;253;244;2020
03;Alicante/Alacant;038;Benimarfull;396;201;195;2020
03;Alicante/Alacant;039;Benimassot;103;55;48;2020
03;Alicante/Alacant;040;Benimeli;429;197;232;2020
03;Alicante/Alacant;041;Benissa;11288;5546;5742;2020
03;Alicante/Alacant;042;Benitachell/Poble Nou de Benitatxell, el;4452;2200;2252;2020
03;Alicante/Alacant;043;Biar;3655;1795;1860;2020
03;Alicante/Alacant;044;Bigastro;6909;3481;3428;2020
03;Alicante/Alacant;045;Bolulla;417;218;199;2020
03;Alicante/Alacant;046;Busot;3075;1563;1512;2020
03;Alicante/Alacant;049;Callosa de Segura;19127;9756;9371;2020
03;Alicante/Alacant;048;Callosa d'en Sarrià;7522;3871;3651;2020
03;Alicante/Alacant;047;Calp;23326;11775;11551;2020
03;Alicante/Alacant;050;Campello, el;28930;14076;14854;2020
03;Alicante/Alacant;051;Campo de Mirra/Camp de Mirra, el;417;212;205;2020
03;Alicante/Alacant;052;Cañada;1208;596;612;2020
03;Alicante/Alacant;053;Castalla;10461;5331;5130;2020
03;Alicante/Alacant;054;Castell de Castells;437;231;206;2020
03;Alicante/Alacant;075;Castell de Guadalest, el;224;111;113;2020
03;Alicante/Alacant;055;Catral;8898;4468;4430;2020
03;Alicante/Alacant;056;Cocentaina;11520;5852;5668;2020
03;Alicante/Alacant;057;Confrides;261;149;112;2020
03;Alicante/Alacant;058;Cox;7386;3757;3629;2020
03;Alicante/Alacant;059;Crevillent;29536;14967;14569;2020
03;Alicante/Alacant;061;Daya Nueva;1733;844;889;2020
03;Alicante/Alacant;062;Daya Vieja;731;371;360;2020
03;Alicante/Alacant;063;Dénia;42827;20723;22104;2020
03;Alicante/Alacant;064;Dolores;7531;3756;3775;2020
03;Alicante/Alacant;065;Elche/Elx;234765;116386;118379;2020
03;Alicante/Alacant;066;Elda;52813;25738;27075;2020
03;Alicante/Alacant;067;Facheca;107;56;51;2020
03;Alicante/Alacant;068;Famorca;45;24;21;2020
03;Alicante/Alacant;069;Finestrat;7103;3645;3458;2020
03;Alicante/Alacant;077;Fondó de les Neus, el/Hondón de las Nieves;2606;1333;1273;2020
03;Alicante/Alacant;070;Formentera del Segura;4268;2168;2100;2020
03;Alicante/Alacant;072;Gaianes;479;236;243;2020
03;Alicante/Alacant;071;Gata de Gorgos;6243;3181;3062;2020
03;Alicante/Alacant;073;Gorga;241;130;111;2020
03;Alicante/Alacant;074;Granja de Rocamora;2591;1356;1235;2020
03;Alicante/Alacant;076;Guardamar del Segura;15849;7735;8114;2020
03;Alicante/Alacant;078;Hondón de los Frailes;1242;633;609;2020
03;Alicante/Alacant;079;Ibi;23564;11776;11788;2020
03;Alicante/Alacant;080;Jacarilla;1998;1024;974;2020
03;Alicante/Alacant;082;Jávea/Xàbia;28016;13928;14088;2020
03;Alicante/Alacant;083;Jijona/Xixona;6879;3355;3524;2020
03;Alicante/Alacant;085;Llíber;830;414;416;2020
03;Alicante/Alacant;084;Lorcha/Orxa, l';582;289;293;2020
03;Alicante/Alacant;086;Millena;240;127;113;2020
03;Alicante/Alacant;088;Monforte del Cid;8346;4375;3971;2020
03;Alicante/Alacant;089;Monóvar/Monòver;12212;6097;6115;2020
03;Alicante/Alacant;903;Montesinos, Los;5061;2579;2482;2020
03;Alicante/Alacant;091;Murla;507;234;273;2020
03;Alicante/Alacant;092;Muro de Alcoy;9315;4636;4679;2020
03;Alicante/Alacant;090;Mutxamel;25645;12822;12823;2020
03;Alicante/Alacant;093;Novelda;25741;12806;12935;2020
03;Alicante/Alacant;094;Nucia, la;18163;9236;8927;2020
03;Alicante/Alacant;095;Ondara;7076;3569;3507;2020
03;Alicante/Alacant;096;Onil;7600;3791;3809;2020
03;Alicante/Alacant;097;Orba;2232;1106;1126;2020
03;Alicante/Alacant;099;Orihuela;78505;38965;39540;2020
03;Alicante/Alacant;098;Orxeta;784;400;384;2020
03;Alicante/Alacant;100;Parcent;967;473;494;2020
03;Alicante/Alacant;101;Pedreguer;7881;3927;3954;2020
03;Alicante/Alacant;102;Pego;10133;5041;5092;2020
03;Alicante/Alacant;103;Penàguila;269;142;127;2020
03;Alicante/Alacant;104;Petrer;34241;17004;17237;2020
03;Alicante/Alacant;902;Pilar de la Horadada;22347;11467;10880;2020
03;Alicante/Alacant;105;Pinós, el/Pinoso;8025;4055;3970;2020
03;Alicante/Alacant;106;Planes;682;367;315;2020
03;Alicante/Alacant;901;Poblets, els;2714;1298;1416;2020
03;Alicante/Alacant;107;Polop;5064;2599;2465;2020
03;Alicante/Alacant;060;Quatretondeta;118;64;54;2020
03;Alicante/Alacant;109;Rafal;4553;2259;2294;2020
03;Alicante/Alacant;110;Ràfol d'Almúnia, el;648;329;319;2020
03;Alicante/Alacant;111;Redován;7926;4116;3810;2020
03;Alicante/Alacant;112;Relleu;1148;598;550;2020
03;Alicante/Alacant;113;Rojales;16671;8517;8154;2020
03;Alicante/Alacant;114;Romana, la;2492;1291;1201;2020
03;Alicante/Alacant;115;Sagra;426;207;219;2020
03;Alicante/Alacant;116;Salinas;1620;834;786;2020
03;Alicante/Alacant;118;San Fulgencio;8071;4090;3981;2020
03;Alicante/Alacant;904;San Isidro;2103;1094;1009;2020
03;Alicante/Alacant;120;San Miguel de Salinas;6313;3178;3135;2020
03;Alicante/Alacant;122;San Vicente del Raspeig/Sant Vicent del Raspeig;58978;29149;29829;2020
03;Alicante/Alacant;117;Sanet y Negrals;690;354;336;2020
03;Alicante/Alacant;119;Sant Joan d'Alacant;24367;11742;12625;2020
03;Alicante/Alacant;121;Santa Pola;33303;16742;16561;2020
03;Alicante/Alacant;123;Sax;9859;4978;4881;2020
03;Alicante/Alacant;124;Sella;577;299;278;2020
03;Alicante/Alacant;125;Senija;583;308;275;2020
03;Alicante/Alacant;127;Tàrbena;623;321;302;2020
03;Alicante/Alacant;128;Teulada;11278;5656;5622;2020
03;Alicante/Alacant;129;Tibi;1662;884;778;2020
03;Alicante/Alacant;130;Tollos;35;22;13;2020
03;Alicante/Alacant;131;Tormos;318;154;164;2020
03;Alicante/Alacant;132;Torremanzanas/Torre de les Maçanes, la;636;335;301;2020
03;Alicante/Alacant;133;Torrevieja;84667;41717;42950;2020
03;Alicante/Alacant;134;Vall d'Alcalà, la;160;89;71;2020
03;Alicante/Alacant;136;Vall de Gallinera;527;280;247;2020
03;Alicante/Alacant;137;Vall de Laguar, la;827;413;414;2020
03;Alicante/Alacant;135;Vall d'Ebo, la;218;113;105;2020
03;Alicante/Alacant;138;Verger, el;4709;2353;2356;2020
03;Alicante/Alacant;139;Villajoyosa/Vila Joiosa, la;35199;17546;17653;2020
03;Alicante/Alacant;140;Villena;34155;17193;16962;2020
03;Alicante/Alacant;081;Xaló;2868;1437;1431;2020
04;Almería;001;Abla;1248;632;616;2020
04;Almería;002;Abrucena;1183;630;553;2020
04;Almería;003;Adra;25412;13025;12387;2020
04;Almería;004;Albanchez;687;344;343;2020
04;Almería;005;Alboloduy;609;296;313;2020
04;Almería;006;Albox;12083;6188;5895;2020
04;Almería;007;Alcolea;844;435;409;2020
04;Almería;008;Alcóntar;514;284;230;2020
04;Almería;009;Alcudia de Monteagud;138;71;67;2020
04;Almería;010;Alhabia;677;356;321;2020
04;Almería;011;Alhama de Almería;3691;1858;1833;2020
04;Almería;012;Alicún;201;102;99;2020
04;Almería;013;Almería;201322;98531;102791;2020
04;Almería;014;Almócita;176;94;82;2020
04;Almería;015;Alsodux;125;76;49;2020
04;Almería;016;Antas;3315;1724;1591;2020
04;Almería;017;Arboleas;4624;2309;2315;2020
04;Almería;018;Armuña de Almanzora;300;145;155;2020
04;Almería;019;Bacares;250;135;115;2020
04;Almería;904;Balanegra;3105;1658;1447;2020
04;Almería;020;Bayárcal;312;173;139;2020
04;Almería;021;Bayarque;216;104;112;2020
04;Almería;022;Bédar;984;505;479;2020
04;Almería;023;Beires;120;57;63;2020
04;Almería;024;Benahadux;4481;2218;2263;2020
04;Almería;026;Benitagla;58;32;26;2020
04;Almería;027;Benizalón;262;141;121;2020
04;Almería;028;Bentarique;240;135;105;2020
04;Almería;029;Berja;12563;6397;6166;2020
04;Almería;030;Canjáyar;1189;626;563;2020
04;Almería;031;Cantoria;3365;1712;1653;2020
04;Almería;032;Carboneras;8105;4166;3939;2020
04;Almería;033;Castro de Filabres;120;63;57;2020
04;Almería;036;Chercos;298;152;146;2020
04;Almería;037;Chirivel;1489;760;729;2020
04;Almería;034;Cóbdar;178;98;80;2020
04;Almería;035;Cuevas del Almanzora;14455;7522;6933;2020
04;Almería;038;Dalías;4066;2014;2052;2020
04;Almería;902;Ejido, El;83758;43396;40362;2020
04;Almería;041;Enix;514;286;228;2020
04;Almería;043;Felix;636;365;271;2020
04;Almería;044;Fines;2104;1100;1004;2020
04;Almería;045;Fiñana;1984;998;986;2020
04;Almería;046;Fondón;994;509;485;2020
04;Almería;047;Gádor;3034;1581;1453;2020
04;Almería;048;Gallardos, Los;2902;1469;1433;2020
04;Almería;049;Garrucha;9520;4967;4553;2020
04;Almería;050;Gérgal;1080;568;512;2020
04;Almería;051;Huécija;486;238;248;2020
04;Almería;052;Huércal de Almería;17917;9094;8823;2020
04;Almería;053;Huércal-Overa;19432;9655;9777;2020
04;Almería;054;Íllar;405;217;188;2020
04;Almería;055;Instinción;448;234;214;2020
04;Almería;056;Laroya;198;114;84;2020
04;Almería;057;Láujar de Andarax;1527;761;766;2020
04;Almería;058;Líjar;394;212;182;2020
04;Almería;059;Lubrín;1449;720;729;2020
04;Almería;060;Lucainena de las Torres;564;293;271;2020
04;Almería;061;Lúcar;760;374;386;2020
04;Almería;062;Macael;5480;2807;2673;2020
04;Almería;063;María;1230;635;595;2020
04;Almería;064;Mojácar;6778;3312;3466;2020
04;Almería;903;Mojonera, La;9191;5191;4000;2020
04;Almería;065;Nacimiento;496;265;231;2020
04;Almería;066;Níjar;31666;17779;13887;2020
04;Almería;067;Ohanes;558;283;275;2020
04;Almería;068;Olula de Castro;191;106;85;2020
04;Almería;069;Olula del Río;6256;3214;3042;2020
04;Almería;070;Oria;2239;1169;1070;2020
04;Almería;071;Padules;414;219;195;2020
04;Almería;072;Partaloa;1035;523;512;2020
04;Almería;073;Paterna del Río;365;210;155;2020
04;Almería;074;Pechina;4103;2085;2018;2020
04;Almería;075;Pulpí;10358;5363;4995;2020
04;Almería;076;Purchena;1664;868;796;2020
04;Almería;077;Rágol;303;155;148;2020
04;Almería;078;Rioja;1453;739;714;2020
04;Almería;079;Roquetas de Mar;98433;50782;47651;2020
04;Almería;080;Santa Cruz de Marchena;199;99;100;2020
04;Almería;081;Santa Fe de Mondújar;461;236;225;2020
04;Almería;082;Senés;289;159;130;2020
04;Almería;083;Serón;2033;1040;993;2020
04;Almería;084;Sierro;379;208;171;2020
04;Almería;085;Somontín;443;224;219;2020
04;Almería;086;Sorbas;2436;1274;1162;2020
04;Almería;087;Suflí;196;105;91;2020
04;Almería;088;Tabernas;3717;1900;1817;2020
04;Almería;089;Taberno;974;478;496;2020
04;Almería;090;Tahal;336;172;164;2020
04;Almería;091;Terque;365;192;173;2020
04;Almería;092;Tíjola;3548;1776;1772;2020
04;Almería;901;Tres Villas, Las;565;303;262;2020
04;Almería;093;Turre;3781;1967;1814;2020
04;Almería;094;Turrillas;248;141;107;2020
04;Almería;095;Uleila del Campo;822;413;409;2020
04;Almería;096;Urrácal;350;182;168;2020
04;Almería;097;Velefique;230;127;103;2020
04;Almería;098;Vélez-Blanco;1874;965;909;2020
04;Almería;099;Vélez-Rubio;6546;3206;3340;2020
04;Almería;100;Vera;16996;8655;8341;2020
04;Almería;101;Viator;5978;3058;2920;2020
04;Almería;102;Vícar;26899;14569;12330;2020
04;Almería;103;Zurgena;2956;1485;1471;2020
01;Araba/Álava;051;Agurain/Salvatierra;5038;2537;2501;2020
01;Araba/Álava;001;Alegría-Dulantzi;2935;1531;1404;2020
01;Araba/Álava;002;Amurrio;10264;5044;5220;2020
01;Araba/Álava;049;Añana;149;89;60;2020
01;Araba/Álava;003;Aramaio;1442;748;694;2020
01;Araba/Álava;006;Armiñón;223;115;108;2020
01;Araba/Álava;037;Arraia-Maeztu;733;414;319;2020
01;Araba/Álava;008;Arratzua-Ubarrundia;984;539;445;2020
01;Araba/Álava;004;Artziniega;1800;892;908;2020
01;Araba/Álava;009;Asparrena;1623;833;790;2020
01;Araba/Álava;010;Ayala/Aiara;2968;1500;1468;2020
01;Araba/Álava;011;Baños de Ebro/Mañueta;294;166;128;2020
01;Araba/Álava;013;Barrundia;881;483;398;2020
01;Araba/Álava;014;Berantevilla;463;240;223;2020
01;Araba/Álava;016;Bernedo;507;305;202;2020
01;Araba/Álava;017;Campezo/Kanpezu;1034;547;487;2020
01;Araba/Álava;021;Elburgo/Burgelu;608;317;291;2020
01;Araba/Álava;022;Elciego;1001;500;501;2020
01;Araba/Álava;023;Elvillar/Bilar;330;162;168;2020
01;Araba/Álava;047;Erriberabeitia;1383;748;635;2020
01;Araba/Álava;046;Erriberagoitia/Ribera Alta;782;455;327;2020
01;Araba/Álava;056;Harana/Valle de Arana;218;121;97;2020
01;Araba/Álava;901;Iruña Oka/Iruña de Oca;3488;1821;1667;2020
01;Araba/Álava;027;Iruraiz-Gauna;532;290;242;2020
01;Araba/Álava;019;Kripan;178;92;86;2020
01;Araba/Álava;020;Kuartango;385;224;161;2020
01;Araba/Álava;028;Labastida/Bastida;1517;779;738;2020
01;Araba/Álava;030;Lagrán;162;90;72;2020
01;Araba/Álava;031;Laguardia;1454;750;704;2020
01;Araba/Álava;032;Lanciego/Lantziego;709;383;326;2020
01;Araba/Álava;902;Lantarón;877;488;389;2020
01;Araba/Álava;033;Lapuebla de Labarca;865;441;424;2020
01;Araba/Álava;036;Laudio/Llodio;18118;8868;9250;2020
01;Araba/Álava;058;Legutio;1921;1010;911;2020
01;Araba/Álava;034;Leza;211;106;105;2020
01;Araba/Álava;039;Moreda de Álava/Moreda Araba;211;105;106;2020
01;Araba/Álava;041;Navaridas;194;114;80;2020
01;Araba/Álava;042;Okondo;1203;629;574;2020
01;Araba/Álava;043;Oyón-Oion;3410;1729;1681;2020
01;Araba/Álava;044;Peñacerrada-Urizaharra;262;156;106;2020
01;Araba/Álava;052;Samaniego;315;148;167;2020
01;Araba/Álava;053;San Millán/Donemiliaga;706;386;320;2020
01;Araba/Álava;054;Urkabustaiz;1386;723;663;2020
01;Araba/Álava;055;Valdegovía/Gaubea;986;538;448;2020
01;Araba/Álava;057;Villabuena de Álava/Eskuernaga;274;141;133;2020
01;Araba/Álava;059;Vitoria-Gasteiz;253996;123627;130369;2020
01;Araba/Álava;060;Yécora/Iekora;270;139;131;2020
01;Araba/Álava;061;Zalduondo;185;105;80;2020
01;Araba/Álava;062;Zambrana;416;220;196;2020
01;Araba/Álava;018;Zigoitia;1749;948;801;2020
01;Araba/Álava;063;Zuia;2300;1188;1112;2020
33;Asturias;001;Allande;1615;799;816;2020
33;Asturias;002;Aller;10413;5141;5272;2020
33;Asturias;003;Amieva;628;362;266;2020
33;Asturias;004;Avilés;77791;36800;40991;2020
33;Asturias;005;Belmonte de Miranda;1437;775;662;2020
33;Asturias;006;Bimenes;1679;803;876;2020
33;Asturias;007;Boal;1482;748;734;2020
33;Asturias;008;Cabrales;1941;980;961;2020
33;Asturias;009;Cabranes;1057;531;526;2020
33;Asturias;010;Candamo;1969;961;1008;2020
33;Asturias;012;Cangas de Onís;6209;3002;3207;2020
33;Asturias;011;Cangas del Narcea;12124;5951;6173;2020
33;Asturias;013;Caravia;469;245;224;2020
33;Asturias;014;Carreño;10301;4953;5348;2020
33;Asturias;015;Caso;1457;838;619;2020
33;Asturias;016;Castrillón;22273;10774;11499;2020
33;Asturias;017;Castropol;3342;1632;1710;2020
33;Asturias;018;Coaña;3296;1612;1684;2020
33;Asturias;019;Colunga;3205;1592;1613;2020
33;Asturias;020;Corvera de Asturias;15525;7599;7926;2020
33;Asturias;021;Cudillero;4922;2431;2491;2020
33;Asturias;022;Degaña;881;456;425;2020
33;Asturias;023;Franco, El;3760;1849;1911;2020
33;Asturias;024;Gijón;271717;127961;143756;2020
33;Asturias;025;Gozón;10282;5025;5257;2020
33;Asturias;026;Grado;9703;4713;4990;2020
33;Asturias;027;Grandas de Salime;815;419;396;2020
33;Asturias;028;Ibias;1207;695;512;2020
33;Asturias;029;Illano;333;168;165;2020
33;Asturias;030;Illas;1023;514;509;2020
33;Asturias;031;Langreo;39183;18687;20496;2020
33;Asturias;032;Laviana;12882;6175;6707;2020
33;Asturias;033;Lena;10701;5153;5548;2020
33;Asturias;035;Llanera;13695;6797;6898;2020
33;Asturias;036;Llanes;13473;6551;6922;2020
33;Asturias;037;Mieres;37537;17827;19710;2020
33;Asturias;038;Morcín;2555;1274;1281;2020
33;Asturias;039;Muros de Nalón;1887;905;982;2020
33;Asturias;040;Nava;5276;2593;2683;2020
33;Asturias;041;Navia;8322;4026;4296;2020
33;Asturias;042;Noreña;5145;2451;2694;2020
33;Asturias;043;Onís;734;403;331;2020
33;Asturias;044;Oviedo;219910;101749;118161;2020
33;Asturias;045;Parres;5315;2596;2719;2020
33;Asturias;046;Peñamellera Alta;498;265;233;2020
33;Asturias;047;Peñamellera Baja;1227;605;622;2020
33;Asturias;048;Pesoz;148;80;68;2020
33;Asturias;049;Piloña;6875;3379;3496;2020
33;Asturias;050;Ponga;572;337;235;2020
33;Asturias;051;Pravia;7984;3861;4123;2020
33;Asturias;052;Proaza;707;414;293;2020
33;Asturias;053;Quirós;1187;687;500;2020
33;Asturias;054;Regueras, Las;1839;938;901;2020
33;Asturias;055;Ribadedeva;1741;834;907;2020
33;Asturias;056;Ribadesella;5688;2710;2978;2020
33;Asturias;057;Ribera de Arriba;1837;932;905;2020
33;Asturias;058;Riosa;1848;926;922;2020
33;Asturias;059;Salas;4900;2413;2487;2020
33;Asturias;061;San Martín de Oscos;376;192;184;2020
33;Asturias;060;San Martín del Rey Aurelio;15817;7564;8253;2020
33;Asturias;063;San Tirso de Abres;421;208;213;2020
33;Asturias;062;Santa Eulalia de Oscos;449;223;226;2020
33;Asturias;064;Santo Adriano;273;135;138;2020
33;Asturias;065;Sariego;1254;603;651;2020
33;Asturias;066;Siero;51509;25220;26289;2020
33;Asturias;067;Sobrescobio;814;433;381;2020
33;Asturias;068;Somiedo;1093;644;449;2020
33;Asturias;069;Soto del Barco;3800;1883;1917;2020
33;Asturias;070;Tapia de Casariego;3726;1805;1921;2020
33;Asturias;071;Taramundi;602;285;317;2020
33;Asturias;072;Teverga;1554;845;709;2020
33;Asturias;073;Tineo;9199;4655;4544;2020
33;Asturias;034;Valdés;11394;5585;5809;2020
33;Asturias;074;Vegadeo;3926;1886;2040;2020
33;Asturias;075;Villanueva de Oscos;272;135;137;2020
33;Asturias;076;Villaviciosa;14470;7180;7290;2020
33;Asturias;077;Villayón;1180;616;564;2020
33;Asturias;078;Yernes y Tameza;133;72;61;2020
05;Ávila;001;Adanero;211;116;95;2020
05;Ávila;002;Adrada, La;2539;1306;1233;2020
05;Ávila;005;Albornos;177;93;84;2020
05;Ávila;007;Aldeanueva de Santa Cruz;117;62;55;2020
05;Ávila;008;Aldeaseca;228;112;116;2020
05;Ávila;010;Aldehuela, La;153;79;74;2020
05;Ávila;012;Amavida;127;70;57;2020
05;Ávila;013;Arenal, El;948;477;471;2020
05;Ávila;014;Arenas de San Pedro;6344;3073;3271;2020
05;Ávila;015;Arevalillo;69;32;37;2020
05;Ávila;016;Arévalo;7960;3899;4061;2020
05;Ávila;017;Aveinte;83;48;35;2020
05;Ávila;018;Avellaneda;26;15;11;2020
05;Ávila;019;Ávila;58369;27784;30585;2020
05;Ávila;021;Barco de Ávila, El;2330;1123;1207;2020
05;Ávila;022;Barraco, El;1893;970;923;2020
05;Ávila;023;Barromán;185;99;86;2020
05;Ávila;024;Becedas;191;100;91;2020
05;Ávila;025;Becedillas;80;42;38;2020
05;Ávila;026;Bercial de Zapardiel;197;103;94;2020
05;Ávila;027;Berlanas, Las;329;173;156;2020
05;Ávila;029;Bernuy-Zapardiel;97;54;43;2020
05;Ávila;030;Berrocalejo de Aragona;49;28;21;2020
05;Ávila;033;Blascomillán;181;95;86;2020
05;Ávila;034;Blasconuño de Matacabras;14;8;6;2020
05;Ávila;035;Blascosancho;96;45;51;2020
05;Ávila;036;Bohodón, El;117;60;57;2020
05;Ávila;037;Bohoyo;232;130;102;2020
05;Ávila;038;Bonilla de la Sierra;125;72;53;2020
05;Ávila;039;Brabos;43;27;16;2020
05;Ávila;040;Bularros;66;45;21;2020
05;Ávila;041;Burgohondo;1180;623;557;2020
05;Ávila;042;Cabezas de Alambre;161;78;83;2020
05;Ávila;043;Cabezas del Pozo;70;37;33;2020
05;Ávila;044;Cabezas del Villar;257;139;118;2020
05;Ávila;045;Cabizuela;79;42;37;2020
05;Ávila;046;Canales;42;24;18;2020
05;Ávila;047;Candeleda;5025;2532;2493;2020
05;Ávila;048;Cantiveros;98;57;41;2020
05;Ávila;049;Cardeñosa;435;234;201;2020
05;Ávila;051;Carrera, La;167;93;74;2020
05;Ávila;052;Casas del Puerto;85;48;37;2020
05;Ávila;053;Casasola;73;43;30;2020
05;Ávila;054;Casavieja;1434;735;699;2020
05;Ávila;055;Casillas;640;336;304;2020
05;Ávila;056;Castellanos de Zapardiel;94;53;41;2020
05;Ávila;057;Cebreros;3152;1639;1513;2020
05;Ávila;058;Cepeda la Mora;74;42;32;2020
05;Ávila;067;Chamartín;74;44;30;2020
05;Ávila;059;Cillán;88;54;34;2020
05;Ávila;060;Cisla;98;49;49;2020
05;Ávila;061;Colilla, La;335;170;165;2020
05;Ávila;062;Collado de Contreras;160;83;77;2020
05;Ávila;063;Collado del Mirón;31;20;11;2020
05;Ávila;064;Constanzana;105;59;46;2020
05;Ávila;065;Crespos;493;266;227;2020
05;Ávila;066;Cuevas del Valle;475;266;209;2020
05;Ávila;903;Diego del Carpio;126;72;54;2020
05;Ávila;069;Donjimeno;77;43;34;2020
05;Ávila;070;Donvidas;30;18;12;2020
05;Ávila;072;Espinosa de los Caballeros;112;59;53;2020
05;Ávila;073;Flores de Ávila;295;164;131;2020
05;Ávila;074;Fontiveros;749;391;358;2020
05;Ávila;075;Fresnedilla;107;54;53;2020
05;Ávila;076;Fresno, El;582;306;276;2020
05;Ávila;077;Fuente el Saúz;159;86;73;2020
05;Ávila;078;Fuentes de Año;95;56;39;2020
05;Ávila;079;Gallegos de Altamiros;66;36;30;2020
05;Ávila;080;Gallegos de Sobrinos;40;19;21;2020
05;Ávila;081;Garganta del Villar;39;27;12;2020
05;Ávila;082;Gavilanes;563;299;264;2020
05;Ávila;083;Gemuño;152;79;73;2020
05;Ávila;085;Gil García;38;18;20;2020
05;Ávila;084;Gilbuena;60;36;24;2020
05;Ávila;086;Gimialcón;75;47;28;2020
05;Ávila;087;Gotarrendura;170;63;107;2020
05;Ávila;088;Grandes y San Martín;25;13;12;2020
05;Ávila;089;Guisando;510;258;252;2020
05;Ávila;090;Gutierre-Muñoz;75;38;37;2020
05;Ávila;092;Hernansancho;155;91;64;2020
05;Ávila;093;Herradón de Pinares;419;232;187;2020
05;Ávila;094;Herreros de Suso;129;69;60;2020
05;Ávila;095;Higuera de las Dueñas;260;148;112;2020
05;Ávila;096;Hija de Dios, La;75;45;30;2020
05;Ávila;097;Horcajada, La;486;257;229;2020
05;Ávila;099;Horcajo de las Torres;496;277;219;2020
05;Ávila;100;Hornillo, El;277;147;130;2020
05;Ávila;102;Hoyo de Pinares, El;2129;1092;1037;2020
05;Ávila;101;Hoyocasero;281;164;117;2020
05;Ávila;103;Hoyorredondo;61;31;30;2020
05;Ávila;106;Hoyos de Miguel Muñoz;27;15;12;2020
05;Ávila;104;Hoyos del Collado;33;19;14;2020
05;Ávila;105;Hoyos del Espino;368;206;162;2020
05;Ávila;107;Hurtumpascual;48;30;18;2020
05;Ávila;108;Junciana;35;20;15;2020
05;Ávila;109;Langa;480;253;227;2020
05;Ávila;110;Lanzahíta;811;415;396;2020
05;Ávila;113;Llanos de Tormes, Los;60;30;30;2020
05;Ávila;112;Losar del Barco, El;107;59;48;2020
05;Ávila;114;Madrigal de las Altas Torres;1399;711;688;2020
05;Ávila;115;Maello;590;305;285;2020
05;Ávila;116;Malpartida de Corneja;96;48;48;2020
05;Ávila;117;Mamblas;200;115;85;2020
05;Ávila;118;Mancera de Arriba;69;37;32;2020
05;Ávila;119;Manjabálago y Ortigosa de Rioalmar;24;15;9;2020
05;Ávila;120;Marlín;32;21;11;2020
05;Ávila;121;Martiherrero;314;163;151;2020
05;Ávila;122;Martínez;113;58;55;2020
05;Ávila;123;Mediana de Voltoya;114;56;58;2020
05;Ávila;124;Medinilla;91;41;50;2020
05;Ávila;125;Mengamuñoz;61;31;30;2020
05;Ávila;126;Mesegar de Corneja;57;34;23;2020
05;Ávila;127;Mijares;694;377;317;2020
05;Ávila;128;Mingorría;373;199;174;2020
05;Ávila;129;Mirón, El;118;71;47;2020
05;Ávila;130;Mironcillo;106;55;51;2020
05;Ávila;131;Mirueña de los Infanzones;94;54;40;2020
05;Ávila;132;Mombeltrán;942;483;459;2020
05;Ávila;133;Monsalupe;62;33;29;2020
05;Ávila;134;Moraleja de Matacabras;49;29;20;2020
05;Ávila;135;Muñana;371;200;171;2020
05;Ávila;136;Muñico;86;46;40;2020
05;Ávila;138;Muñogalindo;326;160;166;2020
05;Ávila;139;Muñogrande;70;39;31;2020
05;Ávila;140;Muñomer del Peco;109;57;52;2020
05;Ávila;141;Muñopepe;101;57;44;2020
05;Ávila;142;Muñosancho;91;45;46;2020
05;Ávila;143;Muñotello;58;29;29;2020
05;Ávila;144;Narrillos del Álamo;72;38;34;2020
05;Ávila;145;Narrillos del Rebollar;43;26;17;2020
05;Ávila;149;Narros de Saldueña;106;60;46;2020
05;Ávila;147;Narros del Castillo;151;84;67;2020
05;Ávila;148;Narros del Puerto;23;12;11;2020
05;Ávila;152;Nava de Arévalo;718;376;342;2020
05;Ávila;153;Nava del Barco;79;43;36;2020
05;Ávila;151;Navacepedilla de Corneja;94;48;46;2020
05;Ávila;154;Navadijos;31;22;9;2020
05;Ávila;155;Navaescurial;45;28;17;2020
05;Ávila;156;Navahondilla;321;194;127;2020
05;Ávila;157;Navalacruz;226;125;101;2020
05;Ávila;158;Navalmoral;338;182;156;2020
05;Ávila;159;Navalonguilla;216;112;104;2020
05;Ávila;160;Navalosa;300;167;133;2020
05;Ávila;161;Navalperal de Pinares;757;394;363;2020
05;Ávila;162;Navalperal de Tormes;81;43;38;2020
05;Ávila;163;Navaluenga;2018;996;1022;2020
05;Ávila;164;Navaquesera;16;7;9;2020
05;Ávila;165;Navarredonda de Gredos;430;217;213;2020
05;Ávila;166;Navarredondilla;177;89;88;2020
05;Ávila;167;Navarrevisca;256;143;113;2020
05;Ávila;168;Navas del Marqués, Las;5146;2637;2509;2020
05;Ávila;169;Navatalgordo;231;130;101;2020
05;Ávila;170;Navatejares;51;25;26;2020
05;Ávila;171;Neila de San Miguel;67;35;32;2020
05;Ávila;172;Niharra;202;122;80;2020
05;Ávila;173;Ojos-Albos;76;46;30;2020
05;Ávila;174;Orbita;69;39;30;2020
05;Ávila;175;Oso, El;158;87;71;2020
05;Ávila;176;Padiernos;273;147;126;2020
05;Ávila;177;Pajares de Adaja;138;76;62;2020
05;Ávila;178;Palacios de Goda;389;204;185;2020
05;Ávila;179;Papatrigo;227;113;114;2020
05;Ávila;180;Parral, El;62;36;26;2020
05;Ávila;181;Pascualcobo;43;28;15;2020
05;Ávila;182;Pedro Bernardo;787;414;373;2020
05;Ávila;183;Pedro-Rodríguez;133;69;64;2020
05;Ávila;184;Peguerinos;275;159;116;2020
05;Ávila;185;Peñalba de Ávila;105;59;46;2020
05;Ávila;186;Piedrahíta;1802;874;928;2020
05;Ávila;187;Piedralaves;2070;1025;1045;2020
05;Ávila;188;Poveda;39;24;15;2020
05;Ávila;189;Poyales del Hoyo;458;248;210;2020
05;Ávila;190;Pozanco;53;30;23;2020
05;Ávila;191;Pradosegar;109;58;51;2020
05;Ávila;192;Puerto Castilla;107;63;44;2020
05;Ávila;193;Rasueros;174;96;78;2020
05;Ávila;194;Riocabado;137;79;58;2020
05;Ávila;195;Riofrío;203;123;80;2020
05;Ávila;196;Rivilla de Barajas;67;31;36;2020
05;Ávila;197;Salobral;112;61;51;2020
05;Ávila;198;Salvadiós;69;34;35;2020
05;Ávila;199;San Bartolomé de Béjar;39;19;20;2020
05;Ávila;200;San Bartolomé de Corneja;44;24;20;2020
05;Ávila;201;San Bartolomé de Pinares;534;288;246;2020
05;Ávila;206;San Esteban de los Patos;23;14;9;2020
05;Ávila;208;San Esteban de Zapardiel;40;24;16;2020
05;Ávila;207;San Esteban del Valle;718;370;348;2020
05;Ávila;209;San García de Ingelmos;75;46;29;2020
05;Ávila;901;San Juan de Gredos;247;134;113;2020
05;Ávila;210;San Juan de la Encinilla;80;40;40;2020
05;Ávila;211;San Juan de la Nava;459;249;210;2020
05;Ávila;212;San Juan del Molinillo;196;111;85;2020
05;Ávila;213;San Juan del Olmo;90;59;31;2020
05;Ávila;214;San Lorenzo de Tormes;27;14;13;2020
05;Ávila;215;San Martín de la Vega del Alberche;166;98;68;2020
05;Ávila;216;San Martín del Pimpollar;186;111;75;2020
05;Ávila;217;San Miguel de Corneja;53;30;23;2020
05;Ávila;218;San Miguel de Serrezuela;115;61;54;2020
05;Ávila;219;San Pascual;39;23;16;2020
05;Ávila;220;San Pedro del Arroyo;422;224;198;2020
05;Ávila;231;San Vicente de Arévalo;170;96;74;2020
05;Ávila;204;Sanchidrián;714;360;354;2020
05;Ávila;205;Sanchorreja;83;39;44;2020
05;Ávila;222;Santa Cruz de Pinares;148;81;67;2020
05;Ávila;221;Santa Cruz del Valle;332;173;159;2020
05;Ávila;226;Santa María de los Caballeros;63;37;26;2020
05;Ávila;224;Santa María del Arroyo;105;57;48;2020
05;Ávila;225;Santa María del Berrocal;388;207;181;2020
05;Ávila;902;Santa María del Cubillo;303;174;129;2020
05;Ávila;227;Santa María del Tiétar;447;233;214;2020
05;Ávila;228;Santiago del Collado;170;110;60;2020
05;Ávila;904;Santiago del Tormes;114;66;48;2020
05;Ávila;229;Santo Domingo de las Posadas;69;37;32;2020
05;Ávila;230;Santo Tomé de Zabarcos;67;37;30;2020
05;Ávila;232;Serrada, La;118;59;59;2020
05;Ávila;233;Serranillos;243;136;107;2020
05;Ávila;234;Sigeres;45;22;23;2020
05;Ávila;235;Sinlabajos;143;74;69;2020
05;Ávila;236;Solana de Ávila;110;61;49;2020
05;Ávila;237;Solana de Rioalmar;151;92;59;2020
05;Ávila;238;Solosancho;820;438;382;2020
05;Ávila;239;Sotalbo;232;131;101;2020
05;Ávila;240;Sotillo de la Adrada;4653;2310;2343;2020
05;Ávila;241;Tiemblo, El;4180;2113;2067;2020
05;Ávila;242;Tiñosillos;775;398;377;2020
05;Ávila;243;Tolbaños;78;44;34;2020
05;Ávila;244;Tormellas;37;23;14;2020
05;Ávila;245;Tornadizos de Ávila;418;213;205;2020
05;Ávila;247;Torre, La;230;127;103;2020
05;Ávila;246;Tórtoles;46;26;20;2020
05;Ávila;249;Umbrías;96;50;46;2020
05;Ávila;251;Vadillo de la Sierra;54;36;18;2020
05;Ávila;252;Valdecasa;59;35;24;2020
05;Ávila;253;Vega de Santa María;77;39;38;2020
05;Ávila;254;Velayos;214;110;104;2020
05;Ávila;256;Villaflor;111;58;53;2020
05;Ávila;257;Villafranca de la Sierra;129;73;56;2020
05;Ávila;905;Villanueva de Ávila;217;112;105;2020
05;Ávila;258;Villanueva de Gómez;115;65;50;2020
05;Ávila;259;Villanueva del Aceral;109;54;55;2020
05;Ávila;260;Villanueva del Campillo;101;55;46;2020
05;Ávila;261;Villar de Corneja;35;21;14;2020
05;Ávila;262;Villarejo del Valle;328;173;155;2020
05;Ávila;263;Villatoro;157;93;64;2020
05;Ávila;264;Viñegra de Moraña;53;30;23;2020
05;Ávila;265;Vita;83;49;34;2020
05;Ávila;266;Zapardiel de la Cañada;91;49;42;2020
05;Ávila;267;Zapardiel de la Ribera;107;59;48;2020
06;Badajoz;001;Acedera;826;425;401;2020
06;Badajoz;002;Aceuchal;5478;2737;2741;2020
06;Badajoz;003;Ahillones;863;427;436;2020
06;Badajoz;004;Alange;1856;945;911;2020
06;Badajoz;005;Albuera, La;2035;1066;969;2020
06;Badajoz;006;Alburquerque;5293;2636;2657;2020
06;Badajoz;007;Alconchel;1659;832;827;2020
06;Badajoz;008;Alconera;743;364;379;2020
06;Badajoz;009;Aljucén;250;138;112;2020
06;Badajoz;010;Almendral;1239;618;621;2020
06;Badajoz;011;Almendralejo;33855;16784;17071;2020
06;Badajoz;012;Arroyo de San Serván;4080;2075;2005;2020
06;Badajoz;013;Atalaya;294;154;140;2020
06;Badajoz;014;Azuaga;7747;3827;3920;2020
06;Badajoz;015;Badajoz;150984;73170;77814;2020
06;Badajoz;016;Barcarrota;3483;1764;1719;2020
06;Badajoz;017;Baterno;266;144;122;2020
06;Badajoz;018;Benquerencia de la Serena;812;401;411;2020
06;Badajoz;019;Berlanga;2331;1145;1186;2020
06;Badajoz;020;Bienvenida;2081;1068;1013;2020
06;Badajoz;021;Bodonal de la Sierra;1036;538;498;2020
06;Badajoz;022;Burguillos del Cerro;3066;1504;1562;2020
06;Badajoz;023;Cabeza del Buey;4808;2379;2429;2020
06;Badajoz;024;Cabeza la Vaca;1298;666;632;2020
06;Badajoz;025;Calamonte;6170;3056;3114;2020
06;Badajoz;026;Calera de León;930;474;456;2020
06;Badajoz;027;Calzadilla de los Barros;736;367;369;2020
06;Badajoz;028;Campanario;4854;2377;2477;2020
06;Badajoz;029;Campillo de Llerena;1343;682;661;2020
06;Badajoz;030;Capilla;172;89;83;2020
06;Badajoz;031;Carmonita;524;266;258;2020
06;Badajoz;032;Carrascalejo, El;85;43;42;2020
06;Badajoz;033;Casas de Don Pedro;1447;747;700;2020
06;Badajoz;034;Casas de Reina;199;97;102;2020
06;Badajoz;035;Castilblanco;915;462;453;2020
06;Badajoz;036;Castuera;5784;2844;2940;2020
06;Badajoz;042;Cheles;1173;569;604;2020
06;Badajoz;037;Codosera, La;2061;1083;978;2020
06;Badajoz;038;Cordobilla de Lácara;897;467;430;2020
06;Badajoz;039;Coronada, La;2165;1056;1109;2020
06;Badajoz;040;Corte de Peleas;1191;580;611;2020
06;Badajoz;041;Cristina;551;282;269;2020
06;Badajoz;043;Don Álvaro;775;404;371;2020
06;Badajoz;044;Don Benito;37284;18408;18876;2020
06;Badajoz;045;Entrín Bajo;552;285;267;2020
06;Badajoz;046;Esparragalejo;1460;721;739;2020
06;Badajoz;047;Esparragosa de la Serena;998;504;494;2020
06;Badajoz;048;Esparragosa de Lares;906;449;457;2020
06;Badajoz;049;Feria;1115;536;579;2020
06;Badajoz;050;Fregenal de la Sierra;4836;2364;2472;2020
06;Badajoz;051;Fuenlabrada de los Montes;1811;891;920;2020
06;Badajoz;052;Fuente de Cantos;4687;2324;2363;2020
06;Badajoz;053;Fuente del Arco;681;350;331;2020
06;Badajoz;054;Fuente del Maestre;6714;3325;3389;2020
06;Badajoz;055;Fuentes de León;2248;1107;1141;2020
06;Badajoz;056;Garbayuela;509;268;241;2020
06;Badajoz;057;Garlitos;565;292;273;2020
06;Badajoz;058;Garrovilla, La;2357;1168;1189;2020
06;Badajoz;059;Granja de Torrehermosa;1977;984;993;2020
06;Badajoz;903;Guadiana del Caudillo;2492;1224;1268;2020
06;Badajoz;060;Guareña;6888;3457;3431;2020
06;Badajoz;061;Haba, La;1219;610;609;2020
06;Badajoz;062;Helechosa de los Montes;626;351;275;2020
06;Badajoz;063;Herrera del Duque;3489;1750;1739;2020
06;Badajoz;064;Higuera de la Serena;936;484;452;2020
06;Badajoz;065;Higuera de Llerena;337;173;164;2020
06;Badajoz;066;Higuera de Vargas;1925;975;950;2020
06;Badajoz;067;Higuera la Real;2219;1116;1103;2020
06;Badajoz;068;Hinojosa del Valle;475;227;248;2020
06;Badajoz;069;Hornachos;3537;1772;1765;2020
06;Badajoz;070;Jerez de los Caballeros;9196;4521;4675;2020
06;Badajoz;071;Lapa, La;279;141;138;2020
06;Badajoz;073;Llera;829;428;401;2020
06;Badajoz;074;Llerena;5743;2856;2887;2020
06;Badajoz;072;Lobón;2756;1406;1350;2020
06;Badajoz;075;Magacela;523;269;254;2020
06;Badajoz;076;Maguilla;957;473;484;2020
06;Badajoz;077;Malcocinado;356;194;162;2020
06;Badajoz;078;Malpartida de la Serena;543;285;258;2020
06;Badajoz;079;Manchita;764;382;382;2020
06;Badajoz;080;Medellín;2275;1147;1128;2020
06;Badajoz;081;Medina de las Torres;1176;614;562;2020
06;Badajoz;082;Mengabril;498;272;226;2020
06;Badajoz;083;Mérida;59548;29000;30548;2020
06;Badajoz;084;Mirandilla;1262;633;629;2020
06;Badajoz;085;Monesterio;4216;2150;2066;2020
06;Badajoz;086;Montemolín;1361;648;713;2020
06;Badajoz;087;Monterrubio de la Serena;2326;1148;1178;2020
06;Badajoz;088;Montijo;15504;7652;7852;2020
06;Badajoz;089;Morera, La;714;366;348;2020
06;Badajoz;090;Nava de Santiago, La;926;468;458;2020
06;Badajoz;091;Navalvillar de Pela;4403;2218;2185;2020
06;Badajoz;092;Nogales;658;331;327;2020
06;Badajoz;093;Oliva de la Frontera;5086;2550;2536;2020
06;Badajoz;094;Oliva de Mérida;1725;874;851;2020
06;Badajoz;095;Olivenza;11912;5942;5970;2020
06;Badajoz;096;Orellana de la Sierra;244;121;123;2020
06;Badajoz;097;Orellana la Vieja;2641;1363;1278;2020
06;Badajoz;098;Palomas;671;335;336;2020
06;Badajoz;099;Parra, La;1327;686;641;2020
06;Badajoz;100;Peñalsordo;896;437;459;2020
06;Badajoz;101;Peraleda del Zaucejo;507;255;252;2020
06;Badajoz;102;Puebla de Alcocer;1212;600;612;2020
06;Badajoz;103;Puebla de la Calzada;5834;2923;2911;2020
06;Badajoz;104;Puebla de la Reina;724;360;364;2020
06;Badajoz;107;Puebla de Obando;1839;936;903;2020
06;Badajoz;108;Puebla de Sancho Pérez;2676;1350;1326;2020
06;Badajoz;105;Puebla del Maestre;670;344;326;2020
06;Badajoz;106;Puebla del Prior;480;247;233;2020
06;Badajoz;902;Pueblonuevo del Guadiana;2008;1006;1002;2020
06;Badajoz;109;Quintana de la Serena;4574;2308;2266;2020
06;Badajoz;110;Reina;150;76;74;2020
06;Badajoz;111;Rena;610;310;300;2020
06;Badajoz;112;Retamal de Llerena;436;223;213;2020
06;Badajoz;113;Ribera del Fresno;3256;1622;1634;2020
06;Badajoz;114;Risco;132;65;67;2020
06;Badajoz;115;Roca de la Sierra, La;1455;711;744;2020
06;Badajoz;116;Salvaleón;1721;861;860;2020
06;Badajoz;117;Salvatierra de los Barros;1607;786;821;2020
06;Badajoz;119;San Pedro de Mérida;838;431;407;2020
06;Badajoz;123;San Vicente de Alcántara;5377;2714;2663;2020
06;Badajoz;118;Sancti-Spíritus;165;95;70;2020
06;Badajoz;120;Santa Amalia;3975;2006;1969;2020
06;Badajoz;121;Santa Marta;4124;2074;2050;2020
06;Badajoz;122;Santos de Maimona, Los;8075;4073;4002;2020
06;Badajoz;124;Segura de León;1851;925;926;2020
06;Badajoz;125;Siruela;1861;943;918;2020
06;Badajoz;126;Solana de los Barros;2601;1301;1300;2020
06;Badajoz;127;Talarrubias;3406;1697;1709;2020
06;Badajoz;128;Talavera la Real;5314;2649;2665;2020
06;Badajoz;129;Táliga;678;336;342;2020
06;Badajoz;130;Tamurejo;212;107;105;2020
06;Badajoz;131;Torre de Miguel Sesmero;1246;637;609;2020
06;Badajoz;132;Torremayor;949;459;490;2020
06;Badajoz;133;Torremejía;2257;1168;1089;2020
06;Badajoz;134;Trasierra;625;330;295;2020
06;Badajoz;135;Trujillanos;1376;704;672;2020
06;Badajoz;136;Usagre;1751;866;885;2020
06;Badajoz;137;Valdecaballeros;1065;552;513;2020
06;Badajoz;901;Valdelacalzada;2721;1384;1337;2020
06;Badajoz;138;Valdetorres;1179;573;606;2020
06;Badajoz;139;Valencia de las Torres;540;284;256;2020
06;Badajoz;140;Valencia del Mombuey;725;372;353;2020
06;Badajoz;141;Valencia del Ventoso;1960;976;984;2020
06;Badajoz;146;Valle de la Serena;1172;586;586;2020
06;Badajoz;147;Valle de Matamoros;363;178;185;2020
06;Badajoz;148;Valle de Santa Ana;1143;563;580;2020
06;Badajoz;142;Valverde de Burguillos;273;145;128;2020
06;Badajoz;143;Valverde de Leganés;4167;2088;2079;2020
06;Badajoz;144;Valverde de Llerena;570;284;286;2020
06;Badajoz;145;Valverde de Mérida;1047;534;513;2020
06;Badajoz;149;Villafranca de los Barros;12673;6230;6443;2020
06;Badajoz;150;Villagarcía de la Torre;906;464;442;2020
06;Badajoz;151;Villagonzalo;1234;599;635;2020
06;Badajoz;152;Villalba de los Barros;1475;743;732;2020
06;Badajoz;153;Villanueva de la Serena;25752;12530;13222;2020
06;Badajoz;154;Villanueva del Fresno;3364;1678;1686;2020
06;Badajoz;156;Villar de Rena;1353;695;658;2020
06;Badajoz;155;Villar del Rey;2106;1126;980;2020
06;Badajoz;157;Villarta de los Montes;423;214;209;2020
06;Badajoz;158;Zafra;16810;8095;8715;2020
06;Badajoz;159;Zahínos;2774;1377;1397;2020
06;Badajoz;160;Zalamea de la Serena;3545;1787;1758;2020
06;Badajoz;162;Zarza, La;3402;1716;1686;2020
06;Badajoz;161;Zarza-Capilla;310;156;154;2020
07;Balears, Illes;002;Alaior;9467;4798;4669;2020
07;Balears, Illes;001;Alaró;5617;2717;2900;2020
07;Balears, Illes;003;Alcúdia;20819;10552;10267;2020
07;Balears, Illes;004;Algaida;5793;2941;2852;2020
07;Balears, Illes;005;Andratx;11433;5716;5717;2020
07;Balears, Illes;901;Ariany;902;469;433;2020
07;Balears, Illes;006;Artà;7984;4010;3974;2020
07;Balears, Illes;007;Banyalbufar;523;279;244;2020
07;Balears, Illes;008;Binissalem;8756;4380;4376;2020
07;Balears, Illes;009;Búger;1087;567;520;2020
07;Balears, Illes;010;Bunyola;6895;3364;3531;2020
07;Balears, Illes;011;Calvià;51710;26010;25700;2020
07;Balears, Illes;012;Campanet;2648;1343;1305;2020
07;Balears, Illes;013;Campos;11283;5631;5652;2020
07;Balears, Illes;014;Capdepera;12158;6189;5969;2020
07;Balears, Illes;064;Castell, Es;7572;3818;3754;2020
07;Balears, Illes;015;Ciutadella de Menorca;30588;15242;15346;2020
07;Balears, Illes;016;Consell;4125;2067;2058;2020
07;Balears, Illes;017;Costitx;1329;659;670;2020
07;Balears, Illes;018;Deià;630;309;321;2020
07;Balears, Illes;026;Eivissa;51128;25766;25362;2020
07;Balears, Illes;019;Escorca;208;128;80;2020
07;Balears, Illes;020;Esporles;5113;2526;2587;2020
07;Balears, Illes;021;Estellencs;327;175;152;2020
07;Balears, Illes;022;Felanitx;18202;9191;9011;2020
07;Balears, Illes;023;Ferreries;4908;2460;2448;2020
07;Balears, Illes;024;Formentera;11904;6228;5676;2020
07;Balears, Illes;025;Fornalutx;679;343;336;2020
07;Balears, Illes;027;Inca;33679;16913;16766;2020
07;Balears, Illes;028;Lloret de Vistalegre;1437;734;703;2020
07;Balears, Illes;029;Lloseta;6122;3076;3046;2020
07;Balears, Illes;030;Llubí;2298;1143;1155;2020
07;Balears, Illes;031;Llucmajor;37752;19173;18579;2020
07;Balears, Illes;033;Manacor;44527;22314;22213;2020
07;Balears, Illes;034;Mancor de la Vall;1528;772;756;2020
07;Balears, Illes;032;Maó-Mahón;29592;14436;15156;2020
07;Balears, Illes;035;Maria de la Salut;2245;1162;1083;2020
07;Balears, Illes;036;Marratxí;37724;18993;18731;2020
07;Balears, Illes;037;Mercadal, Es;5316;2707;2609;2020
07;Balears, Illes;902;Migjorn Gran, Es;1463;726;737;2020
07;Balears, Illes;038;Montuïri;2987;1508;1479;2020
07;Balears, Illes;039;Muro;7394;3763;3631;2020
07;Balears, Illes;040;Palma ;422587;206654;215933;2020
07;Balears, Illes;041;Petra;2942;1459;1483;2020
07;Balears, Illes;044;Pobla, Sa;13764;6970;6794;2020
07;Balears, Illes;042;Pollença;16658;8283;8375;2020
07;Balears, Illes;043;Porreres;5576;2852;2724;2020
07;Balears, Illes;045;Puigpunyent;2044;1008;1036;2020
07;Balears, Illes;059;Salines, Ses;5096;2594;2502;2020
07;Balears, Illes;046;Sant Antoni de Portmany;27033;14205;12828;2020
07;Balears, Illes;049;Sant Joan;2145;1059;1086;2020
07;Balears, Illes;050;Sant Joan de Labritja;6576;3374;3202;2020
07;Balears, Illes;048;Sant Josep de sa Talaia;27732;14338;13394;2020
07;Balears, Illes;051;Sant Llorenç des Cardassar;8742;4342;4400;2020
07;Balears, Illes;052;Sant Lluís;6735;3424;3311;2020
07;Balears, Illes;053;Santa Eugènia;1641;814;827;2020
07;Balears, Illes;054;Santa Eulària des Riu;39358;19894;19464;2020
07;Balears, Illes;055;Santa Margalida;12797;6595;6202;2020
07;Balears, Illes;056;Santa María del Camí;7486;3742;3744;2020
07;Balears, Illes;057;Santanyí;12373;6236;6137;2020
07;Balears, Illes;058;Selva;4080;1994;2086;2020
07;Balears, Illes;047;Sencelles;3370;1692;1678;2020
07;Balears, Illes;060;Sineu;4030;2002;2028;2020
07;Balears, Illes;061;Sóller;13634;6803;6831;2020
07;Balears, Illes;062;Son Servera;11817;5879;5938;2020
07;Balears, Illes;063;Valldemossa;2009;1016;993;2020
07;Balears, Illes;065;Vilafranca de Bonany;3466;1771;1695;2020
08;Barcelona;001;Abrera;12538;6325;6213;2020
08;Barcelona;002;Aguilar de Segarra;282;148;134;2020
08;Barcelona;014;Aiguafreda;2512;1221;1291;2020
08;Barcelona;003;Alella;9904;4838;5066;2020
08;Barcelona;004;Alpens;261;137;124;2020
08;Barcelona;005;Ametlla del Vallès, L';8646;4358;4288;2020
08;Barcelona;006;Arenys de Mar;15941;7761;8180;2020
08;Barcelona;007;Arenys de Munt;9121;4591;4530;2020
08;Barcelona;008;Argençola;219;113;106;2020
08;Barcelona;009;Argentona;12536;6197;6339;2020
08;Barcelona;010;Artés;5762;2911;2851;2020
08;Barcelona;011;Avià;2220;1113;1107;2020
08;Barcelona;012;Avinyó;2289;1137;1152;2020
08;Barcelona;013;Avinyonet del Penedès;1697;899;798;2020
08;Barcelona;015;Badalona;223166;110018;113148;2020
08;Barcelona;904;Badia del Vallès;13415;6568;6847;2020
08;Barcelona;016;Bagà;2140;1061;1079;2020
08;Barcelona;017;Balenyà;3840;1921;1919;2020
08;Barcelona;018;Balsareny;3192;1576;1616;2020
08;Barcelona;252;Barberà del Vallès;33334;16395;16939;2020
08;Barcelona;019;Barcelona;1664182;790708;873474;2020
08;Barcelona;020;Begues;7300;3650;3650;2020
08;Barcelona;021;Bellprat;64;41;23;2020
08;Barcelona;022;Berga;16760;8315;8445;2020
08;Barcelona;023;Bigues i Riells;9358;4779;4579;2020
08;Barcelona;024;Borredà;464;257;207;2020
08;Barcelona;025;Bruc, El;2110;1128;982;2020
08;Barcelona;026;Brull, El;258;142;116;2020
08;Barcelona;027;Cabanyes, Les;979;499;480;2020
08;Barcelona;028;Cabrera d'Anoia;1482;795;687;2020
08;Barcelona;029;Cabrera de Mar;4747;2381;2366;2020
08;Barcelona;030;Cabrils;7432;3667;3765;2020
08;Barcelona;031;Calaf;3656;1843;1813;2020
08;Barcelona;034;Calders;1045;530;515;2020
08;Barcelona;033;Caldes de Montbui;17812;8873;8939;2020
08;Barcelona;032;Caldes d'Estrac;3021;1442;1579;2020
08;Barcelona;035;Calella;19277;9399;9878;2020
08;Barcelona;037;Calldetenes;2513;1281;1232;2020
08;Barcelona;038;Callús;2129;1053;1076;2020
08;Barcelona;036;Calonge de Segarra;188;92;96;2020
08;Barcelona;039;Campins;541;283;258;2020
08;Barcelona;040;Canet de Mar;14865;7294;7571;2020
08;Barcelona;041;Canovelles;16829;8693;8136;2020
08;Barcelona;042;Cànoves i Samalús;3156;1611;1545;2020
08;Barcelona;043;Canyelles;4699;2430;2269;2020
08;Barcelona;044;Capellades;5342;2665;2677;2020
08;Barcelona;045;Capolat;84;39;45;2020
08;Barcelona;046;Cardedeu;18424;8975;9449;2020
08;Barcelona;047;Cardona;4639;2266;2373;2020
08;Barcelona;048;Carme;785;411;374;2020
08;Barcelona;049;Casserres;1588;803;785;2020
08;Barcelona;057;Castell de l'Areny;67;37;30;2020
08;Barcelona;052;Castellar de n'Hug;156;84;72;2020
08;Barcelona;050;Castellar del Riu;176;99;77;2020
08;Barcelona;051;Castellar del Vallès;24488;12089;12399;2020
08;Barcelona;053;Castellbell i el Vilar;3719;1901;1818;2020
08;Barcelona;054;Castellbisbal;12539;6307;6232;2020
08;Barcelona;055;Castellcir;742;397;345;2020
08;Barcelona;056;Castelldefels;67460;33162;34298;2020
08;Barcelona;058;Castellet i la Gornal;2382;1239;1143;2020
08;Barcelona;060;Castellfollit de Riubregós;162;91;71;2020
08;Barcelona;059;Castellfollit del Boix;447;228;219;2020
08;Barcelona;061;Castellgalí;2119;1102;1017;2020
08;Barcelona;062;Castellnou de Bages;1437;770;667;2020
08;Barcelona;063;Castellolí;626;302;324;2020
08;Barcelona;064;Castellterçol;2548;1275;1273;2020
08;Barcelona;065;Castellví de la Marca;1575;795;780;2020
08;Barcelona;066;Castellví de Rosanes;1933;949;984;2020
08;Barcelona;067;Centelles;7513;3696;3817;2020
08;Barcelona;268;Cercs;1150;568;582;2020
08;Barcelona;266;Cerdanyola del Vallès;57855;28284;29571;2020
08;Barcelona;068;Cervelló;9077;4571;4506;2020
08;Barcelona;069;Collbató;4544;2359;2185;2020
08;Barcelona;070;Collsuspina;359;183;176;2020
08;Barcelona;071;Copons;321;157;164;2020
08;Barcelona;072;Corbera de Llobregat;14882;7454;7428;2020
08;Barcelona;073;Cornellà de Llobregat;89936;43622;46314;2020
08;Barcelona;074;Cubelles;15770;7944;7826;2020
08;Barcelona;075;Dosrius;5652;2881;2771;2020
08;Barcelona;076;Esparreguera;22302;11273;11029;2020
08;Barcelona;077;Esplugues de Llobregat;47150;22461;24689;2020
08;Barcelona;078;Espunyola, L';242;120;122;2020
08;Barcelona;254;Esquirol, L';2186;1098;1088;2020
08;Barcelona;079;Estany, L';408;215;193;2020
08;Barcelona;134;Figaró-Montmany;1142;559;583;2020
08;Barcelona;080;Fígols;43;26;17;2020
08;Barcelona;082;Fogars de la Selva;1469;757;712;2020
08;Barcelona;081;Fogars de Montclús;475;249;226;2020
08;Barcelona;083;Folgueroles;2265;1150;1115;2020
08;Barcelona;084;Fonollosa;1459;752;707;2020
08;Barcelona;085;Font-rubí;1414;744;670;2020
08;Barcelona;086;Franqueses del Vallès, Les;20364;10331;10033;2020
08;Barcelona;090;Gaià;183;98;85;2020
08;Barcelona;087;Gallifa;167;89;78;2020
08;Barcelona;088;Garriga, La;16668;8056;8612;2020
08;Barcelona;089;Gavà;47057;23022;24035;2020
08;Barcelona;091;Gelida;7670;3842;3828;2020
08;Barcelona;092;Gironella;4946;2461;2485;2020
08;Barcelona;093;Gisclareny;26;16;10;2020
08;Barcelona;094;Granada, La;2208;1097;1111;2020
08;Barcelona;095;Granera;77;52;25;2020
08;Barcelona;096;Granollers;62419;30891;31528;2020
08;Barcelona;097;Gualba;1548;794;754;2020
08;Barcelona;099;Guardiola de Berguedà;941;492;449;2020
08;Barcelona;100;Gurb;2713;1399;1314;2020
08;Barcelona;101;Hospitalet de Llobregat, L';269382;130289;139093;2020
08;Barcelona;162;Hostalets de Pierola, Els;2980;1518;1462;2020
08;Barcelona;102;Igualada;40742;20073;20669;2020
08;Barcelona;103;Jorba;833;429;404;2020
08;Barcelona;104;Llacuna, La;903;493;410;2020
08;Barcelona;105;Llagosta, La;13587;6691;6896;2020
08;Barcelona;107;Lliçà d'Amunt;15469;7906;7563;2020
08;Barcelona;108;Lliçà de Vall;6497;3319;3178;2020
08;Barcelona;106;Llinars del Vallès;10018;4991;5027;2020
08;Barcelona;109;Lluçà;276;135;141;2020
08;Barcelona;110;Malgrat de Mar;18772;9329;9443;2020
08;Barcelona;111;Malla;272;138;134;2020
08;Barcelona;112;Manlleu;20912;10512;10400;2020
08;Barcelona;113;Manresa;78245;38335;39910;2020
08;Barcelona;242;Marganell;266;127;139;2020
08;Barcelona;114;Martorell;28772;14655;14117;2020
08;Barcelona;115;Martorelles;4820;2435;2385;2020
08;Barcelona;116;Masies de Roda, Les;719;368;351;2020
08;Barcelona;117;Masies de Voltregà, Les;3132;1549;1583;2020
08;Barcelona;118;Masnou, El;23831;11524;12307;2020
08;Barcelona;119;Masquefa;9402;4758;4644;2020
08;Barcelona;120;Matadepera;9496;4756;4740;2020
08;Barcelona;121;Mataró;129661;64476;65185;2020
08;Barcelona;122;Mediona;2369;1192;1177;2020
08;Barcelona;138;Moià;6383;3281;3102;2020
08;Barcelona;123;Molins de Rei;25940;12639;13301;2020
08;Barcelona;124;Mollet del Vallès;51600;25410;26190;2020
08;Barcelona;128;Monistrol de Calders;702;366;336;2020
08;Barcelona;127;Monistrol de Montserrat;3139;1603;1536;2020
08;Barcelona;125;Montcada i Reixac;36803;18148;18655;2020
08;Barcelona;130;Montclar;139;72;67;2020
08;Barcelona;131;Montesquiu;1030;513;517;2020
08;Barcelona;126;Montgat;12200;6029;6171;2020
08;Barcelona;132;Montmajor;469;232;237;2020
08;Barcelona;133;Montmaneu;151;81;70;2020
08;Barcelona;135;Montmeló;8831;4320;4511;2020
08;Barcelona;136;Montornès del Vallès;16644;8390;8254;2020
08;Barcelona;137;Montseny;351;187;164;2020
08;Barcelona;129;Muntanyola;632;328;304;2020
08;Barcelona;139;Mura;220;117;103;2020
08;Barcelona;140;Navarcles;6057;2958;3099;2020
08;Barcelona;141;Navàs;6018;2987;3031;2020
08;Barcelona;142;Nou de Berguedà, La;162;84;78;2020
08;Barcelona;143;Òdena;3668;1881;1787;2020
08;Barcelona;145;Olèrdola;3768;1955;1813;2020
08;Barcelona;146;Olesa de Bonesvalls;1840;968;872;2020
08;Barcelona;147;Olesa de Montserrat;24144;12058;12086;2020
08;Barcelona;148;Olivella;3935;2054;1881;2020
08;Barcelona;149;Olost;1202;586;616;2020
08;Barcelona;144;Olvan;858;419;439;2020
08;Barcelona;150;Orís;322;164;158;2020
08;Barcelona;151;Oristà;549;282;267;2020
08;Barcelona;152;Orpí;151;79;72;2020
08;Barcelona;153;Òrrius;758;387;371;2020
08;Barcelona;154;Pacs del Penedès;918;463;455;2020
08;Barcelona;155;Palafolls;9613;4814;4799;2020
08;Barcelona;156;Palau-solità i Plegamans;14892;7289;7603;2020
08;Barcelona;157;Pallejà;11622;5794;5828;2020
08;Barcelona;905;Palma de Cervelló, La;2992;1475;1517;2020
08;Barcelona;158;Papiol, El;4172;2063;2109;2020
08;Barcelona;159;Parets del Vallès;19071;9518;9553;2020
08;Barcelona;160;Perafita;405;208;197;2020
08;Barcelona;161;Piera;16134;8253;7881;2020
08;Barcelona;163;Pineda de Mar;27984;13940;14044;2020
08;Barcelona;164;Pla del Penedès, El;1275;638;637;2020
08;Barcelona;165;Pobla de Claramunt, La;2185;1110;1075;2020
08;Barcelona;166;Pobla de Lillet, La;1093;531;562;2020
08;Barcelona;167;Polinyà;8504;4320;4184;2020
08;Barcelona;182;Pont de Vilomara i Rocafort, El;3907;2007;1900;2020
08;Barcelona;168;Pontons;528;283;245;2020
08;Barcelona;169;Prat de Llobregat, El;65385;31951;33434;2020
08;Barcelona;171;Prats de Lluçanès;2604;1305;1299;2020
08;Barcelona;170;Prats de Rei, Els;537;286;251;2020
08;Barcelona;230;Premià de Dalt;10441;5201;5240;2020
08;Barcelona;172;Premià de Mar;28531;13913;14618;2020
08;Barcelona;174;Puigdàlber;524;249;275;2020
08;Barcelona;175;Puig-reig;4295;2135;2160;2020
08;Barcelona;176;Pujalt;210;118;92;2020
08;Barcelona;177;Quar, La;49;26;23;2020
08;Barcelona;178;Rajadell;534;273;261;2020
08;Barcelona;179;Rellinars;809;417;392;2020
08;Barcelona;180;Ripollet;39179;19396;19783;2020
08;Barcelona;181;Roca del Vallès, La;10754;5356;5398;2020
08;Barcelona;183;Roda de Ter;6490;3235;3255;2020
08;Barcelona;184;Rubí;78591;38889;39702;2020
08;Barcelona;185;Rubió;239;134;105;2020
08;Barcelona;901;Rupit i Pruit;271;132;139;2020
08;Barcelona;187;Sabadell;216520;105388;111132;2020
08;Barcelona;188;Sagàs;145;77;68;2020
08;Barcelona;190;Saldes;278;159;119;2020
08;Barcelona;191;Sallent;6735;3260;3475;2020
08;Barcelona;194;Sant Adrià de Besòs;37447;18369;19078;2020
08;Barcelona;195;Sant Agustí de Lluçanès;89;44;45;2020
08;Barcelona;196;Sant Andreu de la Barca;27569;13644;13925;2020
08;Barcelona;197;Sant Andreu de Llavaneres;11133;5513;5620;2020
08;Barcelona;198;Sant Antoni de Vilamajor;6208;3066;3142;2020
08;Barcelona;199;Sant Bartomeu del Grau;884;475;409;2020
08;Barcelona;200;Sant Boi de Llobregat;84500;41235;43265;2020
08;Barcelona;201;Sant Boi de Lluçanès;580;293;287;2020
08;Barcelona;203;Sant Cebrià de Vallalta;3438;1791;1647;2020
08;Barcelona;202;Sant Celoni;18136;9032;9104;2020
08;Barcelona;204;Sant Climent de Llobregat;4160;2097;2063;2020
08;Barcelona;205;Sant Cugat del Vallès;92977;45216;47761;2020
08;Barcelona;206;Sant Cugat Sesgarrigues;1009;491;518;2020
08;Barcelona;207;Sant Esteve de Palautordera;2864;1412;1452;2020
08;Barcelona;208;Sant Esteve Sesrovires;7696;3862;3834;2020
08;Barcelona;210;Sant Feliu de Codines;6363;3232;3131;2020
08;Barcelona;211;Sant Feliu de Llobregat;45467;22104;23363;2020
08;Barcelona;212;Sant Feliu Sasserra;605;319;286;2020
08;Barcelona;209;Sant Fost de Campsentelles;8853;4408;4445;2020
08;Barcelona;213;Sant Fruitós de Bages;8837;4348;4489;2020
08;Barcelona;215;Sant Hipòlit de Voltregà;3540;1765;1775;2020
08;Barcelona;193;Sant Iscle de Vallalta;1342;712;630;2020
08;Barcelona;216;Sant Jaume de Frontanyà;30;18;12;2020
08;Barcelona;218;Sant Joan de Vilatorrada;10998;5521;5477;2020
08;Barcelona;217;Sant Joan Despí;34267;16692;17575;2020
08;Barcelona;903;Sant Julià de Cerdanyola;229;127;102;2020
08;Barcelona;220;Sant Julià de Vilatorta;3140;1559;1581;2020
08;Barcelona;221;Sant Just Desvern;18670;8951;9719;2020
08;Barcelona;222;Sant Llorenç d'Hortons;2428;1234;1194;2020
08;Barcelona;223;Sant Llorenç Savall;2417;1216;1201;2020
08;Barcelona;225;Sant Martí d'Albars;114;57;57;2020
08;Barcelona;224;Sant Martí de Centelles;1184;609;575;2020
08;Barcelona;226;Sant Martí de Tous;1228;634;594;2020
08;Barcelona;227;Sant Martí Sarroca;3261;1605;1656;2020
08;Barcelona;228;Sant Martí Sesgueioles;342;178;164;2020
08;Barcelona;229;Sant Mateu de Bages;608;313;295;2020
08;Barcelona;231;Sant Pere de Ribes;31111;15456;15655;2020
08;Barcelona;232;Sant Pere de Riudebitlles;2380;1191;1189;2020
08;Barcelona;233;Sant Pere de Torelló;2470;1276;1194;2020
08;Barcelona;234;Sant Pere de Vilamajor;4544;2279;2265;2020
08;Barcelona;189;Sant Pere Sallavinera;151;83;68;2020
08;Barcelona;235;Sant Pol de Mar;5428;2690;2738;2020
08;Barcelona;236;Sant Quintí de Mediona;2317;1192;1125;2020
08;Barcelona;237;Sant Quirze de Besora;2154;1041;1113;2020
08;Barcelona;238;Sant Quirze del Vallès;20195;9901;10294;2020
08;Barcelona;239;Sant Quirze Safaja;631;346;285;2020
08;Barcelona;240;Sant Sadurní d'Anoia;12841;6328;6513;2020
08;Barcelona;241;Sant Sadurní d'Osormort;76;46;30;2020
08;Barcelona;098;Sant Salvador de Guardiola;3221;1659;1562;2020
08;Barcelona;262;Sant Vicenç de Castellet;9767;4892;4875;2020
08;Barcelona;264;Sant Vicenç de Montalt;6452;3245;3207;2020
08;Barcelona;265;Sant Vicenç de Torelló;2058;1023;1035;2020
08;Barcelona;263;Sant Vicenç dels Horts;28268;14044;14224;2020
08;Barcelona;243;Santa Cecília de Voltregà;182;100;82;2020
08;Barcelona;244;Santa Coloma de Cervelló;8268;4037;4231;2020
08;Barcelona;245;Santa Coloma de Gramenet;120443;59527;60916;2020
08;Barcelona;246;Santa Eugènia de Berga;2278;1161;1117;2020
08;Barcelona;247;Santa Eulàlia de Riuprimer;1383;700;683;2020
08;Barcelona;248;Santa Eulàlia de Ronçana;7426;3729;3697;2020
08;Barcelona;249;Santa Fe del Penedès;367;180;187;2020
08;Barcelona;250;Santa Margarida de Montbui;10225;5148;5077;2020
08;Barcelona;251;Santa Margarida i els Monjos;7676;3919;3757;2020
08;Barcelona;253;Santa Maria de Besora;161;84;77;2020
08;Barcelona;256;Santa Maria de Martorelles;890;446;444;2020
08;Barcelona;255;Santa Maria de Merlès;184;89;95;2020
08;Barcelona;257;Santa Maria de Miralles;119;64;55;2020
08;Barcelona;259;Santa Maria de Palautordera;9630;4870;4760;2020
08;Barcelona;258;Santa Maria d'Oló;1024;518;506;2020
08;Barcelona;260;Santa Perpètua de Mogoda;25999;13083;12916;2020
08;Barcelona;261;Santa Susanna;3548;1775;1773;2020
08;Barcelona;192;Santpedor;7604;3789;3815;2020
08;Barcelona;267;Sentmenat;9235;4681;4554;2020
08;Barcelona;269;Seva;3544;1806;1738;2020
08;Barcelona;270;Sitges;29553;14811;14742;2020
08;Barcelona;271;Sobremunt;78;34;44;2020
08;Barcelona;272;Sora;212;121;91;2020
08;Barcelona;273;Subirats;3104;1619;1485;2020
08;Barcelona;274;Súria;5948;2894;3054;2020
08;Barcelona;276;Tagamanent;318;161;157;2020
08;Barcelona;277;Talamanca;209;118;91;2020
08;Barcelona;278;Taradell;6640;3326;3314;2020
08;Barcelona;275;Tavèrnoles;322;166;156;2020
08;Barcelona;280;Tavertet;105;52;53;2020
08;Barcelona;281;Teià;6427;3153;3274;2020
08;Barcelona;279;Terrassa;223627;109948;113679;2020
08;Barcelona;282;Tiana;8945;4305;4640;2020
08;Barcelona;283;Tona;8356;4156;4200;2020
08;Barcelona;284;Tordera;17519;8870;8649;2020
08;Barcelona;285;Torelló;14400;7171;7229;2020
08;Barcelona;286;Torre de Claramunt, La;3741;1935;1806;2020
08;Barcelona;287;Torrelavit;1422;721;701;2020
08;Barcelona;288;Torrelles de Foix;2398;1281;1117;2020
08;Barcelona;289;Torrelles de Llobregat;6073;3021;3052;2020
08;Barcelona;290;Ullastrell;2089;1053;1036;2020
08;Barcelona;291;Vacarisses;6832;3500;3332;2020
08;Barcelona;292;Vallbona d'Anoia;1357;703;654;2020
08;Barcelona;293;Vallcebre;249;140;109;2020
08;Barcelona;294;Vallgorguina;2988;1513;1475;2020
08;Barcelona;295;Vallirana;15312;7691;7621;2020
08;Barcelona;296;Vallromanes;2558;1322;1236;2020
08;Barcelona;297;Veciana;175;95;80;2020
08;Barcelona;298;Vic;47630;24098;23532;2020
08;Barcelona;299;Vilada;419;221;198;2020
08;Barcelona;301;Viladecans;67197;33231;33966;2020
08;Barcelona;300;Viladecavalls;7545;3760;3785;2020
08;Barcelona;305;Vilafranca del Penedès;40154;19516;20638;2020
08;Barcelona;306;Vilalba Sasserra;753;384;369;2020
08;Barcelona;303;Vilanova de Sau;312;148;164;2020
08;Barcelona;302;Vilanova del Camí;12596;6292;6304;2020
08;Barcelona;902;Vilanova del Vallès;5503;2781;2722;2020
08;Barcelona;307;Vilanova i la Geltrú;67733;32752;34981;2020
08;Barcelona;214;Vilassar de Dalt;9072;4464;4608;2020
08;Barcelona;219;Vilassar de Mar;21035;10186;10849;2020
08;Barcelona;304;Vilobí del Penedès;1102;570;532;2020
08;Barcelona;308;Viver i Serrateix;172;88;84;2020
48;Bizkaia;001;Abadiño;7658;3862;3796;2020
48;Bizkaia;002;Abanto y Ciérvana-Abanto Zierbena;9471;4692;4779;2020
48;Bizkaia;911;Ajangiz;464;242;222;2020
48;Bizkaia;912;Alonsotegi;2879;1421;1458;2020
48;Bizkaia;003;Amorebieta-Etxano;19529;9626;9903;2020
48;Bizkaia;004;Amoroto;416;210;206;2020
48;Bizkaia;005;Arakaldo;165;81;84;2020
48;Bizkaia;006;Arantzazu;408;199;209;2020
48;Bizkaia;093;Areatza;1216;586;630;2020
48;Bizkaia;009;Arrankudiaga;965;471;494;2020
48;Bizkaia;914;Arratzu;413;198;215;2020
48;Bizkaia;010;Arrieta;580;293;287;2020
48;Bizkaia;011;Arrigorriaga;12225;5953;6272;2020
48;Bizkaia;023;Artea;733;371;362;2020
48;Bizkaia;008;Artzentales;699;367;332;2020
48;Bizkaia;091;Atxondo;1335;678;657;2020
48;Bizkaia;070;Aulesti;657;323;334;2020
48;Bizkaia;012;Bakio;2676;1356;1320;2020
48;Bizkaia;090;Balmaseda;7722;3725;3997;2020
48;Bizkaia;013;Barakaldo;101486;48963;52523;2020
48;Bizkaia;014;Barrika;1533;766;767;2020
48;Bizkaia;015;Basauri;40847;19745;21102;2020
48;Bizkaia;092;Bedia;1061;505;556;2020
48;Bizkaia;016;Berango;7217;3523;3694;2020
48;Bizkaia;017;Bermeo;16864;8293;8571;2020
48;Bizkaia;018;Berriatua;1251;685;566;2020
48;Bizkaia;019;Berriz;4580;2287;2293;2020
48;Bizkaia;020;Bilbao;350184;165493;184691;2020
48;Bizkaia;021;Busturia;1632;818;814;2020
48;Bizkaia;901;Derio;6730;3294;3436;2020
48;Bizkaia;026;Dima;1448;746;702;2020
48;Bizkaia;027;Durango;30118;14703;15415;2020
48;Bizkaia;028;Ea;808;426;382;2020
48;Bizkaia;031;Elantxobe;347;177;170;2020
48;Bizkaia;032;Elorrio;7375;3622;3753;2020
48;Bizkaia;902;Erandio;24530;11884;12646;2020
48;Bizkaia;033;Ereño;260;148;112;2020
48;Bizkaia;034;Ermua;15847;7883;7964;2020
48;Bizkaia;079;Errigoiti;486;262;224;2020
48;Bizkaia;029;Etxebarri;11691;5840;5851;2020
48;Bizkaia;030;Etxebarria;782;395;387;2020
48;Bizkaia;906;Forua;907;446;461;2020
48;Bizkaia;035;Fruiz;552;277;275;2020
48;Bizkaia;036;Galdakao;29427;14536;14891;2020
48;Bizkaia;037;Galdames;838;449;389;2020
48;Bizkaia;038;Gamiz-Fika;1362;678;684;2020
48;Bizkaia;039;Garai;325;160;165;2020
48;Bizkaia;040;Gatika;1665;832;833;2020
48;Bizkaia;041;Gautegiz Arteaga;808;410;398;2020
48;Bizkaia;046;Gernika-Lumo;17105;8227;8878;2020
48;Bizkaia;044;Getxo;77770;36387;41383;2020
48;Bizkaia;047;Gizaburuaga;197;100;97;2020
48;Bizkaia;042;Gordexola;1697;865;832;2020
48;Bizkaia;043;Gorliz;5891;2908;2983;2020
48;Bizkaia;045;Güeñes;6736;3262;3474;2020
48;Bizkaia;048;Ibarrangelu;629;318;311;2020
48;Bizkaia;094;Igorre;4337;2133;2204;2020
48;Bizkaia;049;Ispaster;729;385;344;2020
48;Bizkaia;910;Iurreta;3665;1802;1863;2020
48;Bizkaia;050;Izurtza;252;159;93;2020
48;Bizkaia;022;Karrantza Harana/Valle de Carranza;2803;1472;1331;2020
48;Bizkaia;907;Kortezubi;442;214;228;2020
48;Bizkaia;051;Lanestosa;253;136;117;2020
48;Bizkaia;052;Larrabetzu;2037;986;1051;2020
48;Bizkaia;053;Laukiz;1227;600;627;2020
48;Bizkaia;054;Leioa;32013;15604;16409;2020
48;Bizkaia;057;Lekeitio;7317;3622;3695;2020
48;Bizkaia;055;Lemoa;3504;1744;1760;2020
48;Bizkaia;056;Lemoiz;1258;662;596;2020
48;Bizkaia;081;Lezama;2445;1220;1225;2020
48;Bizkaia;903;Loiu;2394;1220;1174;2020
48;Bizkaia;058;Mallabia;1173;600;573;2020
48;Bizkaia;059;Mañaria;522;260;262;2020
48;Bizkaia;060;Markina-Xemein;5068;2560;2508;2020
48;Bizkaia;061;Maruri-Jatabe;978;503;475;2020
48;Bizkaia;062;Mendata;380;197;183;2020
48;Bizkaia;063;Mendexa;425;213;212;2020
48;Bizkaia;064;Meñaka;754;396;358;2020
48;Bizkaia;066;Morga;405;217;188;2020
48;Bizkaia;068;Mundaka;1845;888;957;2020
48;Bizkaia;069;Mungia;17665;8603;9062;2020
48;Bizkaia;007;Munitibar-Arbatzegi Gerrikaitz;473;263;210;2020
48;Bizkaia;908;Murueta;319;165;154;2020
48;Bizkaia;071;Muskiz;7536;3671;3865;2020
48;Bizkaia;067;Muxika;1468;768;700;2020
48;Bizkaia;909;Nabarniz;246;122;124;2020
48;Bizkaia;073;Ondarroa;8395;4193;4202;2020
48;Bizkaia;075;Orozko;2650;1303;1347;2020
48;Bizkaia;083;Ortuella;8385;4090;4295;2020
48;Bizkaia;072;Otxandio;1330;682;648;2020
48;Bizkaia;077;Plentzia;4353;2125;2228;2020
48;Bizkaia;078;Portugalete;45746;21882;23864;2020
48;Bizkaia;082;Santurtzi;46069;22148;23921;2020
48;Bizkaia;084;Sestao;27452;13270;14182;2020
48;Bizkaia;904;Sondika;4547;2199;2348;2020
48;Bizkaia;085;Sopela;14120;6978;7142;2020
48;Bizkaia;086;Sopuerta;2570;1281;1289;2020
48;Bizkaia;076;Sukarrieta;331;169;162;2020
48;Bizkaia;087;Trucios-Turtzioz;509;266;243;2020
48;Bizkaia;088;Ubide;164;87;77;2020
48;Bizkaia;065;Ugao-Miraballes;4148;2089;2059;2020
48;Bizkaia;089;Urduliz;4712;2347;2365;2020
48;Bizkaia;074;Urduña/Orduña;4192;2164;2028;2020
48;Bizkaia;080;Valle de Trápaga-Trapagaran;11975;5814;6161;2020
48;Bizkaia;095;Zaldibar;3045;1533;1512;2020
48;Bizkaia;096;Zalla;8450;4180;4270;2020
48;Bizkaia;905;Zamudio;3275;1620;1655;2020
48;Bizkaia;097;Zaratamo;1631;804;827;2020
48;Bizkaia;024;Zeanuri;1245;636;609;2020
48;Bizkaia;025;Zeberio;1095;568;527;2020
48;Bizkaia;913;Zierbena;1520;803;717;2020
48;Bizkaia;915;Ziortza-Bolibar;404;215;189;2020
09;Burgos;001;Abajas;31;20;11;2020
09;Burgos;003;Adrada de Haza;203;99;104;2020
09;Burgos;006;Aguas Cándidas;56;34;22;2020
09;Burgos;007;Aguilar de Bureba;57;38;19;2020
09;Burgos;009;Albillos;210;113;97;2020
09;Burgos;010;Alcocero de Mola;32;23;9;2020
09;Burgos;011;Alfoz de Bricia;70;43;27;2020
09;Burgos;907;Alfoz de Quintanadueñas;2179;1149;1030;2020
09;Burgos;012;Alfoz de Santa Gadea;104;60;44;2020
09;Burgos;013;Altable;46;27;19;2020
09;Burgos;014;Altos, Los;184;107;77;2020
09;Burgos;016;Ameyugo;113;56;57;2020
09;Burgos;017;Anguix;155;87;68;2020
09;Burgos;018;Aranda de Duero;33187;16064;17123;2020
09;Burgos;019;Arandilla;162;102;60;2020
09;Burgos;020;Arauzo de Miel;306;171;135;2020
09;Burgos;021;Arauzo de Salce;54;31;23;2020
09;Burgos;022;Arauzo de Torre;77;46;31;2020
09;Burgos;023;Arcos;1775;927;848;2020
09;Burgos;024;Arenillas de Riopisuerga;174;102;72;2020
09;Burgos;025;Arija;121;64;57;2020
09;Burgos;026;Arlanzón;407;243;164;2020
09;Burgos;027;Arraya de Oca;47;28;19;2020
09;Burgos;029;Atapuerca;166;96;70;2020
09;Burgos;030;Ausines, Los;133;81;52;2020
09;Burgos;032;Avellanosa de Muñó;106;58;48;2020
09;Burgos;033;Bahabón de Esgueva;79;43;36;2020
09;Burgos;034;Balbases, Los;319;175;144;2020
09;Burgos;035;Baños de Valdearados;333;195;138;2020
09;Burgos;036;Bañuelos de Bureba;35;21;14;2020
09;Burgos;037;Barbadillo de Herreros;109;69;40;2020
09;Burgos;038;Barbadillo del Mercado;140;80;60;2020
09;Burgos;039;Barbadillo del Pez;63;38;25;2020
09;Burgos;041;Barrio de Muñó;31;17;14;2020
09;Burgos;043;Barrios de Bureba, Los;179;106;73;2020
09;Burgos;044;Barrios de Colina;55;30;25;2020
09;Burgos;045;Basconcillos del Tozo;295;166;129;2020
09;Burgos;046;Bascuñana;23;15;8;2020
09;Burgos;047;Belbimbre;57;31;26;2020
09;Burgos;048;Belorado;1780;913;867;2020
09;Burgos;050;Berberana;60;35;25;2020
09;Burgos;051;Berlangas de Roa;183;95;88;2020
09;Burgos;052;Berzosa de Bureba;29;22;7;2020
09;Burgos;054;Bozoó;97;60;37;2020
09;Burgos;055;Brazacorta;54;31;23;2020
09;Burgos;056;Briviesca;6582;3293;3289;2020
09;Burgos;057;Bugedo;187;121;66;2020
09;Burgos;058;Buniel;563;306;257;2020
09;Burgos;059;Burgos;176418;83995;92423;2020
09;Burgos;060;Busto de Bureba;133;71;62;2020
09;Burgos;061;Cabañes de Esgueva;160;92;68;2020
09;Burgos;062;Cabezón de la Sierra;40;17;23;2020
09;Burgos;064;Caleruega;420;210;210;2020
09;Burgos;065;Campillo de Aranda;179;101;78;2020
09;Burgos;066;Campolara;57;41;16;2020
09;Burgos;067;Canicosa de la Sierra;433;228;205;2020
09;Burgos;068;Cantabrana;25;15;10;2020
09;Burgos;070;Carazo;30;21;9;2020
09;Burgos;071;Carcedo de Bureba;40;21;19;2020
09;Burgos;072;Carcedo de Burgos;424;221;203;2020
09;Burgos;073;Cardeñadijo;1369;756;613;2020
09;Burgos;074;Cardeñajimeno;1136;593;543;2020
09;Burgos;075;Cardeñuela Riopico;115;68;47;2020
09;Burgos;076;Carrias;25;19;6;2020
09;Burgos;077;Cascajares de Bureba;30;14;16;2020
09;Burgos;078;Cascajares de la Sierra;33;18;15;2020
09;Burgos;079;Castellanos de Castro;50;30;20;2020
09;Burgos;083;Castil de Peones;25;13;12;2020
09;Burgos;082;Castildelgado;36;21;15;2020
09;Burgos;084;Castrillo de la Reina;176;119;57;2020
09;Burgos;085;Castrillo de la Vega;650;351;299;2020
09;Burgos;088;Castrillo de Riopisuerga;60;36;24;2020
09;Burgos;086;Castrillo del Val;793;449;344;2020
09;Burgos;090;Castrillo Mota de Judíos;50;27;23;2020
09;Burgos;091;Castrojeriz;782;413;369;2020
09;Burgos;063;Cavia;238;141;97;2020
09;Burgos;093;Cayuela;183;100;83;2020
09;Burgos;094;Cebrecos;52;34;18;2020
09;Burgos;095;Celada del Camino;115;55;60;2020
09;Burgos;098;Cerezo de Río Tirón;541;289;252;2020
09;Burgos;100;Cerratón de Juarros;55;37;18;2020
09;Burgos;101;Ciadoncha;80;52;28;2020
09;Burgos;102;Cillaperlata;31;21;10;2020
09;Burgos;103;Cilleruelo de Abajo;210;119;91;2020
09;Burgos;104;Cilleruelo de Arriba;47;23;24;2020
09;Burgos;105;Ciruelos de Cervera;97;56;41;2020
09;Burgos;108;Cogollos;570;319;251;2020
09;Burgos;109;Condado de Treviño;1363;753;610;2020
09;Burgos;110;Contreras;80;52;28;2020
09;Burgos;112;Coruña del Conde;107;67;40;2020
09;Burgos;113;Covarrubias;541;288;253;2020
09;Burgos;114;Cubillo del Campo;99;56;43;2020
09;Burgos;115;Cubo de Bureba;95;54;41;2020
09;Burgos;117;Cueva de Roa, La;120;61;59;2020
09;Burgos;119;Cuevas de San Clemente;41;17;24;2020
09;Burgos;120;Encío;44;22;22;2020
09;Burgos;122;Espinosa de Cervera;91;58;33;2020
09;Burgos;124;Espinosa de los Monteros;1651;850;801;2020
09;Burgos;123;Espinosa del Camino;42;25;17;2020
09;Burgos;125;Estépar;596;355;241;2020
09;Burgos;127;Fontioso;57;34;23;2020
09;Burgos;128;Frandovínez;86;50;36;2020
09;Burgos;129;Fresneda de la Sierra Tirón;94;58;36;2020
09;Burgos;130;Fresneña;68;45;23;2020
09;Burgos;131;Fresnillo de las Dueñas;677;346;331;2020
09;Burgos;132;Fresno de Río Tirón;184;112;72;2020
09;Burgos;133;Fresno de Rodilla;44;26;18;2020
09;Burgos;134;Frías;247;129;118;2020
09;Burgos;135;Fuentebureba;47;27;20;2020
09;Burgos;136;Fuentecén;217;121;96;2020
09;Burgos;137;Fuentelcésped;252;130;122;2020
09;Burgos;138;Fuentelisendo;92;51;41;2020
09;Burgos;139;Fuentemolinos;100;68;32;2020
09;Burgos;140;Fuentenebro;131;80;51;2020
09;Burgos;141;Fuentespina;785;405;380;2020
09;Burgos;143;Galbarros;30;18;12;2020
09;Burgos;144;Gallega, La;45;29;16;2020
09;Burgos;148;Grijalba;112;54;58;2020
09;Burgos;149;Grisaleña;49;36;13;2020
09;Burgos;151;Gumiel de Izán;561;313;248;2020
09;Burgos;152;Gumiel de Mercado;359;195;164;2020
09;Burgos;154;Hacinas;144;88;56;2020
09;Burgos;155;Haza;30;19;11;2020
09;Burgos;159;Hontanas;74;46;28;2020
09;Burgos;160;Hontangas;87;59;28;2020
09;Burgos;162;Hontoria de la Cantera;145;78;67;2020
09;Burgos;164;Hontoria de Valdearados;175;105;70;2020
09;Burgos;163;Hontoria del Pinar;650;363;287;2020
09;Burgos;166;Hormazas, Las;96;53;43;2020
09;Burgos;167;Hornillos del Camino;59;33;26;2020
09;Burgos;168;Horra, La;335;187;148;2020
09;Burgos;169;Hortigüela;105;70;35;2020
09;Burgos;170;Hoyales de Roa;234;121;113;2020
09;Burgos;172;Huérmeces;161;90;71;2020
09;Burgos;173;Huerta de Arriba;125;71;54;2020
09;Burgos;174;Huerta de Rey;901;489;412;2020
09;Burgos;175;Humada;118;79;39;2020
09;Burgos;176;Hurones;62;43;19;2020
09;Burgos;177;Ibeas de Juarros;1405;754;651;2020
09;Burgos;178;Ibrillos;39;26;13;2020
09;Burgos;179;Iglesiarrubia;39;22;17;2020
09;Burgos;180;Iglesias;143;79;64;2020
09;Burgos;181;Isar;287;147;140;2020
09;Burgos;182;Itero del Castillo;80;47;33;2020
09;Burgos;183;Jaramillo de la Fuente;42;28;14;2020
09;Burgos;184;Jaramillo Quemado;10;9;1;2020
09;Burgos;189;Junta de Traslaloma;128;71;57;2020
09;Burgos;190;Junta de Villalba de Losa;87;49;38;2020
09;Burgos;191;Jurisdicción de Lara;31;19;12;2020
09;Burgos;192;Jurisdicción de San Zadornil;57;32;25;2020
09;Burgos;194;Lerma;2537;1275;1262;2020
09;Burgos;195;Llano de Bureba;57;37;20;2020
09;Burgos;196;Madrigal del Monte;147;89;58;2020
09;Burgos;197;Madrigalejo del Monte;174;116;58;2020
09;Burgos;198;Mahamud;100;54;46;2020
09;Burgos;199;Mambrilla de Castrejón;104;65;39;2020
09;Burgos;200;Mambrillas de Lara;45;28;17;2020
09;Burgos;201;Mamolar;27;20;7;2020
09;Burgos;202;Manciles;20;13;7;2020
09;Burgos;206;Mazuela;55;32;23;2020
09;Burgos;208;Mecerreyes;193;105;88;2020
09;Burgos;209;Medina de Pomar;5734;2907;2827;2020
09;Burgos;211;Melgar de Fernamental;1548;841;707;2020
09;Burgos;213;Merindad de Cuesta-Urria;291;162;129;2020
09;Burgos;214;Merindad de Montija;707;418;289;2020
09;Burgos;906;Merindad de Río Ubierna;1418;794;624;2020
09;Burgos;215;Merindad de Sotoscueva;396;225;171;2020
09;Burgos;216;Merindad de Valdeporres;412;218;194;2020
09;Burgos;217;Merindad de Valdivielso;380;223;157;2020
09;Burgos;218;Milagros;434;235;199;2020
09;Burgos;219;Miranda de Ebro;35760;17609;18151;2020
09;Burgos;220;Miraveche;70;45;25;2020
09;Burgos;221;Modúbar de la Emparedada;710;387;323;2020
09;Burgos;223;Monasterio de la Sierra;43;27;16;2020
09;Burgos;224;Monasterio de Rodilla;165;89;76;2020
09;Burgos;225;Moncalvillo;81;48;33;2020
09;Burgos;226;Monterrubio de la Demanda;56;34;22;2020
09;Burgos;227;Montorio;142;78;64;2020
09;Burgos;228;Moradillo de Roa;171;94;77;2020
09;Burgos;229;Nava de Roa;220;115;105;2020
09;Burgos;230;Navas de Bureba;33;16;17;2020
09;Burgos;231;Nebreda;57;42;15;2020
09;Burgos;232;Neila;153;87;66;2020
09;Burgos;235;Olmedillo de Roa;191;110;81;2020
09;Burgos;236;Olmillos de Muñó;37;20;17;2020
09;Burgos;238;Oña;1003;526;477;2020
09;Burgos;239;Oquillas;54;31;23;2020
09;Burgos;241;Orbaneja Riopico;339;189;150;2020
09;Burgos;242;Padilla de Abajo;80;48;32;2020
09;Burgos;243;Padilla de Arriba;79;49;30;2020
09;Burgos;244;Padrones de Bureba;46;21;25;2020
09;Burgos;246;Palacios de la Sierra;701;357;344;2020
09;Burgos;247;Palacios de Riopisuerga;24;12;12;2020
09;Burgos;248;Palazuelos de la Sierra;85;50;35;2020
09;Burgos;249;Palazuelos de Muñó;50;28;22;2020
09;Burgos;250;Pampliega;298;161;137;2020
09;Burgos;251;Pancorbo;429;229;200;2020
09;Burgos;253;Pardilla;118;71;47;2020
09;Burgos;255;Partido de la Sierra en Tobalina;83;50;33;2020
09;Burgos;256;Pedrosa de Duero;500;285;215;2020
09;Burgos;259;Pedrosa de Río Úrbel;248;147;101;2020
09;Burgos;257;Pedrosa del Páramo;89;53;36;2020
09;Burgos;258;Pedrosa del Príncipe;169;91;78;2020
09;Burgos;261;Peñaranda de Duero;516;259;257;2020
09;Burgos;262;Peral de Arlanza;172;96;76;2020
09;Burgos;265;Piérnigas;48;31;17;2020
09;Burgos;266;Pineda de la Sierra;98;63;35;2020
09;Burgos;267;Pineda Trasmonte;121;70;51;2020
09;Burgos;268;Pinilla de los Barruecos;92;54;38;2020
09;Burgos;269;Pinilla de los Moros;37;19;18;2020
09;Burgos;270;Pinilla Trasmonte;168;95;73;2020
09;Burgos;272;Poza de la Sal;274;148;126;2020
09;Burgos;273;Prádanos de Bureba;52;33;19;2020
09;Burgos;274;Pradoluengo;1151;576;575;2020
09;Burgos;275;Presencio;184;110;74;2020
09;Burgos;276;Puebla de Arganzón, La;502;274;228;2020
09;Burgos;277;Puentedura;109;75;34;2020
09;Burgos;279;Quemada;250;150;100;2020
09;Burgos;281;Quintana del Pidio;156;82;74;2020
09;Burgos;280;Quintanabureba;23;13;10;2020
09;Burgos;283;Quintanaélez;44;22;22;2020
09;Burgos;287;Quintanaortuño;261;146;115;2020
09;Burgos;288;Quintanapalla;110;59;51;2020
09;Burgos;289;Quintanar de la Sierra;1603;849;754;2020
09;Burgos;292;Quintanavides;74;44;30;2020
09;Burgos;294;Quintanilla de la Mata;110;65;45;2020
09;Burgos;901;Quintanilla del Agua y Tordueles;360;192;168;2020
09;Burgos;295;Quintanilla del Coco;54;28;26;2020
09;Burgos;298;Quintanilla San García;79;48;31;2020
09;Burgos;301;Quintanilla Vivar;820;437;383;2020
09;Burgos;297;Quintanillas, Las;362;214;148;2020
09;Burgos;302;Rabanera del Pinar;102;63;39;2020
09;Burgos;303;Rábanos;80;48;32;2020
09;Burgos;304;Rabé de las Calzadas;229;114;115;2020
09;Burgos;306;Rebolledo de la Torre;106;60;46;2020
09;Burgos;307;Redecilla del Camino;103;68;35;2020
09;Burgos;308;Redecilla del Campo;66;36;30;2020
09;Burgos;309;Regumiel de la Sierra;334;176;158;2020
09;Burgos;310;Reinoso;15;10;5;2020
09;Burgos;311;Retuerta;62;38;24;2020
09;Burgos;314;Revilla del Campo;100;62;38;2020
09;Burgos;316;Revilla Vallejera;104;63;41;2020
09;Burgos;312;Revilla y Ahedo, La;100;57;43;2020
09;Burgos;315;Revillarruz;523;270;253;2020
09;Burgos;317;Rezmondo;21;8;13;2020
09;Burgos;318;Riocavado de la Sierra;55;36;19;2020
09;Burgos;321;Roa;2167;1091;1076;2020
09;Burgos;323;Rojas;63;45;18;2020
09;Burgos;325;Royuela de Río Franco;174;104;70;2020
09;Burgos;326;Rubena;191;114;77;2020
09;Burgos;327;Rublacedo de Abajo;30;16;14;2020
09;Burgos;328;Rucandio;69;34;35;2020
09;Burgos;329;Salas de Bureba;131;74;57;2020
09;Burgos;330;Salas de los Infantes;1987;1022;965;2020
09;Burgos;332;Saldaña de Burgos;180;102;78;2020
09;Burgos;334;Salinillas de Bureba;54;41;13;2020
09;Burgos;335;San Adrián de Juarros;85;55;30;2020
09;Burgos;337;San Juan del Monte;149;82;67;2020
09;Burgos;338;San Mamés de Burgos;287;163;124;2020
09;Burgos;339;San Martín de Rubiales;150;90;60;2020
09;Burgos;340;San Millán de Lara;72;50;22;2020
09;Burgos;360;San Vicente del Valle;27;21;6;2020
09;Burgos;343;Santa Cecilia;98;61;37;2020
09;Burgos;345;Santa Cruz de la Salceda;140;86;54;2020
09;Burgos;346;Santa Cruz del Valle Urbión;99;66;33;2020
09;Burgos;347;Santa Gadea del Cid;153;78;75;2020
09;Burgos;348;Santa Inés;139;78;61;2020
09;Burgos;350;Santa María del Campo;517;281;236;2020
09;Burgos;351;Santa María del Invierno;63;45;18;2020
09;Burgos;352;Santa María del Mercadillo;101;67;34;2020
09;Burgos;353;Santa María Rivarredonda;92;56;36;2020
09;Burgos;354;Santa Olalla de Bureba;37;26;11;2020
09;Burgos;355;Santibáñez de Esgueva;79;45;34;2020
09;Burgos;356;Santibáñez del Val;47;29;18;2020
09;Burgos;358;Santo Domingo de Silos;273;168;105;2020
09;Burgos;361;Sargentes de la Lora;111;63;48;2020
09;Burgos;362;Sarracín;248;131;117;2020
09;Burgos;363;Sasamón;962;552;410;2020
09;Burgos;365;Sequera de Haza, La;27;19;8;2020
09;Burgos;366;Solarana;77;43;34;2020
09;Burgos;368;Sordillos;33;20;13;2020
09;Burgos;369;Sotillo de la Ribera;475;249;226;2020
09;Burgos;372;Sotragero;273;149;124;2020
09;Burgos;373;Sotresgudo;432;249;183;2020
09;Burgos;374;Susinos del Páramo;116;73;43;2020
09;Burgos;375;Tamarón;44;24;20;2020
09;Burgos;377;Tardajos;783;416;367;2020
09;Burgos;378;Tejada;34;19;15;2020
09;Burgos;380;Terradillos de Esgueva;77;38;39;2020
09;Burgos;381;Tinieblas de la Sierra;34;19;15;2020
09;Burgos;382;Tobar;22;17;5;2020
09;Burgos;384;Tordómar;334;183;151;2020
09;Burgos;386;Torrecilla del Monte;72;39;33;2020
09;Burgos;387;Torregalindo;121;74;47;2020
09;Burgos;388;Torrelara;31;18;13;2020
09;Burgos;389;Torrepadre;70;41;29;2020
09;Burgos;390;Torresandino;604;322;282;2020
09;Burgos;391;Tórtoles de Esgueva;433;229;204;2020
09;Burgos;392;Tosantos;52;28;24;2020
09;Burgos;394;Trespaderne;771;386;385;2020
09;Burgos;395;Tubilla del Agua;136;82;54;2020
09;Burgos;396;Tubilla del Lago;169;93;76;2020
09;Burgos;398;Úrbel del Castillo;72;47;25;2020
09;Burgos;400;Vadocondes;345;192;153;2020
09;Burgos;403;Valdeande;104;61;43;2020
09;Burgos;405;Valdezate;134;77;57;2020
09;Burgos;406;Valdorros;297;175;122;2020
09;Burgos;408;Vallarta de Bureba;40;27;13;2020
09;Burgos;904;Valle de las Navas;509;303;206;2020
09;Burgos;908;Valle de Losa;481;276;205;2020
09;Burgos;409;Valle de Manzanedo;122;65;57;2020
09;Burgos;410;Valle de Mena;3805;1941;1864;2020
09;Burgos;411;Valle de Oca;165;98;67;2020
09;Burgos;902;Valle de Santibáñez;483;276;207;2020
09;Burgos;905;Valle de Sedano;421;239;182;2020
09;Burgos;412;Valle de Tobalina;909;499;410;2020
09;Burgos;413;Valle de Valdebezana;456;238;218;2020
09;Burgos;414;Valle de Valdelaguna;186;111;75;2020
09;Burgos;415;Valle de Valdelucio;330;182;148;2020
09;Burgos;416;Valle de Zamanzas;53;31;22;2020
09;Burgos;417;Vallejera;42;24;18;2020
09;Burgos;418;Valles de Palenzuela;79;39;40;2020
09;Burgos;419;Valluércanes;71;47;24;2020
09;Burgos;407;Valmala;25;12;13;2020
09;Burgos;422;Vid de Bureba, La;31;18;13;2020
09;Burgos;421;Vid y Barrios, La;250;147;103;2020
09;Burgos;423;Vileña;27;17;10;2020
09;Burgos;427;Villadiego;1500;831;669;2020
09;Burgos;428;Villaescusa de Roa;100;57;43;2020
09;Burgos;429;Villaescusa la Sombría;58;43;15;2020
09;Burgos;430;Villaespasa;27;16;11;2020
09;Burgos;431;Villafranca Montes de Oca;113;69;44;2020
09;Burgos;432;Villafruela;176;103;73;2020
09;Burgos;433;Villagalijo;61;38;23;2020
09;Burgos;434;Villagonzalo Pedernales;1859;978;881;2020
09;Burgos;437;Villahoz;287;152;135;2020
09;Burgos;438;Villalba de Duero;705;374;331;2020
09;Burgos;439;Villalbilla de Burgos;1423;772;651;2020
09;Burgos;440;Villalbilla de Gumiel;85;55;30;2020
09;Burgos;441;Villaldemiro;97;54;43;2020
09;Burgos;442;Villalmanzo;420;230;190;2020
09;Burgos;443;Villamayor de los Montes;165;77;88;2020
09;Burgos;444;Villamayor de Treviño;61;32;29;2020
09;Burgos;445;Villambistia;44;32;12;2020
09;Burgos;446;Villamedianilla;11;8;3;2020
09;Burgos;447;Villamiel de la Sierra;44;27;17;2020
09;Burgos;448;Villangómez;217;131;86;2020
09;Burgos;449;Villanueva de Argaño;114;64;50;2020
09;Burgos;450;Villanueva de Carazo;26;16;10;2020
09;Burgos;451;Villanueva de Gumiel;273;143;130;2020
09;Burgos;454;Villanueva de Teba;41;27;14;2020
09;Burgos;455;Villaquirán de la Puebla;46;27;19;2020
09;Burgos;456;Villaquirán de los Infantes;160;83;77;2020
09;Burgos;903;Villarcayo de Merindad de Castilla la Vieja;4011;2065;1946;2020
09;Burgos;458;Villariezo;645;358;287;2020
09;Burgos;460;Villasandino;180;101;79;2020
09;Burgos;463;Villasur de Herreros;264;164;100;2020
09;Burgos;464;Villatuelda;37;20;17;2020
09;Burgos;466;Villaverde del Monte;112;67;45;2020
09;Burgos;467;Villaverde-Mogina;74;51;23;2020
09;Burgos;471;Villayerno Morquillas;195;105;90;2020
09;Burgos;472;Villazopeque;53;31;22;2020
09;Burgos;473;Villegas;89;51;38;2020
09;Burgos;476;Villoruebo;72;47;25;2020
09;Burgos;424;Viloria de Rioja;39;23;16;2020
09;Burgos;425;Vilviestre del Pinar;516;283;233;2020
09;Burgos;478;Vizcaínos;44;32;12;2020
09;Burgos;480;Zael;112;59;53;2020
09;Burgos;482;Zarzosa de Río Pisuerga;34;21;13;2020
09;Burgos;483;Zazuar;210;106;104;2020
09;Burgos;485;Zuñeda;53;31;22;2020
10;Cáceres;001;Abadía;336;183;153;2020
10;Cáceres;002;Abertura;404;200;204;2020
10;Cáceres;003;Acebo;557;274;283;2020
10;Cáceres;004;Acehúche;802;408;394;2020
10;Cáceres;005;Aceituna;600;306;294;2020
10;Cáceres;006;Ahigal;1381;711;670;2020
10;Cáceres;903;Alagón del Río;932;463;469;2020
10;Cáceres;007;Albalá;669;351;318;2020
10;Cáceres;008;Alcántara;1411;701;710;2020
10;Cáceres;009;Alcollarín;282;144;138;2020
10;Cáceres;010;Alcuéscar;2554;1329;1225;2020
10;Cáceres;012;Aldea del Cano;602;284;318;2020
10;Cáceres;013;Aldea del Obispo, La;298;161;137;2020
10;Cáceres;011;Aldeacentenera;561;288;273;2020
10;Cáceres;014;Aldeanueva de la Vera;2042;1003;1039;2020
10;Cáceres;015;Aldeanueva del Camino;727;355;372;2020
10;Cáceres;016;Aldehuela de Jerte;371;197;174;2020
10;Cáceres;017;Alía;816;420;396;2020
10;Cáceres;018;Aliseda;1777;900;877;2020
10;Cáceres;019;Almaraz;1726;881;845;2020
10;Cáceres;020;Almoharín;1811;884;927;2020
10;Cáceres;021;Arroyo de la Luz;5766;2857;2909;2020
10;Cáceres;023;Arroyomolinos;828;422;406;2020
10;Cáceres;022;Arroyomolinos de la Vera;441;218;223;2020
10;Cáceres;024;Baños de Montemayor;751;353;398;2020
10;Cáceres;025;Barrado;387;200;187;2020
10;Cáceres;026;Belvís de Monroy;733;381;352;2020
10;Cáceres;027;Benquerencia;80;48;32;2020
10;Cáceres;028;Berrocalejo;97;54;43;2020
10;Cáceres;029;Berzocana;414;222;192;2020
10;Cáceres;030;Bohonal de Ibor;481;246;235;2020
10;Cáceres;031;Botija;171;88;83;2020
10;Cáceres;032;Brozas;1804;903;901;2020
10;Cáceres;033;Cabañas del Castillo;424;220;204;2020
10;Cáceres;034;Cabezabellosa;340;172;168;2020
10;Cáceres;035;Cabezuela del Valle;2129;1091;1038;2020
10;Cáceres;036;Cabrero;328;182;146;2020
10;Cáceres;037;Cáceres;96255;46104;50151;2020
10;Cáceres;038;Cachorrilla;87;44;43;2020
10;Cáceres;039;Cadalso;426;218;208;2020
10;Cáceres;040;Calzadilla;463;235;228;2020
10;Cáceres;041;Caminomorisco;1181;620;561;2020
10;Cáceres;042;Campillo de Deleitosa;75;33;42;2020
10;Cáceres;043;Campo Lugar;814;407;407;2020
10;Cáceres;044;Cañamero;1618;843;775;2020
10;Cáceres;045;Cañaveral;1036;508;528;2020
10;Cáceres;046;Carbajo;197;102;95;2020
10;Cáceres;047;Carcaboso;1085;549;536;2020
10;Cáceres;048;Carrascalejo;220;111;109;2020
10;Cáceres;049;Casar de Cáceres;4499;2223;2276;2020
10;Cáceres;050;Casar de Palomero;1084;553;531;2020
10;Cáceres;051;Casares de las Hurdes;400;202;198;2020
10;Cáceres;052;Casas de Don Antonio;170;85;85;2020
10;Cáceres;053;Casas de Don Gómez;283;152;131;2020
10;Cáceres;056;Casas de Millán;550;280;270;2020
10;Cáceres;057;Casas de Miravete;126;79;47;2020
10;Cáceres;054;Casas del Castañar;552;269;283;2020
10;Cáceres;055;Casas del Monte;811;420;391;2020
10;Cáceres;058;Casatejada;1344;706;638;2020
10;Cáceres;059;Casillas de Coria;345;170;175;2020
10;Cáceres;060;Castañar de Ibor;1033;533;500;2020
10;Cáceres;061;Ceclavín;1812;914;898;2020
10;Cáceres;062;Cedillo;428;222;206;2020
10;Cáceres;063;Cerezo;159;81;78;2020
10;Cáceres;064;Cilleros;1602;810;792;2020
10;Cáceres;065;Collado de la Vera;191;106;85;2020
10;Cáceres;066;Conquista de la Sierra;185;107;78;2020
10;Cáceres;067;Coria;12366;6066;6300;2020
10;Cáceres;068;Cuacos de Yuste;851;436;415;2020
10;Cáceres;069;Cumbre, La;841;432;409;2020
10;Cáceres;070;Deleitosa;687;349;338;2020
10;Cáceres;071;Descargamaría;116;65;51;2020
10;Cáceres;072;Eljas;901;467;434;2020
10;Cáceres;073;Escurial;865;452;413;2020
10;Cáceres;075;Fresnedoso de Ibor;262;140;122;2020
10;Cáceres;076;Galisteo;916;460;456;2020
10;Cáceres;077;Garciaz;699;362;337;2020
10;Cáceres;079;Garganta la Olla;926;490;436;2020
10;Cáceres;078;Garganta, La;365;199;166;2020
10;Cáceres;080;Gargantilla;376;194;182;2020
10;Cáceres;081;Gargüera;164;89;75;2020
10;Cáceres;082;Garrovillas de Alconétar;2004;992;1012;2020
10;Cáceres;083;Garvín;104;55;49;2020
10;Cáceres;084;Gata;1417;729;688;2020
10;Cáceres;085;Gordo, El;360;188;172;2020
10;Cáceres;086;Granja, La;323;163;160;2020
10;Cáceres;087;Guadalupe;1828;918;910;2020
10;Cáceres;088;Guijo de Coria;196;106;90;2020
10;Cáceres;089;Guijo de Galisteo;1507;760;747;2020
10;Cáceres;090;Guijo de Granadilla;522;274;248;2020
10;Cáceres;091;Guijo de Santa Bárbara;378;197;181;2020
10;Cáceres;092;Herguijuela;274;147;127;2020
10;Cáceres;093;Hernán-Pérez;424;208;216;2020
10;Cáceres;094;Herrera de Alcántara;240;121;119;2020
10;Cáceres;095;Herreruela;330;166;164;2020
10;Cáceres;096;Hervás;3957;1936;2021;2020
10;Cáceres;097;Higuera;110;66;44;2020
10;Cáceres;098;Hinojal;404;207;197;2020
10;Cáceres;099;Holguera;637;323;314;2020
10;Cáceres;100;Hoyos;880;436;444;2020
10;Cáceres;101;Huélaga;219;109;110;2020
10;Cáceres;102;Ibahernando;538;263;275;2020
10;Cáceres;103;Jaraicejo;456;224;232;2020
10;Cáceres;104;Jaraíz de la Vera;6503;3252;3251;2020
10;Cáceres;105;Jarandilla de la Vera;2805;1402;1403;2020
10;Cáceres;106;Jarilla;138;68;70;2020
10;Cáceres;107;Jerte;1260;624;636;2020
10;Cáceres;108;Ladrillar;192;110;82;2020
10;Cáceres;109;Logrosán;1971;1003;968;2020
10;Cáceres;110;Losar de la Vera;2717;1391;1326;2020
10;Cáceres;111;Madrigal de la Vera;1561;812;749;2020
10;Cáceres;112;Madrigalejo;1712;865;847;2020
10;Cáceres;113;Madroñera;2496;1248;1248;2020
10;Cáceres;114;Majadas;1322;668;654;2020
10;Cáceres;115;Malpartida de Cáceres;4076;2042;2034;2020
10;Cáceres;116;Malpartida de Plasencia;4602;2287;2315;2020
10;Cáceres;117;Marchagaz;203;104;99;2020
10;Cáceres;118;Mata de Alcántara;301;154;147;2020
10;Cáceres;119;Membrío;605;300;305;2020
10;Cáceres;120;Mesas de Ibor;163;83;80;2020
10;Cáceres;121;Miajadas;9527;4759;4768;2020
10;Cáceres;122;Millanes;255;131;124;2020
10;Cáceres;123;Mirabel;661;326;335;2020
10;Cáceres;124;Mohedas de Granadilla;838;421;417;2020
10;Cáceres;125;Monroy;938;480;458;2020
10;Cáceres;126;Montánchez;1668;840;828;2020
10;Cáceres;127;Montehermoso;5718;2905;2813;2020
10;Cáceres;128;Moraleja;6696;3315;3381;2020
10;Cáceres;129;Morcillo;358;167;191;2020
10;Cáceres;130;Navaconcejo;2024;1019;1005;2020
10;Cáceres;131;Navalmoral de la Mata;17163;8306;8857;2020
10;Cáceres;132;Navalvillar de Ibor;388;195;193;2020
10;Cáceres;133;Navas del Madroño;1280;637;643;2020
10;Cáceres;134;Navezuelas;632;325;307;2020
10;Cáceres;135;Nuñomoral;1252;666;586;2020
10;Cáceres;136;Oliva de Plasencia;296;167;129;2020
10;Cáceres;137;Palomero;396;208;188;2020
10;Cáceres;138;Pasarón de la Vera;604;293;311;2020
10;Cáceres;139;Pedroso de Acim;80;43;37;2020
10;Cáceres;140;Peraleda de la Mata;1393;700;693;2020
10;Cáceres;141;Peraleda de San Román;300;162;138;2020
10;Cáceres;142;Perales del Puerto;938;474;464;2020
10;Cáceres;143;Pescueza;146;65;81;2020
10;Cáceres;144;Pesga, La;1018;532;486;2020
10;Cáceres;145;Piedras Albas;141;69;72;2020
10;Cáceres;146;Pinofranqueado;1692;899;793;2020
10;Cáceres;147;Piornal;1483;752;731;2020
10;Cáceres;148;Plasencia;39860;19170;20690;2020
10;Cáceres;149;Plasenzuela;487;246;241;2020
10;Cáceres;150;Portaje;370;190;180;2020
10;Cáceres;151;Portezuelo;211;113;98;2020
10;Cáceres;152;Pozuelo de Zarzón;454;231;223;2020
10;Cáceres;905;Pueblonuevo de Miramontes;782;394;388;2020
10;Cáceres;153;Puerto de Santa Cruz;304;161;143;2020
10;Cáceres;154;Rebollar;215;106;109;2020
10;Cáceres;155;Riolobos;1201;613;588;2020
10;Cáceres;156;Robledillo de Gata;90;50;40;2020
10;Cáceres;157;Robledillo de la Vera;258;130;128;2020
10;Cáceres;158;Robledillo de Trujillo;360;179;181;2020
10;Cáceres;159;Robledollano;294;157;137;2020
10;Cáceres;160;Romangordo;263;130;133;2020
10;Cáceres;901;Rosalejo;1334;686;648;2020
10;Cáceres;161;Ruanes;80;43;37;2020
10;Cáceres;162;Salorino;560;293;267;2020
10;Cáceres;163;Salvatierra de Santiago;298;151;147;2020
10;Cáceres;164;San Martín de Trevejo;766;381;385;2020
10;Cáceres;165;Santa Ana;256;136;120;2020
10;Cáceres;166;Santa Cruz de la Sierra;326;166;160;2020
10;Cáceres;167;Santa Cruz de Paniagua;316;173;143;2020
10;Cáceres;168;Santa Marta de Magasca;299;149;150;2020
10;Cáceres;169;Santiago de Alcántara;507;247;260;2020
10;Cáceres;170;Santiago del Campo;237;122;115;2020
10;Cáceres;171;Santibáñez el Alto;361;196;165;2020
10;Cáceres;172;Santibáñez el Bajo;741;378;363;2020
10;Cáceres;173;Saucedilla;852;434;418;2020
10;Cáceres;174;Segura de Toro;181;89;92;2020
10;Cáceres;175;Serradilla;1507;755;752;2020
10;Cáceres;176;Serrejón;410;213;197;2020
10;Cáceres;177;Sierra de Fuentes;1998;1018;980;2020
10;Cáceres;178;Talaván;806;421;385;2020
10;Cáceres;179;Talaveruela de la Vera;298;159;139;2020
10;Cáceres;180;Talayuela;7395;3952;3443;2020
10;Cáceres;181;Tejeda de Tiétar;773;410;363;2020
10;Cáceres;904;Tiétar;879;472;407;2020
10;Cáceres;182;Toril;153;99;54;2020
10;Cáceres;183;Tornavacas;1098;585;513;2020
10;Cáceres;184;Torno, El;851;451;400;2020
10;Cáceres;187;Torre de Don Miguel;484;257;227;2020
10;Cáceres;188;Torre de Santa María;532;268;264;2020
10;Cáceres;185;Torrecilla de los Ángeles;601;326;275;2020
10;Cáceres;186;Torrecillas de la Tiesa;1070;541;529;2020
10;Cáceres;190;Torrejón el Rubio;546;276;270;2020
10;Cáceres;189;Torrejoncillo;2910;1410;1500;2020
10;Cáceres;191;Torremenga;587;313;274;2020
10;Cáceres;192;Torremocha;793;395;398;2020
10;Cáceres;193;Torreorgaz;1656;813;843;2020
10;Cáceres;194;Torrequemada;560;275;285;2020
10;Cáceres;195;Trujillo;8912;4335;4577;2020
10;Cáceres;196;Valdastillas;321;165;156;2020
10;Cáceres;197;Valdecañas de Tajo;106;53;53;2020
10;Cáceres;198;Valdefuentes;1139;562;577;2020
10;Cáceres;199;Valdehúncar;171;92;79;2020
10;Cáceres;200;Valdelacasa de Tajo;348;183;165;2020
10;Cáceres;201;Valdemorales;202;100;102;2020
10;Cáceres;202;Valdeobispo;644;318;326;2020
10;Cáceres;203;Valencia de Alcántara;5373;2627;2746;2020
10;Cáceres;204;Valverde de la Vera;465;238;227;2020
10;Cáceres;205;Valverde del Fresno;2250;1141;1109;2020
10;Cáceres;902;Vegaviana;868;448;420;2020
10;Cáceres;206;Viandar de la Vera;219;114;105;2020
10;Cáceres;207;Villa del Campo;478;225;253;2020
10;Cáceres;208;Villa del Rey;133;66;67;2020
10;Cáceres;209;Villamesías;259;133;126;2020
10;Cáceres;210;Villamiel;400;204;196;2020
10;Cáceres;211;Villanueva de la Sierra;441;222;219;2020
10;Cáceres;212;Villanueva de la Vera;2062;1026;1036;2020
10;Cáceres;214;Villar de Plasencia;233;122;111;2020
10;Cáceres;213;Villar del Pedroso;582;299;283;2020
10;Cáceres;215;Villasbuenas de Gata;376;183;193;2020
10;Cáceres;216;Zarza de Granadilla;1800;911;889;2020
10;Cáceres;217;Zarza de Montánchez;548;277;271;2020
10;Cáceres;218;Zarza la Mayor;1199;595;604;2020
10;Cáceres;219;Zorita;1332;678;654;2020
11;Cádiz;001;Alcalá de los Gazules;5226;2691;2535;2020
11;Cádiz;002;Alcalá del Valle;5043;2533;2510;2020
11;Cádiz;003;Algar;1428;726;702;2020
11;Cádiz;004;Algeciras;123078;60729;62349;2020
11;Cádiz;005;Algodonales;5506;2781;2725;2020
11;Cádiz;006;Arcos de la Frontera;30818;15390;15428;2020
11;Cádiz;007;Barbate;22556;11306;11250;2020
11;Cádiz;008;Barrios, Los;23777;11924;11853;2020
11;Cádiz;901;Benalup-Casas Viejas;6986;3538;3448;2020
11;Cádiz;009;Benaocaz;673;361;312;2020
11;Cádiz;010;Bornos;7654;3815;3839;2020
11;Cádiz;011;Bosque, El;2137;1079;1058;2020
11;Cádiz;012;Cádiz;115439;54580;60859;2020
11;Cádiz;013;Castellar de la Frontera;3057;1527;1530;2020
11;Cádiz;015;Chiclana de la Frontera;85150;42607;42543;2020
11;Cádiz;016;Chipiona;19246;9629;9617;2020
11;Cádiz;014;Conil de la Frontera;22775;11470;11305;2020
11;Cádiz;017;Espera;3869;1950;1919;2020
11;Cádiz;018;Gastor, El;1729;887;842;2020
11;Cádiz;019;Grazalema;2013;997;1016;2020
11;Cádiz;020;Jerez de la Frontera;213105;104086;109019;2020
11;Cádiz;021;Jimena de la Frontera;6707;3413;3294;2020
11;Cádiz;022;Línea de la Concepción, La;63630;31207;32423;2020
11;Cádiz;023;Medina Sidonia;11773;5974;5799;2020
11;Cádiz;024;Olvera;8062;3949;4113;2020
11;Cádiz;025;Paterna de Rivera;5453;2824;2629;2020
11;Cádiz;026;Prado del Rey;5590;2787;2803;2020
11;Cádiz;027;Puerto de Santa María, El;88703;43437;45266;2020
11;Cádiz;028;Puerto Real;41700;20942;20758;2020
11;Cádiz;029;Puerto Serrano;6942;3511;3431;2020
11;Cádiz;030;Rota;29282;14557;14725;2020
11;Cádiz;031;San Fernando;95001;46420;48581;2020
11;Cádiz;902;San José del Valle;4433;2274;2159;2020
11;Cádiz;903;San Martín del Tesorillo;2801;1446;1355;2020
11;Cádiz;033;San Roque;31571;15782;15789;2020
11;Cádiz;032;Sanlúcar de Barrameda;69205;34479;34726;2020
11;Cádiz;034;Setenil de las Bodegas;2741;1408;1333;2020
11;Cádiz;035;Tarifa;18183;9140;9043;2020
11;Cádiz;036;Torre Alháquime;796;400;396;2020
11;Cádiz;037;Trebujena;7016;3488;3528;2020
11;Cádiz;038;Ubrique;16605;8205;8400;2020
11;Cádiz;039;Vejer de la Frontera;12622;6275;6347;2020
11;Cádiz;040;Villaluenga del Rosario;455;238;217;2020
11;Cádiz;041;Villamartín;12134;6098;6036;2020
11;Cádiz;042;Zahara;1379;701;678;2020
39;Cantabria;001;Alfoz de Lloredo;2394;1238;1156;2020
39;Cantabria;002;Ampuero;4319;2166;2153;2020
39;Cantabria;003;Anievas;274;148;126;2020
39;Cantabria;004;Arenas de Iguña;1665;848;817;2020
39;Cantabria;005;Argoños;1788;925;863;2020
39;Cantabria;006;Arnuero;2106;1048;1058;2020
39;Cantabria;007;Arredondo;452;252;200;2020
39;Cantabria;008;Astillero, El;18134;8862;9272;2020
39;Cantabria;009;Bárcena de Cicero;4319;2212;2107;2020
39;Cantabria;010;Bárcena de Pie de Concha;672;339;333;2020
39;Cantabria;011;Bareyo;1994;993;1001;2020
39;Cantabria;012;Cabezón de la Sal;8358;4007;4351;2020
39;Cantabria;013;Cabezón de Liébana;604;338;266;2020
39;Cantabria;014;Cabuérniga;965;520;445;2020
39;Cantabria;015;Camaleño;930;525;405;2020
39;Cantabria;016;Camargo;30320;14818;15502;2020
39;Cantabria;027;Campoo de Enmedio;3696;1872;1824;2020
39;Cantabria;017;Campoo de Yuso;670;363;307;2020
39;Cantabria;018;Cartes;5731;2873;2858;2020
39;Cantabria;019;Castañeda;2968;1509;1459;2020
39;Cantabria;020;Castro-Urdiales;32270;15955;16315;2020
39;Cantabria;021;Cieza;534;273;261;2020
39;Cantabria;022;Cillorigo de Liébana;1299;677;622;2020
39;Cantabria;023;Colindres;8598;4262;4336;2020
39;Cantabria;024;Comillas;2124;999;1125;2020
39;Cantabria;025;Corrales de Buelna, Los;10767;5258;5509;2020
39;Cantabria;026;Corvera de Toranzo;2042;1031;1011;2020
39;Cantabria;028;Entrambasaguas;5260;2630;2630;2020
39;Cantabria;029;Escalante;781;404;377;2020
39;Cantabria;030;Guriezo;2330;1209;1121;2020
39;Cantabria;031;Hazas de Cesto;1580;780;800;2020
39;Cantabria;032;Hermandad de Campoo de Suso;1588;884;704;2020
39;Cantabria;033;Herrerías;587;329;258;2020
39;Cantabria;034;Lamasón;269;169;100;2020
39;Cantabria;035;Laredo;11023;5212;5811;2020
39;Cantabria;036;Liendo;1196;619;577;2020
39;Cantabria;037;Liérganes;2407;1190;1217;2020
39;Cantabria;038;Limpias;1928;958;970;2020
39;Cantabria;039;Luena;600;326;274;2020
39;Cantabria;040;Marina de Cudeyo;5106;2556;2550;2020
39;Cantabria;041;Mazcuerras;2093;1071;1022;2020
39;Cantabria;042;Medio Cudeyo;7577;3680;3897;2020
39;Cantabria;043;Meruelo;2086;1039;1047;2020
39;Cantabria;044;Miengo;4891;2490;2401;2020
39;Cantabria;045;Miera;381;200;181;2020
39;Cantabria;046;Molledo;1507;748;759;2020
39;Cantabria;047;Noja;2588;1292;1296;2020
39;Cantabria;048;Penagos;2142;1087;1055;2020
39;Cantabria;049;Peñarrubia;319;172;147;2020
39;Cantabria;050;Pesaguero;295;169;126;2020
39;Cantabria;051;Pesquera;79;46;33;2020
39;Cantabria;052;Piélagos;25731;12708;13023;2020
39;Cantabria;053;Polaciones;221;140;81;2020
39;Cantabria;054;Polanco;5942;2942;3000;2020
39;Cantabria;055;Potes;1332;648;684;2020
39;Cantabria;056;Puente Viesgo;2845;1435;1410;2020
39;Cantabria;057;Ramales de la Victoria;2877;1444;1433;2020
39;Cantabria;058;Rasines;955;489;466;2020
39;Cantabria;059;Reinosa;8946;4228;4718;2020
39;Cantabria;060;Reocín;8399;4151;4248;2020
39;Cantabria;061;Ribamontán al Mar;4478;2284;2194;2020
39;Cantabria;062;Ribamontán al Monte;2303;1189;1114;2020
39;Cantabria;063;Rionansa;1029;567;462;2020
39;Cantabria;064;Riotuerto;1611;778;833;2020
39;Cantabria;065;Rozas de Valdearroyo, Las;247;137;110;2020
39;Cantabria;066;Ruente;1011;543;468;2020
39;Cantabria;067;Ruesga;836;459;377;2020
39;Cantabria;068;Ruiloba;722;368;354;2020
39;Cantabria;069;San Felices de Buelna;2367;1198;1169;2020
39;Cantabria;070;San Miguel de Aguayo;145;74;71;2020
39;Cantabria;071;San Pedro del Romeral;474;263;211;2020
39;Cantabria;072;San Roque de Riomiera;345;202;143;2020
39;Cantabria;080;San Vicente de la Barquera;4095;2007;2088;2020
39;Cantabria;073;Santa Cruz de Bezana;13088;6439;6649;2020
39;Cantabria;074;Santa María de Cayón;9167;4561;4606;2020
39;Cantabria;075;Santander;173375;79936;93439;2020
39;Cantabria;076;Santillana del Mar;4229;2056;2173;2020
39;Cantabria;077;Santiurde de Reinosa;255;148;107;2020
39;Cantabria;078;Santiurde de Toranzo;1646;865;781;2020
39;Cantabria;079;Santoña;11019;5345;5674;2020
39;Cantabria;081;Saro;516;269;247;2020
39;Cantabria;082;Selaya;1873;942;931;2020
39;Cantabria;083;Soba;1155;641;514;2020
39;Cantabria;084;Solórzano;1046;558;488;2020
39;Cantabria;085;Suances;8827;4331;4496;2020
39;Cantabria;086;Tojos, Los;387;230;157;2020
39;Cantabria;087;Torrelavega;51597;24365;27232;2020
39;Cantabria;088;Tresviso;59;42;17;2020
39;Cantabria;089;Tudanca;135;97;38;2020
39;Cantabria;090;Udías;928;471;457;2020
39;Cantabria;095;Val de San Vicente;2758;1414;1344;2020
39;Cantabria;091;Valdáliga;2150;1124;1026;2020
39;Cantabria;092;Valdeolea;939;500;439;2020
39;Cantabria;093;Valdeprado del Río;325;179;146;2020
39;Cantabria;094;Valderredible;950;543;407;2020
39;Cantabria;101;Valle de Villaverde;274;155;119;2020
39;Cantabria;096;Vega de Liébana;719;380;339;2020
39;Cantabria;097;Vega de Pas;746;401;345;2020
39;Cantabria;098;Villacarriedo;1612;844;768;2020
39;Cantabria;099;Villaescusa;3933;1926;2007;2020
39;Cantabria;100;Villafufre;994;523;471;2020
39;Cantabria;102;Voto;2686;1449;1237;2020
12;Castellón/Castelló;002;Aín;123;64;59;2020
12;Castellón/Castelló;003;Albocàsser;1227;618;609;2020
12;Castellón/Castelló;004;Alcalà de Xivert;6638;3407;3231;2020
12;Castellón/Castelló;005;Alcora, l';10417;5266;5151;2020
12;Castellón/Castelló;006;Alcudia de Veo;188;102;86;2020
12;Castellón/Castelló;007;Alfondeguilla;862;435;427;2020
12;Castellón/Castelló;008;Algimia de Almonacid;262;146;116;2020
12;Castellón/Castelló;009;Almassora;26742;13459;13283;2020
12;Castellón/Castelló;010;Almedíjar;244;136;108;2020
12;Castellón/Castelló;011;Almenara;6090;3064;3026;2020
12;Castellón/Castelló;901;Alqueries, les/Alquerías del Niño Perdido;4464;2230;2234;2020
12;Castellón/Castelló;012;Altura;3601;1863;1738;2020
12;Castellón/Castelló;013;Arañuel;151;80;71;2020
12;Castellón/Castelló;014;Ares del Maestrat;184;107;77;2020
12;Castellón/Castelló;015;Argelita;126;74;52;2020
12;Castellón/Castelló;016;Artana;1955;986;969;2020
12;Castellón/Castelló;001;Atzeneta del Maestrat;1304;653;651;2020
12;Castellón/Castelló;017;Ayódar;153;82;71;2020
12;Castellón/Castelló;018;Azuébar;310;164;146;2020
12;Castellón/Castelló;020;Barracas;168;100;68;2020
12;Castellón/Castelló;022;Bejís;371;210;161;2020
12;Castellón/Castelló;024;Benafer;164;87;77;2020
12;Castellón/Castelló;025;Benafigos;138;82;56;2020
12;Castellón/Castelló;026;Benassal;1063;543;520;2020
12;Castellón/Castelló;027;Benicarló;27363;13635;13728;2020
12;Castellón/Castelló;028;Benicasim/Benicàssim;18364;9113;9251;2020
12;Castellón/Castelló;029;Benlloc;1048;525;523;2020
12;Castellón/Castelló;021;Betxí;5618;2778;2840;2020
12;Castellón/Castelló;032;Borriana/Burriana;35052;17420;17632;2020
12;Castellón/Castelló;031;Borriol;5397;2756;2641;2020
12;Castellón/Castelló;033;Cabanes;2978;1507;1471;2020
12;Castellón/Castelló;034;Càlig;1961;998;963;2020
12;Castellón/Castelló;036;Canet lo Roig;676;337;339;2020
12;Castellón/Castelló;037;Castell de Cabres;22;13;9;2020
12;Castellón/Castelló;038;Castellfort;179;96;83;2020
12;Castellón/Castelló;039;Castellnovo;918;465;453;2020
12;Castellón/Castelló;040;Castelló de la Plana;174264;84319;89945;2020
12;Castellón/Castelló;041;Castillo de Villamalefa;101;68;33;2020
12;Castellón/Castelló;042;Catí;714;359;355;2020
12;Castellón/Castelló;043;Caudiel;659;341;318;2020
12;Castellón/Castelló;044;Cervera del Maestre;557;268;289;2020
12;Castellón/Castelló;053;Chilches/Xilxes;2714;1407;1307;2020
12;Castellón/Castelló;055;Chodos/Xodos;106;65;41;2020
12;Castellón/Castelló;056;Chóvar;288;148;140;2020
12;Castellón/Castelló;045;Cinctorres;400;198;202;2020
12;Castellón/Castelló;046;Cirat;206;114;92;2020
12;Castellón/Castelló;048;Cortes de Arenoso;300;161;139;2020
12;Castellón/Castelló;049;Costur;518;272;246;2020
12;Castellón/Castelló;050;Coves de Vinromà, les;1806;904;902;2020
12;Castellón/Castelló;051;Culla;481;241;240;2020
12;Castellón/Castelló;057;Eslida;725;367;358;2020
12;Castellón/Castelló;058;Espadilla;69;42;27;2020
12;Castellón/Castelló;059;Fanzara;273;140;133;2020
12;Castellón/Castelló;060;Figueroles;523;261;262;2020
12;Castellón/Castelló;061;Forcall;456;223;233;2020
12;Castellón/Castelló;063;Fuente la Reina;51;29;22;2020
12;Castellón/Castelló;064;Fuentes de Ayódar;89;52;37;2020
12;Castellón/Castelló;065;Gaibiel;181;97;84;2020
12;Castellón/Castelló;067;Geldo;633;313;320;2020
12;Castellón/Castelló;068;Herbés;44;26;18;2020
12;Castellón/Castelló;069;Higueras;48;25;23;2020
12;Castellón/Castelló;070;Jana, la;676;346;330;2020
12;Castellón/Castelló;071;Jérica;1559;801;758;2020
12;Castellón/Castelló;074;Llosa, la;982;479;503;2020
12;Castellón/Castelló;072;Llucena/Lucena del Cid;1315;655;660;2020
12;Castellón/Castelló;073;Ludiente;149;82;67;2020
12;Castellón/Castelló;075;Mata de Morella, la;160;88;72;2020
12;Castellón/Castelló;076;Matet;83;45;38;2020
12;Castellón/Castelló;077;Moncofa;6707;3459;3248;2020
12;Castellón/Castelló;078;Montán;368;183;185;2020
12;Castellón/Castelló;079;Montanejos;564;292;272;2020
12;Castellón/Castelló;080;Morella;2416;1184;1232;2020
12;Castellón/Castelló;081;Navajas;720;373;347;2020
12;Castellón/Castelló;082;Nules;13236;6631;6605;2020
12;Castellón/Castelló;083;Olocau del Rey;120;64;56;2020
12;Castellón/Castelló;084;Onda;24980;12484;12496;2020
12;Castellón/Castelló;085;Oropesa del Mar/Orpesa;9339;4751;4588;2020
12;Castellón/Castelló;087;Palanques;34;20;14;2020
12;Castellón/Castelló;088;Pavías;68;43;25;2020
12;Castellón/Castelló;089;Peníscola/Peñíscola;7683;3887;3796;2020
12;Castellón/Castelló;090;Pina de Montalgrao;110;57;53;2020
12;Castellón/Castelló;093;Pobla de Benifassà, la;199;113;86;2020
12;Castellón/Castelló;094;Pobla Tornesa, la;1212;620;592;2020
12;Castellón/Castelló;091;Portell de Morella;188;94;94;2020
12;Castellón/Castelló;092;Puebla de Arenoso;152;81;71;2020
12;Castellón/Castelló;095;Ribesalbes;1163;602;561;2020
12;Castellón/Castelló;096;Rossell;912;482;430;2020
12;Castellón/Castelló;097;Sacañet;62;42;20;2020
12;Castellón/Castelló;098;Salzadella, la;700;361;339;2020
12;Castellón/Castelló;101;San Rafael del Río;466;233;233;2020
12;Castellón/Castelló;902;Sant Joan de Moró;3232;1676;1556;2020
12;Castellón/Castelló;099;Sant Jordi/San Jorge;990;524;466;2020
12;Castellón/Castelló;100;Sant Mateu;1952;969;983;2020
12;Castellón/Castelló;102;Santa Magdalena de Pulpis;754;391;363;2020
12;Castellón/Castelló;104;Segorbe;9097;4509;4588;2020
12;Castellón/Castelló;103;Serratella, la;95;49;46;2020
12;Castellón/Castelló;105;Sierra Engarcerán;988;520;468;2020
12;Castellón/Castelló;106;Soneja;1456;720;736;2020
12;Castellón/Castelló;107;Sot de Ferrer;409;211;198;2020
12;Castellón/Castelló;108;Sueras/Suera;524;277;247;2020
12;Castellón/Castelló;109;Tales;801;409;392;2020
12;Castellón/Castelló;110;Teresa;247;132;115;2020
12;Castellón/Castelló;111;Tírig;420;213;207;2020
12;Castellón/Castelló;112;Todolella;141;84;57;2020
12;Castellón/Castelló;113;Toga;96;50;46;2020
12;Castellón/Castelló;114;Torás;232;128;104;2020
12;Castellón/Castelló;115;Toro, El;241;136;105;2020
12;Castellón/Castelló;116;Torralba del Pinar;61;27;34;2020
12;Castellón/Castelló;119;Torre d'En Besora, la;167;95;72;2020
12;Castellón/Castelló;120;Torre d'en Doménec, la;162;84;78;2020
12;Castellón/Castelló;117;Torreblanca;5574;2835;2739;2020
12;Castellón/Castelló;118;Torrechiva;89;48;41;2020
12;Castellón/Castelló;121;Traiguera;1367;694;673;2020
12;Castellón/Castelló;122;Useras/Useres, les;959;498;461;2020
12;Castellón/Castelló;124;Vall d'Alba;2856;1495;1361;2020
12;Castellón/Castelló;125;Vall de Almonacid;263;130;133;2020
12;Castellón/Castelló;126;Vall d'Uixó, la;31681;15613;16068;2020
12;Castellón/Castelló;123;Vallat;51;25;26;2020
12;Castellón/Castelló;127;Vallibona;66;39;27;2020
12;Castellón/Castelló;128;Vilafamés;1829;1000;829;2020
12;Castellón/Castelló;129;Vilafranca/Villafranca del Cid;2197;1086;1111;2020
12;Castellón/Castelló;132;Vilanova d'Alcolea;569;293;276;2020
12;Castellón/Castelló;134;Vilar de Canes;169;88;81;2020
12;Castellón/Castelló;135;Vila-real;51293;25488;25805;2020
12;Castellón/Castelló;136;Vilavella, la;3125;1554;1571;2020
12;Castellón/Castelló;130;Villahermosa del Río;484;271;213;2020
12;Castellón/Castelló;131;Villamalur;102;65;37;2020
12;Castellón/Castelló;133;Villanueva de Viver;60;33;27;2020
12;Castellón/Castelló;137;Villores;42;21;21;2020
12;Castellón/Castelló;138;Vinaròs;28833;14238;14595;2020
12;Castellón/Castelló;139;Vistabella del Maestrat;333;184;149;2020
12;Castellón/Castelló;140;Viver;1572;823;749;2020
12;Castellón/Castelló;052;Xert;688;332;356;2020
12;Castellón/Castelló;141;Zorita del Maestrazgo;111;58;53;2020
12;Castellón/Castelló;142;Zucaina;162;91;71;2020
51;Ceuta;001;Ceuta;84202;42542;41660;2020
13;Ciudad Real;001;Abenójar;1351;701;650;2020
13;Ciudad Real;002;Agudo;1657;832;825;2020
13;Ciudad Real;003;Alamillo;476;246;230;2020
13;Ciudad Real;004;Albaladejo;1108;568;540;2020
13;Ciudad Real;005;Alcázar de San Juan;30766;14979;15787;2020
13;Ciudad Real;006;Alcoba;542;276;266;2020
13;Ciudad Real;007;Alcolea de Calatrava;1387;707;680;2020
13;Ciudad Real;008;Alcubillas;461;226;235;2020
13;Ciudad Real;009;Aldea del Rey;1631;824;807;2020
13;Ciudad Real;010;Alhambra;1005;507;498;2020
13;Ciudad Real;011;Almadén;5200;2475;2725;2020
13;Ciudad Real;012;Almadenejos;405;212;193;2020
13;Ciudad Real;013;Almagro;8905;4389;4516;2020
13;Ciudad Real;014;Almedina;500;270;230;2020
13;Ciudad Real;015;Almodóvar del Campo;5983;3008;2975;2020
13;Ciudad Real;016;Almuradiel;761;372;389;2020
13;Ciudad Real;017;Anchuras;295;154;141;2020
13;Ciudad Real;903;Arenales de San Gregorio;588;305;283;2020
13;Ciudad Real;018;Arenas de San Juan;1011;514;497;2020
13;Ciudad Real;019;Argamasilla de Alba;6955;3499;3456;2020
13;Ciudad Real;020;Argamasilla de Calatrava;5841;2920;2921;2020
13;Ciudad Real;021;Arroba de los Montes;421;231;190;2020
13;Ciudad Real;022;Ballesteros de Calatrava;376;190;186;2020
13;Ciudad Real;023;Bolaños de Calatrava;12019;6174;5845;2020
13;Ciudad Real;024;Brazatortas;995;513;482;2020
13;Ciudad Real;025;Cabezarados;312;168;144;2020
13;Ciudad Real;026;Cabezarrubias del Puerto;473;249;224;2020
13;Ciudad Real;027;Calzada de Calatrava;3630;1802;1828;2020
13;Ciudad Real;028;Campo de Criptana;13312;6642;6670;2020
13;Ciudad Real;029;Cañada de Calatrava;100;58;42;2020
13;Ciudad Real;030;Caracuel de Calatrava;122;69;53;2020
13;Ciudad Real;031;Carrión de Calatrava;3099;1552;1547;2020
13;Ciudad Real;032;Carrizosa;1188;611;577;2020
13;Ciudad Real;033;Castellar de Santiago;1862;956;906;2020
13;Ciudad Real;038;Chillón;1790;867;923;2020
13;Ciudad Real;034;Ciudad Real;75504;35773;39731;2020
13;Ciudad Real;035;Corral de Calatrava;1117;537;580;2020
13;Ciudad Real;036;Cortijos, Los;877;470;407;2020
13;Ciudad Real;037;Cózar;952;483;469;2020
13;Ciudad Real;039;Daimiel;17916;8980;8936;2020
13;Ciudad Real;040;Fernán Caballero;985;503;482;2020
13;Ciudad Real;041;Fontanarejo;253;144;109;2020
13;Ciudad Real;042;Fuencaliente;1024;528;496;2020
13;Ciudad Real;043;Fuenllana;211;112;99;2020
13;Ciudad Real;044;Fuente el Fresno;3208;1657;1551;2020
13;Ciudad Real;045;Granátula de Calatrava;717;356;361;2020
13;Ciudad Real;046;Guadalmez;697;334;363;2020
13;Ciudad Real;047;Herencia;8456;4311;4145;2020
13;Ciudad Real;048;Hinojosas de Calatrava;522;269;253;2020
13;Ciudad Real;049;Horcajo de los Montes;833;432;401;2020
13;Ciudad Real;050;Labores, Las;558;281;277;2020
13;Ciudad Real;904;Llanos del Caudillo;683;337;346;2020
13;Ciudad Real;051;Luciana;364;198;166;2020
13;Ciudad Real;052;Malagón;7881;3880;4001;2020
13;Ciudad Real;053;Manzanares;17962;8892;9070;2020
13;Ciudad Real;054;Membrilla;5942;2984;2958;2020
13;Ciudad Real;055;Mestanza;669;343;326;2020
13;Ciudad Real;056;Miguelturra;15498;7792;7706;2020
13;Ciudad Real;057;Montiel;1294;676;618;2020
13;Ciudad Real;058;Moral de Calatrava;5208;2640;2568;2020
13;Ciudad Real;059;Navalpino;221;116;105;2020
13;Ciudad Real;060;Navas de Estena;293;162;131;2020
13;Ciudad Real;061;Pedro Muñoz;7285;3672;3613;2020
13;Ciudad Real;062;Picón;668;345;323;2020
13;Ciudad Real;063;Piedrabuena;4379;2226;2153;2020
13;Ciudad Real;064;Poblete;2667;1375;1292;2020
13;Ciudad Real;065;Porzuna;3465;1781;1684;2020
13;Ciudad Real;066;Pozuelo de Calatrava;3586;1833;1753;2020
13;Ciudad Real;067;Pozuelos de Calatrava, Los;359;189;170;2020
13;Ciudad Real;068;Puebla de Don Rodrigo;1162;639;523;2020
13;Ciudad Real;069;Puebla del Príncipe;686;358;328;2020
13;Ciudad Real;070;Puerto Lápice;891;445;446;2020
13;Ciudad Real;071;Puertollano;46607;22549;24058;2020
13;Ciudad Real;072;Retuerta del Bullaque;927;509;418;2020
13;Ciudad Real;901;Robledo, El;1053;551;502;2020
13;Ciudad Real;902;Ruidera;549;268;281;2020
13;Ciudad Real;073;Saceruela;564;298;266;2020
13;Ciudad Real;074;San Carlos del Valle;1109;566;543;2020
13;Ciudad Real;075;San Lorenzo de Calatrava;207;116;91;2020
13;Ciudad Real;076;Santa Cruz de los Cáñamos;515;249;266;2020
13;Ciudad Real;077;Santa Cruz de Mudela;4085;2026;2059;2020
13;Ciudad Real;078;Socuéllamos;12079;6090;5989;2020
13;Ciudad Real;080;Solana del Pino;314;168;146;2020
13;Ciudad Real;079;Solana, La;15419;7807;7612;2020
13;Ciudad Real;081;Terrinches;653;338;315;2020
13;Ciudad Real;082;Tomelloso;36168;17972;18196;2020
13;Ciudad Real;083;Torralba de Calatrava;2966;1482;1484;2020
13;Ciudad Real;084;Torre de Juan Abad;1000;491;509;2020
13;Ciudad Real;085;Torrenueva;2667;1336;1331;2020
13;Ciudad Real;086;Valdemanco del Esteras;168;88;80;2020
13;Ciudad Real;087;Valdepeñas;30252;14766;15486;2020
13;Ciudad Real;088;Valenzuela de Calatrava;674;312;362;2020
13;Ciudad Real;089;Villahermosa;1790;877;913;2020
13;Ciudad Real;090;Villamanrique;1128;553;575;2020
13;Ciudad Real;091;Villamayor de Calatrava;620;310;310;2020
13;Ciudad Real;092;Villanueva de la Fuente;2033;1043;990;2020
13;Ciudad Real;093;Villanueva de los Infantes;4869;2427;2442;2020
13;Ciudad Real;094;Villanueva de San Carlos;291;154;137;2020
13;Ciudad Real;095;Villar del Pozo;61;34;27;2020
13;Ciudad Real;096;Villarrubia de los Ojos;9762;4867;4895;2020
13;Ciudad Real;097;Villarta de San Juan;2739;1382;1357;2020
13;Ciudad Real;098;Viso del Marqués;2256;1094;1162;2020
14;Córdoba;001;Adamuz;4137;2124;2013;2020
14;Córdoba;002;Aguilar de la Frontera;13382;6679;6703;2020
14;Córdoba;003;Alcaracejos;1470;717;753;2020
14;Córdoba;004;Almedinilla;2370;1183;1187;2020
14;Córdoba;005;Almodóvar del Río;7932;3961;3971;2020
14;Córdoba;006;Añora;1530;757;773;2020
14;Córdoba;007;Baena;19045;9620;9425;2020
14;Córdoba;008;Belalcázar;3235;1563;1672;2020
14;Córdoba;009;Belmez;2921;1420;1501;2020
14;Córdoba;010;Benamejí;4963;2467;2496;2020
14;Córdoba;011;Blázquez, Los;664;339;325;2020
14;Córdoba;012;Bujalance;7320;3641;3679;2020
14;Córdoba;013;Cabra;20347;9931;10416;2020
14;Córdoba;014;Cañete de las Torres;2923;1509;1414;2020
14;Córdoba;015;Carcabuey;2371;1203;1168;2020
14;Córdoba;016;Cardeña;1471;735;736;2020
14;Córdoba;017;Carlota, La;14079;7020;7059;2020
14;Córdoba;018;Carpio, El;4363;2159;2204;2020
14;Córdoba;019;Castro del Río;7767;3835;3932;2020
14;Córdoba;020;Conquista;366;182;184;2020
14;Córdoba;021;Córdoba;326039;156523;169516;2020
14;Córdoba;022;Doña Mencía;4615;2244;2371;2020
14;Córdoba;023;Dos Torres;2394;1192;1202;2020
14;Córdoba;024;Encinas Reales;2254;1117;1137;2020
14;Córdoba;025;Espejo;3289;1651;1638;2020
14;Córdoba;026;Espiel;2405;1206;1199;2020
14;Córdoba;027;Fernán-Núñez;9651;4828;4823;2020
14;Córdoba;901;Fuente Carreteros;1148;592;556;2020
14;Córdoba;028;Fuente la Lancha;342;171;171;2020
14;Córdoba;029;Fuente Obejuna;4501;2324;2177;2020
14;Córdoba;030;Fuente Palmera;9766;4871;4895;2020
14;Córdoba;031;Fuente-Tójar;666;323;343;2020
14;Córdoba;032;Granjuela, La;439;222;217;2020
14;Córdoba;033;Guadalcázar;1559;780;779;2020
14;Córdoba;902;Guijarrosa, La;1379;702;677;2020
14;Córdoba;034;Guijo, El;352;181;171;2020
14;Córdoba;035;Hinojosa del Duque;6707;3305;3402;2020
14;Córdoba;036;Hornachuelos;4480;2234;2246;2020
14;Córdoba;037;Iznájar;4134;2078;2056;2020
14;Córdoba;038;Lucena;42733;21259;21474;2020
14;Córdoba;039;Luque;2976;1499;1477;2020
14;Córdoba;040;Montalbán de Córdoba;4467;2203;2264;2020
14;Córdoba;041;Montemayor;3856;1925;1931;2020
14;Córdoba;042;Montilla;22739;11293;11446;2020
14;Córdoba;043;Montoro;9293;4591;4702;2020
14;Córdoba;044;Monturque;1943;963;980;2020
14;Córdoba;045;Moriles;3701;1863;1838;2020
14;Córdoba;046;Nueva Carteya;5341;2715;2626;2020
14;Córdoba;047;Obejo;2008;1057;951;2020
14;Córdoba;048;Palenciana;1465;741;724;2020
14;Córdoba;049;Palma del Río;20928;10406;10522;2020
14;Córdoba;050;Pedro Abad;2815;1420;1395;2020
14;Córdoba;051;Pedroche;1482;738;744;2020
14;Córdoba;052;Peñarroya-Pueblonuevo;10561;5106;5455;2020
14;Córdoba;053;Posadas;7318;3625;3693;2020
14;Córdoba;054;Pozoblanco;17204;8360;8844;2020
14;Córdoba;055;Priego de Córdoba;22367;10919;11448;2020
14;Córdoba;056;Puente Genil;29943;14827;15116;2020
14;Córdoba;057;Rambla, La;7529;3743;3786;2020
14;Córdoba;058;Rute;9898;4936;4962;2020
14;Córdoba;059;San Sebastián de los Ballesteros;804;408;396;2020
14;Córdoba;061;Santa Eufemia;743;372;371;2020
14;Córdoba;060;Santaella;4614;2316;2298;2020
14;Córdoba;062;Torrecampo;1040;510;530;2020
14;Córdoba;063;Valenzuela;1118;561;557;2020
14;Córdoba;064;Valsequillo;348;170;178;2020
14;Córdoba;065;Victoria, La;2289;1142;1147;2020
14;Córdoba;066;Villa del Río;7067;3510;3557;2020
14;Córdoba;067;Villafranca de Córdoba;4860;2489;2371;2020
14;Córdoba;068;Villaharta;621;304;317;2020
14;Córdoba;069;Villanueva de Córdoba;8671;4309;4362;2020
14;Córdoba;070;Villanueva del Duque;1448;739;709;2020
14;Córdoba;071;Villanueva del Rey;1015;496;519;2020
14;Córdoba;072;Villaralto;1118;566;552;2020
14;Córdoba;073;Villaviciosa de Córdoba;3200;1640;1560;2020
14;Córdoba;074;Viso, El;2517;1256;1261;2020
14;Córdoba;075;Zuheros;635;320;315;2020
15;Coruña, A;001;Abegondo;5398;2665;2733;2020
15;Coruña, A;002;Ames;32104;15444;16660;2020
15;Coruña, A;003;Aranga;1834;948;886;2020
15;Coruña, A;004;Ares;5829;2859;2970;2020
15;Coruña, A;005;Arteixo;32738;16251;16487;2020
15;Coruña, A;006;Arzúa;6011;2996;3015;2020
15;Coruña, A;007;Baña, A;3415;1611;1804;2020
15;Coruña, A;008;Bergondo;6661;3242;3419;2020
15;Coruña, A;009;Betanzos;13053;6189;6864;2020
15;Coruña, A;010;Boimorto;1959;988;971;2020
15;Coruña, A;011;Boiro;18884;9176;9708;2020
15;Coruña, A;012;Boqueixón;4206;2075;2131;2020
15;Coruña, A;013;Brión;7923;3805;4118;2020
15;Coruña, A;014;Cabana de Bergantiños;4216;2033;2183;2020
15;Coruña, A;015;Cabanas;3274;1598;1676;2020
15;Coruña, A;016;Camariñas;5209;2540;2669;2020
15;Coruña, A;017;Cambre;24594;11953;12641;2020
15;Coruña, A;018;Capela, A;1221;605;616;2020
15;Coruña, A;019;Carballo;31429;15377;16052;2020
15;Coruña, A;901;Cariño;3775;1872;1903;2020
15;Coruña, A;020;Carnota;3899;1844;2055;2020
15;Coruña, A;021;Carral;6473;3176;3297;2020
15;Coruña, A;022;Cedeira;6676;3326;3350;2020
15;Coruña, A;023;Cee;7550;3606;3944;2020
15;Coruña, A;024;Cerceda;5008;2474;2534;2020
15;Coruña, A;025;Cerdido;1087;532;555;2020
15;Coruña, A;027;Coirós;1853;920;933;2020
15;Coruña, A;028;Corcubión;1590;783;807;2020
15;Coruña, A;029;Coristanco;5950;2851;3099;2020
15;Coruña, A;030;Coruña, A;247604;114776;132828;2020
15;Coruña, A;031;Culleredo;30685;14804;15881;2020
15;Coruña, A;032;Curtis;4053;2042;2011;2020
15;Coruña, A;033;Dodro;2750;1324;1426;2020
15;Coruña, A;034;Dumbría;2935;1410;1525;2020
15;Coruña, A;035;Fene;12868;6150;6718;2020
15;Coruña, A;036;Ferrol;65560;30885;34675;2020
15;Coruña, A;037;Fisterra;4697;2381;2316;2020
15;Coruña, A;038;Frades;2302;1146;1156;2020
15;Coruña, A;039;Irixoa;1340;674;666;2020
15;Coruña, A;041;Laracha, A;11406;5619;5787;2020
15;Coruña, A;040;Laxe;2990;1501;1489;2020
15;Coruña, A;042;Lousame;3268;1624;1644;2020
15;Coruña, A;043;Malpica de Bergantiños;5352;2620;2732;2020
15;Coruña, A;044;Mañón;1319;651;668;2020
15;Coruña, A;045;Mazaricos;3841;1821;2020;2020
15;Coruña, A;046;Melide;7419;3665;3754;2020
15;Coruña, A;047;Mesía;2497;1236;1261;2020
15;Coruña, A;048;Miño;6277;3144;3133;2020
15;Coruña, A;049;Moeche;1186;569;617;2020
15;Coruña, A;050;Monfero;1907;984;923;2020
15;Coruña, A;051;Mugardos;5215;2534;2681;2020
15;Coruña, A;053;Muros;8427;4070;4357;2020
15;Coruña, A;052;Muxía;4596;2224;2372;2020
15;Coruña, A;054;Narón;39056;18879;20177;2020
15;Coruña, A;055;Neda;5023;2448;2575;2020
15;Coruña, A;056;Negreira;6788;3282;3506;2020
15;Coruña, A;057;Noia;14274;6840;7434;2020
15;Coruña, A;058;Oleiros;36534;17654;18880;2020
15;Coruña, A;059;Ordes;12625;6158;6467;2020
15;Coruña, A;060;Oroso;7533;3723;3810;2020
15;Coruña, A;061;Ortigueira;5633;2675;2958;2020
15;Coruña, A;062;Outes;6155;2965;3190;2020
15;Coruña, A;902;Oza-Cesuras;5096;2573;2523;2020
15;Coruña, A;064;Paderne;2383;1175;1208;2020
15;Coruña, A;065;Padrón;8366;4035;4331;2020
15;Coruña, A;066;Pino, O;4652;2348;2304;2020
15;Coruña, A;067;Pobra do Caramiñal, A;9318;4544;4774;2020
15;Coruña, A;068;Ponteceso;5497;2755;2742;2020
15;Coruña, A;069;Pontedeume;7753;3699;4054;2020
15;Coruña, A;070;Pontes de García Rodríguez, As;10068;4902;5166;2020
15;Coruña, A;071;Porto do Son;9142;4548;4594;2020
15;Coruña, A;072;Rianxo;11013;5368;5645;2020
15;Coruña, A;073;Ribeira;26848;13239;13609;2020
15;Coruña, A;074;Rois;4505;2137;2368;2020
15;Coruña, A;075;Sada;16186;7919;8267;2020
15;Coruña, A;076;San Sadurniño;2784;1378;1406;2020
15;Coruña, A;077;Santa Comba;9362;4536;4826;2020
15;Coruña, A;078;Santiago de Compostela;97848;45472;52376;2020
15;Coruña, A;079;Santiso;1544;802;742;2020
15;Coruña, A;080;Sobrado;1730;900;830;2020
15;Coruña, A;081;Somozas, As;1083;543;540;2020
15;Coruña, A;082;Teo;18632;9135;9497;2020
15;Coruña, A;083;Toques;1107;574;533;2020
15;Coruña, A;084;Tordoia;3259;1555;1704;2020
15;Coruña, A;085;Touro;3516;1748;1768;2020
15;Coruña, A;086;Trazo;3013;1485;1528;2020
15;Coruña, A;088;Val do Dubra;3851;1846;2005;2020
15;Coruña, A;087;Valdoviño;6542;3175;3367;2020
15;Coruña, A;089;Vedra;5007;2462;2545;2020
15;Coruña, A;091;Vilarmaior;1209;618;591;2020
15;Coruña, A;090;Vilasantar;1211;633;578;2020
15;Coruña, A;092;Vimianzo;6963;3348;3615;2020
15;Coruña, A;093;Zas;4393;2112;2281;2020
16;Cuenca;001;Abia de la Obispalía;61;37;24;2020
16;Cuenca;002;Acebrón, El;231;111;120;2020
16;Cuenca;003;Alarcón;156;69;87;2020
16;Cuenca;004;Albaladejo del Cuende;245;133;112;2020
16;Cuenca;005;Albalate de las Nogueras;257;137;120;2020
16;Cuenca;006;Albendea;125;61;64;2020
16;Cuenca;007;Alberca de Záncara, La;1608;824;784;2020
16;Cuenca;008;Alcalá de la Vega;90;52;38;2020
16;Cuenca;009;Alcantud;48;27;21;2020
16;Cuenca;010;Alcázar del Rey;142;73;69;2020
16;Cuenca;011;Alcohujate;26;14;12;2020
16;Cuenca;012;Alconchel de la Estrella;85;49;36;2020
16;Cuenca;013;Algarra;24;11;13;2020
16;Cuenca;014;Aliaguilla;632;327;305;2020
16;Cuenca;015;Almarcha, La;378;207;171;2020
16;Cuenca;016;Almendros;239;134;105;2020
16;Cuenca;017;Almodóvar del Pinar;393;212;181;2020
16;Cuenca;018;Almonacid del Marquesado;432;221;211;2020
16;Cuenca;019;Altarejos;188;100;88;2020
16;Cuenca;020;Arandilla del Arroyo;7;5;2;2020
16;Cuenca;905;Arcas;1775;894;881;2020
16;Cuenca;022;Arcos de la Sierra;77;46;31;2020
16;Cuenca;024;Arguisuelas;136;69;67;2020
16;Cuenca;025;Arrancacepas;25;14;11;2020
16;Cuenca;026;Atalaya del Cañavate;98;52;46;2020
16;Cuenca;027;Barajas de Melo;940;505;435;2020
16;Cuenca;029;Barchín del Hoyo;95;61;34;2020
16;Cuenca;030;Bascuñana de San Pedro;23;20;3;2020
16;Cuenca;031;Beamud;39;20;19;2020
16;Cuenca;032;Belinchón;352;181;171;2020
16;Cuenca;033;Belmonte;1870;929;941;2020
16;Cuenca;034;Belmontejo;154;88;66;2020
16;Cuenca;035;Beteta;236;115;121;2020
16;Cuenca;036;Boniches;139;70;69;2020
16;Cuenca;038;Buciegas;32;22;10;2020
16;Cuenca;039;Buenache de Alarcón;463;243;220;2020
16;Cuenca;040;Buenache de la Sierra;105;59;46;2020
16;Cuenca;041;Buendía;408;219;189;2020
16;Cuenca;042;Campillo de Altobuey;1265;628;637;2020
16;Cuenca;043;Campillos-Paravientos;104;60;44;2020
16;Cuenca;044;Campillos-Sierra;38;18;20;2020
16;Cuenca;901;Campos del Paraíso;718;369;349;2020
16;Cuenca;045;Canalejas del Arroyo;177;97;80;2020
16;Cuenca;046;Cañada del Hoyo;232;120;112;2020
16;Cuenca;047;Cañada Juncosa;243;131;112;2020
16;Cuenca;048;Cañamares;457;251;206;2020
16;Cuenca;049;Cañavate, El;132;65;67;2020
16;Cuenca;050;Cañaveras;247;122;125;2020
16;Cuenca;051;Cañaveruelas;126;65;61;2020
16;Cuenca;052;Cañete;764;394;370;2020
16;Cuenca;053;Cañizares;432;233;199;2020
16;Cuenca;055;Carboneras de Guadazaón;795;409;386;2020
16;Cuenca;056;Cardenete;486;264;222;2020
16;Cuenca;057;Carrascosa;67;40;27;2020
16;Cuenca;058;Carrascosa de Haro;100;50;50;2020
16;Cuenca;060;Casas de Benítez;823;402;421;2020
16;Cuenca;061;Casas de Fernando Alonso;1140;593;547;2020
16;Cuenca;062;Casas de Garcimolina;29;19;10;2020
16;Cuenca;063;Casas de Guijarro;112;61;51;2020
16;Cuenca;064;Casas de Haro;827;439;388;2020
16;Cuenca;065;Casas de los Pinos;435;213;222;2020
16;Cuenca;066;Casasimarro;3103;1596;1507;2020
16;Cuenca;067;Castejón;135;74;61;2020
16;Cuenca;068;Castillejo de Iniesta;151;83;68;2020
16;Cuenca;070;Castillejo-Sierra;31;17;14;2020
16;Cuenca;072;Castillo de Garcimuñoz;131;76;55;2020
16;Cuenca;071;Castillo-Albaráñez;21;10;11;2020
16;Cuenca;073;Cervera del Llano;218;115;103;2020
16;Cuenca;023;Chillarón de Cuenca;632;327;305;2020
16;Cuenca;081;Chumillas;58;30;28;2020
16;Cuenca;074;Cierva, La;31;17;14;2020
16;Cuenca;078;Cuenca;54621;25956;28665;2020
16;Cuenca;079;Cueva del Hierro;32;22;10;2020
16;Cuenca;082;Enguídanos;313;162;151;2020
16;Cuenca;083;Fresneda de Altarejos;37;19;18;2020
16;Cuenca;084;Fresneda de la Sierra;51;29;22;2020
16;Cuenca;085;Frontera, La;148;79;69;2020
16;Cuenca;086;Fuente de Pedro Naharro;1215;632;583;2020
16;Cuenca;087;Fuentelespino de Haro;268;134;134;2020
16;Cuenca;088;Fuentelespino de Moya;104;56;48;2020
16;Cuenca;904;Fuentenava de Jábaga;489;261;228;2020
16;Cuenca;089;Fuentes;458;238;220;2020
16;Cuenca;091;Fuertescusa;60;33;27;2020
16;Cuenca;092;Gabaldón;178;104;74;2020
16;Cuenca;093;Garaballa;55;28;27;2020
16;Cuenca;094;Gascueña;143;82;61;2020
16;Cuenca;095;Graja de Campalbo;91;50;41;2020
16;Cuenca;096;Graja de Iniesta;358;190;168;2020
16;Cuenca;097;Henarejos;134;70;64;2020
16;Cuenca;098;Herrumblar, El;677;346;331;2020
16;Cuenca;099;Hinojosa, La;180;95;85;2020
16;Cuenca;100;Hinojosos, Los;784;390;394;2020
16;Cuenca;101;Hito, El;135;76;59;2020
16;Cuenca;102;Honrubia;1531;761;770;2020
16;Cuenca;103;Hontanaya;245;141;104;2020
16;Cuenca;104;Hontecillas;56;30;26;2020
16;Cuenca;106;Horcajo de Santiago;3504;1773;1731;2020
16;Cuenca;107;Huélamo;87;48;39;2020
16;Cuenca;108;Huelves;80;43;37;2020
16;Cuenca;109;Huérguina;51;28;23;2020
16;Cuenca;110;Huerta de la Obispalía;117;67;50;2020
16;Cuenca;111;Huerta del Marquesado;183;102;81;2020
16;Cuenca;112;Huete;1748;903;845;2020
16;Cuenca;113;Iniesta;4320;2119;2201;2020
16;Cuenca;115;Laguna del Marquesado;51;30;21;2020
16;Cuenca;116;Lagunaseca;66;39;27;2020
16;Cuenca;117;Landete;1249;636;613;2020
16;Cuenca;118;Ledaña;1561;765;796;2020
16;Cuenca;119;Leganiel;186;97;89;2020
16;Cuenca;121;Majadas, Las;234;123;111;2020
16;Cuenca;122;Mariana;298;154;144;2020
16;Cuenca;123;Masegosa;62;35;27;2020
16;Cuenca;124;Mesas, Las;2317;1188;1129;2020
16;Cuenca;125;Minglanilla;2198;1127;1071;2020
16;Cuenca;126;Mira;886;446;440;2020
16;Cuenca;128;Monreal del Llano;53;30;23;2020
16;Cuenca;129;Montalbanejo;99;51;48;2020
16;Cuenca;130;Montalbo;655;340;315;2020
16;Cuenca;131;Monteagudo de las Salinas;126;72;54;2020
16;Cuenca;132;Mota de Altarejos;31;20;11;2020
16;Cuenca;133;Mota del Cuervo;6055;3024;3031;2020
16;Cuenca;134;Motilla del Palancar;5917;2937;2980;2020
16;Cuenca;135;Moya;136;80;56;2020
16;Cuenca;137;Narboneta;38;22;16;2020
16;Cuenca;139;Olivares de Júcar;308;159;149;2020
16;Cuenca;140;Olmeda de la Cuesta;22;14;8;2020
16;Cuenca;141;Olmeda del Rey;131;66;65;2020
16;Cuenca;142;Olmedilla de Alarcón;146;84;62;2020
16;Cuenca;143;Olmedilla de Eliz;14;11;3;2020
16;Cuenca;145;Osa de la Vega;465;241;224;2020
16;Cuenca;146;Pajarón;79;37;42;2020
16;Cuenca;147;Pajaroncillo;63;38;25;2020
16;Cuenca;148;Palomares del Campo;572;294;278;2020
16;Cuenca;149;Palomera;160;79;81;2020
16;Cuenca;150;Paracuellos;93;49;44;2020
16;Cuenca;151;Paredes;58;34;24;2020
16;Cuenca;152;Parra de las Vegas, La;35;25;10;2020
16;Cuenca;153;Pedernoso, El;1140;563;577;2020
16;Cuenca;154;Pedroñeras, Las;6639;3397;3242;2020
16;Cuenca;155;Peral, El;640;357;283;2020
16;Cuenca;156;Peraleja, La;87;54;33;2020
16;Cuenca;157;Pesquera, La;202;111;91;2020
16;Cuenca;158;Picazo, El;673;345;328;2020
16;Cuenca;159;Pinarejo;203;105;98;2020
16;Cuenca;160;Pineda de Gigüela;58;36;22;2020
16;Cuenca;161;Piqueras del Castillo;48;27;21;2020
16;Cuenca;162;Portalrubio de Guadamejud;30;14;16;2020
16;Cuenca;163;Portilla;61;33;28;2020
16;Cuenca;165;Poyatos;53;27;26;2020
16;Cuenca;166;Pozoamargo;290;154;136;2020
16;Cuenca;908;Pozorrubielos de la Mancha;188;97;91;2020
16;Cuenca;167;Pozorrubio de Santiago;308;147;161;2020
16;Cuenca;169;Pozuelo, El;44;29;15;2020
16;Cuenca;170;Priego;896;454;442;2020
16;Cuenca;171;Provencio, El;2432;1209;1223;2020
16;Cuenca;172;Puebla de Almenara;344;183;161;2020
16;Cuenca;174;Puebla del Salvador;187;103;84;2020
16;Cuenca;175;Quintanar del Rey;7714;3976;3738;2020
16;Cuenca;176;Rada de Haro;57;33;24;2020
16;Cuenca;177;Reíllo;116;60;56;2020
16;Cuenca;181;Rozalén del Monte;65;31;34;2020
16;Cuenca;185;Saceda-Trasierra;43;30;13;2020
16;Cuenca;186;Saelices;458;236;222;2020
16;Cuenca;187;Salinas del Manzano;65;39;26;2020
16;Cuenca;188;Salmeroncillos;101;56;45;2020
16;Cuenca;189;Salvacañete;305;163;142;2020
16;Cuenca;190;San Clemente;7015;3528;3487;2020
16;Cuenca;191;San Lorenzo de la Parrilla;1040;539;501;2020
16;Cuenca;192;San Martín de Boniches;42;22;20;2020
16;Cuenca;193;San Pedro Palmiches;53;30;23;2020
16;Cuenca;194;Santa Cruz de Moya;207;110;97;2020
16;Cuenca;196;Santa María de los Llanos;686;361;325;2020
16;Cuenca;195;Santa María del Campo Rus;565;289;276;2020
16;Cuenca;197;Santa María del Val;68;40;28;2020
16;Cuenca;198;Sisante;1605;812;793;2020
16;Cuenca;199;Solera de Gabaldón;27;15;12;2020
16;Cuenca;909;Sotorribas;700;365;335;2020
16;Cuenca;202;Talayuelas;864;458;406;2020
16;Cuenca;203;Tarancón;15505;7685;7820;2020
16;Cuenca;204;Tébar;279;150;129;2020
16;Cuenca;205;Tejadillos;115;54;61;2020
16;Cuenca;206;Tinajas;194;104;90;2020
16;Cuenca;209;Torralba;111;67;44;2020
16;Cuenca;211;Torrejoncillo del Rey;351;187;164;2020
16;Cuenca;212;Torrubia del Campo;257;127;130;2020
16;Cuenca;213;Torrubia del Castillo;38;24;14;2020
16;Cuenca;215;Tragacete;250;141;109;2020
16;Cuenca;216;Tresjuncos;278;148;130;2020
16;Cuenca;217;Tribaldos;103;55;48;2020
16;Cuenca;218;Uclés;212;114;98;2020
16;Cuenca;219;Uña;79;41;38;2020
16;Cuenca;906;Valdecolmenas, Los;68;45;23;2020
16;Cuenca;224;Valdemeca;77;44;33;2020
16;Cuenca;225;Valdemorillo de la Sierra;63;36;27;2020
16;Cuenca;227;Valdemoro-Sierra;108;62;46;2020
16;Cuenca;228;Valdeolivas;193;120;73;2020
16;Cuenca;902;Valdetórtola;126;73;53;2020
16;Cuenca;903;Valeras, Las;1494;793;701;2020
16;Cuenca;231;Valhermoso de la Fuente;52;25;27;2020
16;Cuenca;173;Valle de Altomira, El;182;97;85;2020
16;Cuenca;234;Valsalobre;22;12;10;2020
16;Cuenca;236;Valverde de Júcar;1084;550;534;2020
16;Cuenca;237;Valverdejo;88;47;41;2020
16;Cuenca;238;Vara de Rey;496;256;240;2020
16;Cuenca;239;Vega del Codorno;129;79;50;2020
16;Cuenca;240;Vellisca;100;60;40;2020
16;Cuenca;242;Villaconejos de Trabaque;332;168;164;2020
16;Cuenca;243;Villaescusa de Haro;481;244;237;2020
16;Cuenca;244;Villagarcía del Llano;747;378;369;2020
16;Cuenca;245;Villalba de la Sierra;444;219;225;2020
16;Cuenca;246;Villalba del Rey;513;277;236;2020
16;Cuenca;247;Villalgordo del Marquesado;82;43;39;2020
16;Cuenca;248;Villalpardo;1005;506;499;2020
16;Cuenca;249;Villamayor de Santiago;2521;1273;1248;2020
16;Cuenca;250;Villanueva de Guadamejud;68;42;26;2020
16;Cuenca;251;Villanueva de la Jara;2282;1161;1121;2020
16;Cuenca;253;Villar de Cañas;375;198;177;2020
16;Cuenca;254;Villar de Domingo García;212;101;111;2020
16;Cuenca;255;Villar de la Encina;148;82;66;2020
16;Cuenca;263;Villar de Olalla;1285;684;601;2020
16;Cuenca;258;Villar del Humo;191;102;89;2020
16;Cuenca;259;Villar del Infantado;44;25;19;2020
16;Cuenca;910;Villar y Velasco;75;43;32;2020
16;Cuenca;264;Villarejo de Fuentes;418;209;209;2020
16;Cuenca;265;Villarejo de la Peñuela;22;11;11;2020
16;Cuenca;266;Villarejo-Periesteban;382;190;192;2020
16;Cuenca;269;Villares del Saz;414;211;203;2020
16;Cuenca;270;Villarrubio;191;107;84;2020
16;Cuenca;271;Villarta;843;412;431;2020
16;Cuenca;272;Villas de la Ventosa;213;122;91;2020
16;Cuenca;273;Villaverde y Pasaconsol;328;172;156;2020
16;Cuenca;274;Víllora;109;58;51;2020
16;Cuenca;275;Vindel;11;7;4;2020
16;Cuenca;276;Yémeda;18;12;6;2020
16;Cuenca;277;Zafra de Záncara;110;61;49;2020
16;Cuenca;278;Zafrilla;56;29;27;2020
16;Cuenca;279;Zarza de Tajo;266;148;118;2020
16;Cuenca;280;Zarzuela;169;88;81;2020
20;Gipuzkoa;001;Abaltzisketa;318;175;143;2020
20;Gipuzkoa;002;Aduna;472;254;218;2020
20;Gipuzkoa;016;Aia;2039;1078;961;2020
20;Gipuzkoa;003;Aizarnazabal;779;395;384;2020
20;Gipuzkoa;004;Albiztur;302;156;146;2020
20;Gipuzkoa;005;Alegia;1768;909;859;2020
20;Gipuzkoa;006;Alkiza;371;180;191;2020
20;Gipuzkoa;906;Altzaga;178;86;92;2020
20;Gipuzkoa;007;Altzo;460;237;223;2020
20;Gipuzkoa;008;Amezketa;935;501;434;2020
20;Gipuzkoa;009;Andoain;14691;7296;7395;2020
20;Gipuzkoa;010;Anoeta;2085;1076;1009;2020
20;Gipuzkoa;011;Antzuola;2102;1053;1049;2020
20;Gipuzkoa;012;Arama;202;99;103;2020
20;Gipuzkoa;013;Aretxabaleta;7103;3581;3522;2020
20;Gipuzkoa;055;Arrasate/Mondragón;22073;10833;11240;2020
20;Gipuzkoa;014;Asteasu;1561;802;759;2020
20;Gipuzkoa;903;Astigarraga;7029;3578;3451;2020
20;Gipuzkoa;015;Ataun;1696;877;819;2020
20;Gipuzkoa;017;Azkoitia;11627;5783;5844;2020
20;Gipuzkoa;018;Azpeitia;15106;7547;7559;2020
20;Gipuzkoa;904;Baliarrain;153;86;67;2020
20;Gipuzkoa;019;Beasain;13938;7003;6935;2020
20;Gipuzkoa;020;Beizama;146;88;58;2020
20;Gipuzkoa;021;Belauntza;243;132;111;2020
20;Gipuzkoa;022;Berastegi;1075;553;522;2020
20;Gipuzkoa;074;Bergara;14659;7267;7392;2020
20;Gipuzkoa;023;Berrobi;601;318;283;2020
20;Gipuzkoa;024;Bidania-Goiatz;525;285;240;2020
20;Gipuzkoa;029;Deba;5460;2707;2753;2020
20;Gipuzkoa;069;Donostia/San Sebastián;188240;88825;99415;2020
20;Gipuzkoa;030;Eibar;27769;13514;14255;2020
20;Gipuzkoa;031;Elduain;243;122;121;2020
20;Gipuzkoa;033;Elgeta;1131;572;559;2020
20;Gipuzkoa;032;Elgoibar;11570;5709;5861;2020
20;Gipuzkoa;067;Errenteria;39540;19112;20428;2020
20;Gipuzkoa;066;Errezil;578;306;272;2020
20;Gipuzkoa;034;Eskoriatza;4106;2045;2061;2020
20;Gipuzkoa;035;Ezkio-Itsaso;601;316;285;2020
20;Gipuzkoa;038;Gabiria;495;265;230;2020
20;Gipuzkoa;037;Gaintza;121;70;51;2020
20;Gipuzkoa;907;Gaztelu;154;81;73;2020
20;Gipuzkoa;039;Getaria;2796;1408;1388;2020
20;Gipuzkoa;040;Hernani;20438;9990;10448;2020
20;Gipuzkoa;041;Hernialde;303;161;142;2020
20;Gipuzkoa;036;Hondarribia;16881;8415;8466;2020
20;Gipuzkoa;042;Ibarra;4248;2111;2137;2020
20;Gipuzkoa;043;Idiazabal;2293;1157;1136;2020
20;Gipuzkoa;044;Ikaztegieta;479;247;232;2020
20;Gipuzkoa;045;Irun;62910;30759;32151;2020
20;Gipuzkoa;046;Irura;1852;978;874;2020
20;Gipuzkoa;047;Itsasondo;668;347;321;2020
20;Gipuzkoa;048;Larraul;256;144;112;2020
20;Gipuzkoa;902;Lasarte-Oria;18594;8999;9595;2020
20;Gipuzkoa;049;Lazkao;5830;2928;2902;2020
20;Gipuzkoa;050;Leaburu;386;204;182;2020
20;Gipuzkoa;051;Legazpi;8321;4204;4117;2020
20;Gipuzkoa;052;Legorreta;1421;722;699;2020
20;Gipuzkoa;068;Leintz-Gatzaga;217;120;97;2020
20;Gipuzkoa;053;Lezo;6103;3057;3046;2020
20;Gipuzkoa;054;Lizartza;617;325;292;2020
20;Gipuzkoa;901;Mendaro;1976;1000;976;2020
20;Gipuzkoa;057;Mutiloa;255;138;117;2020
20;Gipuzkoa;056;Mutriku;5309;2662;2647;2020
20;Gipuzkoa;063;Oiartzun;10309;5078;5231;2020
20;Gipuzkoa;058;Olaberria;957;484;473;2020
20;Gipuzkoa;059;Oñati;11497;5648;5849;2020
20;Gipuzkoa;076;Ordizia;10503;5222;5281;2020
20;Gipuzkoa;905;Orendain;227;111;116;2020
20;Gipuzkoa;060;Orexa;117;66;51;2020
20;Gipuzkoa;061;Orio;6091;3058;3033;2020
20;Gipuzkoa;062;Ormaiztegi;1258;634;624;2020
20;Gipuzkoa;064;Pasaia;16035;7716;8319;2020
20;Gipuzkoa;070;Segura;1494;748;746;2020
20;Gipuzkoa;065;Soraluze-Placencia de las Armas;3923;1969;1954;2020
20;Gipuzkoa;071;Tolosa;19816;9543;10273;2020
20;Gipuzkoa;072;Urnieta;6185;3108;3077;2020
20;Gipuzkoa;077;Urretxu;6782;3341;3441;2020
20;Gipuzkoa;073;Usurbil;6173;3088;3085;2020
20;Gipuzkoa;075;Villabona;5876;2939;2937;2020
20;Gipuzkoa;078;Zaldibia;1637;834;803;2020
20;Gipuzkoa;079;Zarautz;23360;11344;12016;2020
20;Gipuzkoa;025;Zegama;1524;768;756;2020
20;Gipuzkoa;026;Zerain;270;131;139;2020
20;Gipuzkoa;027;Zestoa;3772;1970;1802;2020
20;Gipuzkoa;028;Zizurkil;3025;1526;1499;2020
20;Gipuzkoa;081;Zumaia;10111;5024;5087;2020
20;Gipuzkoa;080;Zumarraga;9781;4832;4949;2020
17;Girona;001;Agullana;863;431;432;2020
17;Girona;002;Aiguaviva;765;385;380;2020
17;Girona;003;Albanyà;155;79;76;2020
17;Girona;004;Albons;759;391;368;2020
17;Girona;006;Alp;1593;823;770;2020
17;Girona;007;Amer;2332;1144;1188;2020
17;Girona;008;Anglès;5654;2817;2837;2020
17;Girona;009;Arbúcies;6608;3416;3192;2020
17;Girona;010;Argelaguer;396;207;189;2020
17;Girona;011;Armentera, L';951;478;473;2020
17;Girona;012;Avinyonet de Puigventós;1641;818;823;2020
17;Girona;015;Banyoles;20053;9986;10067;2020
17;Girona;016;Bàscara;1001;521;480;2020
17;Girona;013;Begur;3891;1955;1936;2020
17;Girona;018;Bellcaire d'Empordà;678;325;353;2020
17;Girona;019;Besalú;2487;1181;1306;2020
17;Girona;020;Bescanó;4991;2522;2469;2020
17;Girona;021;Beuda;186;99;87;2020
17;Girona;022;Bisbal d'Empordà, La;11159;5565;5594;2020
17;Girona;234;Biure;241;125;116;2020
17;Girona;023;Blanes;39914;19846;20068;2020
17;Girona;029;Boadella i les Escaules;272;137;135;2020
17;Girona;024;Bolvir;375;197;178;2020
17;Girona;025;Bordils;1761;885;876;2020
17;Girona;026;Borrassà;733;380;353;2020
17;Girona;027;Breda;3762;1842;1920;2020
17;Girona;028;Brunyola i Sant Martí Sapresa;389;203;186;2020
17;Girona;031;Cabanelles;267;150;117;2020
17;Girona;030;Cabanes;968;520;448;2020
17;Girona;032;Cadaqués;2695;1300;1395;2020
17;Girona;033;Caldes de Malavella;7872;3935;3937;2020
17;Girona;034;Calonge i Sant Antoni;11331;5681;5650;2020
17;Girona;035;Camós;677;340;337;2020
17;Girona;036;Campdevànol;3232;1560;1672;2020
17;Girona;037;Campelles;140;73;67;2020
17;Girona;038;Campllong;537;264;273;2020
17;Girona;039;Camprodon;2298;1124;1174;2020
17;Girona;040;Canet d'Adri;729;382;347;2020
17;Girona;041;Cantallops;309;153;156;2020
17;Girona;042;Capmany;611;305;306;2020
17;Girona;044;Cassà de la Selva;10410;5293;5117;2020
17;Girona;046;Castellfollit de la Roca;947;488;459;2020
17;Girona;047;Castelló d'Empúries;11100;5604;5496;2020
17;Girona;048;Castell-Platja d'Aro;11030;5426;5604;2020
17;Girona;189;Cellera de Ter, La;1950;959;991;2020
17;Girona;049;Celrà;5561;2796;2765;2020
17;Girona;050;Cervià de Ter;966;494;472;2020
17;Girona;051;Cistella;282;137;145;2020
17;Girona;054;Colera;445;217;228;2020
17;Girona;055;Colomers;174;84;90;2020
17;Girona;057;Corçà;1268;642;626;2020
17;Girona;056;Cornellà del Terri;2399;1215;1184;2020
17;Girona;058;Crespià;254;127;127;2020
17;Girona;901;Cruïlles, Monells i Sant Sadurní de l'Heura;1270;632;638;2020
17;Girona;060;Darnius;537;272;265;2020
17;Girona;061;Das;234;121;113;2020
17;Girona;062;Escala, L';10244;5187;5057;2020
17;Girona;063;Espinelves;221;112;109;2020
17;Girona;064;Espolla;412;204;208;2020
17;Girona;065;Esponellà;463;234;229;2020
17;Girona;005;Far d'Empordà, El;602;311;291;2020
17;Girona;066;Figueres;47235;23363;23872;2020
17;Girona;067;Flaçà;1130;551;579;2020
17;Girona;068;Foixà;303;151;152;2020
17;Girona;069;Fontanals de Cerdanya;437;212;225;2020
17;Girona;070;Fontanilles;146;81;65;2020
17;Girona;071;Fontcoberta;1469;732;737;2020
17;Girona;902;Forallac;1695;827;868;2020
17;Girona;073;Fornells de la Selva;2670;1333;1337;2020
17;Girona;074;Fortià;787;395;392;2020
17;Girona;075;Garrigàs;451;234;217;2020
17;Girona;076;Garrigoles;167;88;79;2020
17;Girona;077;Garriguella;853;425;428;2020
17;Girona;078;Ger;449;222;227;2020
17;Girona;079;Girona;103369;49809;53560;2020
17;Girona;080;Gombrèn;192;95;97;2020
17;Girona;081;Gualta;402;234;168;2020
17;Girona;082;Guils de Cerdanya;549;294;255;2020
17;Girona;083;Hostalric;4291;2158;2133;2020
17;Girona;084;Isòvol;281;163;118;2020
17;Girona;085;Jafre;387;209;178;2020
17;Girona;086;Jonquera, La;3320;1661;1659;2020
17;Girona;087;Juià;319;163;156;2020
17;Girona;088;Lladó;844;411;433;2020
17;Girona;089;Llagostera;8647;4373;4274;2020
17;Girona;090;Llambilles;713;366;347;2020
17;Girona;091;Llanars;535;274;261;2020
17;Girona;092;Llançà;4775;2353;2422;2020
17;Girona;093;Llers;1237;609;628;2020
17;Girona;094;Llívia;1431;745;686;2020
17;Girona;095;Lloret de Mar;39089;19926;19163;2020
17;Girona;096;Llosses, Les;212;121;91;2020
17;Girona;102;Maçanet de Cabrenys;698;352;346;2020
17;Girona;103;Maçanet de la Selva;7066;3636;3430;2020
17;Girona;097;Madremanya;288;137;151;2020
17;Girona;098;Maià de Montcal;463;260;203;2020
17;Girona;100;Masarac;288;150;138;2020
17;Girona;101;Massanes;796;420;376;2020
17;Girona;099;Meranges;100;55;45;2020
17;Girona;105;Mieres;345;176;169;2020
17;Girona;106;Mollet de Peralada;198;104;94;2020
17;Girona;107;Molló;336;166;170;2020
17;Girona;109;Montagut i Oix;930;481;449;2020
17;Girona;110;Mont-ras;1680;851;829;2020
17;Girona;111;Navata;1427;692;735;2020
17;Girona;112;Ogassa;240;132;108;2020
17;Girona;114;Olot;35926;17989;17937;2020
17;Girona;115;Ordis;361;193;168;2020
17;Girona;116;Osor;428;232;196;2020
17;Girona;117;Palafrugell;23244;11531;11713;2020
17;Girona;118;Palamós;18135;8873;9262;2020
17;Girona;119;Palau de Santa Eulàlia;90;51;39;2020
17;Girona;121;Palau-sator;310;169;141;2020
17;Girona;120;Palau-saverdera;1456;738;718;2020
17;Girona;123;Palol de Revardit;448;223;225;2020
17;Girona;124;Pals;2395;1232;1163;2020
17;Girona;125;Pardines;169;90;79;2020
17;Girona;126;Parlavà;391;196;195;2020
17;Girona;128;Pau;557;280;277;2020
17;Girona;129;Pedret i Marzà;191;97;94;2020
17;Girona;130;Pera, La;435;217;218;2020
17;Girona;132;Peralada;1898;937;961;2020
17;Girona;133;Planes d'Hostoles, Les;1712;866;846;2020
17;Girona;134;Planoles;304;165;139;2020
17;Girona;135;Pont de Molins;516;261;255;2020
17;Girona;136;Pontós;260;141;119;2020
17;Girona;137;Porqueres;4677;2304;2373;2020
17;Girona;140;Port de la Selva, El;958;497;461;2020
17;Girona;138;Portbou;1063;521;542;2020
17;Girona;139;Preses, Les;1855;921;934;2020
17;Girona;141;Puigcerdà;9486;4712;4774;2020
17;Girona;142;Quart;3798;1910;1888;2020
17;Girona;043;Queralbs;188;98;90;2020
17;Girona;143;Rabós;184;92;92;2020
17;Girona;144;Regencós;276;150;126;2020
17;Girona;145;Ribes de Freser;1760;883;877;2020
17;Girona;146;Riells i Viabrea;4153;2110;2043;2020
17;Girona;147;Ripoll;10803;5369;5434;2020
17;Girona;148;Riudarenes;2204;1134;1070;2020
17;Girona;149;Riudaura;481;230;251;2020
17;Girona;150;Riudellots de la Selva;2071;1055;1016;2020
17;Girona;151;Riumors;246;121;125;2020
17;Girona;152;Roses;19807;10016;9791;2020
17;Girona;153;Rupià;273;140;133;2020
17;Girona;154;Sales de Llierca;159;82;77;2020
17;Girona;155;Salt;32138;16920;15218;2020
17;Girona;157;Sant Andreu Salou;160;78;82;2020
17;Girona;183;Sant Aniol de Finestres;345;180;165;2020
17;Girona;158;Sant Climent Sescebes;707;439;268;2020
17;Girona;159;Sant Feliu de Buixalleu;797;414;383;2020
17;Girona;160;Sant Feliu de Guíxols;22097;10871;11226;2020
17;Girona;161;Sant Feliu de Pallerols;1437;724;713;2020
17;Girona;162;Sant Ferriol;236;125;111;2020
17;Girona;163;Sant Gregori;3928;2017;1911;2020
17;Girona;164;Sant Hilari Sacalm;5703;2884;2819;2020
17;Girona;165;Sant Jaume de Llierca;871;420;451;2020
17;Girona;167;Sant Joan de les Abadesses;3224;1595;1629;2020
17;Girona;168;Sant Joan de Mollet;498;241;257;2020
17;Girona;185;Sant Joan les Fonts;3044;1553;1491;2020
17;Girona;166;Sant Jordi Desvalls;760;377;383;2020
17;Girona;169;Sant Julià de Ramis;3576;1814;1762;2020
17;Girona;903;Sant Julià del Llor i Bonmatí;1313;660;653;2020
17;Girona;171;Sant Llorenç de la Muga;265;134;131;2020
17;Girona;172;Sant Martí de Llémena;641;334;307;2020
17;Girona;173;Sant Martí Vell;251;136;115;2020
17;Girona;174;Sant Miquel de Campmajor;229;127;102;2020
17;Girona;175;Sant Miquel de Fluvià;761;396;365;2020
17;Girona;176;Sant Mori;166;84;82;2020
17;Girona;177;Sant Pau de Segúries;688;344;344;2020
17;Girona;178;Sant Pere Pescador;2090;1112;978;2020
17;Girona;180;Santa Coloma de Farners;13363;6762;6601;2020
17;Girona;181;Santa Cristina d'Aro;5287;2661;2626;2020
17;Girona;182;Santa Llogaia d'Àlguema;368;189;179;2020
17;Girona;184;Santa Pau;1614;837;777;2020
17;Girona;186;Sarrià de Ter;5229;2567;2662;2020
17;Girona;187;Saus, Camallera i Llampaies;856;426;430;2020
17;Girona;188;Selva de Mar, La;195;105;90;2020
17;Girona;190;Serinyà;1133;574;559;2020
17;Girona;191;Serra de Daró;222;121;101;2020
17;Girona;192;Setcases;170;96;74;2020
17;Girona;193;Sils;6219;3187;3032;2020
17;Girona;052;Siurana;171;82;89;2020
17;Girona;194;Susqueda;93;55;38;2020
17;Girona;195;Tallada d'Empordà, La;454;237;217;2020
17;Girona;196;Terrades;338;166;172;2020
17;Girona;197;Torrent;164;87;77;2020
17;Girona;198;Torroella de Fluvià;703;367;336;2020
17;Girona;199;Torroella de Montgrí;11836;5983;5853;2020
17;Girona;200;Tortellà;818;391;427;2020
17;Girona;201;Toses;168;98;70;2020
17;Girona;202;Tossa de Mar;5818;2927;2891;2020
17;Girona;204;Ullà;1177;648;529;2020
17;Girona;205;Ullastret;274;138;136;2020
17;Girona;203;Ultramort;225;117;108;2020
17;Girona;206;Urús;196;96;100;2020
17;Girona;014;Vajol, La;89;51;38;2020
17;Girona;208;Vall de Bianya, La;1275;641;634;2020
17;Girona;207;Vall d'en Bas, La;3093;1568;1525;2020
17;Girona;170;Vallfogona de Ripollès;196;107;89;2020
17;Girona;209;Vall-llobrega;897;451;446;2020
17;Girona;210;Ventalló;846;428;418;2020
17;Girona;211;Verges;1169;575;594;2020
17;Girona;212;Vidrà;177;88;89;2020
17;Girona;213;Vidreres;7951;4130;3821;2020
17;Girona;214;Vilabertran;993;493;500;2020
17;Girona;215;Vilablareix;3063;1517;1546;2020
17;Girona;217;Viladamat;458;232;226;2020
17;Girona;216;Viladasens;206;110;96;2020
17;Girona;218;Vilademuls;835;431;404;2020
17;Girona;220;Viladrau;1047;508;539;2020
17;Girona;221;Vilafant;5421;2660;2761;2020
17;Girona;223;Vilajuïga;1116;558;558;2020
17;Girona;224;Vilallonga de Ter;398;213;185;2020
17;Girona;225;Vilamacolum;377;211;166;2020
17;Girona;226;Vilamalla;1161;586;575;2020
17;Girona;227;Vilamaniscle;212;121;91;2020
17;Girona;228;Vilanant;386;194;192;2020
17;Girona;230;Vila-sacra;758;377;381;2020
17;Girona;222;Vilaür;158;80;78;2020
17;Girona;233;Vilobí d'Onyar;3333;1732;1601;2020
17;Girona;232;Vilopriu;204;109;95;2020
18;Granada;001;Agrón;260;131;129;2020
18;Granada;002;Alamedilla;569;287;282;2020
18;Granada;003;Albolote;18962;9371;9591;2020
18;Granada;004;Albondón;712;392;320;2020
18;Granada;005;Albuñán;409;211;198;2020
18;Granada;006;Albuñol;7353;4050;3303;2020
18;Granada;007;Albuñuelas;802;395;407;2020
18;Granada;010;Aldeire;630;327;303;2020
18;Granada;011;Alfacar;5488;2801;2687;2020
18;Granada;012;Algarinejo;2467;1275;1192;2020
18;Granada;013;Alhama de Granada;5867;3118;2749;2020
18;Granada;014;Alhendín;9509;4818;4691;2020
18;Granada;015;Alicún de Ortega;471;235;236;2020
18;Granada;016;Almegíjar;337;164;173;2020
18;Granada;017;Almuñécar;25927;12783;13144;2020
18;Granada;904;Alpujarra de la Sierra;969;551;418;2020
18;Granada;018;Alquife;580;289;291;2020
18;Granada;020;Arenas del Rey;653;352;301;2020
18;Granada;021;Armilla;24340;12019;12321;2020
18;Granada;022;Atarfe;18960;9487;9473;2020
18;Granada;023;Baza;20430;10137;10293;2020
18;Granada;024;Beas de Granada;980;514;466;2020
18;Granada;025;Beas de Guadix;329;166;163;2020
18;Granada;027;Benalúa;3310;1639;1671;2020
18;Granada;028;Benalúa de las Villas;1054;547;507;2020
18;Granada;029;Benamaurel;2260;1132;1128;2020
18;Granada;030;Bérchules;712;379;333;2020
18;Granada;032;Bubión;298;156;142;2020
18;Granada;033;Busquístar;279;144;135;2020
18;Granada;034;Cacín;568;288;280;2020
18;Granada;035;Cádiar;1465;782;683;2020
18;Granada;036;Cájar;5205;2519;2686;2020
18;Granada;114;Calahorra, La;668;346;322;2020
18;Granada;037;Calicasas;638;317;321;2020
18;Granada;038;Campotéjar;1229;635;594;2020
18;Granada;039;Caniles;4021;2055;1966;2020
18;Granada;040;Cáñar;377;208;169;2020
18;Granada;042;Capileira;563;281;282;2020
18;Granada;043;Carataunas;201;106;95;2020
18;Granada;044;Cástaras;235;139;96;2020
18;Granada;045;Castilléjar;1321;683;638;2020
18;Granada;046;Castril;2020;1051;969;2020
18;Granada;047;Cenes de la Vega;8153;4054;4099;2020
18;Granada;059;Chauchina;5552;2747;2805;2020
18;Granada;061;Chimeneas;1251;649;602;2020
18;Granada;062;Churriana de la Vega;15689;7736;7953;2020
18;Granada;048;Cijuela;3415;1758;1657;2020
18;Granada;049;Cogollos de Guadix;642;358;284;2020
18;Granada;050;Cogollos de la Vega;2007;1009;998;2020
18;Granada;051;Colomera;1302;681;621;2020
18;Granada;053;Cortes de Baza;1844;911;933;2020
18;Granada;054;Cortes y Graena;982;513;469;2020
18;Granada;912;Cuevas del Campo;1744;885;859;2020
18;Granada;056;Cúllar;4091;2044;2047;2020
18;Granada;057;Cúllar Vega;7547;3833;3714;2020
18;Granada;063;Darro;1634;836;798;2020
18;Granada;064;Dehesas de Guadix;422;206;216;2020
18;Granada;065;Dehesas Viejas;688;357;331;2020
18;Granada;066;Deifontes;2600;1318;1282;2020
18;Granada;067;Diezma;764;406;358;2020
18;Granada;068;Dílar;2092;1053;1039;2020
18;Granada;069;Dólar;628;336;292;2020
18;Granada;915;Domingo Pérez de Granada;878;454;424;2020
18;Granada;070;Dúdar;327;172;155;2020
18;Granada;071;Dúrcal;7111;3542;3569;2020
18;Granada;072;Escúzar;791;410;381;2020
18;Granada;074;Ferreira;301;156;145;2020
18;Granada;076;Fonelas;978;508;470;2020
18;Granada;077;Fornes;556;280;276;2020
18;Granada;078;Freila;939;496;443;2020
18;Granada;079;Fuente Vaqueros;4384;2195;2189;2020
18;Granada;905;Gabias, Las;21543;10894;10649;2020
18;Granada;082;Galera;1071;546;525;2020
18;Granada;083;Gobernador;229;115;114;2020
18;Granada;084;Gójar;5909;3013;2896;2020
18;Granada;085;Gor;744;403;341;2020
18;Granada;086;Gorafe;383;194;189;2020
18;Granada;087;Granada;233648;107829;125819;2020
18;Granada;088;Guadahortuna;1872;968;904;2020
18;Granada;089;Guadix;18436;9175;9261;2020
18;Granada;906;Guájares, Los;1053;569;484;2020
18;Granada;093;Gualchos;5190;2792;2398;2020
18;Granada;094;Güéjar Sierra;2857;1525;1332;2020
18;Granada;095;Güevéjar;2640;1395;1245;2020
18;Granada;096;Huélago;401;213;188;2020
18;Granada;097;Huéneja;1170;627;543;2020
18;Granada;098;Huéscar;7195;3568;3627;2020
18;Granada;099;Huétor de Santillán;1882;969;913;2020
18;Granada;100;Huétor Tájar;10399;5222;5177;2020
18;Granada;101;Huétor Vega;12035;6030;6005;2020
18;Granada;102;Íllora;10065;5063;5002;2020
18;Granada;103;Ítrabo;991;488;503;2020
18;Granada;105;Iznalloz;5120;2629;2491;2020
18;Granada;106;Játar;623;343;280;2020
18;Granada;107;Jayena;1052;544;508;2020
18;Granada;108;Jérez del Marquesado;955;491;464;2020
18;Granada;109;Jete;927;494;433;2020
18;Granada;111;Jun;3853;1951;1902;2020
18;Granada;112;Juviles;135;67;68;2020
18;Granada;115;Láchar;3513;1788;1725;2020
18;Granada;116;Lanjarón;3530;1768;1762;2020
18;Granada;117;Lanteira;564;305;259;2020
18;Granada;119;Lecrín;2156;1085;1071;2020
18;Granada;120;Lentegí;333;171;162;2020
18;Granada;121;Lobras;133;65;68;2020
18;Granada;122;Loja;20419;10176;10243;2020
18;Granada;123;Lugros;310;162;148;2020
18;Granada;124;Lújar;483;258;225;2020
18;Granada;126;Malahá, La;1784;899;885;2020
18;Granada;127;Maracena;22306;10917;11389;2020
18;Granada;128;Marchal;414;197;217;2020
18;Granada;132;Moclín;3622;1794;1828;2020
18;Granada;133;Molvízar;2772;1416;1356;2020
18;Granada;134;Monachil;8007;4121;3886;2020
18;Granada;135;Montefrío;5313;2722;2591;2020
18;Granada;136;Montejícar;2110;1088;1022;2020
18;Granada;137;Montillana;1129;595;534;2020
18;Granada;138;Moraleda de Zafayona;3117;1576;1541;2020
18;Granada;909;Morelábor;572;310;262;2020
18;Granada;140;Motril;58460;28773;29687;2020
18;Granada;141;Murtas;455;263;192;2020
18;Granada;903;Nevada;1072;553;519;2020
18;Granada;143;Nigüelas;1185;603;582;2020
18;Granada;144;Nívar;1036;532;504;2020
18;Granada;145;Ogíjares;14348;7117;7231;2020
18;Granada;146;Orce;1185;598;587;2020
18;Granada;147;Órgiva;5784;2900;2884;2020
18;Granada;148;Otívar;1011;513;498;2020
18;Granada;150;Padul;8694;4366;4328;2020
18;Granada;151;Pampaneira;317;157;160;2020
18;Granada;152;Pedro Martínez;1138;556;582;2020
18;Granada;153;Peligros;11492;5692;5800;2020
18;Granada;154;Peza, La;1167;596;571;2020
18;Granada;910;Pinar, El;865;466;399;2020
18;Granada;157;Pinos Genil;1490;775;715;2020
18;Granada;158;Pinos Puente;9894;4966;4928;2020
18;Granada;159;Píñar;1103;606;497;2020
18;Granada;161;Polícar;263;142;121;2020
18;Granada;162;Polopos;1722;959;763;2020
18;Granada;163;Pórtugos;368;188;180;2020
18;Granada;164;Puebla de Don Fadrique;2238;1139;1099;2020
18;Granada;165;Pulianas;5466;2746;2720;2020
18;Granada;167;Purullena;2306;1174;1132;2020
18;Granada;168;Quéntar;947;487;460;2020
18;Granada;170;Rubite;382;207;175;2020
18;Granada;171;Salar;2621;1304;1317;2020
18;Granada;173;Salobreña;12513;6248;6265;2020
18;Granada;174;Santa Cruz del Comercio;531;272;259;2020
18;Granada;175;Santa Fe;15222;7480;7742;2020
18;Granada;176;Soportújar;264;141;123;2020
18;Granada;177;Sorvilán;527;286;241;2020
18;Granada;901;Taha, La;670;345;325;2020
18;Granada;178;Torre-Cardela;716;385;331;2020
18;Granada;916;Torrenueva Costa;2796;1446;1350;2020
18;Granada;179;Torvizcón;625;332;293;2020
18;Granada;180;Trevélez;736;389;347;2020
18;Granada;181;Turón;232;136;96;2020
18;Granada;182;Ugíjar;2517;1246;1271;2020
18;Granada;914;Valderrubio;2066;1020;1046;2020
18;Granada;907;Valle del Zalabí;2105;1074;1031;2020
18;Granada;902;Valle, El;907;451;456;2020
18;Granada;183;Válor;677;350;327;2020
18;Granada;911;Vegas del Genil;11432;5839;5593;2020
18;Granada;184;Vélez de Benaudalla;2890;1450;1440;2020
18;Granada;185;Ventas de Huelma;657;360;297;2020
18;Granada;149;Villa de Otura;6982;3512;3470;2020
18;Granada;908;Villamena;934;481;453;2020
18;Granada;187;Villanueva de las Torres;562;302;260;2020
18;Granada;188;Villanueva Mesía;2021;995;1026;2020
18;Granada;189;Víznar;993;514;479;2020
18;Granada;192;Zafarraya;2120;1119;1001;2020
18;Granada;913;Zagra;885;467;418;2020
18;Granada;193;Zubia, La;19330;9582;9748;2020
18;Granada;194;Zújar;2544;1282;1262;2020
19;Guadalajara;001;Abánades;53;30;23;2020
19;Guadalajara;002;Ablanque;55;30;25;2020
19;Guadalajara;003;Adobes;35;20;15;2020
19;Guadalajara;004;Alaminos;58;28;30;2020
19;Guadalajara;005;Alarilla;137;87;50;2020
19;Guadalajara;006;Albalate de Zorita;930;519;411;2020
19;Guadalajara;007;Albares;513;268;245;2020
19;Guadalajara;008;Albendiego;50;31;19;2020
19;Guadalajara;009;Alcocer;328;168;160;2020
19;Guadalajara;010;Alcolea de las Peñas;14;8;6;2020
19;Guadalajara;011;Alcolea del Pinar;327;181;146;2020
19;Guadalajara;013;Alcoroches;127;79;48;2020
19;Guadalajara;015;Aldeanueva de Guadalajara;86;52;34;2020
19;Guadalajara;016;Algar de Mesa;55;40;15;2020
19;Guadalajara;017;Algora;66;42;24;2020
19;Guadalajara;018;Alhóndiga;161;91;70;2020
19;Guadalajara;019;Alique;14;7;7;2020
19;Guadalajara;020;Almadrones;55;37;18;2020
19;Guadalajara;021;Almoguera;1300;668;632;2020
19;Guadalajara;022;Almonacid de Zorita;696;350;346;2020
19;Guadalajara;023;Alocén;161;81;80;2020
19;Guadalajara;024;Alovera;12860;6558;6302;2020
19;Guadalajara;027;Alustante;155;90;65;2020
19;Guadalajara;031;Angón;7;6;1;2020
19;Guadalajara;032;Anguita;155;83;72;2020
19;Guadalajara;033;Anquela del Ducado;46;27;19;2020
19;Guadalajara;034;Anquela del Pedregal;29;17;12;2020
19;Guadalajara;036;Aranzueque;358;194;164;2020
19;Guadalajara;037;Arbancón;149;88;61;2020
19;Guadalajara;038;Arbeteta;20;15;5;2020
19;Guadalajara;039;Argecilla;59;41;18;2020
19;Guadalajara;040;Armallones;54;30;24;2020
19;Guadalajara;041;Armuña de Tajuña;229;122;107;2020
19;Guadalajara;042;Arroyo de las Fraguas;21;11;10;2020
19;Guadalajara;043;Atanzón;97;65;32;2020
19;Guadalajara;044;Atienza;385;221;164;2020
19;Guadalajara;045;Auñón;134;78;56;2020
19;Guadalajara;046;Azuqueca de Henares;35407;17928;17479;2020
19;Guadalajara;047;Baides;56;28;28;2020
19;Guadalajara;048;Baños de Tajo;18;13;5;2020
19;Guadalajara;049;Bañuelos;13;11;2;2020
19;Guadalajara;050;Barriopedro;15;10;5;2020
19;Guadalajara;051;Berninches;52;34;18;2020
19;Guadalajara;052;Bodera, La;23;16;7;2020
19;Guadalajara;053;Brihuega;2378;1246;1132;2020
19;Guadalajara;054;Budia;189;115;74;2020
19;Guadalajara;055;Bujalaro;50;24;26;2020
19;Guadalajara;057;Bustares;74;45;29;2020
19;Guadalajara;058;Cabanillas del Campo;10657;5370;5287;2020
19;Guadalajara;059;Campillo de Dueñas;80;47;33;2020
19;Guadalajara;060;Campillo de Ranas;171;100;71;2020
19;Guadalajara;061;Campisábalos;60;46;14;2020
19;Guadalajara;064;Canredondo;64;41;23;2020
19;Guadalajara;065;Cantalojas;146;88;58;2020
19;Guadalajara;066;Cañizar;53;32;21;2020
19;Guadalajara;067;Cardoso de la Sierra, El;57;35;22;2020
19;Guadalajara;070;Casa de Uceda;91;47;44;2020
19;Guadalajara;071;Casar, El;12415;6291;6124;2020
19;Guadalajara;073;Casas de San Galindo;19;14;5;2020
19;Guadalajara;074;Caspueñas;96;59;37;2020
19;Guadalajara;075;Castejón de Henares;64;40;24;2020
19;Guadalajara;076;Castellar de la Muela;29;18;11;2020
19;Guadalajara;078;Castilforte;52;35;17;2020
19;Guadalajara;079;Castilnuevo;7;5;2;2020
19;Guadalajara;080;Cendejas de Enmedio;68;35;33;2020
19;Guadalajara;081;Cendejas de la Torre;25;17;8;2020
19;Guadalajara;082;Centenera;121;67;54;2020
19;Guadalajara;103;Checa;285;170;115;2020
19;Guadalajara;104;Chequilla;18;9;9;2020
19;Guadalajara;106;Chillarón del Rey;90;50;40;2020
19;Guadalajara;105;Chiloeches;3623;1886;1737;2020
19;Guadalajara;086;Cifuentes;1634;846;788;2020
19;Guadalajara;087;Cincovillas;19;10;9;2020
19;Guadalajara;088;Ciruelas;112;63;49;2020
19;Guadalajara;089;Ciruelos del Pinar;19;13;6;2020
19;Guadalajara;090;Cobeta;106;52;54;2020
19;Guadalajara;091;Cogollor;24;15;9;2020
19;Guadalajara;092;Cogolludo;519;305;214;2020
19;Guadalajara;095;Condemios de Abajo;13;9;4;2020
19;Guadalajara;096;Condemios de Arriba;111;65;46;2020
19;Guadalajara;097;Congostrina;14;11;3;2020
19;Guadalajara;098;Copernal;32;20;12;2020
19;Guadalajara;099;Corduente;339;188;151;2020
19;Guadalajara;102;Cubillo de Uceda, El;119;65;54;2020
19;Guadalajara;107;Driebes;348;192;156;2020
19;Guadalajara;108;Durón;99;55;44;2020
19;Guadalajara;109;Embid;35;20;15;2020
19;Guadalajara;110;Escamilla;56;35;21;2020
19;Guadalajara;111;Escariche;178;110;68;2020
19;Guadalajara;112;Escopete;52;25;27;2020
19;Guadalajara;113;Espinosa de Henares;629;324;305;2020
19;Guadalajara;114;Esplegares;32;19;13;2020
19;Guadalajara;115;Establés;35;22;13;2020
19;Guadalajara;116;Estriégana;14;9;5;2020
19;Guadalajara;117;Fontanar;2406;1260;1146;2020
19;Guadalajara;118;Fuembellida;12;8;4;2020
19;Guadalajara;119;Fuencemillán;82;52;30;2020
19;Guadalajara;120;Fuentelahiguera de Albatages;131;76;55;2020
19;Guadalajara;121;Fuentelencina;312;173;139;2020
19;Guadalajara;122;Fuentelsaz;89;49;40;2020
19;Guadalajara;123;Fuentelviejo;47;28;19;2020
19;Guadalajara;124;Fuentenovilla;513;284;229;2020
19;Guadalajara;125;Gajanejos;54;33;21;2020
19;Guadalajara;126;Galápagos;2475;1302;1173;2020
19;Guadalajara;127;Galve de Sorbe;109;60;49;2020
19;Guadalajara;129;Gascueña de Bornova;29;17;12;2020
19;Guadalajara;130;Guadalajara;87484;42091;45393;2020
19;Guadalajara;132;Henche;96;52;44;2020
19;Guadalajara;133;Heras de Ayuso;255;149;106;2020
19;Guadalajara;134;Herrería;24;12;12;2020
19;Guadalajara;135;Hiendelaencina;109;68;41;2020
19;Guadalajara;136;Hijes;18;9;9;2020
19;Guadalajara;138;Hita;288;161;127;2020
19;Guadalajara;139;Hombrados;35;23;12;2020
19;Guadalajara;142;Hontoba;339;192;147;2020
19;Guadalajara;143;Horche;2622;1322;1300;2020
19;Guadalajara;145;Hortezuela de Océn;40;25;15;2020
19;Guadalajara;146;Huerce, La;56;35;21;2020
19;Guadalajara;147;Huérmeces del Cerro;41;28;13;2020
19;Guadalajara;148;Huertahernando;54;35;19;2020
19;Guadalajara;150;Hueva;120;75;45;2020
19;Guadalajara;151;Humanes;1511;760;751;2020
19;Guadalajara;152;Illana;664;368;296;2020
19;Guadalajara;153;Iniéstola;23;15;8;2020
19;Guadalajara;154;Inviernas, Las;58;39;19;2020
19;Guadalajara;155;Irueste;72;46;26;2020
19;Guadalajara;156;Jadraque;1370;726;644;2020
19;Guadalajara;157;Jirueque;55;37;18;2020
19;Guadalajara;159;Ledanca;104;52;52;2020
19;Guadalajara;160;Loranca de Tajuña;1264;687;577;2020
19;Guadalajara;161;Lupiana;259;136;123;2020
19;Guadalajara;162;Luzaga;67;39;28;2020
19;Guadalajara;163;Luzón;69;34;35;2020
19;Guadalajara;165;Majaelrayo;55;32;23;2020
19;Guadalajara;166;Málaga del Fresno;185;102;83;2020
19;Guadalajara;167;Malaguilla;158;84;74;2020
19;Guadalajara;168;Mandayona;287;140;147;2020
19;Guadalajara;169;Mantiel;31;21;10;2020
19;Guadalajara;170;Maranchón;234;124;110;2020
19;Guadalajara;171;Marchamalo;7684;3849;3835;2020
19;Guadalajara;172;Masegoso de Tajuña;49;27;22;2020
19;Guadalajara;173;Matarrubia;57;38;19;2020
19;Guadalajara;174;Matillas;101;56;45;2020
19;Guadalajara;175;Mazarete;35;18;17;2020
19;Guadalajara;176;Mazuecos;266;152;114;2020
19;Guadalajara;177;Medranda;60;32;28;2020
19;Guadalajara;178;Megina;29;17;12;2020
19;Guadalajara;179;Membrillera;87;49;38;2020
19;Guadalajara;181;Miedes de Atienza;53;35;18;2020
19;Guadalajara;182;Mierla, La;39;26;13;2020
19;Guadalajara;184;Millana;105;67;38;2020
19;Guadalajara;183;Milmarcos;78;48;30;2020
19;Guadalajara;185;Miñosa, La;26;17;9;2020
19;Guadalajara;186;Mirabueno;74;47;27;2020
19;Guadalajara;187;Miralrío;53;29;24;2020
19;Guadalajara;188;Mochales;40;21;19;2020
19;Guadalajara;189;Mohernando;183;95;88;2020
19;Guadalajara;190;Molina de Aragón;3233;1597;1636;2020
19;Guadalajara;191;Monasterio;14;6;8;2020
19;Guadalajara;192;Mondéjar;2686;1382;1304;2020
19;Guadalajara;193;Montarrón;25;15;10;2020
19;Guadalajara;194;Moratilla de los Meleros;100;55;45;2020
19;Guadalajara;195;Morenilla;37;22;15;2020
19;Guadalajara;196;Muduex;100;53;47;2020
19;Guadalajara;197;Navas de Jadraque, Las;32;22;10;2020
19;Guadalajara;198;Negredo;17;9;8;2020
19;Guadalajara;199;Ocentejo;18;13;5;2020
19;Guadalajara;200;Olivar, El;69;38;31;2020
19;Guadalajara;201;Olmeda de Cobeta;67;38;29;2020
19;Guadalajara;202;Olmeda de Jadraque, La;15;8;7;2020
19;Guadalajara;203;Ordial, El;28;16;12;2020
19;Guadalajara;204;Orea;181;107;74;2020
19;Guadalajara;208;Pálmaces de Jadraque;40;26;14;2020
19;Guadalajara;209;Pardos;43;25;18;2020
19;Guadalajara;210;Paredes de Sigüenza;22;10;12;2020
19;Guadalajara;211;Pareja;393;234;159;2020
19;Guadalajara;212;Pastrana;858;430;428;2020
19;Guadalajara;213;Pedregal, El;72;45;27;2020
19;Guadalajara;214;Peñalén;75;43;32;2020
19;Guadalajara;215;Peñalver;133;87;46;2020
19;Guadalajara;216;Peralejos de las Truchas;152;80;72;2020
19;Guadalajara;217;Peralveche;38;28;10;2020
19;Guadalajara;218;Pinilla de Jadraque;47;26;21;2020
19;Guadalajara;219;Pinilla de Molina;9;7;2;2020
19;Guadalajara;220;Pioz;4352;2275;2077;2020
19;Guadalajara;221;Piqueras;52;35;17;2020
19;Guadalajara;222;Pobo de Dueñas, El;108;57;51;2020
19;Guadalajara;223;Poveda de la Sierra;114;59;55;2020
19;Guadalajara;224;Pozo de Almoguera;107;64;43;2020
19;Guadalajara;225;Pozo de Guadalajara;1332;713;619;2020
19;Guadalajara;226;Prádena de Atienza;47;35;12;2020
19;Guadalajara;227;Prados Redondos;60;42;18;2020
19;Guadalajara;228;Puebla de Beleña;43;24;19;2020
19;Guadalajara;229;Puebla de Valles;59;33;26;2020
19;Guadalajara;230;Quer;830;433;397;2020
19;Guadalajara;231;Rebollosa de Jadraque;10;7;3;2020
19;Guadalajara;232;Recuenco, El;59;36;23;2020
19;Guadalajara;233;Renera;100;59;41;2020
19;Guadalajara;234;Retiendas;43;31;12;2020
19;Guadalajara;235;Riba de Saelices;102;61;41;2020
19;Guadalajara;237;Rillo de Gallo;42;26;16;2020
19;Guadalajara;238;Riofrío del Llano;57;33;24;2020
19;Guadalajara;239;Robledillo de Mohernando;117;61;56;2020
19;Guadalajara;240;Robledo de Corpes;44;27;17;2020
19;Guadalajara;241;Romanillos de Atienza;36;24;12;2020
19;Guadalajara;242;Romanones;95;48;47;2020
19;Guadalajara;243;Rueda de la Sierra;39;28;11;2020
19;Guadalajara;244;Sacecorbo;89;51;38;2020
19;Guadalajara;245;Sacedón;1523;793;730;2020
19;Guadalajara;246;Saelices de la Sal;39;23;16;2020
19;Guadalajara;247;Salmerón;140;81;59;2020
19;Guadalajara;248;San Andrés del Congosto;74;47;27;2020
19;Guadalajara;249;San Andrés del Rey;40;23;17;2020
19;Guadalajara;250;Santiuste;14;9;5;2020
19;Guadalajara;251;Saúca;56;33;23;2020
19;Guadalajara;252;Sayatón;68;41;27;2020
19;Guadalajara;254;Selas;44;22;22;2020
19;Guadalajara;901;Semillas;35;20;15;2020
19;Guadalajara;255;Setiles;80;43;37;2020
19;Guadalajara;256;Sienes;52;31;21;2020
19;Guadalajara;257;Sigüenza;4319;2184;2135;2020
19;Guadalajara;258;Solanillos del Extremo;88;52;36;2020
19;Guadalajara;259;Somolinos;29;16;13;2020
19;Guadalajara;260;Sotillo, El;43;22;21;2020
19;Guadalajara;261;Sotodosos;33;19;14;2020
19;Guadalajara;262;Tamajón;137;74;63;2020
19;Guadalajara;263;Taragudo;44;27;17;2020
19;Guadalajara;264;Taravilla;36;25;11;2020
19;Guadalajara;265;Tartanedo;144;85;59;2020
19;Guadalajara;266;Tendilla;304;169;135;2020
19;Guadalajara;267;Terzaga;22;12;10;2020
19;Guadalajara;268;Tierzo;55;31;24;2020
19;Guadalajara;269;Toba, La;85;54;31;2020
19;Guadalajara;271;Tordellego;47;24;23;2020
19;Guadalajara;270;Tordelrábano;11;8;3;2020
19;Guadalajara;272;Tordesilos;85;50;35;2020
19;Guadalajara;274;Torija;1527;793;734;2020
19;Guadalajara;279;Torre del Burgo;611;341;270;2020
19;Guadalajara;277;Torrecuadrada de Molina;18;13;5;2020
19;Guadalajara;278;Torrecuadradilla;27;16;11;2020
19;Guadalajara;280;Torrejón del Rey;5623;2938;2685;2020
19;Guadalajara;281;Torremocha de Jadraque;21;11;10;2020
19;Guadalajara;282;Torremocha del Campo;172;98;74;2020
19;Guadalajara;283;Torremocha del Pinar;38;19;19;2020
19;Guadalajara;284;Torremochuela;9;6;3;2020
19;Guadalajara;285;Torrubia;20;12;8;2020
19;Guadalajara;286;Tórtola de Henares;1165;632;533;2020
19;Guadalajara;287;Tortuera;191;101;90;2020
19;Guadalajara;288;Tortuero;16;12;4;2020
19;Guadalajara;289;Traíd;25;17;8;2020
19;Guadalajara;290;Trijueque;1226;660;566;2020
19;Guadalajara;291;Trillo;1338;697;641;2020
19;Guadalajara;293;Uceda;2715;1410;1305;2020
19;Guadalajara;294;Ujados;30;16;14;2020
19;Guadalajara;296;Utande;39;27;12;2020
19;Guadalajara;297;Valdarachas;40;21;19;2020
19;Guadalajara;298;Valdearenas;78;49;29;2020
19;Guadalajara;299;Valdeavellano;105;56;49;2020
19;Guadalajara;300;Valdeaveruelo;1084;571;513;2020
19;Guadalajara;301;Valdeconcha;37;21;16;2020
19;Guadalajara;302;Valdegrudas;55;34;21;2020
19;Guadalajara;303;Valdelcubo;42;28;14;2020
19;Guadalajara;304;Valdenuño Fernández;269;142;127;2020
19;Guadalajara;305;Valdepeñas de la Sierra;149;85;64;2020
19;Guadalajara;306;Valderrebollo;23;12;11;2020
19;Guadalajara;307;Valdesotos;22;14;8;2020
19;Guadalajara;308;Valfermoso de Tajuña;64;45;19;2020
19;Guadalajara;309;Valhermoso;22;12;10;2020
19;Guadalajara;310;Valtablado del Río;7;4;3;2020
19;Guadalajara;311;Valverde de los Arroyos;93;50;43;2020
19;Guadalajara;314;Viana de Jadraque;44;30;14;2020
19;Guadalajara;317;Villanueva de Alcorón;148;82;66;2020
19;Guadalajara;318;Villanueva de Argecilla;37;21;16;2020
19;Guadalajara;319;Villanueva de la Torre;6631;3347;3284;2020
19;Guadalajara;321;Villares de Jadraque;43;28;15;2020
19;Guadalajara;322;Villaseca de Henares;25;12;13;2020
19;Guadalajara;323;Villaseca de Uceda;39;20;19;2020
19;Guadalajara;324;Villel de Mesa;178;104;74;2020
19;Guadalajara;325;Viñuelas;162;84;78;2020
19;Guadalajara;326;Yebes;4189;2188;2001;2020
19;Guadalajara;327;Yebra;453;246;207;2020
19;Guadalajara;329;Yélamos de Abajo;63;33;30;2020
19;Guadalajara;330;Yélamos de Arriba;74;44;30;2020
19;Guadalajara;331;Yunquera de Henares;4205;2155;2050;2020
19;Guadalajara;332;Yunta, La;90;53;37;2020
19;Guadalajara;333;Zaorejas;104;72;32;2020
19;Guadalajara;334;Zarzuela de Jadraque;42;27;15;2020
19;Guadalajara;335;Zorita de los Canes;70;36;34;2020
21;Huelva;001;Alájar;759;393;366;2020
21;Huelva;002;Aljaraque;21474;10683;10791;2020
21;Huelva;003;Almendro, El;840;440;400;2020
21;Huelva;004;Almonaster la Real;1788;960;828;2020
21;Huelva;005;Almonte;24507;11817;12690;2020
21;Huelva;006;Alosno;3933;1936;1997;2020
21;Huelva;007;Aracena;8255;4059;4196;2020
21;Huelva;008;Aroche;3054;1522;1532;2020
21;Huelva;009;Arroyomolinos de León;947;484;463;2020
21;Huelva;010;Ayamonte;21104;10574;10530;2020
21;Huelva;011;Beas;4341;2178;2163;2020
21;Huelva;012;Berrocal;303;149;154;2020
21;Huelva;013;Bollullos Par del Condado;14387;7150;7237;2020
21;Huelva;014;Bonares;6060;3027;3033;2020
21;Huelva;015;Cabezas Rubias;706;371;335;2020
21;Huelva;016;Cala;1159;586;573;2020
21;Huelva;017;Calañas;2768;1419;1349;2020
21;Huelva;018;Campillo, El;2024;979;1045;2020
21;Huelva;019;Campofrío;713;361;352;2020
21;Huelva;020;Cañaveral de León;396;198;198;2020
21;Huelva;021;Cartaya;20083;10238;9845;2020
21;Huelva;022;Castaño del Robledo;228;122;106;2020
21;Huelva;023;Cerro de Andévalo, El;2327;1153;1174;2020
21;Huelva;030;Chucena;2223;1118;1105;2020
21;Huelva;024;Corteconcepción;536;281;255;2020
21;Huelva;025;Cortegana;4602;2333;2269;2020
21;Huelva;026;Cortelazor;299;142;157;2020
21;Huelva;027;Cumbres de Enmedio;51;31;20;2020
21;Huelva;028;Cumbres de San Bartolomé;376;186;190;2020
21;Huelva;029;Cumbres Mayores;1749;868;881;2020
21;Huelva;031;Encinasola;1310;665;645;2020
21;Huelva;032;Escacena del Campo;2287;1112;1175;2020
21;Huelva;033;Fuenteheridos;709;359;350;2020
21;Huelva;034;Galaroza;1382;684;698;2020
21;Huelva;035;Gibraleón;12737;6342;6395;2020
21;Huelva;036;Granada de Río-Tinto, La;243;122;121;2020
21;Huelva;037;Granado, El;532;283;249;2020
21;Huelva;038;Higuera de la Sierra;1291;673;618;2020
21;Huelva;039;Hinojales;330;167;163;2020
21;Huelva;040;Hinojos;3961;1993;1968;2020
21;Huelva;041;Huelva;143837;69043;74794;2020
21;Huelva;042;Isla Cristina;21393;10686;10707;2020
21;Huelva;043;Jabugo;2260;1139;1121;2020
21;Huelva;044;Lepe;27880;14302;13578;2020
21;Huelva;045;Linares de la Sierra;262;126;136;2020
21;Huelva;046;Lucena del Puerto;3261;1710;1551;2020
21;Huelva;047;Manzanilla;2118;1080;1038;2020
21;Huelva;048;Marines, Los;399;217;182;2020
21;Huelva;049;Minas de Riotinto;3812;1854;1958;2020
21;Huelva;050;Moguer;21867;10926;10941;2020
21;Huelva;051;Nava, La;258;132;126;2020
21;Huelva;052;Nerva;5169;2476;2693;2020
21;Huelva;053;Niebla;4116;2071;2045;2020
21;Huelva;054;Palma del Condado, La;10801;5404;5397;2020
21;Huelva;055;Palos de la Frontera;11742;5971;5771;2020
21;Huelva;056;Paterna del Campo;3457;1760;1697;2020
21;Huelva;057;Paymogo;1162;577;585;2020
21;Huelva;058;Puebla de Guzmán;3092;1586;1506;2020
21;Huelva;059;Puerto Moral;278;132;146;2020
21;Huelva;060;Punta Umbría;15355;7805;7550;2020
21;Huelva;061;Rociana del Condado;7939;3968;3971;2020
21;Huelva;062;Rosal de la Frontera;1697;838;859;2020
21;Huelva;063;San Bartolomé de la Torre;3761;1871;1890;2020
21;Huelva;064;San Juan del Puerto;9411;4728;4683;2020
21;Huelva;066;San Silvestre de Guzmán;614;322;292;2020
21;Huelva;065;Sanlúcar de Guadiana;403;199;204;2020
21;Huelva;067;Santa Ana la Real;475;220;255;2020
21;Huelva;068;Santa Bárbara de Casa;1043;517;526;2020
21;Huelva;069;Santa Olalla del Cala;2022;1037;985;2020
21;Huelva;070;Trigueros;7862;3905;3957;2020
21;Huelva;071;Valdelarco;231;108;123;2020
21;Huelva;072;Valverde del Camino;12750;6267;6483;2020
21;Huelva;073;Villablanca;2885;1410;1475;2020
21;Huelva;074;Villalba del Alcor;3366;1663;1703;2020
21;Huelva;075;Villanueva de las Cruces;387;181;206;2020
21;Huelva;076;Villanueva de los Castillejos;2825;1414;1411;2020
21;Huelva;077;Villarrasa;2211;1114;1097;2020
21;Huelva;078;Zalamea la Real;3054;1532;1522;2020
21;Huelva;902;Zarza-Perrunal, La;1253;634;619;2020
21;Huelva;079;Zufre;796;413;383;2020
22;Huesca;001;Abiego;258;135;123;2020
22;Huesca;002;Abizanda;139;70;69;2020
22;Huesca;003;Adahuesca;180;98;82;2020
22;Huesca;004;Agüero;125;71;54;2020
22;Huesca;907;Aínsa-Sobrarbe;2242;1128;1114;2020
22;Huesca;006;Aisa;313;171;142;2020
22;Huesca;007;Albalate de Cinca;1099;595;504;2020
22;Huesca;008;Albalatillo;163;86;77;2020
22;Huesca;009;Albelda;708;374;334;2020
22;Huesca;011;Albero Alto;120;67;53;2020
22;Huesca;012;Albero Bajo;132;70;62;2020
22;Huesca;013;Alberuela de Tubo;290;145;145;2020
22;Huesca;014;Alcalá de Gurrea;239;127;112;2020
22;Huesca;015;Alcalá del Obispo;298;164;134;2020
22;Huesca;016;Alcampell;623;300;323;2020
22;Huesca;017;Alcolea de Cinca;1177;641;536;2020
22;Huesca;018;Alcubierre;362;198;164;2020
22;Huesca;019;Alerre;200;103;97;2020
22;Huesca;020;Alfántega;130;65;65;2020
22;Huesca;021;Almudévar;2377;1197;1180;2020
22;Huesca;022;Almunia de San Juan;666;340;326;2020
22;Huesca;023;Almuniente;457;237;220;2020
22;Huesca;024;Alquézar;312;161;151;2020
22;Huesca;025;Altorricón;1420;771;649;2020
22;Huesca;027;Angüés;353;188;165;2020
22;Huesca;028;Ansó;386;194;192;2020
22;Huesca;029;Antillón;135;70;65;2020
22;Huesca;032;Aragüés del Puerto;111;60;51;2020
22;Huesca;035;Arén;308;171;137;2020
22;Huesca;036;Argavieso;95;57;38;2020
22;Huesca;037;Arguis;125;71;54;2020
22;Huesca;039;Ayerbe;1017;507;510;2020
22;Huesca;040;Azanuy-Alins;170;82;88;2020
22;Huesca;041;Azara;157;83;74;2020
22;Huesca;042;Azlor;138;65;73;2020
22;Huesca;043;Baélls;97;55;42;2020
22;Huesca;044;Bailo;261;154;107;2020
22;Huesca;045;Baldellou;64;38;26;2020
22;Huesca;046;Ballobar;833;434;399;2020
22;Huesca;047;Banastás;310;158;152;2020
22;Huesca;048;Barbastro;17174;8364;8810;2020
22;Huesca;049;Barbués;86;50;36;2020
22;Huesca;050;Barbuñales;96;47;49;2020
22;Huesca;051;Bárcabo;102;55;47;2020
22;Huesca;052;Belver de Cinca;1301;762;539;2020
22;Huesca;053;Benabarre;1142;596;546;2020
22;Huesca;054;Benasque;2184;1179;1005;2020
22;Huesca;246;Beranuy;75;45;30;2020
22;Huesca;055;Berbegal;327;173;154;2020
22;Huesca;057;Bielsa;448;235;213;2020
22;Huesca;058;Bierge;252;139;113;2020
22;Huesca;059;Biescas;1474;776;698;2020
22;Huesca;060;Binaced;1605;878;727;2020
22;Huesca;061;Binéfar;9742;5121;4621;2020
22;Huesca;062;Bisaurri;171;91;80;2020
22;Huesca;063;Biscarrués;182;97;85;2020
22;Huesca;064;Blecua y Torres;173;99;74;2020
22;Huesca;066;Boltaña;1045;560;485;2020
22;Huesca;067;Bonansa;87;49;38;2020
22;Huesca;068;Borau;70;38;32;2020
22;Huesca;069;Broto;538;299;239;2020
22;Huesca;072;Caldearenas;226;130;96;2020
22;Huesca;074;Campo;436;229;207;2020
22;Huesca;075;Camporrélls;127;66;61;2020
22;Huesca;076;Canal de Berdún;323;176;147;2020
22;Huesca;077;Candasnos;419;227;192;2020
22;Huesca;078;Canfranc;558;311;247;2020
22;Huesca;079;Capdesaso;211;88;123;2020
22;Huesca;080;Capella;360;187;173;2020
22;Huesca;081;Casbas de Huesca;275;152;123;2020
22;Huesca;083;Castejón de Monegros;510;276;234;2020
22;Huesca;084;Castejón de Sos;764;381;383;2020
22;Huesca;082;Castejón del Puente;312;163;149;2020
22;Huesca;085;Castelflorite;103;53;50;2020
22;Huesca;086;Castiello de Jaca;221;126;95;2020
22;Huesca;087;Castigaleu;79;49;30;2020
22;Huesca;088;Castillazuelo;153;76;77;2020
22;Huesca;089;Castillonroy;318;163;155;2020
22;Huesca;094;Chalamera;113;60;53;2020
22;Huesca;095;Chía;83;53;30;2020
22;Huesca;096;Chimillas;402;200;202;2020
22;Huesca;090;Colungo;117;65;52;2020
22;Huesca;099;Esplús;632;324;308;2020
22;Huesca;102;Estada;199;116;83;2020
22;Huesca;103;Estadilla;796;391;405;2020
22;Huesca;105;Estopiñán del Castillo;121;61;60;2020
22;Huesca;106;Fago;20;12;8;2020
22;Huesca;107;Fanlo;100;64;36;2020
22;Huesca;109;Fiscal;331;181;150;2020
22;Huesca;110;Fonz;851;432;419;2020
22;Huesca;111;Foradada del Toscar;162;92;70;2020
22;Huesca;112;Fraga;15353;7854;7499;2020
22;Huesca;113;Fueva, La;600;321;279;2020
22;Huesca;114;Gistaín;147;81;66;2020
22;Huesca;115;Grado, El;395;208;187;2020
22;Huesca;116;Grañén;1738;905;833;2020
22;Huesca;117;Graus;3365;1658;1707;2020
22;Huesca;119;Gurrea de Gállego;1476;744;732;2020
22;Huesca;122;Hoz de Jaca;73;37;36;2020
22;Huesca;908;Hoz y Costean;221;128;93;2020
22;Huesca;124;Huerto;213;117;96;2020
22;Huesca;125;Huesca;53956;25702;28254;2020
22;Huesca;126;Ibieca;100;57;43;2020
22;Huesca;127;Igriés;695;371;324;2020
22;Huesca;128;Ilche;197;96;101;2020
22;Huesca;129;Isábena;231;115;116;2020
22;Huesca;130;Jaca;13129;6408;6721;2020
22;Huesca;131;Jasa;96;56;40;2020
22;Huesca;133;Labuerda;155;82;73;2020
22;Huesca;135;Laluenga;191;100;91;2020
22;Huesca;136;Lalueza;892;464;428;2020
22;Huesca;137;Lanaja;1163;609;554;2020
22;Huesca;139;Laperdiguera;92;47;45;2020
22;Huesca;141;Lascellas-Ponzano;130;82;48;2020
22;Huesca;142;Lascuarre;139;72;67;2020
22;Huesca;143;Laspaúles;205;114;91;2020
22;Huesca;144;Laspuña;297;162;135;2020
22;Huesca;149;Loarre;323;179;144;2020
22;Huesca;150;Loporzano;514;293;221;2020
22;Huesca;151;Loscorrales;93;48;45;2020
22;Huesca;905;Lupiñén-Ortilla;335;170;165;2020
22;Huesca;155;Monesma y Cajigar;72;40;32;2020
22;Huesca;156;Monflorite-Lascasas;405;213;192;2020
22;Huesca;157;Montanuy;210;123;87;2020
22;Huesca;158;Monzón;17469;8842;8627;2020
22;Huesca;160;Naval;265;139;126;2020
22;Huesca;162;Novales;152;76;76;2020
22;Huesca;163;Nueno;546;301;245;2020
22;Huesca;164;Olvena;56;29;27;2020
22;Huesca;165;Ontiñena;508;255;253;2020
22;Huesca;167;Osso de Cinca;678;379;299;2020
22;Huesca;168;Palo;26;13;13;2020
22;Huesca;170;Panticosa;800;417;383;2020
22;Huesca;172;Peñalba;644;340;304;2020
22;Huesca;173;Peñas de Riglos, Las;247;155;92;2020
22;Huesca;174;Peralta de Alcofea;563;291;272;2020
22;Huesca;175;Peralta de Calasanz;210;117;93;2020
22;Huesca;176;Peraltilla;209;102;107;2020
22;Huesca;177;Perarrúa;106;56;50;2020
22;Huesca;178;Pertusa;120;73;47;2020
22;Huesca;181;Piracés;100;51;49;2020
22;Huesca;182;Plan;273;139;134;2020
22;Huesca;184;Poleñino;210;110;100;2020
22;Huesca;186;Pozán de Vero;214;105;109;2020
22;Huesca;187;Puebla de Castro, La;377;194;183;2020
22;Huesca;188;Puente de Montañana;93;42;51;2020
22;Huesca;902;Puente la Reina de Jaca;245;127;118;2020
22;Huesca;189;Puértolas;213;116;97;2020
22;Huesca;190;Pueyo de Araguás, El;161;91;70;2020
22;Huesca;193;Pueyo de Santa Cruz;331;168;163;2020
22;Huesca;195;Quicena;282;137;145;2020
22;Huesca;197;Robres;514;266;248;2020
22;Huesca;199;Sabiñánigo;9185;4587;4598;2020
22;Huesca;200;Sahún;303;155;148;2020
22;Huesca;201;Salas Altas;306;156;150;2020
22;Huesca;202;Salas Bajas;185;88;97;2020
22;Huesca;203;Salillas;91;51;40;2020
22;Huesca;204;Sallent de Gállego;1477;729;748;2020
22;Huesca;205;San Esteban de Litera;547;288;259;2020
22;Huesca;207;San Juan de Plan;150;83;67;2020
22;Huesca;903;San Miguel del Cinca;780;399;381;2020
22;Huesca;206;Sangarrén;221;117;104;2020
22;Huesca;208;Santa Cilia;243;124;119;2020
22;Huesca;209;Santa Cruz de la Serós;188;109;79;2020
22;Huesca;906;Santa María de Dulcis;205;107;98;2020
22;Huesca;212;Santaliestra y San Quílez;80;41;39;2020
22;Huesca;213;Sariñena;4184;2192;1992;2020
22;Huesca;214;Secastilla;140;62;78;2020
22;Huesca;215;Seira;145;84;61;2020
22;Huesca;217;Sena;501;268;233;2020
22;Huesca;218;Senés de Alcubierre;40;21;19;2020
22;Huesca;220;Sesa;154;87;67;2020
22;Huesca;221;Sesué;122;61;61;2020
22;Huesca;222;Siétamo;689;378;311;2020
22;Huesca;223;Sopeira;91;51;40;2020
22;Huesca;904;Sotonera, La;859;460;399;2020
22;Huesca;225;Tamarite de Litera;3487;1798;1689;2020
22;Huesca;226;Tardienta;948;469;479;2020
22;Huesca;227;Tella-Sin;225;129;96;2020
22;Huesca;228;Tierz;781;392;389;2020
22;Huesca;229;Tolva;122;68;54;2020
22;Huesca;230;Torla-Ordesa;298;157;141;2020
22;Huesca;232;Torralba de Aragón;113;66;47;2020
22;Huesca;233;Torre la Ribera;96;51;45;2020
22;Huesca;234;Torrente de Cinca;1327;715;612;2020
22;Huesca;235;Torres de Alcanadre;82;49;33;2020
22;Huesca;236;Torres de Barbués;251;123;128;2020
22;Huesca;239;Tramaced;98;63;35;2020
22;Huesca;242;Valfarta;63;39;24;2020
22;Huesca;243;Valle de Bardají;40;22;18;2020
22;Huesca;901;Valle de Hecho;817;432;385;2020
22;Huesca;244;Valle de Lierp;51;30;21;2020
22;Huesca;245;Velilla de Cinca;460;241;219;2020
22;Huesca;909;Vencillón;390;209;181;2020
22;Huesca;247;Viacamp y Litera;37;24;13;2020
22;Huesca;248;Vicién;110;63;47;2020
22;Huesca;249;Villanova;174;87;87;2020
22;Huesca;250;Villanúa;451;238;213;2020
22;Huesca;251;Villanueva de Sigena;384;202;182;2020
22;Huesca;252;Yebra de Basa;142;86;56;2020
22;Huesca;253;Yésero;57;33;24;2020
22;Huesca;254;Zaidín;1798;950;848;2020
23;Jaén;001;Albanchez de Mágina;1011;528;483;2020
23;Jaén;002;Alcalá la Real;21709;10678;11031;2020
23;Jaén;003;Alcaudete;10483;5173;5310;2020
23;Jaén;004;Aldeaquemada;476;259;217;2020
23;Jaén;005;Andújar;36615;17919;18696;2020
23;Jaén;006;Arjona;5515;2715;2800;2020
23;Jaén;007;Arjonilla;3571;1810;1761;2020
23;Jaén;008;Arquillos;1722;866;856;2020
23;Jaén;905;Arroyo del Ojanco;2287;1147;1140;2020
23;Jaén;009;Baeza;15791;7817;7974;2020
23;Jaén;010;Bailén;17548;8709;8839;2020
23;Jaén;011;Baños de la Encina;2576;1329;1247;2020
23;Jaén;012;Beas de Segura;5100;2658;2442;2020
23;Jaén;902;Bedmar y Garcíez;2633;1334;1299;2020
23;Jaén;014;Begíjar;3009;1509;1500;2020
23;Jaén;015;Bélmez de la Moraleda;1569;790;779;2020
23;Jaén;016;Benatae;445;227;218;2020
23;Jaén;017;Cabra del Santo Cristo;1782;927;855;2020
23;Jaén;018;Cambil;2683;1403;1280;2020
23;Jaén;019;Campillo de Arenas;1751;887;864;2020
23;Jaén;020;Canena;1814;936;878;2020
23;Jaén;021;Carboneros;591;307;284;2020
23;Jaén;901;Cárcheles;1332;700;632;2020
23;Jaén;024;Carolina, La;15160;7497;7663;2020
23;Jaén;025;Castellar;3292;1659;1633;2020
23;Jaén;026;Castillo de Locubín;4049;1998;2051;2020
23;Jaén;027;Cazalilla;803;396;407;2020
23;Jaén;028;Cazorla;7352;3565;3787;2020
23;Jaén;029;Chiclana de Segura;955;482;473;2020
23;Jaén;030;Chilluévar;1410;682;728;2020
23;Jaén;031;Escañuela;944;463;481;2020
23;Jaén;032;Espeluy;620;304;316;2020
23;Jaén;033;Frailes;1585;788;797;2020
23;Jaén;034;Fuensanta de Martos;3038;1524;1514;2020
23;Jaén;035;Fuerte del Rey;1355;688;667;2020
23;Jaén;037;Génave;590;324;266;2020
23;Jaén;038;Guardia de Jaén, La;4983;2518;2465;2020
23;Jaén;039;Guarromán;2739;1384;1355;2020
23;Jaén;041;Higuera de Calatrava;614;325;289;2020
23;Jaén;042;Hinojares;373;199;174;2020
23;Jaén;043;Hornos;594;295;299;2020
23;Jaén;044;Huelma;5744;2857;2887;2020
23;Jaén;045;Huesa;2490;1262;1228;2020
23;Jaén;046;Ibros;2827;1422;1405;2020
23;Jaén;047;Iruela, La;1879;938;941;2020
23;Jaén;048;Iznatoraf;942;478;464;2020
23;Jaén;049;Jabalquinto;2017;1022;995;2020
23;Jaén;050;Jaén;112757;54244;58513;2020
23;Jaén;051;Jamilena;3271;1654;1617;2020
23;Jaén;052;Jimena;1269;612;657;2020
23;Jaén;053;Jódar;11634;5813;5821;2020
23;Jaén;040;Lahiguera;1686;827;859;2020
23;Jaén;054;Larva;474;244;230;2020
23;Jaén;055;Linares;57353;28042;29311;2020
23;Jaén;056;Lopera;3652;1854;1798;2020
23;Jaén;057;Lupión;820;405;415;2020
23;Jaén;058;Mancha Real;11328;5660;5668;2020
23;Jaén;059;Marmolejo;6763;3354;3409;2020
23;Jaén;060;Martos;24343;12070;12273;2020
23;Jaén;061;Mengíbar;9997;4973;5024;2020
23;Jaén;062;Montizón;1689;866;823;2020
23;Jaén;063;Navas de San Juan;4528;2275;2253;2020
23;Jaén;064;Noalejo;1932;978;954;2020
23;Jaén;065;Orcera;1791;912;879;2020
23;Jaén;066;Peal de Becerro;5240;2605;2635;2020
23;Jaén;067;Pegalajar;2875;1453;1422;2020
23;Jaén;069;Porcuna;6156;3102;3054;2020
23;Jaén;070;Pozo Alcón;4731;2436;2295;2020
23;Jaén;071;Puente de Génave;2159;1076;1083;2020
23;Jaén;072;Puerta de Segura, La;2234;1121;1113;2020
23;Jaén;073;Quesada;5196;2638;2558;2020
23;Jaén;074;Rus;3531;1811;1720;2020
23;Jaén;075;Sabiote;3886;1918;1968;2020
23;Jaén;076;Santa Elena;890;465;425;2020
23;Jaén;077;Santiago de Calatrava;675;360;315;2020
23;Jaén;904;Santiago-Pontones;2911;1491;1420;2020
23;Jaén;079;Santisteban del Puerto;4463;2297;2166;2020
23;Jaén;080;Santo Tomé;2129;1091;1038;2020
23;Jaén;081;Segura de la Sierra;1803;885;918;2020
23;Jaén;082;Siles;2220;1126;1094;2020
23;Jaén;084;Sorihuela del Guadalimar;1098;571;527;2020
23;Jaén;085;Torreblascopedro;2508;1271;1237;2020
23;Jaén;086;Torredelcampo;14142;7079;7063;2020
23;Jaén;087;Torredonjimeno;13632;6710;6922;2020
23;Jaén;088;Torreperogil;7222;3532;3690;2020
23;Jaén;090;Torres;1372;709;663;2020
23;Jaén;091;Torres de Albánchez;770;402;368;2020
23;Jaén;092;Úbeda;34329;16790;17539;2020
23;Jaén;093;Valdepeñas de Jaén;3679;1819;1860;2020
23;Jaén;094;Vilches;4409;2210;2199;2020
23;Jaén;095;Villacarrillo;10673;5363;5310;2020
23;Jaén;096;Villanueva de la Reina;3038;1522;1516;2020
23;Jaén;097;Villanueva del Arzobispo;8078;4143;3935;2020
23;Jaén;098;Villardompardo;968;488;480;2020
23;Jaén;099;Villares, Los;6020;3014;3006;2020
23;Jaén;101;Villarrodrigo;391;210;181;2020
23;Jaén;903;Villatorres;4298;2175;2123;2020
24;León;001;Acebedo;184;108;76;2020
24;León;002;Algadefe;278;143;135;2020
24;León;003;Alija del Infantado;629;323;306;2020
24;León;004;Almanza;581;335;246;2020
24;León;005;Antigua, La;358;207;151;2020
24;León;006;Ardón;560;302;258;2020
24;León;007;Arganza;774;391;383;2020
24;León;008;Astorga;10741;5027;5714;2020
24;León;009;Balboa;292;159;133;2020
24;León;010;Bañeza, La;10290;4949;5341;2020
24;León;011;Barjas;172;94;78;2020
24;León;012;Barrios de Luna, Los;307;177;130;2020
24;León;014;Bembibre;8598;4145;4453;2020
24;León;015;Benavides;2440;1209;1231;2020
24;León;016;Benuza;482;287;195;2020
24;León;017;Bercianos del Páramo;554;280;274;2020
24;León;018;Bercianos del Real Camino;185;100;85;2020
24;León;019;Berlanga del Bierzo;354;163;191;2020
24;León;020;Boca de Huérgano;455;274;181;2020
24;León;021;Boñar;1816;916;900;2020
24;León;022;Borrenes;309;166;143;2020
24;León;023;Brazuelo;337;182;155;2020
24;León;024;Burgo Ranero, El;702;370;332;2020
24;León;025;Burón;303;176;127;2020
24;León;026;Bustillo del Páramo;1129;585;544;2020
24;León;027;Cabañas Raras;1335;685;650;2020
24;León;028;Cabreros del Río;417;228;189;2020
24;León;029;Cabrillanes;747;394;353;2020
24;León;030;Cacabelos;4996;2470;2526;2020
24;León;031;Calzada del Coto;218;131;87;2020
24;León;032;Campazas;111;53;58;2020
24;León;033;Campo de Villavidel;212;116;96;2020
24;León;034;Camponaraya;4097;2014;2083;2020
24;León;036;Candín;249;139;110;2020
24;León;037;Cármenes;344;191;153;2020
24;León;038;Carracedelo;3364;1684;1680;2020
24;León;039;Carrizo;2224;1118;1106;2020
24;León;040;Carrocera;446;242;204;2020
24;León;041;Carucedo;531;266;265;2020
24;León;042;Castilfalé;67;39;28;2020
24;León;043;Castrillo de Cabrera;111;66;45;2020
24;León;044;Castrillo de la Valduerna;155;68;87;2020
24;León;046;Castrocalbón;938;489;449;2020
24;León;047;Castrocontrigo;725;392;333;2020
24;León;049;Castropodame;1629;841;788;2020
24;León;050;Castrotierra de Valmadrigal;114;60;54;2020
24;León;051;Cea;403;215;188;2020
24;León;052;Cebanico;148;90;58;2020
24;León;053;Cebrones del Río;439;244;195;2020
24;León;065;Chozas de Abajo;2561;1323;1238;2020
24;León;054;Cimanes de la Vega;449;232;217;2020
24;León;055;Cimanes del Tejar;719;391;328;2020
24;León;056;Cistierna;3090;1529;1561;2020
24;León;057;Congosto;1446;725;721;2020
24;León;058;Corbillos de los Oteros;185;106;79;2020
24;León;059;Corullón;887;452;435;2020
24;León;060;Crémenes;527;288;239;2020
24;León;061;Cuadros;2035;1028;1007;2020
24;León;062;Cubillas de los Oteros;135;77;58;2020
24;León;063;Cubillas de Rueda;409;221;188;2020
24;León;064;Cubillos del Sil;1768;929;839;2020
24;León;066;Destriana;459;212;247;2020
24;León;067;Encinedo;690;363;327;2020
24;León;068;Ercina, La;441;235;206;2020
24;León;069;Escobar de Campos;34;19;15;2020
24;León;070;Fabero;4386;2138;2248;2020
24;León;071;Folgoso de la Ribera;1045;507;538;2020
24;León;073;Fresno de la Vega;479;247;232;2020
24;León;074;Fuentes de Carbajal;93;53;40;2020
24;León;076;Garrafe de Torío;1513;811;702;2020
24;León;077;Gordaliza del Pino;245;120;125;2020
24;León;078;Gordoncillo;365;181;184;2020
24;León;079;Gradefes;931;513;418;2020
24;León;080;Grajal de Campos;227;113;114;2020
24;León;081;Gusendos de los Oteros;126;67;59;2020
24;León;082;Hospital de Órbigo;991;500;491;2020
24;León;083;Igüeña;1123;590;533;2020
24;León;084;Izagre;161;82;79;2020
24;León;086;Joarilla de las Matas;279;145;134;2020
24;León;087;Laguna Dalga;640;343;297;2020
24;León;088;Laguna de Negrillos;1061;545;516;2020
24;León;089;León;124028;56191;67837;2020
24;León;092;Llamas de la Ribera;800;423;377;2020
24;León;090;Lucillo;367;198;169;2020
24;León;091;Luyego;590;316;274;2020
24;León;093;Magaz de Cepeda;367;196;171;2020
24;León;094;Mansilla de las Mulas;1743;877;866;2020
24;León;095;Mansilla Mayor;337;180;157;2020
24;León;096;Maraña;112;69;43;2020
24;León;097;Matadeón de los Oteros;223;112;111;2020
24;León;098;Matallana de Torío;1270;661;609;2020
24;León;099;Matanza;161;87;74;2020
24;León;100;Molinaseca;862;477;385;2020
24;León;101;Murias de Paredes;371;190;181;2020
24;León;102;Noceda del Bierzo;640;330;310;2020
24;León;103;Oencia;270;159;111;2020
24;León;104;Omañas, Las;267;146;121;2020
24;León;105;Onzonilla;1832;941;891;2020
24;León;106;Oseja de Sajambre;224;133;91;2020
24;León;107;Pajares de los Oteros;248;153;95;2020
24;León;108;Palacios de la Valduerna;383;184;199;2020
24;León;109;Palacios del Sil;907;498;409;2020
24;León;110;Páramo del Sil;1255;644;611;2020
24;León;112;Peranzanes;279;163;116;2020
24;León;113;Pobladura de Pelayo García;379;198;181;2020
24;León;114;Pola de Gordón, La;3120;1579;1541;2020
24;León;115;Ponferrada;64509;30532;33977;2020
24;León;116;Posada de Valdeón;415;239;176;2020
24;León;117;Pozuelo del Páramo;423;210;213;2020
24;León;118;Prado de la Guzpeña;104;59;45;2020
24;León;119;Priaranza del Bierzo;773;388;385;2020
24;León;120;Prioro;332;200;132;2020
24;León;121;Puebla de Lillo;652;384;268;2020
24;León;122;Puente de Domingo Flórez;1458;762;696;2020
24;León;123;Quintana del Castillo;721;411;310;2020
24;León;124;Quintana del Marco;353;190;163;2020
24;León;125;Quintana y Congosto;375;193;182;2020
24;León;127;Regueras de Arriba;277;146;131;2020
24;León;129;Reyero;123;64;59;2020
24;León;130;Riaño;458;252;206;2020
24;León;131;Riego de la Vega;743;396;347;2020
24;León;132;Riello;622;355;267;2020
24;León;133;Rioseco de Tapia;381;216;165;2020
24;León;134;Robla, La;3752;1862;1890;2020
24;León;136;Roperuelos del Páramo;522;265;257;2020
24;León;137;Sabero;1123;579;544;2020
24;León;139;Sahagún;2477;1220;1257;2020
24;León;141;San Adrián del Valle;100;54;46;2020
24;León;142;San Andrés del Rabanedo;30549;14550;15999;2020
24;León;144;San Cristóbal de la Polantera;667;347;320;2020
24;León;145;San Emiliano;627;350;277;2020
24;León;146;San Esteban de Nogales;257;136;121;2020
24;León;148;San Justo de la Vega;1807;933;874;2020
24;León;149;San Millán de los Caballeros;168;89;79;2020
24;León;150;San Pedro Bercianos;231;123;108;2020
24;León;143;Sancedo;546;272;274;2020
24;León;151;Santa Colomba de Curueño;473;250;223;2020
24;León;152;Santa Colomba de Somoza;501;272;229;2020
24;León;153;Santa Cristina de Valmadrigal;254;134;120;2020
24;León;154;Santa Elena de Jamuz;1047;549;498;2020
24;León;155;Santa María de la Isla;476;246;230;2020
24;León;158;Santa María de Ordás;315;168;147;2020
24;León;156;Santa María del Monte de Cea;225;123;102;2020
24;León;157;Santa María del Páramo;3101;1514;1587;2020
24;León;159;Santa Marina del Rey;1860;934;926;2020
24;León;160;Santas Martas;729;389;340;2020
24;León;161;Santiago Millas;330;182;148;2020
24;León;162;Santovenia de la Valdoncina;2100;1075;1025;2020
24;León;163;Sariegos;5084;2545;2539;2020
24;León;164;Sena de Luna;366;182;184;2020
24;León;165;Sobrado;301;150;151;2020
24;León;166;Soto de la Vega;1526;794;732;2020
24;León;167;Soto y Amío;773;403;370;2020
24;León;168;Toral de los Guzmanes;501;271;230;2020
24;León;206;Toral de los Vados;1812;892;920;2020
24;León;169;Toreno;3012;1498;1514;2020
24;León;170;Torre del Bierzo;2114;1089;1025;2020
24;León;171;Trabadelo;333;185;148;2020
24;León;172;Truchas;419;222;197;2020
24;León;173;Turcia;986;510;476;2020
24;León;174;Urdiales del Páramo;494;264;230;2020
24;León;185;Val de San Lorenzo;496;249;247;2020
24;León;175;Valdefresno;2173;1132;1041;2020
24;León;176;Valdefuentes del Páramo;319;172;147;2020
24;León;177;Valdelugueros;515;295;220;2020
24;León;178;Valdemora;73;32;41;2020
24;León;179;Valdepiélago;307;177;130;2020
24;León;180;Valdepolo;1200;650;550;2020
24;León;181;Valderas;1586;798;788;2020
24;León;182;Valderrey;446;229;217;2020
24;León;183;Valderrueda;827;431;396;2020
24;León;184;Valdesamario;189;104;85;2020
24;León;187;Valdevimbre;958;497;461;2020
24;León;188;Valencia de Don Juan;5272;2590;2682;2020
24;León;191;Vallecillo;125;74;51;2020
24;León;189;Valverde de la Virgen;7377;3811;3566;2020
24;León;190;Valverde-Enrique;155;77;78;2020
24;León;193;Vecilla, La;393;207;186;2020
24;León;196;Vega de Espinareda;2044;1037;1007;2020
24;León;197;Vega de Infanzones;818;413;405;2020
24;León;198;Vega de Valcarce;587;304;283;2020
24;León;194;Vegacervera;267;140;127;2020
24;León;199;Vegaquemada;438;245;193;2020
24;León;201;Vegas del Condado;1109;643;466;2020
24;León;202;Villablino;8444;4148;4296;2020
24;León;203;Villabraz;91;51;40;2020
24;León;205;Villadangos del Páramo;1163;611;552;2020
24;León;207;Villademor de la Vega;325;174;151;2020
24;León;209;Villafranca del Bierzo;2855;1381;1474;2020
24;León;210;Villagatón;627;335;292;2020
24;León;211;Villamandos;295;161;134;2020
24;León;901;Villamanín;911;458;453;2020
24;León;212;Villamañán;1102;560;542;2020
24;León;213;Villamartín de Don Sancho;159;86;73;2020
24;León;214;Villamejil;672;362;310;2020
24;León;215;Villamol;152;78;74;2020
24;León;216;Villamontán de la Valduerna;720;381;339;2020
24;León;217;Villamoratiel de las Matas;135;75;60;2020
24;León;218;Villanueva de las Manzanas;494;258;236;2020
24;León;219;Villaobispo de Otero;532;293;239;2020
24;León;902;Villaornate y Castro;334;172;162;2020
24;León;221;Villaquejida;827;424;403;2020
24;León;222;Villaquilambre;18684;9241;9443;2020
24;León;223;Villarejo de Órbigo;2975;1458;1517;2020
24;León;224;Villares de Órbigo;596;318;278;2020
24;León;225;Villasabariego;1123;575;548;2020
24;León;226;Villaselán;194;112;82;2020
24;León;227;Villaturiel;1826;958;868;2020
24;León;228;Villazala;647;344;303;2020
24;León;229;Villazanzo de Valderaduey;397;232;165;2020
24;León;230;Zotes del Páramo;423;240;183;2020
25;Lleida;001;Abella de la Conca;183;99;84;2020
25;Lleida;002;Àger;580;314;266;2020
25;Lleida;003;Agramunt;5411;2710;2701;2020
25;Lleida;038;Aitona;2567;1338;1229;2020
25;Lleida;004;Alamús, Els;811;412;399;2020
25;Lleida;005;Alàs i Cerc;320;158;162;2020
25;Lleida;006;Albagés, L';361;189;172;2020
25;Lleida;007;Albatàrrec;2236;1142;1094;2020
25;Lleida;008;Albesa;1561;848;713;2020
25;Lleida;009;Albi, L';744;378;366;2020
25;Lleida;010;Alcanó;238;121;117;2020
25;Lleida;011;Alcarràs;9707;5096;4611;2020
25;Lleida;012;Alcoletge;3435;1805;1630;2020
25;Lleida;013;Alfarràs;2765;1440;1325;2020
25;Lleida;014;Alfés;297;159;138;2020
25;Lleida;015;Algerri;404;219;185;2020
25;Lleida;016;Alguaire;3029;1606;1423;2020
25;Lleida;017;Alins;272;143;129;2020
25;Lleida;019;Almacelles;6826;3649;3177;2020
25;Lleida;020;Almatret;305;170;135;2020
25;Lleida;021;Almenar;3357;1774;1583;2020
25;Lleida;022;Alòs de Balaguer;132;79;53;2020
25;Lleida;023;Alpicat;6266;3138;3128;2020
25;Lleida;024;Alt Àneu;414;239;175;2020
25;Lleida;027;Anglesola;1365;689;676;2020
25;Lleida;029;Arbeca;2126;1101;1025;2020
25;Lleida;031;Arres;60;39;21;2020
25;Lleida;032;Arsèguel;81;46;35;2020
25;Lleida;033;Artesa de Lleida;1535;816;719;2020
25;Lleida;034;Artesa de Segre;3400;1756;1644;2020
25;Lleida;036;Aspa;220;115;105;2020
25;Lleida;037;Avellanes i Santa Linya, Les;433;249;184;2020
25;Lleida;039;Baix Pallars;331;180;151;2020
25;Lleida;040;Balaguer;17472;8953;8519;2020
25;Lleida;041;Barbens;878;468;410;2020
25;Lleida;042;Baronia de Rialb, La;229;116;113;2020
25;Lleida;044;Bassella;217;112;105;2020
25;Lleida;045;Bausen;60;30;30;2020
25;Lleida;046;Belianes;520;261;259;2020
25;Lleida;170;Bellaguarda;287;150;137;2020
25;Lleida;047;Bellcaire d'Urgell;1199;607;592;2020
25;Lleida;048;Bell-lloc d'Urgell;2335;1159;1176;2020
25;Lleida;049;Bellmunt d'Urgell;185;90;95;2020
25;Lleida;050;Bellpuig;5218;2774;2444;2020
25;Lleida;051;Bellver de Cerdanya;2005;1035;970;2020
25;Lleida;052;Bellvís;2260;1159;1101;2020
25;Lleida;053;Benavent de Segrià;1518;806;712;2020
25;Lleida;055;Biosca;177;94;83;2020
25;Lleida;057;Bòrdes, Es;255;142;113;2020
25;Lleida;058;Borges Blanques, Les;6173;3152;3021;2020
25;Lleida;059;Bossòst;1115;544;571;2020
25;Lleida;056;Bovera;248;138;110;2020
25;Lleida;060;Cabanabona;71;34;37;2020
25;Lleida;061;Cabó;93;50;43;2020
25;Lleida;062;Camarasa;810;406;404;2020
25;Lleida;063;Canejan;89;45;44;2020
25;Lleida;904;Castell de Mur;173;96;77;2020
25;Lleida;064;Castellar de la Ribera;131;66;65;2020
25;Lleida;067;Castelldans;930;497;433;2020
25;Lleida;068;Castellnou de Seana;665;354;311;2020
25;Lleida;069;Castelló de Farfanya;539;291;248;2020
25;Lleida;070;Castellserà;996;505;491;2020
25;Lleida;071;Cava;45;29;16;2020
25;Lleida;072;Cervera;9350;4778;4572;2020
25;Lleida;073;Cervià de les Garrigues;662;350;312;2020
25;Lleida;074;Ciutadilla;208;111;97;2020
25;Lleida;075;Clariana de Cardener;161;86;75;2020
25;Lleida;076;Cogul, El;151;83;68;2020
25;Lleida;077;Coll de Nargó;540;277;263;2020
25;Lleida;163;Coma i la Pedra, La;255;151;104;2020
25;Lleida;161;Conca de Dalt;410;209;201;2020
25;Lleida;078;Corbins;1462;811;651;2020
25;Lleida;079;Cubells;338;179;159;2020
25;Lleida;081;Espluga Calba, L';329;168;161;2020
25;Lleida;082;Espot;366;197;169;2020
25;Lleida;088;Estamariu;125;72;53;2020
25;Lleida;085;Estaràs;156;79;77;2020
25;Lleida;086;Esterri d'Àneu;804;382;422;2020
25;Lleida;087;Esterri de Cardós;64;34;30;2020
25;Lleida;089;Farrera;108;63;45;2020
25;Lleida;908;Fígols i Alinyà;244;140;104;2020
25;Lleida;092;Floresta, La;140;76;64;2020
25;Lleida;093;Fondarella;776;388;388;2020
25;Lleida;094;Foradada;203;132;71;2020
25;Lleida;096;Fuliola, La;1250;620;630;2020
25;Lleida;097;Fulleda;102;53;49;2020
25;Lleida;098;Gavet de la Conca;261;131;130;2020
25;Lleida;912;Gimenells i el Pla de la Font;1120;600;520;2020
25;Lleida;099;Golmés;1855;940;915;2020
25;Lleida;100;Gósol;206;118;88;2020
25;Lleida;101;Granadella, La;716;392;324;2020
25;Lleida;102;Granja d'Escarp, La;922;509;413;2020
25;Lleida;103;Granyanella;143;80;63;2020
25;Lleida;105;Granyena de les Garrigues;140;85;55;2020
25;Lleida;104;Granyena de Segarra;151;82;69;2020
25;Lleida;109;Guimerà;271;141;130;2020
25;Lleida;903;Guingueta d'Àneu, La;289;156;133;2020
25;Lleida;110;Guissona;7248;3893;3355;2020
25;Lleida;111;Guixers;132;80;52;2020
25;Lleida;115;Isona i Conca Dellà;1042;562;480;2020
25;Lleida;112;Ivars de Noguera;332;173;159;2020
25;Lleida;113;Ivars d'Urgell;1537;806;731;2020
25;Lleida;114;Ivorra;108;59;49;2020
25;Lleida;910;Josa i Tuixén;103;59;44;2020
25;Lleida;118;Juncosa;395;206;189;2020
25;Lleida;119;Juneda;3501;1877;1624;2020
25;Lleida;121;Les;971;464;507;2020
25;Lleida;122;Linyola;2717;1367;1350;2020
25;Lleida;123;Lladorre;237;119;118;2020
25;Lleida;124;Lladurs;180;95;85;2020
25;Lleida;125;Llardecans;444;237;207;2020
25;Lleida;126;Llavorsí;346;176;170;2020
25;Lleida;120;Lleida;140403;69541;70862;2020
25;Lleida;127;Lles de Cerdanya;270;157;113;2020
25;Lleida;128;Llimiana;146;86;60;2020
25;Lleida;129;Llobera;188;107;81;2020
25;Lleida;133;Maials;909;500;409;2020
25;Lleida;130;Maldà;227;109;118;2020
25;Lleida;131;Massalcoreig;610;354;256;2020
25;Lleida;132;Massoteres;212;117;95;2020
25;Lleida;134;Menàrguens;813;445;368;2020
25;Lleida;135;Miralcamp;1385;717;668;2020
25;Lleida;137;Mollerussa;14649;7524;7125;2020
25;Lleida;136;Molsosa, La;104;51;53;2020
25;Lleida;139;Montellà i Martinet;578;318;260;2020
25;Lleida;140;Montferrer i Castellbò;1034;559;475;2020
25;Lleida;138;Montgai;643;342;301;2020
25;Lleida;142;Montoliu de Lleida;483;253;230;2020
25;Lleida;141;Montoliu de Segarra;187;102;85;2020
25;Lleida;143;Montornès de Segarra;96;46;50;2020
25;Lleida;145;Nalec;90;46;44;2020
25;Lleida;025;Naut Aran;1836;953;883;2020
25;Lleida;146;Navès;284;146;138;2020
25;Lleida;148;Odèn;258;152;106;2020
25;Lleida;149;Oliana;1843;918;925;2020
25;Lleida;150;Oliola;203;109;94;2020
25;Lleida;151;Olius;981;527;454;2020
25;Lleida;152;Oluges, Les;171;90;81;2020
25;Lleida;153;Omellons, Els;206;110;96;2020
25;Lleida;154;Omells de na Gaia, Els;130;74;56;2020
25;Lleida;155;Organyà;771;387;384;2020
25;Lleida;156;Os de Balaguer;980;501;479;2020
25;Lleida;157;Ossó de Sió;203;97;106;2020
25;Lleida;158;Palau d'Anglesola, El;2166;1071;1095;2020
25;Lleida;164;Penelles;436;255;181;2020
25;Lleida;165;Peramola;347;173;174;2020
25;Lleida;166;Pinell de Solsonès;193;113;80;2020
25;Lleida;167;Pinós;286;152;134;2020
25;Lleida;911;Plans de Sió, Els;491;266;225;2020
25;Lleida;168;Poal, El;670;350;320;2020
25;Lleida;169;Pobla de Cérvoles, La;189;104;85;2020
25;Lleida;171;Pobla de Segur, La;3043;1515;1528;2020
25;Lleida;030;Pont de Bar, El;152;91;61;2020
25;Lleida;173;Pont de Suert, El;2257;1128;1129;2020
25;Lleida;172;Ponts;2644;1337;1307;2020
25;Lleida;174;Portella, La;743;423;320;2020
25;Lleida;175;Prats i Sansor;222;116;106;2020
25;Lleida;176;Preixana;387;200;187;2020
25;Lleida;177;Preixens;418;211;207;2020
25;Lleida;179;Prullans;226;104;122;2020
25;Lleida;180;Puiggròs;278;142;136;2020
25;Lleida;181;Puigverd d'Agramunt;229;131;98;2020
25;Lleida;182;Puigverd de Lleida;1349;694;655;2020
25;Lleida;183;Rialp;641;319;322;2020
25;Lleida;905;Ribera d'Ondara;433;215;218;2020
25;Lleida;185;Ribera d'Urgellet;932;480;452;2020
25;Lleida;186;Riner;263;133;130;2020
25;Lleida;913;Riu de Cerdanya;93;55;38;2020
25;Lleida;189;Rosselló;3237;1663;1574;2020
25;Lleida;190;Salàs de Pallars;327;174;153;2020
25;Lleida;191;Sanaüja;379;198;181;2020
25;Lleida;196;Sant Esteve de la Sarga;122;74;48;2020
25;Lleida;192;Sant Guim de Freixenet;1037;539;498;2020
25;Lleida;197;Sant Guim de la Plana;181;99;82;2020
25;Lleida;193;Sant Llorenç de Morunys;960;467;493;2020
25;Lleida;902;Sant Martí de Riucorb;639;328;311;2020
25;Lleida;194;Sant Ramon;487;259;228;2020
25;Lleida;201;Sarroca de Bellera;116;68;48;2020
25;Lleida;200;Sarroca de Lleida;358;203;155;2020
25;Lleida;202;Senterada;139;82;57;2020
25;Lleida;035;Sentiu de Sió, La;414;217;197;2020
25;Lleida;204;Seròs;1946;1048;898;2020
25;Lleida;203;Seu d'Urgell, La;12206;5919;6287;2020
25;Lleida;205;Sidamon;748;397;351;2020
25;Lleida;206;Soleràs, El;332;175;157;2020
25;Lleida;207;Solsona;9137;4511;4626;2020
25;Lleida;208;Soriguera;420;225;195;2020
25;Lleida;209;Sort;2154;1066;1088;2020
25;Lleida;210;Soses;1761;913;848;2020
25;Lleida;211;Sudanell;840;457;383;2020
25;Lleida;212;Sunyer;343;200;143;2020
25;Lleida;215;Talarn;595;402;193;2020
25;Lleida;216;Talavera;279;156;123;2020
25;Lleida;217;Tàrrega;17445;8658;8787;2020
25;Lleida;218;Tarrés;102;54;48;2020
25;Lleida;219;Tarroja de Segarra;188;99;89;2020
25;Lleida;220;Térmens;1360;688;672;2020
25;Lleida;221;Tírvia;134;63;71;2020
25;Lleida;222;Tiurana;77;34;43;2020
25;Lleida;223;Torà;1237;627;610;2020
25;Lleida;224;Torms, Els;138;74;64;2020
25;Lleida;225;Tornabous;822;440;382;2020
25;Lleida;227;Torre de Cabdella, La;759;381;378;2020
25;Lleida;226;Torrebesses;267;143;124;2020
25;Lleida;228;Torrefarrera;4694;2381;2313;2020
25;Lleida;907;Torrefeta i Florejacs;607;326;281;2020
25;Lleida;230;Torregrossa;2179;1143;1036;2020
25;Lleida;231;Torrelameu;735;443;292;2020
25;Lleida;232;Torres de Segre;2366;1228;1138;2020
25;Lleida;233;Torre-serona;398;208;190;2020
25;Lleida;234;Tremp;5911;2895;3016;2020
25;Lleida;043;Vall de Boí, La;1019;543;476;2020
25;Lleida;901;Vall de Cardós;350;189;161;2020
25;Lleida;238;Vallbona de les Monges;243;127;116;2020
25;Lleida;240;Vallfogona de Balaguer;1906;951;955;2020
25;Lleida;906;Valls d'Aguilar, Les;245;140;105;2020
25;Lleida;239;Valls de Valira, Les;784;404;380;2020
25;Lleida;909;Vansa i Fórnols, La;149;78;71;2020
25;Lleida;242;Verdú;902;421;481;2020
25;Lleida;243;Vielha e Mijaran;5611;2858;2753;2020
25;Lleida;244;Vilagrassa;560;294;266;2020
25;Lleida;245;Vilaller;549;291;258;2020
25;Lleida;247;Vilamòs;178;95;83;2020
25;Lleida;248;Vilanova de Bellpuig;1183;600;583;2020
25;Lleida;254;Vilanova de la Barca;1088;592;496;2020
25;Lleida;249;Vilanova de l'Aguda;200;98;102;2020
25;Lleida;250;Vilanova de Meià;415;249;166;2020
25;Lleida;251;Vilanova de Segrià;985;529;456;2020
25;Lleida;252;Vila-sana;734;373;361;2020
25;Lleida;253;Vilosell, El;173;89;84;2020
25;Lleida;255;Vinaixa;450;235;215;2020
27;Lugo;001;Abadín;2322;1144;1178;2020
27;Lugo;002;Alfoz;1659;803;856;2020
27;Lugo;003;Antas de Ulla;1940;957;983;2020
27;Lugo;004;Baleira;1226;656;570;2020
27;Lugo;901;Baralla;2482;1303;1179;2020
27;Lugo;005;Barreiros;2925;1412;1513;2020
27;Lugo;006;Becerreá;2807;1403;1404;2020
27;Lugo;007;Begonte;2978;1498;1480;2020
27;Lugo;008;Bóveda;1450;742;708;2020
27;Lugo;902;Burela;9498;4722;4776;2020
27;Lugo;009;Carballedo;2139;1073;1066;2020
27;Lugo;010;Castro de Rei;5073;2508;2565;2020
27;Lugo;011;Castroverde;2595;1342;1253;2020
27;Lugo;012;Cervantes;1294;744;550;2020
27;Lugo;013;Cervo;4218;2074;2144;2020
27;Lugo;016;Chantada;8157;3928;4229;2020
27;Lugo;014;Corgo, O;3422;1748;1674;2020
27;Lugo;015;Cospeito;4395;2147;2248;2020
27;Lugo;017;Folgoso do Courel;1007;520;487;2020
27;Lugo;018;Fonsagrada, A;3389;1773;1616;2020
27;Lugo;019;Foz;10016;4876;5140;2020
27;Lugo;020;Friol;3664;1862;1802;2020
27;Lugo;022;Guitiriz;5490;2731;2759;2020
27;Lugo;023;Guntín;2628;1353;1275;2020
27;Lugo;024;Incio, O;1533;770;763;2020
27;Lugo;026;Láncara;2584;1327;1257;2020
27;Lugo;027;Lourenzá;2139;1039;1100;2020
27;Lugo;028;Lugo;98519;45568;52951;2020
27;Lugo;029;Meira;1748;883;865;2020
27;Lugo;030;Mondoñedo;3539;1669;1870;2020
27;Lugo;031;Monforte de Lemos;18347;8712;9635;2020
27;Lugo;032;Monterroso;3613;1793;1820;2020
27;Lugo;033;Muras;619;307;312;2020
27;Lugo;034;Navia de Suarna;1063;589;474;2020
27;Lugo;035;Negueira de Muñiz;215;116;99;2020
27;Lugo;037;Nogais, As;1047;555;492;2020
27;Lugo;038;Ourol;995;508;487;2020
27;Lugo;039;Outeiro de Rei;5210;2676;2534;2020
27;Lugo;040;Palas de Rei;3326;1680;1646;2020
27;Lugo;041;Pantón;2457;1219;1238;2020
27;Lugo;042;Paradela;1739;866;873;2020
27;Lugo;043;Páramo, O;1344;667;677;2020
27;Lugo;044;Pastoriza, A;2963;1494;1469;2020
27;Lugo;045;Pedrafita do Cebreiro;969;527;442;2020
27;Lugo;047;Pobra do Brollón, A;1632;801;831;2020
27;Lugo;046;Pol;1623;809;814;2020
27;Lugo;048;Pontenova, A;2201;1053;1148;2020
27;Lugo;049;Portomarín;1412;734;678;2020
27;Lugo;050;Quiroga;3169;1495;1674;2020
27;Lugo;056;Rábade;1505;747;758;2020
27;Lugo;051;Ribadeo;9860;4691;5169;2020
27;Lugo;052;Ribas de Sil;931;470;461;2020
27;Lugo;053;Ribeira de Piquín;513;268;245;2020
27;Lugo;054;Riotorto;1235;617;618;2020
27;Lugo;055;Samos;1246;662;584;2020
27;Lugo;057;Sarria;13338;6476;6862;2020
27;Lugo;058;Saviñao, O;3634;1847;1787;2020
27;Lugo;059;Sober;2260;1126;1134;2020
27;Lugo;060;Taboada;2716;1296;1420;2020
27;Lugo;061;Trabada;1127;541;586;2020
27;Lugo;062;Triacastela;637;320;317;2020
27;Lugo;063;Valadouro, O;1978;939;1039;2020
27;Lugo;064;Vicedo, O;1656;816;840;2020
27;Lugo;065;Vilalba;14079;6805;7274;2020
27;Lugo;066;Viveiro;15391;7539;7852;2020
27;Lugo;021;Xermade;1783;875;908;2020
27;Lugo;025;Xove;3277;1631;1646;2020
28;Madrid;001;Acebeda, La;68;34;34;2020
28;Madrid;002;Ajalvir;4721;2451;2270;2020
28;Madrid;003;Alameda del Valle;204;120;84;2020
28;Madrid;004;Álamo, El;9862;4849;5013;2020
28;Madrid;005;Alcalá de Henares;197562;96061;101501;2020
28;Madrid;006;Alcobendas;118417;56554;61863;2020
28;Madrid;007;Alcorcón;172384;82959;89425;2020
28;Madrid;008;Aldea del Fresno;2973;1517;1456;2020
28;Madrid;009;Algete;20864;10236;10628;2020
28;Madrid;010;Alpedrete;14839;7277;7562;2020
28;Madrid;011;Ambite;609;308;301;2020
28;Madrid;012;Anchuelo;1286;667;619;2020
28;Madrid;013;Aranjuez;60332;29420;30912;2020
28;Madrid;014;Arganda del Rey;56678;28331;28347;2020
28;Madrid;015;Arroyomolinos;32935;16419;16516;2020
28;Madrid;016;Atazar, El;90;47;43;2020
28;Madrid;017;Batres;1750;887;863;2020
28;Madrid;018;Becerril de la Sierra;5875;2951;2924;2020
28;Madrid;019;Belmonte de Tajo;1683;869;814;2020
28;Madrid;021;Berrueco, El;777;389;388;2020
28;Madrid;020;Berzosa del Lozoya;222;126;96;2020
28;Madrid;022;Boadilla del Monte;56734;27710;29024;2020
28;Madrid;023;Boalo, El;7663;3868;3795;2020
28;Madrid;024;Braojos;206;122;84;2020
28;Madrid;025;Brea de Tajo;506;292;214;2020
28;Madrid;026;Brunete;10760;5302;5458;2020
28;Madrid;027;Buitrago del Lozoya;1959;933;1026;2020
28;Madrid;028;Bustarviejo;2522;1277;1245;2020
28;Madrid;029;Cabanillas de la Sierra;785;407;378;2020
28;Madrid;030;Cabrera, La;2736;1334;1402;2020
28;Madrid;031;Cadalso de los Vidrios;3047;1572;1475;2020
28;Madrid;032;Camarma de Esteruelas;7437;3780;3657;2020
28;Madrid;033;Campo Real;6420;3259;3161;2020
28;Madrid;034;Canencia;447;242;205;2020
28;Madrid;035;Carabaña;2081;1055;1026;2020
28;Madrid;036;Casarrubuelos;3845;1973;1872;2020
28;Madrid;037;Cenicientos;2038;1019;1019;2020
28;Madrid;038;Cercedilla;7205;3551;3654;2020
28;Madrid;039;Cervera de Buitrago;162;97;65;2020
28;Madrid;051;Chapinería;2414;1219;1195;2020
28;Madrid;052;Chinchón;5413;2733;2680;2020
28;Madrid;040;Ciempozuelos;25104;12674;12430;2020
28;Madrid;041;Cobeña;7486;3667;3819;2020
28;Madrid;046;Collado Mediano;7105;3524;3581;2020
28;Madrid;047;Collado Villalba;64378;31210;33168;2020
28;Madrid;043;Colmenar de Oreja;8154;4128;4026;2020
28;Madrid;042;Colmenar del Arroyo;1785;923;862;2020
28;Madrid;045;Colmenar Viejo;51938;25618;26320;2020
28;Madrid;044;Colmenarejo;9230;4515;4715;2020
28;Madrid;048;Corpa;723;374;349;2020
28;Madrid;049;Coslada;81391;39821;41570;2020
28;Madrid;050;Cubas de la Sagra;6539;3229;3310;2020
28;Madrid;053;Daganzo de Arriba;10337;5155;5182;2020
28;Madrid;054;Escorial, El;16365;8067;8298;2020
28;Madrid;055;Estremera;1334;680;654;2020
28;Madrid;056;Fresnedillas de la Oliva;1651;840;811;2020
28;Madrid;057;Fresno de Torote;2299;1215;1084;2020
28;Madrid;058;Fuenlabrada;194514;95847;98667;2020
28;Madrid;059;Fuente el Saz de Jarama;6807;3426;3381;2020
28;Madrid;060;Fuentidueña de Tajo;2136;1073;1063;2020
28;Madrid;061;Galapagar;34497;16822;17675;2020
28;Madrid;062;Garganta de los Montes;377;203;174;2020
28;Madrid;063;Gargantilla del Lozoya y Pinilla de Buitrago;309;165;144;2020
28;Madrid;064;Gascones;176;98;78;2020
28;Madrid;065;Getafe;185180;90403;94777;2020
28;Madrid;066;Griñón;10435;5211;5224;2020
28;Madrid;067;Guadalix de la Sierra;6440;3253;3187;2020
28;Madrid;068;Guadarrama;16560;8157;8403;2020
28;Madrid;069;Hiruela, La;65;45;20;2020
28;Madrid;070;Horcajo de la Sierra-Aoslos;152;80;72;2020
28;Madrid;071;Horcajuelo de la Sierra;89;50;39;2020
28;Madrid;072;Hoyo de Manzanares;8529;4299;4230;2020
28;Madrid;073;Humanes de Madrid;19701;9799;9902;2020
28;Madrid;074;Leganés;191114;92573;98541;2020
28;Madrid;075;Loeches;8897;4472;4425;2020
28;Madrid;076;Lozoya;580;306;274;2020
28;Madrid;901;Lozoyuela-Navas-Sieteiglesias;1340;694;646;2020
28;Madrid;078;Madarcos;49;30;19;2020
28;Madrid;079;Madrid;3334730;1553899;1780831;2020
28;Madrid;080;Majadahonda;72155;34170;37985;2020
28;Madrid;082;Manzanares el Real;8936;4541;4395;2020
28;Madrid;083;Meco;14670;7388;7282;2020
28;Madrid;084;Mejorada del Campo;23639;11752;11887;2020
28;Madrid;085;Miraflores de la Sierra;6362;3265;3097;2020
28;Madrid;086;Molar, El;9287;4718;4569;2020
28;Madrid;087;Molinos, Los;4433;2181;2252;2020
28;Madrid;088;Montejo de la Sierra;364;188;176;2020
28;Madrid;089;Moraleja de Enmedio;5200;2591;2609;2020
28;Madrid;090;Moralzarzal;13334;6666;6668;2020
28;Madrid;091;Morata de Tajuña;7847;3933;3914;2020
28;Madrid;092;Móstoles;210309;102307;108002;2020
28;Madrid;093;Navacerrada;3091;1552;1539;2020
28;Madrid;094;Navalafuente;1511;774;737;2020
28;Madrid;095;Navalagamella;2637;1362;1275;2020
28;Madrid;096;Navalcarnero;29985;14899;15086;2020
28;Madrid;097;Navarredonda y San Mamés;129;84;45;2020
28;Madrid;099;Navas del Rey;2966;1551;1415;2020
28;Madrid;100;Nuevo Baztán;6454;3295;3159;2020
28;Madrid;101;Olmeda de las Fuentes;346;178;168;2020
28;Madrid;102;Orusco de Tajuña;1295;654;641;2020
28;Madrid;104;Paracuellos de Jarama;25917;13015;12902;2020
28;Madrid;106;Parla;133482;66524;66958;2020
28;Madrid;107;Patones;539;251;288;2020
28;Madrid;108;Pedrezuela;6150;3063;3087;2020
28;Madrid;109;Pelayos de la Presa;2676;1366;1310;2020
28;Madrid;110;Perales de Tajuña;2990;1517;1473;2020
28;Madrid;111;Pezuela de las Torres;867;460;407;2020
28;Madrid;112;Pinilla del Valle;190;106;84;2020
28;Madrid;113;Pinto;53325;26426;26899;2020
28;Madrid;114;Piñuécar-Gandullas;179;91;88;2020
28;Madrid;115;Pozuelo de Alarcón;87165;41766;45399;2020
28;Madrid;116;Pozuelo del Rey;1172;618;554;2020
28;Madrid;117;Prádena del Rincón;125;70;55;2020
28;Madrid;118;Puebla de la Sierra;73;42;31;2020
28;Madrid;902;Puentes Viejas;699;390;309;2020
28;Madrid;119;Quijorna;3541;1771;1770;2020
28;Madrid;120;Rascafría;1725;942;783;2020
28;Madrid;121;Redueña;270;155;115;2020
28;Madrid;122;Ribatejada;801;406;395;2020
28;Madrid;123;Rivas-Vaciamadrid;90973;45073;45900;2020
28;Madrid;124;Robledillo de la Jara;95;48;47;2020
28;Madrid;125;Robledo de Chavela;4364;2274;2090;2020
28;Madrid;126;Robregordo;65;40;25;2020
28;Madrid;127;Rozas de Madrid, Las;96113;46420;49693;2020
28;Madrid;128;Rozas de Puerto Real;555;320;235;2020
28;Madrid;129;San Agustín del Guadalix;13466;6613;6853;2020
28;Madrid;130;San Fernando de Henares;39566;19244;20322;2020
28;Madrid;131;San Lorenzo de El Escorial;18532;8880;9652;2020
28;Madrid;132;San Martín de la Vega;19633;10051;9582;2020
28;Madrid;133;San Martín de Valdeiglesias;8679;4319;4360;2020
28;Madrid;134;San Sebastián de los Reyes;91224;44477;46747;2020
28;Madrid;135;Santa María de la Alameda;1321;700;621;2020
28;Madrid;136;Santorcaz;899;463;436;2020
28;Madrid;137;Santos de la Humosa, Los;2694;1380;1314;2020
28;Madrid;138;Serna del Monte, La;87;47;40;2020
28;Madrid;140;Serranillos del Valle;4291;2111;2180;2020
28;Madrid;141;Sevilla la Nueva;9393;4582;4811;2020
28;Madrid;143;Somosierra;87;50;37;2020
28;Madrid;144;Soto del Real;8981;4399;4582;2020
28;Madrid;145;Talamanca de Jarama;4012;1992;2020;2020
28;Madrid;146;Tielmes;2736;1389;1347;2020
28;Madrid;147;Titulcia;1341;695;646;2020
28;Madrid;148;Torrejón de Ardoz;132853;65343;67510;2020
28;Madrid;149;Torrejón de la Calzada;9194;4559;4635;2020
28;Madrid;150;Torrejón de Velasco;4386;2193;2193;2020
28;Madrid;151;Torrelaguna;4854;2435;2419;2020
28;Madrid;152;Torrelodones;23902;11548;12354;2020
28;Madrid;153;Torremocha de Jarama;1075;542;533;2020
28;Madrid;154;Torres de la Alameda;7833;4002;3831;2020
28;Madrid;903;Tres Cantos;48326;23439;24887;2020
28;Madrid;155;Valdaracete;605;311;294;2020
28;Madrid;156;Valdeavero;1591;828;763;2020
28;Madrid;157;Valdelaguna;979;491;488;2020
28;Madrid;158;Valdemanco;963;498;465;2020
28;Madrid;159;Valdemaqueda;775;397;378;2020
28;Madrid;160;Valdemorillo;12772;6429;6343;2020
28;Madrid;161;Valdemoro;77270;38142;39128;2020
28;Madrid;162;Valdeolmos-Alalpardo;4232;2170;2062;2020
28;Madrid;163;Valdepiélagos;614;325;289;2020
28;Madrid;164;Valdetorres de Jarama;4581;2310;2271;2020
28;Madrid;165;Valdilecha;2982;1533;1449;2020
28;Madrid;166;Valverde de Alcalá;498;262;236;2020
28;Madrid;167;Velilla de San Antonio;12380;6237;6143;2020
28;Madrid;168;Vellón, El;2004;1055;949;2020
28;Madrid;169;Venturada;2241;1179;1062;2020
28;Madrid;171;Villa del Prado;6661;3393;3268;2020
28;Madrid;170;Villaconejos;3422;1758;1664;2020
28;Madrid;172;Villalbilla;14392;7256;7136;2020
28;Madrid;173;Villamanrique de Tajo;707;354;353;2020
28;Madrid;174;Villamanta;2605;1315;1290;2020
28;Madrid;175;Villamantilla;1482;726;756;2020
28;Madrid;176;Villanueva de la Cañada;22115;10756;11359;2020
28;Madrid;178;Villanueva de Perales;1592;813;779;2020
28;Madrid;177;Villanueva del Pardillo;17396;8462;8934;2020
28;Madrid;179;Villar del Olmo;2079;1024;1055;2020
28;Madrid;180;Villarejo de Salvanés;7433;3716;3717;2020
28;Madrid;181;Villaviciosa de Odón;28148;13604;14544;2020
28;Madrid;182;Villavieja del Lozoya;262;140;122;2020
28;Madrid;183;Zarzalejo;1734;891;843;2020
29;Málaga;001;Alameda;5387;2724;2663;2020
29;Málaga;002;Alcaucín;2279;1172;1107;2020
29;Málaga;003;Alfarnate;1065;545;520;2020
29;Málaga;004;Alfarnatejo;364;184;180;2020
29;Málaga;005;Algarrobo;6556;3296;3260;2020
29;Málaga;006;Algatocín;814;420;394;2020
29;Málaga;007;Alhaurín de la Torre;41170;20437;20733;2020
29;Málaga;008;Alhaurín el Grande;25358;12671;12687;2020
29;Málaga;009;Almáchar;1817;935;882;2020
29;Málaga;010;Almargen;1947;992;955;2020
29;Málaga;011;Almogía;3792;1969;1823;2020
29;Málaga;012;Álora;13112;6633;6479;2020
29;Málaga;013;Alozaina;2061;1048;1013;2020
29;Málaga;014;Alpandeire;263;129;134;2020
29;Málaga;015;Antequera;41318;20215;21103;2020
29;Málaga;016;Árchez;385;201;184;2020
29;Málaga;017;Archidona;8168;4163;4005;2020
29;Málaga;018;Ardales;2506;1270;1236;2020
29;Málaga;019;Arenas;1177;617;560;2020
29;Málaga;020;Arriate;4082;2017;2065;2020
29;Málaga;021;Atajate;169;92;77;2020
29;Málaga;022;Benadalid;233;117;116;2020
29;Málaga;023;Benahavís;7748;3850;3898;2020
29;Málaga;024;Benalauría;438;231;207;2020
29;Málaga;025;Benalmádena;69144;33892;35252;2020
29;Málaga;026;Benamargosa;1535;799;736;2020
29;Málaga;027;Benamocarra;3046;1522;1524;2020
29;Málaga;028;Benaoján;1453;743;710;2020
29;Málaga;029;Benarrabá;446;233;213;2020
29;Málaga;030;Borge, El;922;474;448;2020
29;Málaga;031;Burgo, El;1792;922;870;2020
29;Málaga;032;Campillos;8387;4219;4168;2020
29;Málaga;033;Canillas de Aceituno;1680;882;798;2020
29;Málaga;034;Canillas de Albaida;759;375;384;2020
29;Málaga;035;Cañete la Real;1633;819;814;2020
29;Málaga;036;Carratraca;740;387;353;2020
29;Málaga;037;Cartajima;242;129;113;2020
29;Málaga;038;Cártama;26738;13523;13215;2020
29;Málaga;039;Casabermeja;3629;1904;1725;2020
29;Málaga;040;Casarabonela;2514;1339;1175;2020
29;Málaga;041;Casares;6883;3526;3357;2020
29;Málaga;042;Coín;22673;11358;11315;2020
29;Málaga;043;Colmenar;3409;1741;1668;2020
29;Málaga;044;Comares;1330;725;605;2020
29;Málaga;045;Cómpeta;3967;1980;1987;2020
29;Málaga;046;Cortes de la Frontera;3065;1586;1479;2020
29;Málaga;047;Cuevas Bajas;1370;680;690;2020
29;Málaga;049;Cuevas de San Marcos;3601;1810;1791;2020
29;Málaga;048;Cuevas del Becerro;1597;785;812;2020
29;Málaga;050;Cútar;616;321;295;2020
29;Málaga;051;Estepona;70228;34392;35836;2020
29;Málaga;052;Faraján;261;128;133;2020
29;Málaga;053;Frigiliana;3062;1520;1542;2020
29;Málaga;054;Fuengirola;82837;40441;42396;2020
29;Málaga;055;Fuente de Piedra;2662;1353;1309;2020
29;Málaga;056;Gaucín;1589;830;759;2020
29;Málaga;057;Genalguacil;393;196;197;2020
29;Málaga;058;Guaro;2280;1156;1124;2020
29;Málaga;059;Humilladero;3297;1647;1650;2020
29;Málaga;060;Igualeja;752;378;374;2020
29;Málaga;061;Istán;1494;743;751;2020
29;Málaga;062;Iznate;907;468;439;2020
29;Málaga;063;Jimera de Líbar;379;197;182;2020
29;Málaga;064;Jubrique;523;261;262;2020
29;Málaga;065;Júzcar;214;124;90;2020
29;Málaga;066;Macharaviaya;513;279;234;2020
29;Málaga;067;Málaga;578460;277789;300671;2020
29;Málaga;068;Manilva;16439;8304;8135;2020
29;Málaga;069;Marbella;147633;70833;76800;2020
29;Málaga;070;Mijas;85397;42430;42967;2020
29;Málaga;071;Moclinejo;1251;650;601;2020
29;Málaga;072;Mollina;5276;2643;2633;2020
29;Málaga;073;Monda;2697;1388;1309;2020
29;Málaga;903;Montecorto;586;309;277;2020
29;Málaga;074;Montejaque;949;472;477;2020
29;Málaga;075;Nerja;21144;10431;10713;2020
29;Málaga;076;Ojén;3816;1946;1870;2020
29;Málaga;077;Parauta;239;123;116;2020
29;Málaga;079;Periana;3089;1618;1471;2020
29;Málaga;080;Pizarra;9444;4741;4703;2020
29;Málaga;081;Pujerra;308;162;146;2020
29;Málaga;082;Rincón de la Victoria;48768;23899;24869;2020
29;Málaga;083;Riogordo;2723;1416;1307;2020
29;Málaga;084;Ronda;33730;16362;17368;2020
29;Málaga;085;Salares;173;86;87;2020
29;Málaga;086;Sayalonga;1568;817;751;2020
29;Málaga;087;Sedella;576;327;249;2020
29;Málaga;904;Serrato;482;241;241;2020
29;Málaga;088;Sierra de Yeguas;3318;1676;1642;2020
29;Málaga;089;Teba;3744;1870;1874;2020
29;Málaga;090;Tolox;2136;1081;1055;2020
29;Málaga;901;Torremolinos;69166;34603;34563;2020
29;Málaga;091;Torrox;17943;9026;8917;2020
29;Málaga;092;Totalán;737;376;361;2020
29;Málaga;093;Valle de Abdalajís;2502;1278;1224;2020
29;Málaga;094;Vélez-Málaga;82365;40548;41817;2020
29;Málaga;095;Villanueva de Algaidas;4148;2119;2029;2020
29;Málaga;902;Villanueva de la Concepción;3288;1606;1682;2020
29;Málaga;098;Villanueva de Tapia;1460;736;724;2020
29;Málaga;096;Villanueva del Rosario;3362;1638;1724;2020
29;Málaga;097;Villanueva del Trabuco;5308;2648;2660;2020
29;Málaga;099;Viñuela;2055;1079;976;2020
29;Málaga;100;Yunquera;2869;1464;1405;2020
52;Melilla;001;Melilla;87076;44162;42914;2020
30;Murcia;001;Abanilla;6097;3096;3001;2020
30;Murcia;002;Abarán;13022;6514;6508;2020
30;Murcia;003;Águilas;35722;17832;17890;2020
30;Murcia;004;Albudeite;1375;699;676;2020
30;Murcia;005;Alcantarilla;42345;20981;21364;2020
30;Murcia;902;Alcázares, Los;16590;8495;8095;2020
30;Murcia;006;Aledo;1031;512;519;2020
30;Murcia;007;Alguazas;9761;5032;4729;2020
30;Murcia;008;Alhama de Murcia;22160;11202;10958;2020
30;Murcia;009;Archena;19428;10205;9223;2020
30;Murcia;010;Beniel;11465;5977;5488;2020
30;Murcia;011;Blanca;6569;3360;3209;2020
30;Murcia;012;Bullas;11553;5805;5748;2020
30;Murcia;013;Calasparra;10133;5142;4991;2020
30;Murcia;014;Campos del Río;2032;959;1073;2020
30;Murcia;015;Caravaca de la Cruz;25688;12857;12831;2020
30;Murcia;016;Cartagena;216108;107478;108630;2020
30;Murcia;017;Cehegín;14769;7395;7374;2020
30;Murcia;018;Ceutí;12007;6048;5959;2020
30;Murcia;019;Cieza;35283;17731;17552;2020
30;Murcia;020;Fortuna;10289;5494;4795;2020
30;Murcia;021;Fuente Álamo de Murcia;16787;8687;8100;2020
30;Murcia;022;Jumilla;25994;13554;12440;2020
30;Murcia;023;Librilla;5325;2728;2597;2020
30;Murcia;024;Lorca;95515;48838;46677;2020
30;Murcia;025;Lorquí;7246;3646;3600;2020
30;Murcia;026;Mazarrón;32839;16998;15841;2020
30;Murcia;027;Molina de Segura;73095;36494;36601;2020
30;Murcia;028;Moratalla;7804;3951;3853;2020
30;Murcia;029;Mula;17021;8722;8299;2020
30;Murcia;030;Murcia;459403;224929;234474;2020
30;Murcia;031;Ojós;510;267;243;2020
30;Murcia;032;Pliego;3843;1981;1862;2020
30;Murcia;033;Puerto Lumbreras;15780;7998;7782;2020
30;Murcia;034;Ricote;1253;668;585;2020
30;Murcia;035;San Javier;33129;16658;16471;2020
30;Murcia;036;San Pedro del Pinatar;25932;13069;12863;2020
30;Murcia;901;Santomera;16270;8147;8123;2020
30;Murcia;037;Torre-Pacheco;36464;18797;17667;2020
30;Murcia;038;Torres de Cotillas, Las;21753;11058;10695;2020
30;Murcia;039;Totana;32529;16774;15755;2020
30;Murcia;040;Ulea;849;443;406;2020
30;Murcia;041;Unión, La;20538;10418;10120;2020
30;Murcia;042;Villanueva del Río Segura;3111;1558;1553;2020
30;Murcia;043;Yecla;34834;17502;17332;2020
31;Navarra;001;Abáigar;82;47;35;2020
31;Navarra;002;Abárzuza/Abartzuza;544;277;267;2020
31;Navarra;003;Abaurregaina/Abaurrea Alta;127;80;47;2020
31;Navarra;004;Abaurrepea/Abaurrea Baja;31;18;13;2020
31;Navarra;005;Aberin;340;181;159;2020
31;Navarra;006;Ablitas;2484;1261;1223;2020
31;Navarra;007;Adiós;152;87;65;2020
31;Navarra;008;Aguilar de Codés;66;38;28;2020
31;Navarra;009;Aibar/Oibar;794;416;378;2020
31;Navarra;011;Allín/Allin;874;463;411;2020
31;Navarra;012;Allo;960;487;473;2020
31;Navarra;010;Altsasu/Alsasua;7465;3765;3700;2020
31;Navarra;013;Améscoa Baja;711;390;321;2020
31;Navarra;014;Ancín/Antzin;338;188;150;2020
31;Navarra;015;Andosilla;2784;1419;1365;2020
31;Navarra;016;Ansoáin/Antsoain;10836;5327;5509;2020
31;Navarra;017;Anue;481;260;221;2020
31;Navarra;018;Añorbe;595;328;267;2020
31;Navarra;019;Aoiz/Agoitz;2777;1414;1363;2020
31;Navarra;020;Araitz;523;289;234;2020
31;Navarra;025;Arakil;962;506;456;2020
31;Navarra;021;Aranarache/Aranaratxe;70;40;30;2020
31;Navarra;023;Aranguren;11306;5698;5608;2020
31;Navarra;024;Arano;116;62;54;2020
31;Navarra;022;Arantza;608;323;285;2020
31;Navarra;026;Aras;147;79;68;2020
31;Navarra;027;Arbizu;1109;579;530;2020
31;Navarra;028;Arce/Artzi;262;142;120;2020
31;Navarra;029;Arcos, Los;1127;556;571;2020
31;Navarra;030;Arellano;148;80;68;2020
31;Navarra;031;Areso;283;146;137;2020
31;Navarra;032;Arguedas;2287;1175;1112;2020
31;Navarra;033;Aria;51;30;21;2020
31;Navarra;034;Aribe;32;18;14;2020
31;Navarra;035;Armañanzas;52;28;24;2020
31;Navarra;036;Arróniz;1038;557;481;2020
31;Navarra;037;Arruazu;106;55;51;2020
31;Navarra;038;Artajona;1691;875;816;2020
31;Navarra;039;Artazu;111;57;54;2020
31;Navarra;040;Atez/Atetz;225;125;100;2020
31;Navarra;058;Auritz/Burguete;227;122;105;2020
31;Navarra;041;Ayegui/Aiegi;2395;1243;1152;2020
31;Navarra;042;Azagra;3840;1942;1898;2020
31;Navarra;043;Azuelo;26;10;16;2020
31;Navarra;044;Bakaiku;360;192;168;2020
31;Navarra;901;Barañáin/Barañain;20167;9771;10396;2020
31;Navarra;045;Barásoain;613;327;286;2020
31;Navarra;046;Barbarin;49;25;24;2020
31;Navarra;047;Bargota;255;126;129;2020
31;Navarra;048;Barillas;221;121;100;2020
31;Navarra;049;Basaburua;828;467;361;2020
31;Navarra;050;Baztan;7850;3969;3881;2020
31;Navarra;137;Beintza-Labaien;217;128;89;2020
31;Navarra;051;Beire;287;153;134;2020
31;Navarra;052;Belascoáin;119;62;57;2020
31;Navarra;250;Bera;3753;1851;1902;2020
31;Navarra;053;Berbinzana;666;340;326;2020
31;Navarra;905;Beriáin;4113;2025;2088;2020
31;Navarra;902;Berrioplano/Berriobeiti;7457;3801;3656;2020
31;Navarra;903;Berriozar;10651;5348;5303;2020
31;Navarra;054;Bertizarana;603;297;306;2020
31;Navarra;055;Betelu;374;190;184;2020
31;Navarra;253;Bidaurreta;164;87;77;2020
31;Navarra;056;Biurrun-Olcoz;223;126;97;2020
31;Navarra;057;Buñuel;2195;1076;1119;2020
31;Navarra;059;Burgui/Burgi;203;114;89;2020
31;Navarra;060;Burlada/Burlata;19541;9462;10079;2020
31;Navarra;061;Busto, El;54;25;29;2020
31;Navarra;062;Cabanillas;1351;712;639;2020
31;Navarra;063;Cabredo;87;49;38;2020
31;Navarra;064;Cadreita;2045;1064;981;2020
31;Navarra;065;Caparroso;2801;1493;1308;2020
31;Navarra;066;Cárcar;1104;560;544;2020
31;Navarra;067;Carcastillo;2502;1271;1231;2020
31;Navarra;068;Cascante;3952;1958;1994;2020
31;Navarra;069;Cáseda;951;479;472;2020
31;Navarra;070;Castejón;4251;2131;2120;2020
31;Navarra;071;Castillonuevo;13;8;5;2020
31;Navarra;193;Cendea de Olza/Oltza Zendea;1860;914;946;2020
31;Navarra;072;Cintruénigo;8026;4118;3908;2020
31;Navarra;074;Cirauqui/Zirauki;480;249;231;2020
31;Navarra;075;Ciriza/Ziritza;153;74;79;2020
31;Navarra;076;Cizur;3924;2037;1887;2020
31;Navarra;077;Corella;8100;4070;4030;2020
31;Navarra;078;Cortes;3178;1630;1548;2020
31;Navarra;079;Desojo;76;44;32;2020
31;Navarra;080;Dicastillo;591;301;290;2020
31;Navarra;081;Donamaria;442;223;219;2020
31;Navarra;221;Doneztebe/Santesteban;1763;886;877;2020
31;Navarra;083;Echarri/Etxarri;75;37;38;2020
31;Navarra;087;Elgorriaga;220;112;108;2020
31;Navarra;089;Enériz/Eneritz;292;148;144;2020
31;Navarra;090;Eratsun;150;93;57;2020
31;Navarra;091;Ergoiena;370;199;171;2020
31;Navarra;092;Erro;793;446;347;2020
31;Navarra;094;Eslava;105;48;57;2020
31;Navarra;095;Esparza de Salazar/Espartza Zaraitzu;72;39;33;2020
31;Navarra;096;Espronceda;101;57;44;2020
31;Navarra;097;Estella-Lizarra;13991;6696;7295;2020
31;Navarra;098;Esteribar;2726;1403;1323;2020
31;Navarra;099;Etayo;61;34;27;2020
31;Navarra;082;Etxalar;827;430;397;2020
31;Navarra;084;Etxarri Aranatz;2497;1297;1200;2020
31;Navarra;085;Etxauri;649;332;317;2020
31;Navarra;100;Eulate;282;157;125;2020
31;Navarra;101;Ezcabarte;1811;939;872;2020
31;Navarra;093;Ezcároz/Ezkaroze;314;171;143;2020
31;Navarra;102;Ezkurra;138;92;46;2020
31;Navarra;103;Ezprogui;44;22;22;2020
31;Navarra;104;Falces;2336;1202;1134;2020
31;Navarra;105;Fitero;2080;1037;1043;2020
31;Navarra;106;Fontellas;993;496;497;2020
31;Navarra;107;Funes;2444;1292;1152;2020
31;Navarra;108;Fustiñana;2483;1244;1239;2020
31;Navarra;109;Galar;2290;1196;1094;2020
31;Navarra;110;Gallipienzo/Galipentzu;94;52;42;2020
31;Navarra;111;Gallués/Galoze;94;62;32;2020
31;Navarra;112;Garaioa;94;54;40;2020
31;Navarra;113;Garde;142;83;59;2020
31;Navarra;114;Garínoain;498;262;236;2020
31;Navarra;115;Garralda;191;98;93;2020
31;Navarra;116;Genevilla;66;42;24;2020
31;Navarra;117;Goizueta;689;369;320;2020
31;Navarra;118;Goñi;157;100;57;2020
31;Navarra;119;Güesa/Gorza;36;22;14;2020
31;Navarra;120;Guesálaz/Gesalatz;421;247;174;2020
31;Navarra;121;Guirguillano;83;43;40;2020
31;Navarra;256;Hiriberri/Villanueva de Aezkoa;100;54;46;2020
31;Navarra;122;Huarte/Uharte;7278;3655;3623;2020
31;Navarra;124;Ibargoiti;248;148;100;2020
31;Navarra;259;Igantzi;631;335;296;2020
31;Navarra;125;Igúzquiza;318;163;155;2020
31;Navarra;126;Imotz;430;233;197;2020
31;Navarra;127;Irañeta;169;92;77;2020
31;Navarra;904;Irurtzun;2247;1162;1085;2020
31;Navarra;128;Isaba/Izaba;403;194;209;2020
31;Navarra;129;Ituren;507;257;250;2020
31;Navarra;130;Iturmendi;411;213;198;2020
31;Navarra;131;Iza/Itza;1262;680;582;2020
31;Navarra;132;Izagaondoa;172;111;61;2020
31;Navarra;133;Izalzu/Itzaltzu;37;21;16;2020
31;Navarra;134;Jaurrieta;186;106;80;2020
31;Navarra;135;Javier;128;32;96;2020
31;Navarra;136;Juslapeña;568;315;253;2020
31;Navarra;138;Lakuntza;1275;679;596;2020
31;Navarra;139;Lana;163;91;72;2020
31;Navarra;140;Lantz;152;89;63;2020
31;Navarra;141;Lapoblación;122;69;53;2020
31;Navarra;142;Larraga;2123;1125;998;2020
31;Navarra;143;Larraona;96;49;47;2020
31;Navarra;144;Larraun;928;512;416;2020
31;Navarra;145;Lazagurría;185;95;90;2020
31;Navarra;146;Leache/Leatxe;33;18;15;2020
31;Navarra;147;Legarda;125;66;59;2020
31;Navarra;148;Legaria;115;50;65;2020
31;Navarra;149;Leitza;2965;1519;1446;2020
31;Navarra;908;Lekunberri;1574;797;777;2020
31;Navarra;150;Leoz/Leotz;224;146;78;2020
31;Navarra;151;Lerga;46;29;17;2020
31;Navarra;152;Lerín;1746;895;851;2020
31;Navarra;153;Lesaka;2744;1403;1341;2020
31;Navarra;154;Lezaun;238;141;97;2020
31;Navarra;155;Liédena;295;151;144;2020
31;Navarra;156;Lizoáin-Arriasgoiti;294;173;121;2020
31;Navarra;157;Lodosa;4837;2454;2383;2020
31;Navarra;158;Lónguida/Longida;297;157;140;2020
31;Navarra;159;Lumbier;1299;702;597;2020
31;Navarra;160;Luquin;131;68;63;2020
31;Navarra;248;Luzaide/Valcarlos;323;176;147;2020
31;Navarra;161;Mañeru;426;221;205;2020
31;Navarra;162;Marañón;51;26;25;2020
31;Navarra;163;Marcilla;2864;1430;1434;2020
31;Navarra;164;Mélida;731;374;357;2020
31;Navarra;165;Mendavia;3526;1804;1722;2020
31;Navarra;166;Mendaza;291;147;144;2020
31;Navarra;167;Mendigorria;1094;576;518;2020
31;Navarra;168;Metauten;283;156;127;2020
31;Navarra;169;Milagro;3450;1786;1664;2020
31;Navarra;170;Mirafuentes;55;27;28;2020
31;Navarra;171;Miranda de Arga;863;442;421;2020
31;Navarra;172;Monreal/Elo;472;260;212;2020
31;Navarra;173;Monteagudo;1093;557;536;2020
31;Navarra;174;Morentin;115;56;59;2020
31;Navarra;175;Mues;73;41;32;2020
31;Navarra;176;Murchante;4131;2087;2044;2020
31;Navarra;177;Murieta;338;177;161;2020
31;Navarra;178;Murillo el Cuende;673;347;326;2020
31;Navarra;179;Murillo el Fruto;662;354;308;2020
31;Navarra;180;Muruzábal;235;103;132;2020
31;Navarra;181;Navascués/Nabaskoze;126;74;52;2020
31;Navarra;182;Nazar;30;17;13;2020
31;Navarra;088;Noáin (Valle de Elorz)/Noain (Elortzibar);8354;4182;4172;2020
31;Navarra;183;Obanos;940;472;468;2020
31;Navarra;185;Ochagavía/Otsagabia;501;272;229;2020
31;Navarra;184;Oco;75;38;37;2020
31;Navarra;186;Odieta;355;196;159;2020
31;Navarra;187;Oiz;128;74;54;2020
31;Navarra;188;Olaibar;392;224;168;2020
31;Navarra;189;Olazti/Olazagutía;1490;751;739;2020
31;Navarra;190;Olejua;49;27;22;2020
31;Navarra;191;Olite/Erriberri;3981;2011;1970;2020
31;Navarra;192;Olóriz/Oloritz;204;115;89;2020
31;Navarra;195;Orbaizeta;192;94;98;2020
31;Navarra;196;Orbara;32;17;15;2020
31;Navarra;197;Orísoain;79;44;35;2020
31;Navarra;906;Orkoien;4145;2089;2056;2020
31;Navarra;198;Oronz/Orontze;48;23;25;2020
31;Navarra;199;Oroz-Betelu/Orotz-Betelu;147;84;63;2020
31;Navarra;211;Orreaga/Roncesvalles;18;8;10;2020
31;Navarra;200;Oteiza;930;498;432;2020
31;Navarra;201;Pamplona/Iruña;203944;96368;107576;2020
31;Navarra;202;Peralta/Azkoien;5951;3016;2935;2020
31;Navarra;203;Petilla de Aragón;31;17;14;2020
31;Navarra;204;Piedramillera;37;23;14;2020
31;Navarra;205;Pitillas;502;250;252;2020
31;Navarra;206;Puente la Reina/Gares;2889;1472;1417;2020
31;Navarra;207;Pueyo;361;200;161;2020
31;Navarra;208;Ribaforada;3738;1951;1787;2020
31;Navarra;209;Romanzado;171;92;79;2020
31;Navarra;210;Roncal/Erronkari;211;111;100;2020
31;Navarra;212;Sada;135;79;56;2020
31;Navarra;213;Saldías;116;62;54;2020
31;Navarra;214;Salinas de Oro/Jaitz;109;60;49;2020
31;Navarra;215;San Adrián;6344;3134;3210;2020
31;Navarra;217;San Martín de Unx;389;208;181;2020
31;Navarra;216;Sangüesa/Zangoza;4933;2521;2412;2020
31;Navarra;219;Sansol;97;50;47;2020
31;Navarra;220;Santacara;870;451;419;2020
31;Navarra;222;Sarriés/Sartze;60;41;19;2020
31;Navarra;223;Sartaguda;1281;661;620;2020
31;Navarra;224;Sesma;1161;588;573;2020
31;Navarra;225;Sorlada;57;36;21;2020
31;Navarra;226;Sunbilla;665;340;325;2020
31;Navarra;227;Tafalla;10621;5279;5342;2020
31;Navarra;228;Tiebas-Muruarte de Reta;636;336;300;2020
31;Navarra;229;Tirapu;42;26;16;2020
31;Navarra;230;Torralba del Río;96;50;46;2020
31;Navarra;231;Torres del Río;124;61;63;2020
31;Navarra;232;Tudela;37042;18311;18731;2020
31;Navarra;233;Tulebras;132;58;74;2020
31;Navarra;234;Ucar;176;99;77;2020
31;Navarra;123;Uharte Arakil;789;414;375;2020
31;Navarra;235;Ujué/Uxue;175;99;76;2020
31;Navarra;236;Ultzama;1674;859;815;2020
31;Navarra;237;Unciti;209;114;95;2020
31;Navarra;238;Unzué/Untzue;154;81;73;2020
31;Navarra;239;Urdazubi/Urdax;356;175;181;2020
31;Navarra;240;Urdiain;661;343;318;2020
31;Navarra;241;Urraul Alto;137;87;50;2020
31;Navarra;242;Urraul Bajo;317;145;172;2020
31;Navarra;244;Urroz;184;102;82;2020
31;Navarra;243;Urroz-Villa;386;201;185;2020
31;Navarra;245;Urzainqui/Urzainki;87;54;33;2020
31;Navarra;246;Uterga;163;95;68;2020
31;Navarra;247;Uztárroz/Uztarroze;144;76;68;2020
31;Navarra;086;Valle de Egüés/Eguesibar;21418;10734;10684;2020
31;Navarra;194;Valle de Ollo/Ollaran;422;237;185;2020
31;Navarra;260;Valle de Yerri/Deierri;1543;802;741;2020
31;Navarra;249;Valtierra;2430;1227;1203;2020
31;Navarra;251;Viana;4260;2176;2084;2020
31;Navarra;252;Vidángoz/Bidankoze;85;49;36;2020
31;Navarra;254;Villafranca;2883;1457;1426;2020
31;Navarra;255;Villamayor de Monjardín;120;61;59;2020
31;Navarra;257;Villatuerta;1220;606;614;2020
31;Navarra;258;Villava/Atarrabia;10245;4991;5254;2020
31;Navarra;261;Yesa;285;165;120;2020
31;Navarra;262;Zabalza/Zabaltza;301;162;139;2020
31;Navarra;073;Ziordia;350;185;165;2020
31;Navarra;907;Zizur Mayor/Zizur Nagusia;15088;7357;7731;2020
31;Navarra;263;Zubieta;302;155;147;2020
31;Navarra;264;Zugarramurdi;217;107;110;2020
31;Navarra;265;Zúñiga;99;63;36;2020
32;Ourense;001;Allariz;6245;3112;3133;2020
32;Ourense;002;Amoeiro;2296;1155;1141;2020
32;Ourense;003;Arnoia, A;977;489;488;2020
32;Ourense;004;Avión;1736;798;938;2020
32;Ourense;005;Baltar;942;512;430;2020
32;Ourense;006;Bande;1498;749;749;2020
32;Ourense;007;Baños de Molgas;1493;743;750;2020
32;Ourense;008;Barbadás;11158;5450;5708;2020
32;Ourense;009;Barco de Valdeorras, O;13431;6533;6898;2020
32;Ourense;010;Beade;384;198;186;2020
32;Ourense;011;Beariz;970;436;534;2020
32;Ourense;012;Blancos, Os;755;405;350;2020
32;Ourense;013;Boborás;2223;1063;1160;2020
32;Ourense;014;Bola, A;1113;518;595;2020
32;Ourense;015;Bolo, O;850;429;421;2020
32;Ourense;016;Calvos de Randín;735;375;360;2020
32;Ourense;018;Carballeda de Avia;1271;619;652;2020
32;Ourense;017;Carballeda de Valdeorras;1499;783;716;2020
32;Ourense;019;Carballiño, O;14089;6527;7562;2020
32;Ourense;020;Cartelle;2589;1270;1319;2020
32;Ourense;022;Castrelo de Miño;1340;675;665;2020
32;Ourense;021;Castrelo do Val;958;481;477;2020
32;Ourense;023;Castro Caldelas;1204;614;590;2020
32;Ourense;024;Celanova;5644;2651;2993;2020
32;Ourense;025;Cenlle;1100;543;557;2020
32;Ourense;029;Chandrexa de Queixa;472;269;203;2020
32;Ourense;026;Coles;3075;1559;1516;2020
32;Ourense;027;Cortegada;1070;531;539;2020
32;Ourense;028;Cualedro;1668;866;802;2020
32;Ourense;030;Entrimo;1109;529;580;2020
32;Ourense;031;Esgos;1103;568;535;2020
32;Ourense;033;Gomesende;714;347;367;2020
32;Ourense;034;Gudiña, A;1236;626;610;2020
32;Ourense;035;Irixo, O;1420;684;736;2020
32;Ourense;038;Larouco;417;204;213;2020
32;Ourense;039;Laza;1223;644;579;2020
32;Ourense;040;Leiro;1525;744;781;2020
32;Ourense;041;Lobeira;768;377;391;2020
32;Ourense;042;Lobios;1678;839;839;2020
32;Ourense;043;Maceda;2839;1414;1425;2020
32;Ourense;044;Manzaneda;843;410;433;2020
32;Ourense;045;Maside;2709;1347;1362;2020
32;Ourense;046;Melón;1156;556;600;2020
32;Ourense;047;Merca, A;1912;941;971;2020
32;Ourense;048;Mezquita, A;1013;529;484;2020
32;Ourense;049;Montederramo;699;372;327;2020
32;Ourense;050;Monterrei;2520;1279;1241;2020
32;Ourense;051;Muíños;1466;741;725;2020
32;Ourense;052;Nogueira de Ramuín;1988;1010;978;2020
32;Ourense;053;Oímbra;1720;937;783;2020
32;Ourense;054;Ourense;105643;47891;57752;2020
32;Ourense;055;Paderne de Allariz;1372;679;693;2020
32;Ourense;056;Padrenda;1671;820;851;2020
32;Ourense;057;Parada de Sil;546;292;254;2020
32;Ourense;058;Pereiro de Aguiar, O;6350;3259;3091;2020
32;Ourense;059;Peroxa, A;1810;890;920;2020
32;Ourense;060;Petín;849;421;428;2020
32;Ourense;061;Piñor;1183;606;577;2020
32;Ourense;063;Pobra de Trives, A;2014;1000;1014;2020
32;Ourense;064;Pontedeva;494;238;256;2020
32;Ourense;062;Porqueira;823;385;438;2020
32;Ourense;065;Punxín;708;349;359;2020
32;Ourense;066;Quintela de Leirado;630;282;348;2020
32;Ourense;067;Rairiz de Veiga;1228;627;601;2020
32;Ourense;068;Ramirás;1551;724;827;2020
32;Ourense;069;Ribadavia;5012;2468;2544;2020
32;Ourense;071;Riós;1461;750;711;2020
32;Ourense;072;Rúa, A;4283;2120;2163;2020
32;Ourense;073;Rubiá;1383;672;711;2020
32;Ourense;074;San Amaro;1052;511;541;2020
32;Ourense;075;San Cibrao das Viñas;5395;2728;2667;2020
32;Ourense;076;San Cristovo de Cea;2089;1024;1065;2020
32;Ourense;070;San Xoán de Río;506;259;247;2020
32;Ourense;077;Sandiás;1198;563;635;2020
32;Ourense;078;Sarreaus;1145;570;575;2020
32;Ourense;079;Taboadela;1417;719;698;2020
32;Ourense;080;Teixeira, A;315;158;157;2020
32;Ourense;081;Toén;2353;1209;1144;2020
32;Ourense;082;Trasmiras;1263;631;632;2020
32;Ourense;083;Veiga, A;857;438;419;2020
32;Ourense;084;Verea;912;435;477;2020
32;Ourense;085;Verín;13647;6558;7089;2020
32;Ourense;086;Viana do Bolo;2818;1423;1395;2020
32;Ourense;087;Vilamarín;1852;955;897;2020
32;Ourense;088;Vilamartín de Valdeorras;1812;928;884;2020
32;Ourense;089;Vilar de Barrio;1283;654;629;2020
32;Ourense;090;Vilar de Santos;794;384;410;2020
32;Ourense;091;Vilardevós;1802;940;862;2020
32;Ourense;092;Vilariño de Conso;524;304;220;2020
32;Ourense;032;Xinzo de Limia;9637;4695;4942;2020
32;Ourense;036;Xunqueira de Ambía;1374;695;679;2020
32;Ourense;037;Xunqueira de Espadanedo;751;373;378;2020
34;Palencia;001;Abarca de Campos;45;27;18;2020
34;Palencia;003;Abia de las Torres;170;92;78;2020
34;Palencia;004;Aguilar de Campoo;6749;3262;3487;2020
34;Palencia;005;Alar del Rey;921;446;475;2020
34;Palencia;006;Alba de Cerrato;87;47;40;2020
34;Palencia;009;Amayuelas de Arriba;36;23;13;2020
34;Palencia;010;Ampudia;606;307;299;2020
34;Palencia;011;Amusco;418;235;183;2020
34;Palencia;012;Antigüedad;365;192;173;2020
34;Palencia;015;Arconada;40;25;15;2020
34;Palencia;017;Astudillo;1006;508;498;2020
34;Palencia;018;Autilla del Pino;215;117;98;2020
34;Palencia;019;Autillo de Campos;134;73;61;2020
34;Palencia;020;Ayuela;50;31;19;2020
34;Palencia;022;Baltanás;1206;623;583;2020
34;Palencia;024;Baquerín de Campos;28;16;12;2020
34;Palencia;025;Bárcena de Campos;57;25;32;2020
34;Palencia;027;Barruelo de Santullán;1174;589;585;2020
34;Palencia;028;Báscones de Ojeda;137;71;66;2020
34;Palencia;029;Becerril de Campos;742;383;359;2020
34;Palencia;031;Belmonte de Campos;29;15;14;2020
34;Palencia;032;Berzosilla;42;22;20;2020
34;Palencia;033;Boada de Campos;17;13;4;2020
34;Palencia;035;Boadilla de Rioseco;113;63;50;2020
34;Palencia;034;Boadilla del Camino;121;69;52;2020
34;Palencia;036;Brañosera;258;143;115;2020
34;Palencia;037;Buenavista de Valdavia;304;169;135;2020
34;Palencia;038;Bustillo de la Vega;285;158;127;2020
34;Palencia;039;Bustillo del Páramo de Carrión;62;35;27;2020
34;Palencia;041;Calahorra de Boedo;87;41;46;2020
34;Palencia;042;Calzada de los Molinos;324;181;143;2020
34;Palencia;045;Capillas;73;40;33;2020
34;Palencia;046;Cardeñosa de Volpejera;53;27;26;2020
34;Palencia;047;Carrión de los Condes;2035;965;1070;2020
34;Palencia;048;Castil de Vela;63;29;34;2020
34;Palencia;049;Castrejón de la Peña;344;184;160;2020
34;Palencia;050;Castrillo de Don Juan;195;111;84;2020
34;Palencia;051;Castrillo de Onielo;98;50;48;2020
34;Palencia;052;Castrillo de Villavega;175;97;78;2020
34;Palencia;053;Castromocho;222;113;109;2020
34;Palencia;055;Cervatos de la Cueza;265;144;121;2020
34;Palencia;056;Cervera de Pisuerga;2277;1134;1143;2020
34;Palencia;057;Cevico de la Torre;490;246;244;2020
34;Palencia;058;Cevico Navero;185;109;76;2020
34;Palencia;059;Cisneros;431;213;218;2020
34;Palencia;060;Cobos de Cerrato;138;77;61;2020
34;Palencia;061;Collazos de Boedo;99;58;41;2020
34;Palencia;062;Congosto de Valdavia;151;89;62;2020
34;Palencia;063;Cordovilla la Real;103;60;43;2020
34;Palencia;066;Cubillas de Cerrato;60;36;24;2020
34;Palencia;067;Dehesa de Montejo;127;74;53;2020
34;Palencia;068;Dehesa de Romanos;61;35;26;2020
34;Palencia;069;Dueñas;2624;1335;1289;2020
34;Palencia;070;Espinosa de Cerrato;134;75;59;2020
34;Palencia;071;Espinosa de Villagonzalo;168;90;78;2020
34;Palencia;072;Frechilla;152;72;80;2020
34;Palencia;073;Fresno del Río;186;90;96;2020
34;Palencia;074;Frómista;784;402;382;2020
34;Palencia;076;Fuentes de Nava;636;321;315;2020
34;Palencia;077;Fuentes de Valdepero;466;248;218;2020
34;Palencia;079;Grijota;2362;1231;1131;2020
34;Palencia;080;Guardo;5872;2911;2961;2020
34;Palencia;081;Guaza de Campos;61;38;23;2020
34;Palencia;082;Hérmedes de Cerrato;79;39;40;2020
34;Palencia;083;Herrera de Pisuerga;1914;937;977;2020
34;Palencia;084;Herrera de Valdecañas;156;90;66;2020
34;Palencia;086;Hontoria de Cerrato;104;53;51;2020
34;Palencia;087;Hornillos de Cerrato;143;83;60;2020
34;Palencia;088;Husillos;330;186;144;2020
34;Palencia;089;Itero de la Vega;154;93;61;2020
34;Palencia;091;Lagartos;124;70;54;2020
34;Palencia;092;Lantadilla;280;151;129;2020
34;Palencia;094;Ledigos;66;33;33;2020
34;Palencia;903;Loma de Ucieza;194;113;81;2020
34;Palencia;096;Lomas;49;31;18;2020
34;Palencia;098;Magaz de Pisuerga;1015;533;482;2020
34;Palencia;099;Manquillos;61;35;26;2020
34;Palencia;100;Mantinos;143;80;63;2020
34;Palencia;101;Marcilla de Campos;51;24;27;2020
34;Palencia;102;Mazariegos;212;125;87;2020
34;Palencia;103;Mazuecos de Valdeginate;95;59;36;2020
34;Palencia;104;Melgar de Yuso;248;146;102;2020
34;Palencia;106;Meneses de Campos;121;66;55;2020
34;Palencia;107;Micieces de Ojeda;74;42;32;2020
34;Palencia;108;Monzón de Campos;586;306;280;2020
34;Palencia;109;Moratinos;62;35;27;2020
34;Palencia;110;Mudá;84;45;39;2020
34;Palencia;112;Nogal de las Huertas;41;23;18;2020
34;Palencia;113;Olea de Boedo;41;15;26;2020
34;Palencia;114;Olmos de Ojeda;194;120;74;2020
34;Palencia;116;Osornillo;56;29;27;2020
34;Palencia;901;Osorno la Mayor;1185;625;560;2020
34;Palencia;120;Palencia;78144;36875;41269;2020
34;Palencia;121;Palenzuela;212;121;91;2020
34;Palencia;122;Páramo de Boedo;112;65;47;2020
34;Palencia;123;Paredes de Nava;1892;969;923;2020
34;Palencia;124;Payo de Ojeda;62;38;24;2020
34;Palencia;125;Pedraza de Campos;95;45;50;2020
34;Palencia;126;Pedrosa de la Vega;301;168;133;2020
34;Palencia;127;Perales;92;49;43;2020
34;Palencia;904;Pernía, La;316;184;132;2020
34;Palencia;129;Pino del Río;170;103;67;2020
34;Palencia;130;Piña de Campos;206;106;100;2020
34;Palencia;131;Población de Arroyo;55;29;26;2020
34;Palencia;132;Población de Campos;131;75;56;2020
34;Palencia;133;Población de Cerrato;107;64;43;2020
34;Palencia;134;Polentinos;41;21;20;2020
34;Palencia;135;Pomar de Valdivia;467;257;210;2020
34;Palencia;136;Poza de la Vega;176;102;74;2020
34;Palencia;137;Pozo de Urama;23;16;7;2020
34;Palencia;139;Prádanos de Ojeda;186;100;86;2020
34;Palencia;140;Puebla de Valdavia, La;95;49;46;2020
34;Palencia;141;Quintana del Puente;282;155;127;2020
34;Palencia;143;Quintanilla de Onsoña;181;104;77;2020
34;Palencia;146;Reinoso de Cerrato;54;35;19;2020
34;Palencia;147;Renedo de la Vega;186;102;84;2020
34;Palencia;149;Requena de Campos;22;9;13;2020
34;Palencia;151;Respenda de la Peña;151;91;60;2020
34;Palencia;152;Revenga de Campos;146;74;72;2020
34;Palencia;154;Revilla de Collazos;75;44;31;2020
34;Palencia;155;Ribas de Campos;140;70;70;2020
34;Palencia;156;Riberos de la Cueza;54;33;21;2020
34;Palencia;157;Saldaña;2958;1514;1444;2020
34;Palencia;158;Salinas de Pisuerga;318;166;152;2020
34;Palencia;159;San Cebrián de Campos;420;237;183;2020
34;Palencia;160;San Cebrián de Mudá;154;87;67;2020
34;Palencia;161;San Cristóbal de Boedo;22;14;8;2020
34;Palencia;163;San Mamés de Campos;47;24;23;2020
34;Palencia;165;San Román de la Cuba;61;36;25;2020
34;Palencia;167;Santa Cecilia del Alcor;114;65;49;2020
34;Palencia;168;Santa Cruz de Boedo;49;31;18;2020
34;Palencia;169;Santervás de la Vega;439;250;189;2020
34;Palencia;170;Santibáñez de Ecla;51;29;22;2020
34;Palencia;171;Santibáñez de la Peña;1005;491;514;2020
34;Palencia;174;Santoyo;180;100;80;2020
34;Palencia;175;Serna, La;95;62;33;2020
34;Palencia;177;Soto de Cerrato;192;109;83;2020
34;Palencia;176;Sotobañado y Priorato;139;81;58;2020
34;Palencia;178;Tabanera de Cerrato;133;74;59;2020
34;Palencia;179;Tabanera de Valdavia;26;15;11;2020
34;Palencia;180;Támara de Campos;76;40;36;2020
34;Palencia;181;Tariego de Cerrato;476;254;222;2020
34;Palencia;182;Torquemada;954;523;431;2020
34;Palencia;184;Torremormojón;43;24;19;2020
34;Palencia;185;Triollo;68;38;30;2020
34;Palencia;186;Valbuena de Pisuerga;47;23;24;2020
34;Palencia;189;Valdeolmillos;56;32;24;2020
34;Palencia;190;Valderrábano;50;27;23;2020
34;Palencia;192;Valde-Ucieza;80;48;32;2020
34;Palencia;196;Valle de Cerrato;85;52;33;2020
34;Palencia;902;Valle del Retortillo;160;94;66;2020
34;Palencia;199;Velilla del Río Carrión;1230;626;604;2020
34;Palencia;023;Venta de Baños;6401;3236;3165;2020
34;Palencia;201;Vertavillo;176;96;80;2020
34;Palencia;093;Vid de Ojeda, La;90;55;35;2020
34;Palencia;202;Villabasta de Valdavia;32;18;14;2020
34;Palencia;204;Villacidaler;47;28;19;2020
34;Palencia;205;Villaconancio;62;37;25;2020
34;Palencia;206;Villada;920;470;450;2020
34;Palencia;208;Villaeles de Valdavia;51;30;21;2020
34;Palencia;210;Villahán;98;53;45;2020
34;Palencia;211;Villaherreros;204;104;100;2020
34;Palencia;213;Villalaco;57;34;23;2020
34;Palencia;214;Villalba de Guardo;184;98;86;2020
34;Palencia;215;Villalcázar de Sirga;171;88;83;2020
34;Palencia;216;Villalcón;60;35;25;2020
34;Palencia;217;Villalobón;1734;868;866;2020
34;Palencia;218;Villaluenga de la Vega;574;336;238;2020
34;Palencia;220;Villamartín de Campos;181;99;82;2020
34;Palencia;221;Villamediana;176;98;78;2020
34;Palencia;222;Villameriel;106;59;47;2020
34;Palencia;223;Villamoronta;241;142;99;2020
34;Palencia;224;Villamuera de la Cueza;38;25;13;2020
34;Palencia;225;Villamuriel de Cerrato;6469;3335;3134;2020
34;Palencia;227;Villanueva del Rebollar;72;37;35;2020
34;Palencia;228;Villanuño de Valdavia;89;52;37;2020
34;Palencia;229;Villaprovedo;56;39;17;2020
34;Palencia;230;Villarmentero de Campos;18;12;6;2020
34;Palencia;231;Villarrabé;199;101;98;2020
34;Palencia;232;Villarramiel;818;440;378;2020
34;Palencia;233;Villasarracino;137;84;53;2020
34;Palencia;234;Villasila de Valdavia;70;48;22;2020
34;Palencia;236;Villaturde;157;83;74;2020
34;Palencia;237;Villaumbrales;650;323;327;2020
34;Palencia;238;Villaviudas;345;166;179;2020
34;Palencia;240;Villerías de Campos;82;42;40;2020
34;Palencia;241;Villodre;15;8;7;2020
34;Palencia;242;Villodrigo;110;59;51;2020
34;Palencia;243;Villoldo;343;184;159;2020
34;Palencia;245;Villota del Páramo;332;186;146;2020
34;Palencia;246;Villovieco;74;38;36;2020
35;Palmas, Las;001;Agaete;5599;2800;2799;2020
35;Palmas, Las;002;Agüimes;31914;16120;15794;2020
35;Palmas, Las;020;Aldea de San Nicolás, La;7508;3839;3669;2020
35;Palmas, Las;003;Antigua;12972;6845;6127;2020
35;Palmas, Las;004;Arrecife;64645;32443;32202;2020
35;Palmas, Las;005;Artenara;1049;586;463;2020
35;Palmas, Las;006;Arucas;38334;19077;19257;2020
35;Palmas, Las;007;Betancuria;773;397;376;2020
35;Palmas, Las;008;Firgas;7438;3756;3682;2020
35;Palmas, Las;009;Gáldar;24370;12165;12205;2020
35;Palmas, Las;010;Haría;5263;2713;2550;2020
35;Palmas, Las;011;Ingenio;31694;15901;15793;2020
35;Palmas, Las;012;Mogán;20487;10579;9908;2020
35;Palmas, Las;013;Moya;7746;3939;3807;2020
35;Palmas, Las;014;Oliva, La;27234;14140;13094;2020
35;Palmas, Las;015;Pájara;21349;11118;10231;2020
35;Palmas, Las;016;Palmas de Gran Canaria, Las;381223;183905;197318;2020
35;Palmas, Las;017;Puerto del Rosario;41808;21145;20663;2020
35;Palmas, Las;018;San Bartolomé;19099;9556;9543;2020
35;Palmas, Las;019;San Bartolomé de Tirajana;53397;27857;25540;2020
35;Palmas, Las;021;Santa Brígida;18394;9139;9255;2020
35;Palmas, Las;022;Santa Lucía de Tirajana;74602;37222;37380;2020
35;Palmas, Las;023;Santa María de Guía de Gran Canaria;13897;6914;6983;2020
35;Palmas, Las;024;Teguise;22703;11428;11275;2020
35;Palmas, Las;025;Tejeda;1883;1016;867;2020
35;Palmas, Las;026;Telde;102791;50425;52366;2020
35;Palmas, Las;027;Teror;12522;6410;6112;2020
35;Palmas, Las;028;Tías;20628;10607;10021;2020
35;Palmas, Las;029;Tinajo;6434;3324;3110;2020
35;Palmas, Las;030;Tuineje;15596;7972;7624;2020
35;Palmas, Las;032;Valleseco;3727;1957;1770;2020
35;Palmas, Las;031;Valsequillo de Gran Canaria;9377;4704;4673;2020
35;Palmas, Las;033;Vega de San Mateo;7569;3900;3669;2020
35;Palmas, Las;034;Yaiza;17040;8795;8245;2020
36;Pontevedra;020;Agolada;2304;1153;1151;2020
36;Pontevedra;001;Arbo;2576;1335;1241;2020
36;Pontevedra;003;Baiona;12129;5977;6152;2020
36;Pontevedra;002;Barro;3623;1784;1839;2020
36;Pontevedra;004;Bueu;11950;5878;6072;2020
36;Pontevedra;005;Caldas de Reis;9775;4699;5076;2020
36;Pontevedra;006;Cambados;13721;6630;7091;2020
36;Pontevedra;007;Campo Lameiro;1778;841;937;2020
36;Pontevedra;008;Cangas;26582;13195;13387;2020
36;Pontevedra;009;Cañiza, A;5122;2510;2612;2020
36;Pontevedra;010;Catoira;3331;1615;1716;2020
36;Pontevedra;902;Cerdedo-Cotobade;5697;2771;2926;2020
36;Pontevedra;013;Covelo;2368;1198;1170;2020
36;Pontevedra;014;Crecente;1994;973;1021;2020
36;Pontevedra;015;Cuntis;4665;2215;2450;2020
36;Pontevedra;016;Dozón;1073;560;513;2020
36;Pontevedra;017;Estrada, A;20351;9771;10580;2020
36;Pontevedra;018;Forcarei;3308;1569;1739;2020
36;Pontevedra;019;Fornelos de Montes;1598;768;830;2020
36;Pontevedra;021;Gondomar;14702;7303;7399;2020
36;Pontevedra;022;Grove, O;10518;5178;5340;2020
36;Pontevedra;023;Guarda, A;10025;4901;5124;2020
36;Pontevedra;901;Illa de Arousa, A;4932;2449;2483;2020
36;Pontevedra;024;Lalín;20207;9864;10343;2020
36;Pontevedra;025;Lama, A;2397;1192;1205;2020
36;Pontevedra;026;Marín;24242;12060;12182;2020
36;Pontevedra;027;Meaño;5322;2593;2729;2020
36;Pontevedra;028;Meis;4754;2270;2484;2020
36;Pontevedra;029;Moaña;19452;9455;9997;2020
36;Pontevedra;030;Mondariz;4410;2185;2225;2020
36;Pontevedra;031;Mondariz-Balneario;637;324;313;2020
36;Pontevedra;032;Moraña;4147;2012;2135;2020
36;Pontevedra;033;Mos;15063;7428;7635;2020
36;Pontevedra;034;Neves, As;3803;1838;1965;2020
36;Pontevedra;035;Nigrán;17745;8710;9035;2020
36;Pontevedra;036;Oia;3049;1510;1539;2020
36;Pontevedra;037;Pazos de Borbén;2965;1455;1510;2020
36;Pontevedra;041;Poio;17073;8462;8611;2020
36;Pontevedra;043;Ponte Caldelas;5533;2670;2863;2020
36;Pontevedra;042;Ponteareas;22940;11121;11819;2020
36;Pontevedra;044;Pontecesures;3053;1504;1549;2020
36;Pontevedra;038;Pontevedra;83260;39344;43916;2020
36;Pontevedra;039;Porriño, O;20100;9910;10190;2020
36;Pontevedra;040;Portas;2906;1410;1496;2020
36;Pontevedra;045;Redondela;29241;14202;15039;2020
36;Pontevedra;046;Ribadumia;5105;2484;2621;2020
36;Pontevedra;047;Rodeiro;2393;1214;1179;2020
36;Pontevedra;048;Rosal, O;6289;3092;3197;2020
36;Pontevedra;049;Salceda de Caselas;9173;4580;4593;2020
36;Pontevedra;050;Salvaterra de Miño;9990;4999;4991;2020
36;Pontevedra;051;Sanxenxo;17414;8608;8806;2020
36;Pontevedra;052;Silleda;8861;4296;4565;2020
36;Pontevedra;053;Soutomaior;7426;3702;3724;2020
36;Pontevedra;054;Tomiño;13566;6827;6739;2020
36;Pontevedra;055;Tui;17323;8409;8914;2020
36;Pontevedra;056;Valga;5824;2866;2958;2020
36;Pontevedra;057;Vigo;296692;140164;156528;2020
36;Pontevedra;059;Vila de Cruces;5208;2578;2630;2020
36;Pontevedra;058;Vilaboa;5919;2892;3027;2020
36;Pontevedra;060;Vilagarcía de Arousa;37565;17989;19576;2020
36;Pontevedra;061;Vilanova de Arousa;10239;4960;5279;2020
26;Rioja, La;001;Ábalos;255;150;105;2020
26;Rioja, La;002;Agoncillo;1096;605;491;2020
26;Rioja, La;003;Aguilar del Río Alhama;459;242;217;2020
26;Rioja, La;004;Ajamil de Cameros;68;46;22;2020
26;Rioja, La;005;Albelda de Iregua;3481;1774;1707;2020
26;Rioja, La;006;Alberite;2457;1249;1208;2020
26;Rioja, La;007;Alcanadre;638;337;301;2020
26;Rioja, La;008;Aldeanueva de Ebro;2760;1429;1331;2020
26;Rioja, La;009;Alesanco;504;261;243;2020
26;Rioja, La;010;Alesón;94;56;38;2020
26;Rioja, La;011;Alfaro;9611;4831;4780;2020
26;Rioja, La;012;Almarza de Cameros;32;21;11;2020
26;Rioja, La;013;Anguciana;425;229;196;2020
26;Rioja, La;014;Anguiano;494;276;218;2020
26;Rioja, La;015;Arenzana de Abajo;237;121;116;2020
26;Rioja, La;016;Arenzana de Arriba;29;20;9;2020
26;Rioja, La;017;Arnedillo;448;218;230;2020
26;Rioja, La;018;Arnedo;15015;7497;7518;2020
26;Rioja, La;019;Arrúbal;516;268;248;2020
26;Rioja, La;020;Ausejo;808;429;379;2020
26;Rioja, La;021;Autol;4623;2292;2331;2020
26;Rioja, La;022;Azofra;219;124;95;2020
26;Rioja, La;023;Badarán;477;245;232;2020
26;Rioja, La;024;Bañares;230;125;105;2020
26;Rioja, La;026;Baños de Río Tobía;1585;795;790;2020
26;Rioja, La;025;Baños de Rioja;83;48;35;2020
26;Rioja, La;027;Berceo;151;93;58;2020
26;Rioja, La;028;Bergasa;148;82;66;2020
26;Rioja, La;029;Bergasillas Bajera;35;17;18;2020
26;Rioja, La;030;Bezares;22;10;12;2020
26;Rioja, La;031;Bobadilla;96;49;47;2020
26;Rioja, La;032;Brieva de Cameros;38;25;13;2020
26;Rioja, La;033;Briñas;190;88;102;2020
26;Rioja, La;034;Briones;749;394;355;2020
26;Rioja, La;035;Cabezón de Cameros;14;10;4;2020
26;Rioja, La;036;Calahorra;24531;12042;12489;2020
26;Rioja, La;037;Camprovín;165;89;76;2020
26;Rioja, La;038;Canales de la Sierra;86;55;31;2020
26;Rioja, La;039;Canillas de Río Tuerto;43;23;20;2020
26;Rioja, La;040;Cañas;93;48;45;2020
26;Rioja, La;041;Cárdenas;124;66;58;2020
26;Rioja, La;042;Casalarreina;1102;550;552;2020
26;Rioja, La;043;Castañares de Rioja;404;190;214;2020
26;Rioja, La;044;Castroviejo;47;28;19;2020
26;Rioja, La;045;Cellorigo;11;4;7;2020
26;Rioja, La;046;Cenicero;2086;1067;1019;2020
26;Rioja, La;047;Cervera del Río Alhama;2308;1197;1111;2020
26;Rioja, La;048;Cidamón;24;12;12;2020
26;Rioja, La;049;Cihuri;177;94;83;2020
26;Rioja, La;050;Cirueña;168;110;58;2020
26;Rioja, La;051;Clavijo;269;162;107;2020
26;Rioja, La;052;Cordovín;153;76;77;2020
26;Rioja, La;053;Corera;256;133;123;2020
26;Rioja, La;054;Cornago;317;185;132;2020
26;Rioja, La;055;Corporales;39;24;15;2020
26;Rioja, La;056;Cuzcurrita de Río Tirón;509;276;233;2020
26;Rioja, La;057;Daroca de Rioja;50;34;16;2020
26;Rioja, La;058;Enciso;170;109;61;2020
26;Rioja, La;059;Entrena;1545;812;733;2020
26;Rioja, La;060;Estollo;86;54;32;2020
26;Rioja, La;061;Ezcaray;2045;1068;977;2020
26;Rioja, La;062;Foncea;94;55;39;2020
26;Rioja, La;063;Fonzaleche;134;90;44;2020
26;Rioja, La;064;Fuenmayor;3143;1600;1543;2020
26;Rioja, La;065;Galbárruli;67;44;23;2020
26;Rioja, La;066;Galilea;366;185;181;2020
26;Rioja, La;067;Gallinero de Cameros;20;13;7;2020
26;Rioja, La;068;Gimileo;111;60;51;2020
26;Rioja, La;069;Grañón;247;141;106;2020
26;Rioja, La;070;Grávalos;187;102;85;2020
26;Rioja, La;071;Haro;11557;5699;5858;2020
26;Rioja, La;072;Herce;330;169;161;2020
26;Rioja, La;073;Herramélluri;111;60;51;2020
26;Rioja, La;074;Hervías;126;66;60;2020
26;Rioja, La;075;Hormilla;418;225;193;2020
26;Rioja, La;076;Hormilleja;134;64;70;2020
26;Rioja, La;077;Hornillos de Cameros;16;8;8;2020
26;Rioja, La;078;Hornos de Moncalvillo;94;58;36;2020
26;Rioja, La;079;Huércanos;846;468;378;2020
26;Rioja, La;080;Igea;603;341;262;2020
26;Rioja, La;081;Jalón de Cameros;21;10;11;2020
26;Rioja, La;082;Laguna de Cameros;106;65;41;2020
26;Rioja, La;083;Lagunilla del Jubera;343;190;153;2020
26;Rioja, La;084;Lardero;10813;5419;5394;2020
26;Rioja, La;086;Ledesma de la Cogolla;16;12;4;2020
26;Rioja, La;087;Leiva;236;120;116;2020
26;Rioja, La;088;Leza de Río Leza;41;24;17;2020
26;Rioja, La;089;Logroño;152485;72341;80144;2020
26;Rioja, La;091;Lumbreras;152;104;48;2020
26;Rioja, La;092;Manjarrés;119;72;47;2020
26;Rioja, La;093;Mansilla de la Sierra;56;41;15;2020
26;Rioja, La;094;Manzanares de Rioja;65;39;26;2020
26;Rioja, La;095;Matute;91;53;38;2020
26;Rioja, La;096;Medrano;325;173;152;2020
26;Rioja, La;098;Munilla;102;56;46;2020
26;Rioja, La;099;Murillo de Río Leza;1652;845;807;2020
26;Rioja, La;100;Muro de Aguas;61;36;25;2020
26;Rioja, La;101;Muro en Cameros;35;19;16;2020
26;Rioja, La;102;Nájera;8072;3964;4108;2020
26;Rioja, La;103;Nalda;1057;582;475;2020
26;Rioja, La;104;Navajún;10;8;2;2020
26;Rioja, La;105;Navarrete;2935;1482;1453;2020
26;Rioja, La;106;Nestares;80;43;37;2020
26;Rioja, La;107;Nieva de Cameros;83;56;27;2020
26;Rioja, La;109;Ochánduri;71;45;26;2020
26;Rioja, La;108;Ocón;317;194;123;2020
26;Rioja, La;110;Ojacastro;182;109;73;2020
26;Rioja, La;111;Ollauri;286;153;133;2020
26;Rioja, La;112;Ortigosa de Cameros;221;134;87;2020
26;Rioja, La;113;Pazuengos;26;20;6;2020
26;Rioja, La;114;Pedroso;73;51;22;2020
26;Rioja, La;115;Pinillos;19;10;9;2020
26;Rioja, La;117;Pradejón;3910;2030;1880;2020
26;Rioja, La;118;Pradillo;69;37;32;2020
26;Rioja, La;119;Préjano;206;110;96;2020
26;Rioja, La;120;Quel;2078;1106;972;2020
26;Rioja, La;121;Rabanera;32;22;10;2020
26;Rioja, La;122;Rasillo de Cameros, El;145;80;65;2020
26;Rioja, La;123;Redal, El;152;84;68;2020
26;Rioja, La;124;Ribafrecha;958;500;458;2020
26;Rioja, La;125;Rincón de Soto;3886;1989;1897;2020
26;Rioja, La;126;Robres del Castillo;29;19;10;2020
26;Rioja, La;127;Rodezno;228;126;102;2020
26;Rioja, La;128;Sajazarra;129;68;61;2020
26;Rioja, La;129;San Asensio;1108;592;516;2020
26;Rioja, La;130;San Millán de la Cogolla;229;152;77;2020
26;Rioja, La;131;San Millán de Yécora;34;24;10;2020
26;Rioja, La;132;San Román de Cameros;125;79;46;2020
26;Rioja, La;139;San Torcuato;68;35;33;2020
26;Rioja, La;142;San Vicente de la Sonsierra;996;518;478;2020
26;Rioja, La;134;Santa Coloma;91;54;37;2020
26;Rioja, La;135;Santa Engracia del Jubera;160;103;57;2020
26;Rioja, La;136;Santa Eulalia Bajera;105;60;45;2020
26;Rioja, La;138;Santo Domingo de la Calzada;6276;3128;3148;2020
26;Rioja, La;140;Santurde de Rioja;275;148;127;2020
26;Rioja, La;141;Santurdejo;102;64;38;2020
26;Rioja, La;143;Sojuela;347;192;155;2020
26;Rioja, La;144;Sorzano;225;126;99;2020
26;Rioja, La;145;Sotés;284;157;127;2020
26;Rioja, La;146;Soto en Cameros;80;48;32;2020
26;Rioja, La;147;Terroba;34;19;15;2020
26;Rioja, La;148;Tirgo;185;92;93;2020
26;Rioja, La;149;Tobía;43;24;19;2020
26;Rioja, La;150;Tormantos;117;69;48;2020
26;Rioja, La;153;Torre en Cameros;10;8;2;2020
26;Rioja, La;151;Torrecilla en Cameros;453;253;200;2020
26;Rioja, La;152;Torrecilla sobre Alesanco;34;23;11;2020
26;Rioja, La;154;Torremontalbo;10;7;3;2020
26;Rioja, La;155;Treviana;150;81;69;2020
26;Rioja, La;157;Tricio;374;186;188;2020
26;Rioja, La;158;Tudelilla;341;186;155;2020
26;Rioja, La;160;Uruñuela;967;487;480;2020
26;Rioja, La;161;Valdemadera;8;5;3;2020
26;Rioja, La;162;Valgañón;130;80;50;2020
26;Rioja, La;163;Ventosa;161;83;78;2020
26;Rioja, La;164;Ventrosa;48;30;18;2020
26;Rioja, La;165;Viguera;382;220;162;2020
26;Rioja, La;166;Villalba de Rioja;158;96;62;2020
26;Rioja, La;167;Villalobar de Rioja;55;41;14;2020
26;Rioja, La;168;Villamediana de Iregua;8359;4216;4143;2020
26;Rioja, La;169;Villanueva de Cameros;71;39;32;2020
26;Rioja, La;170;Villar de Arnedo, El;596;308;288;2020
26;Rioja, La;171;Villar de Torre;160;100;60;2020
26;Rioja, La;172;Villarejo;26;21;5;2020
26;Rioja, La;173;Villarroya;5;3;2;2020
26;Rioja, La;174;Villarta-Quintana;142;83;59;2020
26;Rioja, La;175;Villavelayo;45;29;16;2020
26;Rioja, La;176;Villaverde de Rioja;56;33;23;2020
26;Rioja, La;177;Villoslada de Cameros;327;210;117;2020
26;Rioja, La;178;Viniegra de Abajo;75;48;27;2020
26;Rioja, La;179;Viniegra de Arriba;36;25;11;2020
26;Rioja, La;180;Zarratón;274;145;129;2020
26;Rioja, La;181;Zarzosa;15;10;5;2020
26;Rioja, La;183;Zorraquín;90;42;48;2020
37;Salamanca;001;Abusejo;175;93;82;2020
37;Salamanca;002;Agallas;132;69;63;2020
37;Salamanca;003;Ahigal de los Aceiteros;113;61;52;2020
37;Salamanca;004;Ahigal de Villarino;29;16;13;2020
37;Salamanca;005;Alameda de Gardón, La;68;35;33;2020
37;Salamanca;006;Alamedilla, La;118;57;61;2020
37;Salamanca;007;Alaraz;425;224;201;2020
37;Salamanca;008;Alba de Tormes;5166;2590;2576;2020
37;Salamanca;009;Alba de Yeltes;214;117;97;2020
37;Salamanca;010;Alberca, La;1071;524;547;2020
37;Salamanca;011;Alberguería de Argañán, La;106;54;52;2020
37;Salamanca;012;Alconada;152;81;71;2020
37;Salamanca;015;Aldea del Obispo;246;127;119;2020
37;Salamanca;013;Aldeacipreste;106;55;51;2020
37;Salamanca;014;Aldeadávila de la Ribera;1209;605;604;2020
37;Salamanca;016;Aldealengua;666;329;337;2020
37;Salamanca;017;Aldeanueva de Figueroa;250;136;114;2020
37;Salamanca;018;Aldeanueva de la Sierra;109;67;42;2020
37;Salamanca;019;Aldearrodrigo;139;75;64;2020
37;Salamanca;020;Aldearrubia;495;269;226;2020
37;Salamanca;021;Aldeaseca de Alba;74;38;36;2020
37;Salamanca;022;Aldeaseca de la Frontera;257;136;121;2020
37;Salamanca;023;Aldeatejada;2210;1113;1097;2020
37;Salamanca;024;Aldeavieja de Tormes;100;55;45;2020
37;Salamanca;025;Aldehuela de la Bóveda;273;147;126;2020
37;Salamanca;026;Aldehuela de Yeltes;190;103;87;2020
37;Salamanca;027;Almenara de Tormes;287;158;129;2020
37;Salamanca;028;Almendra;142;84;58;2020
37;Salamanca;029;Anaya de Alba;189;112;77;2020
37;Salamanca;030;Añover de Tormes;89;46;43;2020
37;Salamanca;031;Arabayona de Mógica;343;192;151;2020
37;Salamanca;032;Arapiles;651;352;299;2020
37;Salamanca;033;Arcediano;95;48;47;2020
37;Salamanca;034;Arco, El;88;44;44;2020
37;Salamanca;035;Armenteros;194;107;87;2020
37;Salamanca;037;Atalaya, La;108;60;48;2020
37;Salamanca;038;Babilafuente;917;476;441;2020
37;Salamanca;039;Bañobárez;291;149;142;2020
37;Salamanca;040;Barbadillo;388;210;178;2020
37;Salamanca;041;Barbalos;70;39;31;2020
37;Salamanca;042;Barceo;43;26;17;2020
37;Salamanca;044;Barruecopardo;448;251;197;2020
37;Salamanca;045;Bastida, La;25;15;10;2020
37;Salamanca;046;Béjar;12559;5930;6629;2020
37;Salamanca;047;Beleña;244;120;124;2020
37;Salamanca;049;Bermellar;124;63;61;2020
37;Salamanca;050;Berrocal de Huebra;68;39;29;2020
37;Salamanca;051;Berrocal de Salvatierra;83;43;40;2020
37;Salamanca;052;Boada;306;151;155;2020
37;Salamanca;054;Bodón, El;258;141;117;2020
37;Salamanca;055;Bogajo;133;72;61;2020
37;Salamanca;056;Bouza, La;55;24;31;2020
37;Salamanca;057;Bóveda del Río Almar;225;123;102;2020
37;Salamanca;058;Brincones;55;28;27;2020
37;Salamanca;059;Buenamadre;124;66;58;2020
37;Salamanca;060;Buenavista;350;190;160;2020
37;Salamanca;061;Cabaco, El;205;111;94;2020
37;Salamanca;063;Cabeza de Béjar, La;60;37;23;2020
37;Salamanca;065;Cabeza del Caballo;279;153;126;2020
37;Salamanca;062;Cabezabellosa de la Calzada;78;46;32;2020
37;Salamanca;067;Cabrerizos;4254;2103;2151;2020
37;Salamanca;068;Cabrillas;371;190;181;2020
37;Salamanca;069;Calvarrasa de Abajo;1166;628;538;2020
37;Salamanca;070;Calvarrasa de Arriba;573;311;262;2020
37;Salamanca;071;Calzada de Béjar, La;91;50;41;2020
37;Salamanca;072;Calzada de Don Diego;153;83;70;2020
37;Salamanca;073;Calzada de Valdunciel;690;338;352;2020
37;Salamanca;074;Campillo de Azaba;155;91;64;2020
37;Salamanca;077;Campo de Peñaranda, El;256;151;105;2020
37;Salamanca;078;Candelario;860;441;419;2020
37;Salamanca;079;Canillas de Abajo;77;54;23;2020
37;Salamanca;080;Cantagallo;265;140;125;2020
37;Salamanca;081;Cantalapiedra;950;491;459;2020
37;Salamanca;082;Cantalpino;833;450;383;2020
37;Salamanca;083;Cantaracillo;191;104;87;2020
37;Salamanca;085;Carbajosa de la Sagrada;7251;3623;3628;2020
37;Salamanca;086;Carpio de Azaba;113;64;49;2020
37;Salamanca;087;Carrascal de Barregas;1231;639;592;2020
37;Salamanca;088;Carrascal del Obispo;206;110;96;2020
37;Salamanca;089;Casafranca;64;34;30;2020
37;Salamanca;090;Casas del Conde, Las;59;26;33;2020
37;Salamanca;091;Casillas de Flores;184;90;94;2020
37;Salamanca;092;Castellanos de Moriscos;2724;1409;1315;2020
37;Salamanca;185;Castellanos de Villiquera;628;343;285;2020
37;Salamanca;096;Castillejo de Martín Viejo;211;129;82;2020
37;Salamanca;097;Castraz;41;27;14;2020
37;Salamanca;098;Cepeda;293;149;144;2020
37;Salamanca;099;Cereceda de la Sierra;66;35;31;2020
37;Salamanca;100;Cerezal de Peñahorcada;71;36;35;2020
37;Salamanca;101;Cerralbo;139;78;61;2020
37;Salamanca;102;Cerro, El;399;204;195;2020
37;Salamanca;103;Cespedosa de Tormes;488;266;222;2020
37;Salamanca;114;Chagarcía Medianero;73;41;32;2020
37;Salamanca;104;Cilleros de la Bastida;21;10;11;2020
37;Salamanca;106;Cipérez;261;138;123;2020
37;Salamanca;107;Ciudad Rodrigo;12261;5893;6368;2020
37;Salamanca;108;Coca de Alba;104;51;53;2020
37;Salamanca;109;Colmenar de Montemayor;186;108;78;2020
37;Salamanca;110;Cordovilla;112;59;53;2020
37;Salamanca;112;Cristóbal;158;92;66;2020
37;Salamanca;113;Cubo de Don Sancho, El;432;226;206;2020
37;Salamanca;115;Dios le Guarde;114;64;50;2020
37;Salamanca;116;Doñinos de Ledesma;68;34;34;2020
37;Salamanca;117;Doñinos de Salamanca;2172;1132;1040;2020
37;Salamanca;118;Éjeme;124;71;53;2020
37;Salamanca;120;Encina de San Silvestre;111;55;56;2020
37;Salamanca;119;Encina, La;104;61;43;2020
37;Salamanca;121;Encinas de Abajo;605;324;281;2020
37;Salamanca;122;Encinas de Arriba;235;120;115;2020
37;Salamanca;123;Encinasola de los Comendadores;160;89;71;2020
37;Salamanca;124;Endrinal;210;115;95;2020
37;Salamanca;125;Escurial de la Sierra;241;130;111;2020
37;Salamanca;126;Espadaña;32;19;13;2020
37;Salamanca;127;Espeja;225;115;110;2020
37;Salamanca;128;Espino de la Orbada;250;137;113;2020
37;Salamanca;129;Florida de Liébana;251;134;117;2020
37;Salamanca;130;Forfoleda;190;104;86;2020
37;Salamanca;131;Frades de la Sierra;177;100;77;2020
37;Salamanca;132;Fregeneda, La;329;163;166;2020
37;Salamanca;133;Fresnedoso;104;59;45;2020
37;Salamanca;134;Fresno Alhándiga;205;113;92;2020
37;Salamanca;135;Fuente de San Esteban, La;1285;655;630;2020
37;Salamanca;136;Fuenteguinaldo;678;334;344;2020
37;Salamanca;137;Fuenteliante;94;49;45;2020
37;Salamanca;138;Fuenterroble de Salvatierra;270;136;134;2020
37;Salamanca;139;Fuentes de Béjar;212;104;108;2020
37;Salamanca;140;Fuentes de Oñoro;1136;612;524;2020
37;Salamanca;141;Gajates;157;75;82;2020
37;Salamanca;142;Galindo y Perahuy;653;376;277;2020
37;Salamanca;143;Galinduste;428;206;222;2020
37;Salamanca;144;Galisancho;361;194;167;2020
37;Salamanca;145;Gallegos de Argañán;264;133;131;2020
37;Salamanca;146;Gallegos de Solmirón;112;64;48;2020
37;Salamanca;147;Garcibuey;191;110;81;2020
37;Salamanca;148;Garcihernández;437;228;209;2020
37;Salamanca;149;Garcirrey;62;37;25;2020
37;Salamanca;150;Gejuelo del Barro;35;20;15;2020
37;Salamanca;151;Golpejas;155;77;78;2020
37;Salamanca;152;Gomecello;430;229;201;2020
37;Salamanca;154;Guadramiro;137;84;53;2020
37;Salamanca;155;Guijo de Ávila;75;42;33;2020
37;Salamanca;156;Guijuelo;5616;2809;2807;2020
37;Salamanca;157;Herguijuela de Ciudad Rodrigo;70;42;28;2020
37;Salamanca;158;Herguijuela de la Sierra;244;135;109;2020
37;Salamanca;159;Herguijuela del Campo;74;40;34;2020
37;Salamanca;160;Hinojosa de Duero;636;318;318;2020
37;Salamanca;161;Horcajo de Montemayor;129;69;60;2020
37;Salamanca;162;Horcajo Medianero;221;116;105;2020
37;Salamanca;163;Hoya, La;37;21;16;2020
37;Salamanca;164;Huerta;288;162;126;2020
37;Salamanca;165;Iruelos;33;16;17;2020
37;Salamanca;166;Ituero de Azaba;210;110;100;2020
37;Salamanca;167;Juzbado;198;102;96;2020
37;Salamanca;168;Lagunilla;441;239;202;2020
37;Salamanca;169;Larrodrigo;182;106;76;2020
37;Salamanca;170;Ledesma;1547;763;784;2020
37;Salamanca;171;Ledrada;477;242;235;2020
37;Salamanca;172;Linares de Riofrío;944;516;428;2020
37;Salamanca;173;Lumbrales;1571;788;783;2020
37;Salamanca;175;Machacón;446;231;215;2020
37;Salamanca;174;Macotera;1019;521;498;2020
37;Salamanca;176;Madroñal;142;78;64;2020
37;Salamanca;177;Maíllo, El;245;138;107;2020
37;Salamanca;178;Malpartida;96;51;45;2020
37;Salamanca;179;Mancera de Abajo;205;109;96;2020
37;Salamanca;180;Manzano, El;70;36;34;2020
37;Salamanca;181;Martiago;263;143;120;2020
37;Salamanca;183;Martín de Yeltes;407;212;195;2020
37;Salamanca;182;Martinamor;79;51;28;2020
37;Salamanca;184;Masueco;285;146;139;2020
37;Salamanca;186;Mata de Ledesma, La;92;52;40;2020
37;Salamanca;187;Matilla de los Caños del Río;623;311;312;2020
37;Salamanca;188;Maya, La;163;96;67;2020
37;Salamanca;189;Membribe de la Sierra;112;67;45;2020
37;Salamanca;190;Mieza;198;102;96;2020
37;Salamanca;191;Milano, El;101;60;41;2020
37;Salamanca;192;Miranda de Azán;440;231;209;2020
37;Salamanca;193;Miranda del Castañar;385;208;177;2020
37;Salamanca;194;Mogarraz;268;136;132;2020
37;Salamanca;195;Molinillo;39;23;16;2020
37;Salamanca;196;Monforte de la Sierra;65;34;31;2020
37;Salamanca;197;Monleón;93;53;40;2020
37;Salamanca;198;Monleras;226;108;118;2020
37;Salamanca;199;Monsagro;138;78;60;2020
37;Salamanca;200;Montejo;205;118;87;2020
37;Salamanca;201;Montemayor del Río;263;140;123;2020
37;Salamanca;202;Monterrubio de Armuña;1326;696;630;2020
37;Salamanca;203;Monterrubio de la Sierra;151;83;68;2020
37;Salamanca;204;Morasverdes;252;132;120;2020
37;Salamanca;205;Morille;226;124;102;2020
37;Salamanca;206;Moríñigo;96;53;43;2020
37;Salamanca;207;Moriscos;459;255;204;2020
37;Salamanca;208;Moronta;72;46;26;2020
37;Salamanca;209;Mozárbez;507;269;238;2020
37;Salamanca;211;Narros de Matalayegua;212;117;95;2020
37;Salamanca;213;Nava de Béjar;86;51;35;2020
37;Salamanca;214;Nava de Francia;123;64;59;2020
37;Salamanca;215;Nava de Sotrobal;155;89;66;2020
37;Salamanca;212;Navacarros;119;64;55;2020
37;Salamanca;216;Navales;317;170;147;2020
37;Salamanca;217;Navalmoral de Béjar;59;27;32;2020
37;Salamanca;218;Navamorales;52;32;20;2020
37;Salamanca;219;Navarredonda de la Rinconada;168;85;83;2020
37;Salamanca;221;Navasfrías;422;223;199;2020
37;Salamanca;222;Negrilla de Palencia;83;50;33;2020
37;Salamanca;223;Olmedo de Camaces;113;59;54;2020
37;Salamanca;224;Orbada, La;197;103;94;2020
37;Salamanca;225;Pajares de la Laguna;106;57;49;2020
37;Salamanca;226;Palacios del Arzobispo;168;82;86;2020
37;Salamanca;228;Palaciosrubios;333;176;157;2020
37;Salamanca;229;Palencia de Negrilla;155;93;62;2020
37;Salamanca;230;Parada de Arriba;252;130;122;2020
37;Salamanca;231;Parada de Rubiales;247;134;113;2020
37;Salamanca;232;Paradinas de San Juan;383;226;157;2020
37;Salamanca;233;Pastores;56;36;20;2020
37;Salamanca;234;Payo, El;324;159;165;2020
37;Salamanca;235;Pedraza de Alba;231;124;107;2020
37;Salamanca;236;Pedrosillo de Alba;132;80;52;2020
37;Salamanca;237;Pedrosillo de los Aires;346;196;150;2020
37;Salamanca;238;Pedrosillo el Ralo;131;68;63;2020
37;Salamanca;239;Pedroso de la Armuña, El;210;111;99;2020
37;Salamanca;240;Pelabravo;1210;646;564;2020
37;Salamanca;241;Pelarrodríguez;172;103;69;2020
37;Salamanca;242;Pelayos;81;49;32;2020
37;Salamanca;243;Peña, La;88;43;45;2020
37;Salamanca;244;Peñacaballera;141;72;69;2020
37;Salamanca;245;Peñaparda;344;171;173;2020
37;Salamanca;246;Peñaranda de Bracamonte;6161;3031;3130;2020
37;Salamanca;247;Peñarandilla;181;99;82;2020
37;Salamanca;248;Peralejos de Abajo;163;86;77;2020
37;Salamanca;249;Peralejos de Arriba;36;23;13;2020
37;Salamanca;250;Pereña de la Ribera;332;179;153;2020
37;Salamanca;251;Peromingo;117;56;61;2020
37;Salamanca;252;Pinedas;105;60;45;2020
37;Salamanca;253;Pino de Tormes, El;157;85;72;2020
37;Salamanca;254;Pitiegua;187;105;82;2020
37;Salamanca;255;Pizarral;49;32;17;2020
37;Salamanca;256;Poveda de las Cintas;199;115;84;2020
37;Salamanca;257;Pozos de Hinojo;52;28;24;2020
37;Salamanca;258;Puebla de Azaba;154;88;66;2020
37;Salamanca;259;Puebla de San Medel;37;22;15;2020
37;Salamanca;260;Puebla de Yeltes;148;78;70;2020
37;Salamanca;261;Puente del Congosto;221;125;96;2020
37;Salamanca;262;Puertas;79;44;35;2020
37;Salamanca;263;Puerto de Béjar;373;177;196;2020
37;Salamanca;264;Puerto Seguro;59;28;31;2020
37;Salamanca;265;Rágama;213;109;104;2020
37;Salamanca;266;Redonda, La;71;41;30;2020
37;Salamanca;267;Retortillo;186;100;86;2020
37;Salamanca;268;Rinconada de la Sierra, La;105;62;43;2020
37;Salamanca;269;Robleda;471;261;210;2020
37;Salamanca;270;Robliza de Cojos;202;105;97;2020
37;Salamanca;271;Rollán;364;202;162;2020
37;Salamanca;272;Saelices el Chico;151;89;62;2020
37;Salamanca;273;Sagrada, La;94;55;39;2020
37;Salamanca;303;Sahugo, El;183;100;83;2020
37;Salamanca;274;Salamanca;144825;65661;79164;2020
37;Salamanca;275;Saldeana;99;57;42;2020
37;Salamanca;276;Salmoral;125;74;51;2020
37;Salamanca;277;Salvatierra de Tormes;74;37;37;2020
37;Salamanca;278;San Cristóbal de la Cuesta;1031;540;491;2020
37;Salamanca;284;San Esteban de la Sierra;345;197;148;2020
37;Salamanca;285;San Felices de los Gallegos;377;198;179;2020
37;Salamanca;286;San Martín del Castañar;225;120;105;2020
37;Salamanca;287;San Miguel de Valero;318;163;155;2020
37;Salamanca;036;San Miguel del Robledo;52;31;21;2020
37;Salamanca;288;San Morales;345;189;156;2020
37;Salamanca;289;San Muñoz;216;109;107;2020
37;Salamanca;291;San Pedro de Rozados;281;159;122;2020
37;Salamanca;290;San Pedro del Valle;142;81;61;2020
37;Salamanca;292;San Pelayo de Guareña;91;53;38;2020
37;Salamanca;280;Sanchón de la Ribera;76;40;36;2020
37;Salamanca;281;Sanchón de la Sagrada;39;23;16;2020
37;Salamanca;282;Sanchotello;227;116;111;2020
37;Salamanca;279;Sancti-Spíritus;782;424;358;2020
37;Salamanca;283;Sando;124;71;53;2020
37;Salamanca;293;Santa María de Sando;100;53;47;2020
37;Salamanca;294;Santa Marta de Tormes;14730;7218;7512;2020
37;Salamanca;296;Santiago de la Puebla;309;158;151;2020
37;Salamanca;297;Santibáñez de Béjar;456;231;225;2020
37;Salamanca;298;Santibáñez de la Sierra;173;100;73;2020
37;Salamanca;299;Santiz;253;135;118;2020
37;Salamanca;300;Santos, Los;605;312;293;2020
37;Salamanca;301;Sardón de los Frailes;94;54;40;2020
37;Salamanca;302;Saucelle;280;139;141;2020
37;Salamanca;304;Sepulcro-Hilario;164;92;72;2020
37;Salamanca;305;Sequeros;232;116;116;2020
37;Salamanca;306;Serradilla del Arroyo;251;138;113;2020
37;Salamanca;307;Serradilla del Llano;153;79;74;2020
37;Salamanca;309;Sierpe, La;40;21;19;2020
37;Salamanca;310;Sieteiglesias de Tormes;193;93;100;2020
37;Salamanca;311;Sobradillo;203;103;100;2020
37;Salamanca;312;Sorihuela;253;135;118;2020
37;Salamanca;313;Sotoserrano;557;297;260;2020
37;Salamanca;314;Tabera de Abajo;103;57;46;2020
37;Salamanca;315;Tala, La;84;46;38;2020
37;Salamanca;316;Tamames;784;397;387;2020
37;Salamanca;317;Tarazona de Guareña;302;163;139;2020
37;Salamanca;318;Tardáguila;201;122;79;2020
37;Salamanca;319;Tejado, El;86;46;40;2020
37;Salamanca;320;Tejeda y Segoyuela;89;49;40;2020
37;Salamanca;321;Tenebrón;137;72;65;2020
37;Salamanca;322;Terradillos;3041;1518;1523;2020
37;Salamanca;323;Topas;521;282;239;2020
37;Salamanca;324;Tordillos;340;185;155;2020
37;Salamanca;325;Tornadizo, El;94;53;41;2020
37;Salamanca;327;Torresmenudas;187;96;91;2020
37;Salamanca;328;Trabanca;177;84;93;2020
37;Salamanca;329;Tremedal de Tormes;41;22;19;2020
37;Salamanca;330;Valdecarros;337;173;164;2020
37;Salamanca;331;Valdefuentes de Sangusín;189;108;81;2020
37;Salamanca;332;Valdehijaderos;73;39;34;2020
37;Salamanca;333;Valdelacasa;216;124;92;2020
37;Salamanca;334;Valdelageve;67;37;30;2020
37;Salamanca;335;Valdelosa;406;205;201;2020
37;Salamanca;336;Valdemierque;64;41;23;2020
37;Salamanca;337;Valderrodrigo;144;76;68;2020
37;Salamanca;338;Valdunciel;95;46;49;2020
37;Salamanca;339;Valero;302;170;132;2020
37;Salamanca;343;Vallejera de Riofrío;72;35;37;2020
37;Salamanca;340;Valsalabroso;141;79;62;2020
37;Salamanca;341;Valverde de Valdelacasa;65;33;32;2020
37;Salamanca;342;Valverdón;280;147;133;2020
37;Salamanca;344;Vecinos;242;120;122;2020
37;Salamanca;345;Vega de Tirados;170;94;76;2020
37;Salamanca;346;Veguillas, Las;283;139;144;2020
37;Salamanca;347;Vellés, La;522;288;234;2020
37;Salamanca;348;Ventosa del Río Almar;105;58;47;2020
37;Salamanca;349;Vídola, La;104;52;52;2020
37;Salamanca;351;Villaflores;271;138;133;2020
37;Salamanca;352;Villagonzalo de Tormes;227;131;96;2020
37;Salamanca;353;Villalba de los Llanos;129;72;57;2020
37;Salamanca;354;Villamayor;7212;3625;3587;2020
37;Salamanca;355;Villanueva del Conde;163;81;82;2020
37;Salamanca;356;Villar de Argañán;91;51;40;2020
37;Salamanca;357;Villar de Ciervo;264;139;125;2020
37;Salamanca;358;Villar de Gallimazo;202;130;72;2020
37;Salamanca;359;Villar de la Yegua;174;91;83;2020
37;Salamanca;360;Villar de Peralonso;217;113;104;2020
37;Salamanca;361;Villar de Samaniego;88;49;39;2020
37;Salamanca;362;Villares de la Reina;6369;3158;3211;2020
37;Salamanca;363;Villares de Yeltes;109;49;60;2020
37;Salamanca;364;Villarino de los Aires;792;416;376;2020
37;Salamanca;365;Villarmayor;178;101;77;2020
37;Salamanca;366;Villarmuerto;39;27;12;2020
37;Salamanca;367;Villasbuenas;183;100;83;2020
37;Salamanca;368;Villasdardo;22;6;16;2020
37;Salamanca;369;Villaseco de los Gamitos;136;78;58;2020
37;Salamanca;370;Villaseco de los Reyes;331;191;140;2020
37;Salamanca;371;Villasrubias;256;140;116;2020
37;Salamanca;372;Villaverde de Guareña;144;79;65;2020
37;Salamanca;373;Villavieja de Yeltes;748;395;353;2020
37;Salamanca;374;Villoria;1345;693;652;2020
37;Salamanca;375;Villoruela;763;383;380;2020
37;Salamanca;350;Vilvestre;428;208;220;2020
37;Salamanca;376;Vitigudino;2445;1185;1260;2020
37;Salamanca;377;Yecla de Yeltes;230;119;111;2020
37;Salamanca;378;Zamarra;85;50;35;2020
37;Salamanca;379;Zamayón;195;114;81;2020
37;Salamanca;380;Zarapicos;55;32;23;2020
37;Salamanca;381;Zarza de Pumareda, La;142;83;59;2020
37;Salamanca;382;Zorita de la Frontera;160;78;82;2020
38;Santa Cruz de Tenerife;001;Adeje;49030;24675;24355;2020
38;Santa Cruz de Tenerife;002;Agulo;1110;556;554;2020
38;Santa Cruz de Tenerife;003;Alajeró;2026;1068;958;2020
38;Santa Cruz de Tenerife;004;Arafo;5593;2769;2824;2020
38;Santa Cruz de Tenerife;005;Arico;8111;4171;3940;2020
38;Santa Cruz de Tenerife;006;Arona;82777;42033;40744;2020
38;Santa Cruz de Tenerife;007;Barlovento;1926;981;945;2020
38;Santa Cruz de Tenerife;008;Breña Alta;7247;3530;3717;2020
38;Santa Cruz de Tenerife;009;Breña Baja;5821;2941;2880;2020
38;Santa Cruz de Tenerife;010;Buenavista del Norte;4786;2402;2384;2020
38;Santa Cruz de Tenerife;011;Candelaria;28383;13774;14609;2020
38;Santa Cruz de Tenerife;012;Fasnia;2818;1475;1343;2020
38;Santa Cruz de Tenerife;013;Frontera;4184;2095;2089;2020
38;Santa Cruz de Tenerife;014;Fuencaliente de la Palma;1751;874;877;2020
38;Santa Cruz de Tenerife;015;Garachico;4869;2441;2428;2020
38;Santa Cruz de Tenerife;016;Garafía;1730;901;829;2020
38;Santa Cruz de Tenerife;017;Granadilla de Abona;51233;25633;25600;2020
38;Santa Cruz de Tenerife;018;Guancha, La;5540;2697;2843;2020
38;Santa Cruz de Tenerife;019;Guía de Isora;21796;10799;10997;2020
38;Santa Cruz de Tenerife;020;Güímar;20662;10207;10455;2020
38;Santa Cruz de Tenerife;021;Hermigua;1775;912;863;2020
38;Santa Cruz de Tenerife;022;Icod de los Vinos;23316;11456;11860;2020
38;Santa Cruz de Tenerife;024;Llanos de Aridane, Los;20760;10071;10689;2020
38;Santa Cruz de Tenerife;025;Matanza de Acentejo, La;9059;4576;4483;2020
38;Santa Cruz de Tenerife;026;Orotava, La;42187;20649;21538;2020
38;Santa Cruz de Tenerife;027;Paso, El;7623;3807;3816;2020
38;Santa Cruz de Tenerife;901;Pinar de El Hierro, El;1894;993;901;2020
38;Santa Cruz de Tenerife;028;Puerto de la Cruz;30492;14871;15621;2020
38;Santa Cruz de Tenerife;029;Puntagorda;2203;1111;1092;2020
38;Santa Cruz de Tenerife;030;Puntallana;2553;1273;1280;2020
38;Santa Cruz de Tenerife;031;Realejos, Los;36727;17995;18732;2020
38;Santa Cruz de Tenerife;032;Rosario, El;17496;8867;8629;2020
38;Santa Cruz de Tenerife;033;San Andrés y Sauces;4182;2090;2092;2020
38;Santa Cruz de Tenerife;023;San Cristóbal de La Laguna;158911;76703;82208;2020
38;Santa Cruz de Tenerife;034;San Juan de la Rambla;4873;2422;2451;2020
38;Santa Cruz de Tenerife;035;San Miguel de Abona;21621;10934;10687;2020
38;Santa Cruz de Tenerife;036;San Sebastián de la Gomera;9258;4647;4611;2020
38;Santa Cruz de Tenerife;037;Santa Cruz de la Palma;15695;7582;8113;2020
38;Santa Cruz de Tenerife;038;Santa Cruz de Tenerife;209194;99840;109354;2020
38;Santa Cruz de Tenerife;039;Santa Úrsula;14953;7437;7516;2020
38;Santa Cruz de Tenerife;040;Santiago del Teide;11281;5606;5675;2020
38;Santa Cruz de Tenerife;041;Sauzal, El;8940;4445;4495;2020
38;Santa Cruz de Tenerife;042;Silos, Los;4743;2360;2383;2020
38;Santa Cruz de Tenerife;043;Tacoronte;24201;11996;12205;2020
38;Santa Cruz de Tenerife;044;Tanque, El;2852;1380;1472;2020
38;Santa Cruz de Tenerife;045;Tazacorte;4601;2343;2258;2020
38;Santa Cruz de Tenerife;046;Tegueste;11287;5555;5732;2020
38;Santa Cruz de Tenerife;047;Tijarafe;2507;1274;1233;2020
38;Santa Cruz de Tenerife;049;Valle Gran Rey;4630;2357;2273;2020
38;Santa Cruz de Tenerife;050;Vallehermoso;2879;1492;1387;2020
38;Santa Cruz de Tenerife;048;Valverde;5069;2544;2525;2020
38;Santa Cruz de Tenerife;051;Victoria de Acentejo, La;9158;4563;4595;2020
38;Santa Cruz de Tenerife;052;Vilaflor de Chasna;1715;878;837;2020
38;Santa Cruz de Tenerife;053;Villa de Mazo;4859;2440;2419;2020
40;Segovia;001;Abades;857;423;434;2020
40;Segovia;002;Adrada de Pirón;37;20;17;2020
40;Segovia;003;Adrados;127;76;51;2020
40;Segovia;004;Aguilafuente;566;284;282;2020
40;Segovia;005;Alconada de Maderuelo;23;15;8;2020
40;Segovia;012;Aldea Real;279;151;128;2020
40;Segovia;006;Aldealcorvo;20;10;10;2020
40;Segovia;007;Aldealengua de Pedraza;73;46;27;2020
40;Segovia;008;Aldealengua de Santa María;64;32;32;2020
40;Segovia;009;Aldeanueva de la Serrezuela;40;29;11;2020
40;Segovia;010;Aldeanueva del Codonal;113;64;49;2020
40;Segovia;013;Aldeasoña;56;34;22;2020
40;Segovia;014;Aldehorno;53;34;19;2020
40;Segovia;015;Aldehuela del Codonal;23;12;11;2020
40;Segovia;016;Aldeonte;57;31;26;2020
40;Segovia;017;Anaya;125;62;63;2020
40;Segovia;018;Añe;72;42;30;2020
40;Segovia;019;Arahuetes;28;21;7;2020
40;Segovia;020;Arcones;145;71;74;2020
40;Segovia;021;Arevalillo de Cega;19;11;8;2020
40;Segovia;022;Armuña;234;134;100;2020
40;Segovia;024;Ayllón;1182;604;578;2020
40;Segovia;025;Barbolla;158;89;69;2020
40;Segovia;026;Basardilla;143;65;78;2020
40;Segovia;028;Bercial;109;58;51;2020
40;Segovia;029;Bercimuel;22;12;10;2020
40;Segovia;030;Bernardos;465;260;205;2020
40;Segovia;031;Bernuy de Porreros;766;410;356;2020
40;Segovia;032;Boceguillas;719;377;342;2020
40;Segovia;033;Brieva;93;52;41;2020
40;Segovia;034;Caballar;82;46;36;2020
40;Segovia;035;Cabañas de Polendos;171;93;78;2020
40;Segovia;036;Cabezuela;644;334;310;2020
40;Segovia;037;Calabazas de Fuentidueña;26;15;11;2020
40;Segovia;039;Campo de San Pedro;230;126;104;2020
40;Segovia;040;Cantalejo;3562;1773;1789;2020
40;Segovia;041;Cantimpalos;1340;711;629;2020
40;Segovia;161;Carabias;51;36;15;2020
40;Segovia;043;Carbonero el Mayor;2494;1286;1208;2020
40;Segovia;044;Carrascal del Río;146;79;67;2020
40;Segovia;045;Casla;156;80;76;2020
40;Segovia;046;Castillejo de Mesleón;130;70;60;2020
40;Segovia;047;Castro de Fuentidueña;37;23;14;2020
40;Segovia;048;Castrojimeno;33;18;15;2020
40;Segovia;049;Castroserna de Abajo;31;17;14;2020
40;Segovia;051;Castroserracín;40;21;19;2020
40;Segovia;052;Cedillo de la Torre;88;47;41;2020
40;Segovia;053;Cerezo de Abajo;102;55;47;2020
40;Segovia;054;Cerezo de Arriba;128;70;58;2020
40;Segovia;065;Chañe;708;359;349;2020
40;Segovia;055;Cilleruelo de San Mamés;30;19;11;2020
40;Segovia;056;Cobos de Fuentidueña;33;15;18;2020
40;Segovia;057;Coca;1726;869;857;2020
40;Segovia;058;Codorniz;322;164;158;2020
40;Segovia;059;Collado Hermoso;124;65;59;2020
40;Segovia;060;Condado de Castilnovo;85;47;38;2020
40;Segovia;061;Corral de Ayllón;72;43;29;2020
40;Segovia;902;Cozuelos de Fuentidueña;126;69;57;2020
40;Segovia;062;Cubillo;74;46;28;2020
40;Segovia;063;Cuéllar;9659;4892;4767;2020
40;Segovia;905;Cuevas de Provanco;130;75;55;2020
40;Segovia;068;Domingo García;25;15;10;2020
40;Segovia;069;Donhierro;84;46;38;2020
40;Segovia;070;Duruelo;166;98;68;2020
40;Segovia;071;Encinas;41;21;20;2020
40;Segovia;072;Encinillas;312;172;140;2020
40;Segovia;073;Escalona del Prado;495;260;235;2020
40;Segovia;074;Escarabajosa de Cabezas;296;160;136;2020
40;Segovia;075;Escobar de Polendos;165;88;77;2020
40;Segovia;076;Espinar, El;9086;4613;4473;2020
40;Segovia;077;Espirdo;1389;738;651;2020
40;Segovia;078;Fresneda de Cuéllar;163;93;70;2020
40;Segovia;079;Fresno de Cantespino;280;155;125;2020
40;Segovia;080;Fresno de la Fuente;79;45;34;2020
40;Segovia;081;Frumales;114;62;52;2020
40;Segovia;082;Fuente de Santa Cruz;110;60;50;2020
40;Segovia;083;Fuente el Olmo de Fuentidueña;170;77;93;2020
40;Segovia;084;Fuente el Olmo de Íscar;55;30;25;2020
40;Segovia;086;Fuentepelayo;822;438;384;2020
40;Segovia;087;Fuentepiñel;85;51;34;2020
40;Segovia;088;Fuenterrebollo;340;177;163;2020
40;Segovia;089;Fuentesaúco de Fuentidueña;233;121;112;2020
40;Segovia;091;Fuentesoto;106;62;44;2020
40;Segovia;092;Fuentidueña;120;72;48;2020
40;Segovia;093;Gallegos;105;58;47;2020
40;Segovia;094;Garcillán;474;252;222;2020
40;Segovia;095;Gomezserracín;664;355;309;2020
40;Segovia;097;Grajera;228;133;95;2020
40;Segovia;099;Honrubia de la Cuesta;55;33;22;2020
40;Segovia;100;Hontalbilla;303;168;135;2020
40;Segovia;101;Hontanares de Eresma;1456;758;698;2020
40;Segovia;103;Huertos, Los;159;88;71;2020
40;Segovia;104;Ituero y Lama;379;195;184;2020
40;Segovia;105;Juarros de Riomoros;42;25;17;2020
40;Segovia;106;Juarros de Voltoya;197;99;98;2020
40;Segovia;107;Labajos;101;59;42;2020
40;Segovia;108;Laguna de Contreras;110;65;45;2020
40;Segovia;109;Languilla;73;43;30;2020
40;Segovia;110;Lastras de Cuéllar;344;185;159;2020
40;Segovia;111;Lastras del Pozo;62;33;29;2020
40;Segovia;112;Lastrilla, La;4020;2042;1978;2020
40;Segovia;113;Losa, La;519;294;225;2020
40;Segovia;115;Maderuelo;137;78;59;2020
40;Segovia;903;Marazoleja;98;65;33;2020
40;Segovia;118;Marazuela;48;30;18;2020
40;Segovia;119;Martín Miguel;211;127;84;2020
40;Segovia;120;Martín Muñoz de la Dehesa;227;117;110;2020
40;Segovia;121;Martín Muñoz de las Posadas;284;155;129;2020
40;Segovia;122;Marugán;606;334;272;2020
40;Segovia;124;Mata de Cuéllar;253;133;120;2020
40;Segovia;123;Matabuena;135;76;59;2020
40;Segovia;125;Matilla, La;78;49;29;2020
40;Segovia;126;Melque de Cercos;67;35;32;2020
40;Segovia;127;Membibre de la Hoz;35;18;17;2020
40;Segovia;128;Migueláñez;131;70;61;2020
40;Segovia;129;Montejo de Arévalo;171;91;80;2020
40;Segovia;130;Montejo de la Vega de la Serrezuela;138;81;57;2020
40;Segovia;131;Monterrubio;58;31;27;2020
40;Segovia;132;Moral de Hornuez;49;28;21;2020
40;Segovia;134;Mozoncillo;879;483;396;2020
40;Segovia;135;Muñopedro;313;171;142;2020
40;Segovia;136;Muñoveros;143;70;73;2020
40;Segovia;138;Nava de la Asunción;2747;1404;1343;2020
40;Segovia;139;Navafría;285;159;126;2020
40;Segovia;140;Navalilla;100;52;48;2020
40;Segovia;141;Navalmanzano;1047;545;502;2020
40;Segovia;142;Navares de Ayuso;53;27;26;2020
40;Segovia;143;Navares de Enmedio;92;56;36;2020
40;Segovia;144;Navares de las Cuevas;21;14;7;2020
40;Segovia;145;Navas de Oro;1305;660;645;2020
40;Segovia;904;Navas de Riofrío;386;183;203;2020
40;Segovia;146;Navas de San Antonio;343;183;160;2020
40;Segovia;148;Nieva;263;127;136;2020
40;Segovia;149;Olombrada;536;292;244;2020
40;Segovia;150;Orejana;56;34;22;2020
40;Segovia;151;Ortigosa de Pestaño;49;26;23;2020
40;Segovia;901;Ortigosa del Monte;544;280;264;2020
40;Segovia;152;Otero de Herreros;943;479;464;2020
40;Segovia;154;Pajarejos;21;11;10;2020
40;Segovia;155;Palazuelos de Eresma;5538;2884;2654;2020
40;Segovia;156;Pedraza;340;194;146;2020
40;Segovia;157;Pelayos del Arroyo;42;25;17;2020
40;Segovia;158;Perosillo;15;12;3;2020
40;Segovia;159;Pinarejos;184;106;78;2020
40;Segovia;160;Pinarnegrillo;92;51;41;2020
40;Segovia;162;Prádena;510;270;240;2020
40;Segovia;163;Puebla de Pedraza;43;23;20;2020
40;Segovia;164;Rapariegos;208;105;103;2020
40;Segovia;181;Real Sitio de San Ildefonso;5285;2583;2702;2020
40;Segovia;165;Rebollo;79;41;38;2020
40;Segovia;166;Remondo;304;156;148;2020
40;Segovia;168;Riaguas de San Bartolomé;24;16;8;2020
40;Segovia;170;Riaza;2117;1122;995;2020
40;Segovia;171;Ribota;47;34;13;2020
40;Segovia;172;Riofrío de Riaza;44;26;18;2020
40;Segovia;173;Roda de Eresma;197;106;91;2020
40;Segovia;174;Sacramenia;385;188;197;2020
40;Segovia;176;Samboal;460;247;213;2020
40;Segovia;177;San Cristóbal de Cuéllar;143;78;65;2020
40;Segovia;178;San Cristóbal de la Vega;93;49;44;2020
40;Segovia;906;San Cristóbal de Segovia;3080;1533;1547;2020
40;Segovia;182;San Martín y Mudrián;248;119;129;2020
40;Segovia;183;San Miguel de Bernuy;148;75;73;2020
40;Segovia;184;San Pedro de Gaíllos;271;147;124;2020
40;Segovia;179;Sanchonuño;973;477;496;2020
40;Segovia;180;Sangarcía;315;177;138;2020
40;Segovia;185;Santa María la Real de Nieva;961;525;436;2020
40;Segovia;186;Santa Marta del Cerro;33;18;15;2020
40;Segovia;188;Santiuste de Pedraza;91;59;32;2020
40;Segovia;189;Santiuste de San Juan Bautista;536;296;240;2020
40;Segovia;190;Santo Domingo de Pirón;53;29;24;2020
40;Segovia;191;Santo Tomé del Puerto;260;142;118;2020
40;Segovia;192;Sauquillo de Cabezas;146;78;68;2020
40;Segovia;193;Sebúlcor;274;141;133;2020
40;Segovia;194;Segovia;52057;24328;27729;2020
40;Segovia;195;Sepúlveda;967;502;465;2020
40;Segovia;196;Sequera de Fresno;34;22;12;2020
40;Segovia;198;Sotillo;28;16;12;2020
40;Segovia;199;Sotosalbos;118;62;56;2020
40;Segovia;200;Tabanera la Luenga;49;25;24;2020
40;Segovia;201;Tolocirio;46;23;23;2020
40;Segovia;206;Torre Val de San Pedro;192;100;92;2020
40;Segovia;202;Torreadrada;55;28;27;2020
40;Segovia;203;Torrecaballeros;1372;706;666;2020
40;Segovia;204;Torrecilla del Pinar;175;95;80;2020
40;Segovia;205;Torreiglesias;252;128;124;2020
40;Segovia;207;Trescasas;1074;549;525;2020
40;Segovia;208;Turégano;986;501;485;2020
40;Segovia;210;Urueñas;102;65;37;2020
40;Segovia;211;Valdeprados;69;37;32;2020
40;Segovia;212;Valdevacas de Montejo;29;14;15;2020
40;Segovia;213;Valdevacas y Guijar;95;53;42;2020
40;Segovia;218;Valle de Tabladillo;82;49;33;2020
40;Segovia;219;Vallelado;712;373;339;2020
40;Segovia;220;Valleruela de Pedraza;68;32;36;2020
40;Segovia;221;Valleruela de Sepúlveda;52;27;25;2020
40;Segovia;214;Valseca;234;129;105;2020
40;Segovia;215;Valtiendas;82;50;32;2020
40;Segovia;216;Valverde del Majano;1115;573;542;2020
40;Segovia;222;Veganzones;219;118;101;2020
40;Segovia;223;Vegas de Matute;293;171;122;2020
40;Segovia;224;Ventosilla y Tejadilla;16;10;6;2020
40;Segovia;225;Villacastín;1483;785;698;2020
40;Segovia;228;Villaverde de Íscar;591;310;281;2020
40;Segovia;229;Villaverde de Montejo;26;17;9;2020
40;Segovia;230;Villeguillo;105;58;47;2020
40;Segovia;231;Yanguas de Eresma;125;68;57;2020
40;Segovia;233;Zarzuela del Monte;485;253;232;2020
40;Segovia;234;Zarzuela del Pinar;424;219;205;2020
41;Sevilla;001;Aguadulce;2035;1005;1030;2020
41;Sevilla;002;Alanís;1706;852;854;2020
41;Sevilla;003;Albaida del Aljarafe;3201;1591;1610;2020
41;Sevilla;004;Alcalá de Guadaíra;75533;37524;38009;2020
41;Sevilla;005;Alcalá del Río;12186;6174;6012;2020
41;Sevilla;006;Alcolea del Río;3347;1670;1677;2020
41;Sevilla;007;Algaba, La;16503;8186;8317;2020
41;Sevilla;008;Algámitas;1253;651;602;2020
41;Sevilla;009;Almadén de la Plata;1307;673;634;2020
41;Sevilla;010;Almensilla;6175;3095;3080;2020
41;Sevilla;011;Arahal;19533;9675;9858;2020
41;Sevilla;012;Aznalcázar;4588;2335;2253;2020
41;Sevilla;013;Aznalcóllar;6083;3093;2990;2020
41;Sevilla;014;Badolatosa;3079;1586;1493;2020
41;Sevilla;015;Benacazón;7222;3642;3580;2020
41;Sevilla;016;Bollullos de la Mitación;10931;5459;5472;2020
41;Sevilla;017;Bormujos;22180;10982;11198;2020
41;Sevilla;018;Brenes;12501;6185;6316;2020
41;Sevilla;019;Burguillos;6766;3414;3352;2020
41;Sevilla;020;Cabezas de San Juan, Las;16358;8170;8188;2020
41;Sevilla;021;Camas;27560;13486;14074;2020
41;Sevilla;022;Campana, La;5238;2624;2614;2020
41;Sevilla;023;Cantillana;10736;5443;5293;2020
41;Sevilla;901;Cañada Rosal;3325;1636;1689;2020
41;Sevilla;024;Carmona;28834;14501;14333;2020
41;Sevilla;025;Carrión de los Céspedes;2547;1242;1305;2020
41;Sevilla;026;Casariche;5429;2799;2630;2020
41;Sevilla;027;Castilblanco de los Arroyos;4899;2465;2434;2020
41;Sevilla;028;Castilleja de Guzmán;2833;1453;1380;2020
41;Sevilla;029;Castilleja de la Cuesta;17516;8463;9053;2020
41;Sevilla;030;Castilleja del Campo;640;330;310;2020
41;Sevilla;031;Castillo de las Guardas, El;1468;771;697;2020
41;Sevilla;032;Cazalla de la Sierra;4684;2310;2374;2020
41;Sevilla;033;Constantina;5864;2901;2963;2020
41;Sevilla;034;Coria del Río;30908;15418;15490;2020
41;Sevilla;035;Coripe;1238;610;628;2020
41;Sevilla;036;Coronil, El;4717;2363;2354;2020
41;Sevilla;037;Corrales, Los;3938;2013;1925;2020
41;Sevilla;903;Cuervo de Sevilla, El;8656;4347;4309;2020
41;Sevilla;038;Dos Hermanas;135050;66330;68720;2020
41;Sevilla;039;Écija;39893;19685;20208;2020
41;Sevilla;040;Espartinas;15824;7921;7903;2020
41;Sevilla;041;Estepa;12497;6213;6284;2020
41;Sevilla;042;Fuentes de Andalucía;7152;3562;3590;2020
41;Sevilla;043;Garrobo, El;782;397;385;2020
41;Sevilla;044;Gelves;10193;5063;5130;2020
41;Sevilla;045;Gerena;7674;3839;3835;2020
41;Sevilla;046;Gilena;3727;1873;1854;2020
41;Sevilla;047;Gines;13428;6618;6810;2020
41;Sevilla;048;Guadalcanal;2608;1316;1292;2020
41;Sevilla;049;Guillena;12903;6483;6420;2020
41;Sevilla;050;Herrera;6464;3210;3254;2020
41;Sevilla;051;Huévar del Aljarafe;3060;1568;1492;2020
41;Sevilla;902;Isla Mayor;5825;2897;2928;2020
41;Sevilla;052;Lantejuela;3846;1964;1882;2020
41;Sevilla;053;Lebrija;27578;13732;13846;2020
41;Sevilla;054;Lora de Estepa;873;440;433;2020
41;Sevilla;055;Lora del Río;18630;9212;9418;2020
41;Sevilla;056;Luisiana, La;4578;2313;2265;2020
41;Sevilla;057;Madroño, El;287;147;140;2020
41;Sevilla;058;Mairena del Alcor;23698;11862;11836;2020
41;Sevilla;059;Mairena del Aljarafe;46555;22632;23923;2020
41;Sevilla;060;Marchena;19329;9619;9710;2020
41;Sevilla;061;Marinaleda;2592;1320;1272;2020
41;Sevilla;062;Martín de la Jara;2665;1369;1296;2020
41;Sevilla;063;Molares, Los;3518;1794;1724;2020
41;Sevilla;064;Montellano;7053;3529;3524;2020
41;Sevilla;065;Morón de la Frontera;27633;13606;14027;2020
41;Sevilla;066;Navas de la Concepción, Las;1542;767;775;2020
41;Sevilla;067;Olivares;9466;4722;4744;2020
41;Sevilla;068;Osuna;17621;8751;8870;2020
41;Sevilla;069;Palacios y Villafranca, Los;38548;19323;19225;2020
41;Sevilla;904;Palmar de Troya, El;2343;1169;1174;2020
41;Sevilla;070;Palomares del Río;8843;4431;4412;2020
41;Sevilla;071;Paradas;6857;3410;3447;2020
41;Sevilla;072;Pedrera;5158;2561;2597;2020
41;Sevilla;073;Pedroso, El;2009;994;1015;2020
41;Sevilla;074;Peñaflor;3639;1829;1810;2020
41;Sevilla;075;Pilas;13952;6992;6960;2020
41;Sevilla;076;Pruna;2605;1325;1280;2020
41;Sevilla;077;Puebla de Cazalla, La;10932;5456;5476;2020
41;Sevilla;078;Puebla de los Infantes, La;2980;1475;1505;2020
41;Sevilla;079;Puebla del Río, La;11920;5880;6040;2020
41;Sevilla;080;Real de la Jara, El;1494;738;756;2020
41;Sevilla;081;Rinconada, La;39062;19299;19763;2020
41;Sevilla;082;Roda de Andalucía, La;4175;2065;2110;2020
41;Sevilla;083;Ronquillo, El;1377;687;690;2020
41;Sevilla;084;Rubio, El;3369;1681;1688;2020
41;Sevilla;085;Salteras;5564;2695;2869;2020
41;Sevilla;086;San Juan de Aznalfarache;21774;10480;11294;2020
41;Sevilla;088;San Nicolás del Puerto;596;311;285;2020
41;Sevilla;087;Sanlúcar la Mayor;13943;6887;7056;2020
41;Sevilla;089;Santiponce;8538;4244;4294;2020
41;Sevilla;090;Saucejo, El;4235;2099;2136;2020
41;Sevilla;091;Sevilla;691395;328013;363382;2020
41;Sevilla;092;Tocina;9486;4709;4777;2020
41;Sevilla;093;Tomares;25455;12579;12876;2020
41;Sevilla;094;Umbrete;9000;4503;4497;2020
41;Sevilla;095;Utrera;50962;25173;25789;2020
41;Sevilla;096;Valencina de la Concepción;7776;3801;3975;2020
41;Sevilla;097;Villamanrique de la Condesa;4477;2201;2276;2020
41;Sevilla;100;Villanueva de San Juan;1090;535;555;2020
41;Sevilla;098;Villanueva del Ariscal;6591;3201;3390;2020
41;Sevilla;099;Villanueva del Río y Minas;4847;2448;2399;2020
41;Sevilla;101;Villaverde del Río;7842;3959;3883;2020
41;Sevilla;102;Viso del Alcor, El;19324;9651;9673;2020
42;Soria;001;Abejar;286;151;135;2020
42;Soria;003;Adradas;59;32;27;2020
42;Soria;004;Ágreda;3026;1553;1473;2020
42;Soria;006;Alconaba;179;116;63;2020
42;Soria;007;Alcubilla de Avellaneda;105;58;47;2020
42;Soria;008;Alcubilla de las Peñas;52;31;21;2020
42;Soria;009;Aldealafuente;88;51;37;2020
42;Soria;010;Aldealices;35;22;13;2020
42;Soria;011;Aldealpozo;15;7;8;2020
42;Soria;012;Aldealseñor;29;16;13;2020
42;Soria;013;Aldehuela de Periáñez;32;19;13;2020
42;Soria;014;Aldehuelas, Las;60;33;27;2020
42;Soria;015;Alentisque;30;19;11;2020
42;Soria;016;Aliud;20;15;5;2020
42;Soria;017;Almajano;191;99;92;2020
42;Soria;018;Almaluez;130;75;55;2020
42;Soria;019;Almarza;602;345;257;2020
42;Soria;020;Almazán;5477;2785;2692;2020
42;Soria;021;Almazul;62;40;22;2020
42;Soria;022;Almenar de Soria;232;136;96;2020
42;Soria;023;Alpanseque;56;34;22;2020
42;Soria;024;Arancón;84;56;28;2020
42;Soria;025;Arcos de Jalón;1454;750;704;2020
42;Soria;026;Arenillas;47;26;21;2020
42;Soria;027;Arévalo de la Sierra;76;48;28;2020
42;Soria;028;Ausejo de la Sierra;87;48;39;2020
42;Soria;029;Baraona;133;74;59;2020
42;Soria;030;Barca;103;65;38;2020
42;Soria;031;Barcones;20;13;7;2020
42;Soria;032;Bayubas de Abajo;141;77;64;2020
42;Soria;033;Bayubas de Arriba;53;32;21;2020
42;Soria;034;Beratón;38;19;19;2020
42;Soria;035;Berlanga de Duero;842;438;404;2020
42;Soria;036;Blacos;44;22;22;2020
42;Soria;037;Bliecos;31;19;12;2020
42;Soria;038;Borjabad;33;20;13;2020
42;Soria;039;Borobia;246;136;110;2020
42;Soria;041;Buberos;31;16;15;2020
42;Soria;042;Buitrago;69;38;31;2020
42;Soria;043;Burgo de Osma-Ciudad de Osma;5038;2526;2512;2020
42;Soria;044;Cabrejas del Campo;51;32;19;2020
42;Soria;045;Cabrejas del Pinar;352;202;150;2020
42;Soria;046;Calatañazor;51;29;22;2020
42;Soria;048;Caltojar;56;39;17;2020
42;Soria;049;Candilichera;108;64;44;2020
42;Soria;050;Cañamaque;34;23;11;2020
42;Soria;051;Carabantes;14;7;7;2020
42;Soria;052;Caracena;14;10;4;2020
42;Soria;053;Carrascosa de Abajo;20;13;7;2020
42;Soria;054;Carrascosa de la Sierra;17;12;5;2020
42;Soria;055;Casarejos;161;84;77;2020
42;Soria;056;Castilfrío de la Sierra;37;24;13;2020
42;Soria;058;Castillejo de Robledo;101;59;42;2020
42;Soria;057;Castilruiz;161;84;77;2020
42;Soria;059;Centenera de Andaluz;19;10;9;2020
42;Soria;060;Cerbón;27;18;9;2020
42;Soria;061;Cidones;300;182;118;2020
42;Soria;062;Cigudosa;21;14;7;2020
42;Soria;063;Cihuela;48;27;21;2020
42;Soria;064;Ciria;79;41;38;2020
42;Soria;065;Cirujales del Río;22;16;6;2020
42;Soria;068;Coscurita;77;49;28;2020
42;Soria;069;Covaleda;1644;848;796;2020
42;Soria;070;Cubilla;31;18;13;2020
42;Soria;071;Cubo de la Solana;181;104;77;2020
42;Soria;073;Cueva de Ágreda;71;44;27;2020
42;Soria;075;Dévanos;78;42;36;2020
42;Soria;076;Deza;217;113;104;2020
42;Soria;078;Duruelo de la Sierra;1088;560;528;2020
42;Soria;079;Escobosa de Almazán;20;13;7;2020
42;Soria;080;Espeja de San Marcelino;150;89;61;2020
42;Soria;081;Espejón;147;78;69;2020
42;Soria;082;Estepa de San Juan;9;6;3;2020
42;Soria;083;Frechilla de Almazán;23;12;11;2020
42;Soria;084;Fresno de Caracena;20;14;6;2020
42;Soria;085;Fuentearmegil;171;98;73;2020
42;Soria;086;Fuentecambrón;32;19;13;2020
42;Soria;087;Fuentecantos;63;32;31;2020
42;Soria;088;Fuentelmonge;66;37;29;2020
42;Soria;089;Fuentelsaz de Soria;61;32;29;2020
42;Soria;090;Fuentepinilla;82;52;30;2020
42;Soria;092;Fuentes de Magaña;59;36;23;2020
42;Soria;093;Fuentestrún;44;30;14;2020
42;Soria;094;Garray;721;385;336;2020
42;Soria;095;Golmayo;2778;1438;1340;2020
42;Soria;096;Gómara;294;159;135;2020
42;Soria;097;Gormaz;20;15;5;2020
42;Soria;098;Herrera de Soria;9;7;2;2020
42;Soria;100;Hinojosa del Campo;29;20;9;2020
42;Soria;103;Langa de Duero;683;365;318;2020
42;Soria;105;Liceras;47;23;24;2020
42;Soria;106;Losilla, La;13;9;4;2020
42;Soria;107;Magaña;68;38;30;2020
42;Soria;108;Maján;9;6;3;2020
42;Soria;110;Matalebreras;67;44;23;2020
42;Soria;111;Matamala de Almazán;283;157;126;2020
42;Soria;113;Medinaceli;682;347;335;2020
42;Soria;115;Miño de Medinaceli;87;53;34;2020
42;Soria;116;Miño de San Esteban;38;27;11;2020
42;Soria;117;Molinos de Duero;158;82;76;2020
42;Soria;118;Momblona;18;14;4;2020
42;Soria;119;Monteagudo de las Vicarías;176;89;87;2020
42;Soria;120;Montejo de Tiermes;151;95;56;2020
42;Soria;121;Montenegro de Cameros;54;36;18;2020
42;Soria;123;Morón de Almazán;194;102;92;2020
42;Soria;124;Muriel de la Fuente;58;35;23;2020
42;Soria;125;Muriel Viejo;79;50;29;2020
42;Soria;127;Nafría de Ucero;33;19;14;2020
42;Soria;128;Narros;46;26;20;2020
42;Soria;129;Navaleno;768;405;363;2020
42;Soria;130;Nepas;52;36;16;2020
42;Soria;131;Nolay;55;30;25;2020
42;Soria;132;Noviercas;154;90;64;2020
42;Soria;134;Ólvega;3675;1890;1785;2020
42;Soria;135;Oncala;71;42;29;2020
42;Soria;139;Pinilla del Campo;21;12;9;2020
42;Soria;140;Portillo de Soria;15;10;5;2020
42;Soria;141;Póveda de Soria, La;104;62;42;2020
42;Soria;142;Pozalmuro;50;26;24;2020
42;Soria;144;Quintana Redonda;492;277;215;2020
42;Soria;145;Quintanas de Gormaz;142;86;56;2020
42;Soria;148;Quiñonería;9;5;4;2020
42;Soria;149;Rábanos, Los;445;252;193;2020
42;Soria;151;Rebollar;42;20;22;2020
42;Soria;152;Recuerda;71;42;29;2020
42;Soria;153;Rello;15;9;6;2020
42;Soria;154;Renieblas;103;65;38;2020
42;Soria;155;Retortillo de Soria;156;90;66;2020
42;Soria;156;Reznos;33;22;11;2020
42;Soria;157;Riba de Escalote, La;11;7;4;2020
42;Soria;158;Rioseco de Soria;124;74;50;2020
42;Soria;159;Rollamienta;40;27;13;2020
42;Soria;160;Royo, El;272;146;126;2020
42;Soria;161;Salduero;152;80;72;2020
42;Soria;162;San Esteban de Gormaz;2956;1562;1394;2020
42;Soria;163;San Felices;53;33;20;2020
42;Soria;164;San Leonardo de Yagüe;2054;1048;1006;2020
42;Soria;165;San Pedro Manrique;623;347;276;2020
42;Soria;166;Santa Cruz de Yanguas;65;38;27;2020
42;Soria;167;Santa María de Huerta;260;145;115;2020
42;Soria;168;Santa María de las Hoyas;94;56;38;2020
42;Soria;171;Serón de Nágima;128;72;56;2020
42;Soria;172;Soliedra;31;17;14;2020
42;Soria;173;Soria;39821;18788;21033;2020
42;Soria;174;Sotillo del Rincón;176;92;84;2020
42;Soria;175;Suellacabras;24;14;10;2020
42;Soria;176;Tajahuerce;26;14;12;2020
42;Soria;177;Tajueco;58;34;24;2020
42;Soria;178;Talveila;96;57;39;2020
42;Soria;181;Tardelcuende;414;215;199;2020
42;Soria;182;Taroda;47;27;20;2020
42;Soria;183;Tejado;101;57;44;2020
42;Soria;184;Torlengua;56;33;23;2020
42;Soria;185;Torreblacos;24;12;12;2020
42;Soria;187;Torrubia de Soria;64;45;19;2020
42;Soria;188;Trévago;45;20;25;2020
42;Soria;189;Ucero;50;26;24;2020
42;Soria;190;Vadillo;89;46;43;2020
42;Soria;191;Valdeavellano de Tera;202;111;91;2020
42;Soria;192;Valdegeña;34;26;8;2020
42;Soria;193;Valdelagua del Cerro;14;9;5;2020
42;Soria;194;Valdemaluque;147;67;80;2020
42;Soria;195;Valdenebro;94;53;41;2020
42;Soria;196;Valdeprado;7;4;3;2020
42;Soria;197;Valderrodilla;68;36;32;2020
42;Soria;198;Valtajeros;18;12;6;2020
42;Soria;200;Velamazán;73;47;26;2020
42;Soria;201;Velilla de la Sierra;24;14;10;2020
42;Soria;202;Velilla de los Ajos;19;11;8;2020
42;Soria;204;Viana de Duero;54;38;16;2020
42;Soria;205;Villaciervos;79;47;32;2020
42;Soria;206;Villanueva de Gormaz;8;6;2;2020
42;Soria;207;Villar del Ala;49;26;23;2020
42;Soria;208;Villar del Campo;22;14;8;2020
42;Soria;209;Villar del Río;144;86;58;2020
42;Soria;211;Villares de Soria, Los;88;48;40;2020
42;Soria;212;Villasayas;66;43;23;2020
42;Soria;213;Villaseca de Arciel;27;17;10;2020
42;Soria;215;Vinuesa;847;453;394;2020
42;Soria;216;Vizmanos;29;18;11;2020
42;Soria;217;Vozmediano;38;24;14;2020
42;Soria;218;Yanguas;103;70;33;2020
42;Soria;219;Yelo;45;27;18;2020
43;Tarragona;001;Aiguamúrcia;930;483;447;2020
43;Tarragona;002;Albinyana;2468;1273;1195;2020
43;Tarragona;003;Albiol, L';500;272;228;2020
43;Tarragona;004;Alcanar;9434;4782;4652;2020
43;Tarragona;005;Alcover;5144;2555;2589;2020
43;Tarragona;904;Aldea, L';4147;2197;1950;2020
43;Tarragona;006;Aldover;905;457;448;2020
43;Tarragona;007;Aleixar, L';893;458;435;2020
43;Tarragona;008;Alfara de Carles;376;201;175;2020
43;Tarragona;009;Alforja;1783;919;864;2020
43;Tarragona;010;Alió;458;219;239;2020
43;Tarragona;011;Almoster;1341;674;667;2020
43;Tarragona;012;Altafulla;5307;2579;2728;2020
43;Tarragona;013;Ametlla de Mar, L';6866;3492;3374;2020
43;Tarragona;906;Ampolla, L';3277;1683;1594;2020
43;Tarragona;014;Amposta;21115;10675;10440;2020
43;Tarragona;016;Arboç, L';5609;2881;2728;2020
43;Tarragona;015;Arbolí;127;74;53;2020
43;Tarragona;017;Argentera, L';117;66;51;2020
43;Tarragona;018;Arnes;444;219;225;2020
43;Tarragona;019;Ascó;1644;844;800;2020
43;Tarragona;020;Banyeres del Penedès;3207;1625;1582;2020
43;Tarragona;021;Barberà de la Conca;471;260;211;2020
43;Tarragona;022;Batea;1901;949;952;2020
43;Tarragona;023;Bellmunt del Priorat;273;142;131;2020
43;Tarragona;024;Bellvei;2237;1162;1075;2020
43;Tarragona;025;Benifallet;723;336;387;2020
43;Tarragona;026;Benissanet;1140;630;510;2020
43;Tarragona;027;Bisbal de Falset, La;211;116;95;2020
43;Tarragona;028;Bisbal del Penedès, La;3631;1918;1713;2020
43;Tarragona;029;Blancafort;382;200;182;2020
43;Tarragona;030;Bonastre;685;359;326;2020
43;Tarragona;031;Borges del Camp, Les;2056;1053;1003;2020
43;Tarragona;032;Bot;554;284;270;2020
43;Tarragona;033;Botarell;1077;552;525;2020
43;Tarragona;034;Bràfim;695;355;340;2020
43;Tarragona;035;Cabacés;302;162;140;2020
43;Tarragona;036;Cabra del Camp;1175;613;562;2020
43;Tarragona;037;Calafell;27601;13887;13714;2020
43;Tarragona;903;Camarles;3194;1617;1577;2020
43;Tarragona;038;Cambrils;34734;16990;17744;2020
43;Tarragona;907;Canonja, La;5956;2912;3044;2020
43;Tarragona;039;Capafonts;111;58;53;2020
43;Tarragona;040;Capçanes;392;197;195;2020
43;Tarragona;041;Caseres;237;117;120;2020
43;Tarragona;042;Castellvell del Camp;2828;1417;1411;2020
43;Tarragona;043;Catllar, El;4557;2366;2191;2020
43;Tarragona;045;Colldejou;168;93;75;2020
43;Tarragona;046;Conesa;100;50;50;2020
43;Tarragona;047;Constantí;6665;3445;3220;2020
43;Tarragona;048;Corbera d'Ebre;1003;529;474;2020
43;Tarragona;049;Cornudella de Montsant;944;501;443;2020
43;Tarragona;050;Creixell;3758;1895;1863;2020
43;Tarragona;051;Cunit;13533;6650;6883;2020
43;Tarragona;901;Deltebre;11578;5849;5729;2020
43;Tarragona;053;Duesaigües;244;138;106;2020
43;Tarragona;054;Espluga de Francolí, L';3736;1830;1906;2020
43;Tarragona;055;Falset;2735;1359;1376;2020
43;Tarragona;056;Fatarella, La;926;451;475;2020
43;Tarragona;057;Febró, La;40;25;15;2020
43;Tarragona;058;Figuera, La;114;62;52;2020
43;Tarragona;059;Figuerola del Camp;329;164;165;2020
43;Tarragona;060;Flix;3410;1723;1687;2020
43;Tarragona;061;Forès;43;26;17;2020
43;Tarragona;062;Freginals;385;206;179;2020
43;Tarragona;063;Galera, La;736;382;354;2020
43;Tarragona;064;Gandesa;3096;1589;1507;2020
43;Tarragona;065;Garcia;527;259;268;2020
43;Tarragona;066;Garidells, Els;190;96;94;2020
43;Tarragona;067;Ginestar;764;407;357;2020
43;Tarragona;068;Godall;598;296;302;2020
43;Tarragona;069;Gratallops;237;128;109;2020
43;Tarragona;070;Guiamets, Els;278;133;145;2020
43;Tarragona;071;Horta de Sant Joan;1146;599;547;2020
43;Tarragona;072;Lloar, El;105;56;49;2020
43;Tarragona;073;Llorac;91;48;43;2020
43;Tarragona;074;Llorenç del Penedès;2395;1180;1215;2020
43;Tarragona;076;Marçà;600;312;288;2020
43;Tarragona;075;Margalef;106;63;43;2020
43;Tarragona;077;Mas de Barberans;564;281;283;2020
43;Tarragona;078;Masdenverge;1071;546;525;2020
43;Tarragona;079;Masllorenç;505;274;231;2020
43;Tarragona;080;Masó, La;280;148;132;2020
43;Tarragona;081;Maspujols;823;421;402;2020
43;Tarragona;082;Masroig, El;492;273;219;2020
43;Tarragona;083;Milà, El;190;91;99;2020
43;Tarragona;084;Miravet;706;375;331;2020
43;Tarragona;085;Molar, El;291;155;136;2020
43;Tarragona;086;Montblanc;7379;3742;3637;2020
43;Tarragona;088;Montbrió del Camp;2909;1499;1410;2020
43;Tarragona;089;Montferri;403;210;193;2020
43;Tarragona;090;Montmell, El;1582;842;740;2020
43;Tarragona;091;Mont-ral;168;99;69;2020
43;Tarragona;092;Mont-roig del Camp;12460;6423;6037;2020
43;Tarragona;093;Móra d'Ebre;5695;2874;2821;2020
43;Tarragona;094;Móra la Nova;3108;1567;1541;2020
43;Tarragona;095;Morell, El;3742;1917;1825;2020
43;Tarragona;096;Morera de Montsant, La;159;87;72;2020
43;Tarragona;097;Nou de Gaià, La;600;294;306;2020
43;Tarragona;098;Nulles;509;274;235;2020
43;Tarragona;100;Pallaresos, Els;4850;2423;2427;2020
43;Tarragona;099;Palma d'Ebre, La;338;165;173;2020
43;Tarragona;101;Passanant i Belltall;155;94;61;2020
43;Tarragona;102;Paüls;545;273;272;2020
43;Tarragona;103;Perafort;1264;659;605;2020
43;Tarragona;104;Perelló, El;2826;1442;1384;2020
43;Tarragona;105;Piles, Les;210;114;96;2020
43;Tarragona;106;Pinell de Brai, El;1008;513;495;2020
43;Tarragona;107;Pira;503;270;233;2020
43;Tarragona;108;Pla de Santa Maria, El;2348;1229;1119;2020
43;Tarragona;109;Pobla de Mafumet, La;3971;2017;1954;2020
43;Tarragona;110;Pobla de Massaluca, La;317;180;137;2020
43;Tarragona;111;Pobla de Montornès, La;2884;1503;1381;2020
43;Tarragona;112;Poboleda;321;166;155;2020
43;Tarragona;113;Pont d'Armentera, El;488;249;239;2020
43;Tarragona;141;Pontils;122;66;56;2020
43;Tarragona;114;Porrera;424;223;201;2020
43;Tarragona;115;Pradell de la Teixeta;158;74;84;2020
43;Tarragona;116;Prades;588;311;277;2020
43;Tarragona;117;Prat de Comte;177;97;80;2020
43;Tarragona;118;Pratdip;726;388;338;2020
43;Tarragona;119;Puigpelat;1163;604;559;2020
43;Tarragona;120;Querol;518;285;233;2020
43;Tarragona;121;Rasquera;783;388;395;2020
43;Tarragona;122;Renau;162;85;77;2020
43;Tarragona;123;Reus;106168;51335;54833;2020
43;Tarragona;124;Riba, La;585;319;266;2020
43;Tarragona;125;Riba-roja d'Ebre;1110;583;527;2020
43;Tarragona;126;Riera de Gaià, La;1742;874;868;2020
43;Tarragona;127;Riudecanyes;1146;611;535;2020
43;Tarragona;128;Riudecols;1189;617;572;2020
43;Tarragona;129;Riudoms;6569;3352;3217;2020
43;Tarragona;130;Rocafort de Queralt;211;114;97;2020
43;Tarragona;131;Roda de Berà;6785;3463;3322;2020
43;Tarragona;132;Rodonyà;494;265;229;2020
43;Tarragona;133;Roquetes;8079;4170;3909;2020
43;Tarragona;134;Rourell, El;372;193;179;2020
43;Tarragona;135;Salomó;549;286;263;2020
43;Tarragona;905;Salou;28526;14736;13790;2020
43;Tarragona;136;Sant Carles de la Ràpita;14953;7316;7637;2020
43;Tarragona;137;Sant Jaume dels Domenys;2624;1348;1276;2020
43;Tarragona;902;Sant Jaume d'Enveja;3527;1781;1746;2020
43;Tarragona;138;Santa Bàrbara;3715;1886;1829;2020
43;Tarragona;139;Santa Coloma de Queralt;2672;1341;1331;2020
43;Tarragona;140;Santa Oliva;3353;1714;1639;2020
43;Tarragona;142;Sarral;1538;798;740;2020
43;Tarragona;143;Savallà del Comtat;53;26;27;2020
43;Tarragona;144;Secuita, La;1708;859;849;2020
43;Tarragona;145;Selva del Camp, La;5683;2867;2816;2020
43;Tarragona;146;Senan;44;30;14;2020
43;Tarragona;044;Sénia, La;5640;2839;2801;2020
43;Tarragona;147;Solivella;632;333;299;2020
43;Tarragona;148;Tarragona;136496;66666;69830;2020
43;Tarragona;149;Tivenys;902;457;445;2020
43;Tarragona;150;Tivissa;1619;812;807;2020
43;Tarragona;151;Torre de Fontaubella, La;131;69;62;2020
43;Tarragona;152;Torre de l'Espanyol, La;601;308;293;2020
43;Tarragona;153;Torredembarra;16567;8134;8433;2020
43;Tarragona;154;Torroja del Priorat;152;85;67;2020
43;Tarragona;155;Tortosa;33439;16594;16845;2020
43;Tarragona;156;Ulldecona;6525;3494;3031;2020
43;Tarragona;157;Ulldemolins;398;226;172;2020
43;Tarragona;158;Vallclara;88;52;36;2020
43;Tarragona;159;Vallfogona de Riucorb;77;47;30;2020
43;Tarragona;160;Vallmoll;1774;890;884;2020
43;Tarragona;161;Valls;24477;12286;12191;2020
43;Tarragona;162;Vandellòs i l'Hospitalet de l'Infant;6603;3304;3299;2020
43;Tarragona;163;Vendrell, El;38373;19052;19321;2020
43;Tarragona;164;Vespella de Gaià;417;230;187;2020
43;Tarragona;165;Vilabella;729;373;356;2020
43;Tarragona;175;Vilalba dels Arcs;621;313;308;2020
43;Tarragona;166;Vilallonga del Camp;2405;1223;1182;2020
43;Tarragona;168;Vilanova de Prades;107;56;51;2020
43;Tarragona;167;Vilanova d'Escornalbou;565;296;269;2020
43;Tarragona;169;Vilaplana;555;297;258;2020
43;Tarragona;170;Vila-rodona;1276;677;599;2020
43;Tarragona;171;Vila-seca;22555;11317;11238;2020
43;Tarragona;172;Vilaverd;443;237;206;2020
43;Tarragona;173;Vilella Alta, La;133;72;61;2020
43;Tarragona;174;Vilella Baixa, La;204;110;94;2020
43;Tarragona;176;Vimbodí i Poblet;890;478;412;2020
43;Tarragona;177;Vinebre;425;215;210;2020
43;Tarragona;178;Vinyols i els Arcs;2124;1113;1011;2020
43;Tarragona;052;Xerta;1154;569;585;2020
44;Teruel;001;Ababuj;77;46;31;2020
44;Teruel;002;Abejuela;50;31;19;2020
44;Teruel;003;Aguatón;19;7;12;2020
44;Teruel;004;Aguaviva;516;250;266;2020
44;Teruel;005;Aguilar del Alfambra;69;40;29;2020
44;Teruel;006;Alacón;238;124;114;2020
44;Teruel;007;Alba;165;93;72;2020
44;Teruel;008;Albalate del Arzobispo;1972;1007;965;2020
44;Teruel;009;Albarracín;1006;514;492;2020
44;Teruel;010;Albentosa;289;156;133;2020
44;Teruel;011;Alcaine;53;34;19;2020
44;Teruel;012;Alcalá de la Selva;331;179;152;2020
44;Teruel;013;Alcañiz;16006;7953;8053;2020
44;Teruel;014;Alcorisa;3298;1678;1620;2020
44;Teruel;016;Alfambra;482;251;231;2020
44;Teruel;017;Aliaga;326;180;146;2020
44;Teruel;021;Allepuz;124;63;61;2020
44;Teruel;022;Alloza;572;300;272;2020
44;Teruel;023;Allueva;24;16;8;2020
44;Teruel;018;Almohaja;14;10;4;2020
44;Teruel;019;Alobras;64;40;24;2020
44;Teruel;020;Alpeñés;21;13;8;2020
44;Teruel;024;Anadón;32;20;12;2020
44;Teruel;025;Andorra;7345;3686;3659;2020
44;Teruel;026;Arcos de las Salinas;118;70;48;2020
44;Teruel;027;Arens de Lledó;205;105;100;2020
44;Teruel;028;Argente;193;96;97;2020
44;Teruel;029;Ariño;714;363;351;2020
44;Teruel;031;Azaila;93;48;45;2020
44;Teruel;032;Bádenas;19;12;7;2020
44;Teruel;033;Báguena;285;155;130;2020
44;Teruel;034;Bañón;146;82;64;2020
44;Teruel;035;Barrachina;109;58;51;2020
44;Teruel;036;Bea;29;18;11;2020
44;Teruel;037;Beceite;531;273;258;2020
44;Teruel;039;Bello;219;110;109;2020
44;Teruel;038;Belmonte de San José;123;58;65;2020
44;Teruel;040;Berge;241;118;123;2020
44;Teruel;041;Bezas;67;43;24;2020
44;Teruel;042;Blancas;125;74;51;2020
44;Teruel;043;Blesa;92;59;33;2020
44;Teruel;044;Bordón;105;58;47;2020
44;Teruel;045;Bronchales;417;236;181;2020
44;Teruel;046;Bueña;49;26;23;2020
44;Teruel;047;Burbáguena;211;113;98;2020
44;Teruel;048;Cabra de Mora;51;33;18;2020
44;Teruel;049;Calaceite;978;483;495;2020
44;Teruel;050;Calamocha;4429;2192;2237;2020
44;Teruel;051;Calanda;3822;1905;1917;2020
44;Teruel;052;Calomarde;74;44;30;2020
44;Teruel;053;Camañas;133;77;56;2020
44;Teruel;054;Camarena de la Sierra;107;67;40;2020
44;Teruel;055;Camarillas;92;57;35;2020
44;Teruel;056;Caminreal;615;320;295;2020
44;Teruel;059;Cantavieja;729;386;343;2020
44;Teruel;060;Cañada de Benatanduz;33;21;12;2020
44;Teruel;061;Cañada de Verich, La;92;55;37;2020
44;Teruel;062;Cañada Vellida;36;24;12;2020
44;Teruel;063;Cañizar del Olivar;100;57;43;2020
44;Teruel;064;Cascante del Río;67;41;26;2020
44;Teruel;065;Castejón de Tornos;55;36;19;2020
44;Teruel;066;Castel de Cabra;93;52;41;2020
44;Teruel;070;Castellar, El;55;37;18;2020
44;Teruel;071;Castellote;676;341;335;2020
44;Teruel;067;Castelnou;134;69;65;2020
44;Teruel;068;Castelserás;800;423;377;2020
44;Teruel;074;Cedrillas;639;312;327;2020
44;Teruel;075;Celadas;367;210;157;2020
44;Teruel;076;Cella;2571;1321;1250;2020
44;Teruel;077;Cerollera, La;88;56;32;2020
44;Teruel;080;Codoñera, La;319;168;151;2020
44;Teruel;082;Corbalán;109;58;51;2020
44;Teruel;084;Cortes de Aragón;60;28;32;2020
44;Teruel;085;Cosa;51;32;19;2020
44;Teruel;086;Cretas;554;281;273;2020
44;Teruel;087;Crivillén;86;47;39;2020
44;Teruel;088;Cuba, La;43;26;17;2020
44;Teruel;089;Cubla;55;37;18;2020
44;Teruel;090;Cucalón;78;49;29;2020
44;Teruel;092;Cuervo, El;80;42;38;2020
44;Teruel;093;Cuevas de Almudén;118;64;54;2020
44;Teruel;094;Cuevas Labradas;137;73;64;2020
44;Teruel;096;Ejulve;177;93;84;2020
44;Teruel;097;Escorihuela;136;67;69;2020
44;Teruel;099;Escucha;801;427;374;2020
44;Teruel;100;Estercuel;205;111;94;2020
44;Teruel;101;Ferreruela de Huerva;64;37;27;2020
44;Teruel;102;Fonfría;26;15;11;2020
44;Teruel;103;Formiche Alto;148;81;67;2020
44;Teruel;105;Fórnoles;74;40;34;2020
44;Teruel;106;Fortanete;202;118;84;2020
44;Teruel;107;Foz-Calanda;258;131;127;2020
44;Teruel;108;Fresneda, La;443;243;200;2020
44;Teruel;109;Frías de Albarracín;104;64;40;2020
44;Teruel;110;Fuenferrada;36;22;14;2020
44;Teruel;111;Fuentes Calientes;91;52;39;2020
44;Teruel;112;Fuentes Claras;445;242;203;2020
44;Teruel;113;Fuentes de Rubielos;124;66;58;2020
44;Teruel;114;Fuentespalda;282;144;138;2020
44;Teruel;115;Galve;160;84;76;2020
44;Teruel;116;Gargallo;97;52;45;2020
44;Teruel;117;Gea de Albarracín;370;203;167;2020
44;Teruel;118;Ginebrosa, La;197;111;86;2020
44;Teruel;119;Griegos;138;84;54;2020
44;Teruel;120;Guadalaviar;244;135;109;2020
44;Teruel;121;Gúdar;77;47;30;2020
44;Teruel;122;Híjar;1754;883;871;2020
44;Teruel;123;Hinojosa de Jarque;112;63;49;2020
44;Teruel;124;Hoz de la Vieja, La;81;44;37;2020
44;Teruel;125;Huesa del Común;69;42;27;2020
44;Teruel;126;Iglesuela del Cid, La;402;211;191;2020
44;Teruel;127;Jabaloyas;59;36;23;2020
44;Teruel;128;Jarque de la Val;62;32;30;2020
44;Teruel;129;Jatiel;39;26;13;2020
44;Teruel;130;Jorcas;29;17;12;2020
44;Teruel;131;Josa;34;21;13;2020
44;Teruel;132;Lagueruela;69;38;31;2020
44;Teruel;133;Lanzuela;22;16;6;2020
44;Teruel;135;Libros;100;63;37;2020
44;Teruel;136;Lidón;54;30;24;2020
44;Teruel;137;Linares de Mora;225;130;95;2020
44;Teruel;141;Lledó;155;78;77;2020
44;Teruel;138;Loscos;125;73;52;2020
44;Teruel;142;Maicas;31;19;12;2020
44;Teruel;143;Manzanera;516;281;235;2020
44;Teruel;144;Martín del Río;387;186;201;2020
44;Teruel;145;Mas de las Matas;1258;661;597;2020
44;Teruel;146;Mata de los Olmos, La;261;132;129;2020
44;Teruel;147;Mazaleón;511;273;238;2020
44;Teruel;148;Mezquita de Jarque;89;51;38;2020
44;Teruel;149;Mirambel;116;69;47;2020
44;Teruel;150;Miravete de la Sierra;38;28;10;2020
44;Teruel;151;Molinos;222;116;106;2020
44;Teruel;152;Monforte de Moyuela;71;49;22;2020
44;Teruel;153;Monreal del Campo;2487;1243;1244;2020
44;Teruel;154;Monroyo;332;194;138;2020
44;Teruel;155;Montalbán;1245;630;615;2020
44;Teruel;156;Monteagudo del Castillo;49;27;22;2020
44;Teruel;157;Monterde de Albarracín;56;34;22;2020
44;Teruel;158;Mora de Rubielos;1512;750;762;2020
44;Teruel;159;Moscardón;55;31;24;2020
44;Teruel;160;Mosqueruela;532;291;241;2020
44;Teruel;161;Muniesa;583;311;272;2020
44;Teruel;163;Noguera de Albarracín;139;80;59;2020
44;Teruel;164;Nogueras;21;15;6;2020
44;Teruel;165;Nogueruelas;210;117;93;2020
44;Teruel;167;Obón;34;16;18;2020
44;Teruel;168;Odón;203;105;98;2020
44;Teruel;169;Ojos Negros;341;188;153;2020
44;Teruel;171;Olba;233;125;108;2020
44;Teruel;172;Oliete;343;182;161;2020
44;Teruel;173;Olmos, Los;118;62;56;2020
44;Teruel;174;Orihuela del Tremedal;450;247;203;2020
44;Teruel;175;Orrios;128;70;58;2020
44;Teruel;176;Palomar de Arroyos;170;102;68;2020
44;Teruel;177;Pancrudo;119;68;51;2020
44;Teruel;178;Parras de Castellote, Las;55;31;24;2020
44;Teruel;179;Peñarroya de Tastavins;446;241;205;2020
44;Teruel;180;Peracense;77;42;35;2020
44;Teruel;181;Peralejos;83;48;35;2020
44;Teruel;182;Perales del Alfambra;236;128;108;2020
44;Teruel;183;Pitarque;68;36;32;2020
44;Teruel;184;Plou;50;31;19;2020
44;Teruel;185;Pobo, El;108;70;38;2020
44;Teruel;187;Portellada, La;236;120;116;2020
44;Teruel;189;Pozondón;43;25;18;2020
44;Teruel;190;Pozuel del Campo;63;34;29;2020
44;Teruel;191;Puebla de Híjar, La;899;455;444;2020
44;Teruel;192;Puebla de Valverde, La;451;250;201;2020
44;Teruel;193;Puertomingalvo;117;58;59;2020
44;Teruel;194;Ráfales;139;83;56;2020
44;Teruel;195;Rillo;85;51;34;2020
44;Teruel;196;Riodeva;134;63;71;2020
44;Teruel;197;Ródenas;62;34;28;2020
44;Teruel;198;Royuela;210;116;94;2020
44;Teruel;199;Rubiales;49;28;21;2020
44;Teruel;200;Rubielos de la Cérida;39;25;14;2020
44;Teruel;201;Rubielos de Mora;635;328;307;2020
44;Teruel;203;Salcedillo;11;7;4;2020
44;Teruel;204;Saldón;24;15;9;2020
44;Teruel;205;Samper de Calanda;721;369;352;2020
44;Teruel;206;San Agustín;123;74;49;2020
44;Teruel;207;San Martín del Río;132;68;64;2020
44;Teruel;208;Santa Cruz de Nogueras;30;13;17;2020
44;Teruel;209;Santa Eulalia;1050;540;510;2020
44;Teruel;210;Sarrión;1148;598;550;2020
44;Teruel;211;Segura de los Baños;41;26;15;2020
44;Teruel;212;Seno;39;17;22;2020
44;Teruel;213;Singra;83;48;35;2020
44;Teruel;215;Terriente;180;97;83;2020
44;Teruel;216;Teruel;36240;17287;18953;2020
44;Teruel;217;Toril y Masegoso;33;26;7;2020
44;Teruel;218;Tormón;25;15;10;2020
44;Teruel;219;Tornos;202;104;98;2020
44;Teruel;220;Torralba de los Sisones;157;85;72;2020
44;Teruel;223;Torre de Arcas;94;46;48;2020
44;Teruel;224;Torre de las Arcas;29;16;13;2020
44;Teruel;225;Torre del Compte;117;57;60;2020
44;Teruel;227;Torre los Negros;83;42;41;2020
44;Teruel;221;Torrecilla de Alcañiz;439;225;214;2020
44;Teruel;222;Torrecilla del Rebollar;123;82;41;2020
44;Teruel;226;Torrelacárcel;143;79;64;2020
44;Teruel;228;Torremocha de Jiloca;107;59;48;2020
44;Teruel;229;Torres de Albarracín;185;105;80;2020
44;Teruel;230;Torrevelilla;170;88;82;2020
44;Teruel;231;Torrijas;43;19;24;2020
44;Teruel;232;Torrijo del Campo;447;234;213;2020
44;Teruel;234;Tramacastiel;67;39;28;2020
44;Teruel;235;Tramacastilla;104;51;53;2020
44;Teruel;236;Tronchón;68;34;34;2020
44;Teruel;237;Urrea de Gaén;427;212;215;2020
44;Teruel;238;Utrillas;3006;1548;1458;2020
44;Teruel;239;Valacloche;20;11;9;2020
44;Teruel;240;Valbona;172;98;74;2020
44;Teruel;241;Valdealgorfa;595;294;301;2020
44;Teruel;243;Valdecuenca;32;18;14;2020
44;Teruel;244;Valdelinares;92;57;35;2020
44;Teruel;245;Valdeltormo;281;134;147;2020
44;Teruel;246;Valderrobres;2435;1242;1193;2020
44;Teruel;247;Valjunquera;338;174;164;2020
44;Teruel;249;Vallecillo, El;44;26;18;2020
44;Teruel;250;Veguillas de la Sierra;21;13;8;2020
44;Teruel;251;Villafranca del Campo;285;153;132;2020
44;Teruel;252;Villahermosa del Campo;83;53;30;2020
44;Teruel;256;Villanueva del Rebollar de la Sierra;42;26;16;2020
44;Teruel;257;Villar del Cobo;160;96;64;2020
44;Teruel;258;Villar del Salz;61;37;24;2020
44;Teruel;260;Villarluengo;171;101;70;2020
44;Teruel;261;Villarquemado;841;442;399;2020
44;Teruel;262;Villarroya de los Pinares;161;85;76;2020
44;Teruel;263;Villastar;507;251;256;2020
44;Teruel;264;Villel;333;183;150;2020
44;Teruel;265;Vinaceite;231;125;106;2020
44;Teruel;266;Visiedo;131;64;67;2020
44;Teruel;267;Vivel del Río Martín;72;37;35;2020
44;Teruel;268;Zoma, La;32;18;14;2020
45;Toledo;001;Ajofrín;2259;1133;1126;2020
45;Toledo;002;Alameda de la Sagra;3734;1948;1786;2020
45;Toledo;003;Albarreal de Tajo;679;348;331;2020
45;Toledo;004;Alcabón;664;341;323;2020
45;Toledo;005;Alcañizo;274;140;134;2020
45;Toledo;006;Alcaudete de la Jara;1660;843;817;2020
45;Toledo;007;Alcolea de Tajo;807;403;404;2020
45;Toledo;008;Aldea en Cabo;168;85;83;2020
45;Toledo;009;Aldeanueva de Barbarroya;501;256;245;2020
45;Toledo;010;Aldeanueva de San Bartolomé;414;209;205;2020
45;Toledo;011;Almendral de la Cañada;323;166;157;2020
45;Toledo;012;Almonacid de Toledo;810;392;418;2020
45;Toledo;013;Almorox;2170;1132;1038;2020
45;Toledo;014;Añover de Tajo;5176;2628;2548;2020
45;Toledo;015;Arcicóllar;908;443;465;2020
45;Toledo;016;Argés;6563;3273;3290;2020
45;Toledo;017;Azután;290;145;145;2020
45;Toledo;018;Barcience;883;479;404;2020
45;Toledo;019;Bargas;10535;5246;5289;2020
45;Toledo;020;Belvís de la Jara;1535;768;767;2020
45;Toledo;021;Borox;3958;2076;1882;2020
45;Toledo;022;Buenaventura;423;211;212;2020
45;Toledo;023;Burguillos de Toledo;3288;1699;1589;2020
45;Toledo;024;Burujón;1307;666;641;2020
45;Toledo;025;Cabañas de la Sagra;1857;963;894;2020
45;Toledo;026;Cabañas de Yepes;260;136;124;2020
45;Toledo;027;Cabezamesada;343;189;154;2020
45;Toledo;028;Calera y Chozas;4608;2324;2284;2020
45;Toledo;029;Caleruela;209;102;107;2020
45;Toledo;030;Calzada de Oropesa;523;285;238;2020
45;Toledo;031;Camarena;4082;2129;1953;2020
45;Toledo;032;Camarenilla;577;292;285;2020
45;Toledo;033;Campillo de la Jara, El;342;182;160;2020
45;Toledo;034;Camuñas;1752;905;847;2020
45;Toledo;035;Cardiel de los Montes;352;187;165;2020
45;Toledo;036;Carmena;768;386;382;2020
45;Toledo;037;Carpio de Tajo, El;1816;914;902;2020
45;Toledo;038;Carranque;4953;2581;2372;2020
45;Toledo;039;Carriches;260;135;125;2020
45;Toledo;040;Casar de Escalona, El;1718;923;795;2020
45;Toledo;041;Casarrubios del Monte;5995;3138;2857;2020
45;Toledo;042;Casasbuenas;187;93;94;2020
45;Toledo;043;Castillo de Bayuela;920;453;467;2020
45;Toledo;045;Cazalegas;1813;936;877;2020
45;Toledo;046;Cebolla;3209;1601;1608;2020
45;Toledo;047;Cedillo del Condado;3826;1978;1848;2020
45;Toledo;048;Cerralbos, Los;414;227;187;2020
45;Toledo;049;Cervera de los Montes;499;254;245;2020
45;Toledo;056;Chozas de Canales;4104;2145;1959;2020
45;Toledo;057;Chueca;251;131;120;2020
45;Toledo;050;Ciruelos;569;309;260;2020
45;Toledo;051;Cobeja;2366;1245;1121;2020
45;Toledo;052;Cobisa;4306;2168;2138;2020
45;Toledo;053;Consuegra;9970;5050;4920;2020
45;Toledo;054;Corral de Almaguer;5246;2712;2534;2020
45;Toledo;055;Cuerva;1299;675;624;2020
45;Toledo;058;Domingo Pérez;345;177;168;2020
45;Toledo;059;Dosbarrios;2260;1156;1104;2020
45;Toledo;060;Erustes;189;98;91;2020
45;Toledo;061;Escalona;3276;1701;1575;2020
45;Toledo;062;Escalonilla;1420;700;720;2020
45;Toledo;063;Espinoso del Rey;425;242;183;2020
45;Toledo;064;Esquivias;5628;2873;2755;2020
45;Toledo;065;Estrella, La;215;115;100;2020
45;Toledo;066;Fuensalida;11655;5901;5754;2020
45;Toledo;067;Gálvez;3012;1502;1510;2020
45;Toledo;068;Garciotum;202;104;98;2020
45;Toledo;069;Gerindote;2339;1175;1164;2020
45;Toledo;070;Guadamur;1784;891;893;2020
45;Toledo;071;Guardia, La;2213;1118;1095;2020
45;Toledo;072;Herencias, Las;772;415;357;2020
45;Toledo;073;Herreruela de Oropesa;327;167;160;2020
45;Toledo;074;Hinojosa de San Vicente;381;213;168;2020
45;Toledo;075;Hontanar;136;79;57;2020
45;Toledo;076;Hormigos;712;400;312;2020
45;Toledo;077;Huecas;722;379;343;2020
45;Toledo;078;Huerta de Valdecarábanos;1683;839;844;2020
45;Toledo;079;Iglesuela del Tiétar, La;424;224;200;2020
45;Toledo;080;Illán de Vacas;3;3;0;2020
45;Toledo;081;Illescas;29558;14901;14657;2020
45;Toledo;082;Lagartera;1354;678;676;2020
45;Toledo;083;Layos;777;375;402;2020
45;Toledo;084;Lillo;2561;1328;1233;2020
45;Toledo;085;Lominchar;2475;1292;1183;2020
45;Toledo;086;Lucillos;563;299;264;2020
45;Toledo;087;Madridejos;10334;5147;5187;2020
45;Toledo;088;Magán;3731;1880;1851;2020
45;Toledo;089;Malpica de Tajo;1680;869;811;2020
45;Toledo;090;Manzaneque;390;190;200;2020
45;Toledo;091;Maqueda;443;217;226;2020
45;Toledo;092;Marjaliza;243;123;120;2020
45;Toledo;093;Marrupe;149;75;74;2020
45;Toledo;094;Mascaraque;425;213;212;2020
45;Toledo;095;Mata, La;817;407;410;2020
45;Toledo;096;Mazarambroz;1244;642;602;2020
45;Toledo;097;Mejorada;1261;646;615;2020
45;Toledo;098;Menasalbas;2600;1372;1228;2020
45;Toledo;099;Méntrida;5320;2729;2591;2020
45;Toledo;100;Mesegar de Tajo;215;114;101;2020
45;Toledo;101;Miguel Esteban;4788;2411;2377;2020
45;Toledo;102;Mocejón;4963;2488;2475;2020
45;Toledo;103;Mohedas de la Jara;400;222;178;2020
45;Toledo;104;Montearagón;518;274;244;2020
45;Toledo;105;Montesclaros;393;208;185;2020
45;Toledo;106;Mora;9819;4918;4901;2020
45;Toledo;107;Nambroca;4862;2498;2364;2020
45;Toledo;108;Nava de Ricomalillo, La;519;274;245;2020
45;Toledo;109;Navahermosa;3564;1849;1715;2020
45;Toledo;110;Navalcán;1955;1025;930;2020
45;Toledo;111;Navalmoralejo;58;30;28;2020
45;Toledo;112;Navalmorales, Los;2420;1273;1147;2020
45;Toledo;113;Navalucillos, Los;2050;1051;999;2020
45;Toledo;114;Navamorcuende;598;299;299;2020
45;Toledo;115;Noblejas;3652;1848;1804;2020
45;Toledo;116;Noez;861;434;427;2020
45;Toledo;117;Nombela;854;454;400;2020
45;Toledo;118;Novés;3019;1550;1469;2020
45;Toledo;119;Numancia de la Sagra;4985;2624;2361;2020
45;Toledo;120;Nuño Gómez;125;70;55;2020
45;Toledo;121;Ocaña;12437;6262;6175;2020
45;Toledo;122;Olías del Rey;8120;4140;3980;2020
45;Toledo;123;Ontígola;4540;2414;2126;2020
45;Toledo;124;Orgaz;2605;1303;1302;2020
45;Toledo;125;Oropesa;2626;1260;1366;2020
45;Toledo;126;Otero;315;165;150;2020
45;Toledo;127;Palomeque;1011;541;470;2020
45;Toledo;128;Pantoja;3394;1705;1689;2020
45;Toledo;129;Paredes de Escalona;112;60;52;2020
45;Toledo;130;Parrillas;338;178;160;2020
45;Toledo;131;Pelahustán;304;173;131;2020
45;Toledo;132;Pepino;3128;1602;1526;2020
45;Toledo;133;Polán;3872;1933;1939;2020
45;Toledo;134;Portillo de Toledo;2231;1134;1097;2020
45;Toledo;135;Puebla de Almoradiel, La;5073;2574;2499;2020
45;Toledo;136;Puebla de Montalbán, La;7858;3969;3889;2020
45;Toledo;137;Pueblanueva, La;2142;1079;1063;2020
45;Toledo;138;Puente del Arzobispo, El;1225;606;619;2020
45;Toledo;139;Puerto de San Vicente;148;80;68;2020
45;Toledo;140;Pulgar;1491;762;729;2020
45;Toledo;141;Quero;980;500;480;2020
45;Toledo;142;Quintanar de la Orden;11148;5536;5612;2020
45;Toledo;143;Quismondo;1564;791;773;2020
45;Toledo;144;Real de San Vicente, El;919;494;425;2020
45;Toledo;145;Recas;4504;2482;2022;2020
45;Toledo;146;Retamoso de la Jara;103;55;48;2020
45;Toledo;147;Rielves;749;382;367;2020
45;Toledo;148;Robledo del Mazo;261;148;113;2020
45;Toledo;149;Romeral, El;582;294;288;2020
45;Toledo;150;San Bartolomé de las Abiertas;437;229;208;2020
45;Toledo;151;San Martín de Montalbán;726;369;357;2020
45;Toledo;152;San Martín de Pusa;629;337;292;2020
45;Toledo;153;San Pablo de los Montes;1743;874;869;2020
45;Toledo;154;San Román de los Montes;1921;1001;920;2020
45;Toledo;155;Santa Ana de Pusa;350;203;147;2020
45;Toledo;156;Santa Cruz de la Zarza;4089;2084;2005;2020
45;Toledo;157;Santa Cruz del Retamar;3302;1736;1566;2020
45;Toledo;158;Santa Olalla;3279;1666;1613;2020
45;Toledo;901;Santo Domingo-Caudilla;1046;553;493;2020
45;Toledo;159;Sartajada;94;57;37;2020
45;Toledo;160;Segurilla;1349;684;665;2020
45;Toledo;161;Seseña;27066;13905;13161;2020
45;Toledo;162;Sevilleja de la Jara;668;364;304;2020
45;Toledo;163;Sonseca;11082;5613;5469;2020
45;Toledo;164;Sotillo de las Palomas;175;91;84;2020
45;Toledo;165;Talavera de la Reina;83663;40156;43507;2020
45;Toledo;166;Tembleque;1966;989;977;2020
45;Toledo;167;Toboso, El;1741;873;868;2020
45;Toledo;168;Toledo;85811;40941;44870;2020
45;Toledo;169;Torralba de Oropesa;197;108;89;2020
45;Toledo;171;Torre de Esteban Hambrán, La;1670;839;831;2020
45;Toledo;170;Torrecilla de la Jara;207;111;96;2020
45;Toledo;172;Torrico;698;353;345;2020
45;Toledo;173;Torrijos;13684;6711;6973;2020
45;Toledo;174;Totanés;355;178;177;2020
45;Toledo;175;Turleque;736;368;368;2020
45;Toledo;176;Ugena;5467;2830;2637;2020
45;Toledo;177;Urda;2477;1239;1238;2020
45;Toledo;179;Valdeverdeja;549;276;273;2020
45;Toledo;180;Valmojado;4371;2216;2155;2020
45;Toledo;181;Velada;2903;1493;1410;2020
45;Toledo;182;Ventas con Peña Aguilera, Las;1062;535;527;2020
45;Toledo;183;Ventas de Retamosa, Las;3510;1852;1658;2020
45;Toledo;184;Ventas de San Julián, Las;233;109;124;2020
45;Toledo;186;Villa de Don Fadrique, La;3623;1800;1823;2020
45;Toledo;185;Villacañas;9489;4716;4773;2020
45;Toledo;187;Villafranca de los Caballeros;4876;2426;2450;2020
45;Toledo;188;Villaluenga de la Sagra;3887;1960;1927;2020
45;Toledo;189;Villamiel de Toledo;926;481;445;2020
45;Toledo;190;Villaminaya;537;271;266;2020
45;Toledo;191;Villamuelas;606;319;287;2020
45;Toledo;192;Villanueva de Alcardete;3172;1639;1533;2020
45;Toledo;193;Villanueva de Bogas;699;361;338;2020
45;Toledo;194;Villarejo de Montalbán;71;39;32;2020
45;Toledo;195;Villarrubia de Santiago;2514;1263;1251;2020
45;Toledo;196;Villaseca de la Sagra;1851;930;921;2020
45;Toledo;197;Villasequilla;2522;1300;1222;2020
45;Toledo;198;Villatobas;2482;1267;1215;2020
45;Toledo;199;Viso de San Juan, El;4828;2574;2254;2020
45;Toledo;200;Yébenes, Los;5882;3001;2881;2020
45;Toledo;201;Yeles;5555;2930;2625;2020
45;Toledo;202;Yepes;5288;2718;2570;2020
45;Toledo;203;Yuncler;4098;2105;1993;2020
45;Toledo;204;Yunclillos;795;411;384;2020
45;Toledo;205;Yuncos;11646;5925;5721;2020
46;Valencia/València;001;Ademuz;1037;558;479;2020
46;Valencia/València;002;Ador;1730;919;811;2020
46;Valencia/València;004;Agullent;2388;1186;1202;2020
46;Valencia/València;042;Aielo de Malferit;4625;2326;2299;2020
46;Valencia/València;043;Aielo de Rugat;160;88;72;2020
46;Valencia/València;005;Alaquàs;29711;14560;15151;2020
46;Valencia/València;006;Albaida;5914;2916;2998;2020
46;Valencia/València;007;Albal;16577;8293;8284;2020
46;Valencia/València;008;Albalat de la Ribera;3326;1676;1650;2020
46;Valencia/València;009;Albalat dels Sorells;4036;1970;2066;2020
46;Valencia/València;010;Albalat dels Tarongers;1208;640;568;2020
46;Valencia/València;011;Alberic;10519;5209;5310;2020
46;Valencia/València;012;Alborache;1229;639;590;2020
46;Valencia/València;013;Alboraia/Alboraya;24741;12112;12629;2020
46;Valencia/València;014;Albuixech;4151;2020;2131;2020
46;Valencia/València;016;Alcàntera de Xúquer;1341;672;669;2020
46;Valencia/València;015;Alcàsser;10196;5118;5078;2020
46;Valencia/València;018;Alcublas;611;330;281;2020
46;Valencia/València;020;Alcúdia de Crespins, l';5113;2534;2579;2020
46;Valencia/València;019;Alcúdia, l';12107;5936;6171;2020
46;Valencia/València;021;Aldaia;32204;16059;16145;2020
46;Valencia/València;022;Alfafar;21395;10473;10922;2020
46;Valencia/València;024;Alfara de la Baronia;569;283;286;2020
46;Valencia/València;025;Alfara del Patriarca;3282;1577;1705;2020
46;Valencia/València;026;Alfarp;1571;809;762;2020
46;Valencia/València;027;Alfarrasí;1219;607;612;2020
46;Valencia/València;023;Alfauir;449;234;215;2020
46;Valencia/València;028;Algar de Palancia;491;260;231;2020
46;Valencia/València;029;Algemesí;27430;13624;13806;2020
46;Valencia/València;030;Algímia d'Alfara;1053;524;529;2020
46;Valencia/València;031;Alginet;13827;6979;6848;2020
46;Valencia/València;032;Almàssera;7438;3610;3828;2020
46;Valencia/València;033;Almiserà;265;136;129;2020
46;Valencia/València;034;Almoines;2477;1249;1228;2020
46;Valencia/València;035;Almussafes;8979;4472;4507;2020
46;Valencia/València;036;Alpuente;635;344;291;2020
46;Valencia/València;037;Alqueria de la Comtessa, l';1496;721;775;2020
46;Valencia/València;017;Alzira;44938;21946;22992;2020
46;Valencia/València;038;Andilla;308;194;114;2020
46;Valencia/València;039;Anna;2615;1316;1299;2020
46;Valencia/València;040;Antella;1157;556;601;2020
46;Valencia/València;041;Aras de los Olmos;359;205;154;2020
46;Valencia/València;003;Atzeneta d'Albaida;1162;588;574;2020
46;Valencia/València;044;Ayora;5283;2600;2683;2020
46;Valencia/València;046;Barx;1303;675;628;2020
46;Valencia/València;045;Barxeta;1586;808;778;2020
46;Valencia/València;047;Bèlgida;679;333;346;2020
46;Valencia/València;048;Bellreguard;4618;2300;2318;2020
46;Valencia/València;049;Bellús;299;157;142;2020
46;Valencia/València;050;Benagéber;180;104;76;2020
46;Valencia/València;051;Benaguasil;11256;5780;5476;2020
46;Valencia/València;052;Benavites;638;302;336;2020
46;Valencia/València;053;Beneixida;627;311;316;2020
46;Valencia/València;054;Benetússer;15000;7301;7699;2020
46;Valencia/València;055;Beniarjó;1767;885;882;2020
46;Valencia/València;056;Beniatjar;219;115;104;2020
46;Valencia/València;057;Benicolet;574;280;294;2020
46;Valencia/València;904;Benicull de Xúquer;1048;524;524;2020
46;Valencia/València;060;Benifaió;11989;5925;6064;2020
46;Valencia/València;059;Benifairó de la Valldigna;1558;785;773;2020
46;Valencia/València;058;Benifairó de les Valls;2213;1109;1104;2020
46;Valencia/València;061;Beniflá;460;232;228;2020
46;Valencia/València;062;Benigànim;5779;2946;2833;2020
46;Valencia/València;063;Benimodo;2272;1150;1122;2020
46;Valencia/València;064;Benimuslem;667;355;312;2020
46;Valencia/València;065;Beniparrell;2015;1015;1000;2020
46;Valencia/València;066;Benirredrà;1555;752;803;2020
46;Valencia/València;067;Benissanó;2291;1140;1151;2020
46;Valencia/València;068;Benissoda;432;237;195;2020
46;Valencia/València;069;Benissuera;185;89;96;2020
46;Valencia/València;070;Bétera;24604;12244;12360;2020
46;Valencia/València;071;Bicorp;529;256;273;2020
46;Valencia/València;072;Bocairent;4142;2090;2052;2020
46;Valencia/València;073;Bolbaite;1324;675;649;2020
46;Valencia/València;074;Bonrepòs i Mirambell;3738;1841;1897;2020
46;Valencia/València;075;Bufali;156;87;69;2020
46;Valencia/València;076;Bugarra;739;373;366;2020
46;Valencia/València;077;Buñol;9498;4748;4750;2020
46;Valencia/València;078;Burjassot;38632;18641;19991;2020
46;Valencia/València;079;Calles;355;205;150;2020
46;Valencia/València;080;Camporrobles;1198;613;585;2020
46;Valencia/València;081;Canals;13516;6776;6740;2020
46;Valencia/València;082;Canet d'En Berenguer;6765;3429;3336;2020
46;Valencia/València;083;Carcaixent;20436;10131;10305;2020
46;Valencia/València;084;Càrcer;1827;873;954;2020
46;Valencia/València;085;Carlet;15740;7858;7882;2020
46;Valencia/València;086;Carrícola;99;51;48;2020
46;Valencia/València;087;Casas Altas;131;72;59;2020
46;Valencia/València;088;Casas Bajas;163;87;76;2020
46;Valencia/València;089;Casinos;2780;1428;1352;2020
46;Valencia/València;090;Castelló de Rugat;2298;1178;1120;2020
46;Valencia/València;091;Castellonet de la Conquesta;141;78;63;2020
46;Valencia/València;092;Castielfabib;308;161;147;2020
46;Valencia/València;093;Catadau;2804;1399;1405;2020
46;Valencia/València;094;Catarroja;28608;14124;14484;2020
46;Valencia/València;095;Caudete de las Fuentes;711;376;335;2020
46;Valencia/València;096;Cerdà;331;179;152;2020
46;Valencia/València;107;Chella;2472;1231;1241;2020
46;Valencia/València;106;Chelva;1531;786;745;2020
46;Valencia/València;108;Chera;469;250;219;2020
46;Valencia/València;109;Cheste;8735;4461;4274;2020
46;Valencia/València;111;Chiva;15414;7874;7540;2020
46;Valencia/València;112;Chulilla;662;358;304;2020
46;Valencia/València;097;Cofrentes;1123;572;551;2020
46;Valencia/València;098;Corbera;3088;1547;1541;2020
46;Valencia/València;099;Cortes de Pallás;771;427;344;2020
46;Valencia/València;100;Cotes;333;172;161;2020
46;Valencia/València;105;Cullera;22521;11269;11252;2020
46;Valencia/València;113;Daimús;3196;1584;1612;2020
46;Valencia/València;114;Domeño;673;332;341;2020
46;Valencia/València;115;Dos Aguas;327;184;143;2020
46;Valencia/València;116;Eliana, l';18362;8963;9399;2020
46;Valencia/València;117;Emperador;688;350;338;2020
46;Valencia/València;118;Enguera;4777;2392;2385;2020
46;Valencia/València;119;Ènova, l';902;464;438;2020
46;Valencia/València;120;Estivella;1441;698;743;2020
46;Valencia/València;121;Estubeny;125;63;62;2020
46;Valencia/València;122;Faura;3553;1788;1765;2020
46;Valencia/València;123;Favara;2504;1280;1224;2020
46;Valencia/València;126;Foios;7452;3677;3775;2020
46;Valencia/València;128;Font de la Figuera, la;2027;1020;1007;2020
46;Valencia/València;127;Font d'En Carròs, la;3778;1880;1898;2020
46;Valencia/València;124;Fontanars dels Alforins;959;500;459;2020
46;Valencia/València;125;Fortaleny;1020;503;517;2020
46;Valencia/València;129;Fuenterrobles;694;382;312;2020
46;Valencia/València;131;Gandia;75798;37242;38556;2020
46;Valencia/València;902;Gátova;405;194;211;2020
46;Valencia/València;130;Gavarda;1042;502;540;2020
46;Valencia/València;132;Genovés, el;2778;1397;1381;2020
46;Valencia/València;133;Gestalgar;548;293;255;2020
46;Valencia/València;134;Gilet;3404;1755;1649;2020
46;Valencia/València;135;Godella;13131;6299;6832;2020
46;Valencia/València;136;Godelleta;3584;1847;1737;2020
46;Valencia/València;137;Granja de la Costera, la;295;149;146;2020
46;Valencia/València;138;Guadasséquies;456;233;223;2020
46;Valencia/València;139;Guadassuar;5902;2866;3036;2020
46;Valencia/València;140;Guardamar de la Safor;531;281;250;2020
46;Valencia/València;141;Higueruelas;501;265;236;2020
46;Valencia/València;142;Jalance;834;433;401;2020
46;Valencia/València;144;Jarafuel;769;397;372;2020
46;Valencia/València;154;Llanera de Ranes;1047;533;514;2020
46;Valencia/València;155;Llaurí;1130;583;547;2020
46;Valencia/València;147;Llíria;23482;11841;11641;2020
46;Valencia/València;152;Llocnou de la Corona;124;66;58;2020
46;Valencia/València;153;Llocnou de Sant Jeroni;554;276;278;2020
46;Valencia/València;151;Llocnou d'En Fenollet;916;474;442;2020
46;Valencia/València;156;Llombai;2653;1322;1331;2020
46;Valencia/València;157;Llosa de Ranes, la;3642;1871;1771;2020
46;Valencia/València;150;Llutxent;2326;1188;1138;2020
46;Valencia/València;148;Loriguilla;2035;1050;985;2020
46;Valencia/València;149;Losa del Obispo;505;257;248;2020
46;Valencia/València;158;Macastre;1300;687;613;2020
46;Valencia/València;159;Manises;31240;15422;15818;2020
46;Valencia/València;160;Manuel;2436;1202;1234;2020
46;Valencia/València;161;Marines;1848;972;876;2020
46;Valencia/València;162;Massalavés;1610;844;766;2020
46;Valencia/València;163;Massalfassar;2555;1271;1284;2020
46;Valencia/València;164;Massamagrell;16163;8013;8150;2020
46;Valencia/València;165;Massanassa;9782;4840;4942;2020
46;Valencia/València;166;Meliana;10970;5376;5594;2020
46;Valencia/València;167;Millares;331;169;162;2020
46;Valencia/València;168;Miramar;2685;1371;1314;2020
46;Valencia/València;169;Mislata;44320;21499;22821;2020
46;Valencia/València;170;Mogente/Moixent;4307;2159;2148;2020
46;Valencia/València;171;Moncada;22021;10771;11250;2020
46;Valencia/València;173;Montaverner;1635;812;823;2020
46;Valencia/València;174;Montesa;1155;585;570;2020
46;Valencia/València;175;Montitxelvo/Montichelvo;585;293;292;2020
46;Valencia/València;176;Montroi/Montroy;2956;1568;1388;2020
46;Valencia/València;172;Montserrat;8188;4226;3962;2020
46;Valencia/València;177;Museros;6596;3362;3234;2020
46;Valencia/València;178;Nàquera/Náquera;6897;3561;3336;2020
46;Valencia/València;179;Navarrés;3004;1498;1506;2020
46;Valencia/València;180;Novelé/Novetlè;857;414;443;2020
46;Valencia/València;181;Oliva;25224;12390;12834;2020
46;Valencia/València;183;Olleria, l';8320;4174;4146;2020
46;Valencia/València;182;Olocau;1828;973;855;2020
46;Valencia/València;184;Ontinyent;35761;17658;18103;2020
46;Valencia/València;185;Otos;422;213;209;2020
46;Valencia/València;186;Paiporta;26514;13065;13449;2020
46;Valencia/València;187;Palma de Gandía;1709;886;823;2020
46;Valencia/València;188;Palmera;1018;515;503;2020
46;Valencia/València;189;Palomar, el;567;287;280;2020
46;Valencia/València;190;Paterna;71035;35129;35906;2020
46;Valencia/València;191;Pedralba;2814;1485;1329;2020
46;Valencia/València;192;Petrés;999;505;494;2020
46;Valencia/València;193;Picanya;11606;5733;5873;2020
46;Valencia/València;194;Picassent;21263;10697;10566;2020
46;Valencia/València;195;Piles;2740;1377;1363;2020
46;Valencia/València;196;Pinet;157;77;80;2020
46;Valencia/València;199;Pobla de Farnals, la;8128;4117;4011;2020
46;Valencia/València;202;Pobla de Vallbona, la;24858;12547;12311;2020
46;Valencia/València;200;Pobla del Duc, la;2515;1214;1301;2020
46;Valencia/València;203;Pobla Llarga, la;4452;2234;2218;2020
46;Valencia/València;197;Polinyà de Xúquer;2503;1268;1235;2020
46;Valencia/València;198;Potries;1060;544;516;2020
46;Valencia/València;205;Puçol;19737;9754;9983;2020
46;Valencia/València;201;Puebla de San Miguel;61;38;23;2020
46;Valencia/València;204;Puig de Santa Maria, el;8718;4248;4470;2020
46;Valencia/València;101;Quart de les Valls;1024;486;538;2020
46;Valencia/València;102;Quart de Poblet;25062;12219;12843;2020
46;Valencia/València;103;Quartell;1655;792;863;2020
46;Valencia/València;104;Quatretonda;2202;1094;1108;2020
46;Valencia/València;206;Quesa;663;344;319;2020
46;Valencia/València;207;Rafelbunyol;9149;4497;4652;2020
46;Valencia/València;208;Rafelcofer;1355;651;704;2020
46;Valencia/València;209;Rafelguaraf;2355;1163;1192;2020
46;Valencia/València;210;Ráfol de Salem;442;213;229;2020
46;Valencia/València;212;Real;2207;1150;1057;2020
46;Valencia/València;211;Real de Gandia, el;2531;1274;1257;2020
46;Valencia/València;213;Requena;20405;10184;10221;2020
46;Valencia/València;214;Riba-roja de Túria;22761;11541;11220;2020
46;Valencia/València;215;Riola;1790;900;890;2020
46;Valencia/València;216;Rocafort;7314;3566;3748;2020
46;Valencia/València;217;Rotglà i Corberà;1117;555;562;2020
46;Valencia/València;218;Rótova;1293;669;624;2020
46;Valencia/València;219;Rugat;174;93;81;2020
46;Valencia/València;220;Sagunto/Sagunt;67173;32919;34254;2020
46;Valencia/València;221;Salem;418;213;205;2020
46;Valencia/València;903;San Antonio de Benagéber;9286;4563;4723;2020
46;Valencia/València;222;Sant Joanet;507;255;252;2020
46;Valencia/València;223;Sedaví;10391;5065;5326;2020
46;Valencia/València;224;Segart;164;88;76;2020
46;Valencia/València;225;Sellent;384;195;189;2020
46;Valencia/València;226;Sempere;30;16;14;2020
46;Valencia/València;227;Senyera;1134;555;579;2020
46;Valencia/València;228;Serra;3187;1631;1556;2020
46;Valencia/València;229;Siete Aguas;1159;606;553;2020
46;Valencia/València;230;Silla;19078;9491;9587;2020
46;Valencia/València;231;Simat de la Valldigna;3297;1652;1645;2020
46;Valencia/València;232;Sinarcas;1105;579;526;2020
46;Valencia/València;233;Sollana;4881;2383;2498;2020
46;Valencia/València;234;Sot de Chera;362;203;159;2020
46;Valencia/València;235;Sueca;27566;13580;13986;2020
46;Valencia/València;236;Sumacàrcer;1097;542;555;2020
46;Valencia/València;237;Tavernes Blanques;9224;4483;4741;2020
46;Valencia/València;238;Tavernes de la Valldigna;17254;8591;8663;2020
46;Valencia/València;239;Teresa de Cofrentes;619;328;291;2020
46;Valencia/València;240;Terrateig;256;136;120;2020
46;Valencia/València;241;Titaguas;454;237;217;2020
46;Valencia/València;242;Torrebaja;402;225;177;2020
46;Valencia/València;243;Torrella;145;81;64;2020
46;Valencia/València;244;Torrent;83962;41367;42595;2020
46;Valencia/València;245;Torres Torres;669;360;309;2020
46;Valencia/València;246;Tous;1287;647;640;2020
46;Valencia/València;247;Tuéjar;1137;600;537;2020
46;Valencia/València;248;Turís;6722;3515;3207;2020
46;Valencia/València;249;Utiel;11458;5724;5734;2020
46;Valencia/València;250;València;800215;380293;419922;2020
46;Valencia/València;251;Vallada;3096;1561;1535;2020
46;Valencia/València;252;Vallanca;133;71;62;2020
46;Valencia/València;253;Vallés;154;82;72;2020
46;Valencia/València;254;Venta del Moro;1198;636;562;2020
46;Valencia/València;255;Vilallonga/Villalonga;4370;2138;2232;2020
46;Valencia/València;256;Vilamarxant;9891;5103;4788;2020
46;Valencia/València;257;Villanueva de Castellón;7054;3470;3584;2020
46;Valencia/València;258;Villar del Arzobispo;3536;1793;1743;2020
46;Valencia/València;259;Villargordo del Cabriel;582;296;286;2020
46;Valencia/València;260;Vinalesa;3412;1655;1757;2020
46;Valencia/València;145;Xàtiva;29623;14496;15127;2020
46;Valencia/València;143;Xeraco;5720;2871;2849;2020
46;Valencia/València;146;Xeresa;2197;1119;1078;2020
46;Valencia/València;110;Xirivella;30197;14963;15234;2020
46;Valencia/València;261;Yátova;2079;1072;1007;2020
46;Valencia/València;262;Yesa, La;221;118;103;2020
46;Valencia/València;263;Zarra;346;193;153;2020
47;Valladolid;001;Adalia;53;31;22;2020
47;Valladolid;002;Aguasal;18;12;6;2020
47;Valladolid;003;Aguilar de Campos;254;146;108;2020
47;Valladolid;004;Alaejos;1379;738;641;2020
47;Valladolid;005;Alcazarén;630;344;286;2020
47;Valladolid;006;Aldea de San Miguel;213;118;95;2020
47;Valladolid;007;Aldeamayor de San Martín;5634;2917;2717;2020
47;Valladolid;008;Almenara de Adaja;22;11;11;2020
47;Valladolid;009;Amusquillo;102;63;39;2020
47;Valladolid;010;Arroyo de la Encomienda;20537;10317;10220;2020
47;Valladolid;011;Ataquines;569;312;257;2020
47;Valladolid;012;Bahabón;103;49;54;2020
47;Valladolid;013;Barcial de la Loma;91;51;40;2020
47;Valladolid;014;Barruelo del Valle;48;30;18;2020
47;Valladolid;015;Becilla de Valderaduey;234;133;101;2020
47;Valladolid;016;Benafarces;69;36;33;2020
47;Valladolid;017;Bercero;196;108;88;2020
47;Valladolid;018;Berceruelo;35;22;13;2020
47;Valladolid;019;Berrueces;108;61;47;2020
47;Valladolid;020;Bobadilla del Campo;292;163;129;2020
47;Valladolid;021;Bocigas;90;48;42;2020
47;Valladolid;022;Bocos de Duero;72;36;36;2020
47;Valladolid;023;Boecillo;4148;2118;2030;2020
47;Valladolid;024;Bolaños de Campos;289;162;127;2020
47;Valladolid;025;Brahojos de Medina;116;60;56;2020
47;Valladolid;026;Bustillo de Chaves;65;36;29;2020
47;Valladolid;027;Cabezón de Pisuerga;3763;1915;1848;2020
47;Valladolid;028;Cabezón de Valderaduey;41;24;17;2020
47;Valladolid;029;Cabreros del Monte;66;36;30;2020
47;Valladolid;030;Campaspero;1060;595;465;2020
47;Valladolid;031;Campillo, El;213;124;89;2020
47;Valladolid;032;Camporredondo;149;86;63;2020
47;Valladolid;033;Canalejas de Peñafiel;238;132;106;2020
47;Valladolid;034;Canillas de Esgueva;75;43;32;2020
47;Valladolid;035;Carpio;994;535;459;2020
47;Valladolid;036;Casasola de Arión;250;141;109;2020
47;Valladolid;037;Castrejón de Trabancos;177;87;90;2020
47;Valladolid;038;Castrillo de Duero;109;63;46;2020
47;Valladolid;039;Castrillo-Tejeriego;163;89;74;2020
47;Valladolid;040;Castrobol;56;29;27;2020
47;Valladolid;041;Castrodeza;154;93;61;2020
47;Valladolid;042;Castromembibre;54;39;15;2020
47;Valladolid;043;Castromonte;318;171;147;2020
47;Valladolid;044;Castronuevo de Esgueva;370;199;171;2020
47;Valladolid;045;Castronuño;833;417;416;2020
47;Valladolid;046;Castroponce;138;76;62;2020
47;Valladolid;047;Castroverde de Cerrato;215;133;82;2020
47;Valladolid;048;Ceinos de Campos;210;112;98;2020
47;Valladolid;049;Cervillego de la Cruz;87;51;36;2020
47;Valladolid;050;Cigales;5328;2714;2614;2020
47;Valladolid;051;Ciguñuela;371;194;177;2020
47;Valladolid;052;Cistérniga;9016;4561;4455;2020
47;Valladolid;053;Cogeces de Íscar;136;66;70;2020
47;Valladolid;054;Cogeces del Monte;659;354;305;2020
47;Valladolid;055;Corcos;203;110;93;2020
47;Valladolid;056;Corrales de Duero;113;65;48;2020
47;Valladolid;057;Cubillas de Santa Marta;329;191;138;2020
47;Valladolid;058;Cuenca de Campos;215;112;103;2020
47;Valladolid;059;Curiel de Duero;118;76;42;2020
47;Valladolid;060;Encinas de Esgueva;231;136;95;2020
47;Valladolid;061;Esguevillas de Esgueva;265;147;118;2020
47;Valladolid;062;Fombellida;176;102;74;2020
47;Valladolid;063;Fompedraza;100;52;48;2020
47;Valladolid;064;Fontihoyuelo;39;23;16;2020
47;Valladolid;065;Fresno el Viejo;878;473;405;2020
47;Valladolid;066;Fuensaldaña;1954;1008;946;2020
47;Valladolid;067;Fuente el Sol;150;79;71;2020
47;Valladolid;068;Fuente-Olmedo;34;18;16;2020
47;Valladolid;069;Gallegos de Hornija;115;58;57;2020
47;Valladolid;070;Gatón de Campos;32;18;14;2020
47;Valladolid;071;Geria;506;240;266;2020
47;Valladolid;073;Herrín de Campos;122;64;58;2020
47;Valladolid;074;Hornillos de Eresma;166;96;70;2020
47;Valladolid;075;Íscar;6341;3191;3150;2020
47;Valladolid;076;Laguna de Duero;22765;11351;11414;2020
47;Valladolid;077;Langayo;250;157;93;2020
47;Valladolid;079;Llano de Olmedo;60;31;29;2020
47;Valladolid;078;Lomoviejo;178;96;82;2020
47;Valladolid;080;Manzanillo;54;26;28;2020
47;Valladolid;081;Marzales;43;21;22;2020
47;Valladolid;082;Matapozuelos;1033;523;510;2020
47;Valladolid;083;Matilla de los Caños;100;54;46;2020
47;Valladolid;084;Mayorga;1478;730;748;2020
47;Valladolid;086;Medina de Rioseco;4606;2272;2334;2020
47;Valladolid;085;Medina del Campo;20416;9947;10469;2020
47;Valladolid;087;Megeces;427;232;195;2020
47;Valladolid;088;Melgar de Abajo;114;63;51;2020
47;Valladolid;089;Melgar de Arriba;153;87;66;2020
47;Valladolid;090;Mojados;3258;1701;1557;2020
47;Valladolid;091;Monasterio de Vega;82;45;37;2020
47;Valladolid;092;Montealegre de Campos;110;65;45;2020
47;Valladolid;093;Montemayor de Pililla;857;465;392;2020
47;Valladolid;094;Moral de la Reina;148;83;65;2020
47;Valladolid;095;Moraleja de las Panaderas;43;23;20;2020
47;Valladolid;096;Morales de Campos;141;73;68;2020
47;Valladolid;097;Mota del Marqués;349;188;161;2020
47;Valladolid;098;Mucientes;653;328;325;2020
47;Valladolid;099;Mudarra, La;157;80;77;2020
47;Valladolid;100;Muriel;122;65;57;2020
47;Valladolid;101;Nava del Rey;1975;1014;961;2020
47;Valladolid;102;Nueva Villa de las Torres;272;157;115;2020
47;Valladolid;103;Olivares de Duero;296;165;131;2020
47;Valladolid;104;Olmedo;3646;1813;1833;2020
47;Valladolid;105;Olmos de Esgueva;185;102;83;2020
47;Valladolid;106;Olmos de Peñafiel;53;30;23;2020
47;Valladolid;109;Palazuelo de Vedija;179;93;86;2020
47;Valladolid;110;Parrilla, La;479;242;237;2020
47;Valladolid;111;Pedraja de Portillo, La;1126;576;550;2020
47;Valladolid;112;Pedrajas de San Esteban;3314;1690;1624;2020
47;Valladolid;113;Pedrosa del Rey;158;91;67;2020
47;Valladolid;114;Peñafiel;5054;2546;2508;2020
47;Valladolid;115;Peñaflor de Hornija;302;169;133;2020
47;Valladolid;116;Pesquera de Duero;442;241;201;2020
47;Valladolid;117;Piña de Esgueva;318;168;150;2020
47;Valladolid;118;Piñel de Abajo;159;88;71;2020
47;Valladolid;119;Piñel de Arriba;91;50;41;2020
47;Valladolid;121;Pollos;601;327;274;2020
47;Valladolid;122;Portillo;2373;1235;1138;2020
47;Valladolid;123;Pozal de Gallinas;547;299;248;2020
47;Valladolid;124;Pozaldez;478;256;222;2020
47;Valladolid;125;Pozuelo de la Orden;46;28;18;2020
47;Valladolid;126;Puras;43;24;19;2020
47;Valladolid;127;Quintanilla de Arriba;162;92;70;2020
47;Valladolid;129;Quintanilla de Onésimo;1026;544;482;2020
47;Valladolid;130;Quintanilla de Trigueros;101;50;51;2020
47;Valladolid;128;Quintanilla del Molar;61;30;31;2020
47;Valladolid;131;Rábano;174;90;84;2020
47;Valladolid;132;Ramiro;43;24;19;2020
47;Valladolid;133;Renedo de Esgueva;3814;1949;1865;2020
47;Valladolid;134;Roales de Campos;161;89;72;2020
47;Valladolid;135;Robladillo;91;54;37;2020
47;Valladolid;137;Roturas;28;17;11;2020
47;Valladolid;138;Rubí de Bracamonte;228;129;99;2020
47;Valladolid;139;Rueda;1237;645;592;2020
47;Valladolid;140;Saelices de Mayorga;108;66;42;2020
47;Valladolid;141;Salvador de Zapardiel;116;67;49;2020
47;Valladolid;142;San Cebrián de Mazote;129;77;52;2020
47;Valladolid;143;San Llorente;105;62;43;2020
47;Valladolid;144;San Martín de Valvení;81;45;36;2020
47;Valladolid;145;San Miguel del Arroyo;659;349;310;2020
47;Valladolid;146;San Miguel del Pino;344;175;169;2020
47;Valladolid;147;San Pablo de la Moraleja;112;63;49;2020
47;Valladolid;148;San Pedro de Latarce;476;257;219;2020
47;Valladolid;149;San Pelayo;50;26;24;2020
47;Valladolid;150;San Román de Hornija;307;145;162;2020
47;Valladolid;151;San Salvador;25;15;10;2020
47;Valladolid;156;San Vicente del Palacio;162;86;76;2020
47;Valladolid;152;Santa Eufemia del Arroyo;72;40;32;2020
47;Valladolid;153;Santervás de Campos;113;61;52;2020
47;Valladolid;154;Santibáñez de Valcorba;168;97;71;2020
47;Valladolid;155;Santovenia de Pisuerga;4604;2360;2244;2020
47;Valladolid;157;Sardón de Duero;579;309;270;2020
47;Valladolid;158;Seca, La;1059;546;513;2020
47;Valladolid;159;Serrada;1103;574;529;2020
47;Valladolid;160;Siete Iglesias de Trabancos;431;234;197;2020
47;Valladolid;161;Simancas;5267;2672;2595;2020
47;Valladolid;162;Tamariz de Campos;73;43;30;2020
47;Valladolid;163;Tiedra;287;139;148;2020
47;Valladolid;164;Tordehumos;411;218;193;2020
47;Valladolid;165;Tordesillas;8745;4412;4333;2020
47;Valladolid;169;Torre de Esgueva;65;34;31;2020
47;Valladolid;170;Torre de Peñafiel;48;29;19;2020
47;Valladolid;166;Torrecilla de la Abadesa;276;133;143;2020
47;Valladolid;167;Torrecilla de la Orden;248;123;125;2020
47;Valladolid;168;Torrecilla de la Torre;36;23;13;2020
47;Valladolid;171;Torrelobatón;400;211;189;2020
47;Valladolid;172;Torrescárcela;159;83;76;2020
47;Valladolid;173;Traspinedo;1111;589;522;2020
47;Valladolid;174;Trigueros del Valle;304;167;137;2020
47;Valladolid;175;Tudela de Duero;8620;4381;4239;2020
47;Valladolid;176;Unión de Campos, La;230;119;111;2020
47;Valladolid;177;Urones de Castroponce;110;66;44;2020
47;Valladolid;178;Urueña;189;106;83;2020
47;Valladolid;179;Valbuena de Duero;462;254;208;2020
47;Valladolid;180;Valdearcos de la Vega;55;30;25;2020
47;Valladolid;181;Valdenebro de los Valles;199;105;94;2020
47;Valladolid;182;Valdestillas;1632;845;787;2020
47;Valladolid;183;Valdunquillo;144;69;75;2020
47;Valladolid;186;Valladolid;299265;140247;159018;2020
47;Valladolid;184;Valoria la Buena;630;342;288;2020
47;Valladolid;185;Valverde de Campos;91;55;36;2020
47;Valladolid;187;Vega de Ruiponce;89;55;34;2020
47;Valladolid;188;Vega de Valdetronco;118;64;54;2020
47;Valladolid;189;Velascálvaro;165;92;73;2020
47;Valladolid;190;Velilla;114;57;57;2020
47;Valladolid;191;Velliza;112;74;38;2020
47;Valladolid;192;Ventosa de la Cuesta;96;57;39;2020
47;Valladolid;193;Viana de Cega;2062;1071;991;2020
47;Valladolid;195;Villabáñez;489;272;217;2020
47;Valladolid;196;Villabaruz de Campos;30;14;16;2020
47;Valladolid;197;Villabrágima;1053;553;500;2020
47;Valladolid;198;Villacarralón;74;45;29;2020
47;Valladolid;199;Villacid de Campos;72;45;27;2020
47;Valladolid;200;Villaco;74;49;25;2020
47;Valladolid;203;Villafrades de Campos;62;33;29;2020
47;Valladolid;204;Villafranca de Duero;267;137;130;2020
47;Valladolid;205;Villafrechós;480;263;217;2020
47;Valladolid;206;Villafuerte;85;47;38;2020
47;Valladolid;207;Villagarcía de Campos;300;179;121;2020
47;Valladolid;208;Villagómez la Nueva;64;34;30;2020
47;Valladolid;209;Villalán de Campos;32;20;12;2020
47;Valladolid;210;Villalar de los Comuneros;468;225;243;2020
47;Valladolid;211;Villalba de la Loma;50;26;24;2020
47;Valladolid;212;Villalba de los Alcores;368;200;168;2020
47;Valladolid;213;Villalbarba;115;55;60;2020
47;Valladolid;214;Villalón de Campos;1561;776;785;2020
47;Valladolid;215;Villamuriel de Campos;49;25;24;2020
47;Valladolid;216;Villán de Tordesillas;117;67;50;2020
47;Valladolid;217;Villanubla;2769;1420;1349;2020
47;Valladolid;218;Villanueva de Duero;1189;623;566;2020
47;Valladolid;219;Villanueva de la Condesa;56;29;27;2020
47;Valladolid;220;Villanueva de los Caballeros;180;94;86;2020
47;Valladolid;221;Villanueva de los Infantes;99;59;40;2020
47;Valladolid;222;Villanueva de San Mancio;82;45;37;2020
47;Valladolid;223;Villardefrades;162;90;72;2020
47;Valladolid;224;Villarmentero de Esgueva;106;58;48;2020
47;Valladolid;225;Villasexmir;72;42;30;2020
47;Valladolid;226;Villavaquerín;161;89;72;2020
47;Valladolid;227;Villavellid;50;32;18;2020
47;Valladolid;228;Villaverde de Medina;513;278;235;2020
47;Valladolid;229;Villavicencio de los Caballeros;233;116;117;2020
47;Valladolid;194;Viloria;339;178;161;2020
47;Valladolid;230;Wamba;310;167;143;2020
47;Valladolid;231;Zaratán;6235;3193;3042;2020
47;Valladolid;232;Zarza, La;110;60;50;2020
49;Zamora;002;Abezames;59;30;29;2020
49;Zamora;003;Alcañices;1065;560;505;2020
49;Zamora;004;Alcubilla de Nogales;115;63;52;2020
49;Zamora;005;Alfaraz de Sayago;125;74;51;2020
49;Zamora;006;Algodre;141;77;64;2020
49;Zamora;007;Almaraz de Duero;401;208;193;2020
49;Zamora;008;Almeida de Sayago;437;237;200;2020
49;Zamora;009;Andavías;452;227;225;2020
49;Zamora;010;Arcenillas;428;220;208;2020
49;Zamora;011;Arcos de la Polvorosa;217;119;98;2020
49;Zamora;012;Argañín;73;38;35;2020
49;Zamora;013;Argujillo;230;117;113;2020
49;Zamora;014;Arquillinos;119;62;57;2020
49;Zamora;015;Arrabalde;212;106;106;2020
49;Zamora;016;Aspariegos;245;110;135;2020
49;Zamora;017;Asturianos;260;132;128;2020
49;Zamora;018;Ayoó de Vidriales;289;144;145;2020
49;Zamora;019;Barcial del Barco;247;128;119;2020
49;Zamora;020;Belver de los Montes;265;144;121;2020
49;Zamora;021;Benavente;17787;8579;9208;2020
49;Zamora;022;Benegiles;304;161;143;2020
49;Zamora;023;Bermillo de Sayago;1007;535;472;2020
49;Zamora;024;Bóveda de Toro, La;699;349;350;2020
49;Zamora;025;Bretó;160;92;68;2020
49;Zamora;026;Bretocino;208;113;95;2020
49;Zamora;027;Brime de Sog;130;62;68;2020
49;Zamora;028;Brime de Urz;106;61;45;2020
49;Zamora;029;Burganes de Valverde;654;345;309;2020
49;Zamora;030;Bustillo del Oro;80;43;37;2020
49;Zamora;031;Cabañas de Sayago;151;84;67;2020
49;Zamora;032;Calzadilla de Tera;299;148;151;2020
49;Zamora;033;Camarzana de Tera;755;373;382;2020
49;Zamora;034;Cañizal;445;232;213;2020
49;Zamora;035;Cañizo;228;125;103;2020
49;Zamora;036;Carbajales de Alba;506;255;251;2020
49;Zamora;037;Carbellino;179;95;84;2020
49;Zamora;038;Casaseca de Campeán;95;54;41;2020
49;Zamora;039;Casaseca de las Chanas;381;198;183;2020
49;Zamora;040;Castrillo de la Guareña;117;62;55;2020
49;Zamora;041;Castrogonzalo;465;255;210;2020
49;Zamora;042;Castronuevo;225;108;117;2020
49;Zamora;043;Castroverde de Campos;272;143;129;2020
49;Zamora;044;Cazurra;76;40;36;2020
49;Zamora;046;Cerecinos de Campos;257;143;114;2020
49;Zamora;047;Cerecinos del Carrizal;111;64;47;2020
49;Zamora;048;Cernadilla;119;63;56;2020
49;Zamora;050;Cobreros;568;310;258;2020
49;Zamora;052;Coomonte;198;111;87;2020
49;Zamora;053;Coreses;1044;538;506;2020
49;Zamora;054;Corrales del Vino;959;470;489;2020
49;Zamora;055;Cotanes del Monte;98;55;43;2020
49;Zamora;056;Cubillos;300;145;155;2020
49;Zamora;057;Cubo de Benavente;116;62;54;2020
49;Zamora;058;Cubo de Tierra del Vino, El;322;172;150;2020
49;Zamora;059;Cuelgamures;81;52;29;2020
49;Zamora;061;Entrala;154;83;71;2020
49;Zamora;062;Espadañedo;111;58;53;2020
49;Zamora;063;Faramontanos de Tábara;319;164;155;2020
49;Zamora;064;Fariza;495;259;236;2020
49;Zamora;065;Fermoselle;1164;591;573;2020
49;Zamora;066;Ferreras de Abajo;479;241;238;2020
49;Zamora;067;Ferreras de Arriba;348;193;155;2020
49;Zamora;068;Ferreruela;446;247;199;2020
49;Zamora;069;Figueruela de Arriba;336;161;175;2020
49;Zamora;071;Fonfría;750;394;356;2020
49;Zamora;075;Fresno de la Polvorosa;132;72;60;2020
49;Zamora;076;Fresno de la Ribera;375;193;182;2020
49;Zamora;077;Fresno de Sayago;161;84;77;2020
49;Zamora;078;Friera de Valverde;144;76;68;2020
49;Zamora;079;Fuente Encalada;102;57;45;2020
49;Zamora;080;Fuentelapeña;669;354;315;2020
49;Zamora;082;Fuentes de Ropel;376;196;180;2020
49;Zamora;081;Fuentesaúco;1587;799;788;2020
49;Zamora;083;Fuentesecas;45;24;21;2020
49;Zamora;084;Fuentespreadas;280;151;129;2020
49;Zamora;085;Galende;982;493;489;2020
49;Zamora;086;Gallegos del Pan;111;65;46;2020
49;Zamora;087;Gallegos del Río;466;258;208;2020
49;Zamora;088;Gamones;89;53;36;2020
49;Zamora;090;Gema;215;106;109;2020
49;Zamora;091;Granja de Moreruela;271;140;131;2020
49;Zamora;092;Granucillo;119;59;60;2020
49;Zamora;093;Guarrate;331;171;160;2020
49;Zamora;094;Hermisende;221;113;108;2020
49;Zamora;095;Hiniesta, La;313;166;147;2020
49;Zamora;096;Jambrina;150;81;69;2020
49;Zamora;097;Justel;64;42;22;2020
49;Zamora;098;Losacino;210;118;92;2020
49;Zamora;099;Losacio;95;55;40;2020
49;Zamora;100;Lubián;304;160;144;2020
49;Zamora;101;Luelmo;147;80;67;2020
49;Zamora;102;Maderal, El;177;97;80;2020
49;Zamora;103;Madridanos;452;238;214;2020
49;Zamora;104;Mahide;316;178;138;2020
49;Zamora;105;Maire de Castroponce;141;75;66;2020
49;Zamora;107;Malva;122;51;71;2020
49;Zamora;108;Manganeses de la Lampreana;465;231;234;2020
49;Zamora;109;Manganeses de la Polvorosa;624;305;319;2020
49;Zamora;110;Manzanal de Arriba;358;185;173;2020
49;Zamora;112;Manzanal de los Infantes;120;69;51;2020
49;Zamora;111;Manzanal del Barco;121;63;58;2020
49;Zamora;113;Matilla de Arzón;164;99;65;2020
49;Zamora;114;Matilla la Seca;42;24;18;2020
49;Zamora;115;Mayalde;177;97;80;2020
49;Zamora;116;Melgar de Tera;366;195;171;2020
49;Zamora;117;Micereces de Tera;435;222;213;2020
49;Zamora;118;Milles de la Polvorosa;213;115;98;2020
49;Zamora;119;Molacillos;242;130;112;2020
49;Zamora;120;Molezuelas de la Carballeda;50;27;23;2020
49;Zamora;121;Mombuey;401;211;190;2020
49;Zamora;122;Monfarracinos;951;497;454;2020
49;Zamora;123;Montamarta;569;303;266;2020
49;Zamora;124;Moral de Sayago;257;147;110;2020
49;Zamora;126;Moraleja de Sayago;291;146;145;2020
49;Zamora;125;Moraleja del Vino;1732;871;861;2020
49;Zamora;128;Morales de Rey;569;289;280;2020
49;Zamora;129;Morales de Toro;954;494;460;2020
49;Zamora;130;Morales de Valverde;163;81;82;2020
49;Zamora;127;Morales del Vino;2971;1554;1417;2020
49;Zamora;131;Moralina;241;124;117;2020
49;Zamora;132;Moreruela de los Infanzones;334;175;159;2020
49;Zamora;133;Moreruela de Tábara;305;166;139;2020
49;Zamora;134;Muelas de los Caballeros;176;102;74;2020
49;Zamora;135;Muelas del Pan;615;317;298;2020
49;Zamora;136;Muga de Sayago;353;173;180;2020
49;Zamora;137;Navianos de Valverde;174;99;75;2020
49;Zamora;138;Olmillos de Castro;213;115;98;2020
49;Zamora;139;Otero de Bodas;150;82;68;2020
49;Zamora;141;Pajares de la Lampreana;306;156;150;2020
49;Zamora;143;Palacios de Sanabria;230;118;112;2020
49;Zamora;142;Palacios del Pan;259;133;126;2020
49;Zamora;145;Pedralba de la Pradería;222;123;99;2020
49;Zamora;146;Pego, El;284;144;140;2020
49;Zamora;147;Peleagonzalo;276;134;142;2020
49;Zamora;148;Peleas de Abajo;288;130;158;2020
49;Zamora;149;Peñausende;384;201;183;2020
49;Zamora;150;Peque;127;55;72;2020
49;Zamora;151;Perdigón, El;673;357;316;2020
49;Zamora;152;Pereruela;515;280;235;2020
49;Zamora;153;Perilla de Castro;161;87;74;2020
49;Zamora;154;Pías;111;63;48;2020
49;Zamora;155;Piedrahita de Castro;92;52;40;2020
49;Zamora;156;Pinilla de Toro;217;113;104;2020
49;Zamora;157;Pino del Oro;183;99;84;2020
49;Zamora;158;Piñero, El;232;121;111;2020
49;Zamora;160;Pobladura de Valderaduey;40;22;18;2020
49;Zamora;159;Pobladura del Valle;289;154;135;2020
49;Zamora;162;Porto;156;87;69;2020
49;Zamora;163;Pozoantiguo;204;103;101;2020
49;Zamora;164;Pozuelo de Tábara;154;79;75;2020
49;Zamora;165;Prado;53;31;22;2020
49;Zamora;166;Puebla de Sanabria;1356;656;700;2020
49;Zamora;167;Pueblica de Valverde;189;103;86;2020
49;Zamora;170;Quintanilla de Urz;106;52;54;2020
49;Zamora;168;Quintanilla del Monte;97;57;40;2020
49;Zamora;169;Quintanilla del Olmo;39;20;19;2020
49;Zamora;171;Quiruelas de Vidriales;652;345;307;2020
49;Zamora;172;Rabanales;501;264;237;2020
49;Zamora;173;Rábano de Aliste;353;175;178;2020
49;Zamora;174;Requejo;149;74;75;2020
49;Zamora;175;Revellinos;249;131;118;2020
49;Zamora;176;Riofrío de Aliste;635;348;287;2020
49;Zamora;177;Rionegro del Puente;260;133;127;2020
49;Zamora;178;Roales;942;495;447;2020
49;Zamora;179;Robleda-Cervantes;395;210;185;2020
49;Zamora;180;Roelos de Sayago;145;72;73;2020
49;Zamora;181;Rosinos de la Requejada;348;188;160;2020
49;Zamora;183;Salce;93;41;52;2020
49;Zamora;184;Samir de los Caños;172;98;74;2020
49;Zamora;185;San Agustín del Pozo;175;92;83;2020
49;Zamora;186;San Cebrián de Castro;237;118;119;2020
49;Zamora;187;San Cristóbal de Entreviñas;1369;717;652;2020
49;Zamora;188;San Esteban del Molar;122;72;50;2020
49;Zamora;189;San Justo;208;108;100;2020
49;Zamora;190;San Martín de Valderaduey;52;27;25;2020
49;Zamora;191;San Miguel de la Ribera;290;143;147;2020
49;Zamora;192;San Miguel del Valle;135;67;68;2020
49;Zamora;193;San Pedro de Ceque;438;232;206;2020
49;Zamora;194;San Pedro de la Nave-Almendra;337;172;165;2020
49;Zamora;208;San Vicente de la Cabeza;357;191;166;2020
49;Zamora;209;San Vitero;492;276;216;2020
49;Zamora;197;Santa Clara de Avedillo;158;79;79;2020
49;Zamora;199;Santa Colomba de las Monjas;255;124;131;2020
49;Zamora;200;Santa Cristina de la Polvorosa;1073;551;522;2020
49;Zamora;201;Santa Croya de Tera;297;151;146;2020
49;Zamora;202;Santa Eufemia del Barco;175;101;74;2020
49;Zamora;203;Santa María de la Vega;293;152;141;2020
49;Zamora;204;Santa María de Valverde;59;29;30;2020
49;Zamora;205;Santibáñez de Tera;368;186;182;2020
49;Zamora;206;Santibáñez de Vidriales;922;467;455;2020
49;Zamora;207;Santovenia;235;119;116;2020
49;Zamora;210;Sanzoles;486;248;238;2020
49;Zamora;214;Tábara;740;372;368;2020
49;Zamora;216;Tapioles;151;88;63;2020
49;Zamora;219;Toro;8665;4260;4405;2020
49;Zamora;220;Torre del Valle, La;148;82;66;2020
49;Zamora;221;Torregamones;253;132;121;2020
49;Zamora;222;Torres del Carrizal;400;203;197;2020
49;Zamora;223;Trabazos;835;448;387;2020
49;Zamora;224;Trefacio;185;99;86;2020
49;Zamora;225;Uña de Quintana;131;70;61;2020
49;Zamora;226;Vadillo de la Guareña;250;133;117;2020
49;Zamora;227;Valcabado;404;208;196;2020
49;Zamora;228;Valdefinjas;54;30;24;2020
49;Zamora;229;Valdescorriel;125;63;62;2020
49;Zamora;230;Vallesa de la Guareña;81;44;37;2020
49;Zamora;231;Vega de Tera;321;160;161;2020
49;Zamora;232;Vega de Villalobos;92;38;54;2020
49;Zamora;233;Vegalatrave;84;44;40;2020
49;Zamora;234;Venialbo;420;224;196;2020
49;Zamora;235;Vezdemarbán;448;235;213;2020
49;Zamora;236;Vidayanes;85;46;39;2020
49;Zamora;237;Videmala;144;73;71;2020
49;Zamora;238;Villabrázaro;248;134;114;2020
49;Zamora;239;Villabuena del Puente;649;333;316;2020
49;Zamora;240;Villadepera;197;109;88;2020
49;Zamora;241;Villaescusa;246;135;111;2020
49;Zamora;242;Villafáfila;469;247;222;2020
49;Zamora;243;Villaferrueña;109;53;56;2020
49;Zamora;244;Villageriz;48;29;19;2020
49;Zamora;245;Villalazán;260;130;130;2020
49;Zamora;246;Villalba de la Lampreana;218;122;96;2020
49;Zamora;247;Villalcampo;419;210;209;2020
49;Zamora;248;Villalobos;235;122;113;2020
49;Zamora;249;Villalonso;73;39;34;2020
49;Zamora;250;Villalpando;1457;716;741;2020
49;Zamora;251;Villalube;170;89;81;2020
49;Zamora;252;Villamayor de Campos;338;173;165;2020
49;Zamora;255;Villamor de los Escuderos;371;193;178;2020
49;Zamora;256;Villanázar;270;140;130;2020
49;Zamora;257;Villanueva de Azoague;358;183;175;2020
49;Zamora;258;Villanueva de Campeán;119;63;56;2020
49;Zamora;259;Villanueva de las Peras;79;36;43;2020
49;Zamora;260;Villanueva del Campo;823;398;425;2020
49;Zamora;263;Villar de Fallaves;44;25;19;2020
49;Zamora;264;Villar del Buey;556;286;270;2020
49;Zamora;261;Villaralbo;1810;915;895;2020
49;Zamora;262;Villardeciervos;399;202;197;2020
49;Zamora;265;Villardiegua de la Ribera;114;64;50;2020
49;Zamora;266;Villárdiga;73;42;31;2020
49;Zamora;267;Villardondiego;106;61;45;2020
49;Zamora;268;Villarrín de Campos;390;212;178;2020
49;Zamora;269;Villaseco del Pan;228;105;123;2020
49;Zamora;270;Villavendimio;177;106;71;2020
49;Zamora;272;Villaveza de Valverde;71;37;34;2020
49;Zamora;271;Villaveza del Agua;176;96;80;2020
49;Zamora;273;Viñas;167;90;77;2020
49;Zamora;275;Zamora;60988;28299;32689;2020
50;Zaragoza;001;Abanto;92;56;36;2020
50;Zaragoza;002;Acered;158;91;67;2020
50;Zaragoza;003;Agón;138;80;58;2020
50;Zaragoza;004;Aguarón;624;332;292;2020
50;Zaragoza;005;Aguilón;233;127;106;2020
50;Zaragoza;006;Ainzón;1064;544;520;2020
50;Zaragoza;007;Aladrén;52;33;19;2020
50;Zaragoza;008;Alagón;7154;3562;3592;2020
50;Zaragoza;009;Alarba;116;66;50;2020
50;Zaragoza;010;Alberite de San Juan;74;44;30;2020
50;Zaragoza;011;Albeta;134;68;66;2020
50;Zaragoza;012;Alborge;107;56;51;2020
50;Zaragoza;013;Alcalá de Ebro;245;119;126;2020
50;Zaragoza;014;Alcalá de Moncayo;143;83;60;2020
50;Zaragoza;015;Alconchel de Ariza;76;43;33;2020
50;Zaragoza;016;Aldehuela de Liestos;51;34;17;2020
50;Zaragoza;017;Alfajarín;2339;1186;1153;2020
50;Zaragoza;018;Alfamén;1443;757;686;2020
50;Zaragoza;019;Alforque;65;37;28;2020
50;Zaragoza;020;Alhama de Aragón;1011;526;485;2020
50;Zaragoza;021;Almochuel;24;12;12;2020
50;Zaragoza;022;Almolda, La;554;278;276;2020
50;Zaragoza;023;Almonacid de la Cuba;230;113;117;2020
50;Zaragoza;024;Almonacid de la Sierra;753;423;330;2020
50;Zaragoza;025;Almunia de Doña Godina, La;8091;4176;3915;2020
50;Zaragoza;026;Alpartir;568;289;279;2020
50;Zaragoza;027;Ambel;253;125;128;2020
50;Zaragoza;028;Anento;95;62;33;2020
50;Zaragoza;029;Aniñón;684;366;318;2020
50;Zaragoza;030;Añón de Moncayo;222;133;89;2020
50;Zaragoza;031;Aranda de Moncayo;145;92;53;2020
50;Zaragoza;032;Arándiga;278;145;133;2020
50;Zaragoza;033;Ardisa;74;47;27;2020
50;Zaragoza;034;Ariza;1100;574;526;2020
50;Zaragoza;035;Artieda;80;48;32;2020
50;Zaragoza;036;Asín;98;52;46;2020
50;Zaragoza;037;Atea;147;91;56;2020
50;Zaragoza;038;Ateca;1762;924;838;2020
50;Zaragoza;039;Azuara;529;297;232;2020
50;Zaragoza;040;Badules;78;42;36;2020
50;Zaragoza;041;Bagüés;16;9;7;2020
50;Zaragoza;042;Balconchán;20;7;13;2020
50;Zaragoza;043;Bárboles;282;152;130;2020
50;Zaragoza;044;Bardallur;254;126;128;2020
50;Zaragoza;045;Belchite;1526;770;756;2020
50;Zaragoza;046;Belmonte de Gracián;194;108;86;2020
50;Zaragoza;047;Berdejo;40;28;12;2020
50;Zaragoza;048;Berrueco;32;20;12;2020
50;Zaragoza;901;Biel;155;97;58;2020
50;Zaragoza;050;Bijuesca;94;65;29;2020
50;Zaragoza;051;Biota;930;474;456;2020
50;Zaragoza;052;Bisimbre;81;46;35;2020
50;Zaragoza;053;Boquiñeni;776;389;387;2020
50;Zaragoza;054;Bordalba;52;33;19;2020
50;Zaragoza;055;Borja;4978;2538;2440;2020
50;Zaragoza;056;Botorrita;490;271;219;2020
50;Zaragoza;057;Brea de Aragón;1589;808;781;2020
50;Zaragoza;058;Bubierca;65;34;31;2020
50;Zaragoza;059;Bujaraloz;980;500;480;2020
50;Zaragoza;060;Bulbuente;220;119;101;2020
50;Zaragoza;061;Bureta;206;106;100;2020
50;Zaragoza;062;Burgo de Ebro, El;2486;1254;1232;2020
50;Zaragoza;063;Buste, El;71;40;31;2020
50;Zaragoza;064;Cabañas de Ebro;496;264;232;2020
50;Zaragoza;065;Cabolafuente;53;32;21;2020
50;Zaragoza;066;Cadrete;4235;2257;1978;2020
50;Zaragoza;067;Calatayud;20092;9930;10162;2020
50;Zaragoza;068;Calatorao;2860;1488;1372;2020
50;Zaragoza;069;Calcena;73;43;30;2020
50;Zaragoza;070;Calmarza;61;35;26;2020
50;Zaragoza;071;Campillo de Aragón;146;80;66;2020
50;Zaragoza;072;Carenas;189;109;80;2020
50;Zaragoza;073;Cariñena;3355;1695;1660;2020
50;Zaragoza;074;Caspe;10026;5295;4731;2020
50;Zaragoza;075;Castejón de Alarba;88;55;33;2020
50;Zaragoza;076;Castejón de las Armas;78;43;35;2020
50;Zaragoza;077;Castejón de Valdejasa;209;104;105;2020
50;Zaragoza;078;Castiliscar;254;133;121;2020
50;Zaragoza;079;Cervera de la Cañada;260;147;113;2020
50;Zaragoza;080;Cerveruela;34;22;12;2020
50;Zaragoza;081;Cetina;583;303;280;2020
50;Zaragoza;092;Chiprana;497;261;236;2020
50;Zaragoza;093;Chodes;104;57;47;2020
50;Zaragoza;082;Cimballa;94;45;49;2020
50;Zaragoza;083;Cinco Olivas;102;52;50;2020
50;Zaragoza;084;Clarés de Ribota;67;38;29;2020
50;Zaragoza;085;Codo;199;106;93;2020
50;Zaragoza;086;Codos;248;160;88;2020
50;Zaragoza;087;Contamina;32;18;14;2020
50;Zaragoza;088;Cosuenda;337;171;166;2020
50;Zaragoza;089;Cuarte de Huerva;13450;6853;6597;2020
50;Zaragoza;090;Cubel;155;75;80;2020
50;Zaragoza;091;Cuerlas, Las;41;22;19;2020
50;Zaragoza;094;Daroca;1965;958;1007;2020
50;Zaragoza;095;Ejea de los Caballeros;16984;8694;8290;2020
50;Zaragoza;096;Embid de Ariza;35;19;16;2020
50;Zaragoza;098;Encinacorba;178;92;86;2020
50;Zaragoza;099;Épila;4372;2277;2095;2020
50;Zaragoza;100;Erla;341;176;165;2020
50;Zaragoza;101;Escatrón;1067;531;536;2020
50;Zaragoza;102;Fabara;1109;599;510;2020
50;Zaragoza;104;Farlete;366;180;186;2020
50;Zaragoza;105;Fayón;380;200;180;2020
50;Zaragoza;106;Fayos, Los;131;69;62;2020
50;Zaragoza;107;Figueruelas;1262;631;631;2020
50;Zaragoza;108;Fombuena;60;39;21;2020
50;Zaragoza;109;Frago, El;97;62;35;2020
50;Zaragoza;110;Frasno, El;379;215;164;2020
50;Zaragoza;111;Fréscano;199;112;87;2020
50;Zaragoza;113;Fuendejalón;784;421;363;2020
50;Zaragoza;114;Fuendetodos;145;85;60;2020
50;Zaragoza;115;Fuentes de Ebro;4549;2345;2204;2020
50;Zaragoza;116;Fuentes de Jiloca;229;125;104;2020
50;Zaragoza;117;Gallocanta;136;75;61;2020
50;Zaragoza;118;Gallur;2566;1298;1268;2020
50;Zaragoza;119;Gelsa;996;525;471;2020
50;Zaragoza;120;Godojos;53;28;25;2020
50;Zaragoza;121;Gotor;302;157;145;2020
50;Zaragoza;122;Grisel;74;43;31;2020
50;Zaragoza;123;Grisén;590;306;284;2020
50;Zaragoza;124;Herrera de los Navarros;489;268;221;2020
50;Zaragoza;125;Ibdes;395;202;193;2020
50;Zaragoza;126;Illueca;2809;1403;1406;2020
50;Zaragoza;128;Isuerre;31;16;15;2020
50;Zaragoza;129;Jaraba;282;155;127;2020
50;Zaragoza;130;Jarque de Moncayo;417;221;196;2020
50;Zaragoza;131;Jaulín;251;129;122;2020
50;Zaragoza;132;Joyosa, La;1101;566;535;2020
50;Zaragoza;133;Lagata;109;57;52;2020
50;Zaragoza;134;Langa del Castillo;122;63;59;2020
50;Zaragoza;135;Layana;94;52;42;2020
50;Zaragoza;136;Lécera;631;339;292;2020
50;Zaragoza;138;Lechón;46;26;20;2020
50;Zaragoza;137;Leciñena;1146;582;564;2020
50;Zaragoza;139;Letux;342;185;157;2020
50;Zaragoza;140;Litago;164;93;71;2020
50;Zaragoza;141;Lituénigo;123;66;57;2020
50;Zaragoza;142;Lobera de Onsella;26;14;12;2020
50;Zaragoza;143;Longares;883;534;349;2020
50;Zaragoza;144;Longás;32;22;10;2020
50;Zaragoza;146;Lucena de Jalón;232;127;105;2020
50;Zaragoza;147;Luceni;955;485;470;2020
50;Zaragoza;148;Luesia;297;165;132;2020
50;Zaragoza;149;Luesma;37;22;15;2020
50;Zaragoza;150;Lumpiaque;806;420;386;2020
50;Zaragoza;151;Luna;684;357;327;2020
50;Zaragoza;152;Maella;2008;1088;920;2020
50;Zaragoza;153;Magallón;1112;565;547;2020
50;Zaragoza;154;Mainar;160;86;74;2020
50;Zaragoza;155;Malanquilla;89;59;30;2020
50;Zaragoza;156;Maleján;276;143;133;2020
50;Zaragoza;160;Mallén;3004;1550;1454;2020
50;Zaragoza;157;Malón;369;182;187;2020
50;Zaragoza;159;Maluenda;937;456;481;2020
50;Zaragoza;161;Manchones;106;57;49;2020
50;Zaragoza;162;Mara;168;84;84;2020
50;Zaragoza;163;María de Huerva;5970;3032;2938;2020
50;Zaragoza;902;Marracos;84;46;38;2020
50;Zaragoza;164;Mediana de Aragón;447;219;228;2020
50;Zaragoza;165;Mequinenza;2279;1155;1124;2020
50;Zaragoza;166;Mesones de Isuela;257;130;127;2020
50;Zaragoza;167;Mezalocha;233;134;99;2020
50;Zaragoza;168;Mianos;27;15;12;2020
50;Zaragoza;169;Miedes de Aragón;415;219;196;2020
50;Zaragoza;170;Monegrillo;394;217;177;2020
50;Zaragoza;171;Moneva;114;69;45;2020
50;Zaragoza;172;Monreal de Ariza;189;110;79;2020
50;Zaragoza;173;Monterde;143;93;50;2020
50;Zaragoza;174;Montón;90;54;36;2020
50;Zaragoza;175;Morata de Jalón;1066;533;533;2020
50;Zaragoza;176;Morata de Jiloca;276;161;115;2020
50;Zaragoza;177;Morés;321;167;154;2020
50;Zaragoza;178;Moros;319;164;155;2020
50;Zaragoza;179;Moyuela;265;146;119;2020
50;Zaragoza;180;Mozota;120;60;60;2020
50;Zaragoza;181;Muel;1401;710;691;2020
50;Zaragoza;182;Muela, La;5894;3061;2833;2020
50;Zaragoza;183;Munébrega;363;198;165;2020
50;Zaragoza;184;Murero;96;56;40;2020
50;Zaragoza;185;Murillo de Gállego;191;113;78;2020
50;Zaragoza;186;Navardún;36;22;14;2020
50;Zaragoza;187;Nigüella;61;38;23;2020
50;Zaragoza;188;Nombrevilla;31;19;12;2020
50;Zaragoza;189;Nonaspe;978;534;444;2020
50;Zaragoza;190;Novallas;825;438;387;2020
50;Zaragoza;191;Novillas;517;256;261;2020
50;Zaragoza;192;Nuévalos;285;159;126;2020
50;Zaragoza;193;Nuez de Ebro;838;419;419;2020
50;Zaragoza;194;Olvés;110;64;46;2020
50;Zaragoza;195;Orcajo;55;34;21;2020
50;Zaragoza;196;Orera;111;60;51;2020
50;Zaragoza;197;Orés;109;69;40;2020
50;Zaragoza;198;Oseja;47;29;18;2020
50;Zaragoza;199;Osera de Ebro;383;191;192;2020
50;Zaragoza;200;Paniza;619;330;289;2020
50;Zaragoza;201;Paracuellos de Jiloca;573;302;271;2020
50;Zaragoza;202;Paracuellos de la Ribera;136;71;65;2020
50;Zaragoza;203;Pastriz;1300;632;668;2020
50;Zaragoza;204;Pedrola;3587;1880;1707;2020
50;Zaragoza;205;Pedrosas, Las;86;40;46;2020
50;Zaragoza;206;Perdiguera;572;306;266;2020
50;Zaragoza;207;Piedratajada;87;48;39;2020
50;Zaragoza;208;Pina de Ebro;2391;1221;1170;2020
50;Zaragoza;209;Pinseque;4070;2087;1983;2020
50;Zaragoza;210;Pintanos, Los;39;25;14;2020
50;Zaragoza;211;Plasencia de Jalón;308;175;133;2020
50;Zaragoza;212;Pleitas;33;13;20;2020
50;Zaragoza;213;Plenas;98;53;45;2020
50;Zaragoza;214;Pomer;21;14;7;2020
50;Zaragoza;215;Pozuel de Ariza;21;12;9;2020
50;Zaragoza;216;Pozuelo de Aragón;282;146;136;2020
50;Zaragoza;217;Pradilla de Ebro;540;292;248;2020
50;Zaragoza;218;Puebla de Albortón;120;73;47;2020
50;Zaragoza;219;Puebla de Alfindén, La;6358;3254;3104;2020
50;Zaragoza;220;Puendeluna;48;28;20;2020
50;Zaragoza;221;Purujosa;32;21;11;2020
50;Zaragoza;222;Quinto;1949;983;966;2020
50;Zaragoza;223;Remolinos;1074;548;526;2020
50;Zaragoza;224;Retascón;62;36;26;2020
50;Zaragoza;225;Ricla;2869;1534;1335;2020
50;Zaragoza;227;Romanos;125;66;59;2020
50;Zaragoza;228;Rueda de Jalón;312;170;142;2020
50;Zaragoza;229;Ruesca;76;35;41;2020
50;Zaragoza;241;Sabiñán;722;392;330;2020
50;Zaragoza;230;Sádaba;1311;667;644;2020
50;Zaragoza;231;Salillas de Jalón;321;157;164;2020
50;Zaragoza;232;Salvatierra de Esca;207;96;111;2020
50;Zaragoza;233;Samper del Salz;100;58;42;2020
50;Zaragoza;234;San Martín de la Virgen de Moncayo;270;152;118;2020
50;Zaragoza;235;San Mateo de Gállego;3269;1671;1598;2020
50;Zaragoza;236;Santa Cruz de Grío;105;66;39;2020
50;Zaragoza;237;Santa Cruz de Moncayo;123;67;56;2020
50;Zaragoza;238;Santa Eulalia de Gállego;97;55;42;2020
50;Zaragoza;239;Santed;64;42;22;2020
50;Zaragoza;240;Sástago;1119;554;565;2020
50;Zaragoza;242;Sediles;108;63;45;2020
50;Zaragoza;243;Sestrica;344;196;148;2020
50;Zaragoza;244;Sierra de Luna;270;138;132;2020
50;Zaragoza;245;Sigüés;79;42;37;2020
50;Zaragoza;246;Sisamón;35;23;12;2020
50;Zaragoza;247;Sobradiel;1136;545;591;2020
50;Zaragoza;248;Sos del Rey Católico;567;297;270;2020
50;Zaragoza;249;Tabuenca;321;187;134;2020
50;Zaragoza;250;Talamantes;61;28;33;2020
50;Zaragoza;251;Tarazona;10558;5259;5299;2020
50;Zaragoza;252;Tauste;6847;3422;3425;2020
50;Zaragoza;253;Terrer;464;250;214;2020
50;Zaragoza;254;Tierga;190;104;86;2020
50;Zaragoza;255;Tobed;230;122;108;2020
50;Zaragoza;256;Torralba de los Frailes;76;42;34;2020
50;Zaragoza;257;Torralba de Ribota;169;94;75;2020
50;Zaragoza;258;Torralbilla;59;34;25;2020
50;Zaragoza;259;Torrehermosa;69;37;32;2020
50;Zaragoza;260;Torrelapaja;35;23;12;2020
50;Zaragoza;261;Torrellas;246;126;120;2020
50;Zaragoza;262;Torres de Berrellén;1443;744;699;2020
50;Zaragoza;263;Torrijo de la Cañada;197;116;81;2020
50;Zaragoza;264;Tosos;183;104;79;2020
50;Zaragoza;265;Trasmoz;88;50;38;2020
50;Zaragoza;266;Trasobares;115;72;43;2020
50;Zaragoza;267;Uncastillo;621;295;326;2020
50;Zaragoza;268;Undués de Lerda;57;32;25;2020
50;Zaragoza;269;Urrea de Jalón;435;252;183;2020
50;Zaragoza;270;Urriés;43;22;21;2020
50;Zaragoza;271;Used;256;141;115;2020
50;Zaragoza;272;Utebo;18822;9365;9457;2020
50;Zaragoza;274;Val de San Martín;61;36;25;2020
50;Zaragoza;273;Valdehorna;33;19;14;2020
50;Zaragoza;275;Valmadrid;112;69;43;2020
50;Zaragoza;276;Valpalmas;137;65;72;2020
50;Zaragoza;277;Valtorres;61;27;34;2020
50;Zaragoza;278;Velilla de Ebro;203;110;93;2020
50;Zaragoza;279;Velilla de Jiloca;81;39;42;2020
50;Zaragoza;280;Vera de Moncayo;322;168;154;2020
50;Zaragoza;281;Vierlas;82;43;39;2020
50;Zaragoza;283;Villadoz;95;55;40;2020
50;Zaragoza;284;Villafeliche;154;85;69;2020
50;Zaragoza;285;Villafranca de Ebro;838;418;420;2020
50;Zaragoza;286;Villalba de Perejil;96;49;47;2020
50;Zaragoza;287;Villalengua;293;161;132;2020
50;Zaragoza;903;Villamayor de Gállego;2745;1375;1370;2020
50;Zaragoza;288;Villanueva de Gállego;4728;2377;2351;2020
50;Zaragoza;290;Villanueva de Huerva;434;226;208;2020
50;Zaragoza;289;Villanueva de Jiloca;52;27;25;2020
50;Zaragoza;291;Villar de los Navarros;113;64;49;2020
50;Zaragoza;292;Villarreal de Huerva;273;156;117;2020
50;Zaragoza;293;Villarroya de la Sierra;435;233;202;2020
50;Zaragoza;294;Villarroya del Campo;89;48;41;2020
50;Zaragoza;282;Vilueña, La;62;31;31;2020
50;Zaragoza;295;Vistabella;48;27;21;2020
50;Zaragoza;296;Zaida, La;447;229;218;2020
50;Zaragoza;297;Zaragoza;681877;326103;355774;2020
50;Zaragoza;298;Zuera;8576;4450;4126;2020
02;Albacete;001;Abengibre;748;365;383;2021
02;Albacete;002;Alatoz;496;272;224;2021
02;Albacete;003;Albacete;172722;84365;88357;2021
02;Albacete;004;Albatana;681;354;327;2021
02;Albacete;005;Alborea;670;350;320;2021
02;Albacete;006;Alcadozo;632;344;288;2021
02;Albacete;007;Alcalá del Júcar;1153;621;532;2021
02;Albacete;008;Alcaraz;1310;682;628;2021
02;Albacete;009;Almansa;24388;12127;12261;2021
02;Albacete;010;Alpera;2285;1189;1096;2021
02;Albacete;011;Ayna;582;314;268;2021
02;Albacete;012;Balazote;2363;1208;1155;2021
02;Albacete;014;Ballestero, El;413;217;196;2021
02;Albacete;013;Balsa de Ves;129;73;56;2021
02;Albacete;015;Barrax;1808;926;882;2021
02;Albacete;016;Bienservida;595;319;276;2021
02;Albacete;017;Bogarra;768;400;368;2021
02;Albacete;018;Bonete;1031;536;495;2021
02;Albacete;019;Bonillo, El;2718;1376;1342;2021
02;Albacete;020;Carcelén;496;265;231;2021
02;Albacete;021;Casas de Juan Núñez;1361;729;632;2021
02;Albacete;022;Casas de Lázaro;328;179;149;2021
02;Albacete;023;Casas de Ves;564;295;269;2021
02;Albacete;024;Casas-Ibáñez;4540;2274;2266;2021
02;Albacete;025;Caudete;10077;5135;4942;2021
02;Albacete;026;Cenizate;1186;594;592;2021
02;Albacete;029;Chinchilla de Monte-Aragón;4344;2261;2083;2021
02;Albacete;027;Corral-Rubio;306;165;141;2021
02;Albacete;028;Cotillas;134;71;63;2021
02;Albacete;030;Elche de la Sierra;3557;1745;1812;2021
02;Albacete;031;Férez;628;309;319;2021
02;Albacete;032;Fuensanta;280;159;121;2021
02;Albacete;033;Fuente-Álamo;2447;1280;1167;2021
02;Albacete;034;Fuentealbilla;1836;942;894;2021
02;Albacete;035;Gineta, La;2554;1321;1233;2021
02;Albacete;036;Golosalvo;99;52;47;2021
02;Albacete;037;Hellín;30427;15281;15146;2021
02;Albacete;038;Herrera, La;311;161;150;2021
02;Albacete;039;Higueruela;1144;599;545;2021
02;Albacete;040;Hoya-Gonzalo;598;322;276;2021
02;Albacete;041;Jorquera;363;196;167;2021
02;Albacete;042;Letur;909;444;465;2021
02;Albacete;043;Lezuza;1322;684;638;2021
02;Albacete;044;Liétor;1123;585;538;2021
02;Albacete;045;Madrigueras;4654;2379;2275;2021
02;Albacete;046;Mahora;1380;709;671;2021
02;Albacete;047;Masegoso;105;61;44;2021
02;Albacete;048;Minaya;1483;764;719;2021
02;Albacete;049;Molinicos;829;430;399;2021
02;Albacete;050;Montalvos;86;48;38;2021
02;Albacete;051;Montealegre del Castillo;2038;1054;984;2021
02;Albacete;052;Motilleja;605;330;275;2021
02;Albacete;053;Munera;3433;1769;1664;2021
02;Albacete;054;Navas de Jorquera;536;281;255;2021
02;Albacete;055;Nerpio;1197;660;537;2021
02;Albacete;056;Ontur;1963;990;973;2021
02;Albacete;057;Ossa de Montiel;2241;1127;1114;2021
02;Albacete;058;Paterna del Madera;323;178;145;2021
02;Albacete;060;Peñas de San Pedro;1410;827;583;2021
02;Albacete;059;Peñascosa;320;176;144;2021
02;Albacete;061;Pétrola;676;356;320;2021
02;Albacete;062;Povedilla;401;220;181;2021
02;Albacete;901;Pozo Cañada;2797;1422;1375;2021
02;Albacete;063;Pozohondo;1584;826;758;2021
02;Albacete;064;Pozo-Lorente;394;204;190;2021
02;Albacete;065;Pozuelo;465;250;215;2021
02;Albacete;066;Recueja, La;225;128;97;2021
02;Albacete;067;Riópar;1326;684;642;2021
02;Albacete;068;Robledo;391;211;180;2021
02;Albacete;069;Roda, La;15401;7794;7607;2021
02;Albacete;070;Salobre;461;242;219;2021
02;Albacete;071;San Pedro;1148;594;554;2021
02;Albacete;072;Socovos;1750;902;848;2021
02;Albacete;073;Tarazona de la Mancha;6184;3169;3015;2021
02;Albacete;074;Tobarra;7691;3974;3717;2021
02;Albacete;075;Valdeganga;1947;997;950;2021
02;Albacete;076;Vianos;327;171;156;2021
02;Albacete;077;Villa de Ves;62;36;26;2021
02;Albacete;078;Villalgordo del Júcar;1081;577;504;2021
02;Albacete;079;Villamalea;4040;2062;1978;2021
02;Albacete;080;Villapalacios;556;285;271;2021
02;Albacete;081;Villarrobledo;24978;12350;12628;2021
02;Albacete;082;Villatoya;108;63;45;2021
02;Albacete;083;Villavaliente;214;131;83;2021
02;Albacete;084;Villaverde de Guadalimar;333;182;151;2021
02;Albacete;085;Viveros;328;172;156;2021
02;Albacete;086;Yeste;2567;1334;1233;2021
03;Alicante/Alacant;002;Agost;4906;2474;2432;2021
03;Alicante/Alacant;003;Agres;580;319;261;2021
03;Alicante/Alacant;004;Aigües;1049;544;505;2021
03;Alicante/Alacant;005;Albatera;12714;6420;6294;2021
03;Alicante/Alacant;006;Alcalalí;1336;667;669;2021
03;Alicante/Alacant;007;Alcocer de Planes;243;118;125;2021
03;Alicante/Alacant;008;Alcoleja;181;100;81;2021
03;Alicante/Alacant;009;Alcoy/Alcoi;59128;28964;30164;2021
03;Alicante/Alacant;010;Alfafara;408;195;213;2021
03;Alicante/Alacant;011;Alfàs del Pi, l';20495;10144;10351;2021
03;Alicante/Alacant;012;Algorfa;3396;1731;1665;2021
03;Alicante/Alacant;013;Algueña;1334;672;662;2021
03;Alicante/Alacant;014;Alicante/Alacant;337304;163052;174252;2021
03;Alicante/Alacant;015;Almoradí;21404;10773;10631;2021
03;Alicante/Alacant;016;Almudaina;117;56;61;2021
03;Alicante/Alacant;017;Alqueria d'Asnar, l';498;246;252;2021
03;Alicante/Alacant;018;Altea;22657;11117;11540;2021
03;Alicante/Alacant;019;Aspe;21088;10612;10476;2021
03;Alicante/Alacant;001;Atzúbia, l';609;315;294;2021
03;Alicante/Alacant;020;Balones;134;71;63;2021
03;Alicante/Alacant;021;Banyeres de Mariola;7113;3572;3541;2021
03;Alicante/Alacant;022;Benasau;170;79;91;2021
03;Alicante/Alacant;023;Beneixama;1707;861;846;2021
03;Alicante/Alacant;024;Benejúzar;5453;2736;2717;2021
03;Alicante/Alacant;025;Benferri;1958;1010;948;2021
03;Alicante/Alacant;026;Beniarbeig;2227;1143;1084;2021
03;Alicante/Alacant;027;Beniardá;192;96;96;2021
03;Alicante/Alacant;028;Beniarrés;1083;557;526;2021
03;Alicante/Alacant;030;Benidoleig;1166;585;581;2021
03;Alicante/Alacant;031;Benidorm;69118;34455;34663;2021
03;Alicante/Alacant;032;Benifallim;103;56;47;2021
03;Alicante/Alacant;033;Benifato;135;70;65;2021
03;Alicante/Alacant;029;Benigembla;483;239;244;2021
03;Alicante/Alacant;034;Benijófar;3323;1614;1709;2021
03;Alicante/Alacant;035;Benilloba;737;392;345;2021
03;Alicante/Alacant;036;Benillup;101;54;47;2021
03;Alicante/Alacant;037;Benimantell;501;259;242;2021
03;Alicante/Alacant;038;Benimarfull;397;203;194;2021
03;Alicante/Alacant;039;Benimassot;97;55;42;2021
03;Alicante/Alacant;040;Benimeli;415;189;226;2021
03;Alicante/Alacant;041;Benissa;11462;5626;5836;2021
03;Alicante/Alacant;042;Benitachell/Poble Nou de Benitatxell, el;4447;2220;2227;2021
03;Alicante/Alacant;043;Biar;3628;1776;1852;2021
03;Alicante/Alacant;044;Bigastro;6994;3514;3480;2021
03;Alicante/Alacant;045;Bolulla;426;222;204;2021
03;Alicante/Alacant;046;Busot;3207;1628;1579;2021
03;Alicante/Alacant;049;Callosa de Segura;19273;9835;9438;2021
03;Alicante/Alacant;048;Callosa d'en Sarrià;7589;3919;3670;2021
03;Alicante/Alacant;047;Calp;23530;11801;11729;2021
03;Alicante/Alacant;050;Campello, el;29013;14086;14927;2021
03;Alicante/Alacant;051;Campo de Mirra/Camp de Mirra, el;429;217;212;2021
03;Alicante/Alacant;052;Cañada;1191;590;601;2021
03;Alicante/Alacant;053;Castalla;10752;5484;5268;2021
03;Alicante/Alacant;054;Castell de Castells;425;226;199;2021
03;Alicante/Alacant;075;Castell de Guadalest, el;243;118;125;2021
03;Alicante/Alacant;055;Catral;8880;4450;4430;2021
03;Alicante/Alacant;056;Cocentaina;11451;5783;5668;2021
03;Alicante/Alacant;057;Confrides;271;147;124;2021
03;Alicante/Alacant;058;Cox;7427;3768;3659;2021
03;Alicante/Alacant;059;Crevillent;29717;15038;14679;2021
03;Alicante/Alacant;061;Daya Nueva;1757;856;901;2021
03;Alicante/Alacant;062;Daya Vieja;707;352;355;2021
03;Alicante/Alacant;063;Dénia;42953;20826;22127;2021
03;Alicante/Alacant;064;Dolores;7620;3804;3816;2021
03;Alicante/Alacant;065;Elche/Elx;234205;116222;117983;2021
03;Alicante/Alacant;066;Elda;52551;25618;26933;2021
03;Alicante/Alacant;067;Facheca;105;54;51;2021
03;Alicante/Alacant;068;Famorca;45;24;21;2021
03;Alicante/Alacant;069;Finestrat;7402;3798;3604;2021
03;Alicante/Alacant;077;Fondó de les Neus, el/Hondón de las Nieves;2634;1352;1282;2021
03;Alicante/Alacant;070;Formentera del Segura;4337;2203;2134;2021
03;Alicante/Alacant;072;Gaianes;505;248;257;2021
03;Alicante/Alacant;071;Gata de Gorgos;6223;3172;3051;2021
03;Alicante/Alacant;073;Gorga;261;141;120;2021
03;Alicante/Alacant;074;Granja de Rocamora;2609;1353;1256;2021
03;Alicante/Alacant;076;Guardamar del Segura;15983;7779;8204;2021
03;Alicante/Alacant;078;Hondón de los Frailes;1299;658;641;2021
03;Alicante/Alacant;079;Ibi;23652;11845;11807;2021
03;Alicante/Alacant;080;Jacarilla;2030;1035;995;2021
03;Alicante/Alacant;082;Jávea/Xàbia;27983;13977;14006;2021
03;Alicante/Alacant;083;Jijona/Xixona;6861;3328;3533;2021
03;Alicante/Alacant;085;Llíber;883;442;441;2021
03;Alicante/Alacant;084;Lorcha/Orxa, l';584;290;294;2021
03;Alicante/Alacant;086;Millena;242;130;112;2021
03;Alicante/Alacant;088;Monforte del Cid;8500;4417;4083;2021
03;Alicante/Alacant;089;Monóvar/Monòver;12188;6087;6101;2021
03;Alicante/Alacant;903;Montesinos, Los;5123;2624;2499;2021
03;Alicante/Alacant;091;Murla;549;255;294;2021
03;Alicante/Alacant;092;Muro de Alcoy;9326;4653;4673;2021
03;Alicante/Alacant;090;Mutxamel;25679;12839;12840;2021
03;Alicante/Alacant;093;Novelda;25611;12726;12885;2021
03;Alicante/Alacant;094;Nucia, la;18108;9220;8888;2021
03;Alicante/Alacant;095;Ondara;7080;3564;3516;2021
03;Alicante/Alacant;096;Onil;7569;3770;3799;2021
03;Alicante/Alacant;097;Orba;2233;1092;1141;2021
03;Alicante/Alacant;099;Orihuela;78940;39105;39835;2021
03;Alicante/Alacant;098;Orxeta;787;397;390;2021
03;Alicante/Alacant;100;Parcent;983;489;494;2021
03;Alicante/Alacant;101;Pedreguer;8006;3989;4017;2021
03;Alicante/Alacant;102;Pego;10240;5085;5155;2021
03;Alicante/Alacant;103;Penàguila;275;141;134;2021
03;Alicante/Alacant;104;Petrer;34009;16850;17159;2021
03;Alicante/Alacant;902;Pilar de la Horadada;22597;11611;10986;2021
03;Alicante/Alacant;105;Pinós, el/Pinoso;8142;4126;4016;2021
03;Alicante/Alacant;106;Planes;693;376;317;2021
03;Alicante/Alacant;901;Poblets, els;2721;1296;1425;2021
03;Alicante/Alacant;107;Polop;5069;2573;2496;2021
03;Alicante/Alacant;060;Quatretondeta;117;63;54;2021
03;Alicante/Alacant;109;Rafal;4597;2275;2322;2021
03;Alicante/Alacant;110;Ràfol d'Almúnia, el;670;346;324;2021
03;Alicante/Alacant;111;Redován;8058;4197;3861;2021
03;Alicante/Alacant;112;Relleu;1173;601;572;2021
03;Alicante/Alacant;113;Rojales;15978;8162;7816;2021
03;Alicante/Alacant;114;Romana, la;2542;1329;1213;2021
03;Alicante/Alacant;115;Sagra;427;201;226;2021
03;Alicante/Alacant;116;Salinas;1642;842;800;2021
03;Alicante/Alacant;118;San Fulgencio;8447;4275;4172;2021
03;Alicante/Alacant;904;San Isidro;2146;1117;1029;2021
03;Alicante/Alacant;120;San Miguel de Salinas;6553;3284;3269;2021
03;Alicante/Alacant;122;San Vicente del Raspeig/Sant Vicent del Raspeig;58912;29148;29764;2021
03;Alicante/Alacant;117;Sanet y Negrals;702;348;354;2021
03;Alicante/Alacant;119;Sant Joan d'Alacant;24363;11755;12608;2021
03;Alicante/Alacant;121;Santa Pola;34148;17132;17016;2021
03;Alicante/Alacant;123;Sax;9935;5012;4923;2021
03;Alicante/Alacant;124;Sella;578;305;273;2021
03;Alicante/Alacant;125;Senija;605;312;293;2021
03;Alicante/Alacant;127;Tàrbena;642;338;304;2021
03;Alicante/Alacant;128;Teulada;11466;5723;5743;2021
03;Alicante/Alacant;129;Tibi;1691;892;799;2021
03;Alicante/Alacant;130;Tollos;37;23;14;2021
03;Alicante/Alacant;131;Tormos;327;156;171;2021
03;Alicante/Alacant;132;Torremanzanas/Torre de les Maçanes, la;681;355;326;2021
03;Alicante/Alacant;133;Torrevieja;82842;40721;42121;2021
03;Alicante/Alacant;134;Vall d'Alcalà, la;163;90;73;2021
03;Alicante/Alacant;136;Vall de Gallinera;557;293;264;2021
03;Alicante/Alacant;137;Vall de Laguar, la;843;419;424;2021
03;Alicante/Alacant;135;Vall d'Ebo, la;204;105;99;2021
03;Alicante/Alacant;138;Verger, el;4841;2412;2429;2021
03;Alicante/Alacant;139;Villajoyosa/Vila Joiosa, la;34684;17216;17468;2021
03;Alicante/Alacant;140;Villena;34025;17068;16957;2021
03;Alicante/Alacant;081;Xaló;2892;1448;1444;2021
04;Almería;001;Abla;1258;646;612;2021
04;Almería;002;Abrucena;1208;639;569;2021
04;Almería;003;Adra;25501;13058;12443;2021
04;Almería;004;Albanchez;726;379;347;2021
04;Almería;005;Alboloduy;612;297;315;2021
04;Almería;006;Albox;12070;6186;5884;2021
04;Almería;007;Alcolea;849;438;411;2021
04;Almería;008;Alcóntar;542;304;238;2021
04;Almería;009;Alcudia de Monteagud;129;69;60;2021
04;Almería;010;Alhabia;675;354;321;2021
04;Almería;011;Alhama de Almería;3733;1872;1861;2021
04;Almería;012;Alicún;204;103;101;2021
04;Almería;013;Almería;200753;98141;102612;2021
04;Almería;014;Almócita;197;104;93;2021
04;Almería;015;Alsodux;131;79;52;2021
04;Almería;016;Antas;3355;1743;1612;2021
04;Almería;017;Arboleas;4685;2356;2329;2021
04;Almería;018;Armuña de Almanzora;313;156;157;2021
04;Almería;019;Bacares;249;135;114;2021
04;Almería;904;Balanegra;2959;1568;1391;2021
04;Almería;020;Bayárcal;317;173;144;2021
04;Almería;021;Bayarque;219;101;118;2021
04;Almería;022;Bédar;974;500;474;2021
04;Almería;023;Beires;132;63;69;2021
04;Almería;024;Benahadux;4526;2246;2280;2021
04;Almería;026;Benitagla;59;33;26;2021
04;Almería;027;Benizalón;263;148;115;2021
04;Almería;028;Bentarique;239;132;107;2021
04;Almería;029;Berja;12708;6508;6200;2021
04;Almería;030;Canjáyar;1178;619;559;2021
04;Almería;031;Cantoria;3547;1790;1757;2021
04;Almería;032;Carboneras;8183;4205;3978;2021
04;Almería;033;Castro de Filabres;115;61;54;2021
04;Almería;036;Chercos;288;143;145;2021
04;Almería;037;Chirivel;1501;769;732;2021
04;Almería;034;Cóbdar;170;92;78;2021
04;Almería;035;Cuevas del Almanzora;14623;7592;7031;2021
04;Almería;038;Dalías;4102;2031;2071;2021
04;Almería;902;Ejido, El;84005;43349;40656;2021
04;Almería;041;Enix;540;298;242;2021
04;Almería;043;Felix;664;381;283;2021
04;Almería;044;Fines;2160;1131;1029;2021
04;Almería;045;Fiñana;1977;1001;976;2021
04;Almería;046;Fondón;1032;533;499;2021
04;Almería;047;Gádor;3008;1564;1444;2021
04;Almería;048;Gallardos, Los;3003;1517;1486;2021
04;Almería;049;Garrucha;9875;5220;4655;2021
04;Almería;050;Gérgal;1107;587;520;2021
04;Almería;051;Huécija;491;244;247;2021
04;Almería;052;Huércal de Almería;17974;9131;8843;2021
04;Almería;053;Huércal-Overa;19744;9799;9945;2021
04;Almería;054;Íllar;436;229;207;2021
04;Almería;055;Instinción;462;239;223;2021
04;Almería;056;Laroya;197;110;87;2021
04;Almería;057;Láujar de Andarax;1591;802;789;2021
04;Almería;058;Líjar;398;210;188;2021
04;Almería;059;Lubrín;1489;759;730;2021
04;Almería;060;Lucainena de las Torres;584;303;281;2021
04;Almería;061;Lúcar;772;388;384;2021
04;Almería;062;Macael;5449;2800;2649;2021
04;Almería;063;María;1235;632;603;2021
04;Almería;064;Mojácar;7257;3546;3711;2021
04;Almería;903;Mojonera, La;9086;5107;3979;2021
04;Almería;065;Nacimiento;485;251;234;2021
04;Almería;066;Níjar;31458;17679;13779;2021
04;Almería;067;Ohanes;561;292;269;2021
04;Almería;068;Olula de Castro;190;106;84;2021
04;Almería;069;Olula del Río;6258;3201;3057;2021
04;Almería;070;Oria;2215;1145;1070;2021
04;Almería;071;Padules;436;237;199;2021
04;Almería;072;Partaloa;1065;527;538;2021
04;Almería;073;Paterna del Río;387;220;167;2021
04;Almería;074;Pechina;4143;2102;2041;2021
04;Almería;075;Pulpí;10342;5297;5045;2021
04;Almería;076;Purchena;1636;854;782;2021
04;Almería;077;Rágol;305;154;151;2021
04;Almería;078;Rioja;1488;761;727;2021
04;Almería;079;Roquetas de Mar;98725;50709;48016;2021
04;Almería;080;Santa Cruz de Marchena;203;104;99;2021
04;Almería;081;Santa Fe de Mondújar;477;257;220;2021
04;Almería;082;Senés;291;162;129;2021
04;Almería;083;Serón;2039;1044;995;2021
04;Almería;084;Sierro;380;202;178;2021
04;Almería;085;Somontín;444;221;223;2021
04;Almería;086;Sorbas;2471;1285;1186;2021
04;Almería;087;Suflí;197;111;86;2021
04;Almería;088;Tabernas;3887;2014;1873;2021
04;Almería;089;Taberno;996;488;508;2021
04;Almería;090;Tahal;349;180;169;2021
04;Almería;091;Terque;372;195;177;2021
04;Almería;092;Tíjola;3528;1773;1755;2021
04;Almería;901;Tres Villas, Las;564;310;254;2021
04;Almería;093;Turre;3892;2021;1871;2021
04;Almería;094;Turrillas;260;146;114;2021
04;Almería;095;Uleila del Campo;816;401;415;2021
04;Almería;096;Urrácal;369;190;179;2021
04;Almería;097;Velefique;235;132;103;2021
04;Almería;098;Vélez-Blanco;1946;992;954;2021
04;Almería;099;Vélez-Rubio;6521;3188;3333;2021
04;Almería;100;Vera;17700;9009;8691;2021
04;Almería;101;Viator;6039;3099;2940;2021
04;Almería;102;Vícar;27398;14898;12500;2021
04;Almería;103;Zurgena;2895;1466;1429;2021
01;Araba/Álava;051;Agurain/Salvatierra;5029;2522;2507;2021
01;Araba/Álava;001;Alegría-Dulantzi;2925;1517;1408;2021
01;Araba/Álava;002;Amurrio;10307;5084;5223;2021
01;Araba/Álava;049;Añana;155;94;61;2021
01;Araba/Álava;003;Aramaio;1456;756;700;2021
01;Araba/Álava;006;Armiñón;231;117;114;2021
01;Araba/Álava;037;Arraia-Maeztu;800;447;353;2021
01;Araba/Álava;008;Arratzua-Ubarrundia;1017;550;467;2021
01;Araba/Álava;004;Artziniega;1809;888;921;2021
01;Araba/Álava;009;Asparrena;1633;830;803;2021
01;Araba/Álava;010;Ayala/Aiara;2951;1502;1449;2021
01;Araba/Álava;011;Baños de Ebro/Mañueta;287;158;129;2021
01;Araba/Álava;013;Barrundia;895;493;402;2021
01;Araba/Álava;014;Berantevilla;465;242;223;2021
01;Araba/Álava;016;Bernedo;538;314;224;2021
01;Araba/Álava;017;Campezo/Kanpezu;1081;576;505;2021
01;Araba/Álava;021;Elburgo/Burgelu;634;332;302;2021
01;Araba/Álava;022;Elciego;996;499;497;2021
01;Araba/Álava;023;Elvillar/Bilar;327;159;168;2021
01;Araba/Álava;047;Erriberabeitia;1421;764;657;2021
01;Araba/Álava;046;Erriberagoitia/Ribera Alta;826;475;351;2021
01;Araba/Álava;056;Harana/Valle de Arana;226;125;101;2021
01;Araba/Álava;901;Iruña Oka/Iruña de Oca;3468;1825;1643;2021
01;Araba/Álava;027;Iruraiz-Gauna;529;290;239;2021
01;Araba/Álava;019;Kripan;175;91;84;2021
01;Araba/Álava;020;Kuartango;396;227;169;2021
01;Araba/Álava;028;Labastida/Bastida;1532;789;743;2021
01;Araba/Álava;030;Lagrán;171;97;74;2021
01;Araba/Álava;031;Laguardia;1464;751;713;2021
01;Araba/Álava;032;Lanciego/Lantziego;692;366;326;2021
01;Araba/Álava;902;Lantarón;915;514;401;2021
01;Araba/Álava;033;Lapuebla de Labarca;858;436;422;2021
01;Araba/Álava;036;Laudio/Llodio;18009;8767;9242;2021
01;Araba/Álava;058;Legutio;1993;1054;939;2021
01;Araba/Álava;034;Leza;219;112;107;2021
01;Araba/Álava;039;Moreda de Álava/Moreda Araba;209;107;102;2021
01;Araba/Álava;041;Navaridas;197;111;86;2021
01;Araba/Álava;042;Okondo;1196;626;570;2021
01;Araba/Álava;043;Oyón-Oion;3418;1737;1681;2021
01;Araba/Álava;044;Peñacerrada-Urizaharra;299;177;122;2021
01;Araba/Álava;052;Samaniego;308;147;161;2021
01;Araba/Álava;053;San Millán/Donemiliaga;716;389;327;2021
01;Araba/Álava;054;Urkabustaiz;1414;733;681;2021
01;Araba/Álava;055;Valdegovía/Gaubea;1049;568;481;2021
01;Araba/Álava;057;Villabuena de Álava/Eskuernaga;287;148;139;2021
01;Araba/Álava;059;Vitoria-Gasteiz;253093;123092;130001;2021
01;Araba/Álava;060;Yécora/Iekora;266;135;131;2021
01;Araba/Álava;061;Zalduondo;192;105;87;2021
01;Araba/Álava;062;Zambrana;432;231;201;2021
01;Araba/Álava;018;Zigoitia;1802;972;830;2021
01;Araba/Álava;063;Zuia;2318;1211;1107;2021
33;Asturias;001;Allande;1620;800;820;2021
33;Asturias;002;Aller;10346;5109;5237;2021
33;Asturias;003;Amieva;616;353;263;2021
33;Asturias;004;Avilés;76874;36292;40582;2021
33;Asturias;005;Belmonte de Miranda;1439;770;669;2021
33;Asturias;006;Bimenes;1691;816;875;2021
33;Asturias;007;Boal;1452;732;720;2021
33;Asturias;008;Cabrales;1942;977;965;2021
33;Asturias;009;Cabranes;1111;565;546;2021
33;Asturias;010;Candamo;1967;964;1003;2021
33;Asturias;012;Cangas de Onís;6195;2996;3199;2021
33;Asturias;011;Cangas del Narcea;11966;5865;6101;2021
33;Asturias;013;Caravia;507;269;238;2021
33;Asturias;014;Carreño;10288;4970;5318;2021
33;Asturias;015;Caso;1441;824;617;2021
33;Asturias;016;Castrillón;22299;10809;11490;2021
33;Asturias;017;Castropol;3335;1631;1704;2021
33;Asturias;018;Coaña;3312;1621;1691;2021
33;Asturias;019;Colunga;3236;1600;1636;2021
33;Asturias;020;Corvera de Asturias;15570;7614;7956;2021
33;Asturias;021;Cudillero;4968;2461;2507;2021
33;Asturias;022;Degaña;852;433;419;2021
33;Asturias;023;Franco, El;3780;1850;1930;2021
33;Asturias;024;Gijón;268896;126485;142411;2021
33;Asturias;025;Gozón;10412;5099;5313;2021
33;Asturias;026;Grado;9644;4692;4952;2021
33;Asturias;027;Grandas de Salime;792;403;389;2021
33;Asturias;028;Ibias;1182;679;503;2021
33;Asturias;029;Illano;320;162;158;2021
33;Asturias;030;Illas;1045;529;516;2021
33;Asturias;031;Langreo;38683;18413;20270;2021
33;Asturias;032;Laviana;12754;6136;6618;2021
33;Asturias;033;Lena;10596;5112;5484;2021
33;Asturias;035;Llanera;13790;6828;6962;2021
33;Asturias;036;Llanes;13611;6632;6979;2021
33;Asturias;037;Mieres;37026;17576;19450;2021
33;Asturias;038;Morcín;2543;1271;1272;2021
33;Asturias;039;Muros de Nalón;1921;921;1000;2021
33;Asturias;040;Nava;5264;2585;2679;2021
33;Asturias;041;Navia;8302;4008;4294;2021
33;Asturias;042;Noreña;5113;2445;2668;2021
33;Asturias;043;Onís;729;393;336;2021
33;Asturias;044;Oviedo;217552;100622;116930;2021
33;Asturias;045;Parres;5292;2585;2707;2021
33;Asturias;046;Peñamellera Alta;512;279;233;2021
33;Asturias;047;Peñamellera Baja;1244;617;627;2021
33;Asturias;048;Pesoz;141;78;63;2021
33;Asturias;049;Piloña;6921;3400;3521;2021
33;Asturias;050;Ponga;574;339;235;2021
33;Asturias;051;Pravia;7936;3868;4068;2021
33;Asturias;052;Proaza;722;423;299;2021
33;Asturias;053;Quirós;1207;701;506;2021
33;Asturias;054;Regueras, Las;1877;951;926;2021
33;Asturias;055;Ribadedeva;1724;832;892;2021
33;Asturias;056;Ribadesella;5686;2696;2990;2021
33;Asturias;057;Ribera de Arriba;1851;939;912;2021
33;Asturias;058;Riosa;1836;933;903;2021
33;Asturias;059;Salas;4878;2410;2468;2021
33;Asturias;061;San Martín de Oscos;353;180;173;2021
33;Asturias;060;San Martín del Rey Aurelio;15665;7523;8142;2021
33;Asturias;063;San Tirso de Abres;419;205;214;2021
33;Asturias;062;Santa Eulalia de Oscos;434;221;213;2021
33;Asturias;064;Santo Adriano;277;138;139;2021
33;Asturias;065;Sariego;1297;628;669;2021
33;Asturias;066;Siero;51608;25270;26338;2021
33;Asturias;067;Sobrescobio;829;440;389;2021
33;Asturias;068;Somiedo;1104;651;453;2021
33;Asturias;069;Soto del Barco;3850;1895;1955;2021
33;Asturias;070;Tapia de Casariego;3683;1788;1895;2021
33;Asturias;071;Taramundi;592;278;314;2021
33;Asturias;072;Teverga;1584;866;718;2021
33;Asturias;073;Tineo;9096;4608;4488;2021
33;Asturias;034;Valdés;11281;5540;5741;2021
33;Asturias;074;Vegadeo;3914;1872;2042;2021
33;Asturias;075;Villanueva de Oscos;275;138;137;2021
33;Asturias;076;Villaviciosa;14869;7394;7475;2021
33;Asturias;077;Villayón;1151;599;552;2021
33;Asturias;078;Yernes y Tameza;128;68;60;2021
05;Ávila;001;Adanero;196;106;90;2021
05;Ávila;002;Adrada, La;2757;1408;1349;2021
05;Ávila;005;Albornos;172;88;84;2021
05;Ávila;007;Aldeanueva de Santa Cruz;113;59;54;2021
05;Ávila;008;Aldeaseca;219;105;114;2021
05;Ávila;010;Aldehuela, La;147;75;72;2021
05;Ávila;012;Amavida;128;72;56;2021
05;Ávila;013;Arenal, El;943;473;470;2021
05;Ávila;014;Arenas de San Pedro;6434;3118;3316;2021
05;Ávila;015;Arevalillo;67;32;35;2021
05;Ávila;016;Arévalo;7881;3838;4043;2021
05;Ávila;017;Aveinte;82;48;34;2021
05;Ávila;018;Avellaneda;26;15;11;2021
05;Ávila;019;Ávila;57949;27608;30341;2021
05;Ávila;021;Barco de Ávila, El;2298;1103;1195;2021
05;Ávila;022;Barraco, El;1973;1010;963;2021
05;Ávila;023;Barromán;181;96;85;2021
05;Ávila;024;Becedas;183;94;89;2021
05;Ávila;025;Becedillas;77;40;37;2021
05;Ávila;026;Bercial de Zapardiel;195;102;93;2021
05;Ávila;027;Berlanas, Las;334;177;157;2021
05;Ávila;029;Bernuy-Zapardiel;90;51;39;2021
05;Ávila;030;Berrocalejo de Aragona;49;27;22;2021
05;Ávila;033;Blascomillán;181;94;87;2021
05;Ávila;034;Blasconuño de Matacabras;14;8;6;2021
05;Ávila;035;Blascosancho;101;50;51;2021
05;Ávila;036;Bohodón, El;117;63;54;2021
05;Ávila;037;Bohoyo;231;131;100;2021
05;Ávila;038;Bonilla de la Sierra;131;78;53;2021
05;Ávila;039;Brabos;42;26;16;2021
05;Ávila;040;Bularros;63;42;21;2021
05;Ávila;041;Burgohondo;1231;651;580;2021
05;Ávila;042;Cabezas de Alambre;160;76;84;2021
05;Ávila;043;Cabezas del Pozo;68;36;32;2021
05;Ávila;044;Cabezas del Villar;257;141;116;2021
05;Ávila;045;Cabizuela;80;43;37;2021
05;Ávila;046;Canales;39;23;16;2021
05;Ávila;047;Candeleda;5049;2550;2499;2021
05;Ávila;048;Cantiveros;100;60;40;2021
05;Ávila;049;Cardeñosa;427;231;196;2021
05;Ávila;051;Carrera, La;164;92;72;2021
05;Ávila;052;Casas del Puerto;83;45;38;2021
05;Ávila;053;Casasola;68;40;28;2021
05;Ávila;054;Casavieja;1422;731;691;2021
05;Ávila;055;Casillas;646;348;298;2021
05;Ávila;056;Castellanos de Zapardiel;94;54;40;2021
05;Ávila;057;Cebreros;3246;1690;1556;2021
05;Ávila;058;Cepeda la Mora;70;40;30;2021
05;Ávila;067;Chamartín;68;41;27;2021
05;Ávila;059;Cillán;82;50;32;2021
05;Ávila;060;Cisla;104;55;49;2021
05;Ávila;061;Colilla, La;341;175;166;2021
05;Ávila;062;Collado de Contreras;158;80;78;2021
05;Ávila;063;Collado del Mirón;29;19;10;2021
05;Ávila;064;Constanzana;107;61;46;2021
05;Ávila;065;Crespos;494;263;231;2021
05;Ávila;066;Cuevas del Valle;514;284;230;2021
05;Ávila;903;Diego del Carpio;117;66;51;2021
05;Ávila;069;Donjimeno;72;39;33;2021
05;Ávila;070;Donvidas;30;18;12;2021
05;Ávila;072;Espinosa de los Caballeros;109;56;53;2021
05;Ávila;073;Flores de Ávila;287;156;131;2021
05;Ávila;074;Fontiveros;734;383;351;2021
05;Ávila;075;Fresnedilla;110;57;53;2021
05;Ávila;076;Fresno, El;589;316;273;2021
05;Ávila;077;Fuente el Saúz;157;89;68;2021
05;Ávila;078;Fuentes de Año;96;55;41;2021
05;Ávila;079;Gallegos de Altamiros;63;36;27;2021
05;Ávila;080;Gallegos de Sobrinos;36;18;18;2021
05;Ávila;081;Garganta del Villar;42;28;14;2021
05;Ávila;082;Gavilanes;576;306;270;2021
05;Ávila;083;Gemuño;147;76;71;2021
05;Ávila;085;Gil García;42;19;23;2021
05;Ávila;084;Gilbuena;60;36;24;2021
05;Ávila;086;Gimialcón;74;46;28;2021
05;Ávila;087;Gotarrendura;169;63;106;2021
05;Ávila;088;Grandes y San Martín;26;13;13;2021
05;Ávila;089;Guisando;522;261;261;2021
05;Ávila;090;Gutierre-Muñoz;71;37;34;2021
05;Ávila;092;Hernansancho;156;90;66;2021
05;Ávila;093;Herradón de Pinares;436;243;193;2021
05;Ávila;094;Herreros de Suso;131;72;59;2021
05;Ávila;095;Higuera de las Dueñas;266;150;116;2021
05;Ávila;096;Hija de Dios, La;80;48;32;2021
05;Ávila;097;Horcajada, La;495;257;238;2021
05;Ávila;099;Horcajo de las Torres;481;273;208;2021
05;Ávila;100;Hornillo, El;281;149;132;2021
05;Ávila;102;Hoyo de Pinares, El;2163;1106;1057;2021
05;Ávila;101;Hoyocasero;278;164;114;2021
05;Ávila;103;Hoyorredondo;60;31;29;2021
05;Ávila;106;Hoyos de Miguel Muñoz;26;13;13;2021
05;Ávila;104;Hoyos del Collado;31;18;13;2021
05;Ávila;105;Hoyos del Espino;371;194;177;2021
05;Ávila;107;Hurtumpascual;45;28;17;2021
05;Ávila;108;Junciana;40;24;16;2021
05;Ávila;109;Langa;467;244;223;2021
05;Ávila;110;Lanzahíta;815;423;392;2021
05;Ávila;113;Llanos de Tormes, Los;58;30;28;2021
05;Ávila;112;Losar del Barco, El;109;60;49;2021
05;Ávila;114;Madrigal de las Altas Torres;1380;698;682;2021
05;Ávila;115;Maello;636;336;300;2021
05;Ávila;116;Malpartida de Corneja;90;45;45;2021
05;Ávila;117;Mamblas;202;114;88;2021
05;Ávila;118;Mancera de Arriba;72;41;31;2021
05;Ávila;119;Manjabálago y Ortigosa de Rioalmar;21;12;9;2021
05;Ávila;120;Marlín;32;21;11;2021
05;Ávila;121;Martiherrero;336;172;164;2021
05;Ávila;122;Martínez;111;59;52;2021
05;Ávila;123;Mediana de Voltoya;119;58;61;2021
05;Ávila;124;Medinilla;104;48;56;2021
05;Ávila;125;Mengamuñoz;59;28;31;2021
05;Ávila;126;Mesegar de Corneja;57;34;23;2021
05;Ávila;127;Mijares;743;402;341;2021
05;Ávila;128;Mingorría;377;196;181;2021
05;Ávila;129;Mirón, El;114;70;44;2021
05;Ávila;130;Mironcillo;105;54;51;2021
05;Ávila;131;Mirueña de los Infanzones;84;49;35;2021
05;Ávila;132;Mombeltrán;934;483;451;2021
05;Ávila;133;Monsalupe;60;32;28;2021
05;Ávila;134;Moraleja de Matacabras;52;28;24;2021
05;Ávila;135;Muñana;342;188;154;2021
05;Ávila;136;Muñico;80;45;35;2021
05;Ávila;138;Muñogalindo;325;161;164;2021
05;Ávila;139;Muñogrande;71;40;31;2021
05;Ávila;140;Muñomer del Peco;108;56;52;2021
05;Ávila;141;Muñopepe;99;55;44;2021
05;Ávila;142;Muñosancho;91;46;45;2021
05;Ávila;143;Muñotello;66;30;36;2021
05;Ávila;144;Narrillos del Álamo;71;37;34;2021
05;Ávila;145;Narrillos del Rebollar;38;24;14;2021
05;Ávila;149;Narros de Saldueña;106;59;47;2021
05;Ávila;147;Narros del Castillo;159;88;71;2021
05;Ávila;148;Narros del Puerto;29;16;13;2021
05;Ávila;152;Nava de Arévalo;714;370;344;2021
05;Ávila;153;Nava del Barco;79;41;38;2021
05;Ávila;151;Navacepedilla de Corneja;91;49;42;2021
05;Ávila;154;Navadijos;32;21;11;2021
05;Ávila;155;Navaescurial;46;28;18;2021
05;Ávila;156;Navahondilla;358;216;142;2021
05;Ávila;157;Navalacruz;221;123;98;2021
05;Ávila;158;Navalmoral;340;178;162;2021
05;Ávila;159;Navalonguilla;209;105;104;2021
05;Ávila;160;Navalosa;322;182;140;2021
05;Ávila;161;Navalperal de Pinares;765;409;356;2021
05;Ávila;162;Navalperal de Tormes;87;50;37;2021
05;Ávila;163;Navaluenga;2135;1068;1067;2021
05;Ávila;164;Navaquesera;22;10;12;2021
05;Ávila;165;Navarredonda de Gredos;424;216;208;2021
05;Ávila;166;Navarredondilla;175;86;89;2021
05;Ávila;167;Navarrevisca;272;153;119;2021
05;Ávila;168;Navas del Marqués, Las;5231;2676;2555;2021
05;Ávila;169;Navatalgordo;243;136;107;2021
05;Ávila;170;Navatejares;55;25;30;2021
05;Ávila;171;Neila de San Miguel;65;35;30;2021
05;Ávila;172;Niharra;188;114;74;2021
05;Ávila;173;Ojos-Albos;82;47;35;2021
05;Ávila;174;Orbita;73;43;30;2021
05;Ávila;175;Oso, El;149;85;64;2021
05;Ávila;176;Padiernos;280;153;127;2021
05;Ávila;177;Pajares de Adaja;137;74;63;2021
05;Ávila;178;Palacios de Goda;387;208;179;2021
05;Ávila;179;Papatrigo;228;110;118;2021
05;Ávila;180;Parral, El;61;36;25;2021
05;Ávila;181;Pascualcobo;41;27;14;2021
05;Ávila;182;Pedro Bernardo;807;425;382;2021
05;Ávila;183;Pedro-Rodríguez;135;68;67;2021
05;Ávila;184;Peguerinos;273;156;117;2021
05;Ávila;185;Peñalba de Ávila;116;63;53;2021
05;Ávila;186;Piedrahíta;1754;848;906;2021
05;Ávila;187;Piedralaves;2136;1067;1069;2021
05;Ávila;188;Poveda;38;23;15;2021
05;Ávila;189;Poyales del Hoyo;428;231;197;2021
05;Ávila;190;Pozanco;49;29;20;2021
05;Ávila;191;Pradosegar;104;56;48;2021
05;Ávila;192;Puerto Castilla;114;70;44;2021
05;Ávila;193;Rasueros;168;94;74;2021
05;Ávila;194;Riocabado;131;76;55;2021
05;Ávila;195;Riofrío;196;120;76;2021
05;Ávila;196;Rivilla de Barajas;67;32;35;2021
05;Ávila;197;Salobral;118;62;56;2021
05;Ávila;198;Salvadiós;67;33;34;2021
05;Ávila;199;San Bartolomé de Béjar;44;22;22;2021
05;Ávila;200;San Bartolomé de Corneja;40;24;16;2021
05;Ávila;201;San Bartolomé de Pinares;521;284;237;2021
05;Ávila;206;San Esteban de los Patos;23;15;8;2021
05;Ávila;208;San Esteban de Zapardiel;45;25;20;2021
05;Ávila;207;San Esteban del Valle;736;385;351;2021
05;Ávila;209;San García de Ingelmos;71;45;26;2021
05;Ávila;901;San Juan de Gredos;255;144;111;2021
05;Ávila;210;San Juan de la Encinilla;74;37;37;2021
05;Ávila;211;San Juan de la Nava;466;258;208;2021
05;Ávila;212;San Juan del Molinillo;206;116;90;2021
05;Ávila;213;San Juan del Olmo;85;57;28;2021
05;Ávila;214;San Lorenzo de Tormes;33;17;16;2021
05;Ávila;215;San Martín de la Vega del Alberche;163;94;69;2021
05;Ávila;216;San Martín del Pimpollar;188;113;75;2021
05;Ávila;217;San Miguel de Corneja;53;30;23;2021
05;Ávila;218;San Miguel de Serrezuela;112;58;54;2021
05;Ávila;219;San Pascual;43;25;18;2021
05;Ávila;220;San Pedro del Arroyo;445;236;209;2021
05;Ávila;231;San Vicente de Arévalo;172;94;78;2021
05;Ávila;204;Sanchidrián;727;372;355;2021
05;Ávila;205;Sanchorreja;85;41;44;2021
05;Ávila;222;Santa Cruz de Pinares;162;92;70;2021
05;Ávila;221;Santa Cruz del Valle;324;168;156;2021
05;Ávila;226;Santa María de los Caballeros;66;41;25;2021
05;Ávila;224;Santa María del Arroyo;105;56;49;2021
05;Ávila;225;Santa María del Berrocal;373;198;175;2021
05;Ávila;902;Santa María del Cubillo;314;178;136;2021
05;Ávila;227;Santa María del Tiétar;484;256;228;2021
05;Ávila;228;Santiago del Collado;168;108;60;2021
05;Ávila;904;Santiago del Tormes;110;63;47;2021
05;Ávila;229;Santo Domingo de las Posadas;72;41;31;2021
05;Ávila;230;Santo Tomé de Zabarcos;69;39;30;2021
05;Ávila;232;Serrada, La;134;68;66;2021
05;Ávila;233;Serranillos;245;134;111;2021
05;Ávila;234;Sigeres;41;18;23;2021
05;Ávila;235;Sinlabajos;141;70;71;2021
05;Ávila;236;Solana de Ávila;112;63;49;2021
05;Ávila;237;Solana de Rioalmar;145;88;57;2021
05;Ávila;238;Solosancho;815;439;376;2021
05;Ávila;239;Sotalbo;230;134;96;2021
05;Ávila;240;Sotillo de la Adrada;4721;2330;2391;2021
05;Ávila;241;Tiemblo, El;4414;2237;2177;2021
05;Ávila;242;Tiñosillos;766;397;369;2021
05;Ávila;243;Tolbaños;76;45;31;2021
05;Ávila;244;Tormellas;37;23;14;2021
05;Ávila;245;Tornadizos de Ávila;429;216;213;2021
05;Ávila;247;Torre, La;219;118;101;2021
05;Ávila;246;Tórtoles;47;26;21;2021
05;Ávila;249;Umbrías;103;53;50;2021
05;Ávila;251;Vadillo de la Sierra;58;40;18;2021
05;Ávila;252;Valdecasa;60;36;24;2021
05;Ávila;253;Vega de Santa María;71;39;32;2021
05;Ávila;254;Velayos;212;106;106;2021
05;Ávila;256;Villaflor;103;56;47;2021
05;Ávila;257;Villafranca de la Sierra;141;79;62;2021
05;Ávila;905;Villanueva de Ávila;217;113;104;2021
05;Ávila;258;Villanueva de Gómez;116;67;49;2021
05;Ávila;259;Villanueva del Aceral;105;49;56;2021
05;Ávila;260;Villanueva del Campillo;107;59;48;2021
05;Ávila;261;Villar de Corneja;37;22;15;2021
05;Ávila;262;Villarejo del Valle;332;176;156;2021
05;Ávila;263;Villatoro;159;93;66;2021
05;Ávila;264;Viñegra de Moraña;50;28;22;2021
05;Ávila;265;Vita;80;48;32;2021
05;Ávila;266;Zapardiel de la Cañada;85;47;38;2021
05;Ávila;267;Zapardiel de la Ribera;100;54;46;2021
06;Badajoz;001;Acedera;820;419;401;2021
06;Badajoz;002;Aceuchal;5467;2725;2742;2021
06;Badajoz;003;Ahillones;851;424;427;2021
06;Badajoz;004;Alange;1850;948;902;2021
06;Badajoz;005;Albuera, La;2026;1054;972;2021
06;Badajoz;006;Alburquerque;5245;2614;2631;2021
06;Badajoz;007;Alconchel;1654;833;821;2021
06;Badajoz;008;Alconera;744;367;377;2021
06;Badajoz;009;Aljucén;250;138;112;2021
06;Badajoz;010;Almendral;1223;609;614;2021
06;Badajoz;011;Almendralejo;33741;16700;17041;2021
06;Badajoz;012;Arroyo de San Serván;4081;2066;2015;2021
06;Badajoz;013;Atalaya;288;150;138;2021
06;Badajoz;014;Azuaga;7702;3817;3885;2021
06;Badajoz;015;Badajoz;150610;72942;77668;2021
06;Badajoz;016;Barcarrota;3498;1779;1719;2021
06;Badajoz;017;Baterno;258;140;118;2021
06;Badajoz;018;Benquerencia de la Serena;808;405;403;2021
06;Badajoz;019;Berlanga;2306;1141;1165;2021
06;Badajoz;020;Bienvenida;2087;1074;1013;2021
06;Badajoz;021;Bodonal de la Sierra;1017;518;499;2021
06;Badajoz;022;Burguillos del Cerro;3076;1518;1558;2021
06;Badajoz;023;Cabeza del Buey;4732;2351;2381;2021
06;Badajoz;024;Cabeza la Vaca;1298;665;633;2021
06;Badajoz;025;Calamonte;6152;3034;3118;2021
06;Badajoz;026;Calera de León;946;479;467;2021
06;Badajoz;027;Calzadilla de los Barros;721;358;363;2021
06;Badajoz;028;Campanario;4823;2375;2448;2021
06;Badajoz;029;Campillo de Llerena;1333;666;667;2021
06;Badajoz;030;Capilla;165;84;81;2021
06;Badajoz;031;Carmonita;532;267;265;2021
06;Badajoz;032;Carrascalejo, El;90;43;47;2021
06;Badajoz;033;Casas de Don Pedro;1456;747;709;2021
06;Badajoz;034;Casas de Reina;202;102;100;2021
06;Badajoz;035;Castilblanco;903;461;442;2021
06;Badajoz;036;Castuera;5708;2817;2891;2021
06;Badajoz;042;Cheles;1172;571;601;2021
06;Badajoz;037;Codosera, La;2049;1068;981;2021
06;Badajoz;038;Cordobilla de Lácara;878;455;423;2021
06;Badajoz;039;Coronada, La;2175;1058;1117;2021
06;Badajoz;040;Corte de Peleas;1207;587;620;2021
06;Badajoz;041;Cristina;551;283;268;2021
06;Badajoz;043;Don Álvaro;784;416;368;2021
06;Badajoz;044;Don Benito;37275;18378;18897;2021
06;Badajoz;045;Entrín Bajo;552;283;269;2021
06;Badajoz;046;Esparragalejo;1474;729;745;2021
06;Badajoz;047;Esparragosa de la Serena;994;505;489;2021
06;Badajoz;048;Esparragosa de Lares;895;445;450;2021
06;Badajoz;049;Feria;1077;514;563;2021
06;Badajoz;050;Fregenal de la Sierra;4811;2349;2462;2021
06;Badajoz;051;Fuenlabrada de los Montes;1793;878;915;2021
06;Badajoz;052;Fuente de Cantos;4684;2332;2352;2021
06;Badajoz;053;Fuente del Arco;681;351;330;2021
06;Badajoz;054;Fuente del Maestre;6704;3320;3384;2021
06;Badajoz;055;Fuentes de León;2244;1104;1140;2021
06;Badajoz;056;Garbayuela;510;275;235;2021
06;Badajoz;057;Garlitos;554;287;267;2021
06;Badajoz;058;Garrovilla, La;2334;1147;1187;2021
06;Badajoz;059;Granja de Torrehermosa;1965;975;990;2021
06;Badajoz;903;Guadiana;2465;1212;1253;2021
06;Badajoz;060;Guareña;6812;3419;3393;2021
06;Badajoz;061;Haba, La;1206;601;605;2021
06;Badajoz;062;Helechosa de los Montes;612;341;271;2021
06;Badajoz;063;Herrera del Duque;3465;1745;1720;2021
06;Badajoz;064;Higuera de la Serena;937;479;458;2021
06;Badajoz;065;Higuera de Llerena;335;173;162;2021
06;Badajoz;066;Higuera de Vargas;1930;984;946;2021
06;Badajoz;067;Higuera la Real;2202;1108;1094;2021
06;Badajoz;068;Hinojosa del Valle;476;229;247;2021
06;Badajoz;069;Hornachos;3509;1753;1756;2021
06;Badajoz;070;Jerez de los Caballeros;9171;4512;4659;2021
06;Badajoz;071;Lapa, La;277;141;136;2021
06;Badajoz;073;Llera;823;424;399;2021
06;Badajoz;074;Llerena;5697;2821;2876;2021
06;Badajoz;072;Lobón;2760;1408;1352;2021
06;Badajoz;075;Magacela;511;264;247;2021
06;Badajoz;076;Maguilla;960;480;480;2021
06;Badajoz;077;Malcocinado;351;192;159;2021
06;Badajoz;078;Malpartida de la Serena;536;280;256;2021
06;Badajoz;079;Manchita;769;389;380;2021
06;Badajoz;080;Medellín;2247;1144;1103;2021
06;Badajoz;081;Medina de las Torres;1163;602;561;2021
06;Badajoz;082;Mengabril;489;268;221;2021
06;Badajoz;083;Mérida;59424;28920;30504;2021
06;Badajoz;084;Mirandilla;1247;624;623;2021
06;Badajoz;085;Monesterio;4267;2206;2061;2021
06;Badajoz;086;Montemolín;1365;661;704;2021
06;Badajoz;087;Monterrubio de la Serena;2312;1137;1175;2021
06;Badajoz;088;Montijo;15483;7636;7847;2021
06;Badajoz;089;Morera, La;714;366;348;2021
06;Badajoz;090;Nava de Santiago, La;933;472;461;2021
06;Badajoz;091;Navalvillar de Pela;4392;2200;2192;2021
06;Badajoz;092;Nogales;646;322;324;2021
06;Badajoz;093;Oliva de la Frontera;5083;2556;2527;2021
06;Badajoz;094;Oliva de Mérida;1710;868;842;2021
06;Badajoz;095;Olivenza;11871;5901;5970;2021
06;Badajoz;096;Orellana de la Sierra;255;132;123;2021
06;Badajoz;097;Orellana la Vieja;2627;1358;1269;2021
06;Badajoz;098;Palomas;673;335;338;2021
06;Badajoz;099;Parra, La;1322;685;637;2021
06;Badajoz;100;Peñalsordo;870;430;440;2021
06;Badajoz;101;Peraleda del Zaucejo;490;251;239;2021
06;Badajoz;102;Puebla de Alcocer;1174;574;600;2021
06;Badajoz;103;Puebla de la Calzada;5861;2949;2912;2021
06;Badajoz;104;Puebla de la Reina;719;355;364;2021
06;Badajoz;107;Puebla de Obando;1839;938;901;2021
06;Badajoz;108;Puebla de Sancho Pérez;2665;1355;1310;2021
06;Badajoz;105;Puebla del Maestre;665;347;318;2021
06;Badajoz;106;Puebla del Prior;469;241;228;2021
06;Badajoz;902;Pueblonuevo del Guadiana;1989;996;993;2021
06;Badajoz;109;Quintana de la Serena;4576;2309;2267;2021
06;Badajoz;110;Reina;151;79;72;2021
06;Badajoz;111;Rena;607;317;290;2021
06;Badajoz;112;Retamal de Llerena;432;225;207;2021
06;Badajoz;113;Ribera del Fresno;3268;1637;1631;2021
06;Badajoz;114;Risco;130;63;67;2021
06;Badajoz;115;Roca de la Sierra, La;1442;705;737;2021
06;Badajoz;116;Salvaleón;1692;848;844;2021
06;Badajoz;117;Salvatierra de los Barros;1608;788;820;2021
06;Badajoz;119;San Pedro de Mérida;852;439;413;2021
06;Badajoz;123;San Vicente de Alcántara;5340;2701;2639;2021
06;Badajoz;118;Sancti-Spíritus;163;91;72;2021
06;Badajoz;120;Santa Amalia;3957;1984;1973;2021
06;Badajoz;121;Santa Marta;4094;2047;2047;2021
06;Badajoz;122;Santos de Maimona, Los;8064;4056;4008;2021
06;Badajoz;124;Segura de León;1834;917;917;2021
06;Badajoz;125;Siruela;1852;937;915;2021
06;Badajoz;126;Solana de los Barros;2575;1282;1293;2021
06;Badajoz;127;Talarrubias;3355;1667;1688;2021
06;Badajoz;128;Talavera la Real;5311;2651;2660;2021
06;Badajoz;129;Táliga;674;331;343;2021
06;Badajoz;130;Tamurejo;211;108;103;2021
06;Badajoz;131;Torre de Miguel Sesmero;1235;631;604;2021
06;Badajoz;132;Torremayor;985;483;502;2021
06;Badajoz;133;Torremejía;2249;1167;1082;2021
06;Badajoz;134;Trasierra;617;326;291;2021
06;Badajoz;135;Trujillanos;1389;715;674;2021
06;Badajoz;136;Usagre;1761;869;892;2021
06;Badajoz;137;Valdecaballeros;1088;564;524;2021
06;Badajoz;901;Valdelacalzada;2731;1387;1344;2021
06;Badajoz;138;Valdetorres;1170;571;599;2021
06;Badajoz;139;Valencia de las Torres;519;274;245;2021
06;Badajoz;140;Valencia del Mombuey;715;366;349;2021
06;Badajoz;141;Valencia del Ventoso;1931;966;965;2021
06;Badajoz;146;Valle de la Serena;1160;585;575;2021
06;Badajoz;147;Valle de Matamoros;358;181;177;2021
06;Badajoz;148;Valle de Santa Ana;1129;552;577;2021
06;Badajoz;142;Valverde de Burguillos;278;146;132;2021
06;Badajoz;143;Valverde de Leganés;4157;2087;2070;2021
06;Badajoz;144;Valverde de Llerena;566;278;288;2021
06;Badajoz;145;Valverde de Mérida;1036;525;511;2021
06;Badajoz;149;Villafranca de los Barros;12534;6175;6359;2021
06;Badajoz;150;Villagarcía de la Torre;910;464;446;2021
06;Badajoz;151;Villagonzalo;1231;592;639;2021
06;Badajoz;152;Villalba de los Barros;1472;733;739;2021
06;Badajoz;153;Villanueva de la Serena;25837;12538;13299;2021
06;Badajoz;154;Villanueva del Fresno;3335;1671;1664;2021
06;Badajoz;156;Villar de Rena;1332;687;645;2021
06;Badajoz;155;Villar del Rey;2103;1137;966;2021
06;Badajoz;157;Villarta de los Montes;418;213;205;2021
06;Badajoz;158;Zafra;16786;8068;8718;2021
06;Badajoz;159;Zahínos;2780;1379;1401;2021
06;Badajoz;160;Zalamea de la Serena;3473;1745;1728;2021
06;Badajoz;162;Zarza, La;3380;1695;1685;2021
06;Badajoz;161;Zarza-Capilla;296;149;147;2021
07;Balears, Illes;002;Alaior;9477;4776;4701;2021
07;Balears, Illes;001;Alaró;5741;2777;2964;2021
07;Balears, Illes;003;Alcúdia;20651;10443;10208;2021
07;Balears, Illes;004;Algaida;5963;3026;2937;2021
07;Balears, Illes;005;Andratx;11571;5830;5741;2021
07;Balears, Illes;901;Ariany;897;458;439;2021
07;Balears, Illes;006;Artà;7984;3992;3992;2021
07;Balears, Illes;007;Banyalbufar;542;286;256;2021
07;Balears, Illes;008;Binissalem;8895;4472;4423;2021
07;Balears, Illes;009;Búger;1084;578;506;2021
07;Balears, Illes;010;Bunyola;7037;3456;3581;2021
07;Balears, Illes;011;Calvià;51567;25858;25709;2021
07;Balears, Illes;012;Campanet;2684;1352;1332;2021
07;Balears, Illes;013;Campos;11425;5698;5727;2021
07;Balears, Illes;014;Capdepera;12003;6078;5925;2021
07;Balears, Illes;064;Castell, Es;7530;3824;3706;2021
07;Balears, Illes;015;Ciutadella de Menorca;30638;15286;15352;2021
07;Balears, Illes;016;Consell;4243;2111;2132;2021
07;Balears, Illes;017;Costitx;1379;681;698;2021
07;Balears, Illes;018;Deià;674;327;347;2021
07;Balears, Illes;026;Eivissa;50643;25538;25105;2021
07;Balears, Illes;019;Escorca;181;110;71;2021
07;Balears, Illes;020;Esporles;5134;2544;2590;2021
07;Balears, Illes;021;Estellencs;326;173;153;2021
07;Balears, Illes;022;Felanitx;18164;9163;9001;2021
07;Balears, Illes;023;Ferreries;4892;2455;2437;2021
07;Balears, Illes;024;Formentera;11708;6121;5587;2021
07;Balears, Illes;025;Fornalutx;682;340;342;2021
07;Balears, Illes;027;Inca;33726;16940;16786;2021
07;Balears, Illes;028;Lloret de Vistalegre;1465;746;719;2021
07;Balears, Illes;029;Lloseta;6250;3131;3119;2021
07;Balears, Illes;030;Llubí;2385;1191;1194;2021
07;Balears, Illes;031;Llucmajor;38224;19355;18869;2021
07;Balears, Illes;033;Manacor;44809;22419;22390;2021
07;Balears, Illes;034;Mancor de la Vall;1569;792;777;2021
07;Balears, Illes;032;Maó-Mahón;29578;14399;15179;2021
07;Balears, Illes;035;Maria de la Salut;2242;1157;1085;2021
07;Balears, Illes;036;Marratxí;38357;19253;19104;2021
07;Balears, Illes;037;Mercadal, Es;5444;2768;2676;2021
07;Balears, Illes;902;Migjorn Gran, Es;1500;748;752;2021
07;Balears, Illes;038;Montuïri;3087;1551;1536;2021
07;Balears, Illes;039;Muro;7515;3827;3688;2021
07;Balears, Illes;040;Palma;419366;205249;214117;2021
07;Balears, Illes;041;Petra;3028;1498;1530;2021
07;Balears, Illes;044;Pobla, Sa;13873;6998;6875;2021
07;Balears, Illes;042;Pollença;16969;8474;8495;2021
07;Balears, Illes;043;Porreres;5624;2853;2771;2021
07;Balears, Illes;045;Puigpunyent;2057;1020;1037;2021
07;Balears, Illes;059;Salines, Ses;5010;2532;2478;2021
07;Balears, Illes;046;Sant Antoni de Portmany;27205;14274;12931;2021
07;Balears, Illes;049;Sant Joan;2185;1076;1109;2021
07;Balears, Illes;050;Sant Joan de Labritja;6635;3358;3277;2021
07;Balears, Illes;048;Sant Josep de sa Talaia;28299;14602;13697;2021
07;Balears, Illes;051;Sant Llorenç des Cardassar;8920;4477;4443;2021
07;Balears, Illes;052;Sant Lluís;6877;3503;3374;2021
07;Balears, Illes;053;Santa Eugènia;1724;860;864;2021
07;Balears, Illes;054;Santa Eulària des Riu;40038;20177;19861;2021
07;Balears, Illes;055;Santa Margalida;12767;6575;6192;2021
07;Balears, Illes;056;Santa María del Camí;7507;3754;3753;2021
07;Balears, Illes;057;Santanyí;12342;6201;6141;2021
07;Balears, Illes;058;Selva;4126;2036;2090;2021
07;Balears, Illes;047;Sencelles;3542;1791;1751;2021
07;Balears, Illes;060;Sineu;4122;2050;2072;2021
07;Balears, Illes;061;Sóller;13491;6720;6771;2021
07;Balears, Illes;062;Son Servera;11835;5886;5949;2021
07;Balears, Illes;063;Valldemossa;2042;1040;1002;2021
07;Balears, Illes;065;Vilafranca de Bonany;3558;1819;1739;2021
08;Barcelona;001;Abrera;12620;6373;6247;2021
08;Barcelona;002;Aguilar de Segarra;286;154;132;2021
08;Barcelona;014;Aiguafreda;2556;1239;1317;2021
08;Barcelona;003;Alella;9954;4879;5075;2021
08;Barcelona;004;Alpens;269;143;126;2021
08;Barcelona;005;Ametlla del Vallès, L';8787;4427;4360;2021
08;Barcelona;006;Arenys de Mar;15942;7749;8193;2021
08;Barcelona;007;Arenys de Munt;9191;4649;4542;2021
08;Barcelona;008;Argençola;220;114;106;2021
08;Barcelona;009;Argentona;12629;6280;6349;2021
08;Barcelona;010;Artés;5782;2908;2874;2021
08;Barcelona;011;Avià;2199;1100;1099;2021
08;Barcelona;012;Avinyó;2286;1148;1138;2021
08;Barcelona;013;Avinyonet del Penedès;1701;906;795;2021
08;Barcelona;015;Badalona;223006;110001;113005;2021
08;Barcelona;904;Badia del Vallès;13228;6473;6755;2021
08;Barcelona;016;Bagà;2145;1065;1080;2021
08;Barcelona;017;Balenyà;3900;1956;1944;2021
08;Barcelona;018;Balsareny;3278;1632;1646;2021
08;Barcelona;252;Barberà del Vallès;33016;16237;16779;2021
08;Barcelona;019;Barcelona;1636732;778744;857988;2021
08;Barcelona;020;Begues;7356;3685;3671;2021
08;Barcelona;021;Bellprat;73;46;27;2021
08;Barcelona;022;Berga;16682;8253;8429;2021
08;Barcelona;023;Bigues i Riells;9542;4850;4692;2021
08;Barcelona;024;Borredà;455;257;198;2021
08;Barcelona;025;Bruc, El;2177;1160;1017;2021
08;Barcelona;026;Brull, El;275;149;126;2021
08;Barcelona;027;Cabanyes, Les;1005;515;490;2021
08;Barcelona;028;Cabrera d'Anoia;1521;803;718;2021
08;Barcelona;029;Cabrera de Mar;4787;2399;2388;2021
08;Barcelona;030;Cabrils;7567;3752;3815;2021
08;Barcelona;031;Calaf;3597;1805;1792;2021
08;Barcelona;034;Calders;1063;539;524;2021
08;Barcelona;033;Caldes de Montbui;17797;8850;8947;2021
08;Barcelona;032;Caldes d'Estrac;3097;1472;1625;2021
08;Barcelona;035;Calella;19236;9356;9880;2021
08;Barcelona;037;Calldetenes;2504;1274;1230;2021
08;Barcelona;038;Callús;2098;1036;1062;2021
08;Barcelona;036;Calonge de Segarra;194;95;99;2021
08;Barcelona;039;Campins;540;277;263;2021
08;Barcelona;040;Canet de Mar;14810;7227;7583;2021
08;Barcelona;041;Canovelles;16872;8753;8119;2021
08;Barcelona;042;Cànoves i Samalús;3219;1642;1577;2021
08;Barcelona;043;Canyelles;4886;2533;2353;2021
08;Barcelona;044;Capellades;5314;2647;2667;2021
08;Barcelona;045;Capolat;84;40;44;2021
08;Barcelona;046;Cardedeu;18609;9066;9543;2021
08;Barcelona;047;Cardona;4593;2256;2337;2021
08;Barcelona;048;Carme;768;397;371;2021
08;Barcelona;049;Casserres;1636;812;824;2021
08;Barcelona;057;Castell de l'Areny;72;40;32;2021
08;Barcelona;052;Castellar de n'Hug;167;87;80;2021
08;Barcelona;050;Castellar del Riu;171;98;73;2021
08;Barcelona;051;Castellar del Vallès;24659;12192;12467;2021
08;Barcelona;053;Castellbell i el Vilar;3853;1985;1868;2021
08;Barcelona;054;Castellbisbal;12610;6348;6262;2021
08;Barcelona;055;Castellcir;753;392;361;2021
08;Barcelona;056;Castelldefels;67226;32930;34296;2021
08;Barcelona;058;Castellet i la Gornal;2452;1278;1174;2021
08;Barcelona;060;Castellfollit de Riubregós;163;88;75;2021
08;Barcelona;059;Castellfollit del Boix;448;233;215;2021
08;Barcelona;061;Castellgalí;2179;1143;1036;2021
08;Barcelona;062;Castellnou de Bages;1420;752;668;2021
08;Barcelona;063;Castellolí;653;317;336;2021
08;Barcelona;064;Castellterçol;2632;1333;1299;2021
08;Barcelona;065;Castellví de la Marca;1597;820;777;2021
08;Barcelona;066;Castellví de Rosanes;1996;986;1010;2021
08;Barcelona;067;Centelles;7595;3736;3859;2021
08;Barcelona;268;Cercs;1190;596;594;2021
08;Barcelona;266;Cerdanyola del Vallès;57217;27911;29306;2021
08;Barcelona;068;Cervelló;9233;4633;4600;2021
08;Barcelona;069;Collbató;4655;2414;2241;2021
08;Barcelona;070;Collsuspina;387;193;194;2021
08;Barcelona;071;Copons;322;158;164;2021
08;Barcelona;072;Corbera de Llobregat;15017;7532;7485;2021
08;Barcelona;073;Cornellà de Llobregat;89300;43334;45966;2021
08;Barcelona;074;Cubelles;16051;8073;7978;2021
08;Barcelona;075;Dosrius;5685;2867;2818;2021
08;Barcelona;076;Esparreguera;22358;11298;11060;2021
08;Barcelona;077;Esplugues de Llobregat;46777;22274;24503;2021
08;Barcelona;078;Espunyola, L';258;129;129;2021
08;Barcelona;254;Esquirol, L';2198;1109;1089;2021
08;Barcelona;079;Estany, L';408;215;193;2021
08;Barcelona;134;Figaró-Montmany;1127;550;577;2021
08;Barcelona;080;Fígols;46;27;19;2021
08;Barcelona;082;Fogars de la Selva;1540;793;747;2021
08;Barcelona;081;Fogars de Montclús;467;251;216;2021
08;Barcelona;083;Folgueroles;2269;1140;1129;2021
08;Barcelona;084;Fonollosa;1495;766;729;2021
08;Barcelona;085;Font-rubí;1440;752;688;2021
08;Barcelona;086;Franqueses del Vallès, Les;20351;10307;10044;2021
08;Barcelona;090;Gaià;189;102;87;2021
08;Barcelona;087;Gallifa;183;97;86;2021
08;Barcelona;088;Garriga, La;16733;8073;8660;2021
08;Barcelona;089;Gavà;46931;22963;23968;2021
08;Barcelona;091;Gelida;7723;3863;3860;2021
08;Barcelona;092;Gironella;4916;2434;2482;2021
08;Barcelona;093;Gisclareny;27;18;9;2021
08;Barcelona;094;Granada, La;2207;1106;1101;2021
08;Barcelona;095;Granera;85;55;30;2021
08;Barcelona;096;Granollers;62475;30903;31572;2021
08;Barcelona;097;Gualba;1585;805;780;2021
08;Barcelona;099;Guardiola de Berguedà;929;479;450;2021
08;Barcelona;100;Gurb;2705;1386;1319;2021
08;Barcelona;101;Hospitalet de Llobregat, L';264657;127991;136666;2021
08;Barcelona;162;Hostalets de Pierola, Els;3064;1547;1517;2021
08;Barcelona;102;Igualada;40875;20124;20751;2021
08;Barcelona;103;Jorba;825;422;403;2021
08;Barcelona;104;Llacuna, La;917;491;426;2021
08;Barcelona;105;Llagosta, La;13259;6515;6744;2021
08;Barcelona;107;Lliçà d'Amunt;15673;7992;7681;2021
08;Barcelona;108;Lliçà de Vall;6580;3361;3219;2021
08;Barcelona;106;Llinars del Vallès;10116;5039;5077;2021
08;Barcelona;109;Lluçà;271;134;137;2021
08;Barcelona;110;Malgrat de Mar;18950;9428;9522;2021
08;Barcelona;111;Malla;276;141;135;2021
08;Barcelona;112;Manlleu;20804;10491;10313;2021
08;Barcelona;113;Manresa;78192;38330;39862;2021
08;Barcelona;242;Marganell;271;135;136;2021
08;Barcelona;114;Martorell;28667;14623;14044;2021
08;Barcelona;115;Martorelles;4823;2434;2389;2021
08;Barcelona;116;Masies de Roda, Les;704;357;347;2021
08;Barcelona;117;Masies de Voltregà, Les;3178;1565;1613;2021
08;Barcelona;118;Masnou, El;23848;11505;12343;2021
08;Barcelona;119;Masquefa;9623;4904;4719;2021
08;Barcelona;120;Matadepera;9672;4844;4828;2021
08;Barcelona;121;Mataró;129120;64086;65034;2021
08;Barcelona;122;Mediona;2419;1228;1191;2021
08;Barcelona;138;Moià;6474;3329;3145;2021
08;Barcelona;123;Molins de Rei;26104;12718;13386;2021
08;Barcelona;124;Mollet del Vallès;51151;25180;25971;2021
08;Barcelona;128;Monistrol de Calders;716;380;336;2021
08;Barcelona;127;Monistrol de Montserrat;3178;1637;1541;2021
08;Barcelona;125;Montcada i Reixac;36794;18179;18615;2021
08;Barcelona;130;Montclar;136;70;66;2021
08;Barcelona;131;Montesquiu;1048;525;523;2021
08;Barcelona;126;Montgat;12260;6036;6224;2021
08;Barcelona;132;Montmajor;472;236;236;2021
08;Barcelona;133;Montmaneu;158;87;71;2021
08;Barcelona;135;Montmeló;8798;4288;4510;2021
08;Barcelona;136;Montornès del Vallès;16804;8482;8322;2021
08;Barcelona;137;Montseny;362;189;173;2021
08;Barcelona;129;Muntanyola;655;350;305;2021
08;Barcelona;139;Mura;231;121;110;2021
08;Barcelona;140;Navarcles;6068;2972;3096;2021
08;Barcelona;141;Navàs;5973;2951;3022;2021
08;Barcelona;142;Nou de Berguedà, La;176;94;82;2021
08;Barcelona;143;Òdena;3681;1896;1785;2021
08;Barcelona;145;Olèrdola;3847;1989;1858;2021
08;Barcelona;146;Olesa de Bonesvalls;1923;1004;919;2021
08;Barcelona;147;Olesa de Montserrat;24132;12061;12071;2021
08;Barcelona;148;Olivella;4127;2129;1998;2021
08;Barcelona;149;Olost;1190;578;612;2021
08;Barcelona;144;Olvan;874;425;449;2021
08;Barcelona;150;Orís;339;174;165;2021
08;Barcelona;151;Oristà;547;282;265;2021
08;Barcelona;152;Orpí;154;78;76;2021
08;Barcelona;153;Òrrius;779;397;382;2021
08;Barcelona;154;Pacs del Penedès;915;466;449;2021
08;Barcelona;155;Palafolls;9646;4840;4806;2021
08;Barcelona;156;Palau-solità i Plegamans;14917;7294;7623;2021
08;Barcelona;157;Pallejà;11636;5799;5837;2021
08;Barcelona;905;Palma de Cervelló, La;3015;1489;1526;2021
08;Barcelona;158;Papiol, El;4232;2102;2130;2021
08;Barcelona;159;Parets del Vallès;18907;9416;9491;2021
08;Barcelona;160;Perafita;412;211;201;2021
08;Barcelona;161;Piera;16411;8386;8025;2021
08;Barcelona;163;Pineda de Mar;27974;13933;14041;2021
08;Barcelona;164;Pla del Penedès, El;1306;656;650;2021
08;Barcelona;165;Pobla de Claramunt, La;2207;1124;1083;2021
08;Barcelona;166;Pobla de Lillet, La;1063;513;550;2021
08;Barcelona;167;Polinyà;8494;4309;4185;2021
08;Barcelona;182;Pont de Vilomara i Rocafort, El;4016;2072;1944;2021
08;Barcelona;168;Pontons;523;286;237;2021
08;Barcelona;169;Prat de Llobregat, El;65532;32073;33459;2021
08;Barcelona;171;Prats de Lluçanès;2634;1320;1314;2021
08;Barcelona;170;Prats de Rei, Els;551;296;255;2021
08;Barcelona;230;Premià de Dalt;10419;5203;5216;2021
08;Barcelona;172;Premià de Mar;28523;13902;14621;2021
08;Barcelona;174;Puigdàlber;551;265;286;2021
08;Barcelona;175;Puig-reig;4289;2120;2169;2021
08;Barcelona;176;Pujalt;206;114;92;2021
08;Barcelona;177;Quar, La;51;28;23;2021
08;Barcelona;178;Rajadell;549;278;271;2021
08;Barcelona;179;Rellinars;868;448;420;2021
08;Barcelona;180;Ripollet;39139;19350;19789;2021
08;Barcelona;181;Roca del Vallès, La;10676;5334;5342;2021
08;Barcelona;183;Roda de Ter;6449;3217;3232;2021
08;Barcelona;184;Rubí;78549;38782;39767;2021
08;Barcelona;185;Rubió;236;140;96;2021
08;Barcelona;901;Rupit i Pruit;296;149;147;2021
08;Barcelona;187;Sabadell;216204;105076;111128;2021
08;Barcelona;188;Sagàs;151;79;72;2021
08;Barcelona;190;Saldes;283;163;120;2021
08;Barcelona;191;Sallent;6717;3249;3468;2021
08;Barcelona;194;Sant Adrià de Besòs;37283;18357;18926;2021
08;Barcelona;195;Sant Agustí de Lluçanès;92;47;45;2021
08;Barcelona;196;Sant Andreu de la Barca;27175;13417;13758;2021
08;Barcelona;197;Sant Andreu de Llavaneres;11150;5518;5632;2021
08;Barcelona;198;Sant Antoni de Vilamajor;6383;3173;3210;2021
08;Barcelona;199;Sant Bartomeu del Grau;913;485;428;2021
08;Barcelona;200;Sant Boi de Llobregat;83755;40823;42932;2021
08;Barcelona;201;Sant Boi de Lluçanès;573;293;280;2021
08;Barcelona;203;Sant Cebrià de Vallalta;3570;1858;1712;2021
08;Barcelona;202;Sant Celoni;18176;9063;9113;2021
08;Barcelona;204;Sant Climent de Llobregat;4193;2099;2094;2021
08;Barcelona;205;Sant Cugat del Vallès;94012;45711;48301;2021
08;Barcelona;206;Sant Cugat Sesgarrigues;1004;494;510;2021
08;Barcelona;207;Sant Esteve de Palautordera;2997;1478;1519;2021
08;Barcelona;208;Sant Esteve Sesrovires;7771;3910;3861;2021
08;Barcelona;210;Sant Feliu de Codines;6406;3234;3172;2021
08;Barcelona;211;Sant Feliu de Llobregat;45463;22089;23374;2021
08;Barcelona;212;Sant Feliu Sasserra;617;329;288;2021
08;Barcelona;209;Sant Fost de Campsentelles;8997;4478;4519;2021
08;Barcelona;213;Sant Fruitós de Bages;8936;4401;4535;2021
08;Barcelona;215;Sant Hipòlit de Voltregà;3547;1788;1759;2021
08;Barcelona;193;Sant Iscle de Vallalta;1438;773;665;2021
08;Barcelona;216;Sant Jaume de Frontanyà;28;17;11;2021
08;Barcelona;218;Sant Joan de Vilatorrada;10871;5438;5433;2021
08;Barcelona;217;Sant Joan Despí;34130;16622;17508;2021
08;Barcelona;903;Sant Julià de Cerdanyola;235;131;104;2021
08;Barcelona;220;Sant Julià de Vilatorta;3152;1566;1586;2021
08;Barcelona;221;Sant Just Desvern;19379;9331;10048;2021
08;Barcelona;222;Sant Llorenç d'Hortons;2459;1244;1215;2021
08;Barcelona;223;Sant Llorenç Savall;2514;1262;1252;2021
08;Barcelona;225;Sant Martí d'Albars;107;53;54;2021
08;Barcelona;224;Sant Martí de Centelles;1186;609;577;2021
08;Barcelona;226;Sant Martí de Tous;1236;634;602;2021
08;Barcelona;227;Sant Martí Sarroca;3286;1616;1670;2021
08;Barcelona;228;Sant Martí Sesgueioles;344;182;162;2021
08;Barcelona;229;Sant Mateu de Bages;614;315;299;2021
08;Barcelona;231;Sant Pere de Ribes;31525;15727;15798;2021
08;Barcelona;232;Sant Pere de Riudebitlles;2411;1218;1193;2021
08;Barcelona;233;Sant Pere de Torelló;2488;1286;1202;2021
08;Barcelona;234;Sant Pere de Vilamajor;4671;2350;2321;2021
08;Barcelona;189;Sant Pere Sallavinera;159;84;75;2021
08;Barcelona;235;Sant Pol de Mar;5538;2750;2788;2021
08;Barcelona;236;Sant Quintí de Mediona;2367;1214;1153;2021
08;Barcelona;237;Sant Quirze de Besora;2145;1035;1110;2021
08;Barcelona;238;Sant Quirze del Vallès;20156;9875;10281;2021
08;Barcelona;239;Sant Quirze Safaja;660;361;299;2021
08;Barcelona;240;Sant Sadurní d'Anoia;12840;6315;6525;2021
08;Barcelona;241;Sant Sadurní d'Osormort;76;47;29;2021
08;Barcelona;098;Sant Salvador de Guardiola;3243;1646;1597;2021
08;Barcelona;262;Sant Vicenç de Castellet;9868;4959;4909;2021
08;Barcelona;264;Sant Vicenç de Montalt;6523;3280;3243;2021
08;Barcelona;265;Sant Vicenç de Torelló;2077;1031;1046;2021
08;Barcelona;263;Sant Vicenç dels Horts;28115;13930;14185;2021
08;Barcelona;243;Santa Cecília de Voltregà;179;99;80;2021
08;Barcelona;244;Santa Coloma de Cervelló;8273;4041;4232;2021
08;Barcelona;245;Santa Coloma de Gramenet;119289;58879;60410;2021
08;Barcelona;246;Santa Eugènia de Berga;2259;1149;1110;2021
08;Barcelona;247;Santa Eulàlia de Riuprimer;1409;705;704;2021
08;Barcelona;248;Santa Eulàlia de Ronçana;7538;3782;3756;2021
08;Barcelona;249;Santa Fe del Penedès;378;183;195;2021
08;Barcelona;250;Santa Margarida de Montbui;10192;5145;5047;2021
08;Barcelona;251;Santa Margarida i els Monjos;7664;3908;3756;2021
08;Barcelona;253;Santa Maria de Besora;161;85;76;2021
08;Barcelona;256;Santa Maria de Martorelles;882;442;440;2021
08;Barcelona;255;Santa Maria de Merlès;180;91;89;2021
08;Barcelona;257;Santa Maria de Miralles;129;69;60;2021
08;Barcelona;259;Santa Maria de Palautordera;9666;4852;4814;2021
08;Barcelona;258;Santa Maria d'Oló;1065;525;540;2021
08;Barcelona;260;Santa Perpètua de Mogoda;26033;13099;12934;2021
08;Barcelona;261;Santa Susanna;3650;1838;1812;2021
08;Barcelona;192;Santpedor;7566;3765;3801;2021
08;Barcelona;267;Sentmenat;9347;4731;4616;2021
08;Barcelona;269;Seva;3696;1903;1793;2021
08;Barcelona;270;Sitges;30217;15109;15108;2021
08;Barcelona;271;Sobremunt;78;33;45;2021
08;Barcelona;272;Sora;211;116;95;2021
08;Barcelona;273;Subirats;3149;1638;1511;2021
08;Barcelona;274;Súria;5923;2871;3052;2021
08;Barcelona;276;Tagamanent;325;162;163;2021
08;Barcelona;277;Talamanca;222;124;98;2021
08;Barcelona;278;Taradell;6687;3342;3345;2021
08;Barcelona;275;Tavèrnoles;329;165;164;2021
08;Barcelona;280;Tavertet;113;55;58;2021
08;Barcelona;281;Teià;6532;3227;3305;2021
08;Barcelona;279;Terrassa;223011;109645;113366;2021
08;Barcelona;282;Tiana;9009;4346;4663;2021
08;Barcelona;283;Tona;8368;4148;4220;2021
08;Barcelona;284;Tordera;17788;9012;8776;2021
08;Barcelona;285;Torelló;14553;7265;7288;2021
08;Barcelona;286;Torre de Claramunt, La;3852;1993;1859;2021
08;Barcelona;287;Torrelavit;1429;723;706;2021
08;Barcelona;288;Torrelles de Foix;2479;1315;1164;2021
08;Barcelona;289;Torrelles de Llobregat;6126;3030;3096;2021
08;Barcelona;290;Ullastrell;2096;1053;1043;2021
08;Barcelona;291;Vacarisses;7082;3653;3429;2021
08;Barcelona;292;Vallbona d'Anoia;1375;702;673;2021
08;Barcelona;293;Vallcebre;258;143;115;2021
08;Barcelona;294;Vallgorguina;3052;1553;1499;2021
08;Barcelona;295;Vallirana;15438;7724;7714;2021
08;Barcelona;296;Vallromanes;2594;1353;1241;2021
08;Barcelona;297;Veciana;179;97;82;2021
08;Barcelona;298;Vic;47319;23954;23365;2021
08;Barcelona;299;Vilada;424;230;194;2021
08;Barcelona;301;Viladecans;66707;32907;33800;2021
08;Barcelona;300;Viladecavalls;7621;3795;3826;2021
08;Barcelona;305;Vilafranca del Penedès;39969;19433;20536;2021
08;Barcelona;306;Vilalba Sasserra;758;386;372;2021
08;Barcelona;303;Vilanova de Sau;314;150;164;2021
08;Barcelona;302;Vilanova del Camí;12736;6382;6354;2021
08;Barcelona;902;Vilanova del Vallès;5535;2794;2741;2021
08;Barcelona;307;Vilanova i la Geltrú;67458;32616;34842;2021
08;Barcelona;214;Vilassar de Dalt;9074;4475;4599;2021
08;Barcelona;219;Vilassar de Mar;20936;10128;10808;2021
08;Barcelona;304;Vilobí del Penedès;1128;585;543;2021
08;Barcelona;308;Viver i Serrateix;175;88;87;2021
48;Bizkaia;001;Abadiño;7618;3829;3789;2021
48;Bizkaia;002;Abanto y Ciérvana-Abanto Zierbena;9436;4683;4753;2021
48;Bizkaia;911;Ajangiz;483;254;229;2021
48;Bizkaia;912;Alonsotegi;2944;1448;1496;2021
48;Bizkaia;003;Amorebieta-Etxano;19576;9643;9933;2021
48;Bizkaia;004;Amoroto;414;215;199;2021
48;Bizkaia;005;Arakaldo;160;76;84;2021
48;Bizkaia;006;Arantzazu;399;196;203;2021
48;Bizkaia;093;Areatza;1271;619;652;2021
48;Bizkaia;009;Arrankudiaga;989;485;504;2021
48;Bizkaia;914;Arratzu;424;203;221;2021
48;Bizkaia;010;Arrieta;575;298;277;2021
48;Bizkaia;011;Arrigorriaga;12140;5919;6221;2021
48;Bizkaia;023;Artea;742;377;365;2021
48;Bizkaia;008;Artzentales;726;384;342;2021
48;Bizkaia;091;Atxondo;1366;699;667;2021
48;Bizkaia;070;Aulesti;646;319;327;2021
48;Bizkaia;012;Bakio;2775;1400;1375;2021
48;Bizkaia;090;Balmaseda;7651;3675;3976;2021
48;Bizkaia;013;Barakaldo;100907;48656;52251;2021
48;Bizkaia;014;Barrika;1554;788;766;2021
48;Bizkaia;015;Basauri;40535;19551;20984;2021
48;Bizkaia;092;Bedia;1076;517;559;2021
48;Bizkaia;016;Berango;7271;3566;3705;2021
48;Bizkaia;017;Bermeo;16784;8250;8534;2021
48;Bizkaia;018;Berriatua;1232;673;559;2021
48;Bizkaia;019;Berriz;4537;2261;2276;2021
48;Bizkaia;020;Bilbao;346405;163802;182603;2021
48;Bizkaia;021;Busturia;1649;825;824;2021
48;Bizkaia;901;Derio;6780;3308;3472;2021
48;Bizkaia;026;Dima;1472;758;714;2021
48;Bizkaia;027;Durango;29935;14586;15349;2021
48;Bizkaia;028;Ea;820;435;385;2021
48;Bizkaia;031;Elantxobe;344;169;175;2021
48;Bizkaia;032;Elorrio;7383;3646;3737;2021
48;Bizkaia;902;Erandio;24489;11858;12631;2021
48;Bizkaia;033;Ereño;263;148;115;2021
48;Bizkaia;034;Ermua;15791;7823;7968;2021
48;Bizkaia;079;Errigoiti;489;262;227;2021
48;Bizkaia;029;Etxebarri;11664;5836;5828;2021
48;Bizkaia;030;Etxebarria;790;403;387;2021
48;Bizkaia;906;Forua;910;447;463;2021
48;Bizkaia;035;Fruiz;548;272;276;2021
48;Bizkaia;036;Galdakao;29404;14490;14914;2021
48;Bizkaia;037;Galdames;842;447;395;2021
48;Bizkaia;038;Gamiz-Fika;1383;695;688;2021
48;Bizkaia;039;Garai;329;164;165;2021
48;Bizkaia;040;Gatika;1674;843;831;2021
48;Bizkaia;041;Gautegiz Arteaga;854;426;428;2021
48;Bizkaia;046;Gernika-Lumo;17093;8226;8867;2021
48;Bizkaia;044;Getxo;77139;36176;40963;2021
48;Bizkaia;047;Gizaburuaga;200;103;97;2021
48;Bizkaia;042;Gordexola;1723;878;845;2021
48;Bizkaia;043;Gorliz;6022;2972;3050;2021
48;Bizkaia;045;Güeñes;6699;3246;3453;2021
48;Bizkaia;048;Ibarrangelu;670;344;326;2021
48;Bizkaia;094;Igorre;4314;2128;2186;2021
48;Bizkaia;049;Ispaster;754;397;357;2021
48;Bizkaia;910;Iurreta;3696;1814;1882;2021
48;Bizkaia;050;Izurtza;240;152;88;2021
48;Bizkaia;022;Karrantza Harana/Valle de Carranza;2759;1435;1324;2021
48;Bizkaia;907;Kortezubi;439;209;230;2021
48;Bizkaia;051;Lanestosa;261;142;119;2021
48;Bizkaia;052;Larrabetzu;2081;1021;1060;2021
48;Bizkaia;053;Laukiz;1237;602;635;2021
48;Bizkaia;054;Leioa;32188;15709;16479;2021
48;Bizkaia;057;Lekeitio;7271;3581;3690;2021
48;Bizkaia;055;Lemoa;3489;1746;1743;2021
48;Bizkaia;056;Lemoiz;1297;679;618;2021
48;Bizkaia;081;Lezama;2454;1226;1228;2021
48;Bizkaia;903;Loiu;2363;1194;1169;2021
48;Bizkaia;058;Mallabia;1172;595;577;2021
48;Bizkaia;059;Mañaria;521;261;260;2021
48;Bizkaia;060;Markina-Xemein;5072;2566;2506;2021
48;Bizkaia;061;Maruri-Jatabe;992;511;481;2021
48;Bizkaia;062;Mendata;379;199;180;2021
48;Bizkaia;063;Mendexa;422;215;207;2021
48;Bizkaia;064;Meñaka;753;395;358;2021
48;Bizkaia;066;Morga;408;214;194;2021
48;Bizkaia;068;Mundaka;1862;915;947;2021
48;Bizkaia;069;Mungia;17701;8618;9083;2021
48;Bizkaia;007;Munitibar-Arbatzegi Gerrikaitz;484;263;221;2021
48;Bizkaia;908;Murueta;323;168;155;2021
48;Bizkaia;071;Muskiz;7438;3617;3821;2021
48;Bizkaia;067;Muxika;1475;776;699;2021
48;Bizkaia;909;Nabarniz;267;130;137;2021
48;Bizkaia;073;Ondarroa;8326;4158;4168;2021
48;Bizkaia;075;Orozko;2658;1306;1352;2021
48;Bizkaia;083;Ortuella;8379;4080;4299;2021
48;Bizkaia;072;Otxandio;1359;697;662;2021
48;Bizkaia;077;Plentzia;4414;2145;2269;2021
48;Bizkaia;078;Portugalete;45285;21649;23636;2021
48;Bizkaia;082;Santurtzi;46085;22150;23935;2021
48;Bizkaia;084;Sestao;27342;13235;14107;2021
48;Bizkaia;904;Sondika;4555;2203;2352;2021
48;Bizkaia;085;Sopela;14276;7061;7215;2021
48;Bizkaia;086;Sopuerta;2638;1304;1334;2021
48;Bizkaia;076;Sukarrieta;347;187;160;2021
48;Bizkaia;087;Trucios-Turtzioz;502;262;240;2021
48;Bizkaia;088;Ubide;162;86;76;2021
48;Bizkaia;065;Ugao-Miraballes;4114;2066;2048;2021
48;Bizkaia;089;Urduliz;5034;2490;2544;2021
48;Bizkaia;074;Urduña/Orduña;4199;2165;2034;2021
48;Bizkaia;080;Valle de Trápaga-Trapagaran;11911;5788;6123;2021
48;Bizkaia;095;Zaldibar;3038;1533;1505;2021
48;Bizkaia;096;Zalla;8416;4137;4279;2021
48;Bizkaia;905;Zamudio;3277;1628;1649;2021
48;Bizkaia;097;Zaratamo;1647;822;825;2021
48;Bizkaia;024;Zeanuri;1248;629;619;2021
48;Bizkaia;025;Zeberio;1088;564;524;2021
48;Bizkaia;913;Zierbena;1516;806;710;2021
48;Bizkaia;915;Ziortza-Bolibar;411;215;196;2021
09;Burgos;001;Abajas;29;19;10;2021
09;Burgos;003;Adrada de Haza;197;97;100;2021
09;Burgos;006;Aguas Cándidas;56;35;21;2021
09;Burgos;007;Aguilar de Bureba;52;33;19;2021
09;Burgos;009;Albillos;221;116;105;2021
09;Burgos;010;Alcocero de Mola;33;23;10;2021
09;Burgos;011;Alfoz de Bricia;73;45;28;2021
09;Burgos;907;Alfoz de Quintanadueñas;2163;1138;1025;2021
09;Burgos;012;Alfoz de Santa Gadea;105;59;46;2021
09;Burgos;013;Altable;47;28;19;2021
09;Burgos;014;Altos, Los;191;111;80;2021
09;Burgos;016;Ameyugo;116;59;57;2021
09;Burgos;017;Anguix;158;94;64;2021
09;Burgos;018;Aranda de Duero;33084;16021;17063;2021
09;Burgos;019;Arandilla;158;103;55;2021
09;Burgos;020;Arauzo de Miel;288;162;126;2021
09;Burgos;021;Arauzo de Salce;47;27;20;2021
09;Burgos;022;Arauzo de Torre;71;44;27;2021
09;Burgos;023;Arcos;1816;948;868;2021
09;Burgos;024;Arenillas de Riopisuerga;176;106;70;2021
09;Burgos;025;Arija;118;63;55;2021
09;Burgos;026;Arlanzón;419;248;171;2021
09;Burgos;027;Arraya de Oca;46;25;21;2021
09;Burgos;029;Atapuerca;182;106;76;2021
09;Burgos;030;Ausines, Los;131;81;50;2021
09;Burgos;032;Avellanosa de Muñó;103;55;48;2021
09;Burgos;033;Bahabón de Esgueva;80;45;35;2021
09;Burgos;034;Balbases, Los;321;176;145;2021
09;Burgos;035;Baños de Valdearados;322;191;131;2021
09;Burgos;036;Bañuelos de Bureba;31;18;13;2021
09;Burgos;037;Barbadillo de Herreros;112;71;41;2021
09;Burgos;038;Barbadillo del Mercado;144;77;67;2021
09;Burgos;039;Barbadillo del Pez;65;37;28;2021
09;Burgos;041;Barrio de Muñó;32;18;14;2021
09;Burgos;043;Barrios de Bureba, Los;186;108;78;2021
09;Burgos;044;Barrios de Colina;51;28;23;2021
09;Burgos;045;Basconcillos del Tozo;292;167;125;2021
09;Burgos;046;Bascuñana;21;13;8;2021
09;Burgos;047;Belbimbre;57;30;27;2021
09;Burgos;048;Belorado;1754;890;864;2021
09;Burgos;050;Berberana;54;33;21;2021
09;Burgos;051;Berlangas de Roa;180;95;85;2021
09;Burgos;052;Berzosa de Bureba;27;21;6;2021
09;Burgos;054;Bozoó;100;61;39;2021
09;Burgos;055;Brazacorta;51;30;21;2021
09;Burgos;056;Briviesca;6465;3227;3238;2021
09;Burgos;057;Bugedo;196;122;74;2021
09;Burgos;058;Buniel;605;329;276;2021
09;Burgos;059;Burgos;174051;82859;91192;2021
09;Burgos;060;Busto de Bureba;138;76;62;2021
09;Burgos;061;Cabañes de Esgueva;166;93;73;2021
09;Burgos;062;Cabezón de la Sierra;40;16;24;2021
09;Burgos;064;Caleruega;419;206;213;2021
09;Burgos;065;Campillo de Aranda;169;99;70;2021
09;Burgos;066;Campolara;56;40;16;2021
09;Burgos;067;Canicosa de la Sierra;436;234;202;2021
09;Burgos;068;Cantabrana;25;15;10;2021
09;Burgos;070;Carazo;30;20;10;2021
09;Burgos;071;Carcedo de Bureba;45;24;21;2021
09;Burgos;072;Carcedo de Burgos;448;235;213;2021
09;Burgos;073;Cardeñadijo;1414;779;635;2021
09;Burgos;074;Cardeñajimeno;1175;626;549;2021
09;Burgos;075;Cardeñuela Riopico;109;64;45;2021
09;Burgos;076;Carrias;25;18;7;2021
09;Burgos;077;Cascajares de Bureba;29;14;15;2021
09;Burgos;078;Cascajares de la Sierra;32;18;14;2021
09;Burgos;079;Castellanos de Castro;49;29;20;2021
09;Burgos;083;Castil de Peones;25;13;12;2021
09;Burgos;082;Castildelgado;33;19;14;2021
09;Burgos;084;Castrillo de la Reina;173;116;57;2021
09;Burgos;085;Castrillo de la Vega;648;346;302;2021
09;Burgos;088;Castrillo de Riopisuerga;57;33;24;2021
09;Burgos;086;Castrillo del Val;814;460;354;2021
09;Burgos;090;Castrillo Mota de Judíos;49;26;23;2021
09;Burgos;091;Castrojeriz;758;405;353;2021
09;Burgos;063;Cavia;248;144;104;2021
09;Burgos;093;Cayuela;190;104;86;2021
09;Burgos;094;Cebrecos;54;34;20;2021
09;Burgos;095;Celada del Camino;102;48;54;2021
09;Burgos;098;Cerezo de Río Tirón;532;290;242;2021
09;Burgos;100;Cerratón de Juarros;52;35;17;2021
09;Burgos;101;Ciadoncha;78;49;29;2021
09;Burgos;102;Cillaperlata;35;23;12;2021
09;Burgos;103;Cilleruelo de Abajo;218;125;93;2021
09;Burgos;104;Cilleruelo de Arriba;41;21;20;2021
09;Burgos;105;Ciruelos de Cervera;104;61;43;2021
09;Burgos;108;Cogollos;592;335;257;2021
09;Burgos;109;Condado de Treviño;1416;778;638;2021
09;Burgos;110;Contreras;81;52;29;2021
09;Burgos;112;Coruña del Conde;105;67;38;2021
09;Burgos;113;Covarrubias;539;287;252;2021
09;Burgos;114;Cubillo del Campo;102;60;42;2021
09;Burgos;115;Cubo de Bureba;105;61;44;2021
09;Burgos;117;Cueva de Roa, La;106;54;52;2021
09;Burgos;119;Cuevas de San Clemente;42;18;24;2021
09;Burgos;120;Encío;43;21;22;2021
09;Burgos;122;Espinosa de Cervera;90;58;32;2021
09;Burgos;124;Espinosa de los Monteros;1674;861;813;2021
09;Burgos;123;Espinosa del Camino;46;27;19;2021
09;Burgos;125;Estépar;604;357;247;2021
09;Burgos;127;Fontioso;50;31;19;2021
09;Burgos;128;Frandovínez;97;55;42;2021
09;Burgos;129;Fresneda de la Sierra Tirón;94;57;37;2021
09;Burgos;130;Fresneña;69;44;25;2021
09;Burgos;131;Fresnillo de las Dueñas;695;356;339;2021
09;Burgos;132;Fresno de Río Tirón;178;105;73;2021
09;Burgos;133;Fresno de Rodilla;46;26;20;2021
09;Burgos;134;Frías;270;142;128;2021
09;Burgos;135;Fuentebureba;40;24;16;2021
09;Burgos;136;Fuentecén;223;120;103;2021
09;Burgos;137;Fuentelcésped;257;129;128;2021
09;Burgos;138;Fuentelisendo;106;58;48;2021
09;Burgos;139;Fuentemolinos;99;68;31;2021
09;Burgos;140;Fuentenebro;150;92;58;2021
09;Burgos;141;Fuentespina;770;402;368;2021
09;Burgos;143;Galbarros;30;18;12;2021
09;Burgos;144;Gallega, La;44;30;14;2021
09;Burgos;148;Grijalba;111;55;56;2021
09;Burgos;149;Grisaleña;65;45;20;2021
09;Burgos;151;Gumiel de Izán;556;309;247;2021
09;Burgos;152;Gumiel de Mercado;374;202;172;2021
09;Burgos;154;Hacinas;151;91;60;2021
09;Burgos;155;Haza;28;19;9;2021
09;Burgos;159;Hontanas;72;44;28;2021
09;Burgos;160;Hontangas;91;59;32;2021
09;Burgos;162;Hontoria de la Cantera;153;84;69;2021
09;Burgos;164;Hontoria de Valdearados;169;102;67;2021
09;Burgos;163;Hontoria del Pinar;644;350;294;2021
09;Burgos;166;Hormazas, Las;98;54;44;2021
09;Burgos;167;Hornillos del Camino;56;31;25;2021
09;Burgos;168;Horra, La;312;174;138;2021
09;Burgos;169;Hortigüela;100;66;34;2021
09;Burgos;170;Hoyales de Roa;226;117;109;2021
09;Burgos;172;Huérmeces;164;94;70;2021
09;Burgos;173;Huerta de Arriba;128;71;57;2021
09;Burgos;174;Huerta de Rey;908;485;423;2021
09;Burgos;175;Humada;123;83;40;2021
09;Burgos;176;Hurones;57;39;18;2021
09;Burgos;177;Ibeas de Juarros;1438;771;667;2021
09;Burgos;178;Ibrillos;37;25;12;2021
09;Burgos;179;Iglesiarrubia;43;23;20;2021
09;Burgos;180;Iglesias;146;77;69;2021
09;Burgos;181;Isar;291;151;140;2021
09;Burgos;182;Itero del Castillo;82;48;34;2021
09;Burgos;183;Jaramillo de la Fuente;42;28;14;2021
09;Burgos;184;Jaramillo Quemado;10;9;1;2021
09;Burgos;189;Junta de Traslaloma;123;67;56;2021
09;Burgos;190;Junta de Villalba de Losa;87;47;40;2021
09;Burgos;191;Jurisdicción de Lara;31;19;12;2021
09;Burgos;192;Jurisdicción de San Zadornil;62;37;25;2021
09;Burgos;194;Lerma;2609;1308;1301;2021
09;Burgos;195;Llano de Bureba;53;37;16;2021
09;Burgos;196;Madrigal del Monte;155;94;61;2021
09;Burgos;197;Madrigalejo del Monte;179;116;63;2021
09;Burgos;198;Mahamud;111;61;50;2021
09;Burgos;199;Mambrilla de Castrejón;104;65;39;2021
09;Burgos;200;Mambrillas de Lara;46;28;18;2021
09;Burgos;201;Mamolar;27;17;10;2021
09;Burgos;202;Manciles;22;14;8;2021
09;Burgos;206;Mazuela;59;35;24;2021
09;Burgos;208;Mecerreyes;196;107;89;2021
09;Burgos;209;Medina de Pomar;5834;2950;2884;2021
09;Burgos;211;Melgar de Fernamental;1553;846;707;2021
09;Burgos;213;Merindad de Cuesta-Urria;284;163;121;2021
09;Burgos;214;Merindad de Montija;730;434;296;2021
09;Burgos;906;Merindad de Río Ubierna;1436;808;628;2021
09;Burgos;215;Merindad de Sotoscueva;409;234;175;2021
09;Burgos;216;Merindad de Valdeporres;431;226;205;2021
09;Burgos;217;Merindad de Valdivielso;386;220;166;2021
09;Burgos;218;Milagros;438;243;195;2021
09;Burgos;219;Miranda de Ebro;35528;17515;18013;2021
09;Burgos;220;Miraveche;85;54;31;2021
09;Burgos;221;Modúbar de la Emparedada;768;418;350;2021
09;Burgos;223;Monasterio de la Sierra;40;24;16;2021
09;Burgos;224;Monasterio de Rodilla;164;90;74;2021
09;Burgos;225;Moncalvillo;83;49;34;2021
09;Burgos;226;Monterrubio de la Demanda;58;35;23;2021
09;Burgos;227;Montorio;152;85;67;2021
09;Burgos;228;Moradillo de Roa;163;89;74;2021
09;Burgos;229;Nava de Roa;206;110;96;2021
09;Burgos;230;Navas de Bureba;31;14;17;2021
09;Burgos;231;Nebreda;51;37;14;2021
09;Burgos;232;Neila;144;82;62;2021
09;Burgos;235;Olmedillo de Roa;190;105;85;2021
09;Burgos;236;Olmillos de Muñó;36;21;15;2021
09;Burgos;238;Oña;1008;527;481;2021
09;Burgos;239;Oquillas;48;27;21;2021
09;Burgos;241;Orbaneja Riopico;355;203;152;2021
09;Burgos;242;Padilla de Abajo;75;45;30;2021
09;Burgos;243;Padilla de Arriba;86;53;33;2021
09;Burgos;244;Padrones de Bureba;45;20;25;2021
09;Burgos;246;Palacios de la Sierra;702;357;345;2021
09;Burgos;247;Palacios de Riopisuerga;22;11;11;2021
09;Burgos;248;Palazuelos de la Sierra;87;54;33;2021
09;Burgos;249;Palazuelos de Muñó;53;28;25;2021
09;Burgos;250;Pampliega;287;158;129;2021
09;Burgos;251;Pancorbo;423;223;200;2021
09;Burgos;253;Pardilla;115;68;47;2021
09;Burgos;255;Partido de la Sierra en Tobalina;84;52;32;2021
09;Burgos;256;Pedrosa de Duero;485;281;204;2021
09;Burgos;259;Pedrosa de Río Úrbel;252;151;101;2021
09;Burgos;257;Pedrosa del Páramo;84;51;33;2021
09;Burgos;258;Pedrosa del Príncipe;165;90;75;2021
09;Burgos;261;Peñaranda de Duero;511;262;249;2021
09;Burgos;262;Peral de Arlanza;175;98;77;2021
09;Burgos;265;Piérnigas;37;21;16;2021
09;Burgos;266;Pineda de la Sierra;99;64;35;2021
09;Burgos;267;Pineda Trasmonte;117;67;50;2021
09;Burgos;268;Pinilla de los Barruecos;99;60;39;2021
09;Burgos;269;Pinilla de los Moros;40;21;19;2021
09;Burgos;270;Pinilla Trasmonte;165;94;71;2021
09;Burgos;272;Poza de la Sal;294;161;133;2021
09;Burgos;273;Prádanos de Bureba;56;35;21;2021
09;Burgos;274;Pradoluengo;1120;569;551;2021
09;Burgos;275;Presencio;190;113;77;2021
09;Burgos;276;Puebla de Arganzón, La;513;278;235;2021
09;Burgos;277;Puentedura;120;78;42;2021
09;Burgos;279;Quemada;255;156;99;2021
09;Burgos;281;Quintana del Pidio;157;86;71;2021
09;Burgos;280;Quintanabureba;30;18;12;2021
09;Burgos;283;Quintanaélez;43;23;20;2021
09;Burgos;287;Quintanaortuño;274;150;124;2021
09;Burgos;288;Quintanapalla;117;60;57;2021
09;Burgos;289;Quintanar de la Sierra;1596;840;756;2021
09;Burgos;292;Quintanavides;74;43;31;2021
09;Burgos;294;Quintanilla de la Mata;117;71;46;2021
09;Burgos;901;Quintanilla del Agua y Tordueles;357;193;164;2021
09;Burgos;295;Quintanilla del Coco;50;25;25;2021
09;Burgos;298;Quintanilla San García;79;46;33;2021
09;Burgos;301;Quintanilla Vivar;872;476;396;2021
09;Burgos;297;Quintanillas, Las;379;220;159;2021
09;Burgos;302;Rabanera del Pinar;98;60;38;2021
09;Burgos;303;Rábanos;82;49;33;2021
09;Burgos;304;Rabé de las Calzadas;232;116;116;2021
09;Burgos;306;Rebolledo de la Torre;95;55;40;2021
09;Burgos;307;Redecilla del Camino;104;67;37;2021
09;Burgos;308;Redecilla del Campo;63;36;27;2021
09;Burgos;309;Regumiel de la Sierra;336;176;160;2021
09;Burgos;310;Reinoso;15;11;4;2021
09;Burgos;311;Retuerta;66;39;27;2021
09;Burgos;314;Revilla del Campo;106;63;43;2021
09;Burgos;316;Revilla Vallejera;101;60;41;2021
09;Burgos;312;Revilla y Ahedo, La;102;58;44;2021
09;Burgos;315;Revillarruz;564;295;269;2021
09;Burgos;317;Rezmondo;21;8;13;2021
09;Burgos;318;Riocavado de la Sierra;57;37;20;2021
09;Burgos;321;Roa;2196;1108;1088;2021
09;Burgos;323;Rojas;64;44;20;2021
09;Burgos;325;Royuela de Río Franco;177;105;72;2021
09;Burgos;326;Rubena;193;112;81;2021
09;Burgos;327;Rublacedo de Abajo;29;15;14;2021
09;Burgos;328;Rucandio;64;31;33;2021
09;Burgos;329;Salas de Bureba;135;79;56;2021
09;Burgos;330;Salas de los Infantes;1980;1021;959;2021
09;Burgos;332;Saldaña de Burgos;189;109;80;2021
09;Burgos;334;Salinillas de Bureba;51;38;13;2021
09;Burgos;335;San Adrián de Juarros;94;61;33;2021
09;Burgos;337;San Juan del Monte;156;85;71;2021
09;Burgos;338;San Mamés de Burgos;318;179;139;2021
09;Burgos;339;San Martín de Rubiales;151;90;61;2021
09;Burgos;340;San Millán de Lara;69;49;20;2021
09;Burgos;360;San Vicente del Valle;27;20;7;2021
09;Burgos;343;Santa Cecilia;100;60;40;2021
09;Burgos;345;Santa Cruz de la Salceda;132;83;49;2021
09;Burgos;346;Santa Cruz del Valle Urbión;101;68;33;2021
09;Burgos;347;Santa Gadea del Cid;152;81;71;2021
09;Burgos;348;Santa Inés;147;84;63;2021
09;Burgos;350;Santa María del Campo;518;281;237;2021
09;Burgos;351;Santa María del Invierno;66;48;18;2021
09;Burgos;352;Santa María del Mercadillo;104;66;38;2021
09;Burgos;353;Santa María Rivarredonda;95;58;37;2021
09;Burgos;354;Santa Olalla de Bureba;35;24;11;2021
09;Burgos;355;Santibáñez de Esgueva;85;48;37;2021
09;Burgos;356;Santibáñez del Val;54;33;21;2021
09;Burgos;358;Santo Domingo de Silos;262;166;96;2021
09;Burgos;361;Sargentes de la Lora;115;66;49;2021
09;Burgos;362;Sarracín;257;135;122;2021
09;Burgos;363;Sasamón;963;558;405;2021
09;Burgos;365;Sequera de Haza, La;25;18;7;2021
09;Burgos;366;Solarana;73;43;30;2021
09;Burgos;368;Sordillos;28;16;12;2021
09;Burgos;369;Sotillo de la Ribera;469;248;221;2021
09;Burgos;372;Sotragero;289;158;131;2021
09;Burgos;373;Sotresgudo;445;257;188;2021
09;Burgos;374;Susinos del Páramo;113;71;42;2021
09;Burgos;375;Tamarón;41;22;19;2021
09;Burgos;377;Tardajos;800;430;370;2021
09;Burgos;378;Tejada;34;19;15;2021
09;Burgos;380;Terradillos de Esgueva;73;36;37;2021
09;Burgos;381;Tinieblas de la Sierra;28;15;13;2021
09;Burgos;382;Tobar;22;16;6;2021
09;Burgos;384;Tordómar;329;182;147;2021
09;Burgos;386;Torrecilla del Monte;73;40;33;2021
09;Burgos;387;Torregalindo;120;74;46;2021
09;Burgos;388;Torrelara;33;19;14;2021
09;Burgos;389;Torrepadre;76;44;32;2021
09;Burgos;390;Torresandino;591;316;275;2021
09;Burgos;391;Tórtoles de Esgueva;397;213;184;2021
09;Burgos;392;Tosantos;56;31;25;2021
09;Burgos;394;Trespaderne;757;372;385;2021
09;Burgos;395;Tubilla del Agua;142;86;56;2021
09;Burgos;396;Tubilla del Lago;167;89;78;2021
09;Burgos;398;Úrbel del Castillo;68;45;23;2021
09;Burgos;400;Vadocondes;355;194;161;2021
09;Burgos;403;Valdeande;99;58;41;2021
09;Burgos;405;Valdezate;124;72;52;2021
09;Burgos;406;Valdorros;342;196;146;2021
09;Burgos;408;Vallarta de Bureba;45;29;16;2021
09;Burgos;904;Valle de las Navas;530;310;220;2021
09;Burgos;908;Valle de Losa;488;280;208;2021
09;Burgos;409;Valle de Manzanedo;132;68;64;2021
09;Burgos;410;Valle de Mena;3987;2032;1955;2021
09;Burgos;411;Valle de Oca;169;102;67;2021
09;Burgos;902;Valle de Santibáñez;482;282;200;2021
09;Burgos;905;Valle de Sedano;409;237;172;2021
09;Burgos;412;Valle de Tobalina;901;491;410;2021
09;Burgos;413;Valle de Valdebezana;456;244;212;2021
09;Burgos;414;Valle de Valdelaguna;194;117;77;2021
09;Burgos;415;Valle de Valdelucio;339;190;149;2021
09;Burgos;416;Valle de Zamanzas;50;32;18;2021
09;Burgos;417;Vallejera;40;23;17;2021
09;Burgos;418;Valles de Palenzuela;81;40;41;2021
09;Burgos;419;Valluércanes;67;45;22;2021
09;Burgos;407;Valmala;24;12;12;2021
09;Burgos;422;Vid de Bureba, La;19;11;8;2021
09;Burgos;421;Vid y Barrios, La;276;163;113;2021
09;Burgos;423;Vileña;26;16;10;2021
09;Burgos;427;Villadiego;1484;825;659;2021
09;Burgos;428;Villaescusa de Roa;97;53;44;2021
09;Burgos;429;Villaescusa la Sombría;57;42;15;2021
09;Burgos;430;Villaespasa;27;16;11;2021
09;Burgos;431;Villafranca Montes de Oca;115;69;46;2021
09;Burgos;432;Villafruela;168;98;70;2021
09;Burgos;433;Villagalijo;58;34;24;2021
09;Burgos;434;Villagonzalo Pedernales;1853;980;873;2021
09;Burgos;437;Villahoz;291;153;138;2021
09;Burgos;438;Villalba de Duero;707;373;334;2021
09;Burgos;439;Villalbilla de Burgos;1454;788;666;2021
09;Burgos;440;Villalbilla de Gumiel;86;54;32;2021
09;Burgos;441;Villaldemiro;99;56;43;2021
09;Burgos;442;Villalmanzo;415;227;188;2021
09;Burgos;443;Villamayor de los Montes;155;76;79;2021
09;Burgos;444;Villamayor de Treviño;64;33;31;2021
09;Burgos;445;Villambistia;44;32;12;2021
09;Burgos;446;Villamedianilla;10;7;3;2021
09;Burgos;447;Villamiel de la Sierra;44;27;17;2021
09;Burgos;448;Villangómez;225;136;89;2021
09;Burgos;449;Villanueva de Argaño;114;64;50;2021
09;Burgos;450;Villanueva de Carazo;24;16;8;2021
09;Burgos;451;Villanueva de Gumiel;274;142;132;2021
09;Burgos;454;Villanueva de Teba;39;26;13;2021
09;Burgos;455;Villaquirán de la Puebla;48;29;19;2021
09;Burgos;456;Villaquirán de los Infantes;151;79;72;2021
09;Burgos;903;Villarcayo de Merindad de Castilla la Vieja;4029;2074;1955;2021
09;Burgos;458;Villariezo;690;380;310;2021
09;Burgos;460;Villasandino;176;100;76;2021
09;Burgos;463;Villasur de Herreros;258;161;97;2021
09;Burgos;464;Villatuelda;42;22;20;2021
09;Burgos;466;Villaverde del Monte;122;73;49;2021
09;Burgos;467;Villaverde-Mogina;74;51;23;2021
09;Burgos;471;Villayerno Morquillas;209;111;98;2021
09;Burgos;472;Villazopeque;52;30;22;2021
09;Burgos;473;Villegas;90;51;39;2021
09;Burgos;476;Villoruebo;68;46;22;2021
09;Burgos;424;Viloria de Rioja;38;23;15;2021
09;Burgos;425;Vilviestre del Pinar;532;295;237;2021
09;Burgos;478;Vizcaínos;46;34;12;2021
09;Burgos;480;Zael;117;58;59;2021
09;Burgos;482;Zarzosa de Río Pisuerga;34;21;13;2021
09;Burgos;483;Zazuar;207;106;101;2021
09;Burgos;485;Zuñeda;56;30;26;2021
10;Cáceres;001;Abadía;359;193;166;2021
10;Cáceres;002;Abertura;400;204;196;2021
10;Cáceres;003;Acebo;560;271;289;2021
10;Cáceres;004;Acehúche;813;413;400;2021
10;Cáceres;005;Aceituna;587;299;288;2021
10;Cáceres;006;Ahigal;1393;711;682;2021
10;Cáceres;903;Alagón del Río;933;461;472;2021
10;Cáceres;007;Albalá;681;355;326;2021
10;Cáceres;008;Alcántara;1386;689;697;2021
10;Cáceres;009;Alcollarín;279;139;140;2021
10;Cáceres;010;Alcuéscar;2486;1286;1200;2021
10;Cáceres;012;Aldea del Cano;610;287;323;2021
10;Cáceres;013;Aldea del Obispo, La;299;163;136;2021
10;Cáceres;011;Aldeacentenera;568;296;272;2021
10;Cáceres;014;Aldeanueva de la Vera;2035;997;1038;2021
10;Cáceres;015;Aldeanueva del Camino;729;362;367;2021
10;Cáceres;016;Aldehuela de Jerte;372;195;177;2021
10;Cáceres;017;Alía;783;407;376;2021
10;Cáceres;018;Aliseda;1751;895;856;2021
10;Cáceres;019;Almaraz;1700;869;831;2021
10;Cáceres;020;Almoharín;1796;879;917;2021
10;Cáceres;021;Arroyo de la Luz;5663;2802;2861;2021
10;Cáceres;023;Arroyomolinos;844;434;410;2021
10;Cáceres;022;Arroyomolinos de la Vera;433;215;218;2021
10;Cáceres;024;Baños de Montemayor;749;356;393;2021
10;Cáceres;025;Barrado;363;188;175;2021
10;Cáceres;026;Belvís de Monroy;745;390;355;2021
10;Cáceres;027;Benquerencia;79;47;32;2021
10;Cáceres;028;Berrocalejo;102;56;46;2021
10;Cáceres;029;Berzocana;416;217;199;2021
10;Cáceres;030;Bohonal de Ibor;485;243;242;2021
10;Cáceres;031;Botija;187;95;92;2021
10;Cáceres;032;Brozas;1790;886;904;2021
10;Cáceres;033;Cabañas del Castillo;419;216;203;2021
10;Cáceres;034;Cabezabellosa;344;172;172;2021
10;Cáceres;035;Cabezuela del Valle;2141;1099;1042;2021
10;Cáceres;036;Cabrero;323;181;142;2021
10;Cáceres;037;Cáceres;95418;45735;49683;2021
10;Cáceres;038;Cachorrilla;95;47;48;2021
10;Cáceres;039;Cadalso;417;211;206;2021
10;Cáceres;040;Calzadilla;464;233;231;2021
10;Cáceres;041;Caminomorisco;1161;604;557;2021
10;Cáceres;042;Campillo de Deleitosa;78;36;42;2021
10;Cáceres;043;Campo Lugar;824;407;417;2021
10;Cáceres;044;Cañamero;1622;852;770;2021
10;Cáceres;045;Cañaveral;1024;506;518;2021
10;Cáceres;046;Carbajo;198;100;98;2021
10;Cáceres;047;Carcaboso;1080;544;536;2021
10;Cáceres;048;Carrascalejo;225;116;109;2021
10;Cáceres;049;Casar de Cáceres;4516;2228;2288;2021
10;Cáceres;050;Casar de Palomero;1059;543;516;2021
10;Cáceres;051;Casares de las Hurdes;383;196;187;2021
10;Cáceres;052;Casas de Don Antonio;178;91;87;2021
10;Cáceres;053;Casas de Don Gómez;277;149;128;2021
10;Cáceres;056;Casas de Millán;556;280;276;2021
10;Cáceres;057;Casas de Miravete;129;81;48;2021
10;Cáceres;054;Casas del Castañar;531;261;270;2021
10;Cáceres;055;Casas del Monte;787;406;381;2021
10;Cáceres;058;Casatejada;1343;700;643;2021
10;Cáceres;059;Casillas de Coria;344;171;173;2021
10;Cáceres;060;Castañar de Ibor;1021;529;492;2021
10;Cáceres;061;Ceclavín;1801;916;885;2021
10;Cáceres;062;Cedillo;424;219;205;2021
10;Cáceres;063;Cerezo;153;77;76;2021
10;Cáceres;064;Cilleros;1617;817;800;2021
10;Cáceres;065;Collado de la Vera;217;124;93;2021
10;Cáceres;066;Conquista de la Sierra;192;112;80;2021
10;Cáceres;067;Coria;12330;6048;6282;2021
10;Cáceres;068;Cuacos de Yuste;847;430;417;2021
10;Cáceres;069;Cumbre, La;837;424;413;2021
10;Cáceres;070;Deleitosa;684;352;332;2021
10;Cáceres;071;Descargamaría;107;62;45;2021
10;Cáceres;072;Eljas;897;464;433;2021
10;Cáceres;073;Escurial;862;453;409;2021
10;Cáceres;075;Fresnedoso de Ibor;264;141;123;2021
10;Cáceres;076;Galisteo;902;450;452;2021
10;Cáceres;077;Garciaz;700;360;340;2021
10;Cáceres;079;Garganta la Olla;924;491;433;2021
10;Cáceres;078;Garganta, La;358;193;165;2021
10;Cáceres;080;Gargantilla;374;193;181;2021
10;Cáceres;081;Gargüera;178;96;82;2021
10;Cáceres;082;Garrovillas de Alconétar;1955;969;986;2021
10;Cáceres;083;Garvín;96;51;45;2021
10;Cáceres;084;Gata;1413;722;691;2021
10;Cáceres;085;Gordo, El;382;202;180;2021
10;Cáceres;086;Granja, La;318;161;157;2021
10;Cáceres;087;Guadalupe;1822;910;912;2021
10;Cáceres;088;Guijo de Coria;197;107;90;2021
10;Cáceres;089;Guijo de Galisteo;1513;764;749;2021
10;Cáceres;090;Guijo de Granadilla;514;272;242;2021
10;Cáceres;091;Guijo de Santa Bárbara;388;202;186;2021
10;Cáceres;092;Herguijuela;268;142;126;2021
10;Cáceres;093;Hernán-Pérez;415;202;213;2021
10;Cáceres;094;Herrera de Alcántara;230;119;111;2021
10;Cáceres;095;Herreruela;329;169;160;2021
10;Cáceres;096;Hervás;3952;1933;2019;2021
10;Cáceres;097;Higuera;106;62;44;2021
10;Cáceres;098;Hinojal;391;202;189;2021
10;Cáceres;099;Holguera;620;315;305;2021
10;Cáceres;100;Hoyos;882;429;453;2021
10;Cáceres;101;Huélaga;210;105;105;2021
10;Cáceres;102;Ibahernando;540;267;273;2021
10;Cáceres;103;Jaraicejo;457;224;233;2021
10;Cáceres;104;Jaraíz de la Vera;6499;3255;3244;2021
10;Cáceres;105;Jarandilla de la Vera;2843;1414;1429;2021
10;Cáceres;106;Jarilla;136;68;68;2021
10;Cáceres;107;Jerte;1256;624;632;2021
10;Cáceres;108;Ladrillar;185;108;77;2021
10;Cáceres;109;Logrosán;1944;990;954;2021
10;Cáceres;110;Losar de la Vera;2658;1359;1299;2021
10;Cáceres;111;Madrigal de la Vera;1566;819;747;2021
10;Cáceres;112;Madrigalejo;1694;860;834;2021
10;Cáceres;113;Madroñera;2446;1227;1219;2021
10;Cáceres;114;Majadas;1345;677;668;2021
10;Cáceres;115;Malpartida de Cáceres;4060;2023;2037;2021
10;Cáceres;116;Malpartida de Plasencia;4637;2282;2355;2021
10;Cáceres;117;Marchagaz;247;137;110;2021
10;Cáceres;118;Mata de Alcántara;284;147;137;2021
10;Cáceres;119;Membrío;587;290;297;2021
10;Cáceres;120;Mesas de Ibor;162;82;80;2021
10;Cáceres;121;Miajadas;9503;4732;4771;2021
10;Cáceres;122;Millanes;255;130;125;2021
10;Cáceres;123;Mirabel;669;333;336;2021
10;Cáceres;124;Mohedas de Granadilla;849;429;420;2021
10;Cáceres;125;Monroy;920;473;447;2021
10;Cáceres;126;Montánchez;1654;832;822;2021
10;Cáceres;127;Montehermoso;5680;2896;2784;2021
10;Cáceres;128;Moraleja;6685;3321;3364;2021
10;Cáceres;129;Morcillo;371;175;196;2021
10;Cáceres;130;Navaconcejo;2035;1030;1005;2021
10;Cáceres;131;Navalmoral de la Mata;17010;8233;8777;2021
10;Cáceres;132;Navalvillar de Ibor;393;196;197;2021
10;Cáceres;133;Navas del Madroño;1261;626;635;2021
10;Cáceres;134;Navezuelas;631;325;306;2021
10;Cáceres;135;Nuñomoral;1224;650;574;2021
10;Cáceres;136;Oliva de Plasencia;286;165;121;2021
10;Cáceres;137;Palomero;396;208;188;2021
10;Cáceres;138;Pasarón de la Vera;606;292;314;2021
10;Cáceres;139;Pedroso de Acim;77;44;33;2021
10;Cáceres;140;Peraleda de la Mata;1401;709;692;2021
10;Cáceres;141;Peraleda de San Román;297;164;133;2021
10;Cáceres;142;Perales del Puerto;943;473;470;2021
10;Cáceres;143;Pescueza;138;60;78;2021
10;Cáceres;144;Pesga, La;1013;525;488;2021
10;Cáceres;145;Piedras Albas;137;66;71;2021
10;Cáceres;146;Pinofranqueado;1682;888;794;2021
10;Cáceres;147;Piornal;1485;749;736;2021
10;Cáceres;148;Plasencia;39558;19023;20535;2021
10;Cáceres;149;Plasenzuela;477;234;243;2021
10;Cáceres;150;Portaje;371;193;178;2021
10;Cáceres;151;Portezuelo;220;118;102;2021
10;Cáceres;152;Pozuelo de Zarzón;435;218;217;2021
10;Cáceres;905;Pueblonuevo de Miramontes;767;383;384;2021
10;Cáceres;153;Puerto de Santa Cruz;287;147;140;2021
10;Cáceres;154;Rebollar;208;105;103;2021
10;Cáceres;155;Riolobos;1197;604;593;2021
10;Cáceres;156;Robledillo de Gata;85;48;37;2021
10;Cáceres;157;Robledillo de la Vera;262;131;131;2021
10;Cáceres;158;Robledillo de Trujillo;362;183;179;2021
10;Cáceres;159;Robledollano;286;155;131;2021
10;Cáceres;160;Romangordo;259;129;130;2021
10;Cáceres;901;Rosalejo;1383;715;668;2021
10;Cáceres;161;Ruanes;86;45;41;2021
10;Cáceres;162;Salorino;566;295;271;2021
10;Cáceres;163;Salvatierra de Santiago;284;145;139;2021
10;Cáceres;164;San Martín de Trevejo;754;376;378;2021
10;Cáceres;165;Santa Ana;273;142;131;2021
10;Cáceres;166;Santa Cruz de la Sierra;324;165;159;2021
10;Cáceres;167;Santa Cruz de Paniagua;296;167;129;2021
10;Cáceres;168;Santa Marta de Magasca;301;151;150;2021
10;Cáceres;169;Santiago de Alcántara;488;240;248;2021
10;Cáceres;170;Santiago del Campo;234;123;111;2021
10;Cáceres;171;Santibáñez el Alto;354;191;163;2021
10;Cáceres;172;Santibáñez el Bajo;748;383;365;2021
10;Cáceres;173;Saucedilla;869;448;421;2021
10;Cáceres;174;Segura de Toro;190;94;96;2021
10;Cáceres;175;Serradilla;1503;755;748;2021
10;Cáceres;176;Serrejón;409;215;194;2021
10;Cáceres;177;Sierra de Fuentes;1984;1021;963;2021
10;Cáceres;178;Talaván;796;412;384;2021
10;Cáceres;179;Talaveruela de la Vera;316;163;153;2021
10;Cáceres;180;Talayuela;7328;3902;3426;2021
10;Cáceres;181;Tejeda de Tiétar;770;406;364;2021
10;Cáceres;904;Tiétar;878;475;403;2021
10;Cáceres;182;Toril;155;101;54;2021
10;Cáceres;183;Tornavacas;1065;569;496;2021
10;Cáceres;184;Torno, El;843;438;405;2021
10;Cáceres;187;Torre de Don Miguel;495;259;236;2021
10;Cáceres;188;Torre de Santa María;528;262;266;2021
10;Cáceres;185;Torrecilla de los Ángeles;648;336;312;2021
10;Cáceres;186;Torrecillas de la Tiesa;1075;545;530;2021
10;Cáceres;190;Torrejón el Rubio;550;278;272;2021
10;Cáceres;189;Torrejoncillo;2894;1397;1497;2021
10;Cáceres;191;Torremenga;587;309;278;2021
10;Cáceres;192;Torremocha;770;384;386;2021
10;Cáceres;193;Torreorgaz;1675;826;849;2021
10;Cáceres;194;Torrequemada;566;277;289;2021
10;Cáceres;195;Trujillo;8821;4303;4518;2021
10;Cáceres;196;Valdastillas;312;158;154;2021
10;Cáceres;197;Valdecañas de Tajo;113;55;58;2021
10;Cáceres;198;Valdefuentes;1147;561;586;2021
10;Cáceres;199;Valdehúncar;179;96;83;2021
10;Cáceres;200;Valdelacasa de Tajo;346;188;158;2021
10;Cáceres;201;Valdemorales;207;104;103;2021
10;Cáceres;202;Valdeobispo;654;319;335;2021
10;Cáceres;203;Valencia de Alcántara;5325;2618;2707;2021
10;Cáceres;204;Valverde de la Vera;438;226;212;2021
10;Cáceres;205;Valverde del Fresno;2190;1106;1084;2021
10;Cáceres;902;Vegaviana;845;437;408;2021
10;Cáceres;206;Viandar de la Vera;213;110;103;2021
10;Cáceres;207;Villa del Campo;456;217;239;2021
10;Cáceres;208;Villa del Rey;128;63;65;2021
10;Cáceres;209;Villamesías;263;134;129;2021
10;Cáceres;210;Villamiel;405;205;200;2021
10;Cáceres;211;Villanueva de la Sierra;470;242;228;2021
10;Cáceres;212;Villanueva de la Vera;2114;1059;1055;2021
10;Cáceres;214;Villar de Plasencia;239;127;112;2021
10;Cáceres;213;Villar del Pedroso;560;285;275;2021
10;Cáceres;215;Villasbuenas de Gata;388;188;200;2021
10;Cáceres;216;Zarza de Granadilla;1792;914;878;2021
10;Cáceres;217;Zarza de Montánchez;529;268;261;2021
10;Cáceres;218;Zarza la Mayor;1192;594;598;2021
10;Cáceres;219;Zorita;1324;662;662;2021
11;Cádiz;001;Alcalá de los Gazules;5245;2697;2548;2021
11;Cádiz;002;Alcalá del Valle;5031;2526;2505;2021
11;Cádiz;003;Algar;1442;739;703;2021
11;Cádiz;004;Algeciras;122982;60664;62318;2021
11;Cádiz;005;Algodonales;5526;2784;2742;2021
11;Cádiz;006;Arcos de la Frontera;30902;15427;15475;2021
11;Cádiz;007;Barbate;22761;11407;11354;2021
11;Cádiz;008;Barrios, Los;23983;12032;11951;2021
11;Cádiz;901;Benalup-Casas Viejas;7020;3558;3462;2021
11;Cádiz;009;Benaocaz;695;373;322;2021
11;Cádiz;010;Bornos;7655;3822;3833;2021
11;Cádiz;011;Bosque, El;2223;1130;1093;2021
11;Cádiz;012;Cádiz;114244;53995;60249;2021
11;Cádiz;013;Castellar de la Frontera;3070;1528;1542;2021
11;Cádiz;015;Chiclana de la Frontera;86306;43131;43175;2021
11;Cádiz;016;Chipiona;19368;9686;9682;2021
11;Cádiz;014;Conil de la Frontera;23182;11661;11521;2021
11;Cádiz;017;Espera;3845;1923;1922;2021
11;Cádiz;018;Gastor, El;1709;865;844;2021
11;Cádiz;019;Grazalema;2030;1006;1024;2021
11;Cádiz;020;Jerez de la Frontera;212801;103879;108922;2021
11;Cádiz;021;Jimena de la Frontera;6665;3405;3260;2021
11;Cádiz;022;Línea de la Concepción, La;63365;31010;32355;2021
11;Cádiz;023;Medina Sidonia;11813;5983;5830;2021
11;Cádiz;024;Olvera;8016;3931;4085;2021
11;Cádiz;025;Paterna de Rivera;5470;2830;2640;2021
11;Cádiz;026;Prado del Rey;5655;2811;2844;2021
11;Cádiz;027;Puerto de Santa María, El;89060;43569;45491;2021
11;Cádiz;028;Puerto Real;41771;20973;20798;2021
11;Cádiz;029;Puerto Serrano;6954;3522;3432;2021
11;Cádiz;030;Rota;29326;14564;14762;2021
11;Cádiz;031;San Fernando;94867;46277;48590;2021
11;Cádiz;902;San José del Valle;4432;2261;2171;2021
11;Cádiz;903;San Martín del Tesorillo;2821;1460;1361;2021
11;Cádiz;033;San Roque;32178;16042;16136;2021
11;Cádiz;032;Sanlúcar de Barrameda;69507;34632;34875;2021
11;Cádiz;034;Setenil de las Bodegas;2698;1387;1311;2021
11;Cádiz;035;Tarifa;18466;9275;9191;2021
11;Cádiz;036;Torre Alháquime;800;400;400;2021
11;Cádiz;037;Trebujena;7042;3499;3543;2021
11;Cádiz;038;Ubrique;16482;8138;8344;2021
11;Cádiz;039;Vejer de la Frontera;12572;6253;6319;2021
11;Cádiz;040;Villaluenga del Rosario;464;237;227;2021
11;Cádiz;041;Villamartín;12125;6089;6036;2021
11;Cádiz;042;Zahara;1391;703;688;2021
39;Cantabria;001;Alfoz de Lloredo;2437;1263;1174;2021
39;Cantabria;002;Ampuero;4368;2189;2179;2021
39;Cantabria;003;Anievas;266;146;120;2021
39;Cantabria;004;Arenas de Iguña;1703;858;845;2021
39;Cantabria;005;Argoños;1834;946;888;2021
39;Cantabria;006;Arnuero;2144;1067;1077;2021
39;Cantabria;007;Arredondo;470;269;201;2021
39;Cantabria;008;Astillero, El;18116;8824;9292;2021
39;Cantabria;009;Bárcena de Cicero;4399;2252;2147;2021
39;Cantabria;010;Bárcena de Pie de Concha;671;337;334;2021
39;Cantabria;011;Bareyo;2129;1075;1054;2021
39;Cantabria;012;Cabezón de la Sal;8273;3953;4320;2021
39;Cantabria;013;Cabezón de Liébana;580;328;252;2021
39;Cantabria;014;Cabuérniga;985;523;462;2021
39;Cantabria;015;Camaleño;956;535;421;2021
39;Cantabria;016;Camargo;30497;14897;15600;2021
39;Cantabria;027;Campoo de Enmedio;3692;1876;1816;2021
39;Cantabria;017;Campoo de Yuso;680;371;309;2021
39;Cantabria;018;Cartes;5750;2872;2878;2021
39;Cantabria;019;Castañeda;3029;1548;1481;2021
39;Cantabria;020;Castro-Urdiales;32975;16325;16650;2021
39;Cantabria;021;Cieza;548;280;268;2021
39;Cantabria;022;Cillorigo de Liébana;1299;681;618;2021
39;Cantabria;023;Colindres;8504;4203;4301;2021
39;Cantabria;024;Comillas;2117;1000;1117;2021
39;Cantabria;025;Corrales de Buelna, Los;10703;5200;5503;2021
39;Cantabria;026;Corvera de Toranzo;2054;1033;1021;2021
39;Cantabria;028;Entrambasaguas;5357;2683;2674;2021
39;Cantabria;029;Escalante;762;396;366;2021
39;Cantabria;030;Guriezo;2410;1257;1153;2021
39;Cantabria;031;Hazas de Cesto;1644;802;842;2021
39;Cantabria;032;Hermandad de Campoo de Suso;1604;887;717;2021
39;Cantabria;033;Herrerías;589;328;261;2021
39;Cantabria;034;Lamasón;268;170;98;2021
39;Cantabria;035;Laredo;10996;5227;5769;2021
39;Cantabria;036;Liendo;1216;627;589;2021
39;Cantabria;037;Liérganes;2403;1184;1219;2021
39;Cantabria;038;Limpias;1961;974;987;2021
39;Cantabria;039;Luena;623;338;285;2021
39;Cantabria;040;Marina de Cudeyo;5186;2588;2598;2021
39;Cantabria;041;Mazcuerras;2080;1070;1010;2021
39;Cantabria;042;Medio Cudeyo;7606;3675;3931;2021
39;Cantabria;043;Meruelo;2174;1077;1097;2021
39;Cantabria;044;Miengo;5059;2594;2465;2021
39;Cantabria;045;Miera;386;202;184;2021
39;Cantabria;046;Molledo;1494;743;751;2021
39;Cantabria;047;Noja;2650;1321;1329;2021
39;Cantabria;048;Penagos;2168;1096;1072;2021
39;Cantabria;049;Peñarrubia;318;170;148;2021
39;Cantabria;050;Pesaguero;294;171;123;2021
39;Cantabria;051;Pesquera;82;49;33;2021
39;Cantabria;052;Piélagos;26035;12873;13162;2021
39;Cantabria;053;Polaciones;215;136;79;2021
39;Cantabria;054;Polanco;5978;2958;3020;2021
39;Cantabria;055;Potes;1322;628;694;2021
39;Cantabria;056;Puente Viesgo;2902;1464;1438;2021
39;Cantabria;057;Ramales de la Victoria;2902;1466;1436;2021
39;Cantabria;058;Rasines;971;495;476;2021
39;Cantabria;059;Reinosa;8810;4168;4642;2021
39;Cantabria;060;Reocín;8382;4137;4245;2021
39;Cantabria;061;Ribamontán al Mar;4629;2367;2262;2021
39;Cantabria;062;Ribamontán al Monte;2382;1220;1162;2021
39;Cantabria;063;Rionansa;1042;581;461;2021
39;Cantabria;064;Riotuerto;1645;790;855;2021
39;Cantabria;065;Rozas de Valdearroyo, Las;257;143;114;2021
39;Cantabria;066;Ruente;1034;559;475;2021
39;Cantabria;067;Ruesga;826;453;373;2021
39;Cantabria;068;Ruiloba;741;375;366;2021
39;Cantabria;069;San Felices de Buelna;2355;1194;1161;2021
39;Cantabria;070;San Miguel de Aguayo;148;78;70;2021
39;Cantabria;071;San Pedro del Romeral;474;264;210;2021
39;Cantabria;072;San Roque de Riomiera;337;197;140;2021
39;Cantabria;080;San Vicente de la Barquera;4073;2000;2073;2021
39;Cantabria;073;Santa Cruz de Bezana;13292;6498;6794;2021
39;Cantabria;074;Santa María de Cayón;9205;4587;4618;2021
39;Cantabria;075;Santander;172221;79453;92768;2021
39;Cantabria;076;Santillana del Mar;4231;2058;2173;2021
39;Cantabria;077;Santiurde de Reinosa;244;142;102;2021
39;Cantabria;078;Santiurde de Toranzo;1695;894;801;2021
39;Cantabria;079;Santoña;11011;5364;5647;2021
39;Cantabria;081;Saro;519;272;247;2021
39;Cantabria;082;Selaya;1854;936;918;2021
39;Cantabria;083;Soba;1153;641;512;2021
39;Cantabria;084;Solórzano;1048;556;492;2021
39;Cantabria;085;Suances;9026;4449;4577;2021
39;Cantabria;086;Tojos, Los;397;235;162;2021
39;Cantabria;087;Torrelavega;51237;24160;27077;2021
39;Cantabria;088;Tresviso;59;40;19;2021
39;Cantabria;089;Tudanca;148;104;44;2021
39;Cantabria;090;Udías;930;468;462;2021
39;Cantabria;095;Val de San Vicente;2786;1428;1358;2021
39;Cantabria;091;Valdáliga;2157;1128;1029;2021
39;Cantabria;092;Valdeolea;922;490;432;2021
39;Cantabria;093;Valdeprado del Río;316;176;140;2021
39;Cantabria;094;Valderredible;961;547;414;2021
39;Cantabria;101;Valle de Villaverde;276;151;125;2021
39;Cantabria;096;Vega de Liébana;718;375;343;2021
39;Cantabria;097;Vega de Pas;748;401;347;2021
39;Cantabria;098;Villacarriedo;1625;844;781;2021
39;Cantabria;099;Villaescusa;3958;1940;2018;2021
39;Cantabria;100;Villafufre;1012;526;486;2021
39;Cantabria;102;Voto;2789;1489;1300;2021
12;Castellón/Castelló;002;Aín;135;71;64;2021
12;Castellón/Castelló;003;Albocàsser;1253;633;620;2021
12;Castellón/Castelló;004;Alcalà de Xivert;6691;3427;3264;2021
12;Castellón/Castelló;005;Alcora, l';10428;5280;5148;2021
12;Castellón/Castelló;006;Alcudia de Veo;196;107;89;2021
12;Castellón/Castelló;007;Alfondeguilla;870;432;438;2021
12;Castellón/Castelló;008;Algimia de Almonacid;240;136;104;2021
12;Castellón/Castelló;009;Almassora;26878;13485;13393;2021
12;Castellón/Castelló;010;Almedíjar;254;140;114;2021
12;Castellón/Castelló;011;Almenara;6254;3143;3111;2021
12;Castellón/Castelló;901;Alqueries, les/Alquerías del Niño Perdido;4539;2270;2269;2021
12;Castellón/Castelló;012;Altura;3658;1891;1767;2021
12;Castellón/Castelló;013;Arañuel;152;82;70;2021
12;Castellón/Castelló;014;Ares del Maestrat;175;104;71;2021
12;Castellón/Castelló;015;Argelita;147;81;66;2021
12;Castellón/Castelló;016;Artana;1970;999;971;2021
12;Castellón/Castelló;001;Atzeneta del Maestrat;1292;655;637;2021
12;Castellón/Castelló;017;Ayódar;158;85;73;2021
12;Castellón/Castelló;018;Azuébar;319;172;147;2021
12;Castellón/Castelló;020;Barracas;185;101;84;2021
12;Castellón/Castelló;022;Bejís;390;218;172;2021
12;Castellón/Castelló;024;Benafer;173;94;79;2021
12;Castellón/Castelló;025;Benafigos;145;84;61;2021
12;Castellón/Castelló;026;Benassal;1055;539;516;2021
12;Castellón/Castelló;027;Benicarló;27658;13799;13859;2021
12;Castellón/Castelló;028;Benicasim/Benicàssim;18991;9437;9554;2021
12;Castellón/Castelló;029;Benlloc;1075;552;523;2021
12;Castellón/Castelló;021;Betxí;5605;2773;2832;2021
12;Castellón/Castelló;032;Borriana/Burriana;34903;17321;17582;2021
12;Castellón/Castelló;031;Borriol;5552;2835;2717;2021
12;Castellón/Castelló;033;Cabanes;3027;1537;1490;2021
12;Castellón/Castelló;034;Càlig;2002;1012;990;2021
12;Castellón/Castelló;036;Canet lo Roig;687;346;341;2021
12;Castellón/Castelló;037;Castell de Cabres;22;13;9;2021
12;Castellón/Castelló;038;Castellfort;179;97;82;2021
12;Castellón/Castelló;039;Castellnovo;914;464;450;2021
12;Castellón/Castelló;040;Castelló de la Plana;172589;83337;89252;2021
12;Castellón/Castelló;041;Castillo de Villamalefa;103;68;35;2021
12;Castellón/Castelló;042;Catí;714;358;356;2021
12;Castellón/Castelló;043;Caudiel;663;344;319;2021
12;Castellón/Castelló;044;Cervera del Maestre;577;276;301;2021
12;Castellón/Castelló;053;Chilches/Xilxes;2795;1441;1354;2021
12;Castellón/Castelló;055;Chodos/Xodos;109;67;42;2021
12;Castellón/Castelló;056;Chóvar;302;158;144;2021
12;Castellón/Castelló;045;Cinctorres;404;198;206;2021
12;Castellón/Castelló;046;Cirat;211;118;93;2021
12;Castellón/Castelló;048;Cortes de Arenoso;291;155;136;2021
12;Castellón/Castelló;049;Costur;531;278;253;2021
12;Castellón/Castelló;050;Coves de Vinromà, les;1792;902;890;2021
12;Castellón/Castelló;051;Culla;510;257;253;2021
12;Castellón/Castelló;057;Eslida;749;376;373;2021
12;Castellón/Castelló;058;Espadilla;84;46;38;2021
12;Castellón/Castelló;059;Fanzara;273;136;137;2021
12;Castellón/Castelló;060;Figueroles;531;264;267;2021
12;Castellón/Castelló;061;Forcall;454;218;236;2021
12;Castellón/Castelló;063;Fuente la Reina;49;30;19;2021
12;Castellón/Castelló;064;Fuentes de Ayódar;93;52;41;2021
12;Castellón/Castelló;065;Gaibiel;186;103;83;2021
12;Castellón/Castelló;067;Geldo;628;315;313;2021
12;Castellón/Castelló;068;Herbers;53;33;20;2021
12;Castellón/Castelló;069;Higueras;49;26;23;2021
12;Castellón/Castelló;070;Jana, la;664;340;324;2021
12;Castellón/Castelló;071;Jérica;1650;842;808;2021
12;Castellón/Castelló;074;Llosa, la;983;477;506;2021
12;Castellón/Castelló;072;Llucena/Lucena del Cid;1308;658;650;2021
12;Castellón/Castelló;073;Ludiente;155;86;69;2021
12;Castellón/Castelló;075;Mata de Morella, la;169;92;77;2021
12;Castellón/Castelló;076;Matet;73;44;29;2021
12;Castellón/Castelló;077;Moncofa;6958;3590;3368;2021
12;Castellón/Castelló;078;Montán;365;184;181;2021
12;Castellón/Castelló;079;Montanejos;544;284;260;2021
12;Castellón/Castelló;080;Morella;2406;1176;1230;2021
12;Castellón/Castelló;081;Navajas;750;385;365;2021
12;Castellón/Castelló;082;Nules;13256;6628;6628;2021
12;Castellón/Castelló;083;Olocau del Rey;117;62;55;2021
12;Castellón/Castelló;084;Onda;24939;12504;12435;2021
12;Castellón/Castelló;085;Oropesa del Mar/Orpesa;9755;4974;4781;2021
12;Castellón/Castelló;087;Palanques;36;21;15;2021
12;Castellón/Castelló;088;Pavías;72;45;27;2021
12;Castellón/Castelló;089;Peníscola/Peñíscola;7882;4002;3880;2021
12;Castellón/Castelló;090;Pina de Montalgrao;114;59;55;2021
12;Castellón/Castelló;093;Pobla de Benifassà, la;213;122;91;2021
12;Castellón/Castelló;094;Pobla Tornesa, la;1239;632;607;2021
12;Castellón/Castelló;091;Portell de Morella;181;92;89;2021
12;Castellón/Castelló;092;Puebla de Arenoso;158;86;72;2021
12;Castellón/Castelló;095;Ribesalbes;1156;598;558;2021
12;Castellón/Castelló;096;Rossell;904;476;428;2021
12;Castellón/Castelló;097;Sacañet;57;38;19;2021
12;Castellón/Castelló;098;Salzadella, la;683;353;330;2021
12;Castellón/Castelló;101;San Rafael del Río;468;235;233;2021
12;Castellón/Castelló;902;Sant Joan de Moró;3307;1714;1593;2021
12;Castellón/Castelló;099;Sant Jordi/San Jorge;1063;567;496;2021
12;Castellón/Castelló;100;Sant Mateu;1968;974;994;2021
12;Castellón/Castelló;102;Santa Magdalena de Pulpis;755;391;364;2021
12;Castellón/Castelló;104;Segorbe;9139;4551;4588;2021
12;Castellón/Castelló;103;Serratella, la;92;45;47;2021
12;Castellón/Castelló;105;Sierra Engarcerán;992;525;467;2021
12;Castellón/Castelló;106;Soneja;1479;735;744;2021
12;Castellón/Castelló;107;Sot de Ferrer;428;229;199;2021
12;Castellón/Castelló;108;Sueras/Suera;554;293;261;2021
12;Castellón/Castelló;109;Tales;843;433;410;2021
12;Castellón/Castelló;110;Teresa;245;131;114;2021
12;Castellón/Castelló;111;Tírig;419;211;208;2021
12;Castellón/Castelló;112;Todolella;145;84;61;2021
12;Castellón/Castelló;113;Toga;101;54;47;2021
12;Castellón/Castelló;114;Torás;247;138;109;2021
12;Castellón/Castelló;115;Toro, El;239;132;107;2021
12;Castellón/Castelló;116;Torralba del Pinar;63;30;33;2021
12;Castellón/Castelló;119;Torre d'En Besora, la;167;92;75;2021
12;Castellón/Castelló;120;Torre d'en Doménec, la;157;80;77;2021
12;Castellón/Castelló;117;Torreblanca;5606;2845;2761;2021
12;Castellón/Castelló;118;Torrechiva;93;49;44;2021
12;Castellón/Castelló;121;Traiguera;1358;693;665;2021
12;Castellón/Castelló;122;Useras/Useres, les;968;507;461;2021
12;Castellón/Castelló;124;Vall d'Alba;2943;1541;1402;2021
12;Castellón/Castelló;125;Vall de Almonacid;286;143;143;2021
12;Castellón/Castelló;126;Vall d'Uixó, la;31549;15506;16043;2021
12;Castellón/Castelló;123;Vallat;57;28;29;2021
12;Castellón/Castelló;127;Vallibona;67;40;27;2021
12;Castellón/Castelló;128;Vilafamés;1840;991;849;2021
12;Castellón/Castelló;129;Vilafranca/Villafranca del Cid;2201;1085;1116;2021
12;Castellón/Castelló;132;Vilanova d'Alcolea;578;297;281;2021
12;Castellón/Castelló;134;Vilar de Canes;174;88;86;2021
12;Castellón/Castelló;135;Vila-real;51130;25400;25730;2021
12;Castellón/Castelló;136;Vilavella, la;3111;1549;1562;2021
12;Castellón/Castelló;130;Villahermosa del Río;476;268;208;2021
12;Castellón/Castelló;131;Villamalur;92;61;31;2021
12;Castellón/Castelló;133;Villanueva de Viver;82;43;39;2021
12;Castellón/Castelló;137;Villores;46;22;24;2021
12;Castellón/Castelló;138;Vinaròs;28862;14267;14595;2021
12;Castellón/Castelló;139;Vistabella del Maestrat;337;183;154;2021
12;Castellón/Castelló;140;Viver;1661;851;810;2021
12;Castellón/Castelló;052;Xert;686;335;351;2021
12;Castellón/Castelló;141;Zorita del Maestrazgo;116;60;56;2021
12;Castellón/Castelló;142;Zucaina;175;98;77;2021
51;Ceuta;001;Ceuta;83517;42208;41309;2021
13;Ciudad Real;001;Abenójar;1339;691;648;2021
13;Ciudad Real;002;Agudo;1638;824;814;2021
13;Ciudad Real;003;Alamillo;470;242;228;2021
13;Ciudad Real;004;Albaladejo;1099;561;538;2021
13;Ciudad Real;005;Alcázar de San Juan;30548;14876;15672;2021
13;Ciudad Real;006;Alcoba;540;274;266;2021
13;Ciudad Real;007;Alcolea de Calatrava;1363;693;670;2021
13;Ciudad Real;008;Alcubillas;466;225;241;2021
13;Ciudad Real;009;Aldea del Rey;1598;805;793;2021
13;Ciudad Real;010;Alhambra;989;500;489;2021
13;Ciudad Real;011;Almadén;5105;2445;2660;2021
13;Ciudad Real;012;Almadenejos;398;206;192;2021
13;Ciudad Real;013;Almagro;8896;4395;4501;2021
13;Ciudad Real;014;Almedina;497;269;228;2021
13;Ciudad Real;015;Almodóvar del Campo;5947;2989;2958;2021
13;Ciudad Real;016;Almuradiel;750;376;374;2021
13;Ciudad Real;017;Anchuras;274;143;131;2021
13;Ciudad Real;903;Arenales de San Gregorio;572;295;277;2021
13;Ciudad Real;018;Arenas de San Juan;1033;529;504;2021
13;Ciudad Real;019;Argamasilla de Alba;6844;3435;3409;2021
13;Ciudad Real;020;Argamasilla de Calatrava;5853;2921;2932;2021
13;Ciudad Real;021;Arroba de los Montes;408;222;186;2021
13;Ciudad Real;022;Ballesteros de Calatrava;370;179;191;2021
13;Ciudad Real;023;Bolaños de Calatrava;11992;6165;5827;2021
13;Ciudad Real;024;Brazatortas;1002;523;479;2021
13;Ciudad Real;025;Cabezarados;307;168;139;2021
13;Ciudad Real;026;Cabezarrubias del Puerto;465;244;221;2021
13;Ciudad Real;027;Calzada de Calatrava;3615;1801;1814;2021
13;Ciudad Real;028;Campo de Criptana;13229;6614;6615;2021
13;Ciudad Real;029;Cañada de Calatrava;105;60;45;2021
13;Ciudad Real;030;Caracuel de Calatrava;116;68;48;2021
13;Ciudad Real;031;Carrión de Calatrava;3086;1559;1527;2021
13;Ciudad Real;032;Carrizosa;1175;599;576;2021
13;Ciudad Real;033;Castellar de Santiago;1833;936;897;2021
13;Ciudad Real;038;Chillón;1777;863;914;2021
13;Ciudad Real;034;Ciudad Real;75104;35566;39538;2021
13;Ciudad Real;035;Corral de Calatrava;1102;531;571;2021
13;Ciudad Real;036;Cortijos, Los;876;473;403;2021
13;Ciudad Real;037;Cózar;923;467;456;2021
13;Ciudad Real;039;Daimiel;17771;8913;8858;2021
13;Ciudad Real;040;Fernán Caballero;979;501;478;2021
13;Ciudad Real;041;Fontanarejo;248;141;107;2021
13;Ciudad Real;042;Fuencaliente;1018;527;491;2021
13;Ciudad Real;043;Fuenllana;214;114;100;2021
13;Ciudad Real;044;Fuente el Fresno;3141;1610;1531;2021
13;Ciudad Real;045;Granátula de Calatrava;719;356;363;2021
13;Ciudad Real;046;Guadalmez;725;353;372;2021
13;Ciudad Real;047;Herencia;8510;4314;4196;2021
13;Ciudad Real;048;Hinojosas de Calatrava;503;265;238;2021
13;Ciudad Real;049;Horcajo de los Montes;826;430;396;2021
13;Ciudad Real;050;Labores, Las;563;287;276;2021
13;Ciudad Real;904;Llanos del Caudillo;700;344;356;2021
13;Ciudad Real;051;Luciana;365;195;170;2021
13;Ciudad Real;052;Malagón;7842;3878;3964;2021
13;Ciudad Real;053;Manzanares;17845;8844;9001;2021
13;Ciudad Real;054;Membrilla;5927;2971;2956;2021
13;Ciudad Real;055;Mestanza;662;339;323;2021
13;Ciudad Real;056;Miguelturra;15658;7880;7778;2021
13;Ciudad Real;057;Montiel;1256;650;606;2021
13;Ciudad Real;058;Moral de Calatrava;5211;2638;2573;2021
13;Ciudad Real;059;Navalpino;208;111;97;2021
13;Ciudad Real;060;Navas de Estena;287;160;127;2021
13;Ciudad Real;061;Pedro Muñoz;7325;3694;3631;2021
13;Ciudad Real;062;Picón;661;343;318;2021
13;Ciudad Real;063;Piedrabuena;4390;2227;2163;2021
13;Ciudad Real;064;Poblete;2759;1425;1334;2021
13;Ciudad Real;065;Porzuna;3495;1808;1687;2021
13;Ciudad Real;066;Pozuelo de Calatrava;3623;1851;1772;2021
13;Ciudad Real;067;Pozuelos de Calatrava, Los;352;188;164;2021
13;Ciudad Real;068;Puebla de Don Rodrigo;1141;635;506;2021
13;Ciudad Real;069;Puebla del Príncipe;687;364;323;2021
13;Ciudad Real;070;Puerto Lápice;890;445;445;2021
13;Ciudad Real;071;Puertollano;46036;22214;23822;2021
13;Ciudad Real;072;Retuerta del Bullaque;930;518;412;2021
13;Ciudad Real;901;Robledo, El;1058;552;506;2021
13;Ciudad Real;902;Ruidera;563;277;286;2021
13;Ciudad Real;073;Saceruela;540;282;258;2021
13;Ciudad Real;074;San Carlos del Valle;1087;559;528;2021
13;Ciudad Real;075;San Lorenzo de Calatrava;211;119;92;2021
13;Ciudad Real;076;Santa Cruz de los Cáñamos;515;250;265;2021
13;Ciudad Real;077;Santa Cruz de Mudela;4017;2002;2015;2021
13;Ciudad Real;078;Socuéllamos;12067;6081;5986;2021
13;Ciudad Real;080;Solana del Pino;322;172;150;2021
13;Ciudad Real;079;Solana, La;15357;7802;7555;2021
13;Ciudad Real;081;Terrinches;633;331;302;2021
13;Ciudad Real;082;Tomelloso;35984;17902;18082;2021
13;Ciudad Real;083;Torralba de Calatrava;2990;1487;1503;2021
13;Ciudad Real;084;Torre de Juan Abad;990;486;504;2021
13;Ciudad Real;085;Torrenueva;2708;1375;1333;2021
13;Ciudad Real;086;Valdemanco del Esteras;164;86;78;2021
13;Ciudad Real;087;Valdepeñas;30218;14768;15450;2021
13;Ciudad Real;088;Valenzuela de Calatrava;658;303;355;2021
13;Ciudad Real;089;Villahermosa;1770;876;894;2021
13;Ciudad Real;090;Villamanrique;1114;547;567;2021
13;Ciudad Real;091;Villamayor de Calatrava;612;302;310;2021
13;Ciudad Real;092;Villanueva de la Fuente;1985;1023;962;2021
13;Ciudad Real;093;Villanueva de los Infantes;4852;2425;2427;2021
13;Ciudad Real;094;Villanueva de San Carlos;280;145;135;2021
13;Ciudad Real;095;Villar del Pozo;56;33;23;2021
13;Ciudad Real;096;Villarrubia de los Ojos;9722;4859;4863;2021
13;Ciudad Real;097;Villarta de San Juan;2723;1369;1354;2021
13;Ciudad Real;098;Viso del Marqués;2224;1085;1139;2021
14;Córdoba;001;Adamuz;4141;2122;2019;2021
14;Córdoba;002;Aguilar de la Frontera;13398;6684;6714;2021
14;Córdoba;003;Alcaracejos;1481;716;765;2021
14;Córdoba;004;Almedinilla;2352;1170;1182;2021
14;Córdoba;005;Almodóvar del Río;8036;4004;4032;2021
14;Córdoba;006;Añora;1526;754;772;2021
14;Córdoba;007;Baena;18885;9455;9430;2021
14;Córdoba;008;Belalcázar;3207;1557;1650;2021
14;Córdoba;009;Belmez;2905;1407;1498;2021
14;Córdoba;010;Benamejí;4982;2471;2511;2021
14;Córdoba;011;Blázquez, Los;659;337;322;2021
14;Córdoba;012;Bujalance;7316;3658;3658;2021
14;Córdoba;013;Cabra;20245;9870;10375;2021
14;Córdoba;014;Cañete de las Torres;2888;1489;1399;2021
14;Córdoba;015;Carcabuey;2374;1203;1171;2021
14;Córdoba;016;Cardeña;1473;746;727;2021
14;Córdoba;017;Carlota, La;14228;7070;7158;2021
14;Córdoba;018;Carpio, El;4382;2163;2219;2021
14;Córdoba;019;Castro del Río;7740;3826;3914;2021
14;Córdoba;020;Conquista;372;192;180;2021
14;Córdoba;021;Córdoba;322071;154617;167454;2021
14;Córdoba;022;Doña Mencía;4603;2239;2364;2021
14;Córdoba;023;Dos Torres;2399;1191;1208;2021
14;Córdoba;024;Encinas Reales;2256;1116;1140;2021
14;Córdoba;025;Espejo;3272;1641;1631;2021
14;Córdoba;026;Espiel;2424;1210;1214;2021
14;Córdoba;027;Fernán-Núñez;9667;4809;4858;2021
14;Córdoba;901;Fuente Carreteros;1133;586;547;2021
14;Córdoba;028;Fuente la Lancha;337;165;172;2021
14;Córdoba;029;Fuente Obejuna;4505;2331;2174;2021
14;Córdoba;030;Fuente Palmera;9803;4890;4913;2021
14;Córdoba;031;Fuente-Tójar;676;328;348;2021
14;Córdoba;032;Granjuela, La;432;217;215;2021
14;Córdoba;033;Guadalcázar;1562;779;783;2021
14;Córdoba;902;Guijarrosa, La;1365;699;666;2021
14;Córdoba;034;Guijo, El;349;179;170;2021
14;Córdoba;035;Hinojosa del Duque;6684;3297;3387;2021
14;Córdoba;036;Hornachuelos;4517;2249;2268;2021
14;Córdoba;037;Iznájar;4106;2074;2032;2021
14;Córdoba;038;Lucena;42712;21254;21458;2021
14;Córdoba;039;Luque;2945;1483;1462;2021
14;Córdoba;040;Montalbán de Córdoba;4517;2232;2285;2021
14;Córdoba;041;Montemayor;3851;1929;1922;2021
14;Córdoba;042;Montilla;22633;11214;11419;2021
14;Córdoba;043;Montoro;9231;4558;4673;2021
14;Córdoba;044;Monturque;1948;967;981;2021
14;Córdoba;045;Moriles;3721;1868;1853;2021
14;Córdoba;046;Nueva Carteya;5341;2717;2624;2021
14;Córdoba;047;Obejo;2025;1054;971;2021
14;Córdoba;048;Palenciana;1463;742;721;2021
14;Córdoba;049;Palma del Río;20910;10407;10503;2021
14;Córdoba;050;Pedro Abad;2808;1409;1399;2021
14;Córdoba;051;Pedroche;1491;746;745;2021
14;Córdoba;052;Peñarroya-Pueblonuevo;10508;5091;5417;2021
14;Córdoba;053;Posadas;7296;3615;3681;2021
14;Córdoba;054;Pozoblanco;17156;8321;8835;2021
14;Córdoba;055;Priego de Córdoba;22251;10867;11384;2021
14;Córdoba;056;Puente Genil;29767;14685;15082;2021
14;Córdoba;057;Rambla, La;7515;3763;3752;2021
14;Córdoba;058;Rute;9835;4918;4917;2021
14;Córdoba;059;San Sebastián de los Ballesteros;829;420;409;2021
14;Córdoba;061;Santa Eufemia;747;374;373;2021
14;Córdoba;060;Santaella;4611;2319;2292;2021
14;Córdoba;062;Torrecampo;1020;503;517;2021
14;Córdoba;063;Valenzuela;1098;553;545;2021
14;Córdoba;064;Valsequillo;346;169;177;2021
14;Córdoba;065;Victoria, La;2336;1173;1163;2021
14;Córdoba;066;Villa del Río;7016;3482;3534;2021
14;Córdoba;067;Villafranca de Córdoba;4897;2507;2390;2021
14;Córdoba;068;Villaharta;640;319;321;2021
14;Córdoba;069;Villanueva de Córdoba;8662;4294;4368;2021
14;Córdoba;070;Villanueva del Duque;1451;734;717;2021
14;Córdoba;071;Villanueva del Rey;997;496;501;2021
14;Córdoba;072;Villaralto;1102;557;545;2021
14;Córdoba;073;Villaviciosa de Córdoba;3191;1636;1555;2021
14;Córdoba;074;Viso, El;2537;1267;1270;2021
14;Córdoba;075;Zuheros;634;319;315;2021
15;Coruña, A;001;Abegondo;5494;2701;2793;2021
15;Coruña, A;002;Ames;31993;15379;16614;2021
15;Coruña, A;003;Aranga;1833;941;892;2021
15;Coruña, A;004;Ares;5997;2951;3046;2021
15;Coruña, A;005;Arteixo;32894;16272;16622;2021
15;Coruña, A;006;Arzúa;5964;2981;2983;2021
15;Coruña, A;007;Baña, A;3389;1597;1792;2021
15;Coruña, A;008;Bergondo;6817;3331;3486;2021
15;Coruña, A;009;Betanzos;13030;6187;6843;2021
15;Coruña, A;010;Boimorto;1943;972;971;2021
15;Coruña, A;011;Boiro;18955;9206;9749;2021
15;Coruña, A;012;Boqueixón;4186;2050;2136;2021
15;Coruña, A;013;Brión;7957;3817;4140;2021
15;Coruña, A;014;Cabana de Bergantiños;4185;2022;2163;2021
15;Coruña, A;015;Cabanas;3359;1645;1714;2021
15;Coruña, A;016;Camariñas;5224;2552;2672;2021
15;Coruña, A;017;Cambre;24616;11986;12630;2021
15;Coruña, A;018;Capela, A;1242;617;625;2021
15;Coruña, A;019;Carballo;31414;15347;16067;2021
15;Coruña, A;901;Cariño;3763;1855;1908;2021
15;Coruña, A;020;Carnota;3854;1821;2033;2021
15;Coruña, A;021;Carral;6574;3232;3342;2021
15;Coruña, A;022;Cedeira;6650;3324;3326;2021
15;Coruña, A;023;Cee;7568;3617;3951;2021
15;Coruña, A;024;Cerceda;4996;2466;2530;2021
15;Coruña, A;025;Cerdido;1075;528;547;2021
15;Coruña, A;027;Coirós;1873;929;944;2021
15;Coruña, A;028;Corcubión;1606;795;811;2021
15;Coruña, A;029;Coristanco;5878;2824;3054;2021
15;Coruña, A;030;Coruña, A;245468;113806;131662;2021
15;Coruña, A;031;Culleredo;30758;14820;15938;2021
15;Coruña, A;032;Curtis;4081;2048;2033;2021
15;Coruña, A;033;Dodro;2710;1304;1406;2021
15;Coruña, A;034;Dumbría;2927;1405;1522;2021
15;Coruña, A;035;Fene;12832;6114;6718;2021
15;Coruña, A;036;Ferrol;64785;30473;34312;2021
15;Coruña, A;037;Fisterra;4714;2393;2321;2021
15;Coruña, A;038;Frades;2306;1135;1171;2021
15;Coruña, A;039;Irixoa;1340;677;663;2021
15;Coruña, A;041;Laracha, A;11521;5669;5852;2021
15;Coruña, A;040;Laxe;3004;1511;1493;2021
15;Coruña, A;042;Lousame;3235;1618;1617;2021
15;Coruña, A;043;Malpica de Bergantiños;5332;2605;2727;2021
15;Coruña, A;044;Mañón;1309;646;663;2021
15;Coruña, A;045;Mazaricos;3806;1809;1997;2021
15;Coruña, A;046;Melide;7427;3661;3766;2021
15;Coruña, A;047;Mesía;2479;1233;1246;2021
15;Coruña, A;048;Miño;6423;3214;3209;2021
15;Coruña, A;049;Moeche;1200;573;627;2021
15;Coruña, A;050;Monfero;1908;977;931;2021
15;Coruña, A;051;Mugardos;5226;2542;2684;2021
15;Coruña, A;053;Muros;8399;4048;4351;2021
15;Coruña, A;052;Muxía;4564;2193;2371;2021
15;Coruña, A;054;Narón;38913;18851;20062;2021
15;Coruña, A;055;Neda;5032;2451;2581;2021
15;Coruña, A;056;Negreira;6775;3268;3507;2021
15;Coruña, A;057;Noia;14240;6810;7430;2021
15;Coruña, A;058;Oleiros;36922;17831;19091;2021
15;Coruña, A;059;Ordes;12605;6160;6445;2021
15;Coruña, A;060;Oroso;7530;3718;3812;2021
15;Coruña, A;061;Ortigueira;5485;2594;2891;2021
15;Coruña, A;062;Outes;6150;2957;3193;2021
15;Coruña, A;902;Oza-Cesuras;5170;2611;2559;2021
15;Coruña, A;064;Paderne;2393;1185;1208;2021
15;Coruña, A;065;Padrón;8317;4011;4306;2021
15;Coruña, A;066;Pino, O;4639;2349;2290;2021
15;Coruña, A;067;Pobra do Caramiñal, A;9291;4543;4748;2021
15;Coruña, A;068;Ponteceso;5457;2730;2727;2021
15;Coruña, A;069;Pontedeume;7687;3683;4004;2021
15;Coruña, A;070;Pontes de García Rodríguez, As;10032;4900;5132;2021
15;Coruña, A;071;Porto do Son;9155;4557;4598;2021
15;Coruña, A;072;Rianxo;11004;5382;5622;2021
15;Coruña, A;073;Ribeira;26839;13234;13605;2021
15;Coruña, A;074;Rois;4493;2145;2348;2021
15;Coruña, A;075;Sada;16382;8006;8376;2021
15;Coruña, A;076;San Sadurniño;2812;1395;1417;2021
15;Coruña, A;077;Santa Comba;9359;4538;4821;2021
15;Coruña, A;078;Santiago de Compostela;97858;45505;52353;2021
15;Coruña, A;079;Santiso;1529;794;735;2021
15;Coruña, A;080;Sobrado;1778;923;855;2021
15;Coruña, A;081;Somozas, As;1076;547;529;2021
15;Coruña, A;082;Teo;18778;9187;9591;2021
15;Coruña, A;083;Toques;1101;564;537;2021
15;Coruña, A;084;Tordoia;3228;1534;1694;2021
15;Coruña, A;085;Touro;3495;1730;1765;2021
15;Coruña, A;086;Trazo;3059;1503;1556;2021
15;Coruña, A;088;Val do Dubra;3816;1829;1987;2021
15;Coruña, A;087;Valdoviño;6872;3357;3515;2021
15;Coruña, A;089;Vedra;5032;2478;2554;2021
15;Coruña, A;091;Vilarmaior;1219;626;593;2021
15;Coruña, A;090;Vilasantar;1219;643;576;2021
15;Coruña, A;092;Vimianzo;6925;3348;3577;2021
15;Coruña, A;093;Zas;4384;2108;2276;2021
16;Cuenca;001;Abia de la Obispalía;57;35;22;2021
16;Cuenca;002;Acebrón, El;227;107;120;2021
16;Cuenca;003;Alarcón;151;69;82;2021
16;Cuenca;004;Albaladejo del Cuende;236;125;111;2021
16;Cuenca;005;Albalate de las Nogueras;256;137;119;2021
16;Cuenca;006;Albendea;122;58;64;2021
16;Cuenca;007;Alberca de Záncara, La;1581;808;773;2021
16;Cuenca;008;Alcalá de la Vega;85;52;33;2021
16;Cuenca;009;Alcantud;48;27;21;2021
16;Cuenca;010;Alcázar del Rey;128;68;60;2021
16;Cuenca;011;Alcohujate;29;16;13;2021
16;Cuenca;012;Alconchel de la Estrella;86;49;37;2021
16;Cuenca;013;Algarra;24;11;13;2021
16;Cuenca;014;Aliaguilla;644;331;313;2021
16;Cuenca;015;Almarcha, La;414;227;187;2021
16;Cuenca;016;Almendros;234;129;105;2021
16;Cuenca;017;Almodóvar del Pinar;383;199;184;2021
16;Cuenca;018;Almonacid del Marquesado;440;227;213;2021
16;Cuenca;019;Altarejos;200;105;95;2021
16;Cuenca;020;Arandilla del Arroyo;7;5;2;2021
16;Cuenca;905;Arcas;1867;932;935;2021
16;Cuenca;022;Arcos de la Sierra;73;44;29;2021
16;Cuenca;024;Arguisuelas;135;68;67;2021
16;Cuenca;025;Arrancacepas;20;11;9;2021
16;Cuenca;026;Atalaya del Cañavate;103;54;49;2021
16;Cuenca;027;Barajas de Melo;1005;532;473;2021
16;Cuenca;029;Barchín del Hoyo;94;63;31;2021
16;Cuenca;030;Bascuñana de San Pedro;20;17;3;2021
16;Cuenca;031;Beamud;38;20;18;2021
16;Cuenca;032;Belinchón;369;190;179;2021
16;Cuenca;033;Belmonte;1810;891;919;2021
16;Cuenca;034;Belmontejo;143;83;60;2021
16;Cuenca;035;Beteta;230;113;117;2021
16;Cuenca;036;Boniches;139;69;70;2021
16;Cuenca;038;Buciegas;32;22;10;2021
16;Cuenca;039;Buenache de Alarcón;454;242;212;2021
16;Cuenca;040;Buenache de la Sierra;105;59;46;2021
16;Cuenca;041;Buendía;410;221;189;2021
16;Cuenca;042;Campillo de Altobuey;1246;623;623;2021
16;Cuenca;043;Campillos-Paravientos;101;61;40;2021
16;Cuenca;044;Campillos-Sierra;32;15;17;2021
16;Cuenca;901;Campos del Paraíso;714;372;342;2021
16;Cuenca;045;Canalejas del Arroyo;170;94;76;2021
16;Cuenca;046;Cañada del Hoyo;224;116;108;2021
16;Cuenca;047;Cañada Juncosa;241;133;108;2021
16;Cuenca;048;Cañamares;459;253;206;2021
16;Cuenca;049;Cañavate, El;140;67;73;2021
16;Cuenca;050;Cañaveras;236;117;119;2021
16;Cuenca;051;Cañaveruelas;130;66;64;2021
16;Cuenca;052;Cañete;766;396;370;2021
16;Cuenca;053;Cañizares;428;232;196;2021
16;Cuenca;055;Carboneras de Guadazaón;778;402;376;2021
16;Cuenca;056;Cardenete;488;254;234;2021
16;Cuenca;057;Carrascosa;67;40;27;2021
16;Cuenca;058;Carrascosa de Haro;101;51;50;2021
16;Cuenca;060;Casas de Benítez;816;397;419;2021
16;Cuenca;061;Casas de Fernando Alonso;1147;597;550;2021
16;Cuenca;062;Casas de Garcimolina;29;18;11;2021
16;Cuenca;063;Casas de Guijarro;119;62;57;2021
16;Cuenca;064;Casas de Haro;835;445;390;2021
16;Cuenca;065;Casas de los Pinos;417;202;215;2021
16;Cuenca;066;Casasimarro;3089;1601;1488;2021
16;Cuenca;067;Castejón;122;68;54;2021
16;Cuenca;068;Castillejo de Iniesta;129;70;59;2021
16;Cuenca;070;Castillejo-Sierra;29;16;13;2021
16;Cuenca;072;Castillo de Garcimuñoz;128;75;53;2021
16;Cuenca;071;Castillo-Albaráñez;20;9;11;2021
16;Cuenca;073;Cervera del Llano;217;113;104;2021
16;Cuenca;023;Chillarón de Cuenca;698;364;334;2021
16;Cuenca;081;Chumillas;58;32;26;2021
16;Cuenca;074;Cierva, La;34;20;14;2021
16;Cuenca;078;Cuenca;53988;25588;28400;2021
16;Cuenca;079;Cueva del Hierro;35;22;13;2021
16;Cuenca;082;Enguídanos;303;165;138;2021
16;Cuenca;083;Fresneda de Altarejos;37;21;16;2021
16;Cuenca;084;Fresneda de la Sierra;49;28;21;2021
16;Cuenca;085;Frontera, La;143;76;67;2021
16;Cuenca;086;Fuente de Pedro Naharro;1209;625;584;2021
16;Cuenca;087;Fuentelespino de Haro;246;126;120;2021
16;Cuenca;088;Fuentelespino de Moya;103;55;48;2021
16;Cuenca;904;Fuentenava de Jábaga;527;273;254;2021
16;Cuenca;089;Fuentes;466;242;224;2021
16;Cuenca;091;Fuertescusa;57;31;26;2021
16;Cuenca;092;Gabaldón;170;100;70;2021
16;Cuenca;093;Garaballa;63;33;30;2021
16;Cuenca;094;Gascueña;148;86;62;2021
16;Cuenca;095;Graja de Campalbo;91;50;41;2021
16;Cuenca;096;Graja de Iniesta;354;185;169;2021
16;Cuenca;097;Henarejos;137;72;65;2021
16;Cuenca;098;Herrumblar, El;690;353;337;2021
16;Cuenca;099;Hinojosa, La;195;99;96;2021
16;Cuenca;100;Hinojosos, Los;765;388;377;2021
16;Cuenca;101;Hito, El;159;83;76;2021
16;Cuenca;102;Honrubia;1507;747;760;2021
16;Cuenca;103;Hontanaya;250;144;106;2021
16;Cuenca;104;Hontecillas;62;32;30;2021
16;Cuenca;106;Horcajo de Santiago;3545;1801;1744;2021
16;Cuenca;107;Huélamo;78;43;35;2021
16;Cuenca;108;Huelves;84;48;36;2021
16;Cuenca;109;Huérguina;53;29;24;2021
16;Cuenca;110;Huerta de la Obispalía;126;73;53;2021
16;Cuenca;111;Huerta del Marquesado;185;103;82;2021
16;Cuenca;112;Huete;1746;896;850;2021
16;Cuenca;113;Iniesta;4355;2153;2202;2021
16;Cuenca;115;Laguna del Marquesado;54;31;23;2021
16;Cuenca;116;Lagunaseca;55;33;22;2021
16;Cuenca;117;Landete;1211;621;590;2021
16;Cuenca;118;Ledaña;1562;778;784;2021
16;Cuenca;119;Leganiel;209;108;101;2021
16;Cuenca;121;Majadas, Las;234;123;111;2021
16;Cuenca;122;Mariana;304;158;146;2021
16;Cuenca;123;Masegosa;61;34;27;2021
16;Cuenca;124;Mesas, Las;2310;1188;1122;2021
16;Cuenca;125;Minglanilla;2237;1146;1091;2021
16;Cuenca;126;Mira;908;453;455;2021
16;Cuenca;128;Monreal del Llano;52;30;22;2021
16;Cuenca;129;Montalbanejo;99;50;49;2021
16;Cuenca;130;Montalbo;670;346;324;2021
16;Cuenca;131;Monteagudo de las Salinas;119;69;50;2021
16;Cuenca;132;Mota de Altarejos;32;20;12;2021
16;Cuenca;133;Mota del Cuervo;6035;3007;3028;2021
16;Cuenca;134;Motilla del Palancar;5964;2968;2996;2021
16;Cuenca;135;Moya;129;76;53;2021
16;Cuenca;137;Narboneta;42;22;20;2021
16;Cuenca;139;Olivares de Júcar;295;152;143;2021
16;Cuenca;140;Olmeda de la Cuesta;21;13;8;2021
16;Cuenca;141;Olmeda del Rey;130;64;66;2021
16;Cuenca;142;Olmedilla de Alarcón;142;85;57;2021
16;Cuenca;143;Olmedilla de Eliz;15;12;3;2021
16;Cuenca;145;Osa de la Vega;455;236;219;2021
16;Cuenca;146;Pajarón;77;36;41;2021
16;Cuenca;147;Pajaroncillo;56;35;21;2021
16;Cuenca;148;Palomares del Campo;571;292;279;2021
16;Cuenca;149;Palomera;157;76;81;2021
16;Cuenca;150;Paracuellos;91;47;44;2021
16;Cuenca;151;Paredes;57;33;24;2021
16;Cuenca;152;Parra de las Vegas, La;33;24;9;2021
16;Cuenca;153;Pedernoso, El;1132;559;573;2021
16;Cuenca;154;Pedroñeras, Las;6638;3399;3239;2021
16;Cuenca;155;Peral, El;633;356;277;2021
16;Cuenca;156;Peraleja, La;93;57;36;2021
16;Cuenca;157;Pesquera, La;209;115;94;2021
16;Cuenca;158;Picazo, El;660;337;323;2021
16;Cuenca;159;Pinarejo;191;96;95;2021
16;Cuenca;160;Pineda de Gigüela;61;42;19;2021
16;Cuenca;161;Piqueras del Castillo;45;25;20;2021
16;Cuenca;162;Portalrubio de Guadamejud;35;19;16;2021
16;Cuenca;163;Portilla;58;31;27;2021
16;Cuenca;165;Poyatos;58;32;26;2021
16;Cuenca;166;Pozoamargo;289;159;130;2021
16;Cuenca;908;Pozorrubielos de la Mancha;191;102;89;2021
16;Cuenca;167;Pozorrubio de Santiago;322;153;169;2021
16;Cuenca;169;Pozuelo, El;40;28;12;2021
16;Cuenca;170;Priego;892;451;441;2021
16;Cuenca;171;Provencio, El;2416;1208;1208;2021
16;Cuenca;172;Puebla de Almenara;334;178;156;2021
16;Cuenca;174;Puebla del Salvador;185;100;85;2021
16;Cuenca;175;Quintanar del Rey;7616;3933;3683;2021
16;Cuenca;176;Rada de Haro;53;34;19;2021
16;Cuenca;177;Reíllo;111;58;53;2021
16;Cuenca;181;Rozalén del Monte;60;30;30;2021
16;Cuenca;185;Saceda-Trasierra;42;27;15;2021
16;Cuenca;186;Saelices;459;236;223;2021
16;Cuenca;187;Salinas del Manzano;74;44;30;2021
16;Cuenca;188;Salmeroncillos;100;58;42;2021
16;Cuenca;189;Salvacañete;287;147;140;2021
16;Cuenca;190;San Clemente;6953;3506;3447;2021
16;Cuenca;191;San Lorenzo de la Parrilla;1052;537;515;2021
16;Cuenca;192;San Martín de Boniches;45;24;21;2021
16;Cuenca;193;San Pedro Palmiches;50;29;21;2021
16;Cuenca;194;Santa Cruz de Moya;232;121;111;2021
16;Cuenca;196;Santa María de los Llanos;681;362;319;2021
16;Cuenca;195;Santa María del Campo Rus;534;270;264;2021
16;Cuenca;197;Santa María del Val;62;35;27;2021
16;Cuenca;198;Sisante;1619;826;793;2021
16;Cuenca;199;Solera de Gabaldón;27;15;12;2021
16;Cuenca;909;Sotorribas;681;360;321;2021
16;Cuenca;202;Talayuelas;849;452;397;2021
16;Cuenca;203;Tarancón;15645;7735;7910;2021
16;Cuenca;204;Tébar;292;155;137;2021
16;Cuenca;205;Tejadillos;115;52;63;2021
16;Cuenca;206;Tinajas;201;109;92;2021
16;Cuenca;209;Torralba;109;64;45;2021
16;Cuenca;211;Torrejoncillo del Rey;358;198;160;2021
16;Cuenca;212;Torrubia del Campo;281;136;145;2021
16;Cuenca;213;Torrubia del Castillo;36;21;15;2021
16;Cuenca;215;Tragacete;261;148;113;2021
16;Cuenca;216;Tresjuncos;268;145;123;2021
16;Cuenca;217;Tribaldos;97;52;45;2021
16;Cuenca;218;Uclés;226;118;108;2021
16;Cuenca;219;Uña;89;48;41;2021
16;Cuenca;906;Valdecolmenas, Los;70;45;25;2021
16;Cuenca;224;Valdemeca;73;44;29;2021
16;Cuenca;225;Valdemorillo de la Sierra;56;32;24;2021
16;Cuenca;227;Valdemoro-Sierra;112;61;51;2021
16;Cuenca;228;Valdeolivas;204;127;77;2021
16;Cuenca;902;Valdetórtola;124;73;51;2021
16;Cuenca;903;Valeras, Las;1479;781;698;2021
16;Cuenca;231;Valhermoso de la Fuente;46;23;23;2021
16;Cuenca;173;Valle de Altomira, El;198;106;92;2021
16;Cuenca;234;Valsalobre;21;11;10;2021
16;Cuenca;236;Valverde de Júcar;1108;561;547;2021
16;Cuenca;237;Valverdejo;95;52;43;2021
16;Cuenca;238;Vara de Rey;473;243;230;2021
16;Cuenca;239;Vega del Codorno;130;81;49;2021
16;Cuenca;240;Vellisca;112;63;49;2021
16;Cuenca;242;Villaconejos de Trabaque;323;165;158;2021
16;Cuenca;243;Villaescusa de Haro;471;237;234;2021
16;Cuenca;244;Villagarcía del Llano;719;361;358;2021
16;Cuenca;245;Villalba de la Sierra;469;233;236;2021
16;Cuenca;246;Villalba del Rey;492;262;230;2021
16;Cuenca;247;Villalgordo del Marquesado;73;40;33;2021
16;Cuenca;248;Villalpardo;993;498;495;2021
16;Cuenca;249;Villamayor de Santiago;2466;1260;1206;2021
16;Cuenca;250;Villanueva de Guadamejud;67;41;26;2021
16;Cuenca;251;Villanueva de la Jara;2280;1155;1125;2021
16;Cuenca;253;Villar de Cañas;386;203;183;2021
16;Cuenca;254;Villar de Domingo García;207;101;106;2021
16;Cuenca;255;Villar de la Encina;147;78;69;2021
16;Cuenca;263;Villar de Olalla;1313;697;616;2021
16;Cuenca;258;Villar del Humo;173;99;74;2021
16;Cuenca;259;Villar del Infantado;45;25;20;2021
16;Cuenca;910;Villar y Velasco;73;42;31;2021
16;Cuenca;264;Villarejo de Fuentes;401;202;199;2021
16;Cuenca;265;Villarejo de la Peñuela;23;12;11;2021
16;Cuenca;266;Villarejo-Periesteban;384;191;193;2021
16;Cuenca;269;Villares del Saz;447;230;217;2021
16;Cuenca;270;Villarrubio;200;112;88;2021
16;Cuenca;271;Villarta;808;403;405;2021
16;Cuenca;272;Villas de la Ventosa;214;121;93;2021
16;Cuenca;273;Villaverde y Pasaconsol;335;174;161;2021
16;Cuenca;274;Víllora;120;65;55;2021
16;Cuenca;275;Vindel;11;7;4;2021
16;Cuenca;276;Yémeda;17;12;5;2021
16;Cuenca;277;Zafra de Záncara;106;60;46;2021
16;Cuenca;278;Zafrilla;57;31;26;2021
16;Cuenca;279;Zarza de Tajo;269;146;123;2021
16;Cuenca;280;Zarzuela;159;87;72;2021
20;Gipuzkoa;001;Abaltzisketa;312;168;144;2021
20;Gipuzkoa;002;Aduna;482;258;224;2021
20;Gipuzkoa;016;Aia;2056;1087;969;2021
20;Gipuzkoa;003;Aizarnazabal;795;405;390;2021
20;Gipuzkoa;004;Albiztur;316;160;156;2021
20;Gipuzkoa;005;Alegia;1762;910;852;2021
20;Gipuzkoa;006;Alkiza;362;175;187;2021
20;Gipuzkoa;906;Altzaga;177;84;93;2021
20;Gipuzkoa;007;Altzo;447;229;218;2021
20;Gipuzkoa;008;Amezketa;945;504;441;2021
20;Gipuzkoa;009;Andoain;14631;7230;7401;2021
20;Gipuzkoa;010;Anoeta;2086;1075;1011;2021
20;Gipuzkoa;011;Antzuola;2081;1041;1040;2021
20;Gipuzkoa;012;Arama;200;97;103;2021
20;Gipuzkoa;013;Aretxabaleta;7108;3565;3543;2021
20;Gipuzkoa;055;Arrasate/Mondragón;21867;10738;11129;2021
20;Gipuzkoa;014;Asteasu;1549;792;757;2021
20;Gipuzkoa;903;Astigarraga;7185;3665;3520;2021
20;Gipuzkoa;015;Ataun;1697;872;825;2021
20;Gipuzkoa;017;Azkoitia;11657;5802;5855;2021
20;Gipuzkoa;018;Azpeitia;15191;7605;7586;2021
20;Gipuzkoa;904;Baliarrain;153;86;67;2021
20;Gipuzkoa;019;Beasain;13949;6999;6950;2021
20;Gipuzkoa;020;Beizama;144;88;56;2021
20;Gipuzkoa;021;Belauntza;253;131;122;2021
20;Gipuzkoa;022;Berastegi;1099;559;540;2021
20;Gipuzkoa;074;Bergara;14584;7243;7341;2021
20;Gipuzkoa;023;Berrobi;598;314;284;2021
20;Gipuzkoa;024;Bidania-Goiatz;534;286;248;2021
20;Gipuzkoa;029;Deba;5441;2696;2745;2021
20;Gipuzkoa;069;Donostia/San Sebastián;188102;88861;99241;2021
20;Gipuzkoa;030;Eibar;27467;13379;14088;2021
20;Gipuzkoa;031;Elduain;244;124;120;2021
20;Gipuzkoa;033;Elgeta;1141;580;561;2021
20;Gipuzkoa;032;Elgoibar;11464;5635;5829;2021
20;Gipuzkoa;067;Errenteria;39219;18951;20268;2021
20;Gipuzkoa;066;Errezil;578;301;277;2021
20;Gipuzkoa;034;Eskoriatza;4131;2076;2055;2021
20;Gipuzkoa;035;Ezkio-Itsaso;614;317;297;2021
20;Gipuzkoa;038;Gabiria;502;272;230;2021
20;Gipuzkoa;037;Gaintza;126;72;54;2021
20;Gipuzkoa;907;Gaztelu;173;90;83;2021
20;Gipuzkoa;039;Getaria;2794;1398;1396;2021
20;Gipuzkoa;040;Hernani;20362;9974;10388;2021
20;Gipuzkoa;041;Hernialde;321;167;154;2021
20;Gipuzkoa;036;Hondarribia;16852;8390;8462;2021
20;Gipuzkoa;042;Ibarra;4220;2096;2124;2021
20;Gipuzkoa;043;Idiazabal;2281;1152;1129;2021
20;Gipuzkoa;044;Ikaztegieta;485;250;235;2021
20;Gipuzkoa;045;Irun;62933;30835;32098;2021
20;Gipuzkoa;046;Irura;1877;986;891;2021
20;Gipuzkoa;047;Itsasondo;658;338;320;2021
20;Gipuzkoa;048;Larraul;259;148;111;2021
20;Gipuzkoa;902;Lasarte-Oria;18893;9170;9723;2021
20;Gipuzkoa;049;Lazkao;6007;3000;3007;2021
20;Gipuzkoa;050;Leaburu;380;204;176;2021
20;Gipuzkoa;051;Legazpi;8367;4211;4156;2021
20;Gipuzkoa;052;Legorreta;1440;720;720;2021
20;Gipuzkoa;068;Leintz-Gatzaga;211;118;93;2021
20;Gipuzkoa;053;Lezo;6062;3023;3039;2021
20;Gipuzkoa;054;Lizartza;625;329;296;2021
20;Gipuzkoa;901;Mendaro;1983;1000;983;2021
20;Gipuzkoa;057;Mutiloa;256;135;121;2021
20;Gipuzkoa;056;Mutriku;5284;2644;2640;2021
20;Gipuzkoa;063;Oiartzun;10291;5074;5217;2021
20;Gipuzkoa;058;Olaberria;938;472;466;2021
20;Gipuzkoa;059;Oñati;11428;5620;5808;2021
20;Gipuzkoa;076;Ordizia;10420;5200;5220;2021
20;Gipuzkoa;905;Orendain;230;112;118;2021
20;Gipuzkoa;060;Orexa;117;66;51;2021
20;Gipuzkoa;061;Orio;6096;3045;3051;2021
20;Gipuzkoa;062;Ormaiztegi;1248;626;622;2021
20;Gipuzkoa;064;Pasaia;15867;7617;8250;2021
20;Gipuzkoa;070;Segura;1461;729;732;2021
20;Gipuzkoa;065;Soraluze-Placencia de las Armas;3903;1966;1937;2021
20;Gipuzkoa;071;Tolosa;19795;9559;10236;2021
20;Gipuzkoa;072;Urnieta;6197;3119;3078;2021
20;Gipuzkoa;077;Urretxu;6773;3359;3414;2021
20;Gipuzkoa;073;Usurbil;6132;3064;3068;2021
20;Gipuzkoa;075;Villabona;5864;2928;2936;2021
20;Gipuzkoa;078;Zaldibia;1636;838;798;2021
20;Gipuzkoa;079;Zarautz;23271;11298;11973;2021
20;Gipuzkoa;025;Zegama;1550;784;766;2021
20;Gipuzkoa;026;Zerain;282;137;145;2021
20;Gipuzkoa;027;Zestoa;3769;1974;1795;2021
20;Gipuzkoa;028;Zizurkil;3001;1518;1483;2021
20;Gipuzkoa;081;Zumaia;10124;5036;5088;2021
20;Gipuzkoa;080;Zumarraga;9668;4766;4902;2021
17;Girona;001;Agullana;885;445;440;2021
17;Girona;002;Aiguaviva;789;395;394;2021
17;Girona;003;Albanyà;178;90;88;2021
17;Girona;004;Albons;798;407;391;2021
17;Girona;006;Alp;1645;849;796;2021
17;Girona;007;Amer;2383;1170;1213;2021
17;Girona;008;Anglès;5709;2850;2859;2021
17;Girona;009;Arbúcies;6507;3355;3152;2021
17;Girona;010;Argelaguer;417;212;205;2021
17;Girona;011;Armentera, L';998;503;495;2021
17;Girona;012;Avinyonet de Puigventós;1657;825;832;2021
17;Girona;015;Banyoles;20168;10040;10128;2021
17;Girona;016;Bàscara;1015;523;492;2021
17;Girona;013;Begur;4039;2020;2019;2021
17;Girona;018;Bellcaire d'Empordà;699;330;369;2021
17;Girona;019;Besalú;2502;1175;1327;2021
17;Girona;020;Bescanó;5094;2567;2527;2021
17;Girona;021;Beuda;187;96;91;2021
17;Girona;022;Bisbal d'Empordà, La;11190;5596;5594;2021
17;Girona;234;Biure;244;127;117;2021
17;Girona;023;Blanes;40274;20054;20220;2021
17;Girona;029;Boadella i les Escaules;271;138;133;2021
17;Girona;024;Bolvir;489;256;233;2021
17;Girona;025;Bordils;1796;904;892;2021
17;Girona;026;Borrassà;752;388;364;2021
17;Girona;027;Breda;3836;1894;1942;2021
17;Girona;028;Brunyola i Sant Martí Sapresa;390;200;190;2021
17;Girona;031;Cabanelles;266;148;118;2021
17;Girona;030;Cabanes;941;504;437;2021
17;Girona;032;Cadaqués;2820;1378;1442;2021
17;Girona;033;Caldes de Malavella;8051;4024;4027;2021
17;Girona;034;Calonge i Sant Antoni;11484;5762;5722;2021
17;Girona;035;Camós;711;354;357;2021
17;Girona;036;Campdevànol;3225;1567;1658;2021
17;Girona;037;Campelles;149;76;73;2021
17;Girona;038;Campllong;533;264;269;2021
17;Girona;039;Camprodon;2435;1193;1242;2021
17;Girona;040;Canet d'Adri;749;387;362;2021
17;Girona;041;Cantallops;305;154;151;2021
17;Girona;042;Capmany;618;313;305;2021
17;Girona;044;Cassà de la Selva;10505;5346;5159;2021
17;Girona;046;Castellfollit de la Roca;939;486;453;2021
17;Girona;047;Castelló d'Empúries;11154;5629;5525;2021
17;Girona;048;Castell-Platja d'Aro;11455;5654;5801;2021
17;Girona;189;Cellera de Ter, La;1973;964;1009;2021
17;Girona;049;Celrà;5606;2808;2798;2021
17;Girona;050;Cervià de Ter;973;498;475;2021
17;Girona;051;Cistella;282;137;145;2021
17;Girona;054;Colera;462;229;233;2021
17;Girona;055;Colomers;188;92;96;2021
17;Girona;057;Corçà;1275;655;620;2021
17;Girona;056;Cornellà del Terri;2422;1227;1195;2021
17;Girona;058;Crespià;270;138;132;2021
17;Girona;901;Cruïlles, Monells i Sant Sadurní de l'Heura;1327;664;663;2021
17;Girona;060;Darnius;540;274;266;2021
17;Girona;061;Das;248;129;119;2021
17;Girona;062;Escala, L';10497;5324;5173;2021
17;Girona;063;Espinelves;239;120;119;2021
17;Girona;064;Espolla;412;204;208;2021
17;Girona;065;Esponellà;469;240;229;2021
17;Girona;005;Far d'Empordà, El;619;318;301;2021
17;Girona;066;Figueres;47043;23220;23823;2021
17;Girona;067;Flaçà;1147;556;591;2021
17;Girona;068;Foixà;299;149;150;2021
17;Girona;069;Fontanals de Cerdanya;506;258;248;2021
17;Girona;070;Fontanilles;157;88;69;2021
17;Girona;071;Fontcoberta;1468;727;741;2021
17;Girona;902;Forallac;1708;842;866;2021
17;Girona;073;Fornells de la Selva;2700;1339;1361;2021
17;Girona;074;Fortià;793;396;397;2021
17;Girona;075;Garrigàs;464;243;221;2021
17;Girona;076;Garrigoles;170;92;78;2021
17;Girona;077;Garriguella;909;458;451;2021
17;Girona;078;Ger;502;263;239;2021
17;Girona;079;Girona;101932;49050;52882;2021
17;Girona;080;Gombrèn;196;96;100;2021
17;Girona;081;Gualta;421;242;179;2021
17;Girona;082;Guils de Cerdanya;588;314;274;2021
17;Girona;083;Hostalric;4332;2170;2162;2021
17;Girona;084;Isòvol;314;173;141;2021
17;Girona;085;Jafre;382;204;178;2021
17;Girona;086;Jonquera, La;3340;1676;1664;2021
17;Girona;087;Juià;327;169;158;2021
17;Girona;088;Lladó;845;417;428;2021
17;Girona;089;Llagostera;8851;4456;4395;2021
17;Girona;090;Llambilles;730;371;359;2021
17;Girona;091;Llanars;535;274;261;2021
17;Girona;092;Llançà;4842;2381;2461;2021
17;Girona;093;Llers;1252;626;626;2021
17;Girona;094;Llívia;1504;790;714;2021
17;Girona;095;Lloret de Mar;38402;19552;18850;2021
17;Girona;096;Llosses, Les;209;122;87;2021
17;Girona;102;Maçanet de Cabrenys;729;367;362;2021
17;Girona;103;Maçanet de la Selva;7349;3796;3553;2021
17;Girona;097;Madremanya;296;140;156;2021
17;Girona;098;Maià de Montcal;469;255;214;2021
17;Girona;100;Masarac;284;149;135;2021
17;Girona;101;Massanes;803;427;376;2021
17;Girona;099;Meranges;97;53;44;2021
17;Girona;105;Mieres;349;178;171;2021
17;Girona;106;Mollet de Peralada;197;106;91;2021
17;Girona;107;Molló;347;167;180;2021
17;Girona;109;Montagut i Oix;951;495;456;2021
17;Girona;110;Mont-ras;1672;851;821;2021
17;Girona;111;Navata;1434;698;736;2021
17;Girona;112;Ogassa;240;133;107;2021
17;Girona;114;Olot;36299;18284;18015;2021
17;Girona;115;Ordis;369;198;171;2021
17;Girona;116;Osor;426;225;201;2021
17;Girona;117;Palafrugell;23046;11471;11575;2021
17;Girona;118;Palamós;18196;8887;9309;2021
17;Girona;119;Palau de Santa Eulàlia;111;62;49;2021
17;Girona;121;Palau-sator;323;171;152;2021
17;Girona;120;Palau-saverdera;1490;752;738;2021
17;Girona;123;Palol de Revardit;446;219;227;2021
17;Girona;124;Pals;2516;1305;1211;2021
17;Girona;125;Pardines;166;90;76;2021
17;Girona;126;Parlavà;413;206;207;2021
17;Girona;128;Pau;588;294;294;2021
17;Girona;129;Pedret i Marzà;187;93;94;2021
17;Girona;130;Pera, La;448;224;224;2021
17;Girona;132;Peralada;1945;964;981;2021
17;Girona;133;Planes d'Hostoles, Les;1711;867;844;2021
17;Girona;134;Planoles;311;167;144;2021
17;Girona;135;Pont de Molins;518;261;257;2021
17;Girona;136;Pontós;264;145;119;2021
17;Girona;137;Porqueres;4701;2317;2384;2021
17;Girona;140;Port de la Selva, El;1010;524;486;2021
17;Girona;138;Portbou;1095;547;548;2021
17;Girona;139;Preses, Les;1875;929;946;2021
17;Girona;141;Puigcerdà;9518;4733;4785;2021
17;Girona;142;Quart;3856;1951;1905;2021
17;Girona;043;Queralbs;191;99;92;2021
17;Girona;143;Rabós;206;99;107;2021
17;Girona;144;Regencós;282;151;131;2021
17;Girona;145;Ribes de Freser;1787;894;893;2021
17;Girona;146;Riells i Viabrea;4268;2151;2117;2021
17;Girona;147;Ripoll;10721;5329;5392;2021
17;Girona;148;Riudarenes;2283;1187;1096;2021
17;Girona;149;Riudaura;511;253;258;2021
17;Girona;150;Riudellots de la Selva;2076;1049;1027;2021
17;Girona;151;Riumors;244;127;117;2021
17;Girona;152;Roses;19921;10106;9815;2021
17;Girona;153;Rupià;296;148;148;2021
17;Girona;154;Sales de Llierca;164;79;85;2021
17;Girona;155;Salt;32230;16926;15304;2021
17;Girona;157;Sant Andreu Salou;156;76;80;2021
17;Girona;183;Sant Aniol de Finestres;353;179;174;2021
17;Girona;158;Sant Climent Sescebes;712;432;280;2021
17;Girona;159;Sant Feliu de Buixalleu;808;415;393;2021
17;Girona;160;Sant Feliu de Guíxols;22210;10908;11302;2021
17;Girona;161;Sant Feliu de Pallerols;1456;736;720;2021
17;Girona;162;Sant Ferriol;247;131;116;2021
17;Girona;163;Sant Gregori;4012;2066;1946;2021
17;Girona;164;Sant Hilari Sacalm;5758;2903;2855;2021
17;Girona;165;Sant Jaume de Llierca;852;421;431;2021
17;Girona;167;Sant Joan de les Abadesses;3250;1613;1637;2021
17;Girona;168;Sant Joan de Mollet;501;248;253;2021
17;Girona;185;Sant Joan les Fonts;3050;1547;1503;2021
17;Girona;166;Sant Jordi Desvalls;796;391;405;2021
17;Girona;169;Sant Julià de Ramis;3612;1818;1794;2021
17;Girona;903;Sant Julià del Llor i Bonmatí;1314;667;647;2021
17;Girona;171;Sant Llorenç de la Muga;267;139;128;2021
17;Girona;172;Sant Martí de Llémena;663;340;323;2021
17;Girona;173;Sant Martí Vell;244;130;114;2021
17;Girona;174;Sant Miquel de Campmajor;243;134;109;2021
17;Girona;175;Sant Miquel de Fluvià;755;390;365;2021
17;Girona;176;Sant Mori;157;78;79;2021
17;Girona;177;Sant Pau de Segúries;725;359;366;2021
17;Girona;178;Sant Pere Pescador;2083;1120;963;2021
17;Girona;180;Santa Coloma de Farners;13459;6800;6659;2021
17;Girona;181;Santa Cristina d'Aro;5408;2725;2683;2021
17;Girona;182;Santa Llogaia d'Àlguema;378;193;185;2021
17;Girona;184;Santa Pau;1585;814;771;2021
17;Girona;186;Sarrià de Ter;5231;2585;2646;2021
17;Girona;187;Saus, Camallera i Llampaies;865;440;425;2021
17;Girona;188;Selva de Mar, La;212;109;103;2021
17;Girona;190;Serinyà;1143;576;567;2021
17;Girona;191;Serra de Daró;235;128;107;2021
17;Girona;192;Setcases;185;102;83;2021
17;Girona;193;Sils;6349;3257;3092;2021
17;Girona;052;Siurana;179;85;94;2021
17;Girona;194;Susqueda;99;59;40;2021
17;Girona;195;Tallada d'Empordà, La;466;247;219;2021
17;Girona;196;Terrades;334;164;170;2021
17;Girona;197;Torrent;160;88;72;2021
17;Girona;198;Torroella de Fluvià;726;372;354;2021
17;Girona;199;Torroella de Montgrí;12023;6107;5916;2021
17;Girona;200;Tortellà;816;394;422;2021
17;Girona;201;Toses;178;104;74;2021
17;Girona;202;Tossa de Mar;5930;3010;2920;2021
17;Girona;204;Ullà;1167;643;524;2021
17;Girona;205;Ullastret;258;128;130;2021
17;Girona;203;Ultramort;226;118;108;2021
17;Girona;206;Urús;210;105;105;2021
17;Girona;014;Vajol, La;88;48;40;2021
17;Girona;208;Vall de Bianya, La;1315;664;651;2021
17;Girona;207;Vall d'en Bas, La;3115;1581;1534;2021
17;Girona;170;Vallfogona de Ripollès;213;112;101;2021
17;Girona;209;Vall-llobrega;918;464;454;2021
17;Girona;210;Ventalló;914;464;450;2021
17;Girona;211;Verges;1183;589;594;2021
17;Girona;212;Vidrà;186;95;91;2021
17;Girona;213;Vidreres;8073;4186;3887;2021
17;Girona;214;Vilabertran;969;483;486;2021
17;Girona;215;Vilablareix;3225;1609;1616;2021
17;Girona;217;Viladamat;471;237;234;2021
17;Girona;216;Viladasens;214;115;99;2021
17;Girona;218;Vilademuls;835;431;404;2021
17;Girona;220;Viladrau;1102;542;560;2021
17;Girona;221;Vilafant;5480;2693;2787;2021
17;Girona;223;Vilajuïga;1124;556;568;2021
17;Girona;224;Vilallonga de Ter;386;209;177;2021
17;Girona;225;Vilamacolum;371;218;153;2021
17;Girona;226;Vilamalla;1154;584;570;2021
17;Girona;227;Vilamaniscle;205;116;89;2021
17;Girona;228;Vilanant;399;201;198;2021
17;Girona;230;Vila-sacra;761;372;389;2021
17;Girona;222;Vilaür;162;83;79;2021
17;Girona;233;Vilobí d'Onyar;3310;1719;1591;2021
17;Girona;232;Vilopriu;230;122;108;2021
18;Granada;001;Agrón;255;131;124;2021
18;Granada;002;Alamedilla;564;286;278;2021
18;Granada;003;Albolote;19128;9428;9700;2021
18;Granada;004;Albondón;722;398;324;2021
18;Granada;005;Albuñán;403;208;195;2021
18;Granada;006;Albuñol;7473;4135;3338;2021
18;Granada;007;Albuñuelas;786;386;400;2021
18;Granada;010;Aldeire;623;322;301;2021
18;Granada;011;Alfacar;5497;2808;2689;2021
18;Granada;012;Algarinejo;2440;1258;1182;2021
18;Granada;013;Alhama de Granada;5667;2994;2673;2021
18;Granada;014;Alhendín;9674;4900;4774;2021
18;Granada;015;Alicún de Ortega;468;233;235;2021
18;Granada;016;Almegíjar;330;161;169;2021
18;Granada;017;Almuñécar;25890;12769;13121;2021
18;Granada;904;Alpujarra de la Sierra;952;536;416;2021
18;Granada;018;Alquife;561;276;285;2021
18;Granada;020;Arenas del Rey;624;332;292;2021
18;Granada;021;Armilla;24388;12006;12382;2021
18;Granada;022;Atarfe;19198;9627;9571;2021
18;Granada;023;Baza;20281;10028;10253;2021
18;Granada;024;Beas de Granada;980;513;467;2021
18;Granada;025;Beas de Guadix;323;162;161;2021
18;Granada;027;Benalúa;3289;1620;1669;2021
18;Granada;028;Benalúa de las Villas;1064;545;519;2021
18;Granada;029;Benamaurel;2284;1134;1150;2021
18;Granada;030;Bérchules;715;384;331;2021
18;Granada;032;Bubión;322;172;150;2021
18;Granada;033;Busquístar;286;152;134;2021
18;Granada;034;Cacín;555;284;271;2021
18;Granada;035;Cádiar;1492;799;693;2021
18;Granada;036;Cájar;5262;2592;2670;2021
18;Granada;114;Calahorra, La;664;339;325;2021
18;Granada;037;Calicasas;644;320;324;2021
18;Granada;038;Campotéjar;1228;619;609;2021
18;Granada;039;Caniles;4038;2065;1973;2021
18;Granada;040;Cáñar;388;213;175;2021
18;Granada;042;Capileira;580;283;297;2021
18;Granada;043;Carataunas;200;106;94;2021
18;Granada;044;Cástaras;240;145;95;2021
18;Granada;045;Castilléjar;1288;671;617;2021
18;Granada;046;Castril;2018;1048;970;2021
18;Granada;047;Cenes de la Vega;8181;4077;4104;2021
18;Granada;059;Chauchina;5624;2795;2829;2021
18;Granada;061;Chimeneas;1244;656;588;2021
18;Granada;062;Churriana de la Vega;15741;7760;7981;2021
18;Granada;048;Cijuela;3472;1784;1688;2021
18;Granada;049;Cogollos de Guadix;630;356;274;2021
18;Granada;050;Cogollos de la Vega;2015;1029;986;2021
18;Granada;051;Colomera;1298;675;623;2021
18;Granada;053;Cortes de Baza;1870;932;938;2021
18;Granada;054;Cortes y Graena;990;514;476;2021
18;Granada;912;Cuevas del Campo;1742;877;865;2021
18;Granada;056;Cúllar;4079;2033;2046;2021
18;Granada;057;Cúllar Vega;7719;3927;3792;2021
18;Granada;063;Darro;1636;832;804;2021
18;Granada;064;Dehesas de Guadix;412;199;213;2021
18;Granada;065;Dehesas Viejas;685;356;329;2021
18;Granada;066;Deifontes;2625;1329;1296;2021
18;Granada;067;Diezma;776;416;360;2021
18;Granada;068;Dílar;2137;1069;1068;2021
18;Granada;069;Dólar;637;345;292;2021
18;Granada;915;Domingo Pérez de Granada;862;447;415;2021
18;Granada;070;Dúdar;362;192;170;2021
18;Granada;071;Dúrcal;7168;3580;3588;2021
18;Granada;072;Escúzar;806;420;386;2021
18;Granada;074;Ferreira;293;151;142;2021
18;Granada;076;Fonelas;955;505;450;2021
18;Granada;077;Fornes;534;274;260;2021
18;Granada;078;Freila;936;502;434;2021
18;Granada;079;Fuente Vaqueros;4415;2208;2207;2021
18;Granada;905;Gabias, Las;22051;11156;10895;2021
18;Granada;082;Galera;1107;567;540;2021
18;Granada;083;Gobernador;220;109;111;2021
18;Granada;084;Gójar;5993;3036;2957;2021
18;Granada;085;Gor;729;380;349;2021
18;Granada;086;Gorafe;382;192;190;2021
18;Granada;087;Granada;231775;106987;124788;2021
18;Granada;088;Guadahortuna;1839;952;887;2021
18;Granada;089;Guadix;18462;9191;9271;2021
18;Granada;906;Guájares, Los;1074;581;493;2021
18;Granada;093;Gualchos;5287;2822;2465;2021
18;Granada;094;Güéjar Sierra;2906;1550;1356;2021
18;Granada;095;Güevéjar;2658;1398;1260;2021
18;Granada;096;Huélago;384;195;189;2021
18;Granada;097;Huéneja;1193;639;554;2021
18;Granada;098;Huéscar;7236;3574;3662;2021
18;Granada;099;Huétor de Santillán;1897;979;918;2021
18;Granada;100;Huétor Tájar;10514;5288;5226;2021
18;Granada;101;Huétor Vega;12120;6083;6037;2021
18;Granada;102;Íllora;10080;5083;4997;2021
18;Granada;103;Ítrabo;974;475;499;2021
18;Granada;105;Iznalloz;5094;2605;2489;2021
18;Granada;106;Játar;609;336;273;2021
18;Granada;107;Jayena;1045;538;507;2021
18;Granada;108;Jérez del Marquesado;954;491;463;2021
18;Granada;109;Jete;985;518;467;2021
18;Granada;111;Jun;3928;1986;1942;2021
18;Granada;112;Juviles;136;70;66;2021
18;Granada;115;Láchar;3550;1808;1742;2021
18;Granada;116;Lanjarón;3612;1829;1783;2021
18;Granada;117;Lanteira;571;309;262;2021
18;Granada;119;Lecrín;2197;1098;1099;2021
18;Granada;120;Lentegí;337;173;164;2021
18;Granada;121;Lobras;130;67;63;2021
18;Granada;122;Loja;20465;10224;10241;2021
18;Granada;123;Lugros;311;163;148;2021
18;Granada;124;Lújar;476;256;220;2021
18;Granada;126;Malahá, La;1788;899;889;2021
18;Granada;127;Maracena;22358;10928;11430;2021
18;Granada;128;Marchal;414;202;212;2021
18;Granada;132;Moclín;3613;1791;1822;2021
18;Granada;133;Molvízar;2748;1408;1340;2021
18;Granada;134;Monachil;8137;4170;3967;2021
18;Granada;135;Montefrío;5336;2765;2571;2021
18;Granada;136;Montejícar;2072;1072;1000;2021
18;Granada;137;Montillana;1127;594;533;2021
18;Granada;138;Moraleda de Zafayona;3106;1568;1538;2021
18;Granada;909;Morelábor;589;317;272;2021
18;Granada;140;Motril;58545;28786;29759;2021
18;Granada;141;Murtas;460;260;200;2021
18;Granada;903;Nevada;1116;578;538;2021
18;Granada;143;Nigüelas;1198;613;585;2021
18;Granada;144;Nívar;1094;565;529;2021
18;Granada;145;Ogíjares;14559;7223;7336;2021
18;Granada;146;Orce;1192;601;591;2021
18;Granada;147;Órgiva;5866;2915;2951;2021
18;Granada;148;Otívar;1012;516;496;2021
18;Granada;150;Padul;8934;4461;4473;2021
18;Granada;151;Pampaneira;315;159;156;2021
18;Granada;152;Pedro Martínez;1148;576;572;2021
18;Granada;153;Peligros;11544;5707;5837;2021
18;Granada;154;Peza, La;1170;601;569;2021
18;Granada;910;Pinar, El;886;470;416;2021
18;Granada;157;Pinos Genil;1518;784;734;2021
18;Granada;158;Pinos Puente;9853;4918;4935;2021
18;Granada;159;Píñar;1102;597;505;2021
18;Granada;161;Polícar;261;138;123;2021
18;Granada;162;Polopos;1714;959;755;2021
18;Granada;163;Pórtugos;387;198;189;2021
18;Granada;164;Puebla de Don Fadrique;2227;1130;1097;2021
18;Granada;165;Pulianas;5480;2755;2725;2021
18;Granada;167;Purullena;2320;1169;1151;2021
18;Granada;168;Quéntar;987;514;473;2021
18;Granada;170;Rubite;384;213;171;2021
18;Granada;171;Salar;2638;1322;1316;2021
18;Granada;173;Salobreña;12472;6230;6242;2021
18;Granada;174;Santa Cruz del Comercio;543;277;266;2021
18;Granada;175;Santa Fe;15175;7474;7701;2021
18;Granada;176;Soportújar;259;134;125;2021
18;Granada;177;Sorvilán;524;290;234;2021
18;Granada;901;Taha, La;715;354;361;2021
18;Granada;178;Torre-Cardela;715;384;331;2021
18;Granada;916;Torrenueva Costa;2892;1491;1401;2021
18;Granada;179;Torvizcón;634;339;295;2021
18;Granada;180;Trevélez;721;380;341;2021
18;Granada;181;Turón;232;140;92;2021
18;Granada;182;Ugíjar;2550;1262;1288;2021
18;Granada;914;Valderrubio;2059;1016;1043;2021
18;Granada;907;Valle del Zalabí;2117;1076;1041;2021
18;Granada;902;Valle, El;917;458;459;2021
18;Granada;183;Válor;705;371;334;2021
18;Granada;911;Vegas del Genil;11678;5947;5731;2021
18;Granada;184;Vélez de Benaudalla;2923;1475;1448;2021
18;Granada;185;Ventas de Huelma;666;363;303;2021
18;Granada;149;Villa de Otura;7173;3622;3551;2021
18;Granada;908;Villamena;963;500;463;2021
18;Granada;187;Villanueva de las Torres;561;298;263;2021
18;Granada;188;Villanueva Mesía;2038;998;1040;2021
18;Granada;189;Víznar;1000;523;477;2021
18;Granada;192;Zafarraya;2096;1096;1000;2021
18;Granada;913;Zagra;914;483;431;2021
18;Granada;193;Zubia, La;19473;9649;9824;2021
18;Granada;194;Zújar;2516;1275;1241;2021
19;Guadalajara;001;Abánades;55;34;21;2021
19;Guadalajara;002;Ablanque;60;33;27;2021
19;Guadalajara;003;Adobes;32;18;14;2021
19;Guadalajara;004;Alaminos;57;26;31;2021
19;Guadalajara;005;Alarilla;127;82;45;2021
19;Guadalajara;006;Albalate de Zorita;1080;599;481;2021
19;Guadalajara;007;Albares;479;250;229;2021
19;Guadalajara;008;Albendiego;45;31;14;2021
19;Guadalajara;009;Alcocer;326;164;162;2021
19;Guadalajara;010;Alcolea de las Peñas;16;9;7;2021
19;Guadalajara;011;Alcolea del Pinar;326;191;135;2021
19;Guadalajara;013;Alcoroches;128;78;50;2021
19;Guadalajara;015;Aldeanueva de Guadalajara;99;57;42;2021
19;Guadalajara;016;Algar de Mesa;53;38;15;2021
19;Guadalajara;017;Algora;82;51;31;2021
19;Guadalajara;018;Alhóndiga;157;88;69;2021
19;Guadalajara;019;Alique;15;7;8;2021
19;Guadalajara;020;Almadrones;55;36;19;2021
19;Guadalajara;021;Almoguera;1307;662;645;2021
19;Guadalajara;022;Almonacid de Zorita;694;358;336;2021
19;Guadalajara;023;Alocén;161;82;79;2021
19;Guadalajara;024;Alovera;13051;6657;6394;2021
19;Guadalajara;027;Alustante;153;89;64;2021
19;Guadalajara;031;Angón;8;7;1;2021
19;Guadalajara;032;Anguita;152;78;74;2021
19;Guadalajara;033;Anquela del Ducado;59;35;24;2021
19;Guadalajara;034;Anquela del Pedregal;26;16;10;2021
19;Guadalajara;036;Aranzueque;370;206;164;2021
19;Guadalajara;037;Arbancón;139;82;57;2021
19;Guadalajara;038;Arbeteta;20;16;4;2021
19;Guadalajara;039;Argecilla;70;45;25;2021
19;Guadalajara;040;Armallones;55;32;23;2021
19;Guadalajara;041;Armuña de Tajuña;240;123;117;2021
19;Guadalajara;042;Arroyo de las Fraguas;22;12;10;2021
19;Guadalajara;043;Atanzón;100;66;34;2021
19;Guadalajara;044;Atienza;395;227;168;2021
19;Guadalajara;045;Auñón;140;80;60;2021
19;Guadalajara;046;Azuqueca de Henares;35236;17777;17459;2021
19;Guadalajara;047;Baides;63;33;30;2021
19;Guadalajara;048;Baños de Tajo;21;15;6;2021
19;Guadalajara;049;Bañuelos;13;11;2;2021
19;Guadalajara;050;Barriopedro;17;11;6;2021
19;Guadalajara;051;Berninches;53;35;18;2021
19;Guadalajara;052;Bodera, La;21;14;7;2021
19;Guadalajara;053;Brihuega;2467;1297;1170;2021
19;Guadalajara;054;Budia;201;121;80;2021
19;Guadalajara;055;Bujalaro;48;23;25;2021
19;Guadalajara;057;Bustares;76;46;30;2021
19;Guadalajara;058;Cabanillas del Campo;10844;5447;5397;2021
19;Guadalajara;059;Campillo de Dueñas;75;48;27;2021
19;Guadalajara;060;Campillo de Ranas;167;98;69;2021
19;Guadalajara;061;Campisábalos;66;46;20;2021
19;Guadalajara;064;Canredondo;76;50;26;2021
19;Guadalajara;065;Cantalojas;146;82;64;2021
19;Guadalajara;066;Cañizar;57;34;23;2021
19;Guadalajara;067;Cardoso de la Sierra, El;56;35;21;2021
19;Guadalajara;070;Casa de Uceda;98;51;47;2021
19;Guadalajara;071;Casar, El;12710;6458;6252;2021
19;Guadalajara;073;Casas de San Galindo;19;14;5;2021
19;Guadalajara;074;Caspueñas;116;72;44;2021
19;Guadalajara;075;Castejón de Henares;61;39;22;2021
19;Guadalajara;076;Castellar de la Muela;32;19;13;2021
19;Guadalajara;078;Castilforte;60;37;23;2021
19;Guadalajara;079;Castilnuevo;6;5;1;2021
19;Guadalajara;080;Cendejas de Enmedio;66;33;33;2021
19;Guadalajara;081;Cendejas de la Torre;24;17;7;2021
19;Guadalajara;082;Centenera;143;82;61;2021
19;Guadalajara;103;Checa;286;174;112;2021
19;Guadalajara;104;Chequilla;17;9;8;2021
19;Guadalajara;106;Chillarón del Rey;84;48;36;2021
19;Guadalajara;105;Chiloeches;3797;1964;1833;2021
19;Guadalajara;086;Cifuentes;1611;823;788;2021
19;Guadalajara;087;Cincovillas;20;11;9;2021
19;Guadalajara;088;Ciruelas;117;65;52;2021
19;Guadalajara;089;Ciruelos del Pinar;23;14;9;2021
19;Guadalajara;090;Cobeta;109;53;56;2021
19;Guadalajara;091;Cogollor;21;14;7;2021
19;Guadalajara;092;Cogolludo;552;328;224;2021
19;Guadalajara;095;Condemios de Abajo;10;8;2;2021
19;Guadalajara;096;Condemios de Arriba;111;65;46;2021
19;Guadalajara;097;Congostrina;12;9;3;2021
19;Guadalajara;098;Copernal;31;19;12;2021
19;Guadalajara;099;Corduente;342;189;153;2021
19;Guadalajara;102;Cubillo de Uceda, El;129;72;57;2021
19;Guadalajara;107;Driebes;361;194;167;2021
19;Guadalajara;108;Durón;105;59;46;2021
19;Guadalajara;109;Embid;33;19;14;2021
19;Guadalajara;110;Escamilla;57;37;20;2021
19;Guadalajara;111;Escariche;201;125;76;2021
19;Guadalajara;112;Escopete;64;31;33;2021
19;Guadalajara;113;Espinosa de Henares;627;322;305;2021
19;Guadalajara;114;Esplegares;39;22;17;2021
19;Guadalajara;115;Establés;29;18;11;2021
19;Guadalajara;116;Estriégana;10;8;2;2021
19;Guadalajara;117;Fontanar;2523;1323;1200;2021
19;Guadalajara;118;Fuembellida;13;8;5;2021
19;Guadalajara;119;Fuencemillán;86;52;34;2021
19;Guadalajara;120;Fuentelahiguera de Albatages;132;78;54;2021
19;Guadalajara;121;Fuentelencina;299;159;140;2021
19;Guadalajara;122;Fuentelsaz;92;48;44;2021
19;Guadalajara;123;Fuentelviejo;54;31;23;2021
19;Guadalajara;124;Fuentenovilla;566;313;253;2021
19;Guadalajara;125;Gajanejos;57;34;23;2021
19;Guadalajara;126;Galápagos;2579;1346;1233;2021
19;Guadalajara;127;Galve de Sorbe;95;53;42;2021
19;Guadalajara;129;Gascueña de Bornova;31;19;12;2021
19;Guadalajara;130;Guadalajara;87064;41856;45208;2021
19;Guadalajara;132;Henche;86;46;40;2021
19;Guadalajara;133;Heras de Ayuso;239;141;98;2021
19;Guadalajara;134;Herrería;26;15;11;2021
19;Guadalajara;135;Hiendelaencina;117;72;45;2021
19;Guadalajara;136;Hijes;18;9;9;2021
19;Guadalajara;138;Hita;292;162;130;2021
19;Guadalajara;139;Hombrados;39;25;14;2021
19;Guadalajara;142;Hontoba;378;211;167;2021
19;Guadalajara;143;Horche;2702;1359;1343;2021
19;Guadalajara;145;Hortezuela de Océn;38;23;15;2021
19;Guadalajara;146;Huerce, La;52;32;20;2021
19;Guadalajara;147;Huérmeces del Cerro;41;29;12;2021
19;Guadalajara;148;Huertahernando;58;37;21;2021
19;Guadalajara;150;Hueva;105;63;42;2021
19;Guadalajara;151;Humanes;1577;796;781;2021
19;Guadalajara;152;Illana;776;434;342;2021
19;Guadalajara;153;Iniéstola;22;15;7;2021
19;Guadalajara;154;Inviernas, Las;61;43;18;2021
19;Guadalajara;155;Irueste;82;50;32;2021
19;Guadalajara;156;Jadraque;1383;728;655;2021
19;Guadalajara;157;Jirueque;51;35;16;2021
19;Guadalajara;159;Ledanca;113;56;57;2021
19;Guadalajara;160;Loranca de Tajuña;1396;752;644;2021
19;Guadalajara;161;Lupiana;268;141;127;2021
19;Guadalajara;162;Luzaga;65;37;28;2021
19;Guadalajara;163;Luzón;65;32;33;2021
19;Guadalajara;165;Majaelrayo;58;35;23;2021
19;Guadalajara;166;Málaga del Fresno;180;102;78;2021
19;Guadalajara;167;Malaguilla;175;96;79;2021
19;Guadalajara;168;Mandayona;290;141;149;2021
19;Guadalajara;169;Mantiel;30;20;10;2021
19;Guadalajara;170;Maranchón;232;122;110;2021
19;Guadalajara;171;Marchamalo;7889;3956;3933;2021
19;Guadalajara;172;Masegoso de Tajuña;49;28;21;2021
19;Guadalajara;173;Matarrubia;65;42;23;2021
19;Guadalajara;174;Matillas;97;55;42;2021
19;Guadalajara;175;Mazarete;31;17;14;2021
19;Guadalajara;176;Mazuecos;270;151;119;2021
19;Guadalajara;177;Medranda;63;33;30;2021
19;Guadalajara;178;Megina;35;22;13;2021
19;Guadalajara;179;Membrillera;102;60;42;2021
19;Guadalajara;181;Miedes de Atienza;54;36;18;2021
19;Guadalajara;182;Mierla, La;40;26;14;2021
19;Guadalajara;184;Millana;108;63;45;2021
19;Guadalajara;183;Milmarcos;73;45;28;2021
19;Guadalajara;185;Miñosa, La;34;20;14;2021
19;Guadalajara;186;Mirabueno;78;47;31;2021
19;Guadalajara;187;Miralrío;59;32;27;2021
19;Guadalajara;188;Mochales;42;23;19;2021
19;Guadalajara;189;Mohernando;174;96;78;2021
19;Guadalajara;190;Molina de Aragón;3217;1606;1611;2021
19;Guadalajara;191;Monasterio;14;6;8;2021
19;Guadalajara;192;Mondéjar;2745;1422;1323;2021
19;Guadalajara;193;Montarrón;28;18;10;2021
19;Guadalajara;194;Moratilla de los Meleros;102;58;44;2021
19;Guadalajara;195;Morenilla;50;28;22;2021
19;Guadalajara;196;Muduex;101;53;48;2021
19;Guadalajara;197;Navas de Jadraque, Las;31;21;10;2021
19;Guadalajara;198;Negredo;17;9;8;2021
19;Guadalajara;199;Ocentejo;17;12;5;2021
19;Guadalajara;200;Olivar, El;69;39;30;2021
19;Guadalajara;201;Olmeda de Cobeta;63;35;28;2021
19;Guadalajara;202;Olmeda de Jadraque, La;15;10;5;2021
19;Guadalajara;203;Ordial, El;37;23;14;2021
19;Guadalajara;204;Orea;210;119;91;2021
19;Guadalajara;208;Pálmaces de Jadraque;44;29;15;2021
19;Guadalajara;209;Pardos;40;24;16;2021
19;Guadalajara;210;Paredes de Sigüenza;24;10;14;2021
19;Guadalajara;211;Pareja;455;268;187;2021
19;Guadalajara;212;Pastrana;839;417;422;2021
19;Guadalajara;213;Pedregal, El;66;43;23;2021
19;Guadalajara;214;Peñalén;75;43;32;2021
19;Guadalajara;215;Peñalver;151;95;56;2021
19;Guadalajara;216;Peralejos de las Truchas;155;82;73;2021
19;Guadalajara;217;Peralveche;40;30;10;2021
19;Guadalajara;218;Pinilla de Jadraque;51;30;21;2021
19;Guadalajara;219;Pinilla de Molina;10;8;2;2021
19;Guadalajara;220;Pioz;4687;2447;2240;2021
19;Guadalajara;221;Piqueras;49;33;16;2021
19;Guadalajara;222;Pobo de Dueñas, El;104;55;49;2021
19;Guadalajara;223;Poveda de la Sierra;116;59;57;2021
19;Guadalajara;224;Pozo de Almoguera;104;63;41;2021
19;Guadalajara;225;Pozo de Guadalajara;1392;740;652;2021
19;Guadalajara;226;Prádena de Atienza;40;28;12;2021
19;Guadalajara;227;Prados Redondos;57;41;16;2021
19;Guadalajara;228;Puebla de Beleña;35;21;14;2021
19;Guadalajara;229;Puebla de Valles;59;32;27;2021
19;Guadalajara;230;Quer;921;483;438;2021
19;Guadalajara;231;Rebollosa de Jadraque;10;7;3;2021
19;Guadalajara;232;Recuenco, El;62;36;26;2021
19;Guadalajara;233;Renera;109;66;43;2021
19;Guadalajara;234;Retiendas;52;35;17;2021
19;Guadalajara;235;Riba de Saelices;106;65;41;2021
19;Guadalajara;237;Rillo de Gallo;47;29;18;2021
19;Guadalajara;238;Riofrío del Llano;61;36;25;2021
19;Guadalajara;239;Robledillo de Mohernando;127;71;56;2021
19;Guadalajara;240;Robledo de Corpes;40;23;17;2021
19;Guadalajara;241;Romanillos de Atienza;34;23;11;2021
19;Guadalajara;242;Romanones;104;54;50;2021
19;Guadalajara;243;Rueda de la Sierra;40;28;12;2021
19;Guadalajara;244;Sacecorbo;91;52;39;2021
19;Guadalajara;245;Sacedón;1530;796;734;2021
19;Guadalajara;246;Saelices de la Sal;39;21;18;2021
19;Guadalajara;247;Salmerón;141;82;59;2021
19;Guadalajara;248;San Andrés del Congosto;74;47;27;2021
19;Guadalajara;249;San Andrés del Rey;39;21;18;2021
19;Guadalajara;250;Santiuste;15;10;5;2021
19;Guadalajara;251;Saúca;54;32;22;2021
19;Guadalajara;252;Sayatón;64;36;28;2021
19;Guadalajara;254;Selas;43;21;22;2021
19;Guadalajara;901;Semillas;36;22;14;2021
19;Guadalajara;255;Setiles;85;46;39;2021
19;Guadalajara;256;Sienes;49;29;20;2021
19;Guadalajara;257;Sigüenza;4298;2170;2128;2021
19;Guadalajara;258;Solanillos del Extremo;87;53;34;2021
19;Guadalajara;259;Somolinos;30;16;14;2021
19;Guadalajara;260;Sotillo, El;41;21;20;2021
19;Guadalajara;261;Sotodosos;30;18;12;2021
19;Guadalajara;262;Tamajón;146;81;65;2021
19;Guadalajara;263;Taragudo;45;28;17;2021
19;Guadalajara;264;Taravilla;33;22;11;2021
19;Guadalajara;265;Tartanedo;144;83;61;2021
19;Guadalajara;266;Tendilla;298;165;133;2021
19;Guadalajara;267;Terzaga;20;12;8;2021
19;Guadalajara;268;Tierzo;48;27;21;2021
19;Guadalajara;269;Toba, La;80;51;29;2021
19;Guadalajara;271;Tordellego;50;29;21;2021
19;Guadalajara;270;Tordelrábano;10;6;4;2021
19;Guadalajara;272;Tordesilos;94;54;40;2021
19;Guadalajara;274;Torija;1577;829;748;2021
19;Guadalajara;279;Torre del Burgo;470;269;201;2021
19;Guadalajara;277;Torrecuadrada de Molina;18;13;5;2021
19;Guadalajara;278;Torrecuadradilla;28;16;12;2021
19;Guadalajara;280;Torrejón del Rey;5892;3072;2820;2021
19;Guadalajara;281;Torremocha de Jadraque;20;11;9;2021
19;Guadalajara;282;Torremocha del Campo;174;100;74;2021
19;Guadalajara;283;Torremocha del Pinar;38;19;19;2021
19;Guadalajara;284;Torremochuela;8;6;2;2021
19;Guadalajara;285;Torrubia;23;14;9;2021
19;Guadalajara;286;Tórtola de Henares;1240;668;572;2021
19;Guadalajara;287;Tortuera;184;96;88;2021
19;Guadalajara;288;Tortuero;17;12;5;2021
19;Guadalajara;289;Traíd;27;17;10;2021
19;Guadalajara;290;Trijueque;1327;728;599;2021
19;Guadalajara;291;Trillo;1363;709;654;2021
19;Guadalajara;293;Uceda;2933;1506;1427;2021
19;Guadalajara;294;Ujados;30;15;15;2021
19;Guadalajara;296;Utande;37;28;9;2021
19;Guadalajara;297;Valdarachas;43;21;22;2021
19;Guadalajara;298;Valdearenas;82;51;31;2021
19;Guadalajara;299;Valdeavellano;100;54;46;2021
19;Guadalajara;300;Valdeaveruelo;1144;601;543;2021
19;Guadalajara;301;Valdeconcha;38;21;17;2021
19;Guadalajara;302;Valdegrudas;52;33;19;2021
19;Guadalajara;303;Valdelcubo;39;26;13;2021
19;Guadalajara;304;Valdenuño Fernández;299;157;142;2021
19;Guadalajara;305;Valdepeñas de la Sierra;145;84;61;2021
19;Guadalajara;306;Valderrebollo;25;13;12;2021
19;Guadalajara;307;Valdesotos;24;15;9;2021
19;Guadalajara;308;Valfermoso de Tajuña;64;42;22;2021
19;Guadalajara;309;Valhermoso;25;14;11;2021
19;Guadalajara;310;Valtablado del Río;8;5;3;2021
19;Guadalajara;311;Valverde de los Arroyos;92;49;43;2021
19;Guadalajara;314;Viana de Jadraque;45;31;14;2021
19;Guadalajara;317;Villanueva de Alcorón;138;78;60;2021
19;Guadalajara;318;Villanueva de Argecilla;40;22;18;2021
19;Guadalajara;319;Villanueva de la Torre;6591;3331;3260;2021
19;Guadalajara;321;Villares de Jadraque;48;31;17;2021
19;Guadalajara;322;Villaseca de Henares;25;13;12;2021
19;Guadalajara;323;Villaseca de Uceda;40;21;19;2021
19;Guadalajara;324;Villel de Mesa;180;107;73;2021
19;Guadalajara;325;Viñuelas;182;91;91;2021
19;Guadalajara;326;Yebes;4636;2412;2224;2021
19;Guadalajara;327;Yebra;465;249;216;2021
19;Guadalajara;329;Yélamos de Abajo;62;30;32;2021
19;Guadalajara;330;Yélamos de Arriba;77;47;30;2021
19;Guadalajara;331;Yunquera de Henares;4364;2241;2123;2021
19;Guadalajara;332;Yunta, La;91;53;38;2021
19;Guadalajara;333;Zaorejas;104;73;31;2021
19;Guadalajara;334;Zarzuela de Jadraque;56;35;21;2021
19;Guadalajara;335;Zorita de los Canes;63;35;28;2021
21;Huelva;001;Alájar;814;417;397;2021
21;Huelva;002;Aljaraque;21706;10810;10896;2021
21;Huelva;003;Almendro, El;835;440;395;2021
21;Huelva;004;Almonaster la Real;1786;954;832;2021
21;Huelva;005;Almonte;24577;11922;12655;2021
21;Huelva;006;Alosno;3929;1934;1995;2021
21;Huelva;007;Aracena;8215;4051;4164;2021
21;Huelva;008;Aroche;3046;1519;1527;2021
21;Huelva;009;Arroyomolinos de León;950;482;468;2021
21;Huelva;010;Ayamonte;21510;10786;10724;2021
21;Huelva;011;Beas;4464;2231;2233;2021
21;Huelva;012;Berrocal;312;156;156;2021
21;Huelva;013;Bollullos Par del Condado;14392;7142;7250;2021
21;Huelva;014;Bonares;6075;3036;3039;2021
21;Huelva;015;Cabezas Rubias;716;377;339;2021
21;Huelva;016;Cala;1158;584;574;2021
21;Huelva;017;Calañas;2763;1408;1355;2021
21;Huelva;018;Campillo, El;1996;967;1029;2021
21;Huelva;019;Campofrío;731;373;358;2021
21;Huelva;020;Cañaveral de León;401;197;204;2021
21;Huelva;021;Cartaya;20314;10337;9977;2021
21;Huelva;022;Castaño del Robledo;230;126;104;2021
21;Huelva;023;Cerro de Andévalo, El;2320;1156;1164;2021
21;Huelva;030;Chucena;2242;1123;1119;2021
21;Huelva;024;Corteconcepción;571;307;264;2021
21;Huelva;025;Cortegana;4635;2335;2300;2021
21;Huelva;026;Cortelazor;303;141;162;2021
21;Huelva;027;Cumbres de Enmedio;53;29;24;2021
21;Huelva;028;Cumbres de San Bartolomé;374;187;187;2021
21;Huelva;029;Cumbres Mayores;1734;858;876;2021
21;Huelva;031;Encinasola;1292;659;633;2021
21;Huelva;032;Escacena del Campo;2294;1117;1177;2021
21;Huelva;033;Fuenteheridos;751;387;364;2021
21;Huelva;034;Galaroza;1373;680;693;2021
21;Huelva;035;Gibraleón;12810;6398;6412;2021
21;Huelva;036;Granada de Río-Tinto, La;242;120;122;2021
21;Huelva;037;Granado, El;517;272;245;2021
21;Huelva;038;Higuera de la Sierra;1326;694;632;2021
21;Huelva;039;Hinojales;338;169;169;2021
21;Huelva;040;Hinojos;3903;1971;1932;2021
21;Huelva;041;Huelva;142538;68393;74145;2021
21;Huelva;042;Isla Cristina;21516;10786;10730;2021
21;Huelva;043;Jabugo;2247;1127;1120;2021
21;Huelva;044;Lepe;28293;14593;13700;2021
21;Huelva;045;Linares de la Sierra;268;132;136;2021
21;Huelva;046;Lucena del Puerto;3187;1673;1514;2021
21;Huelva;047;Manzanilla;2152;1102;1050;2021
21;Huelva;048;Marines, Los;410;222;188;2021
21;Huelva;049;Minas de Riotinto;3778;1837;1941;2021
21;Huelva;050;Moguer;22061;11059;11002;2021
21;Huelva;051;Nava, La;255;135;120;2021
21;Huelva;052;Nerva;5127;2458;2669;2021
21;Huelva;053;Niebla;4158;2087;2071;2021
21;Huelva;054;Palma del Condado, La;10787;5386;5401;2021
21;Huelva;055;Palos de la Frontera;12001;6145;5856;2021
21;Huelva;056;Paterna del Campo;3478;1772;1706;2021
21;Huelva;057;Paymogo;1149;569;580;2021
21;Huelva;058;Puebla de Guzmán;3154;1622;1532;2021
21;Huelva;059;Puerto Moral;281;136;145;2021
21;Huelva;060;Punta Umbría;15891;8063;7828;2021
21;Huelva;061;Rociana del Condado;7834;3906;3928;2021
21;Huelva;062;Rosal de la Frontera;1682;833;849;2021
21;Huelva;063;San Bartolomé de la Torre;3846;1917;1929;2021
21;Huelva;064;San Juan del Puerto;9503;4777;4726;2021
21;Huelva;066;San Silvestre de Guzmán;653;336;317;2021
21;Huelva;065;Sanlúcar de Guadiana;380;189;191;2021
21;Huelva;067;Santa Ana la Real;489;226;263;2021
21;Huelva;068;Santa Bárbara de Casa;1055;522;533;2021
21;Huelva;069;Santa Olalla del Cala;2034;1041;993;2021
21;Huelva;070;Trigueros;7906;3919;3987;2021
21;Huelva;071;Valdelarco;236;111;125;2021
21;Huelva;072;Valverde del Camino;12714;6247;6467;2021
21;Huelva;073;Villablanca;2911;1458;1453;2021
21;Huelva;074;Villalba del Alcor;3334;1655;1679;2021
21;Huelva;075;Villanueva de las Cruces;385;180;205;2021
21;Huelva;076;Villanueva de los Castillejos;2849;1438;1411;2021
21;Huelva;077;Villarrasa;2203;1111;1092;2021
21;Huelva;078;Zalamea la Real;3055;1530;1525;2021
21;Huelva;902;Zarza-Perrunal, La;1252;629;623;2021
21;Huelva;079;Zufre;785;407;378;2021
22;Huesca;001;Abiego;271;138;133;2021
22;Huesca;002;Abizanda;143;73;70;2021
22;Huesca;003;Adahuesca;190;106;84;2021
22;Huesca;004;Agüero;139;79;60;2021
22;Huesca;907;Aínsa-Sobrarbe;2312;1159;1153;2021
22;Huesca;006;Aisa;336;183;153;2021
22;Huesca;007;Albalate de Cinca;1125;617;508;2021
22;Huesca;008;Albalatillo;188;99;89;2021
22;Huesca;009;Albelda;686;358;328;2021
22;Huesca;011;Albero Alto;118;66;52;2021
22;Huesca;012;Albero Bajo;137;75;62;2021
22;Huesca;013;Alberuela de Tubo;306;154;152;2021
22;Huesca;014;Alcalá de Gurrea;230;120;110;2021
22;Huesca;015;Alcalá del Obispo;337;191;146;2021
22;Huesca;016;Alcampell;627;297;330;2021
22;Huesca;017;Alcolea de Cinca;1200;654;546;2021
22;Huesca;018;Alcubierre;372;202;170;2021
22;Huesca;019;Alerre;208;112;96;2021
22;Huesca;020;Alfántega;133;71;62;2021
22;Huesca;021;Almudévar;2412;1213;1199;2021
22;Huesca;022;Almunia de San Juan;689;354;335;2021
22;Huesca;023;Almuniente;454;240;214;2021
22;Huesca;024;Alquézar;338;173;165;2021
22;Huesca;025;Altorricón;1441;787;654;2021
22;Huesca;027;Angüés;370;199;171;2021
22;Huesca;028;Ansó;397;199;198;2021
22;Huesca;029;Antillón;137;71;66;2021
22;Huesca;032;Aragüés del Puerto;116;63;53;2021
22;Huesca;035;Arén;318;177;141;2021
22;Huesca;036;Argavieso;114;67;47;2021
22;Huesca;037;Arguis;153;84;69;2021
22;Huesca;039;Ayerbe;1028;508;520;2021
22;Huesca;040;Azanuy-Alins;177;87;90;2021
22;Huesca;041;Azara;162;86;76;2021
22;Huesca;042;Azlor;148;65;83;2021
22;Huesca;043;Baélls;94;54;40;2021
22;Huesca;044;Bailo;263;160;103;2021
22;Huesca;045;Baldellou;71;41;30;2021
22;Huesca;046;Ballobar;849;440;409;2021
22;Huesca;047;Banastás;327;169;158;2021
22;Huesca;048;Barbastro;17146;8342;8804;2021
22;Huesca;049;Barbués;91;55;36;2021
22;Huesca;050;Barbuñales;100;50;50;2021
22;Huesca;051;Bárcabo;106;57;49;2021
22;Huesca;052;Belver de Cinca;1307;757;550;2021
22;Huesca;053;Benabarre;1162;601;561;2021
22;Huesca;054;Benasque;2239;1212;1027;2021
22;Huesca;246;Beranuy;74;42;32;2021
22;Huesca;055;Berbegal;308;165;143;2021
22;Huesca;057;Bielsa;481;258;223;2021
22;Huesca;058;Bierge;254;141;113;2021
22;Huesca;059;Biescas;1550;813;737;2021
22;Huesca;060;Binaced;1597;874;723;2021
22;Huesca;061;Binéfar;9888;5234;4654;2021
22;Huesca;062;Bisaurri;176;91;85;2021
22;Huesca;063;Biscarrués;191;103;88;2021
22;Huesca;064;Blecua y Torres;179;99;80;2021
22;Huesca;066;Boltaña;1065;573;492;2021
22;Huesca;067;Bonansa;90;51;39;2021
22;Huesca;068;Borau;83;46;37;2021
22;Huesca;069;Broto;564;317;247;2021
22;Huesca;072;Caldearenas;222;129;93;2021
22;Huesca;074;Campo;459;239;220;2021
22;Huesca;075;Camporrélls;123;67;56;2021
22;Huesca;076;Canal de Berdún;348;191;157;2021
22;Huesca;077;Candasnos;402;217;185;2021
22;Huesca;078;Canfranc;599;332;267;2021
22;Huesca;079;Capdesaso;208;88;120;2021
22;Huesca;080;Capella;350;182;168;2021
22;Huesca;081;Casbas de Huesca;290;163;127;2021
22;Huesca;083;Castejón de Monegros;497;265;232;2021
22;Huesca;084;Castejón de Sos;791;396;395;2021
22;Huesca;082;Castejón del Puente;345;179;166;2021
22;Huesca;085;Castelflorite;103;51;52;2021
22;Huesca;086;Castiello de Jaca;240;134;106;2021
22;Huesca;087;Castigaleu;80;50;30;2021
22;Huesca;088;Castillazuelo;164;84;80;2021
22;Huesca;089;Castillonroy;333;174;159;2021
22;Huesca;094;Chalamera;114;60;54;2021
22;Huesca;095;Chía;83;52;31;2021
22;Huesca;096;Chimillas;411;208;203;2021
22;Huesca;090;Colungo;118;66;52;2021
22;Huesca;099;Esplús;649;335;314;2021
22;Huesca;102;Estada;204;119;85;2021
22;Huesca;103;Estadilla;803;403;400;2021
22;Huesca;105;Estopiñán del Castillo;120;62;58;2021
22;Huesca;106;Fago;21;11;10;2021
22;Huesca;107;Fanlo;103;67;36;2021
22;Huesca;109;Fiscal;344;185;159;2021
22;Huesca;110;Fonz;845;431;414;2021
22;Huesca;111;Foradada del Toscar;158;86;72;2021
22;Huesca;112;Fraga;15250;7830;7420;2021
22;Huesca;113;Fueva, La;612;329;283;2021
22;Huesca;114;Gistaín;133;76;57;2021
22;Huesca;115;Grado, El;393;205;188;2021
22;Huesca;116;Grañén;1740;907;833;2021
22;Huesca;117;Graus;3434;1707;1727;2021
22;Huesca;119;Gurrea de Gállego;1478;756;722;2021
22;Huesca;122;Hoz de Jaca;68;36;32;2021
22;Huesca;908;Hoz y Costean;240;136;104;2021
22;Huesca;124;Huerto;227;123;104;2021
22;Huesca;125;Huesca;53429;25516;27913;2021
22;Huesca;126;Ibieca;113;61;52;2021
22;Huesca;127;Igriés;703;375;328;2021
22;Huesca;128;Ilche;185;92;93;2021
22;Huesca;129;Isábena;247;127;120;2021
22;Huesca;130;Jaca;13344;6544;6800;2021
22;Huesca;131;Jasa;94;55;39;2021
22;Huesca;133;Labuerda;154;85;69;2021
22;Huesca;135;Laluenga;194;103;91;2021
22;Huesca;136;Lalueza;885;460;425;2021
22;Huesca;137;Lanaja;1195;623;572;2021
22;Huesca;139;Laperdiguera;92;50;42;2021
22;Huesca;141;Lascellas-Ponzano;133;81;52;2021
22;Huesca;142;Lascuarre;147;74;73;2021
22;Huesca;143;Laspaúles;222;124;98;2021
22;Huesca;144;Laspuña;288;159;129;2021
22;Huesca;149;Loarre;345;190;155;2021
22;Huesca;150;Loporzano;574;322;252;2021
22;Huesca;151;Loscorrales;93;48;45;2021
22;Huesca;905;Lupiñén-Ortilla;348;176;172;2021
22;Huesca;155;Monesma y Cajigar;69;37;32;2021
22;Huesca;156;Monflorite-Lascasas;432;228;204;2021
22;Huesca;157;Montanuy;215;121;94;2021
22;Huesca;158;Monzón;17362;8791;8571;2021
22;Huesca;160;Naval;261;141;120;2021
22;Huesca;162;Novales;147;72;75;2021
22;Huesca;163;Nueno;587;330;257;2021
22;Huesca;164;Olvena;58;30;28;2021
22;Huesca;165;Ontiñena;500;250;250;2021
22;Huesca;167;Osso de Cinca;671;377;294;2021
22;Huesca;168;Palo;28;14;14;2021
22;Huesca;170;Panticosa;849;450;399;2021
22;Huesca;172;Peñalba;692;385;307;2021
22;Huesca;173;Peñas de Riglos, Las;255;156;99;2021
22;Huesca;174;Peralta de Alcofea;576;297;279;2021
22;Huesca;175;Peralta de Calasanz;226;124;102;2021
22;Huesca;176;Peraltilla;224;108;116;2021
22;Huesca;177;Perarrúa;107;56;51;2021
22;Huesca;178;Pertusa;129;78;51;2021
22;Huesca;181;Piracés;96;49;47;2021
22;Huesca;182;Plan;274;141;133;2021
22;Huesca;184;Poleñino;199;104;95;2021
22;Huesca;186;Pozán de Vero;234;116;118;2021
22;Huesca;187;Puebla de Castro, La;391;206;185;2021
22;Huesca;188;Puente de Montañana;96;42;54;2021
22;Huesca;902;Puente la Reina de Jaca;251;133;118;2021
22;Huesca;189;Puértolas;212;115;97;2021
22;Huesca;190;Pueyo de Araguás, El;167;94;73;2021
22;Huesca;193;Pueyo de Santa Cruz;326;163;163;2021
22;Huesca;195;Quicena;291;139;152;2021
22;Huesca;197;Robres;525;274;251;2021
22;Huesca;199;Sabiñánigo;9352;4685;4667;2021
22;Huesca;200;Sahún;302;147;155;2021
22;Huesca;201;Salas Altas;309;160;149;2021
22;Huesca;202;Salas Bajas;193;95;98;2021
22;Huesca;203;Salillas;107;59;48;2021
22;Huesca;204;Sallent de Gállego;1519;751;768;2021
22;Huesca;205;San Esteban de Litera;570;300;270;2021
22;Huesca;207;San Juan de Plan;148;83;65;2021
22;Huesca;903;San Miguel del Cinca;795;413;382;2021
22;Huesca;206;Sangarrén;219;112;107;2021
22;Huesca;208;Santa Cilia;245;125;120;2021
22;Huesca;209;Santa Cruz de la Serós;193;110;83;2021
22;Huesca;906;Santa María de Dulcis;204;106;98;2021
22;Huesca;212;Santaliestra y San Quílez;75;40;35;2021
22;Huesca;213;Sariñena;4173;2186;1987;2021
22;Huesca;214;Secastilla;149;67;82;2021
22;Huesca;215;Seira;154;88;66;2021
22;Huesca;217;Sena;491;258;233;2021
22;Huesca;218;Senés de Alcubierre;45;23;22;2021
22;Huesca;220;Sesa;162;94;68;2021
22;Huesca;221;Sesué;123;57;66;2021
22;Huesca;222;Siétamo;710;396;314;2021
22;Huesca;223;Sopeira;93;53;40;2021
22;Huesca;904;Sotonera, La;903;484;419;2021
22;Huesca;225;Tamarite de Litera;3449;1776;1673;2021
22;Huesca;226;Tardienta;938;466;472;2021
22;Huesca;227;Tella-Sin;224;128;96;2021
22;Huesca;228;Tierz;800;394;406;2021
22;Huesca;229;Tolva;126;68;58;2021
22;Huesca;230;Torla-Ordesa;299;160;139;2021
22;Huesca;232;Torralba de Aragón;109;63;46;2021
22;Huesca;233;Torre la Ribera;95;50;45;2021
22;Huesca;234;Torrente de Cinca;1279;724;555;2021
22;Huesca;235;Torres de Alcanadre;91;52;39;2021
22;Huesca;236;Torres de Barbués;251;121;130;2021
22;Huesca;239;Tramaced;100;63;37;2021
22;Huesca;242;Valfarta;65;38;27;2021
22;Huesca;243;Valle de Bardají;64;39;25;2021
22;Huesca;901;Valle de Hecho;817;432;385;2021
22;Huesca;244;Valle de Lierp;46;27;19;2021
22;Huesca;245;Velilla de Cinca;480;251;229;2021
22;Huesca;909;Vencillón;399;216;183;2021
22;Huesca;247;Viacamp y Litera;41;26;15;2021
22;Huesca;248;Vicién;122;72;50;2021
22;Huesca;249;Villanova;171;86;85;2021
22;Huesca;250;Villanúa;524;275;249;2021
22;Huesca;251;Villanueva de Sigena;364;196;168;2021
22;Huesca;252;Yebra de Basa;152;91;61;2021
22;Huesca;253;Yésero;60;34;26;2021
22;Huesca;254;Zaidín;1860;978;882;2021
23;Jaén;001;Albanchez de Mágina;992;519;473;2021
23;Jaén;002;Alcalá la Real;21623;10662;10961;2021
23;Jaén;003;Alcaudete;10434;5105;5329;2021
23;Jaén;004;Aldeaquemada;487;260;227;2021
23;Jaén;005;Andújar;36212;17697;18515;2021
23;Jaén;006;Arjona;5450;2691;2759;2021
23;Jaén;007;Arjonilla;3545;1794;1751;2021
23;Jaén;008;Arquillos;1708;863;845;2021
23;Jaén;905;Arroyo del Ojanco;2243;1134;1109;2021
23;Jaén;009;Baeza;15762;7799;7963;2021
23;Jaén;010;Bailén;17498;8688;8810;2021
23;Jaén;011;Baños de la Encina;2596;1344;1252;2021
23;Jaén;012;Beas de Segura;5115;2678;2437;2021
23;Jaén;902;Bedmar y Garcíez;2656;1344;1312;2021
23;Jaén;014;Begíjar;2998;1503;1495;2021
23;Jaén;015;Bélmez de la Moraleda;1542;768;774;2021
23;Jaén;016;Benatae;443;226;217;2021
23;Jaén;017;Cabra del Santo Cristo;1786;937;849;2021
23;Jaén;018;Cambil;2662;1389;1273;2021
23;Jaén;019;Campillo de Arenas;1743;878;865;2021
23;Jaén;020;Canena;1822;944;878;2021
23;Jaén;021;Carboneros;608;314;294;2021
23;Jaén;901;Cárcheles;1320;696;624;2021
23;Jaén;024;Carolina, La;15048;7442;7606;2021
23;Jaén;025;Castellar;3267;1648;1619;2021
23;Jaén;026;Castillo de Locubín;4019;1994;2025;2021
23;Jaén;027;Cazalilla;775;393;382;2021
23;Jaén;028;Cazorla;7248;3512;3736;2021
23;Jaén;029;Chiclana de Segura;917;457;460;2021
23;Jaén;030;Chilluévar;1392;685;707;2021
23;Jaén;031;Escañuela;940;465;475;2021
23;Jaén;032;Espeluy;609;296;313;2021
23;Jaén;033;Frailes;1599;796;803;2021
23;Jaén;034;Fuensanta de Martos;3011;1511;1500;2021
23;Jaén;035;Fuerte del Rey;1313;677;636;2021
23;Jaén;037;Génave;593;324;269;2021
23;Jaén;038;Guardia de Jaén, La;5082;2584;2498;2021
23;Jaén;039;Guarromán;2714;1370;1344;2021
23;Jaén;041;Higuera de Calatrava;601;316;285;2021
23;Jaén;042;Hinojares;356;188;168;2021
23;Jaén;043;Hornos;601;294;307;2021
23;Jaén;044;Huelma;5682;2827;2855;2021
23;Jaén;045;Huesa;2475;1251;1224;2021
23;Jaén;046;Ibros;2808;1402;1406;2021
23;Jaén;047;Iruela, La;1892;952;940;2021
23;Jaén;048;Iznatoraf;907;455;452;2021
23;Jaén;049;Jabalquinto;2013;1014;999;2021
23;Jaén;050;Jaén;111932;53799;58133;2021
23;Jaén;051;Jamilena;3302;1668;1634;2021
23;Jaén;052;Jimena;1249;605;644;2021
23;Jaén;053;Jódar;11583;5783;5800;2021
23;Jaén;040;Lahiguera;1652;816;836;2021
23;Jaén;054;Larva;467;243;224;2021
23;Jaén;055;Linares;56525;27620;28905;2021
23;Jaén;056;Lopera;3640;1845;1795;2021
23;Jaén;057;Lupión;830;408;422;2021
23;Jaén;058;Mancha Real;11315;5638;5677;2021
23;Jaén;059;Marmolejo;6726;3333;3393;2021
23;Jaén;060;Martos;24271;12017;12254;2021
23;Jaén;061;Mengíbar;9973;4960;5013;2021
23;Jaén;062;Montizón;1635;840;795;2021
23;Jaén;063;Navas de San Juan;4473;2257;2216;2021
23;Jaén;064;Noalejo;1884;957;927;2021
23;Jaén;065;Orcera;1761;889;872;2021
23;Jaén;066;Peal de Becerro;5325;2659;2666;2021
23;Jaén;067;Pegalajar;2859;1434;1425;2021
23;Jaén;069;Porcuna;6115;3079;3036;2021
23;Jaén;070;Pozo Alcón;4706;2428;2278;2021
23;Jaén;071;Puente de Génave;2166;1091;1075;2021
23;Jaén;072;Puerta de Segura, La;2250;1137;1113;2021
23;Jaén;073;Quesada;5161;2625;2536;2021
23;Jaén;074;Rus;3516;1792;1724;2021
23;Jaén;075;Sabiote;3867;1908;1959;2021
23;Jaén;076;Santa Elena;887;464;423;2021
23;Jaén;077;Santiago de Calatrava;670;355;315;2021
23;Jaén;904;Santiago-Pontones;2832;1464;1368;2021
23;Jaén;079;Santisteban del Puerto;4472;2316;2156;2021
23;Jaén;080;Santo Tomé;2118;1077;1041;2021
23;Jaén;081;Segura de la Sierra;1771;873;898;2021
23;Jaén;082;Siles;2209;1128;1081;2021
23;Jaén;084;Sorihuela del Guadalimar;1075;558;517;2021
23;Jaén;085;Torreblascopedro;2422;1227;1195;2021
23;Jaén;086;Torredelcampo;14059;7042;7017;2021
23;Jaén;087;Torredonjimeno;13545;6679;6866;2021
23;Jaén;088;Torreperogil;7194;3529;3665;2021
23;Jaén;090;Torres;1350;696;654;2021
23;Jaén;091;Torres de Albánchez;760;399;361;2021
23;Jaén;092;Úbeda;34208;16725;17483;2021
23;Jaén;093;Valdepeñas de Jaén;3649;1819;1830;2021
23;Jaén;094;Vilches;4376;2194;2182;2021
23;Jaén;095;Villacarrillo;10545;5316;5229;2021
23;Jaén;096;Villanueva de la Reina;3026;1527;1499;2021
23;Jaén;097;Villanueva del Arzobispo;7967;4072;3895;2021
23;Jaén;098;Villardompardo;956;483;473;2021
23;Jaén;099;Villares, Los;6106;3067;3039;2021
23;Jaén;101;Villarrodrigo;392;206;186;2021
23;Jaén;903;Villatorres;4311;2190;2121;2021
24;León;001;Acebedo;185;106;79;2021
24;León;002;Algadefe;283;150;133;2021
24;León;003;Alija del Infantado;594;313;281;2021
24;León;004;Almanza;596;342;254;2021
24;León;005;Antigua, La;351;199;152;2021
24;León;006;Ardón;562;298;264;2021
24;León;007;Arganza;788;397;391;2021
24;León;008;Astorga;10553;4940;5613;2021
24;León;009;Balboa;287;159;128;2021
24;León;010;Bañeza, La;10068;4853;5215;2021
24;León;011;Barjas;167;92;75;2021
24;León;012;Barrios de Luna, Los;308;179;129;2021
24;León;014;Bembibre;8455;4067;4388;2021
24;León;015;Benavides;2426;1198;1228;2021
24;León;016;Benuza;464;277;187;2021
24;León;017;Bercianos del Páramo;541;273;268;2021
24;León;018;Bercianos del Real Camino;178;95;83;2021
24;León;019;Berlanga del Bierzo;347;158;189;2021
24;León;020;Boca de Huérgano;444;267;177;2021
24;León;021;Boñar;1819;928;891;2021
24;León;022;Borrenes;306;164;142;2021
24;León;023;Brazuelo;306;172;134;2021
24;León;024;Burgo Ranero, El;725;383;342;2021
24;León;025;Burón;294;172;122;2021
24;León;026;Bustillo del Páramo;1113;575;538;2021
24;León;027;Cabañas Raras;1331;688;643;2021
24;León;028;Cabreros del Río;409;228;181;2021
24;León;029;Cabrillanes;731;388;343;2021
24;León;030;Cacabelos;4888;2410;2478;2021
24;León;031;Calzada del Coto;217;128;89;2021
24;León;032;Campazas;113;54;59;2021
24;León;033;Campo de Villavidel;211;119;92;2021
24;León;034;Camponaraya;4105;2017;2088;2021
24;León;036;Candín;255;142;113;2021
24;León;037;Cármenes;335;187;148;2021
24;León;038;Carracedelo;3403;1705;1698;2021
24;León;039;Carrizo;2266;1131;1135;2021
24;León;040;Carrocera;452;238;214;2021
24;León;041;Carucedo;511;253;258;2021
24;León;042;Castilfalé;65;38;27;2021
24;León;043;Castrillo de Cabrera;108;65;43;2021
24;León;044;Castrillo de la Valduerna;149;70;79;2021
24;León;046;Castrocalbón;940;489;451;2021
24;León;047;Castrocontrigo;720;398;322;2021
24;León;049;Castropodame;1605;837;768;2021
24;León;050;Castrotierra de Valmadrigal;111;57;54;2021
24;León;051;Cea;402;216;186;2021
24;León;052;Cebanico;141;85;56;2021
24;León;053;Cebrones del Río;423;236;187;2021
24;León;065;Chozas de Abajo;2596;1344;1252;2021
24;León;054;Cimanes de la Vega;441;227;214;2021
24;León;055;Cimanes del Tejar;737;405;332;2021
24;León;056;Cistierna;3038;1497;1541;2021
24;León;057;Congosto;1431;711;720;2021
24;León;058;Corbillos de los Oteros;193;112;81;2021
24;León;059;Corullón;862;432;430;2021
24;León;060;Crémenes;522;287;235;2021
24;León;061;Cuadros;2057;1040;1017;2021
24;León;062;Cubillas de los Oteros;133;75;58;2021
24;León;063;Cubillas de Rueda;389;212;177;2021
24;León;064;Cubillos del Sil;1796;937;859;2021
24;León;066;Destriana;441;207;234;2021
24;León;067;Encinedo;661;353;308;2021
24;León;068;Ercina, La;450;248;202;2021
24;León;069;Escobar de Campos;33;19;14;2021
24;León;070;Fabero;4346;2116;2230;2021
24;León;071;Folgoso de la Ribera;1034;503;531;2021
24;León;073;Fresno de la Vega;478;244;234;2021
24;León;074;Fuentes de Carbajal;81;50;31;2021
24;León;076;Garrafe de Torío;1589;850;739;2021
24;León;077;Gordaliza del Pino;255;124;131;2021
24;León;078;Gordoncillo;350;170;180;2021
24;León;079;Gradefes;925;512;413;2021
24;León;080;Grajal de Campos;205;100;105;2021
24;León;081;Gusendos de los Oteros;127;67;60;2021
24;León;082;Hospital de Órbigo;977;489;488;2021
24;León;083;Igüeña;1109;577;532;2021
24;León;084;Izagre;150;77;73;2021
24;León;086;Joarilla de las Matas;270;142;128;2021
24;León;087;Laguna Dalga;633;341;292;2021
24;León;088;Laguna de Negrillos;1057;536;521;2021
24;León;089;León;122051;55166;66885;2021
24;León;092;Llamas de la Ribera;807;422;385;2021
24;León;090;Lucillo;377;199;178;2021
24;León;091;Luyego;564;305;259;2021
24;León;093;Magaz de Cepeda;358;191;167;2021
24;León;094;Mansilla de las Mulas;1708;853;855;2021
24;León;095;Mansilla Mayor;326;173;153;2021
24;León;096;Maraña;113;68;45;2021
24;León;097;Matadeón de los Oteros;229;116;113;2021
24;León;098;Matallana de Torío;1278;665;613;2021
24;León;099;Matanza;167;89;78;2021
24;León;100;Molinaseca;891;494;397;2021
24;León;101;Murias de Paredes;367;190;177;2021
24;León;102;Noceda del Bierzo;625;322;303;2021
24;León;103;Oencia;273;155;118;2021
24;León;104;Omañas, Las;261;140;121;2021
24;León;105;Onzonilla;1857;959;898;2021
24;León;106;Oseja de Sajambre;231;140;91;2021
24;León;107;Pajares de los Oteros;232;140;92;2021
24;León;108;Palacios de la Valduerna;373;184;189;2021
24;León;109;Palacios del Sil;912;499;413;2021
24;León;110;Páramo del Sil;1244;638;606;2021
24;León;112;Peranzanes;269;156;113;2021
24;León;113;Pobladura de Pelayo García;388;199;189;2021
24;León;114;Pola de Gordón, La;3060;1548;1512;2021
24;León;115;Ponferrada;63747;30144;33603;2021
24;León;116;Posada de Valdeón;424;243;181;2021
24;León;117;Pozuelo del Páramo;404;202;202;2021
24;León;118;Prado de la Guzpeña;99;57;42;2021
24;León;119;Priaranza del Bierzo;754;380;374;2021
24;León;120;Prioro;337;199;138;2021
24;León;121;Puebla de Lillo;672;390;282;2021
24;León;122;Puente de Domingo Flórez;1438;749;689;2021
24;León;123;Quintana del Castillo;718;399;319;2021
24;León;124;Quintana del Marco;356;192;164;2021
24;León;125;Quintana y Congosto;411;218;193;2021
24;León;127;Regueras de Arriba;271;143;128;2021
24;León;129;Reyero;131;68;63;2021
24;León;130;Riaño;471;259;212;2021
24;León;131;Riego de la Vega;708;381;327;2021
24;León;132;Riello;616;347;269;2021
24;León;133;Rioseco de Tapia;386;219;167;2021
24;León;134;Robla, La;3714;1845;1869;2021
24;León;136;Roperuelos del Páramo;512;264;248;2021
24;León;137;Sabero;1108;567;541;2021
24;León;139;Sahagún;2441;1210;1231;2021
24;León;141;San Adrián del Valle;100;57;43;2021
24;León;142;San Andrés del Rabanedo;30160;14358;15802;2021
24;León;144;San Cristóbal de la Polantera;658;346;312;2021
24;León;145;San Emiliano;630;355;275;2021
24;León;146;San Esteban de Nogales;252;133;119;2021
24;León;148;San Justo de la Vega;1780;917;863;2021
24;León;149;San Millán de los Caballeros;173;91;82;2021
24;León;150;San Pedro Bercianos;230;121;109;2021
24;León;143;Sancedo;536;269;267;2021
24;León;151;Santa Colomba de Curueño;478;251;227;2021
24;León;152;Santa Colomba de Somoza;518;285;233;2021
24;León;153;Santa Cristina de Valmadrigal;262;135;127;2021
24;León;154;Santa Elena de Jamuz;1029;540;489;2021
24;León;155;Santa María de la Isla;468;243;225;2021
24;León;158;Santa María de Ordás;332;179;153;2021
24;León;156;Santa María del Monte de Cea;217;117;100;2021
24;León;157;Santa María del Páramo;3109;1513;1596;2021
24;León;159;Santa Marina del Rey;1848;936;912;2021
24;León;160;Santas Martas;728;386;342;2021
24;León;161;Santiago Millas;343;192;151;2021
24;León;162;Santovenia de la Valdoncina;2079;1059;1020;2021
24;León;163;Sariegos;5170;2599;2571;2021
24;León;164;Sena de Luna;367;183;184;2021
24;León;165;Sobrado;292;149;143;2021
24;León;166;Soto de la Vega;1518;791;727;2021
24;León;167;Soto y Amío;770;393;377;2021
24;León;168;Toral de los Guzmanes;508;276;232;2021
24;León;206;Toral de los Vados;1809;902;907;2021
24;León;169;Toreno;3017;1503;1514;2021
24;León;170;Torre del Bierzo;2079;1060;1019;2021
24;León;171;Trabadelo;336;185;151;2021
24;León;172;Truchas;418;221;197;2021
24;León;173;Turcia;1003;517;486;2021
24;León;174;Urdiales del Páramo;480;257;223;2021
24;León;185;Val de San Lorenzo;496;247;249;2021
24;León;175;Valdefresno;2208;1155;1053;2021
24;León;176;Valdefuentes del Páramo;310;167;143;2021
24;León;177;Valdelugueros;515;292;223;2021
24;León;178;Valdemora;70;31;39;2021
24;León;179;Valdepiélago;309;175;134;2021
24;León;180;Valdepolo;1207;660;547;2021
24;León;181;Valderas;1575;794;781;2021
24;León;182;Valderrey;435;225;210;2021
24;León;183;Valderrueda;836;446;390;2021
24;León;184;Valdesamario;195;112;83;2021
24;León;187;Valdevimbre;936;489;447;2021
24;León;188;Valencia de Don Juan;5159;2535;2624;2021
24;León;191;Vallecillo;123;72;51;2021
24;León;189;Valverde de la Virgen;7442;3840;3602;2021
24;León;190;Valverde-Enrique;152;77;75;2021
24;León;193;Vecilla, La;414;221;193;2021
24;León;196;Vega de Espinareda;2005;1021;984;2021
24;León;197;Vega de Infanzones;824;415;409;2021
24;León;198;Vega de Valcarce;578;300;278;2021
24;León;194;Vegacervera;262;137;125;2021
24;León;199;Vegaquemada;426;244;182;2021
24;León;201;Vegas del Condado;1149;663;486;2021
24;León;202;Villablino;8226;3998;4228;2021
24;León;203;Villabraz;92;52;40;2021
24;León;205;Villadangos del Páramo;1214;653;561;2021
24;León;207;Villademor de la Vega;299;158;141;2021
24;León;209;Villafranca del Bierzo;2806;1351;1455;2021
24;León;210;Villagatón;636;347;289;2021
24;León;211;Villamandos;292;159;133;2021
24;León;901;Villamanín;912;460;452;2021
24;León;212;Villamañán;1083;553;530;2021
24;León;213;Villamartín de Don Sancho;156;86;70;2021
24;León;214;Villamejil;682;367;315;2021
24;León;215;Villamol;150;78;72;2021
24;León;216;Villamontán de la Valduerna;711;373;338;2021
24;León;217;Villamoratiel de las Matas;129;72;57;2021
24;León;218;Villanueva de las Manzanas;495;257;238;2021
24;León;219;Villaobispo de Otero;515;287;228;2021
24;León;902;Villaornate y Castro;318;165;153;2021
24;León;221;Villaquejida;828;425;403;2021
24;León;222;Villaquilambre;18597;9204;9393;2021
24;León;223;Villarejo de Órbigo;2945;1439;1506;2021
24;León;224;Villares de Órbigo;587;313;274;2021
24;León;225;Villasabariego;1121;575;546;2021
24;León;226;Villaselán;181;104;77;2021
24;León;227;Villaturiel;1865;983;882;2021
24;León;228;Villazala;636;344;292;2021
24;León;229;Villazanzo de Valderaduey;392;228;164;2021
24;León;230;Zotes del Páramo;419;237;182;2021
25;Lleida;001;Abella de la Conca;171;89;82;2021
25;Lleida;002;Àger;588;322;266;2021
25;Lleida;003;Agramunt;5464;2763;2701;2021
25;Lleida;038;Aitona;2493;1311;1182;2021
25;Lleida;004;Alamús, Els;773;390;383;2021
25;Lleida;005;Alàs i Cerc;322;155;167;2021
25;Lleida;006;Albagés, L';357;189;168;2021
25;Lleida;007;Albatàrrec;2224;1148;1076;2021
25;Lleida;008;Albesa;1561;847;714;2021
25;Lleida;009;Albi, L';749;383;366;2021
25;Lleida;010;Alcanó;233;118;115;2021
25;Lleida;011;Alcarràs;9678;5070;4608;2021
25;Lleida;012;Alcoletge;3492;1843;1649;2021
25;Lleida;013;Alfarràs;2759;1427;1332;2021
25;Lleida;014;Alfés;301;162;139;2021
25;Lleida;015;Algerri;423;232;191;2021
25;Lleida;016;Alguaire;3065;1632;1433;2021
25;Lleida;017;Alins;279;147;132;2021
25;Lleida;019;Almacelles;6875;3682;3193;2021
25;Lleida;020;Almatret;310;173;137;2021
25;Lleida;021;Almenar;3365;1778;1587;2021
25;Lleida;022;Alòs de Balaguer;122;74;48;2021
25;Lleida;023;Alpicat;6274;3159;3115;2021
25;Lleida;024;Alt Àneu;430;250;180;2021
25;Lleida;027;Anglesola;1356;686;670;2021
25;Lleida;029;Arbeca;2141;1114;1027;2021
25;Lleida;031;Arres;67;44;23;2021
25;Lleida;032;Arsèguel;85;49;36;2021
25;Lleida;033;Artesa de Lleida;1525;808;717;2021
25;Lleida;034;Artesa de Segre;3441;1772;1669;2021
25;Lleida;036;Aspa;207;103;104;2021
25;Lleida;037;Avellanes i Santa Linya, Les;447;250;197;2021
25;Lleida;039;Baix Pallars;342;184;158;2021
25;Lleida;040;Balaguer;17409;8918;8491;2021
25;Lleida;041;Barbens;943;518;425;2021
25;Lleida;042;Baronia de Rialb, La;229;118;111;2021
25;Lleida;044;Bassella;224;119;105;2021
25;Lleida;045;Bausen;66;34;32;2021
25;Lleida;046;Belianes;521;257;264;2021
25;Lleida;170;Bellaguarda;292;154;138;2021
25;Lleida;047;Bellcaire d'Urgell;1225;629;596;2021
25;Lleida;048;Bell-lloc d'Urgell;2329;1155;1174;2021
25;Lleida;049;Bellmunt d'Urgell;182;90;92;2021
25;Lleida;050;Bellpuig;5151;2737;2414;2021
25;Lleida;051;Bellver de Cerdanya;2135;1106;1029;2021
25;Lleida;052;Bellvís;2258;1153;1105;2021
25;Lleida;053;Benavent de Segrià;1533;810;723;2021
25;Lleida;055;Biosca;178;96;82;2021
25;Lleida;057;Bòrdes, Es;285;158;127;2021
25;Lleida;058;Borges Blanques, Les;6195;3167;3028;2021
25;Lleida;059;Bossòst;1120;546;574;2021
25;Lleida;056;Bovera;261;147;114;2021
25;Lleida;060;Cabanabona;60;28;32;2021
25;Lleida;061;Cabó;94;47;47;2021
25;Lleida;062;Camarasa;807;408;399;2021
25;Lleida;063;Canejan;89;45;44;2021
25;Lleida;904;Castell de Mur;169;97;72;2021
25;Lleida;064;Castellar de la Ribera;136;68;68;2021
25;Lleida;067;Castelldans;900;481;419;2021
25;Lleida;068;Castellnou de Seana;692;359;333;2021
25;Lleida;069;Castelló de Farfanya;529;287;242;2021
25;Lleida;070;Castellserà;976;498;478;2021
25;Lleida;071;Cava;46;32;14;2021
25;Lleida;072;Cervera;9328;4763;4565;2021
25;Lleida;073;Cervià de les Garrigues;665;354;311;2021
25;Lleida;074;Ciutadilla;202;104;98;2021
25;Lleida;075;Clariana de Cardener;158;83;75;2021
25;Lleida;076;Cogul, El;143;81;62;2021
25;Lleida;077;Coll de Nargó;548;280;268;2021
25;Lleida;163;Coma i la Pedra, La;277;162;115;2021
25;Lleida;161;Conca de Dalt;421;215;206;2021
25;Lleida;078;Corbins;1499;839;660;2021
25;Lleida;079;Cubells;357;182;175;2021
25;Lleida;081;Espluga Calba, L';328;165;163;2021
25;Lleida;082;Espot;366;196;170;2021
25;Lleida;088;Estamariu;129;73;56;2021
25;Lleida;085;Estaràs;172;87;85;2021
25;Lleida;086;Esterri d'Àneu;832;406;426;2021
25;Lleida;087;Esterri de Cardós;64;32;32;2021
25;Lleida;089;Farrera;116;67;49;2021
25;Lleida;908;Fígols i Alinyà;260;146;114;2021
25;Lleida;092;Floresta, La;145;79;66;2021
25;Lleida;093;Fondarella;781;390;391;2021
25;Lleida;094;Foradada;195;123;72;2021
25;Lleida;096;Fuliola, La;1247;635;612;2021
25;Lleida;097;Fulleda;101;50;51;2021
25;Lleida;098;Gavet de la Conca;262;133;129;2021
25;Lleida;912;Gimenells i el Pla de la Font;1118;597;521;2021
25;Lleida;099;Golmés;1855;931;924;2021
25;Lleida;100;Gósol;232;133;99;2021
25;Lleida;101;Granadella, La;705;385;320;2021
25;Lleida;102;Granja d'Escarp, La;931;523;408;2021
25;Lleida;103;Granyanella;145;82;63;2021
25;Lleida;105;Granyena de les Garrigues;154;93;61;2021
25;Lleida;104;Granyena de Segarra;159;86;73;2021
25;Lleida;109;Guimerà;263;141;122;2021
25;Lleida;903;Guingueta d'Àneu, La;300;163;137;2021
25;Lleida;110;Guissona;7291;3917;3374;2021
25;Lleida;111;Guixers;126;76;50;2021
25;Lleida;115;Isona i Conca Dellà;1060;578;482;2021
25;Lleida;112;Ivars de Noguera;335;175;160;2021
25;Lleida;113;Ivars d'Urgell;1553;818;735;2021
25;Lleida;114;Ivorra;110;61;49;2021
25;Lleida;910;Josa i Tuixén;100;58;42;2021
25;Lleida;118;Juncosa;397;206;191;2021
25;Lleida;119;Juneda;3569;1916;1653;2021
25;Lleida;121;Les;966;475;491;2021
25;Lleida;122;Linyola;2724;1380;1344;2021
25;Lleida;123;Lladorre;244;124;120;2021
25;Lleida;124;Lladurs;187;98;89;2021
25;Lleida;125;Llardecans;429;229;200;2021
25;Lleida;126;Llavorsí;345;176;169;2021
25;Lleida;120;Lleida;140080;69390;70690;2021
25;Lleida;127;Lles de Cerdanya;288;164;124;2021
25;Lleida;128;Llimiana;155;90;65;2021
25;Lleida;129;Llobera;187;108;79;2021
25;Lleida;133;Maials;926;510;416;2021
25;Lleida;130;Maldà;237;120;117;2021
25;Lleida;131;Massalcoreig;599;344;255;2021
25;Lleida;132;Massoteres;223;124;99;2021
25;Lleida;134;Menàrguens;789;428;361;2021
25;Lleida;135;Miralcamp;1366;713;653;2021
25;Lleida;137;Mollerussa;14545;7462;7083;2021
25;Lleida;136;Molsosa, La;102;51;51;2021
25;Lleida;139;Montellà i Martinet;596;328;268;2021
25;Lleida;140;Montferrer i Castellbò;1081;588;493;2021
25;Lleida;138;Montgai;655;346;309;2021
25;Lleida;142;Montoliu de Lleida;493;259;234;2021
25;Lleida;141;Montoliu de Segarra;191;105;86;2021
25;Lleida;143;Montornès de Segarra;91;43;48;2021
25;Lleida;145;Nalec;88;46;42;2021
25;Lleida;025;Naut Aran;1941;1013;928;2021
25;Lleida;146;Navès;293;148;145;2021
25;Lleida;148;Odèn;253;149;104;2021
25;Lleida;149;Oliana;1857;929;928;2021
25;Lleida;150;Oliola;201;108;93;2021
25;Lleida;151;Olius;962;519;443;2021
25;Lleida;152;Oluges, Les;169;92;77;2021
25;Lleida;153;Omellons, Els;202;109;93;2021
25;Lleida;154;Omells de na Gaia, Els;127;71;56;2021
25;Lleida;155;Organyà;766;378;388;2021
25;Lleida;156;Os de Balaguer;1000;513;487;2021
25;Lleida;157;Ossó de Sió;196;94;102;2021
25;Lleida;158;Palau d'Anglesola, El;2205;1101;1104;2021
25;Lleida;164;Penelles;443;254;189;2021
25;Lleida;165;Peramola;348;174;174;2021
25;Lleida;166;Pinell de Solsonès;188;109;79;2021
25;Lleida;167;Pinós;290;155;135;2021
25;Lleida;911;Plans de Sió, Els;503;277;226;2021
25;Lleida;168;Poal, El;667;345;322;2021
25;Lleida;169;Pobla de Cérvoles, La;198;104;94;2021
25;Lleida;171;Pobla de Segur, La;3050;1522;1528;2021
25;Lleida;030;Pont de Bar, El;174;105;69;2021
25;Lleida;173;Pont de Suert, El;2331;1169;1162;2021
25;Lleida;172;Ponts;2629;1338;1291;2021
25;Lleida;174;Portella, La;727;409;318;2021
25;Lleida;175;Prats i Sansor;251;132;119;2021
25;Lleida;176;Preixana;391;207;184;2021
25;Lleida;177;Preixens;421;211;210;2021
25;Lleida;179;Prullans;246;115;131;2021
25;Lleida;180;Puiggròs;265;134;131;2021
25;Lleida;181;Puigverd d'Agramunt;230;131;99;2021
25;Lleida;182;Puigverd de Lleida;1384;711;673;2021
25;Lleida;183;Rialp;658;327;331;2021
25;Lleida;905;Ribera d'Ondara;431;219;212;2021
25;Lleida;185;Ribera d'Urgellet;947;489;458;2021
25;Lleida;186;Riner;281;139;142;2021
25;Lleida;913;Riu de Cerdanya;93;56;37;2021
25;Lleida;189;Rosselló;3186;1627;1559;2021
25;Lleida;190;Salàs de Pallars;343;187;156;2021
25;Lleida;191;Sanaüja;396;207;189;2021
25;Lleida;196;Sant Esteve de la Sarga;122;74;48;2021
25;Lleida;192;Sant Guim de Freixenet;1059;551;508;2021
25;Lleida;197;Sant Guim de la Plana;184;101;83;2021
25;Lleida;193;Sant Llorenç de Morunys;985;483;502;2021
25;Lleida;902;Sant Martí de Riucorb;649;341;308;2021
25;Lleida;194;Sant Ramon;497;261;236;2021
25;Lleida;201;Sarroca de Bellera;120;69;51;2021
25;Lleida;200;Sarroca de Lleida;357;196;161;2021
25;Lleida;202;Senterada;150;88;62;2021
25;Lleida;035;Sentiu de Sió, La;426;222;204;2021
25;Lleida;204;Seròs;1923;1038;885;2021
25;Lleida;203;Seu d'Urgell, La;12252;5949;6303;2021
25;Lleida;205;Sidamon;755;403;352;2021
25;Lleida;206;Soleràs, El;337;181;156;2021
25;Lleida;207;Solsona;9175;4533;4642;2021
25;Lleida;208;Soriguera;431;229;202;2021
25;Lleida;209;Sort;2181;1073;1108;2021
25;Lleida;210;Soses;1781;935;846;2021
25;Lleida;211;Sudanell;844;465;379;2021
25;Lleida;212;Sunyer;334;187;147;2021
25;Lleida;215;Talarn;489;288;201;2021
25;Lleida;216;Talavera;287;158;129;2021
25;Lleida;217;Tàrrega;17649;8752;8897;2021
25;Lleida;218;Tarrés;105;51;54;2021
25;Lleida;219;Tarroja de Segarra;187;103;84;2021
25;Lleida;220;Térmens;1330;682;648;2021
25;Lleida;221;Tírvia;131;63;68;2021
25;Lleida;222;Tiurana;73;33;40;2021
25;Lleida;223;Torà;1209;607;602;2021
25;Lleida;224;Torms, Els;145;78;67;2021
25;Lleida;225;Tornabous;826;444;382;2021
25;Lleida;227;Torre de Cabdella, La;765;388;377;2021
25;Lleida;226;Torrebesses;298;169;129;2021
25;Lleida;228;Torrefarrera;4702;2379;2323;2021
25;Lleida;907;Torrefeta i Florejacs;602;330;272;2021
25;Lleida;230;Torregrossa;2157;1125;1032;2021
25;Lleida;231;Torrelameu;759;471;288;2021
25;Lleida;232;Torres de Segre;2381;1257;1124;2021
25;Lleida;233;Torre-serona;383;200;183;2021
25;Lleida;234;Tremp;5893;2892;3001;2021
25;Lleida;043;Vall de Boí, La;1060;562;498;2021
25;Lleida;901;Vall de Cardós;382;204;178;2021
25;Lleida;238;Vallbona de les Monges;236;122;114;2021
25;Lleida;240;Vallfogona de Balaguer;1912;959;953;2021
25;Lleida;906;Valls d'Aguilar, Les;264;149;115;2021
25;Lleida;239;Valls de Valira, Les;800;412;388;2021
25;Lleida;909;Vansa i Fórnols, La;156;81;75;2021
25;Lleida;242;Verdú;880;409;471;2021
25;Lleida;243;Vielha e Mijaran;5674;2888;2786;2021
25;Lleida;244;Vilagrassa;587;310;277;2021
25;Lleida;245;Vilaller;554;293;261;2021
25;Lleida;247;Vilamòs;164;90;74;2021
25;Lleida;248;Vilanova de Bellpuig;1178;601;577;2021
25;Lleida;254;Vilanova de la Barca;1127;625;502;2021
25;Lleida;249;Vilanova de l'Aguda;194;95;99;2021
25;Lleida;250;Vilanova de Meià;427;263;164;2021
25;Lleida;251;Vilanova de Segrià;1000;544;456;2021
25;Lleida;252;Vila-sana;761;378;383;2021
25;Lleida;253;Vilosell, El;192;100;92;2021
25;Lleida;255;Vinaixa;464;244;220;2021
27;Lugo;001;Abadín;2297;1144;1153;2021
27;Lugo;002;Alfoz;1610;781;829;2021
27;Lugo;003;Antas de Ulla;1935;954;981;2021
27;Lugo;004;Baleira;1190;641;549;2021
27;Lugo;901;Baralla;2445;1279;1166;2021
27;Lugo;005;Barreiros;3001;1458;1543;2021
27;Lugo;006;Becerreá;2826;1414;1412;2021
27;Lugo;007;Begonte;2976;1492;1484;2021
27;Lugo;008;Bóveda;1407;718;689;2021
27;Lugo;902;Burela;9428;4717;4711;2021
27;Lugo;009;Carballedo;2123;1065;1058;2021
27;Lugo;010;Castro de Rei;5110;2533;2577;2021
27;Lugo;011;Castroverde;2609;1343;1266;2021
27;Lugo;012;Cervantes;1288;742;546;2021
27;Lugo;013;Cervo;4192;2071;2121;2021
27;Lugo;016;Chantada;8134;3931;4203;2021
27;Lugo;014;Corgo, O;3440;1766;1674;2021
27;Lugo;015;Cospeito;4374;2142;2232;2021
27;Lugo;017;Folgoso do Courel;989;512;477;2021
27;Lugo;018;Fonsagrada, A;3328;1751;1577;2021
27;Lugo;019;Foz;10078;4880;5198;2021
27;Lugo;020;Friol;3682;1874;1808;2021
27;Lugo;022;Guitiriz;5455;2735;2720;2021
27;Lugo;023;Guntín;2638;1354;1284;2021
27;Lugo;024;Incio, O;1521;771;750;2021
27;Lugo;026;Láncara;2551;1305;1246;2021
27;Lugo;027;Lourenzá;2129;1032;1097;2021
27;Lugo;028;Lugo;97613;45039;52574;2021
27;Lugo;029;Meira;1731;876;855;2021
27;Lugo;030;Mondoñedo;3480;1629;1851;2021
27;Lugo;031;Monforte de Lemos;18242;8675;9567;2021
27;Lugo;032;Monterroso;3562;1771;1791;2021
27;Lugo;033;Muras;611;310;301;2021
27;Lugo;034;Navia de Suarna;1041;584;457;2021
27;Lugo;035;Negueira de Muñiz;223;120;103;2021
27;Lugo;037;Nogais, As;1018;541;477;2021
27;Lugo;038;Ourol;984;506;478;2021
27;Lugo;039;Outeiro de Rei;5216;2685;2531;2021
27;Lugo;040;Palas de Rei;3316;1679;1637;2021
27;Lugo;041;Pantón;2429;1205;1224;2021
27;Lugo;042;Paradela;1723;861;862;2021
27;Lugo;043;Páramo, O;1347;675;672;2021
27;Lugo;044;Pastoriza, A;2918;1474;1444;2021
27;Lugo;045;Pedrafita do Cebreiro;943;512;431;2021
27;Lugo;047;Pobra do Brollón, A;1615;794;821;2021
27;Lugo;046;Pol;1634;816;818;2021
27;Lugo;048;Pontenova, A;2207;1058;1149;2021
27;Lugo;049;Portomarín;1382;717;665;2021
27;Lugo;050;Quiroga;3151;1481;1670;2021
27;Lugo;056;Rábade;1524;754;770;2021
27;Lugo;051;Ribadeo;9871;4677;5194;2021
27;Lugo;052;Ribas de Sil;946;481;465;2021
27;Lugo;053;Ribeira de Piquín;513;270;243;2021
27;Lugo;054;Riotorto;1213;607;606;2021
27;Lugo;055;Samos;1222;648;574;2021
27;Lugo;057;Sarria;13257;6446;6811;2021
27;Lugo;058;Saviñao, O;3589;1805;1784;2021
27;Lugo;059;Sober;2243;1100;1143;2021
27;Lugo;060;Taboada;2689;1289;1400;2021
27;Lugo;061;Trabada;1114;538;576;2021
27;Lugo;062;Triacastela;627;313;314;2021
27;Lugo;063;Valadouro, O;1960;935;1025;2021
27;Lugo;064;Vicedo, O;1657;812;845;2021
27;Lugo;065;Vilalba;14006;6728;7278;2021
27;Lugo;066;Viveiro;15312;7485;7827;2021
27;Lugo;021;Xermade;1768;867;901;2021
27;Lugo;025;Xove;3360;1724;1636;2021
28;Madrid;001;Acebeda, La;55;26;29;2021
28;Madrid;002;Ajalvir;4676;2437;2239;2021
28;Madrid;003;Alameda del Valle;246;148;98;2021
28;Madrid;004;Álamo, El;9908;4892;5016;2021
28;Madrid;005;Alcalá de Henares;195982;95061;100921;2021
28;Madrid;006;Alcobendas;116589;55719;60870;2021
28;Madrid;007;Alcorcón;170817;81998;88819;2021
28;Madrid;008;Aldea del Fresno;3085;1574;1511;2021
28;Madrid;009;Algete;20749;10184;10565;2021
28;Madrid;010;Alpedrete;14959;7351;7608;2021
28;Madrid;011;Ambite;662;330;332;2021
28;Madrid;012;Anchuelo;1359;701;658;2021
28;Madrid;013;Aranjuez;59833;29126;30707;2021
28;Madrid;014;Arganda del Rey;56386;28161;28225;2021
28;Madrid;015;Arroyomolinos;33687;16775;16912;2021
28;Madrid;016;Atazar, El;109;62;47;2021
28;Madrid;017;Batres;1820;924;896;2021
28;Madrid;018;Becerril de la Sierra;6108;3042;3066;2021
28;Madrid;019;Belmonte de Tajo;1751;902;849;2021
28;Madrid;021;Berrueco, El;796;407;389;2021
28;Madrid;020;Berzosa del Lozoya;216;124;92;2021
28;Madrid;022;Boadilla del Monte;59052;28833;30219;2021
28;Madrid;023;Boalo, El;8009;4025;3984;2021
28;Madrid;024;Braojos;218;132;86;2021
28;Madrid;025;Brea de Tajo;523;302;221;2021
28;Madrid;026;Brunete;10726;5284;5442;2021
28;Madrid;027;Buitrago del Lozoya;1940;930;1010;2021
28;Madrid;028;Bustarviejo;2701;1366;1335;2021
28;Madrid;029;Cabanillas de la Sierra;837;433;404;2021
28;Madrid;030;Cabrera, La;2782;1357;1425;2021
28;Madrid;031;Cadalso de los Vidrios;3203;1651;1552;2021
28;Madrid;032;Camarma de Esteruelas;7555;3799;3756;2021
28;Madrid;033;Campo Real;6416;3251;3165;2021
28;Madrid;034;Canencia;461;247;214;2021
28;Madrid;035;Carabaña;2142;1076;1066;2021
28;Madrid;036;Casarrubuelos;3939;2012;1927;2021
28;Madrid;037;Cenicientos;2083;1043;1040;2021
28;Madrid;038;Cercedilla;7359;3645;3714;2021
28;Madrid;039;Cervera de Buitrago;158;96;62;2021
28;Madrid;051;Chapinería;2494;1256;1238;2021
28;Madrid;052;Chinchón;5506;2766;2740;2021
28;Madrid;040;Ciempozuelos;25083;12652;12431;2021
28;Madrid;041;Cobeña;7444;3646;3798;2021
28;Madrid;046;Collado Mediano;7348;3654;3694;2021
28;Madrid;047;Collado Villalba;63825;30921;32904;2021
28;Madrid;043;Colmenar de Oreja;8303;4189;4114;2021
28;Madrid;042;Colmenar del Arroyo;1875;980;895;2021
28;Madrid;045;Colmenar Viejo;52480;25888;26592;2021
28;Madrid;044;Colmenarejo;9376;4578;4798;2021
28;Madrid;048;Corpa;742;381;361;2021
28;Madrid;049;Coslada;81273;39711;41562;2021
28;Madrid;050;Cubas de la Sagra;6642;3304;3338;2021
28;Madrid;053;Daganzo de Arriba;10520;5242;5278;2021
28;Madrid;054;Escorial, El;16594;8155;8439;2021
28;Madrid;055;Estremera;1381;716;665;2021
28;Madrid;056;Fresnedillas de la Oliva;1742;878;864;2021
28;Madrid;057;Fresno de Torote;2416;1279;1137;2021
28;Madrid;058;Fuenlabrada;192233;94533;97700;2021
28;Madrid;059;Fuente el Saz de Jarama;6883;3470;3413;2021
28;Madrid;060;Fuentidueña de Tajo;2228;1115;1113;2021
28;Madrid;061;Galapagar;34712;16926;17786;2021
28;Madrid;062;Garganta de los Montes;411;216;195;2021
28;Madrid;063;Gargantilla del Lozoya y Pinilla de Buitrago;344;192;152;2021
28;Madrid;064;Gascones;191;103;88;2021
28;Madrid;065;Getafe;183095;89299;93796;2021
28;Madrid;066;Griñón;10467;5210;5257;2021
28;Madrid;067;Guadalix de la Sierra;6594;3320;3274;2021
28;Madrid;068;Guadarrama;16747;8275;8472;2021
28;Madrid;069;Hiruela, La;72;50;22;2021
28;Madrid;070;Horcajo de la Sierra-Aoslos;170;88;82;2021
28;Madrid;071;Horcajuelo de la Sierra;106;57;49;2021
28;Madrid;072;Hoyo de Manzanares;8680;4363;4317;2021
28;Madrid;073;Humanes de Madrid;19736;9807;9929;2021
28;Madrid;074;Leganés;187762;90732;97030;2021
28;Madrid;075;Loeches;8860;4458;4402;2021
28;Madrid;076;Lozoya;593;318;275;2021
28;Madrid;901;Lozoyuela-Navas-Sieteiglesias;1407;728;679;2021
28;Madrid;078;Madarcos;57;33;24;2021
28;Madrid;079;Madrid;3305408;1540894;1764514;2021
28;Madrid;080;Majadahonda;72034;34119;37915;2021
28;Madrid;082;Manzanares el Real;9202;4657;4545;2021
28;Madrid;083;Meco;14903;7533;7370;2021
28;Madrid;084;Mejorada del Campo;23737;11788;11949;2021
28;Madrid;085;Miraflores de la Sierra;6585;3377;3208;2021
28;Madrid;086;Molar, El;9291;4714;4577;2021
28;Madrid;087;Molinos, Los;4563;2239;2324;2021
28;Madrid;088;Montejo de la Sierra;365;187;178;2021
28;Madrid;089;Moraleja de Enmedio;5294;2654;2640;2021
28;Madrid;090;Moralzarzal;13573;6775;6798;2021
28;Madrid;091;Morata de Tajuña;7924;4011;3913;2021
28;Madrid;092;Móstoles;209639;101892;107747;2021
28;Madrid;093;Navacerrada;3220;1611;1609;2021
28;Madrid;094;Navalafuente;1573;809;764;2021
28;Madrid;095;Navalagamella;2720;1396;1324;2021
28;Madrid;096;Navalcarnero;30695;15285;15410;2021
28;Madrid;097;Navarredonda y San Mamés;141;89;52;2021
28;Madrid;099;Navas del Rey;3062;1596;1466;2021
28;Madrid;100;Nuevo Baztán;6630;3403;3227;2021
28;Madrid;101;Olmeda de las Fuentes;357;183;174;2021
28;Madrid;102;Orusco de Tajuña;1291;661;630;2021
28;Madrid;104;Paracuellos de Jarama;26235;13164;13071;2021
28;Madrid;106;Parla;131689;65505;66184;2021
28;Madrid;107;Patones;524;254;270;2021
28;Madrid;108;Pedrezuela;6226;3113;3113;2021
28;Madrid;109;Pelayos de la Presa;2827;1442;1385;2021
28;Madrid;110;Perales de Tajuña;3059;1545;1514;2021
28;Madrid;111;Pezuela de las Torres;927;495;432;2021
28;Madrid;112;Pinilla del Valle;196;106;90;2021
28;Madrid;113;Pinto;53537;26464;27073;2021
28;Madrid;114;Piñuécar-Gandullas;185;96;89;2021
28;Madrid;115;Pozuelo de Alarcón;87134;41716;45418;2021
28;Madrid;116;Pozuelo del Rey;1190;617;573;2021
28;Madrid;117;Prádena del Rincón;149;80;69;2021
28;Madrid;118;Puebla de la Sierra;75;47;28;2021
28;Madrid;902;Puentes Viejas;719;396;323;2021
28;Madrid;119;Quijorna;3593;1800;1793;2021
28;Madrid;120;Rascafría;1754;955;799;2021
28;Madrid;121;Redueña;294;165;129;2021
28;Madrid;122;Ribatejada;863;444;419;2021
28;Madrid;123;Rivas-Vaciamadrid;92925;46032;46893;2021
28;Madrid;124;Robledillo de la Jara;97;50;47;2021
28;Madrid;125;Robledo de Chavela;4479;2352;2127;2021
28;Madrid;126;Robregordo;71;42;29;2021
28;Madrid;127;Rozas de Madrid, Las;94862;45806;49056;2021
28;Madrid;128;Rozas de Puerto Real;590;341;249;2021
28;Madrid;129;San Agustín del Guadalix;13538;6640;6898;2021
28;Madrid;130;San Fernando de Henares;39313;19140;20173;2021
28;Madrid;131;San Lorenzo de El Escorial;18454;8835;9619;2021
28;Madrid;132;San Martín de la Vega;19853;10133;9720;2021
28;Madrid;133;San Martín de Valdeiglesias;8760;4356;4404;2021
28;Madrid;134;San Sebastián de los Reyes;90962;44221;46741;2021
28;Madrid;135;Santa María de la Alameda;1436;769;667;2021
28;Madrid;136;Santorcaz;925;467;458;2021
28;Madrid;137;Santos de la Humosa, Los;2729;1395;1334;2021
28;Madrid;138;Serna del Monte, La;96;53;43;2021
28;Madrid;140;Serranillos del Valle;4429;2194;2235;2021
28;Madrid;141;Sevilla la Nueva;9345;4598;4747;2021
28;Madrid;143;Somosierra;87;49;38;2021
28;Madrid;144;Soto del Real;9091;4458;4633;2021
28;Madrid;145;Talamanca de Jarama;4123;2032;2091;2021
28;Madrid;146;Tielmes;2781;1418;1363;2021
28;Madrid;147;Titulcia;1360;697;663;2021
28;Madrid;148;Torrejón de Ardoz;132771;65240;67531;2021
28;Madrid;149;Torrejón de la Calzada;9549;4737;4812;2021
28;Madrid;150;Torrejón de Velasco;4594;2273;2321;2021
28;Madrid;151;Torrelaguna;4897;2448;2449;2021
28;Madrid;152;Torrelodones;24122;11634;12488;2021
28;Madrid;153;Torremocha de Jarama;1079;552;527;2021
28;Madrid;154;Torres de la Alameda;7729;3946;3783;2021
28;Madrid;903;Tres Cantos;48751;23678;25073;2021
28;Madrid;155;Valdaracete;612;314;298;2021
28;Madrid;156;Valdeavero;1670;861;809;2021
28;Madrid;157;Valdelaguna;1026;517;509;2021
28;Madrid;158;Valdemanco;1012;523;489;2021
28;Madrid;159;Valdemaqueda;789;405;384;2021
28;Madrid;160;Valdemorillo;13245;6691;6554;2021
28;Madrid;161;Valdemoro;77587;38185;39402;2021
28;Madrid;162;Valdeolmos-Alalpardo;4309;2215;2094;2021
28;Madrid;163;Valdepiélagos;612;316;296;2021
28;Madrid;164;Valdetorres de Jarama;4696;2353;2343;2021
28;Madrid;165;Valdilecha;3079;1581;1498;2021
28;Madrid;166;Valverde de Alcalá;518;275;243;2021
28;Madrid;167;Velilla de San Antonio;12543;6311;6232;2021
28;Madrid;168;Vellón, El;2083;1088;995;2021
28;Madrid;169;Venturada;2387;1240;1147;2021
28;Madrid;171;Villa del Prado;6837;3484;3353;2021
28;Madrid;170;Villaconejos;3464;1771;1693;2021
28;Madrid;172;Villalbilla;15049;7601;7448;2021
28;Madrid;173;Villamanrique de Tajo;762;393;369;2021
28;Madrid;174;Villamanta;2643;1336;1307;2021
28;Madrid;175;Villamantilla;1514;744;770;2021
28;Madrid;176;Villanueva de la Cañada;22580;11005;11575;2021
28;Madrid;178;Villanueva de Perales;1599;825;774;2021
28;Madrid;177;Villanueva del Pardillo;17310;8407;8903;2021
28;Madrid;179;Villar del Olmo;2211;1100;1111;2021
28;Madrid;180;Villarejo de Salvanés;7552;3764;3788;2021
28;Madrid;181;Villaviciosa de Odón;28030;13559;14471;2021
28;Madrid;182;Villavieja del Lozoya;276;150;126;2021
28;Madrid;183;Zarzalejo;1786;908;878;2021
29;Málaga;001;Alameda;5453;2765;2688;2021
29;Málaga;002;Alcaucín;2366;1210;1156;2021
29;Málaga;003;Alfarnate;1057;541;516;2021
29;Málaga;004;Alfarnatejo;358;185;173;2021
29;Málaga;005;Algarrobo;6551;3298;3253;2021
29;Málaga;006;Algatocín;825;429;396;2021
29;Málaga;007;Alhaurín de la Torre;41868;20802;21066;2021
29;Málaga;008;Alhaurín el Grande;26095;13022;13073;2021
29;Málaga;009;Almáchar;1843;940;903;2021
29;Málaga;010;Almargen;1944;990;954;2021
29;Málaga;011;Almogía;3859;2002;1857;2021
29;Málaga;012;Álora;13336;6764;6572;2021
29;Málaga;013;Alozaina;2090;1057;1033;2021
29;Málaga;014;Alpandeire;261;127;134;2021
29;Málaga;015;Antequera;41348;20247;21101;2021
29;Málaga;016;Árchez;398;204;194;2021
29;Málaga;017;Archidona;8114;4128;3986;2021
29;Málaga;018;Ardales;2518;1281;1237;2021
29;Málaga;019;Arenas;1181;615;566;2021
29;Málaga;020;Arriate;4112;2036;2076;2021
29;Málaga;021;Atajate;179;100;79;2021
29;Málaga;022;Benadalid;236;118;118;2021
29;Málaga;023;Benahavís;7829;3871;3958;2021
29;Málaga;024;Benalauría;436;227;209;2021
29;Málaga;025;Benalmádena;70204;34383;35821;2021
29;Málaga;026;Benamargosa;1535;787;748;2021
29;Málaga;027;Benamocarra;3030;1516;1514;2021
29;Málaga;028;Benaoján;1470;747;723;2021
29;Málaga;029;Benarrabá;438;231;207;2021
29;Málaga;030;Borge, El;906;461;445;2021
29;Málaga;031;Burgo, El;1805;917;888;2021
29;Málaga;032;Campillos;8301;4162;4139;2021
29;Málaga;033;Canillas de Aceituno;1704;886;818;2021
29;Málaga;034;Canillas de Albaida;811;396;415;2021
29;Málaga;035;Cañete la Real;1633;811;822;2021
29;Málaga;036;Carratraca;719;376;343;2021
29;Málaga;037;Cartajima;259;138;121;2021
29;Málaga;038;Cártama;27436;13883;13553;2021
29;Málaga;039;Casabermeja;3712;1939;1773;2021
29;Málaga;040;Casarabonela;2532;1349;1183;2021
29;Málaga;041;Casares;7342;3764;3578;2021
29;Málaga;042;Coín;23375;11697;11678;2021
29;Málaga;043;Colmenar;3450;1776;1674;2021
29;Málaga;044;Comares;1349;735;614;2021
29;Málaga;045;Cómpeta;3866;1939;1927;2021
29;Málaga;046;Cortes de la Frontera;3034;1567;1467;2021
29;Málaga;047;Cuevas Bajas;1355;661;694;2021
29;Málaga;049;Cuevas de San Marcos;3614;1811;1803;2021
29;Málaga;048;Cuevas del Becerro;1601;783;818;2021
29;Málaga;050;Cútar;602;313;289;2021
29;Málaga;051;Estepona;71925;35203;36722;2021
29;Málaga;052;Faraján;250;124;126;2021
29;Málaga;053;Frigiliana;3198;1584;1614;2021
29;Málaga;054;Fuengirola;82585;40285;42300;2021
29;Málaga;055;Fuente de Piedra;2770;1389;1381;2021
29;Málaga;056;Gaucín;1595;826;769;2021
29;Málaga;057;Genalguacil;391;196;195;2021
29;Málaga;058;Guaro;2326;1191;1135;2021
29;Málaga;059;Humilladero;3293;1640;1653;2021
29;Málaga;060;Igualeja;740;371;369;2021
29;Málaga;061;Istán;1520;758;762;2021
29;Málaga;062;Iznate;912;474;438;2021
29;Málaga;063;Jimera de Líbar;388;202;186;2021
29;Málaga;064;Jubrique;553;279;274;2021
29;Málaga;065;Júzcar;235;135;100;2021
29;Málaga;066;Macharaviaya;524;286;238;2021
29;Málaga;067;Málaga;577405;277234;300171;2021
29;Málaga;068;Manilva;16849;8488;8361;2021
29;Málaga;069;Marbella;147958;70871;77087;2021
29;Málaga;070;Mijas;86744;43088;43656;2021
29;Málaga;071;Moclinejo;1244;651;593;2021
29;Málaga;072;Mollina;5341;2675;2666;2021
29;Málaga;073;Monda;2762;1437;1325;2021
29;Málaga;903;Montecorto;572;303;269;2021
29;Málaga;074;Montejaque;938;468;470;2021
29;Málaga;075;Nerja;21018;10357;10661;2021
29;Málaga;076;Ojén;4023;2062;1961;2021
29;Málaga;077;Parauta;251;129;122;2021
29;Málaga;079;Periana;3159;1644;1515;2021
29;Málaga;080;Pizarra;9572;4801;4771;2021
29;Málaga;081;Pujerra;298;154;144;2021
29;Málaga;082;Rincón de la Victoria;49790;24348;25442;2021
29;Málaga;083;Riogordo;2734;1423;1311;2021
29;Málaga;084;Ronda;33624;16295;17329;2021
29;Málaga;085;Salares;173;88;85;2021
29;Málaga;086;Sayalonga;1614;832;782;2021
29;Málaga;087;Sedella;592;336;256;2021
29;Málaga;904;Serrato;473;237;236;2021
29;Málaga;088;Sierra de Yeguas;3386;1714;1672;2021
29;Málaga;089;Teba;3727;1873;1854;2021
29;Málaga;090;Tolox;2203;1111;1092;2021
29;Málaga;901;Torremolinos;68056;34047;34009;2021
29;Málaga;091;Torrox;18937;9547;9390;2021
29;Málaga;092;Totalán;725;368;357;2021
29;Málaga;093;Valle de Abdalajís;2483;1259;1224;2021
29;Málaga;094;Vélez-Málaga;82967;40919;42048;2021
29;Málaga;095;Villanueva de Algaidas;4129;2119;2010;2021
29;Málaga;902;Villanueva de la Concepción;3277;1592;1685;2021
29;Málaga;098;Villanueva de Tapia;1437;728;709;2021
29;Málaga;096;Villanueva del Rosario;3374;1633;1741;2021
29;Málaga;097;Villanueva del Trabuco;5360;2688;2672;2021
29;Málaga;099;Viñuela;2045;1062;983;2021
29;Málaga;100;Yunquera;2866;1465;1401;2021
52;Melilla;001;Melilla;86261;43603;42658;2021
30;Murcia;001;Abanilla;6116;3099;3017;2021
30;Murcia;002;Abarán;13066;6531;6535;2021
30;Murcia;003;Águilas;35956;17929;18027;2021
30;Murcia;004;Albudeite;1388;705;683;2021
30;Murcia;005;Alcantarilla;42559;21073;21486;2021
30;Murcia;902;Alcázares, Los;16935;8677;8258;2021
30;Murcia;006;Aledo;1083;538;545;2021
30;Murcia;007;Alguazas;9842;5071;4771;2021
30;Murcia;008;Alhama de Murcia;22240;11262;10978;2021
30;Murcia;009;Archena;19500;10221;9279;2021
30;Murcia;010;Beniel;11508;6008;5500;2021
30;Murcia;011;Blanca;6608;3390;3218;2021
30;Murcia;012;Bullas;11619;5824;5795;2021
30;Murcia;013;Calasparra;10133;5141;4992;2021
30;Murcia;014;Campos del Río;2061;982;1079;2021
30;Murcia;015;Caravaca de la Cruz;25611;12803;12808;2021
30;Murcia;016;Cartagena;216365;107458;108907;2021
30;Murcia;017;Cehegín;14798;7412;7386;2021
30;Murcia;018;Ceutí;12199;6154;6045;2021
30;Murcia;019;Cieza;35301;17768;17533;2021
30;Murcia;020;Fortuna;10512;5577;4935;2021
30;Murcia;021;Fuente Álamo de Murcia;17225;8944;8281;2021
30;Murcia;022;Jumilla;26234;13683;12551;2021
30;Murcia;023;Librilla;5351;2736;2615;2021
30;Murcia;024;Lorca;96238;49260;46978;2021
30;Murcia;025;Lorquí;7320;3698;3622;2021
30;Murcia;026;Mazarrón;32988;17021;15967;2021
30;Murcia;027;Molina de Segura;73498;36682;36816;2021
30;Murcia;028;Moratalla;7797;3959;3838;2021
30;Murcia;029;Mula;17074;8761;8313;2021
30;Murcia;030;Murcia;460349;225606;234743;2021
30;Murcia;031;Ojós;495;259;236;2021
30;Murcia;032;Pliego;3868;2004;1864;2021
30;Murcia;033;Puerto Lumbreras;16060;8174;7886;2021
30;Murcia;034;Ricote;1265;676;589;2021
30;Murcia;035;San Javier;33645;16873;16772;2021
30;Murcia;036;San Pedro del Pinatar;26320;13250;13070;2021
30;Murcia;901;Santomera;16154;8092;8062;2021
30;Murcia;037;Torre-Pacheco;37299;19235;18064;2021
30;Murcia;038;Torres de Cotillas, Las;21837;11063;10774;2021
30;Murcia;039;Totana;32316;16616;15700;2021
30;Murcia;040;Ulea;866;447;419;2021
30;Murcia;041;Unión, La;20536;10415;10121;2021
30;Murcia;042;Villanueva del Río Segura;3268;1652;1616;2021
30;Murcia;043;Yecla;35083;17633;17450;2021
31;Navarra;001;Abáigar;84;49;35;2021
31;Navarra;002;Abárzuza/Abartzuza;538;270;268;2021
31;Navarra;003;Abaurregaina/Abaurrea Alta;128;80;48;2021
31;Navarra;004;Abaurrepea/Abaurrea Baja;29;19;10;2021
31;Navarra;005;Aberin;346;187;159;2021
31;Navarra;006;Ablitas;2480;1252;1228;2021
31;Navarra;007;Adiós;167;94;73;2021
31;Navarra;008;Aguilar de Codés;69;43;26;2021
31;Navarra;009;Aibar/Oibar;782;409;373;2021
31;Navarra;011;Allín/Allin;884;477;407;2021
31;Navarra;012;Allo;925;478;447;2021
31;Navarra;010;Altsasu/Alsasua;7441;3755;3686;2021
31;Navarra;013;Améscoa Baja;721;399;322;2021
31;Navarra;014;Ancín/Antzin;330;185;145;2021
31;Navarra;015;Andosilla;2752;1390;1362;2021
31;Navarra;016;Ansoáin/Antsoain;10732;5275;5457;2021
31;Navarra;017;Anue;493;263;230;2021
31;Navarra;018;Añorbe;614;337;277;2021
31;Navarra;019;Aoiz/Agoitz;2791;1411;1380;2021
31;Navarra;020;Araitz;512;284;228;2021
31;Navarra;025;Arakil;966;506;460;2021
31;Navarra;021;Aranarache/Aranaratxe;69;40;29;2021
31;Navarra;023;Aranguren;11726;5920;5806;2021
31;Navarra;024;Arano;114;61;53;2021
31;Navarra;022;Arantza;606;320;286;2021
31;Navarra;026;Aras;153;81;72;2021
31;Navarra;027;Arbizu;1113;581;532;2021
31;Navarra;028;Arce/Artzi;253;142;111;2021
31;Navarra;029;Arcos, Los;1132;560;572;2021
31;Navarra;030;Arellano;164;84;80;2021
31;Navarra;031;Areso;275;142;133;2021
31;Navarra;032;Arguedas;2310;1189;1121;2021
31;Navarra;033;Aria;49;30;19;2021
31;Navarra;034;Aribe;32;18;14;2021
31;Navarra;035;Armañanzas;47;25;22;2021
31;Navarra;036;Arróniz;1049;565;484;2021
31;Navarra;037;Arruazu;100;53;47;2021
31;Navarra;038;Artajona;1741;893;848;2021
31;Navarra;039;Artazu;117;59;58;2021
31;Navarra;040;Atez/Atetz;221;124;97;2021
31;Navarra;058;Auritz/Burguete;228;125;103;2021
31;Navarra;041;Ayegui/Aiegi;2430;1265;1165;2021
31;Navarra;042;Azagra;3781;1910;1871;2021
31;Navarra;043;Azuelo;27;11;16;2021
31;Navarra;044;Bakaiku;353;187;166;2021
31;Navarra;901;Barañáin/Barañain;19853;9633;10220;2021
31;Navarra;045;Barásoain;613;324;289;2021
31;Navarra;046;Barbarin;48;25;23;2021
31;Navarra;047;Bargota;254;127;127;2021
31;Navarra;048;Barillas;236;131;105;2021
31;Navarra;049;Basaburua;838;478;360;2021
31;Navarra;050;Baztan;7863;3973;3890;2021
31;Navarra;137;Beintza-Labaien;214;126;88;2021
31;Navarra;051;Beire;301;154;147;2021
31;Navarra;052;Belascoáin;117;62;55;2021
31;Navarra;250;Bera;3759;1851;1908;2021
31;Navarra;053;Berbinzana;677;345;332;2021
31;Navarra;905;Beriáin;4132;2028;2104;2021
31;Navarra;902;Berrioplano/Berriobeiti;7468;3802;3666;2021
31;Navarra;903;Berriozar;10723;5378;5345;2021
31;Navarra;054;Bertizarana;596;290;306;2021
31;Navarra;055;Betelu;377;191;186;2021
31;Navarra;253;Bidaurreta;165;85;80;2021
31;Navarra;056;Biurrun-Olcoz;227;126;101;2021
31;Navarra;057;Buñuel;2238;1096;1142;2021
31;Navarra;059;Burgui/Burgi;193;110;83;2021
31;Navarra;060;Burlada/Burlata;19723;9557;10166;2021
31;Navarra;061;Busto, El;53;25;28;2021
31;Navarra;062;Cabanillas;1335;698;637;2021
31;Navarra;063;Cabredo;85;47;38;2021
31;Navarra;064;Cadreita;2045;1069;976;2021
31;Navarra;065;Caparroso;2784;1468;1316;2021
31;Navarra;066;Cárcar;1120;567;553;2021
31;Navarra;067;Carcastillo;2487;1265;1222;2021
31;Navarra;068;Cascante;3962;1963;1999;2021
31;Navarra;069;Cáseda;952;486;466;2021
31;Navarra;070;Castejón;4306;2162;2144;2021
31;Navarra;071;Castillonuevo;18;11;7;2021
31;Navarra;193;Cendea de Olza/Oltza Zendea;1868;926;942;2021
31;Navarra;072;Cintruénigo;8051;4159;3892;2021
31;Navarra;074;Cirauqui/Zirauki;488;248;240;2021
31;Navarra;075;Ciriza/Ziritza;163;80;83;2021
31;Navarra;076;Cizur;3890;2001;1889;2021
31;Navarra;077;Corella;8220;4159;4061;2021
31;Navarra;078;Cortes;3164;1618;1546;2021
31;Navarra;079;Desojo;72;41;31;2021
31;Navarra;080;Dicastillo;589;305;284;2021
31;Navarra;081;Donamaria;451;223;228;2021
31;Navarra;221;Doneztebe/Santesteban;1826;909;917;2021
31;Navarra;083;Echarri/Etxarri;78;39;39;2021
31;Navarra;087;Elgorriaga;214;108;106;2021
31;Navarra;089;Enériz/Eneritz;296;146;150;2021
31;Navarra;090;Eratsun;146;89;57;2021
31;Navarra;091;Ergoiena;366;197;169;2021
31;Navarra;092;Erro;790;447;343;2021
31;Navarra;094;Eslava;106;49;57;2021
31;Navarra;095;Esparza de Salazar/Espartza Zaraitzu;74;40;34;2021
31;Navarra;096;Espronceda;103;58;45;2021
31;Navarra;097;Estella-Lizarra;13911;6692;7219;2021
31;Navarra;098;Esteribar;2790;1445;1345;2021
31;Navarra;099;Etayo;65;36;29;2021
31;Navarra;082;Etxalar;828;434;394;2021
31;Navarra;084;Etxarri Aranatz;2489;1293;1196;2021
31;Navarra;085;Etxauri;645;325;320;2021
31;Navarra;100;Eulate;279;156;123;2021
31;Navarra;101;Ezcabarte;1809;939;870;2021
31;Navarra;093;Ezcároz/Ezkaroze;308;169;139;2021
31;Navarra;102;Ezkurra;136;93;43;2021
31;Navarra;103;Ezprogui;43;20;23;2021
31;Navarra;104;Falces;2316;1190;1126;2021
31;Navarra;105;Fitero;2081;1035;1046;2021
31;Navarra;106;Fontellas;999;508;491;2021
31;Navarra;107;Funes;2455;1303;1152;2021
31;Navarra;108;Fustiñana;2490;1256;1234;2021
31;Navarra;109;Galar;2274;1184;1090;2021
31;Navarra;110;Gallipienzo/Galipentzu;102;58;44;2021
31;Navarra;111;Gallués/Galoze;96;62;34;2021
31;Navarra;112;Garaioa;96;54;42;2021
31;Navarra;113;Garde;137;81;56;2021
31;Navarra;114;Garínoain;503;267;236;2021
31;Navarra;115;Garralda;190;95;95;2021
31;Navarra;116;Genevilla;61;37;24;2021
31;Navarra;117;Goizueta;688;366;322;2021
31;Navarra;118;Goñi;165;101;64;2021
31;Navarra;119;Güesa/Gorza;34;21;13;2021
31;Navarra;120;Guesálaz/Gesalatz;438;251;187;2021
31;Navarra;121;Guirguillano;80;42;38;2021
31;Navarra;256;Hiriberri/Villanueva de Aezkoa;101;55;46;2021
31;Navarra;122;Huarte/Uharte;7286;3670;3616;2021
31;Navarra;124;Ibargoiti;265;154;111;2021
31;Navarra;259;Igantzi;587;314;273;2021
31;Navarra;125;Igúzquiza;317;161;156;2021
31;Navarra;126;Imotz;435;238;197;2021
31;Navarra;127;Irañeta;168;92;76;2021
31;Navarra;904;Irurtzun;2296;1188;1108;2021
31;Navarra;128;Isaba/Izaba;410;197;213;2021
31;Navarra;129;Ituren;508;256;252;2021
31;Navarra;130;Iturmendi;431;225;206;2021
31;Navarra;131;Iza/Itza;1293;701;592;2021
31;Navarra;132;Izagaondoa;172;111;61;2021
31;Navarra;133;Izalzu/Itzaltzu;38;22;16;2021
31;Navarra;134;Jaurrieta;181;104;77;2021
31;Navarra;135;Javier;125;29;96;2021
31;Navarra;136;Juslapeña;585;319;266;2021
31;Navarra;138;Lakuntza;1268;672;596;2021
31;Navarra;139;Lana;162;91;71;2021
31;Navarra;140;Lantz;151;88;63;2021
31;Navarra;141;Lapoblación;126;72;54;2021
31;Navarra;142;Larraga;2108;1115;993;2021
31;Navarra;143;Larraona;99;48;51;2021
31;Navarra;144;Larraun;916;501;415;2021
31;Navarra;145;Lazagurría;175;90;85;2021
31;Navarra;146;Leache/Leatxe;32;17;15;2021
31;Navarra;147;Legarda;124;64;60;2021
31;Navarra;148;Legaria;108;47;61;2021
31;Navarra;149;Leitza;3010;1547;1463;2021
31;Navarra;908;Lekunberri;1624;826;798;2021
31;Navarra;150;Leoz/Leotz;226;146;80;2021
31;Navarra;151;Lerga;46;29;17;2021
31;Navarra;152;Lerín;1775;918;857;2021
31;Navarra;153;Lesaka;2744;1395;1349;2021
31;Navarra;154;Lezaun;239;137;102;2021
31;Navarra;155;Liédena;316;161;155;2021
31;Navarra;156;Lizoáin-Arriasgoiti;314;184;130;2021
31;Navarra;157;Lodosa;4844;2457;2387;2021
31;Navarra;158;Lónguida/Longida;280;145;135;2021
31;Navarra;159;Lumbier;1293;700;593;2021
31;Navarra;160;Luquin;132;65;67;2021
31;Navarra;248;Luzaide/Valcarlos;320;177;143;2021
31;Navarra;161;Mañeru;423;218;205;2021
31;Navarra;162;Marañón;51;28;23;2021
31;Navarra;163;Marcilla;2866;1437;1429;2021
31;Navarra;164;Mélida;733;375;358;2021
31;Navarra;165;Mendavia;3505;1788;1717;2021
31;Navarra;166;Mendaza;299;148;151;2021
31;Navarra;167;Mendigorria;1112;583;529;2021
31;Navarra;168;Metauten;289;162;127;2021
31;Navarra;169;Milagro;3470;1798;1672;2021
31;Navarra;170;Mirafuentes;61;31;30;2021
31;Navarra;171;Miranda de Arga;852;450;402;2021
31;Navarra;172;Monreal/Elo;480;267;213;2021
31;Navarra;173;Monteagudo;1105;566;539;2021
31;Navarra;174;Morentin;116;59;57;2021
31;Navarra;175;Mues;85;48;37;2021
31;Navarra;176;Murchante;4135;2094;2041;2021
31;Navarra;177;Murieta;359;188;171;2021
31;Navarra;178;Murillo el Cuende;673;351;322;2021
31;Navarra;179;Murillo el Fruto;665;358;307;2021
31;Navarra;180;Muruzábal;254;116;138;2021
31;Navarra;181;Navascués/Nabaskoze;124;74;50;2021
31;Navarra;182;Nazar;36;22;14;2021
31;Navarra;088;Noáin (Valle de Elorz)/Noain (Elortzibar);8354;4191;4163;2021
31;Navarra;183;Obanos;928;459;469;2021
31;Navarra;185;Ochagavía/Otsagabia;496;269;227;2021
31;Navarra;184;Oco;74;38;36;2021
31;Navarra;186;Odieta;362;198;164;2021
31;Navarra;187;Oiz;132;75;57;2021
31;Navarra;188;Olaibar;389;219;170;2021
31;Navarra;189;Olazti/Olazagutía;1485;752;733;2021
31;Navarra;190;Olejua;51;29;22;2021
31;Navarra;191;Olite/Erriberri;3998;2022;1976;2021
31;Navarra;192;Olóriz/Oloritz;210;121;89;2021
31;Navarra;195;Orbaizeta;191;92;99;2021
31;Navarra;196;Orbara;32;17;15;2021
31;Navarra;197;Orísoain;87;47;40;2021
31;Navarra;906;Orkoien;4160;2103;2057;2021
31;Navarra;198;Oronz/Orontze;49;25;24;2021
31;Navarra;199;Oroz-Betelu/Orotz-Betelu;139;78;61;2021
31;Navarra;211;Orreaga/Roncesvalles;19;10;9;2021
31;Navarra;200;Oteiza;941;502;439;2021
31;Navarra;201;Pamplona/Iruña;203081;95849;107232;2021
31;Navarra;202;Peralta/Azkoien;5965;3014;2951;2021
31;Navarra;203;Petilla de Aragón;30;16;14;2021
31;Navarra;204;Piedramillera;39;24;15;2021
31;Navarra;205;Pitillas;532;260;272;2021
31;Navarra;206;Puente la Reina/Gares;2920;1501;1419;2021
31;Navarra;207;Pueyo;345;190;155;2021
31;Navarra;208;Ribaforada;3718;1949;1769;2021
31;Navarra;209;Romanzado;187;102;85;2021
31;Navarra;210;Roncal/Erronkari;206;104;102;2021
31;Navarra;212;Sada;136;78;58;2021
31;Navarra;213;Saldías;114;62;52;2021
31;Navarra;214;Salinas de Oro/Jaitz;108;57;51;2021
31;Navarra;215;San Adrián;6369;3179;3190;2021
31;Navarra;217;San Martín de Unx;393;207;186;2021
31;Navarra;216;Sangüesa/Zangoza;4872;2480;2392;2021
31;Navarra;219;Sansol;98;50;48;2021
31;Navarra;220;Santacara;865;448;417;2021
31;Navarra;222;Sarriés/Sartze;61;43;18;2021
31;Navarra;223;Sartaguda;1287;671;616;2021
31;Navarra;224;Sesma;1149;585;564;2021
31;Navarra;225;Sorlada;51;29;22;2021
31;Navarra;226;Sunbilla;674;344;330;2021
31;Navarra;227;Tafalla;10582;5256;5326;2021
31;Navarra;228;Tiebas-Muruarte de Reta;646;348;298;2021
31;Navarra;229;Tirapu;47;30;17;2021
31;Navarra;230;Torralba del Río;91;49;42;2021
31;Navarra;231;Torres del Río;122;61;61;2021
31;Navarra;232;Tudela;37008;18239;18769;2021
31;Navarra;233;Tulebras;136;59;77;2021
31;Navarra;234;Ucar;185;104;81;2021
31;Navarra;123;Uharte Arakil;781;408;373;2021
31;Navarra;235;Ujué/Uxue;175;96;79;2021
31;Navarra;236;Ultzama;1669;859;810;2021
31;Navarra;237;Unciti;227;129;98;2021
31;Navarra;238;Unzué/Untzue;160;84;76;2021
31;Navarra;239;Urdazubi/Urdax;348;176;172;2021
31;Navarra;240;Urdiain;664;347;317;2021
31;Navarra;241;Urraul Alto;142;90;52;2021
31;Navarra;242;Urraul Bajo;307;146;161;2021
31;Navarra;244;Urroz;179;99;80;2021
31;Navarra;243;Urroz-Villa;400;208;192;2021
31;Navarra;245;Urzainqui/Urzainki;88;55;33;2021
31;Navarra;246;Uterga;170;99;71;2021
31;Navarra;247;Uztárroz/Uztarroze;150;76;74;2021
31;Navarra;086;Valle de Egüés/Eguesibar;21556;10811;10745;2021
31;Navarra;194;Valle de Ollo/Ollaran;413;225;188;2021
31;Navarra;260;Valle de Yerri/Deierri;1563;807;756;2021
31;Navarra;249;Valtierra;2439;1219;1220;2021
31;Navarra;251;Viana;4341;2219;2122;2021
31;Navarra;252;Vidángoz/Bidankoze;82;48;34;2021
31;Navarra;254;Villafranca;2907;1489;1418;2021
31;Navarra;255;Villamayor de Monjardín;117;60;57;2021
31;Navarra;257;Villatuerta;1258;623;635;2021
31;Navarra;258;Villava/Atarrabia;10131;4938;5193;2021
31;Navarra;261;Yesa;288;168;120;2021
31;Navarra;262;Zabalza/Zabaltza;303;163;140;2021
31;Navarra;073;Ziordia;352;189;163;2021
31;Navarra;907;Zizur Mayor/Zizur Nagusia;15198;7442;7756;2021
31;Navarra;263;Zubieta;304;157;147;2021
31;Navarra;264;Zugarramurdi;211;104;107;2021
31;Navarra;265;Zúñiga;78;51;27;2021
32;Ourense;001;Allariz;6314;3134;3180;2021
32;Ourense;002;Amoeiro;2333;1179;1154;2021
32;Ourense;003;Arnoia, A;952;473;479;2021
32;Ourense;004;Avión;1738;790;948;2021
32;Ourense;005;Baltar;919;496;423;2021
32;Ourense;006;Bande;1490;755;735;2021
32;Ourense;007;Baños de Molgas;1483;743;740;2021
32;Ourense;008;Barbadás;11022;5395;5627;2021
32;Ourense;009;Barco de Valdeorras, O;13384;6496;6888;2021
32;Ourense;010;Beade;379;198;181;2021
32;Ourense;011;Beariz;971;440;531;2021
32;Ourense;012;Blancos, Os;745;404;341;2021
32;Ourense;013;Boborás;2206;1052;1154;2021
32;Ourense;014;Bola, A;1075;508;567;2021
32;Ourense;015;Bolo, O;828;420;408;2021
32;Ourense;016;Calvos de Randín;717;367;350;2021
32;Ourense;018;Carballeda de Avia;1249;610;639;2021
32;Ourense;017;Carballeda de Valdeorras;1460;759;701;2021
32;Ourense;019;Carballiño, O;13911;6462;7449;2021
32;Ourense;020;Cartelle;2570;1265;1305;2021
32;Ourense;022;Castrelo de Miño;1321;668;653;2021
32;Ourense;021;Castrelo do Val;979;489;490;2021
32;Ourense;023;Castro Caldelas;1182;599;583;2021
32;Ourense;024;Celanova;5652;2653;2999;2021
32;Ourense;025;Cenlle;1094;542;552;2021
32;Ourense;029;Chandrexa de Queixa;482;263;219;2021
32;Ourense;026;Coles;3125;1594;1531;2021
32;Ourense;027;Cortegada;1061;523;538;2021
32;Ourense;028;Cualedro;1639;860;779;2021
32;Ourense;030;Entrimo;1128;539;589;2021
32;Ourense;031;Esgos;1109;564;545;2021
32;Ourense;033;Gomesende;693;342;351;2021
32;Ourense;034;Gudiña, A;1232;625;607;2021
32;Ourense;035;Irixo, O;1401;674;727;2021
32;Ourense;038;Larouco;427;208;219;2021
32;Ourense;039;Laza;1222;632;590;2021
32;Ourense;040;Leiro;1510;743;767;2021
32;Ourense;041;Lobeira;769;383;386;2021
32;Ourense;042;Lobios;1672;838;834;2021
32;Ourense;043;Maceda;2849;1416;1433;2021
32;Ourense;044;Manzaneda;846;415;431;2021
32;Ourense;045;Maside;2718;1350;1368;2021
32;Ourense;046;Melón;1135;548;587;2021
32;Ourense;047;Merca, A;1939;968;971;2021
32;Ourense;048;Mezquita, A;1006;528;478;2021
32;Ourense;049;Montederramo;705;378;327;2021
32;Ourense;050;Monterrei;2501;1280;1221;2021
32;Ourense;051;Muíños;1447;732;715;2021
32;Ourense;052;Nogueira de Ramuín;2067;1053;1014;2021
32;Ourense;053;Oímbra;1713;936;777;2021
32;Ourense;054;Ourense;104596;47408;57188;2021
32;Ourense;055;Paderne de Allariz;1373;674;699;2021
32;Ourense;056;Padrenda;1653;799;854;2021
32;Ourense;057;Parada de Sil;544;288;256;2021
32;Ourense;058;Pereiro de Aguiar, O;6470;3353;3117;2021
32;Ourense;059;Peroxa, A;1826;906;920;2021
32;Ourense;060;Petín;879;436;443;2021
32;Ourense;061;Piñor;1162;597;565;2021
32;Ourense;063;Pobra de Trives, A;2015;1000;1015;2021
32;Ourense;064;Pontedeva;491;241;250;2021
32;Ourense;062;Porqueira;827;381;446;2021
32;Ourense;065;Punxín;704;340;364;2021
32;Ourense;066;Quintela de Leirado;614;272;342;2021
32;Ourense;067;Rairiz de Veiga;1223;625;598;2021
32;Ourense;068;Ramirás;1507;705;802;2021
32;Ourense;069;Ribadavia;5005;2451;2554;2021
32;Ourense;071;Riós;1459;749;710;2021
32;Ourense;072;Rúa, A;4245;2109;2136;2021
32;Ourense;073;Rubiá;1390;682;708;2021
32;Ourense;074;San Amaro;1048;502;546;2021
32;Ourense;075;San Cibrao das Viñas;5509;2781;2728;2021
32;Ourense;076;San Cristovo de Cea;2072;1016;1056;2021
32;Ourense;070;San Xoán de Río;505;262;243;2021
32;Ourense;077;Sandiás;1181;565;616;2021
32;Ourense;078;Sarreaus;1114;547;567;2021
32;Ourense;079;Taboadela;1452;738;714;2021
32;Ourense;080;Teixeira, A;336;172;164;2021
32;Ourense;081;Toén;2374;1218;1156;2021
32;Ourense;082;Trasmiras;1261;632;629;2021
32;Ourense;083;Veiga, A;886;452;434;2021
32;Ourense;084;Verea;914;441;473;2021
32;Ourense;085;Verín;13644;6544;7100;2021
32;Ourense;086;Viana do Bolo;2787;1415;1372;2021
32;Ourense;087;Vilamarín;1882;978;904;2021
32;Ourense;088;Vilamartín de Valdeorras;1837;940;897;2021
32;Ourense;089;Vilar de Barrio;1258;636;622;2021
32;Ourense;090;Vilar de Santos;791;384;407;2021
32;Ourense;091;Vilardevós;1781;938;843;2021
32;Ourense;092;Vilariño de Conso;513;293;220;2021
32;Ourense;032;Xinzo de Limia;9621;4682;4939;2021
32;Ourense;036;Xunqueira de Ambía;1366;689;677;2021
32;Ourense;037;Xunqueira de Espadanedo;738;365;373;2021
34;Palencia;001;Abarca de Campos;45;28;17;2021
34;Palencia;003;Abia de las Torres;167;90;77;2021
34;Palencia;004;Aguilar de Campoo;6711;3232;3479;2021
34;Palencia;005;Alar del Rey;908;444;464;2021
34;Palencia;006;Alba de Cerrato;83;47;36;2021
34;Palencia;009;Amayuelas de Arriba;36;23;13;2021
34;Palencia;010;Ampudia;600;306;294;2021
34;Palencia;011;Amusco;414;232;182;2021
34;Palencia;012;Antigüedad;362;202;160;2021
34;Palencia;015;Arconada;43;26;17;2021
34;Palencia;017;Astudillo;1021;516;505;2021
34;Palencia;018;Autilla del Pino;217;119;98;2021
34;Palencia;019;Autillo de Campos;132;69;63;2021
34;Palencia;020;Ayuela;54;34;20;2021
34;Palencia;022;Baltanás;1219;628;591;2021
34;Palencia;024;Baquerín de Campos;26;16;10;2021
34;Palencia;025;Bárcena de Campos;52;23;29;2021
34;Palencia;027;Barruelo de Santullán;1187;585;602;2021
34;Palencia;028;Báscones de Ojeda;138;71;67;2021
34;Palencia;029;Becerril de Campos;762;392;370;2021
34;Palencia;031;Belmonte de Campos;26;12;14;2021
34;Palencia;032;Berzosilla;39;22;17;2021
34;Palencia;033;Boada de Campos;18;13;5;2021
34;Palencia;035;Boadilla de Rioseco;114;65;49;2021
34;Palencia;034;Boadilla del Camino;121;70;51;2021
34;Palencia;036;Brañosera;255;142;113;2021
34;Palencia;037;Buenavista de Valdavia;308;172;136;2021
34;Palencia;038;Bustillo de la Vega;278;156;122;2021
34;Palencia;039;Bustillo del Páramo de Carrión;60;33;27;2021
34;Palencia;041;Calahorra de Boedo;85;41;44;2021
34;Palencia;042;Calzada de los Molinos;317;177;140;2021
34;Palencia;045;Capillas;72;39;33;2021
34;Palencia;046;Cardeñosa de Volpejera;56;29;27;2021
34;Palencia;047;Carrión de los Condes;2011;963;1048;2021
34;Palencia;048;Castil de Vela;58;28;30;2021
34;Palencia;049;Castrejón de la Peña;346;187;159;2021
34;Palencia;050;Castrillo de Don Juan;196;113;83;2021
34;Palencia;051;Castrillo de Onielo;104;51;53;2021
34;Palencia;052;Castrillo de Villavega;173;99;74;2021
34;Palencia;053;Castromocho;212;108;104;2021
34;Palencia;055;Cervatos de la Cueza;269;147;122;2021
34;Palencia;056;Cervera de Pisuerga;2288;1138;1150;2021
34;Palencia;057;Cevico de la Torre;479;244;235;2021
34;Palencia;058;Cevico Navero;186;111;75;2021
34;Palencia;059;Cisneros;429;212;217;2021
34;Palencia;060;Cobos de Cerrato;131;75;56;2021
34;Palencia;061;Collazos de Boedo;104;62;42;2021
34;Palencia;062;Congosto de Valdavia;150;88;62;2021
34;Palencia;063;Cordovilla la Real;98;57;41;2021
34;Palencia;066;Cubillas de Cerrato;63;38;25;2021
34;Palencia;067;Dehesa de Montejo;127;74;53;2021
34;Palencia;068;Dehesa de Romanos;56;33;23;2021
34;Palencia;069;Dueñas;2592;1321;1271;2021
34;Palencia;070;Espinosa de Cerrato;134;73;61;2021
34;Palencia;071;Espinosa de Villagonzalo;165;89;76;2021
34;Palencia;072;Frechilla;148;74;74;2021
34;Palencia;073;Fresno del Río;186;90;96;2021
34;Palencia;074;Frómista;777;397;380;2021
34;Palencia;076;Fuentes de Nava;625;318;307;2021
34;Palencia;077;Fuentes de Valdepero;497;258;239;2021
34;Palencia;079;Grijota;2496;1296;1200;2021
34;Palencia;080;Guardo;5786;2851;2935;2021
34;Palencia;081;Guaza de Campos;58;35;23;2021
34;Palencia;082;Hérmedes de Cerrato;78;39;39;2021
34;Palencia;083;Herrera de Pisuerga;1889;931;958;2021
34;Palencia;084;Herrera de Valdecañas;154;87;67;2021
34;Palencia;086;Hontoria de Cerrato;102;51;51;2021
34;Palencia;087;Hornillos de Cerrato;143;81;62;2021
34;Palencia;088;Husillos;358;195;163;2021
34;Palencia;089;Itero de la Vega;152;90;62;2021
34;Palencia;091;Lagartos;128;74;54;2021
34;Palencia;092;Lantadilla;284;153;131;2021
34;Palencia;094;Ledigos;65;33;32;2021
34;Palencia;903;Loma de Ucieza;199;118;81;2021
34;Palencia;096;Lomas;45;29;16;2021
34;Palencia;098;Magaz de Pisuerga;1024;533;491;2021
34;Palencia;099;Manquillos;61;38;23;2021
34;Palencia;100;Mantinos;140;79;61;2021
34;Palencia;101;Marcilla de Campos;45;21;24;2021
34;Palencia;102;Mazariegos;217;129;88;2021
34;Palencia;103;Mazuecos de Valdeginate;93;58;35;2021
34;Palencia;104;Melgar de Yuso;254;147;107;2021
34;Palencia;106;Meneses de Campos;120;70;50;2021
34;Palencia;107;Micieces de Ojeda;71;42;29;2021
34;Palencia;108;Monzón de Campos;596;315;281;2021
34;Palencia;109;Moratinos;63;33;30;2021
34;Palencia;110;Mudá;81;46;35;2021
34;Palencia;112;Nogal de las Huertas;39;22;17;2021
34;Palencia;113;Olea de Boedo;41;15;26;2021
34;Palencia;114;Olmos de Ojeda;187;118;69;2021
34;Palencia;116;Osornillo;56;29;27;2021
34;Palencia;901;Osorno la Mayor;1171;609;562;2021
34;Palencia;120;Palencia;77090;36352;40738;2021
34;Palencia;121;Palenzuela;214;123;91;2021
34;Palencia;122;Páramo de Boedo;106;62;44;2021
34;Palencia;123;Paredes de Nava;1875;960;915;2021
34;Palencia;124;Payo de Ojeda;63;39;24;2021
34;Palencia;125;Pedraza de Campos;74;39;35;2021
34;Palencia;126;Pedrosa de la Vega;288;163;125;2021
34;Palencia;127;Perales;91;44;47;2021
34;Palencia;904;Pernía, La;316;184;132;2021
34;Palencia;129;Pino del Río;174;101;73;2021
34;Palencia;130;Piña de Campos;203;102;101;2021
34;Palencia;131;Población de Arroyo;56;31;25;2021
34;Palencia;132;Población de Campos;135;76;59;2021
34;Palencia;133;Población de Cerrato;112;65;47;2021
34;Palencia;134;Polentinos;44;24;20;2021
34;Palencia;135;Pomar de Valdivia;475;264;211;2021
34;Palencia;136;Poza de la Vega;175;102;73;2021
34;Palencia;137;Pozo de Urama;21;14;7;2021
34;Palencia;139;Prádanos de Ojeda;185;103;82;2021
34;Palencia;140;Puebla de Valdavia, La;92;48;44;2021
34;Palencia;141;Quintana del Puente;290;160;130;2021
34;Palencia;143;Quintanilla de Onsoña;179;100;79;2021
34;Palencia;146;Reinoso de Cerrato;58;36;22;2021
34;Palencia;147;Renedo de la Vega;191;102;89;2021
34;Palencia;149;Requena de Campos;22;10;12;2021
34;Palencia;151;Respenda de la Peña;147;89;58;2021
34;Palencia;152;Revenga de Campos;147;74;73;2021
34;Palencia;154;Revilla de Collazos;79;46;33;2021
34;Palencia;155;Ribas de Campos;137;66;71;2021
34;Palencia;156;Riberos de la Cueza;54;33;21;2021
34;Palencia;157;Saldaña;2950;1515;1435;2021
34;Palencia;158;Salinas de Pisuerga;311;160;151;2021
34;Palencia;159;San Cebrián de Campos;413;228;185;2021
34;Palencia;160;San Cebrián de Mudá;154;86;68;2021
34;Palencia;161;San Cristóbal de Boedo;23;15;8;2021
34;Palencia;163;San Mamés de Campos;49;26;23;2021
34;Palencia;165;San Román de la Cuba;62;37;25;2021
34;Palencia;167;Santa Cecilia del Alcor;107;61;46;2021
34;Palencia;168;Santa Cruz de Boedo;49;30;19;2021
34;Palencia;169;Santervás de la Vega;413;236;177;2021
34;Palencia;170;Santibáñez de Ecla;48;27;21;2021
34;Palencia;171;Santibáñez de la Peña;1002;492;510;2021
34;Palencia;174;Santoyo;188;104;84;2021
34;Palencia;175;Serna, La;94;61;33;2021
34;Palencia;177;Soto de Cerrato;192;110;82;2021
34;Palencia;176;Sotobañado y Priorato;144;83;61;2021
34;Palencia;178;Tabanera de Cerrato;137;73;64;2021
34;Palencia;179;Tabanera de Valdavia;24;14;10;2021
34;Palencia;180;Támara de Campos;74;39;35;2021
34;Palencia;181;Tariego de Cerrato;485;255;230;2021
34;Palencia;182;Torquemada;970;530;440;2021
34;Palencia;184;Torremormojón;47;25;22;2021
34;Palencia;185;Triollo;71;39;32;2021
34;Palencia;186;Valbuena de Pisuerga;46;23;23;2021
34;Palencia;189;Valdeolmillos;57;32;25;2021
34;Palencia;190;Valderrábano;48;26;22;2021
34;Palencia;192;Valde-Ucieza;81;51;30;2021
34;Palencia;196;Valle de Cerrato;88;51;37;2021
34;Palencia;902;Valle del Retortillo;174;98;76;2021
34;Palencia;199;Velilla del Río Carrión;1187;607;580;2021
34;Palencia;023;Venta de Baños;6399;3230;3169;2021
34;Palencia;201;Vertavillo;169;90;79;2021
34;Palencia;093;Vid de Ojeda, La;88;53;35;2021
34;Palencia;202;Villabasta de Valdavia;32;18;14;2021
34;Palencia;204;Villacidaler;45;27;18;2021
34;Palencia;205;Villaconancio;60;37;23;2021
34;Palencia;206;Villada;897;454;443;2021
34;Palencia;208;Villaeles de Valdavia;53;32;21;2021
34;Palencia;210;Villahán;95;52;43;2021
34;Palencia;211;Villaherreros;203;107;96;2021
34;Palencia;213;Villalaco;52;30;22;2021
34;Palencia;214;Villalba de Guardo;191;103;88;2021
34;Palencia;215;Villalcázar de Sirga;168;86;82;2021
34;Palencia;216;Villalcón;61;36;25;2021
34;Palencia;217;Villalobón;1768;884;884;2021
34;Palencia;218;Villaluenga de la Vega;566;328;238;2021
34;Palencia;220;Villamartín de Campos;187;103;84;2021
34;Palencia;221;Villamediana;182;105;77;2021
34;Palencia;222;Villameriel;108;62;46;2021
34;Palencia;223;Villamoronta;243;143;100;2021
34;Palencia;224;Villamuera de la Cueza;36;24;12;2021
34;Palencia;225;Villamuriel de Cerrato;6470;3344;3126;2021
34;Palencia;227;Villanueva del Rebollar;68;35;33;2021
34;Palencia;228;Villanuño de Valdavia;92;53;39;2021
34;Palencia;229;Villaprovedo;52;34;18;2021
34;Palencia;230;Villarmentero de Campos;18;12;6;2021
34;Palencia;231;Villarrabé;192;99;93;2021
34;Palencia;232;Villarramiel;833;439;394;2021
34;Palencia;233;Villasarracino;138;83;55;2021
34;Palencia;234;Villasila de Valdavia;64;43;21;2021
34;Palencia;236;Villaturde;158;86;72;2021
34;Palencia;237;Villaumbrales;653;324;329;2021
34;Palencia;238;Villaviudas;355;169;186;2021
34;Palencia;240;Villerías de Campos;86;43;43;2021
34;Palencia;241;Villodre;17;9;8;2021
34;Palencia;242;Villodrigo;109;59;50;2021
34;Palencia;243;Villoldo;325;173;152;2021
34;Palencia;245;Villota del Páramo;315;180;135;2021
34;Palencia;246;Villovieco;68;37;31;2021
35;Palmas, Las;001;Agaete;5695;2856;2839;2021
35;Palmas, Las;002;Agüimes;32105;16197;15908;2021
35;Palmas, Las;020;Aldea de San Nicolás, La;7516;3867;3649;2021
35;Palmas, Las;003;Antigua;12783;6716;6067;2021
35;Palmas, Las;004;Arrecife;64497;32389;32108;2021
35;Palmas, Las;005;Artenara;1046;594;452;2021
35;Palmas, Las;006;Arucas;38535;19155;19380;2021
35;Palmas, Las;007;Betancuria;762;394;368;2021
35;Palmas, Las;008;Firgas;7513;3792;3721;2021
35;Palmas, Las;009;Gáldar;24455;12247;12208;2021
35;Palmas, Las;010;Haría;5365;2767;2598;2021
35;Palmas, Las;011;Ingenio;31887;15999;15888;2021
35;Palmas, Las;012;Mogán;20572;10618;9954;2021
35;Palmas, Las;013;Moya;7833;3981;3852;2021
35;Palmas, Las;014;Oliva, La;27768;14398;13370;2021
35;Palmas, Las;015;Pájara;21014;10946;10068;2021
35;Palmas, Las;016;Palmas de Gran Canaria, Las;378675;182571;196104;2021
35;Palmas, Las;017;Puerto del Rosario;41786;21069;20717;2021
35;Palmas, Las;018;San Bartolomé;19058;9528;9530;2021
35;Palmas, Las;019;San Bartolomé de Tirajana;53066;27752;25314;2021
35;Palmas, Las;021;Santa Brígida;18297;9115;9182;2021
35;Palmas, Las;022;Santa Lucía de Tirajana;73573;36635;36938;2021
35;Palmas, Las;023;Santa María de Guía de Gran Canaria;13871;6905;6966;2021
35;Palmas, Las;024;Teguise;23044;11595;11449;2021
35;Palmas, Las;025;Tejeda;1865;1015;850;2021
35;Palmas, Las;026;Telde;102769;50464;52305;2021
35;Palmas, Las;027;Teror;12634;6457;6177;2021
35;Palmas, Las;028;Tías;20801;10641;10160;2021
35;Palmas, Las;029;Tinajo;6447;3318;3129;2021
35;Palmas, Las;030;Tuineje;15549;7910;7639;2021
35;Palmas, Las;032;Valleseco;3754;1968;1786;2021
35;Palmas, Las;031;Valsequillo de Gran Canaria;9382;4697;4685;2021
35;Palmas, Las;033;Vega de San Mateo;7645;3944;3701;2021
35;Palmas, Las;034;Yaiza;16977;8781;8196;2021
36;Pontevedra;020;Agolada;2228;1115;1113;2021
36;Pontevedra;001;Arbo;2599;1350;1249;2021
36;Pontevedra;003;Baiona;12286;6043;6243;2021
36;Pontevedra;002;Barro;3622;1778;1844;2021
36;Pontevedra;004;Bueu;11987;5889;6098;2021
36;Pontevedra;005;Caldas de Reis;9788;4728;5060;2021
36;Pontevedra;006;Cambados;13673;6600;7073;2021
36;Pontevedra;007;Campo Lameiro;1769;831;938;2021
36;Pontevedra;008;Cangas;26708;13265;13443;2021
36;Pontevedra;009;Cañiza, A;5115;2512;2603;2021
36;Pontevedra;010;Catoira;3316;1604;1712;2021
36;Pontevedra;902;Cerdedo-Cotobade;5719;2780;2939;2021
36;Pontevedra;013;Covelo;2455;1264;1191;2021
36;Pontevedra;014;Crecente;1961;952;1009;2021
36;Pontevedra;015;Cuntis;4643;2214;2429;2021
36;Pontevedra;016;Dozón;1057;550;507;2021
36;Pontevedra;017;Estrada, A;20261;9736;10525;2021
36;Pontevedra;018;Forcarei;3268;1557;1711;2021
36;Pontevedra;019;Fornelos de Montes;1594;766;828;2021
36;Pontevedra;021;Gondomar;14920;7437;7483;2021
36;Pontevedra;022;Grove, O;10699;5249;5450;2021
36;Pontevedra;023;Guarda, A;9991;4896;5095;2021
36;Pontevedra;901;Illa de Arousa, A;4951;2435;2516;2021
36;Pontevedra;024;Lalín;20199;9855;10344;2021
36;Pontevedra;025;Lama, A;2410;1195;1215;2021
36;Pontevedra;026;Marín;24248;12095;12153;2021
36;Pontevedra;027;Meaño;5314;2591;2723;2021
36;Pontevedra;028;Meis;4796;2311;2485;2021
36;Pontevedra;029;Moaña;19496;9469;10027;2021
36;Pontevedra;030;Mondariz;4394;2177;2217;2021
36;Pontevedra;031;Mondariz-Balneario;675;343;332;2021
36;Pontevedra;032;Moraña;4121;1998;2123;2021
36;Pontevedra;033;Mos;15190;7498;7692;2021
36;Pontevedra;034;Neves, As;3770;1850;1920;2021
36;Pontevedra;035;Nigrán;18005;8857;9148;2021
36;Pontevedra;036;Oia;3104;1537;1567;2021
36;Pontevedra;037;Pazos de Borbén;2975;1459;1516;2021
36;Pontevedra;041;Poio;17230;8546;8684;2021
36;Pontevedra;043;Ponte Caldelas;5548;2685;2863;2021
36;Pontevedra;042;Ponteareas;22942;11121;11821;2021
36;Pontevedra;044;Pontecesures;3081;1511;1570;2021
36;Pontevedra;038;Pontevedra;83114;39314;43800;2021
36;Pontevedra;039;Porriño, O;20212;9915;10297;2021
36;Pontevedra;040;Portas;2860;1385;1475;2021
36;Pontevedra;045;Redondela;29192;14150;15042;2021
36;Pontevedra;046;Ribadumia;5157;2516;2641;2021
36;Pontevedra;047;Rodeiro;2361;1192;1169;2021
36;Pontevedra;048;Rosal, O;6376;3139;3237;2021
36;Pontevedra;049;Salceda de Caselas;9249;4635;4614;2021
36;Pontevedra;050;Salvaterra de Miño;10048;5027;5021;2021
36;Pontevedra;051;Sanxenxo;17635;8711;8924;2021
36;Pontevedra;052;Silleda;8845;4296;4549;2021
36;Pontevedra;053;Soutomaior;7482;3733;3749;2021
36;Pontevedra;054;Tomiño;13730;6892;6838;2021
36;Pontevedra;055;Tui;17398;8446;8952;2021
36;Pontevedra;056;Valga;5768;2835;2933;2021
36;Pontevedra;057;Vigo;293837;138634;155203;2021
36;Pontevedra;059;Vila de Cruces;5097;2531;2566;2021
36;Pontevedra;058;Vilaboa;5955;2915;3040;2021
36;Pontevedra;060;Vilagarcía de Arousa;37545;17999;19546;2021
36;Pontevedra;061;Vilanova de Arousa;10306;4996;5310;2021
26;Rioja, La;001;Ábalos;248;144;104;2021
26;Rioja, La;002;Agoncillo;1153;636;517;2021
26;Rioja, La;003;Aguilar del Río Alhama;457;238;219;2021
26;Rioja, La;004;Ajamil de Cameros;67;47;20;2021
26;Rioja, La;005;Albelda de Iregua;3484;1794;1690;2021
26;Rioja, La;006;Alberite;2518;1287;1231;2021
26;Rioja, La;007;Alcanadre;647;339;308;2021
26;Rioja, La;008;Aldeanueva de Ebro;2794;1452;1342;2021
26;Rioja, La;009;Alesanco;500;261;239;2021
26;Rioja, La;010;Alesón;92;52;40;2021
26;Rioja, La;011;Alfaro;9562;4794;4768;2021
26;Rioja, La;012;Almarza de Cameros;36;22;14;2021
26;Rioja, La;013;Anguciana;423;230;193;2021
26;Rioja, La;014;Anguiano;511;279;232;2021
26;Rioja, La;015;Arenzana de Abajo;244;128;116;2021
26;Rioja, La;016;Arenzana de Arriba;28;20;8;2021
26;Rioja, La;017;Arnedillo;452;217;235;2021
26;Rioja, La;018;Arnedo;14954;7476;7478;2021
26;Rioja, La;019;Arrúbal;537;282;255;2021
26;Rioja, La;020;Ausejo;780;414;366;2021
26;Rioja, La;021;Autol;4702;2363;2339;2021
26;Rioja, La;022;Azofra;225;126;99;2021
26;Rioja, La;023;Badarán;502;255;247;2021
26;Rioja, La;024;Bañares;220;116;104;2021
26;Rioja, La;026;Baños de Río Tobía;1583;800;783;2021
26;Rioja, La;025;Baños de Rioja;84;49;35;2021
26;Rioja, La;027;Berceo;146;92;54;2021
26;Rioja, La;028;Bergasa;147;81;66;2021
26;Rioja, La;029;Bergasillas Bajera;34;18;16;2021
26;Rioja, La;030;Bezares;25;12;13;2021
26;Rioja, La;031;Bobadilla;99;51;48;2021
26;Rioja, La;032;Brieva de Cameros;46;30;16;2021
26;Rioja, La;033;Briñas;187;88;99;2021
26;Rioja, La;034;Briones;754;391;363;2021
26;Rioja, La;035;Cabezón de Cameros;19;12;7;2021
26;Rioja, La;036;Calahorra;24579;12055;12524;2021
26;Rioja, La;037;Camprovín;171;89;82;2021
26;Rioja, La;038;Canales de la Sierra;78;51;27;2021
26;Rioja, La;039;Canillas de Río Tuerto;40;22;18;2021
26;Rioja, La;040;Cañas;91;47;44;2021
26;Rioja, La;041;Cárdenas;134;72;62;2021
26;Rioja, La;042;Casalarreina;1090;538;552;2021
26;Rioja, La;043;Castañares de Rioja;407;197;210;2021
26;Rioja, La;044;Castroviejo;45;27;18;2021
26;Rioja, La;045;Cellorigo;10;4;6;2021
26;Rioja, La;046;Cenicero;2106;1084;1022;2021
26;Rioja, La;047;Cervera del Río Alhama;2313;1204;1109;2021
26;Rioja, La;048;Cidamón;24;12;12;2021
26;Rioja, La;049;Cihuri;184;97;87;2021
26;Rioja, La;050;Cirueña;180;114;66;2021
26;Rioja, La;051;Clavijo;291;171;120;2021
26;Rioja, La;052;Cordovín;158;80;78;2021
26;Rioja, La;053;Corera;262;139;123;2021
26;Rioja, La;054;Cornago;322;190;132;2021
26;Rioja, La;055;Corporales;38;24;14;2021
26;Rioja, La;056;Cuzcurrita de Río Tirón;522;274;248;2021
26;Rioja, La;057;Daroca de Rioja;62;40;22;2021
26;Rioja, La;058;Enciso;174;112;62;2021
26;Rioja, La;059;Entrena;1613;848;765;2021
26;Rioja, La;060;Estollo;84;52;32;2021
26;Rioja, La;061;Ezcaray;2076;1092;984;2021
26;Rioja, La;062;Foncea;98;58;40;2021
26;Rioja, La;063;Fonzaleche;146;95;51;2021
26;Rioja, La;064;Fuenmayor;3191;1618;1573;2021
26;Rioja, La;065;Galbárruli;78;48;30;2021
26;Rioja, La;066;Galilea;385;200;185;2021
26;Rioja, La;067;Gallinero de Cameros;19;12;7;2021
26;Rioja, La;068;Gimileo;113;59;54;2021
26;Rioja, La;069;Grañón;249;138;111;2021
26;Rioja, La;070;Grávalos;182;98;84;2021
26;Rioja, La;071;Haro;11633;5743;5890;2021
26;Rioja, La;072;Herce;332;171;161;2021
26;Rioja, La;073;Herramélluri;102;56;46;2021
26;Rioja, La;074;Hervías;117;60;57;2021
26;Rioja, La;075;Hormilla;429;229;200;2021
26;Rioja, La;076;Hormilleja;141;70;71;2021
26;Rioja, La;077;Hornillos de Cameros;22;14;8;2021
26;Rioja, La;078;Hornos de Moncalvillo;96;58;38;2021
26;Rioja, La;079;Huércanos;866;482;384;2021
26;Rioja, La;080;Igea;631;359;272;2021
26;Rioja, La;081;Jalón de Cameros;19;9;10;2021
26;Rioja, La;082;Laguna de Cameros;110;66;44;2021
26;Rioja, La;083;Lagunilla del Jubera;333;182;151;2021
26;Rioja, La;084;Lardero;11042;5543;5499;2021
26;Rioja, La;086;Ledesma de la Cogolla;18;13;5;2021
26;Rioja, La;087;Leiva;237;117;120;2021
26;Rioja, La;088;Leza de Río Leza;42;23;19;2021
26;Rioja, La;089;Logroño;150808;71462;79346;2021
26;Rioja, La;091;Lumbreras de Cameros;150;102;48;2021
26;Rioja, La;092;Manjarrés;117;71;46;2021
26;Rioja, La;093;Mansilla de la Sierra;54;39;15;2021
26;Rioja, La;094;Manzanares de Rioja;60;37;23;2021
26;Rioja, La;095;Matute;97;55;42;2021
26;Rioja, La;096;Medrano;341;180;161;2021
26;Rioja, La;098;Munilla;108;62;46;2021
26;Rioja, La;099;Murillo de Río Leza;1617;825;792;2021
26;Rioja, La;100;Muro de Aguas;67;41;26;2021
26;Rioja, La;101;Muro en Cameros;35;19;16;2021
26;Rioja, La;102;Nájera;8060;3964;4096;2021
26;Rioja, La;103;Nalda;1127;617;510;2021
26;Rioja, La;104;Navajún;10;8;2;2021
26;Rioja, La;105;Navarrete;2996;1505;1491;2021
26;Rioja, La;106;Nestares;86;48;38;2021
26;Rioja, La;107;Nieva de Cameros;89;60;29;2021
26;Rioja, La;109;Ochánduri;79;47;32;2021
26;Rioja, La;108;Ocón;332;200;132;2021
26;Rioja, La;110;Ojacastro;182;110;72;2021
26;Rioja, La;111;Ollauri;310;165;145;2021
26;Rioja, La;112;Ortigosa de Cameros;224;135;89;2021
26;Rioja, La;113;Pazuengos;26;21;5;2021
26;Rioja, La;114;Pedroso;83;53;30;2021
26;Rioja, La;115;Pinillos;20;10;10;2021
26;Rioja, La;117;Pradejón;3928;2034;1894;2021
26;Rioja, La;118;Pradillo;64;35;29;2021
26;Rioja, La;119;Préjano;207;114;93;2021
26;Rioja, La;120;Quel;2074;1103;971;2021
26;Rioja, La;121;Rabanera;32;22;10;2021
26;Rioja, La;122;Rasillo de Cameros, El;136;75;61;2021
26;Rioja, La;123;Redal, El;148;85;63;2021
26;Rioja, La;124;Ribafrecha;1009;521;488;2021
26;Rioja, La;125;Rincón de Soto;3900;2005;1895;2021
26;Rioja, La;126;Robres del Castillo;26;16;10;2021
26;Rioja, La;127;Rodezno;212;118;94;2021
26;Rioja, La;128;Sajazarra;129;70;59;2021
26;Rioja, La;129;San Asensio;1111;590;521;2021
26;Rioja, La;130;San Millán de la Cogolla;224;146;78;2021
26;Rioja, La;131;San Millán de Yécora;34;24;10;2021
26;Rioja, La;132;San Román de Cameros;131;83;48;2021
26;Rioja, La;139;San Torcuato;68;36;32;2021
26;Rioja, La;142;San Vicente de la Sonsierra;1015;533;482;2021
26;Rioja, La;134;Santa Coloma;97;60;37;2021
26;Rioja, La;135;Santa Engracia del Jubera;174;108;66;2021
26;Rioja, La;136;Santa Eulalia Bajera;108;62;46;2021
26;Rioja, La;138;Santo Domingo de la Calzada;6222;3118;3104;2021
26;Rioja, La;140;Santurde de Rioja;278;152;126;2021
26;Rioja, La;141;Santurdejo;99;63;36;2021
26;Rioja, La;143;Sojuela;465;256;209;2021
26;Rioja, La;144;Sorzano;230;125;105;2021
26;Rioja, La;145;Sotés;276;154;122;2021
26;Rioja, La;146;Soto en Cameros;84;48;36;2021
26;Rioja, La;147;Terroba;37;19;18;2021
26;Rioja, La;148;Tirgo;183;91;92;2021
26;Rioja, La;149;Tobía;49;26;23;2021
26;Rioja, La;150;Tormantos;116;64;52;2021
26;Rioja, La;153;Torre en Cameros;10;8;2;2021
26;Rioja, La;151;Torrecilla en Cameros;454;251;203;2021
26;Rioja, La;152;Torrecilla sobre Alesanco;35;22;13;2021
26;Rioja, La;154;Torremontalbo;11;8;3;2021
26;Rioja, La;155;Treviana;145;76;69;2021
26;Rioja, La;157;Tricio;360;176;184;2021
26;Rioja, La;158;Tudelilla;334;182;152;2021
26;Rioja, La;160;Uruñuela;975;492;483;2021
26;Rioja, La;161;Valdemadera;10;6;4;2021
26;Rioja, La;162;Valgañón;137;80;57;2021
26;Rioja, La;163;Ventosa;214;108;106;2021
26;Rioja, La;164;Ventrosa;55;34;21;2021
26;Rioja, La;165;Viguera;397;229;168;2021
26;Rioja, La;166;Villalba de Rioja;163;97;66;2021
26;Rioja, La;167;Villalobar de Rioja;69;49;20;2021
26;Rioja, La;168;Villamediana de Iregua;8608;4346;4262;2021
26;Rioja, La;169;Villanueva de Cameros;73;43;30;2021
26;Rioja, La;170;Villar de Arnedo, El;590;310;280;2021
26;Rioja, La;171;Villar de Torre;163;100;63;2021
26;Rioja, La;172;Villarejo;34;24;10;2021
26;Rioja, La;173;Villarroya;5;3;2;2021
26;Rioja, La;174;Villarta-Quintana;136;79;57;2021
26;Rioja, La;175;Villavelayo;39;26;13;2021
26;Rioja, La;176;Villaverde de Rioja;59;34;25;2021
26;Rioja, La;177;Villoslada de Cameros;354;228;126;2021
26;Rioja, La;178;Viniegra de Abajo;81;50;31;2021
26;Rioja, La;179;Viniegra de Arriba;37;25;12;2021
26;Rioja, La;180;Zarratón;256;139;117;2021
26;Rioja, La;181;Zarzosa;13;9;4;2021
26;Rioja, La;183;Zorraquín;90;45;45;2021
37;Salamanca;001;Abusejo;166;87;79;2021
37;Salamanca;002;Agallas;128;65;63;2021
37;Salamanca;003;Ahigal de los Aceiteros;114;62;52;2021
37;Salamanca;004;Ahigal de Villarino;24;14;10;2021
37;Salamanca;005;Alameda de Gardón, La;67;36;31;2021
37;Salamanca;006;Alamedilla, La;121;62;59;2021
37;Salamanca;007;Alaraz;429;226;203;2021
37;Salamanca;008;Alba de Tormes;5159;2586;2573;2021
37;Salamanca;009;Alba de Yeltes;216;120;96;2021
37;Salamanca;010;Alberca, La;1065;523;542;2021
37;Salamanca;011;Alberguería de Argañán, La;107;55;52;2021
37;Salamanca;012;Alconada;144;77;67;2021
37;Salamanca;015;Aldea del Obispo;252;136;116;2021
37;Salamanca;013;Aldeacipreste;100;53;47;2021
37;Salamanca;014;Aldeadávila de la Ribera;1181;584;597;2021
37;Salamanca;016;Aldealengua;673;336;337;2021
37;Salamanca;017;Aldeanueva de Figueroa;244;131;113;2021
37;Salamanca;018;Aldeanueva de la Sierra;110;69;41;2021
37;Salamanca;019;Aldearrodrigo;147;79;68;2021
37;Salamanca;020;Aldearrubia;519;285;234;2021
37;Salamanca;021;Aldeaseca de Alba;73;40;33;2021
37;Salamanca;022;Aldeaseca de la Frontera;253;132;121;2021
37;Salamanca;023;Aldeatejada;2307;1165;1142;2021
37;Salamanca;024;Aldeavieja de Tormes;100;55;45;2021
37;Salamanca;025;Aldehuela de la Bóveda;279;151;128;2021
37;Salamanca;026;Aldehuela de Yeltes;193;103;90;2021
37;Salamanca;027;Almenara de Tormes;289;157;132;2021
37;Salamanca;028;Almendra;140;80;60;2021
37;Salamanca;029;Anaya de Alba;188;115;73;2021
37;Salamanca;030;Añover de Tormes;91;47;44;2021
37;Salamanca;031;Arabayona de Mógica;339;192;147;2021
37;Salamanca;032;Arapiles;669;363;306;2021
37;Salamanca;033;Arcediano;96;49;47;2021
37;Salamanca;034;Arco, El;93;47;46;2021
37;Salamanca;035;Armenteros;192;114;78;2021
37;Salamanca;037;Atalaya, La;108;60;48;2021
37;Salamanca;038;Babilafuente;932;488;444;2021
37;Salamanca;039;Bañobárez;287;145;142;2021
37;Salamanca;040;Barbadillo;402;217;185;2021
37;Salamanca;041;Barbalos;74;42;32;2021
37;Salamanca;042;Barceo;44;26;18;2021
37;Salamanca;044;Barruecopardo;443;247;196;2021
37;Salamanca;045;Bastida, La;32;18;14;2021
37;Salamanca;046;Béjar;12269;5811;6458;2021
37;Salamanca;047;Beleña;227;120;107;2021
37;Salamanca;049;Bermellar;133;68;65;2021
37;Salamanca;050;Berrocal de Huebra;79;44;35;2021
37;Salamanca;051;Berrocal de Salvatierra;83;45;38;2021
37;Salamanca;052;Boada;299;151;148;2021
37;Salamanca;054;Bodón, El;256;140;116;2021
37;Salamanca;055;Bogajo;134;72;62;2021
37;Salamanca;056;Bouza, La;55;24;31;2021
37;Salamanca;057;Bóveda del Río Almar;221;122;99;2021
37;Salamanca;058;Brincones;53;28;25;2021
37;Salamanca;059;Buenamadre;119;60;59;2021
37;Salamanca;060;Buenavista;365;196;169;2021
37;Salamanca;061;Cabaco, El;223;119;104;2021
37;Salamanca;063;Cabeza de Béjar, La;60;39;21;2021
37;Salamanca;065;Cabeza del Caballo;257;141;116;2021
37;Salamanca;062;Cabezabellosa de la Calzada;75;44;31;2021
37;Salamanca;067;Cabrerizos;4284;2132;2152;2021
37;Salamanca;068;Cabrillas;355;180;175;2021
37;Salamanca;069;Calvarrasa de Abajo;1169;620;549;2021
37;Salamanca;070;Calvarrasa de Arriba;594;318;276;2021
37;Salamanca;071;Calzada de Béjar, La;91;51;40;2021
37;Salamanca;072;Calzada de Don Diego;148;81;67;2021
37;Salamanca;073;Calzada de Valdunciel;698;349;349;2021
37;Salamanca;074;Campillo de Azaba;155;91;64;2021
37;Salamanca;077;Campo de Peñaranda, El;249;147;102;2021
37;Salamanca;078;Candelario;874;449;425;2021
37;Salamanca;079;Canillas de Abajo;80;56;24;2021
37;Salamanca;080;Cantagallo;267;140;127;2021
37;Salamanca;081;Cantalapiedra;923;475;448;2021
37;Salamanca;082;Cantalpino;821;443;378;2021
37;Salamanca;083;Cantaracillo;197;106;91;2021
37;Salamanca;085;Carbajosa de la Sagrada;7368;3673;3695;2021
37;Salamanca;086;Carpio de Azaba;116;65;51;2021
37;Salamanca;087;Carrascal de Barregas;1295;666;629;2021
37;Salamanca;088;Carrascal del Obispo;194;106;88;2021
37;Salamanca;089;Casafranca;61;31;30;2021
37;Salamanca;090;Casas del Conde, Las;64;29;35;2021
37;Salamanca;091;Casillas de Flores;191;93;98;2021
37;Salamanca;092;Castellanos de Moriscos;2809;1453;1356;2021
37;Salamanca;185;Castellanos de Villiquera;653;358;295;2021
37;Salamanca;096;Castillejo de Martín Viejo;211;126;85;2021
37;Salamanca;097;Castraz;38;24;14;2021
37;Salamanca;098;Cepeda;293;149;144;2021
37;Salamanca;099;Cereceda de la Sierra;67;33;34;2021
37;Salamanca;100;Cerezal de Peñahorcada;64;31;33;2021
37;Salamanca;101;Cerralbo;131;71;60;2021
37;Salamanca;102;Cerro, El;397;205;192;2021
37;Salamanca;103;Cespedosa de Tormes;518;276;242;2021
37;Salamanca;114;Chagarcía Medianero;64;34;30;2021
37;Salamanca;104;Cilleros de la Bastida;21;10;11;2021
37;Salamanca;106;Cipérez;255;132;123;2021
37;Salamanca;107;Ciudad Rodrigo;12065;5797;6268;2021
37;Salamanca;108;Coca de Alba;106;53;53;2021
37;Salamanca;109;Colmenar de Montemayor;177;101;76;2021
37;Salamanca;110;Cordovilla;112;60;52;2021
37;Salamanca;112;Cristóbal;159;92;67;2021
37;Salamanca;113;Cubo de Don Sancho, El;427;221;206;2021
37;Salamanca;115;Dios le Guarde;117;63;54;2021
37;Salamanca;116;Doñinos de Ledesma;63;32;31;2021
37;Salamanca;117;Doñinos de Salamanca;2214;1152;1062;2021
37;Salamanca;118;Éjeme;129;75;54;2021
37;Salamanca;120;Encina de San Silvestre;114;56;58;2021
37;Salamanca;119;Encina, La;104;62;42;2021
37;Salamanca;121;Encinas de Abajo;617;323;294;2021
37;Salamanca;122;Encinas de Arriba;240;121;119;2021
37;Salamanca;123;Encinasola de los Comendadores;157;88;69;2021
37;Salamanca;124;Endrinal;210;119;91;2021
37;Salamanca;125;Escurial de la Sierra;241;134;107;2021
37;Salamanca;126;Espadaña;38;24;14;2021
37;Salamanca;127;Espeja;220;117;103;2021
37;Salamanca;128;Espino de la Orbada;252;142;110;2021
37;Salamanca;129;Florida de Liébana;254;138;116;2021
37;Salamanca;130;Forfoleda;198;113;85;2021
37;Salamanca;131;Frades de la Sierra;182;102;80;2021
37;Salamanca;132;Fregeneda, La;315;153;162;2021
37;Salamanca;133;Fresnedoso;101;58;43;2021
37;Salamanca;134;Fresno Alhándiga;196;107;89;2021
37;Salamanca;135;Fuente de San Esteban, La;1270;646;624;2021
37;Salamanca;136;Fuenteguinaldo;674;327;347;2021
37;Salamanca;137;Fuenteliante;97;48;49;2021
37;Salamanca;138;Fuenterroble de Salvatierra;264;134;130;2021
37;Salamanca;139;Fuentes de Béjar;216;107;109;2021
37;Salamanca;140;Fuentes de Oñoro;1119;606;513;2021
37;Salamanca;141;Gajates;152;70;82;2021
37;Salamanca;142;Galindo y Perahuy;645;371;274;2021
37;Salamanca;143;Galinduste;414;202;212;2021
37;Salamanca;144;Galisancho;353;195;158;2021
37;Salamanca;145;Gallegos de Argañán;268;134;134;2021
37;Salamanca;146;Gallegos de Solmirón;115;67;48;2021
37;Salamanca;147;Garcibuey;189;107;82;2021
37;Salamanca;148;Garcihernández;427;223;204;2021
37;Salamanca;149;Garcirrey;58;34;24;2021
37;Salamanca;150;Gejuelo del Barro;34;20;14;2021
37;Salamanca;151;Golpejas;146;75;71;2021
37;Salamanca;152;Gomecello;432;226;206;2021
37;Salamanca;154;Guadramiro;133;82;51;2021
37;Salamanca;155;Guijo de Ávila;71;41;30;2021
37;Salamanca;156;Guijuelo;5550;2776;2774;2021
37;Salamanca;157;Herguijuela de Ciudad Rodrigo;68;41;27;2021
37;Salamanca;158;Herguijuela de la Sierra;241;135;106;2021
37;Salamanca;159;Herguijuela del Campo;69;37;32;2021
37;Salamanca;160;Hinojosa de Duero;616;312;304;2021
37;Salamanca;161;Horcajo de Montemayor;133;71;62;2021
37;Salamanca;162;Horcajo Medianero;223;116;107;2021
37;Salamanca;163;Hoya, La;29;18;11;2021
37;Salamanca;164;Huerta;287;159;128;2021
37;Salamanca;165;Iruelos;31;13;18;2021
37;Salamanca;166;Ituero de Azaba;204;105;99;2021
37;Salamanca;167;Juzbado;199;100;99;2021
37;Salamanca;168;Lagunilla;447;244;203;2021
37;Salamanca;169;Larrodrigo;185;107;78;2021
37;Salamanca;170;Ledesma;1553;757;796;2021
37;Salamanca;171;Ledrada;466;240;226;2021
37;Salamanca;172;Linares de Riofrío;938;518;420;2021
37;Salamanca;173;Lumbrales;1550;780;770;2021
37;Salamanca;175;Machacón;446;231;215;2021
37;Salamanca;174;Macotera;1001;511;490;2021
37;Salamanca;176;Madroñal;136;76;60;2021
37;Salamanca;177;Maíllo, El;271;154;117;2021
37;Salamanca;178;Malpartida;96;51;45;2021
37;Salamanca;179;Mancera de Abajo;212;109;103;2021
37;Salamanca;180;Manzano, El;65;34;31;2021
37;Salamanca;181;Martiago;254;139;115;2021
37;Salamanca;183;Martín de Yeltes;408;212;196;2021
37;Salamanca;182;Martinamor;81;53;28;2021
37;Salamanca;184;Masueco;274;143;131;2021
37;Salamanca;186;Mata de Ledesma, La;85;48;37;2021
37;Salamanca;187;Matilla de los Caños del Río;639;316;323;2021
37;Salamanca;188;Maya, La;167;97;70;2021
37;Salamanca;189;Membribe de la Sierra;111;66;45;2021
37;Salamanca;190;Mieza;189;98;91;2021
37;Salamanca;191;Milano, El;99;60;39;2021
37;Salamanca;192;Miranda de Azán;449;240;209;2021
37;Salamanca;193;Miranda del Castañar;382;205;177;2021
37;Salamanca;194;Mogarraz;260;134;126;2021
37;Salamanca;195;Molinillo;42;25;17;2021
37;Salamanca;196;Monforte de la Sierra;61;31;30;2021
37;Salamanca;197;Monleón;96;55;41;2021
37;Salamanca;198;Monleras;226;110;116;2021
37;Salamanca;199;Monsagro;135;74;61;2021
37;Salamanca;200;Montejo;207;118;89;2021
37;Salamanca;201;Montemayor del Río;267;141;126;2021
37;Salamanca;202;Monterrubio de Armuña;1319;686;633;2021
37;Salamanca;203;Monterrubio de la Sierra;154;86;68;2021
37;Salamanca;204;Morasverdes;245;125;120;2021
37;Salamanca;205;Morille;227;125;102;2021
37;Salamanca;206;Moríñigo;96;52;44;2021
37;Salamanca;207;Moriscos;487;264;223;2021
37;Salamanca;208;Moronta;75;48;27;2021
37;Salamanca;209;Mozárbez;507;270;237;2021
37;Salamanca;211;Narros de Matalayegua;210;117;93;2021
37;Salamanca;213;Nava de Béjar;86;51;35;2021
37;Salamanca;214;Nava de Francia;118;61;57;2021
37;Salamanca;215;Nava de Sotrobal;163;95;68;2021
37;Salamanca;212;Navacarros;121;64;57;2021
37;Salamanca;216;Navales;317;169;148;2021
37;Salamanca;217;Navalmoral de Béjar;58;27;31;2021
37;Salamanca;218;Navamorales;47;27;20;2021
37;Salamanca;219;Navarredonda de la Rinconada;165;83;82;2021
37;Salamanca;221;Navasfrías;408;219;189;2021
37;Salamanca;222;Negrilla de Palencia;81;46;35;2021
37;Salamanca;223;Olmedo de Camaces;103;54;49;2021
37;Salamanca;224;Orbada, La;190;102;88;2021
37;Salamanca;225;Pajares de la Laguna;104;57;47;2021
37;Salamanca;226;Palacios del Arzobispo;175;86;89;2021
37;Salamanca;228;Palaciosrubios;329;175;154;2021
37;Salamanca;229;Palencia de Negrilla;151;92;59;2021
37;Salamanca;230;Parada de Arriba;255;130;125;2021
37;Salamanca;231;Parada de Rubiales;257;139;118;2021
37;Salamanca;232;Paradinas de San Juan;388;228;160;2021
37;Salamanca;233;Pastores;51;31;20;2021
37;Salamanca;234;Payo, El;313;152;161;2021
37;Salamanca;235;Pedraza de Alba;222;117;105;2021
37;Salamanca;236;Pedrosillo de Alba;125;74;51;2021
37;Salamanca;237;Pedrosillo de los Aires;323;182;141;2021
37;Salamanca;238;Pedrosillo el Ralo;122;64;58;2021
37;Salamanca;239;Pedroso de la Armuña, El;217;112;105;2021
37;Salamanca;240;Pelabravo;1225;653;572;2021
37;Salamanca;241;Pelarrodríguez;173;102;71;2021
37;Salamanca;242;Pelayos;80;48;32;2021
37;Salamanca;243;Peña, La;87;47;40;2021
37;Salamanca;244;Peñacaballera;138;68;70;2021
37;Salamanca;245;Peñaparda;339;169;170;2021
37;Salamanca;246;Peñaranda de Bracamonte;6123;3012;3111;2021
37;Salamanca;247;Peñarandilla;175;95;80;2021
37;Salamanca;248;Peralejos de Abajo;170;90;80;2021
37;Salamanca;249;Peralejos de Arriba;37;25;12;2021
37;Salamanca;250;Pereña de la Ribera;327;178;149;2021
37;Salamanca;251;Peromingo;125;58;67;2021
37;Salamanca;252;Pinedas;104;61;43;2021
37;Salamanca;253;Pino de Tormes, El;158;85;73;2021
37;Salamanca;254;Pitiegua;186;102;84;2021
37;Salamanca;255;Pizarral;54;34;20;2021
37;Salamanca;256;Poveda de las Cintas;203;115;88;2021
37;Salamanca;257;Pozos de Hinojo;53;28;25;2021
37;Salamanca;258;Puebla de Azaba;140;79;61;2021
37;Salamanca;259;Puebla de San Medel;37;22;15;2021
37;Salamanca;260;Puebla de Yeltes;147;78;69;2021
37;Salamanca;261;Puente del Congosto;218;125;93;2021
37;Salamanca;262;Puertas;73;42;31;2021
37;Salamanca;263;Puerto de Béjar;370;177;193;2021
37;Salamanca;264;Puerto Seguro;58;28;30;2021
37;Salamanca;265;Rágama;210;106;104;2021
37;Salamanca;266;Redonda, La;66;39;27;2021
37;Salamanca;267;Retortillo;182;98;84;2021
37;Salamanca;268;Rinconada de la Sierra, La;104;61;43;2021
37;Salamanca;269;Robleda;470;261;209;2021
37;Salamanca;270;Robliza de Cojos;198;103;95;2021
37;Salamanca;271;Rollán;352;190;162;2021
37;Salamanca;272;Saelices el Chico;159;90;69;2021
37;Salamanca;273;Sagrada, La;89;50;39;2021
37;Salamanca;303;Sahugo, El;186;101;85;2021
37;Salamanca;274;Salamanca;143269;64867;78402;2021
37;Salamanca;275;Saldeana;98;56;42;2021
37;Salamanca;276;Salmoral;124;71;53;2021
37;Salamanca;277;Salvatierra de Tormes;76;39;37;2021
37;Salamanca;278;San Cristóbal de la Cuesta;1029;537;492;2021
37;Salamanca;284;San Esteban de la Sierra;357;201;156;2021
37;Salamanca;285;San Felices de los Gallegos;367;197;170;2021
37;Salamanca;286;San Martín del Castañar;228;124;104;2021
37;Salamanca;287;San Miguel de Valero;332;171;161;2021
37;Salamanca;036;San Miguel del Robledo;54;31;23;2021
37;Salamanca;288;San Morales;332;179;153;2021
37;Salamanca;289;San Muñoz;209;105;104;2021
37;Salamanca;291;San Pedro de Rozados;276;157;119;2021
37;Salamanca;290;San Pedro del Valle;132;77;55;2021
37;Salamanca;292;San Pelayo de Guareña;96;54;42;2021
37;Salamanca;280;Sanchón de la Ribera;79;42;37;2021
37;Salamanca;281;Sanchón de la Sagrada;38;22;16;2021
37;Salamanca;282;Sanchotello;231;115;116;2021
37;Salamanca;279;Sancti-Spíritus;775;419;356;2021
37;Salamanca;283;Sando;116;67;49;2021
37;Salamanca;293;Santa María de Sando;100;51;49;2021
37;Salamanca;294;Santa Marta de Tormes;14646;7142;7504;2021
37;Salamanca;296;Santiago de la Puebla;297;153;144;2021
37;Salamanca;297;Santibáñez de Béjar;462;230;232;2021
37;Salamanca;298;Santibáñez de la Sierra;178;100;78;2021
37;Salamanca;299;Santiz;253;138;115;2021
37;Salamanca;300;Santos, Los;595;302;293;2021
37;Salamanca;301;Sardón de los Frailes;99;57;42;2021
37;Salamanca;302;Saucelle;275;135;140;2021
37;Salamanca;304;Sepulcro-Hilario;157;87;70;2021
37;Salamanca;305;Sequeros;240;116;124;2021
37;Salamanca;306;Serradilla del Arroyo;248;137;111;2021
37;Salamanca;307;Serradilla del Llano;147;77;70;2021
37;Salamanca;309;Sierpe, La;41;21;20;2021
37;Salamanca;310;Sieteiglesias de Tormes;184;85;99;2021
37;Salamanca;311;Sobradillo;196;99;97;2021
37;Salamanca;312;Sorihuela;258;133;125;2021
37;Salamanca;313;Sotoserrano;553;298;255;2021
37;Salamanca;314;Tabera de Abajo;109;58;51;2021
37;Salamanca;315;Tala, La;80;44;36;2021
37;Salamanca;316;Tamames;783;394;389;2021
37;Salamanca;317;Tarazona de Guareña;288;156;132;2021
37;Salamanca;318;Tardáguila;196;116;80;2021
37;Salamanca;319;Tejado, El;82;44;38;2021
37;Salamanca;320;Tejeda y Segoyuela;90;49;41;2021
37;Salamanca;321;Tenebrón;135;72;63;2021
37;Salamanca;322;Terradillos;3096;1531;1565;2021
37;Salamanca;323;Topas;534;283;251;2021
37;Salamanca;324;Tordillos;328;179;149;2021
37;Salamanca;325;Tornadizo, El;92;52;40;2021
37;Salamanca;327;Torresmenudas;201;106;95;2021
37;Salamanca;328;Trabanca;174;85;89;2021
37;Salamanca;329;Tremedal de Tormes;37;19;18;2021
37;Salamanca;330;Valdecarros;328;168;160;2021
37;Salamanca;331;Valdefuentes de Sangusín;188;107;81;2021
37;Salamanca;332;Valdehijaderos;73;41;32;2021
37;Salamanca;333;Valdelacasa;211;120;91;2021
37;Salamanca;334;Valdelageve;65;35;30;2021
37;Salamanca;335;Valdelosa;404;205;199;2021
37;Salamanca;336;Valdemierque;64;41;23;2021
37;Salamanca;337;Valderrodrigo;136;72;64;2021
37;Salamanca;338;Valdunciel;103;53;50;2021
37;Salamanca;339;Valero;302;171;131;2021
37;Salamanca;343;Vallejera de Riofrío;69;36;33;2021
37;Salamanca;340;Valsalabroso;133;75;58;2021
37;Salamanca;341;Valverde de Valdelacasa;66;34;32;2021
37;Salamanca;342;Valverdón;277;144;133;2021
37;Salamanca;344;Vecinos;239;119;120;2021
37;Salamanca;345;Vega de Tirados;159;86;73;2021
37;Salamanca;346;Veguillas, Las;284;142;142;2021
37;Salamanca;347;Vellés, La;514;282;232;2021
37;Salamanca;348;Ventosa del Río Almar;101;58;43;2021
37;Salamanca;349;Vídola, La;107;52;55;2021
37;Salamanca;351;Villaflores;260;129;131;2021
37;Salamanca;352;Villagonzalo de Tormes;237;140;97;2021
37;Salamanca;353;Villalba de los Llanos;117;68;49;2021
37;Salamanca;354;Villamayor;7371;3699;3672;2021
37;Salamanca;355;Villanueva del Conde;171;87;84;2021
37;Salamanca;356;Villar de Argañán;91;48;43;2021
37;Salamanca;357;Villar de Ciervo;260;137;123;2021
37;Salamanca;358;Villar de Gallimazo;210;141;69;2021
37;Salamanca;359;Villar de la Yegua;162;88;74;2021
37;Salamanca;360;Villar de Peralonso;212;113;99;2021
37;Salamanca;361;Villar de Samaniego;87;49;38;2021
37;Salamanca;362;Villares de la Reina;6491;3211;3280;2021
37;Salamanca;363;Villares de Yeltes;111;51;60;2021
37;Salamanca;364;Villarino de los Aires;789;414;375;2021
37;Salamanca;365;Villarmayor;173;98;75;2021
37;Salamanca;366;Villarmuerto;42;27;15;2021
37;Salamanca;367;Villasbuenas;181;99;82;2021
37;Salamanca;368;Villasdardo;24;8;16;2021
37;Salamanca;369;Villaseco de los Gamitos;134;78;56;2021
37;Salamanca;370;Villaseco de los Reyes;314;184;130;2021
37;Salamanca;371;Villasrubias;251;135;116;2021
37;Salamanca;372;Villaverde de Guareña;139;78;61;2021
37;Salamanca;373;Villavieja de Yeltes;745;384;361;2021
37;Salamanca;374;Villoria;1344;685;659;2021
37;Salamanca;375;Villoruela;761;379;382;2021
37;Salamanca;350;Vilvestre;411;204;207;2021
37;Salamanca;376;Vitigudino;2410;1164;1246;2021
37;Salamanca;377;Yecla de Yeltes;227;118;109;2021
37;Salamanca;378;Zamarra;82;48;34;2021
37;Salamanca;379;Zamayón;198;114;84;2021
37;Salamanca;380;Zarapicos;59;34;25;2021
37;Salamanca;381;Zarza de Pumareda, La;138;84;54;2021
37;Salamanca;382;Zorita de la Frontera;170;83;87;2021
38;Santa Cruz de Tenerife;001;Adeje;48733;24562;24171;2021
38;Santa Cruz de Tenerife;002;Agulo;1099;547;552;2021
38;Santa Cruz de Tenerife;003;Alajeró;2047;1080;967;2021
38;Santa Cruz de Tenerife;004;Arafo;5604;2794;2810;2021
38;Santa Cruz de Tenerife;005;Arico;8234;4235;3999;2021
38;Santa Cruz de Tenerife;006;Arona;82563;41804;40759;2021
38;Santa Cruz de Tenerife;007;Barlovento;1921;970;951;2021
38;Santa Cruz de Tenerife;008;Breña Alta;7196;3509;3687;2021
38;Santa Cruz de Tenerife;009;Breña Baja;5866;2957;2909;2021
38;Santa Cruz de Tenerife;010;Buenavista del Norte;4766;2385;2381;2021
38;Santa Cruz de Tenerife;011;Candelaria;28463;13766;14697;2021
38;Santa Cruz de Tenerife;012;Fasnia;2807;1470;1337;2021
38;Santa Cruz de Tenerife;013;Frontera;4278;2137;2141;2021
38;Santa Cruz de Tenerife;014;Fuencaliente de la Palma;1756;885;871;2021
38;Santa Cruz de Tenerife;015;Garachico;4895;2448;2447;2021
38;Santa Cruz de Tenerife;016;Garafía;1813;944;869;2021
38;Santa Cruz de Tenerife;017;Granadilla de Abona;51850;25952;25898;2021
38;Santa Cruz de Tenerife;018;Guancha, La;5553;2713;2840;2021
38;Santa Cruz de Tenerife;019;Guía de Isora;21827;10809;11018;2021
38;Santa Cruz de Tenerife;020;Güímar;21000;10342;10658;2021
38;Santa Cruz de Tenerife;021;Hermigua;1767;914;853;2021
38;Santa Cruz de Tenerife;022;Icod de los Vinos;23310;11489;11821;2021
38;Santa Cruz de Tenerife;024;Llanos de Aridane, Los;20648;10001;10647;2021
38;Santa Cruz de Tenerife;025;Matanza de Acentejo, La;9114;4577;4537;2021
38;Santa Cruz de Tenerife;026;Orotava, La;42219;20691;21528;2021
38;Santa Cruz de Tenerife;027;Paso, El;7745;3868;3877;2021
38;Santa Cruz de Tenerife;901;Pinar de El Hierro, El;1936;1020;916;2021
38;Santa Cruz de Tenerife;028;Puerto de la Cruz;30179;14681;15498;2021
38;Santa Cruz de Tenerife;029;Puntagorda;2234;1133;1101;2021
38;Santa Cruz de Tenerife;030;Puntallana;2549;1286;1263;2021
38;Santa Cruz de Tenerife;031;Realejos, Los;36824;18051;18773;2021
38;Santa Cruz de Tenerife;032;Rosario, El;17590;8920;8670;2021
38;Santa Cruz de Tenerife;033;San Andrés y Sauces;4213;2101;2112;2021
38;Santa Cruz de Tenerife;023;San Cristóbal de La Laguna;158010;76117;81893;2021
38;Santa Cruz de Tenerife;034;San Juan de la Rambla;4854;2410;2444;2021
38;Santa Cruz de Tenerife;035;San Miguel de Abona;21872;10989;10883;2021
38;Santa Cruz de Tenerife;036;San Sebastián de la Gomera;9261;4644;4617;2021
38;Santa Cruz de Tenerife;037;Santa Cruz de la Palma;15446;7430;8016;2021
38;Santa Cruz de Tenerife;038;Santa Cruz de Tenerife;208563;99438;109125;2021
38;Santa Cruz de Tenerife;039;Santa Úrsula;14987;7452;7535;2021
38;Santa Cruz de Tenerife;040;Santiago del Teide;11115;5515;5600;2021
38;Santa Cruz de Tenerife;041;Sauzal, El;8918;4437;4481;2021
38;Santa Cruz de Tenerife;042;Silos, Los;4692;2347;2345;2021
38;Santa Cruz de Tenerife;043;Tacoronte;24346;12094;12252;2021
38;Santa Cruz de Tenerife;044;Tanque, El;2829;1371;1458;2021
38;Santa Cruz de Tenerife;045;Tazacorte;4558;2342;2216;2021
38;Santa Cruz de Tenerife;046;Tegueste;11326;5595;5731;2021
38;Santa Cruz de Tenerife;047;Tijarafe;2560;1304;1256;2021
38;Santa Cruz de Tenerife;049;Valle Gran Rey;4643;2374;2269;2021
38;Santa Cruz de Tenerife;050;Vallehermoso;2917;1519;1398;2021
38;Santa Cruz de Tenerife;048;Valverde;5084;2552;2532;2021
38;Santa Cruz de Tenerife;051;Victoria de Acentejo, La;9161;4568;4593;2021
38;Santa Cruz de Tenerife;052;Vilaflor de Chasna;1789;907;882;2021
38;Santa Cruz de Tenerife;053;Villa de Mazo;4875;2453;2422;2021
40;Segovia;001;Abades;835;417;418;2021
40;Segovia;002;Adrada de Pirón;39;20;19;2021
40;Segovia;003;Adrados;125;74;51;2021
40;Segovia;004;Aguilafuente;557;278;279;2021
40;Segovia;005;Alconada de Maderuelo;22;14;8;2021
40;Segovia;012;Aldea Real;281;151;130;2021
40;Segovia;006;Aldealcorvo;19;10;9;2021
40;Segovia;007;Aldealengua de Pedraza;80;48;32;2021
40;Segovia;008;Aldealengua de Santa María;61;31;30;2021
40;Segovia;009;Aldeanueva de la Serrezuela;42;30;12;2021
40;Segovia;010;Aldeanueva del Codonal;116;63;53;2021
40;Segovia;013;Aldeasoña;62;38;24;2021
40;Segovia;014;Aldehorno;52;33;19;2021
40;Segovia;015;Aldehuela del Codonal;24;14;10;2021
40;Segovia;016;Aldeonte;56;32;24;2021
40;Segovia;017;Anaya;122;60;62;2021
40;Segovia;018;Añe;68;40;28;2021
40;Segovia;019;Arahuetes;28;23;5;2021
40;Segovia;020;Arcones;171;86;85;2021
40;Segovia;021;Arevalillo de Cega;17;11;6;2021
40;Segovia;022;Armuña;246;143;103;2021
40;Segovia;024;Ayllón;1153;592;561;2021
40;Segovia;025;Barbolla;139;77;62;2021
40;Segovia;026;Basardilla;168;77;91;2021
40;Segovia;028;Bercial;104;55;49;2021
40;Segovia;029;Bercimuel;20;12;8;2021
40;Segovia;030;Bernardos;486;274;212;2021
40;Segovia;031;Bernuy de Porreros;788;412;376;2021
40;Segovia;032;Boceguillas;701;362;339;2021
40;Segovia;033;Brieva;94;53;41;2021
40;Segovia;034;Caballar;76;44;32;2021
40;Segovia;035;Cabañas de Polendos;184;96;88;2021
40;Segovia;036;Cabezuela;640;332;308;2021
40;Segovia;037;Calabazas de Fuentidueña;27;17;10;2021
40;Segovia;039;Campo de San Pedro;250;137;113;2021
40;Segovia;040;Cantalejo;3522;1742;1780;2021
40;Segovia;041;Cantimpalos;1346;716;630;2021
40;Segovia;161;Carabias;50;36;14;2021
40;Segovia;043;Carbonero el Mayor;2502;1283;1219;2021
40;Segovia;044;Carrascal del Río;150;82;68;2021
40;Segovia;045;Casla;159;82;77;2021
40;Segovia;046;Castillejo de Mesleón;120;65;55;2021
40;Segovia;047;Castro de Fuentidueña;47;29;18;2021
40;Segovia;048;Castrojimeno;32;17;15;2021
40;Segovia;049;Castroserna de Abajo;33;17;16;2021
40;Segovia;051;Castroserracín;45;23;22;2021
40;Segovia;052;Cedillo de la Torre;89;47;42;2021
40;Segovia;053;Cerezo de Abajo;115;62;53;2021
40;Segovia;054;Cerezo de Arriba;134;73;61;2021
40;Segovia;065;Chañe;708;361;347;2021
40;Segovia;055;Cilleruelo de San Mamés;34;23;11;2021
40;Segovia;056;Cobos de Fuentidueña;34;15;19;2021
40;Segovia;057;Coca;1726;867;859;2021
40;Segovia;058;Codorniz;322;162;160;2021
40;Segovia;059;Collado Hermoso;129;66;63;2021
40;Segovia;060;Condado de Castilnovo;85;46;39;2021
40;Segovia;061;Corral de Ayllón;71;41;30;2021
40;Segovia;902;Cozuelos de Fuentidueña;120;63;57;2021
40;Segovia;062;Cubillo;76;48;28;2021
40;Segovia;063;Cuéllar;9620;4856;4764;2021
40;Segovia;905;Cuevas de Provanco;127;73;54;2021
40;Segovia;068;Domingo García;32;19;13;2021
40;Segovia;069;Donhierro;85;47;38;2021
40;Segovia;070;Duruelo;190;110;80;2021
40;Segovia;071;Encinas;40;21;19;2021
40;Segovia;072;Encinillas;319;178;141;2021
40;Segovia;073;Escalona del Prado;498;261;237;2021
40;Segovia;074;Escarabajosa de Cabezas;289;154;135;2021
40;Segovia;075;Escobar de Polendos;168;93;75;2021
40;Segovia;076;Espinar, El;9476;4797;4679;2021
40;Segovia;077;Espirdo;1452;767;685;2021
40;Segovia;078;Fresneda de Cuéllar;166;100;66;2021
40;Segovia;079;Fresno de Cantespino;313;179;134;2021
40;Segovia;080;Fresno de la Fuente;78;40;38;2021
40;Segovia;081;Frumales;111;60;51;2021
40;Segovia;082;Fuente de Santa Cruz;108;57;51;2021
40;Segovia;083;Fuente el Olmo de Fuentidueña;135;68;67;2021
40;Segovia;084;Fuente el Olmo de Íscar;49;28;21;2021
40;Segovia;086;Fuentepelayo;804;429;375;2021
40;Segovia;087;Fuentepiñel;81;48;33;2021
40;Segovia;088;Fuenterrebollo;332;176;156;2021
40;Segovia;089;Fuentesaúco de Fuentidueña;234;124;110;2021
40;Segovia;091;Fuentesoto;108;63;45;2021
40;Segovia;092;Fuentidueña;132;78;54;2021
40;Segovia;093;Gallegos;99;57;42;2021
40;Segovia;094;Garcillán;512;268;244;2021
40;Segovia;095;Gomezserracín;660;348;312;2021
40;Segovia;097;Grajera;245;145;100;2021
40;Segovia;099;Honrubia de la Cuesta;54;32;22;2021
40;Segovia;100;Hontalbilla;292;163;129;2021
40;Segovia;101;Hontanares de Eresma;1502;786;716;2021
40;Segovia;103;Huertos, Los;171;95;76;2021
40;Segovia;104;Ituero y Lama;397;204;193;2021
40;Segovia;105;Juarros de Riomoros;46;27;19;2021
40;Segovia;106;Juarros de Voltoya;188;97;91;2021
40;Segovia;107;Labajos;102;59;43;2021
40;Segovia;108;Laguna de Contreras;106;64;42;2021
40;Segovia;109;Languilla;70;41;29;2021
40;Segovia;110;Lastras de Cuéllar;335;179;156;2021
40;Segovia;111;Lastras del Pozo;55;30;25;2021
40;Segovia;112;Lastrilla, La;4186;2138;2048;2021
40;Segovia;113;Losa, La;521;292;229;2021
40;Segovia;115;Maderuelo;125;71;54;2021
40;Segovia;903;Marazoleja;103;68;35;2021
40;Segovia;118;Marazuela;52;32;20;2021
40;Segovia;119;Martín Miguel;230;138;92;2021
40;Segovia;120;Martín Muñoz de la Dehesa;244;128;116;2021
40;Segovia;121;Martín Muñoz de las Posadas;277;152;125;2021
40;Segovia;122;Marugán;714;393;321;2021
40;Segovia;124;Mata de Cuéllar;259;135;124;2021
40;Segovia;123;Matabuena;183;103;80;2021
40;Segovia;125;Matilla, La;80;47;33;2021
40;Segovia;126;Melque de Cercos;59;32;27;2021
40;Segovia;127;Membibre de la Hoz;35;18;17;2021
40;Segovia;128;Migueláñez;129;68;61;2021
40;Segovia;129;Montejo de Arévalo;174;93;81;2021
40;Segovia;130;Montejo de la Vega de la Serrezuela;141;81;60;2021
40;Segovia;131;Monterrubio;60;32;28;2021
40;Segovia;132;Moral de Hornuez;47;28;19;2021
40;Segovia;134;Mozoncillo;851;466;385;2021
40;Segovia;135;Muñopedro;315;166;149;2021
40;Segovia;136;Muñoveros;141;69;72;2021
40;Segovia;138;Nava de la Asunción;2748;1400;1348;2021
40;Segovia;139;Navafría;299;163;136;2021
40;Segovia;140;Navalilla;94;49;45;2021
40;Segovia;141;Navalmanzano;1048;547;501;2021
40;Segovia;142;Navares de Ayuso;52;26;26;2021
40;Segovia;143;Navares de Enmedio;92;55;37;2021
40;Segovia;144;Navares de las Cuevas;22;15;7;2021
40;Segovia;145;Navas de Oro;1304;666;638;2021
40;Segovia;904;Navas de Riofrío;367;178;189;2021
40;Segovia;146;Navas de San Antonio;366;197;169;2021
40;Segovia;148;Nieva;260;127;133;2021
40;Segovia;149;Olombrada;519;285;234;2021
40;Segovia;150;Orejana;66;39;27;2021
40;Segovia;151;Ortigosa de Pestaño;46;23;23;2021
40;Segovia;901;Ortigosa del Monte;580;300;280;2021
40;Segovia;152;Otero de Herreros;957;483;474;2021
40;Segovia;154;Pajarejos;21;11;10;2021
40;Segovia;155;Palazuelos de Eresma;5597;2921;2676;2021
40;Segovia;156;Pedraza;342;194;148;2021
40;Segovia;157;Pelayos del Arroyo;52;30;22;2021
40;Segovia;158;Perosillo;15;12;3;2021
40;Segovia;159;Pinarejos;175;100;75;2021
40;Segovia;160;Pinarnegrillo;100;57;43;2021
40;Segovia;162;Prádena;508;268;240;2021
40;Segovia;163;Puebla de Pedraza;43;23;20;2021
40;Segovia;164;Rapariegos;202;101;101;2021
40;Segovia;181;Real Sitio de San Ildefonso;5237;2560;2677;2021
40;Segovia;165;Rebollo;73;38;35;2021
40;Segovia;166;Remondo;308;155;153;2021
40;Segovia;168;Riaguas de San Bartolomé;26;18;8;2021
40;Segovia;170;Riaza;2135;1135;1000;2021
40;Segovia;171;Ribota;45;35;10;2021
40;Segovia;172;Riofrío de Riaza;34;21;13;2021
40;Segovia;173;Roda de Eresma;201;109;92;2021
40;Segovia;174;Sacramenia;373;181;192;2021
40;Segovia;176;Samboal;448;240;208;2021
40;Segovia;177;San Cristóbal de Cuéllar;147;80;67;2021
40;Segovia;178;San Cristóbal de la Vega;88;49;39;2021
40;Segovia;906;San Cristóbal de Segovia;3102;1543;1559;2021
40;Segovia;182;San Martín y Mudrián;243;116;127;2021
40;Segovia;183;San Miguel de Bernuy;138;69;69;2021
40;Segovia;184;San Pedro de Gaíllos;278;150;128;2021
40;Segovia;179;Sanchonuño;980;486;494;2021
40;Segovia;180;Sangarcía;306;173;133;2021
40;Segovia;185;Santa María la Real de Nieva;926;507;419;2021
40;Segovia;186;Santa Marta del Cerro;40;21;19;2021
40;Segovia;188;Santiuste de Pedraza;85;57;28;2021
40;Segovia;189;Santiuste de San Juan Bautista;535;290;245;2021
40;Segovia;190;Santo Domingo de Pirón;59;34;25;2021
40;Segovia;191;Santo Tomé del Puerto;259;141;118;2021
40;Segovia;192;Sauquillo de Cabezas;141;78;63;2021
40;Segovia;193;Sebúlcor;264;143;121;2021
40;Segovia;194;Segovia;51258;23880;27378;2021
40;Segovia;195;Sepúlveda;987;510;477;2021
40;Segovia;196;Sequera de Fresno;32;21;11;2021
40;Segovia;198;Sotillo;29;16;13;2021
40;Segovia;199;Sotosalbos;137;75;62;2021
40;Segovia;200;Tabanera la Luenga;47;24;23;2021
40;Segovia;201;Tolocirio;45;21;24;2021
40;Segovia;206;Torre Val de San Pedro;197;102;95;2021
40;Segovia;202;Torreadrada;50;26;24;2021
40;Segovia;203;Torrecaballeros;1389;719;670;2021
40;Segovia;204;Torrecilla del Pinar;174;92;82;2021
40;Segovia;205;Torreiglesias;261;130;131;2021
40;Segovia;207;Trescasas;1072;551;521;2021
40;Segovia;208;Turégano;998;508;490;2021
40;Segovia;210;Urueñas;104;66;38;2021
40;Segovia;211;Valdeprados;70;39;31;2021
40;Segovia;212;Valdevacas de Montejo;28;14;14;2021
40;Segovia;213;Valdevacas y Guijar;96;53;43;2021
40;Segovia;218;Valle de Tabladillo;79;49;30;2021
40;Segovia;219;Vallelado;718;372;346;2021
40;Segovia;220;Valleruela de Pedraza;73;34;39;2021
40;Segovia;221;Valleruela de Sepúlveda;53;26;27;2021
40;Segovia;214;Valseca;230;126;104;2021
40;Segovia;215;Valtiendas;79;48;31;2021
40;Segovia;216;Valverde del Majano;1112;567;545;2021
40;Segovia;222;Veganzones;216;115;101;2021
40;Segovia;223;Vegas de Matute;313;183;130;2021
40;Segovia;224;Ventosilla y Tejadilla;17;11;6;2021
40;Segovia;225;Villacastín;1491;772;719;2021
40;Segovia;228;Villaverde de Íscar;560;295;265;2021
40;Segovia;229;Villaverde de Montejo;31;20;11;2021
40;Segovia;230;Villeguillo;103;58;45;2021
40;Segovia;231;Yanguas de Eresma;126;71;55;2021
40;Segovia;233;Zarzuela del Monte;512;266;246;2021
40;Segovia;234;Zarzuela del Pinar;421;219;202;2021
41;Sevilla;001;Aguadulce;2022;999;1023;2021
41;Sevilla;002;Alanís;1716;854;862;2021
41;Sevilla;003;Albaida del Aljarafe;3221;1589;1632;2021
41;Sevilla;004;Alcalá de Guadaíra;75546;37521;38025;2021
41;Sevilla;005;Alcalá del Río;12264;6215;6049;2021
41;Sevilla;006;Alcolea del Río;3348;1664;1684;2021
41;Sevilla;007;Algaba, La;16484;8171;8313;2021
41;Sevilla;008;Algámitas;1253;652;601;2021
41;Sevilla;009;Almadén de la Plata;1331;689;642;2021
41;Sevilla;010;Almensilla;6287;3147;3140;2021
41;Sevilla;011;Arahal;19497;9651;9846;2021
41;Sevilla;012;Aznalcázar;4614;2344;2270;2021
41;Sevilla;013;Aznalcóllar;6060;3072;2988;2021
41;Sevilla;014;Badolatosa;3099;1600;1499;2021
41;Sevilla;015;Benacazón;7322;3688;3634;2021
41;Sevilla;016;Bollullos de la Mitación;11099;5546;5553;2021
41;Sevilla;017;Bormujos;22390;11110;11280;2021
41;Sevilla;018;Brenes;12581;6221;6360;2021
41;Sevilla;019;Burguillos;6902;3481;3421;2021
41;Sevilla;020;Cabezas de San Juan, Las;16335;8139;8196;2021
41;Sevilla;021;Camas;27490;13482;14008;2021
41;Sevilla;022;Campana, La;5228;2619;2609;2021
41;Sevilla;023;Cantillana;10755;5447;5308;2021
41;Sevilla;901;Cañada Rosal;3347;1652;1695;2021
41;Sevilla;024;Carmona;29123;14675;14448;2021
41;Sevilla;025;Carrión de los Céspedes;2587;1256;1331;2021
41;Sevilla;026;Casariche;5384;2764;2620;2021
41;Sevilla;027;Castilblanco de los Arroyos;5059;2562;2497;2021
41;Sevilla;028;Castilleja de Guzmán;2860;1464;1396;2021
41;Sevilla;029;Castilleja de la Cuesta;17366;8395;8971;2021
41;Sevilla;030;Castilleja del Campo;633;320;313;2021
41;Sevilla;031;Castillo de las Guardas, El;1512;801;711;2021
41;Sevilla;032;Cazalla de la Sierra;4752;2334;2418;2021
41;Sevilla;033;Constantina;5864;2910;2954;2021
41;Sevilla;034;Coria del Río;30774;15307;15467;2021
41;Sevilla;035;Coripe;1241;607;634;2021
41;Sevilla;036;Coronil, El;4699;2357;2342;2021
41;Sevilla;037;Corrales, Los;3985;2034;1951;2021
41;Sevilla;903;Cuervo de Sevilla, El;8667;4366;4301;2021
41;Sevilla;038;Dos Hermanas;136250;66833;69417;2021
41;Sevilla;039;Écija;39838;19621;20217;2021
41;Sevilla;040;Espartinas;16048;8043;8005;2021
41;Sevilla;041;Estepa;12459;6205;6254;2021
41;Sevilla;042;Fuentes de Andalucía;7160;3567;3593;2021
41;Sevilla;043;Garrobo, El;812;419;393;2021
41;Sevilla;044;Gelves;10295;5111;5184;2021
41;Sevilla;045;Gerena;7740;3854;3886;2021
41;Sevilla;046;Gilena;3709;1859;1850;2021
41;Sevilla;047;Gines;13529;6665;6864;2021
41;Sevilla;048;Guadalcanal;2588;1307;1281;2021
41;Sevilla;049;Guillena;13054;6562;6492;2021
41;Sevilla;050;Herrera;6504;3232;3272;2021
41;Sevilla;051;Huévar del Aljarafe;3129;1603;1526;2021
41;Sevilla;902;Isla Mayor;5826;2913;2913;2021
41;Sevilla;052;Lantejuela;3856;1969;1887;2021
41;Sevilla;053;Lebrija;27616;13778;13838;2021
41;Sevilla;054;Lora de Estepa;875;448;427;2021
41;Sevilla;055;Lora del Río;18578;9177;9401;2021
41;Sevilla;056;Luisiana, La;4587;2322;2265;2021
41;Sevilla;057;Madroño, El;300;153;147;2021
41;Sevilla;058;Mairena del Alcor;23893;11958;11935;2021
41;Sevilla;059;Mairena del Aljarafe;46895;22747;24148;2021
41;Sevilla;060;Marchena;19317;9610;9707;2021
41;Sevilla;061;Marinaleda;2618;1335;1283;2021
41;Sevilla;062;Martín de la Jara;2663;1368;1295;2021
41;Sevilla;063;Molares, Los;3563;1824;1739;2021
41;Sevilla;064;Montellano;7014;3519;3495;2021
41;Sevilla;065;Morón de la Frontera;27582;13560;14022;2021
41;Sevilla;066;Navas de la Concepción, Las;1538;759;779;2021
41;Sevilla;067;Olivares;9452;4719;4733;2021
41;Sevilla;068;Osuna;17594;8740;8854;2021
41;Sevilla;069;Palacios y Villafranca, Los;38678;19349;19329;2021
41;Sevilla;904;Palmar de Troya, El;2340;1172;1168;2021
41;Sevilla;070;Palomares del Río;9020;4522;4498;2021
41;Sevilla;071;Paradas;6850;3401;3449;2021
41;Sevilla;072;Pedrera;5147;2541;2606;2021
41;Sevilla;073;Pedroso, El;2038;1013;1025;2021
41;Sevilla;074;Peñaflor;3648;1831;1817;2021
41;Sevilla;075;Pilas;13856;6933;6923;2021
41;Sevilla;076;Pruna;2604;1319;1285;2021
41;Sevilla;077;Puebla de Cazalla, La;10896;5463;5433;2021
41;Sevilla;078;Puebla de los Infantes, La;2999;1477;1522;2021
41;Sevilla;079;Puebla del Río, La;11873;5843;6030;2021
41;Sevilla;080;Real de la Jara, El;1513;752;761;2021
41;Sevilla;081;Rinconada, La;39204;19395;19809;2021
41;Sevilla;082;Roda de Andalucía, La;4223;2085;2138;2021
41;Sevilla;083;Ronquillo, El;1431;713;718;2021
41;Sevilla;084;Rubio, El;3376;1683;1693;2021
41;Sevilla;085;Salteras;5646;2724;2922;2021
41;Sevilla;086;San Juan de Aznalfarache;22088;10632;11456;2021
41;Sevilla;088;San Nicolás del Puerto;608;315;293;2021
41;Sevilla;087;Sanlúcar la Mayor;14026;6902;7124;2021
41;Sevilla;089;Santiponce;8491;4222;4269;2021
41;Sevilla;090;Saucejo, El;4247;2102;2145;2021
41;Sevilla;091;Sevilla;684234;324312;359922;2021
41;Sevilla;092;Tocina;9508;4712;4796;2021
41;Sevilla;093;Tomares;25370;12519;12851;2021
41;Sevilla;094;Umbrete;9086;4538;4548;2021
41;Sevilla;095;Utrera;51145;25205;25940;2021
41;Sevilla;096;Valencina de la Concepción;7894;3878;4016;2021
41;Sevilla;097;Villamanrique de la Condesa;4531;2218;2313;2021
41;Sevilla;100;Villanueva de San Juan;1076;533;543;2021
41;Sevilla;098;Villanueva del Ariscal;6673;3254;3419;2021
41;Sevilla;099;Villanueva del Río y Minas;4892;2465;2427;2021
41;Sevilla;101;Villaverde del Río;7811;3951;3860;2021
41;Sevilla;102;Viso del Alcor, El;19251;9624;9627;2021
42;Soria;001;Abejar;273;142;131;2021
42;Soria;003;Adradas;55;29;26;2021
42;Soria;004;Ágreda;3006;1546;1460;2021
42;Soria;006;Alconaba;196;128;68;2021
42;Soria;007;Alcubilla de Avellaneda;116;63;53;2021
42;Soria;008;Alcubilla de las Peñas;51;30;21;2021
42;Soria;009;Aldealafuente;86;51;35;2021
42;Soria;010;Aldealices;29;20;9;2021
42;Soria;011;Aldealpozo;17;7;10;2021
42;Soria;012;Aldealseñor;32;19;13;2021
42;Soria;013;Aldehuela de Periáñez;33;19;14;2021
42;Soria;014;Aldehuelas, Las;56;32;24;2021
42;Soria;015;Alentisque;26;16;10;2021
42;Soria;016;Aliud;22;16;6;2021
42;Soria;017;Almajano;188;99;89;2021
42;Soria;018;Almaluez;124;74;50;2021
42;Soria;019;Almarza;640;372;268;2021
42;Soria;020;Almazán;5411;2759;2652;2021
42;Soria;021;Almazul;65;43;22;2021
42;Soria;022;Almenar de Soria;233;141;92;2021
42;Soria;023;Alpanseque;54;34;20;2021
42;Soria;024;Arancón;84;55;29;2021
42;Soria;025;Arcos de Jalón;1477;762;715;2021
42;Soria;026;Arenillas;47;28;19;2021
42;Soria;027;Arévalo de la Sierra;73;46;27;2021
42;Soria;028;Ausejo de la Sierra;91;51;40;2021
42;Soria;029;Baraona;127;72;55;2021
42;Soria;030;Barca;108;69;39;2021
42;Soria;031;Barcones;21;14;7;2021
42;Soria;032;Bayubas de Abajo;135;73;62;2021
42;Soria;033;Bayubas de Arriba;61;35;26;2021
42;Soria;034;Beratón;38;20;18;2021
42;Soria;035;Berlanga de Duero;872;454;418;2021
42;Soria;036;Blacos;41;21;20;2021
42;Soria;037;Bliecos;29;18;11;2021
42;Soria;038;Borjabad;33;20;13;2021
42;Soria;039;Borobia;242;134;108;2021
42;Soria;041;Buberos;29;15;14;2021
42;Soria;042;Buitrago;72;40;32;2021
42;Soria;043;Burgo de Osma-Ciudad de Osma;5034;2533;2501;2021
42;Soria;044;Cabrejas del Campo;48;29;19;2021
42;Soria;045;Cabrejas del Pinar;346;194;152;2021
42;Soria;046;Calatañazor;49;27;22;2021
42;Soria;048;Caltojar;57;39;18;2021
42;Soria;049;Candilichera;100;61;39;2021
42;Soria;050;Cañamaque;32;22;10;2021
42;Soria;051;Carabantes;15;8;7;2021
42;Soria;052;Caracena;14;10;4;2021
42;Soria;053;Carrascosa de Abajo;18;12;6;2021
42;Soria;054;Carrascosa de la Sierra;17;12;5;2021
42;Soria;055;Casarejos;156;82;74;2021
42;Soria;056;Castilfrío de la Sierra;35;21;14;2021
42;Soria;058;Castillejo de Robledo;104;63;41;2021
42;Soria;057;Castilruiz;153;83;70;2021
42;Soria;059;Centenera de Andaluz;21;11;10;2021
42;Soria;060;Cerbón;30;20;10;2021
42;Soria;061;Cidones;302;181;121;2021
42;Soria;062;Cigudosa;20;14;6;2021
42;Soria;063;Cihuela;47;28;19;2021
42;Soria;064;Ciria;76;40;36;2021
42;Soria;065;Cirujales del Río;20;15;5;2021
42;Soria;068;Coscurita;72;46;26;2021
42;Soria;069;Covaleda;1621;841;780;2021
42;Soria;070;Cubilla;27;15;12;2021
42;Soria;071;Cubo de la Solana;179;103;76;2021
42;Soria;073;Cueva de Ágreda;67;42;25;2021
42;Soria;075;Dévanos;79;44;35;2021
42;Soria;076;Deza;211;113;98;2021
42;Soria;078;Duruelo de la Sierra;1066;553;513;2021
42;Soria;079;Escobosa de Almazán;20;13;7;2021
42;Soria;080;Espeja de San Marcelino;158;95;63;2021
42;Soria;081;Espejón;147;80;67;2021
42;Soria;082;Estepa de San Juan;9;6;3;2021
42;Soria;083;Frechilla de Almazán;20;10;10;2021
42;Soria;084;Fresno de Caracena;20;14;6;2021
42;Soria;085;Fuentearmegil;160;95;65;2021
42;Soria;086;Fuentecambrón;32;20;12;2021
42;Soria;087;Fuentecantos;66;33;33;2021
42;Soria;088;Fuentelmonge;64;37;27;2021
42;Soria;089;Fuentelsaz de Soria;63;33;30;2021
42;Soria;090;Fuentepinilla;82;50;32;2021
42;Soria;092;Fuentes de Magaña;54;33;21;2021
42;Soria;093;Fuentestrún;42;29;13;2021
42;Soria;094;Garray;750;404;346;2021
42;Soria;095;Golmayo;2844;1482;1362;2021
42;Soria;096;Gómara;294;158;136;2021
42;Soria;097;Gormaz;21;16;5;2021
42;Soria;098;Herrera de Soria;9;7;2;2021
42;Soria;100;Hinojosa del Campo;28;19;9;2021
42;Soria;103;Langa de Duero;694;368;326;2021
42;Soria;105;Liceras;47;25;22;2021
42;Soria;106;Losilla, La;12;8;4;2021
42;Soria;107;Magaña;68;37;31;2021
42;Soria;108;Maján;9;6;3;2021
42;Soria;110;Matalebreras;64;42;22;2021
42;Soria;111;Matamala de Almazán;266;147;119;2021
42;Soria;113;Medinaceli;664;339;325;2021
42;Soria;115;Miño de Medinaceli;83;52;31;2021
42;Soria;116;Miño de San Esteban;43;29;14;2021
42;Soria;117;Molinos de Duero;158;84;74;2021
42;Soria;118;Momblona;17;13;4;2021
42;Soria;119;Monteagudo de las Vicarías;179;89;90;2021
42;Soria;120;Montejo de Tiermes;148;93;55;2021
42;Soria;121;Montenegro de Cameros;51;34;17;2021
42;Soria;123;Morón de Almazán;191;99;92;2021
42;Soria;124;Muriel de la Fuente;54;35;19;2021
42;Soria;125;Muriel Viejo;82;53;29;2021
42;Soria;127;Nafría de Ucero;33;19;14;2021
42;Soria;128;Narros;48;29;19;2021
42;Soria;129;Navaleno;755;400;355;2021
42;Soria;130;Nepas;51;36;15;2021
42;Soria;131;Nolay;58;34;24;2021
42;Soria;132;Noviercas;160;88;72;2021
42;Soria;134;Ólvega;3668;1871;1797;2021
42;Soria;135;Oncala;67;42;25;2021
42;Soria;139;Pinilla del Campo;20;12;8;2021
42;Soria;140;Portillo de Soria;14;10;4;2021
42;Soria;141;Póveda de Soria, La;112;69;43;2021
42;Soria;142;Pozalmuro;53;27;26;2021
42;Soria;144;Quintana Redonda;496;280;216;2021
42;Soria;145;Quintanas de Gormaz;141;88;53;2021
42;Soria;148;Quiñonería;8;4;4;2021
42;Soria;149;Rábanos, Los;465;254;211;2021
42;Soria;151;Rebollar;41;20;21;2021
42;Soria;152;Recuerda;71;42;29;2021
42;Soria;153;Rello;15;9;6;2021
42;Soria;154;Renieblas;111;72;39;2021
42;Soria;155;Retortillo de Soria;160;93;67;2021
42;Soria;156;Reznos;31;20;11;2021
42;Soria;157;Riba de Escalote, La;11;7;4;2021
42;Soria;158;Rioseco de Soria;125;76;49;2021
42;Soria;159;Rollamienta;41;27;14;2021
42;Soria;160;Royo, El;260;140;120;2021
42;Soria;161;Salduero;147;79;68;2021
42;Soria;162;San Esteban de Gormaz;2948;1552;1396;2021
42;Soria;163;San Felices;59;36;23;2021
42;Soria;164;San Leonardo de Yagüe;2042;1032;1010;2021
42;Soria;165;San Pedro Manrique;655;361;294;2021
42;Soria;166;Santa Cruz de Yanguas;62;35;27;2021
42;Soria;167;Santa María de Huerta;265;147;118;2021
42;Soria;168;Santa María de las Hoyas;87;52;35;2021
42;Soria;171;Serón de Nágima;130;73;57;2021
42;Soria;172;Soliedra;31;17;14;2021
42;Soria;173;Soria;39695;18740;20955;2021
42;Soria;174;Sotillo del Rincón;178;95;83;2021
42;Soria;175;Suellacabras;25;13;12;2021
42;Soria;176;Tajahuerce;24;13;11;2021
42;Soria;177;Tajueco;60;36;24;2021
42;Soria;178;Talveila;107;64;43;2021
42;Soria;181;Tardelcuende;420;221;199;2021
42;Soria;182;Taroda;46;26;20;2021
42;Soria;183;Tejado;92;54;38;2021
42;Soria;184;Torlengua;51;31;20;2021
42;Soria;185;Torreblacos;26;13;13;2021
42;Soria;187;Torrubia de Soria;61;41;20;2021
42;Soria;188;Trévago;43;20;23;2021
42;Soria;189;Ucero;63;37;26;2021
42;Soria;190;Vadillo;86;45;41;2021
42;Soria;191;Valdeavellano de Tera;204;109;95;2021
42;Soria;192;Valdegeña;38;29;9;2021
42;Soria;193;Valdelagua del Cerro;12;7;5;2021
42;Soria;194;Valdemaluque;148;68;80;2021
42;Soria;195;Valdenebro;96;54;42;2021
42;Soria;196;Valdeprado;6;3;3;2021
42;Soria;197;Valderrodilla;67;36;31;2021
42;Soria;198;Valtajeros;22;13;9;2021
42;Soria;200;Velamazán;72;49;23;2021
42;Soria;201;Velilla de la Sierra;28;17;11;2021
42;Soria;202;Velilla de los Ajos;19;11;8;2021
42;Soria;204;Viana de Duero;54;36;18;2021
42;Soria;205;Villaciervos;72;44;28;2021
42;Soria;206;Villanueva de Gormaz;8;6;2;2021
42;Soria;207;Villar del Ala;50;27;23;2021
42;Soria;208;Villar del Campo;26;17;9;2021
42;Soria;209;Villar del Río;154;93;61;2021
42;Soria;211;Villares de Soria, Los;81;45;36;2021
42;Soria;212;Villasayas;66;41;25;2021
42;Soria;213;Villaseca de Arciel;24;15;9;2021
42;Soria;215;Vinuesa;837;442;395;2021
42;Soria;216;Vizmanos;26;16;10;2021
42;Soria;217;Vozmediano;37;24;13;2021
42;Soria;218;Yanguas;113;71;42;2021
42;Soria;219;Yelo;47;29;18;2021
43;Tarragona;001;Aiguamúrcia;960;495;465;2021
43;Tarragona;002;Albinyana;2504;1294;1210;2021
43;Tarragona;003;Albiol, L';515;278;237;2021
43;Tarragona;004;Alcanar;9579;4862;4717;2021
43;Tarragona;005;Alcover;5185;2569;2616;2021
43;Tarragona;904;Aldea, L';4160;2219;1941;2021
43;Tarragona;006;Aldover;911;464;447;2021
43;Tarragona;007;Aleixar, L';912;469;443;2021
43;Tarragona;008;Alfara de Carles;376;203;173;2021
43;Tarragona;009;Alforja;1843;937;906;2021
43;Tarragona;010;Alió;478;237;241;2021
43;Tarragona;011;Almoster;1322;658;664;2021
43;Tarragona;012;Altafulla;5512;2679;2833;2021
43;Tarragona;013;Ametlla de Mar, L';7131;3620;3511;2021
43;Tarragona;906;Ampolla, L';3444;1778;1666;2021
43;Tarragona;014;Amposta;21317;10776;10541;2021
43;Tarragona;016;Arboç, L';5625;2886;2739;2021
43;Tarragona;015;Arbolí;126;76;50;2021
43;Tarragona;017;Argentera, L';126;72;54;2021
43;Tarragona;018;Arnes;441;218;223;2021
43;Tarragona;019;Ascó;1611;820;791;2021
43;Tarragona;020;Banyeres del Penedès;3280;1659;1621;2021
43;Tarragona;021;Barberà de la Conca;472;262;210;2021
43;Tarragona;022;Batea;1879;937;942;2021
43;Tarragona;023;Bellmunt del Priorat;281;143;138;2021
43;Tarragona;024;Bellvei;2303;1183;1120;2021
43;Tarragona;025;Benifallet;741;358;383;2021
43;Tarragona;026;Benissanet;1129;615;514;2021
43;Tarragona;027;Bisbal de Falset, La;218;124;94;2021
43;Tarragona;028;Bisbal del Penedès, La;3830;2012;1818;2021
43;Tarragona;029;Blancafort;398;209;189;2021
43;Tarragona;030;Bonastre;727;384;343;2021
43;Tarragona;031;Borges del Camp, Les;2104;1077;1027;2021
43;Tarragona;032;Bot;566;289;277;2021
43;Tarragona;033;Botarell;1094;559;535;2021
43;Tarragona;034;Bràfim;695;347;348;2021
43;Tarragona;035;Cabacés;312;165;147;2021
43;Tarragona;036;Cabra del Camp;1230;647;583;2021
43;Tarragona;037;Calafell;28463;14280;14183;2021
43;Tarragona;903;Camarles;3220;1647;1573;2021
43;Tarragona;038;Cambrils;35064;17150;17914;2021
43;Tarragona;907;Canonja, La;5933;2892;3041;2021
43;Tarragona;039;Capafonts;125;68;57;2021
43;Tarragona;040;Capçanes;394;200;194;2021
43;Tarragona;041;Caseres;226;116;110;2021
43;Tarragona;042;Castellvell del Camp;2873;1441;1432;2021
43;Tarragona;043;Catllar, El;4740;2467;2273;2021
43;Tarragona;045;Colldejou;167;93;74;2021
43;Tarragona;046;Conesa;106;52;54;2021
43;Tarragona;047;Constantí;6724;3470;3254;2021
43;Tarragona;048;Corbera d'Ebre;981;510;471;2021
43;Tarragona;049;Cornudella de Montsant;965;509;456;2021
43;Tarragona;050;Creixell;3912;1970;1942;2021
43;Tarragona;051;Cunit;14081;6956;7125;2021
43;Tarragona;901;Deltebre;11539;5801;5738;2021
43;Tarragona;053;Duesaigües;234;131;103;2021
43;Tarragona;054;Espluga de Francolí, L';3717;1821;1896;2021
43;Tarragona;055;Falset;2724;1368;1356;2021
43;Tarragona;056;Fatarella, La;917;447;470;2021
43;Tarragona;057;Febró, La;41;25;16;2021
43;Tarragona;058;Figuera, La;117;66;51;2021
43;Tarragona;059;Figuerola del Camp;336;167;169;2021
43;Tarragona;060;Flix;3451;1740;1711;2021
43;Tarragona;061;Forès;48;27;21;2021
43;Tarragona;062;Freginals;391;210;181;2021
43;Tarragona;063;Galera, La;723;375;348;2021
43;Tarragona;064;Gandesa;3098;1587;1511;2021
43;Tarragona;065;Garcia;535;261;274;2021
43;Tarragona;066;Garidells, Els;198;98;100;2021
43;Tarragona;067;Ginestar;787;420;367;2021
43;Tarragona;068;Godall;614;304;310;2021
43;Tarragona;069;Gratallops;237;131;106;2021
43;Tarragona;070;Guiamets, Els;276;134;142;2021
43;Tarragona;071;Horta de Sant Joan;1138;589;549;2021
43;Tarragona;072;Lloar, El;111;57;54;2021
43;Tarragona;073;Llorac;92;49;43;2021
43;Tarragona;074;Llorenç del Penedès;2381;1169;1212;2021
43;Tarragona;076;Marçà;612;320;292;2021
43;Tarragona;075;Margalef;104;61;43;2021
43;Tarragona;077;Mas de Barberans;572;286;286;2021
43;Tarragona;078;Masdenverge;1109;572;537;2021
43;Tarragona;079;Masllorenç;508;276;232;2021
43;Tarragona;080;Masó, La;283;148;135;2021
43;Tarragona;081;Maspujols;826;420;406;2021
43;Tarragona;082;Masroig, El;499;278;221;2021
43;Tarragona;083;Milà, El;191;91;100;2021
43;Tarragona;084;Miravet;685;364;321;2021
43;Tarragona;085;Molar, El;298;157;141;2021
43;Tarragona;086;Montblanc;7433;3771;3662;2021
43;Tarragona;088;Montbrió del Camp;2985;1539;1446;2021
43;Tarragona;089;Montferri;397;211;186;2021
43;Tarragona;090;Montmell, El;1730;924;806;2021
43;Tarragona;091;Mont-ral;169;94;75;2021
43;Tarragona;092;Mont-roig del Camp;12689;6514;6175;2021
43;Tarragona;093;Móra d'Ebre;5585;2797;2788;2021
43;Tarragona;094;Móra la Nova;3120;1562;1558;2021
43;Tarragona;095;Morell, El;3732;1918;1814;2021
43;Tarragona;096;Morera de Montsant, La;163;87;76;2021
43;Tarragona;097;Nou de Gaià, La;616;304;312;2021
43;Tarragona;098;Nulles;516;280;236;2021
43;Tarragona;100;Pallaresos, Els;4872;2441;2431;2021
43;Tarragona;099;Palma d'Ebre, La;334;168;166;2021
43;Tarragona;101;Passanant i Belltall;167;98;69;2021
43;Tarragona;102;Paüls;563;287;276;2021
43;Tarragona;103;Perafort;1275;662;613;2021
43;Tarragona;104;Perelló, El;2846;1453;1393;2021
43;Tarragona;105;Piles, Les;218;117;101;2021
43;Tarragona;106;Pinell de Brai, El;998;503;495;2021
43;Tarragona;107;Pira;498;267;231;2021
43;Tarragona;108;Pla de Santa Maria, El;2340;1222;1118;2021
43;Tarragona;109;Pobla de Mafumet, La;4025;2036;1989;2021
43;Tarragona;110;Pobla de Massaluca, La;341;192;149;2021
43;Tarragona;111;Pobla de Montornès, La;2999;1543;1456;2021
43;Tarragona;112;Poboleda;328;165;163;2021
43;Tarragona;113;Pont d'Armentera, El;493;245;248;2021
43;Tarragona;141;Pontils;138;74;64;2021
43;Tarragona;114;Porrera;428;224;204;2021
43;Tarragona;115;Pradell de la Teixeta;164;78;86;2021
43;Tarragona;116;Prades;602;322;280;2021
43;Tarragona;117;Prat de Comte;186;98;88;2021
43;Tarragona;118;Pratdip;680;353;327;2021
43;Tarragona;119;Puigpelat;1196;629;567;2021
43;Tarragona;120;Querol;544;305;239;2021
43;Tarragona;121;Rasquera;846;420;426;2021
43;Tarragona;122;Renau;155;83;72;2021
43;Tarragona;123;Reus;106084;51298;54786;2021
43;Tarragona;124;Riba, La;575;310;265;2021
43;Tarragona;125;Riba-roja d'Ebre;1117;595;522;2021
43;Tarragona;126;Riera de Gaià, La;1737;864;873;2021
43;Tarragona;127;Riudecanyes;1194;635;559;2021
43;Tarragona;128;Riudecols;1225;631;594;2021
43;Tarragona;129;Riudoms;6617;3364;3253;2021
43;Tarragona;130;Rocafort de Queralt;230;123;107;2021
43;Tarragona;131;Roda de Berà;7127;3653;3474;2021
43;Tarragona;132;Rodonyà;507;273;234;2021
43;Tarragona;133;Roquetes;8159;4207;3952;2021
43;Tarragona;134;Rourell, El;402;205;197;2021
43;Tarragona;135;Salomó;544;280;264;2021
43;Tarragona;905;Salou;28512;14673;13839;2021
43;Tarragona;136;Sant Carles de la Ràpita;14931;7312;7619;2021
43;Tarragona;137;Sant Jaume dels Domenys;2666;1369;1297;2021
43;Tarragona;902;Sant Jaume d'Enveja;3552;1775;1777;2021
43;Tarragona;138;Santa Bàrbara;3762;1928;1834;2021
43;Tarragona;139;Santa Coloma de Queralt;2702;1344;1358;2021
43;Tarragona;140;Santa Oliva;3450;1756;1694;2021
43;Tarragona;142;Sarral;1549;803;746;2021
43;Tarragona;143;Savallà del Comtat;53;27;26;2021
43;Tarragona;144;Secuita, La;1728;869;859;2021
43;Tarragona;145;Selva del Camp, La;5694;2854;2840;2021
43;Tarragona;146;Senan;42;28;14;2021
43;Tarragona;044;Sénia, La;5530;2774;2756;2021
43;Tarragona;147;Solivella;640;332;308;2021
43;Tarragona;148;Tarragona;135436;66116;69320;2021
43;Tarragona;149;Tivenys;900;457;443;2021
43;Tarragona;150;Tivissa;1639;830;809;2021
43;Tarragona;151;Torre de Fontaubella, La;128;66;62;2021
43;Tarragona;152;Torre de l'Espanyol, La;598;309;289;2021
43;Tarragona;153;Torredembarra;17057;8366;8691;2021
43;Tarragona;154;Torroja del Priorat;141;79;62;2021
43;Tarragona;155;Tortosa;33572;16730;16842;2021
43;Tarragona;156;Ulldecona;6317;3335;2982;2021
43;Tarragona;157;Ulldemolins;400;227;173;2021
43;Tarragona;158;Vallclara;91;55;36;2021
43;Tarragona;159;Vallfogona de Riucorb;77;48;29;2021
43;Tarragona;160;Vallmoll;1793;900;893;2021
43;Tarragona;161;Valls;24553;12297;12256;2021
43;Tarragona;162;Vandellòs i l'Hospitalet de l'Infant;6645;3301;3344;2021
43;Tarragona;163;Vendrell, El;38891;19299;19592;2021
43;Tarragona;164;Vespella de Gaià;458;249;209;2021
43;Tarragona;165;Vilabella;705;359;346;2021
43;Tarragona;175;Vilalba dels Arcs;630;313;317;2021
43;Tarragona;166;Vilallonga del Camp;2385;1222;1163;2021
43;Tarragona;168;Vilanova de Prades;108;54;54;2021
43;Tarragona;167;Vilanova d'Escornalbou;582;303;279;2021
43;Tarragona;169;Vilaplana;536;287;249;2021
43;Tarragona;170;Vila-rodona;1299;688;611;2021
43;Tarragona;171;Vila-seca;22522;11309;11213;2021
43;Tarragona;172;Vilaverd;445;243;202;2021
43;Tarragona;173;Vilella Alta, La;131;69;62;2021
43;Tarragona;174;Vilella Baixa, La;208;113;95;2021
43;Tarragona;176;Vimbodí i Poblet;880;474;406;2021
43;Tarragona;177;Vinebre;427;212;215;2021
43;Tarragona;178;Vinyols i els Arcs;2193;1154;1039;2021
43;Tarragona;052;Xerta;1159;573;586;2021
44;Teruel;001;Ababuj;76;44;32;2021
44;Teruel;002;Abejuela;57;36;21;2021
44;Teruel;003;Aguatón;17;8;9;2021
44;Teruel;004;Aguaviva;547;267;280;2021
44;Teruel;005;Aguilar del Alfambra;76;41;35;2021
44;Teruel;006;Alacón;235;121;114;2021
44;Teruel;007;Alba;184;103;81;2021
44;Teruel;008;Albalate del Arzobispo;1977;1013;964;2021
44;Teruel;009;Albarracín;990;505;485;2021
44;Teruel;010;Albentosa;294;160;134;2021
44;Teruel;011;Alcaine;46;29;17;2021
44;Teruel;012;Alcalá de la Selva;352;193;159;2021
44;Teruel;013;Alcañiz;16029;7994;8035;2021
44;Teruel;014;Alcorisa;3293;1685;1608;2021
44;Teruel;016;Alfambra;483;258;225;2021
44;Teruel;017;Aliaga;333;190;143;2021
44;Teruel;021;Allepuz;128;64;64;2021
44;Teruel;022;Alloza;577;303;274;2021
44;Teruel;023;Allueva;22;14;8;2021
44;Teruel;018;Almohaja;14;10;4;2021
44;Teruel;019;Alobras;65;43;22;2021
44;Teruel;020;Alpeñés;20;12;8;2021
44;Teruel;024;Anadón;32;20;12;2021
44;Teruel;025;Andorra;7327;3682;3645;2021
44;Teruel;026;Arcos de las Salinas;112;65;47;2021
44;Teruel;027;Arens de Lledó;221;113;108;2021
44;Teruel;028;Argente;199;98;101;2021
44;Teruel;029;Ariño;685;350;335;2021
44;Teruel;031;Azaila;100;52;48;2021
44;Teruel;032;Bádenas;18;11;7;2021
44;Teruel;033;Báguena;278;153;125;2021
44;Teruel;034;Bañón;149;85;64;2021
44;Teruel;035;Barrachina;113;60;53;2021
44;Teruel;036;Bea;31;18;13;2021
44;Teruel;037;Beceite;544;279;265;2021
44;Teruel;039;Bello;224;112;112;2021
44;Teruel;038;Belmonte de San José;123;59;64;2021
44;Teruel;040;Berge;237;117;120;2021
44;Teruel;041;Bezas;63;40;23;2021
44;Teruel;042;Blancas;132;79;53;2021
44;Teruel;043;Blesa;85;56;29;2021
44;Teruel;044;Bordón;116;66;50;2021
44;Teruel;045;Bronchales;424;240;184;2021
44;Teruel;046;Bueña;52;28;24;2021
44;Teruel;047;Burbáguena;207;116;91;2021
44;Teruel;048;Cabra de Mora;68;44;24;2021
44;Teruel;049;Calaceite;982;482;500;2021
44;Teruel;050;Calamocha;4473;2216;2257;2021
44;Teruel;051;Calanda;3753;1864;1889;2021
44;Teruel;052;Calomarde;78;46;32;2021
44;Teruel;053;Camañas;140;78;62;2021
44;Teruel;054;Camarena de la Sierra;116;70;46;2021
44;Teruel;055;Camarillas;82;50;32;2021
44;Teruel;056;Caminreal;634;332;302;2021
44;Teruel;059;Cantavieja;734;388;346;2021
44;Teruel;060;Cañada de Benatanduz;34;22;12;2021
44;Teruel;061;Cañada de Verich, La;101;58;43;2021
44;Teruel;062;Cañada Vellida;37;26;11;2021
44;Teruel;063;Cañizar del Olivar;105;60;45;2021
44;Teruel;064;Cascante del Río;69;41;28;2021
44;Teruel;065;Castejón de Tornos;52;34;18;2021
44;Teruel;066;Castel de Cabra;95;52;43;2021
44;Teruel;070;Castellar, El;56;38;18;2021
44;Teruel;071;Castellote;687;349;338;2021
44;Teruel;067;Castelnou;120;63;57;2021
44;Teruel;068;Castelserás;789;416;373;2021
44;Teruel;074;Cedrillas;609;298;311;2021
44;Teruel;075;Celadas;374;213;161;2021
44;Teruel;076;Cella;2578;1334;1244;2021
44;Teruel;077;Cerollera, La;84;52;32;2021
44;Teruel;080;Codoñera, La;317;167;150;2021
44;Teruel;082;Corbalán;108;56;52;2021
44;Teruel;084;Cortes de Aragón;63;28;35;2021
44;Teruel;085;Cosa;55;36;19;2021
44;Teruel;086;Cretas;555;284;271;2021
44;Teruel;087;Crivillén;87;48;39;2021
44;Teruel;088;Cuba, La;42;25;17;2021
44;Teruel;089;Cubla;52;35;17;2021
44;Teruel;090;Cucalón;82;50;32;2021
44;Teruel;092;Cuervo, El;74;36;38;2021
44;Teruel;093;Cuevas de Almudén;118;64;54;2021
44;Teruel;094;Cuevas Labradas;137;73;64;2021
44;Teruel;096;Ejulve;178;93;85;2021
44;Teruel;097;Escorihuela;141;73;68;2021
44;Teruel;099;Escucha;782;424;358;2021
44;Teruel;100;Estercuel;209;115;94;2021
44;Teruel;101;Ferreruela de Huerva;74;43;31;2021
44;Teruel;102;Fonfría;29;18;11;2021
44;Teruel;103;Formiche Alto;155;87;68;2021
44;Teruel;105;Fórnoles;81;43;38;2021
44;Teruel;106;Fortanete;200;116;84;2021
44;Teruel;107;Foz-Calanda;271;135;136;2021
44;Teruel;108;Fresneda, La;457;251;206;2021
44;Teruel;109;Frías de Albarracín;105;67;38;2021
44;Teruel;110;Fuenferrada;40;25;15;2021
44;Teruel;111;Fuentes Calientes;92;55;37;2021
44;Teruel;112;Fuentes Claras;433;236;197;2021
44;Teruel;113;Fuentes de Rubielos;154;83;71;2021
44;Teruel;114;Fuentespalda;293;151;142;2021
44;Teruel;115;Galve;163;83;80;2021
44;Teruel;116;Gargallo;98;50;48;2021
44;Teruel;117;Gea de Albarracín;378;208;170;2021
44;Teruel;118;Ginebrosa, La;201;111;90;2021
44;Teruel;119;Griegos;138;86;52;2021
44;Teruel;120;Guadalaviar;253;136;117;2021
44;Teruel;121;Gúdar;79;43;36;2021
44;Teruel;122;Híjar;1771;909;862;2021
44;Teruel;123;Hinojosa de Jarque;110;62;48;2021
44;Teruel;124;Hoz de la Vieja, La;91;46;45;2021
44;Teruel;125;Huesa del Común;73;45;28;2021
44;Teruel;126;Iglesuela del Cid, La;407;214;193;2021
44;Teruel;127;Jabaloyas;61;38;23;2021
44;Teruel;128;Jarque de la Val;60;31;29;2021
44;Teruel;129;Jatiel;45;30;15;2021
44;Teruel;130;Jorcas;34;19;15;2021
44;Teruel;131;Josa;36;25;11;2021
44;Teruel;132;Lagueruela;66;37;29;2021
44;Teruel;133;Lanzuela;25;18;7;2021
44;Teruel;135;Libros;104;63;41;2021
44;Teruel;136;Lidón;54;30;24;2021
44;Teruel;137;Linares de Mora;226;132;94;2021
44;Teruel;141;Lledó;172;87;85;2021
44;Teruel;138;Loscos;122;72;50;2021
44;Teruel;142;Maicas;31;19;12;2021
44;Teruel;143;Manzanera;527;293;234;2021
44;Teruel;144;Martín del Río;372;174;198;2021
44;Teruel;145;Mas de las Matas;1271;666;605;2021
44;Teruel;146;Mata de los Olmos, La;257;133;124;2021
44;Teruel;147;Mazaleón;503;269;234;2021
44;Teruel;148;Mezquita de Jarque;87;49;38;2021
44;Teruel;149;Mirambel;111;67;44;2021
44;Teruel;150;Miravete de la Sierra;38;28;10;2021
44;Teruel;151;Molinos;238;126;112;2021
44;Teruel;152;Monforte de Moyuela;71;49;22;2021
44;Teruel;153;Monreal del Campo;2522;1256;1266;2021
44;Teruel;154;Monroyo;318;182;136;2021
44;Teruel;155;Montalbán;1237;629;608;2021
44;Teruel;156;Monteagudo del Castillo;51;28;23;2021
44;Teruel;157;Monterde de Albarracín;57;34;23;2021
44;Teruel;158;Mora de Rubielos;1539;770;769;2021
44;Teruel;159;Moscardón;53;29;24;2021
44;Teruel;160;Mosqueruela;531;288;243;2021
44;Teruel;161;Muniesa;571;306;265;2021
44;Teruel;163;Noguera de Albarracín;142;80;62;2021
44;Teruel;164;Nogueras;28;19;9;2021
44;Teruel;165;Nogueruelas;207;120;87;2021
44;Teruel;167;Obón;32;16;16;2021
44;Teruel;168;Odón;218;111;107;2021
44;Teruel;169;Ojos Negros;330;183;147;2021
44;Teruel;171;Olba;264;140;124;2021
44;Teruel;172;Oliete;340;181;159;2021
44;Teruel;173;Olmos, Los;118;64;54;2021
44;Teruel;174;Orihuela del Tremedal;454;250;204;2021
44;Teruel;175;Orrios;130;71;59;2021
44;Teruel;176;Palomar de Arroyos;168;100;68;2021
44;Teruel;177;Pancrudo;119;70;49;2021
44;Teruel;178;Parras de Castellote, Las;56;32;24;2021
44;Teruel;179;Peñarroya de Tastavins;450;241;209;2021
44;Teruel;180;Peracense;85;45;40;2021
44;Teruel;181;Peralejos;85;47;38;2021
44;Teruel;182;Perales del Alfambra;251;130;121;2021
44;Teruel;183;Pitarque;69;36;33;2021
44;Teruel;184;Plou;48;30;18;2021
44;Teruel;185;Pobo, El;112;73;39;2021
44;Teruel;187;Portellada, La;230;119;111;2021
44;Teruel;189;Pozondón;47;28;19;2021
44;Teruel;190;Pozuel del Campo;62;34;28;2021
44;Teruel;191;Puebla de Híjar, La;909;459;450;2021
44;Teruel;192;Puebla de Valverde, La;445;244;201;2021
44;Teruel;193;Puertomingalvo;125;64;61;2021
44;Teruel;194;Ráfales;144;86;58;2021
44;Teruel;195;Rillo;92;56;36;2021
44;Teruel;196;Riodeva;128;63;65;2021
44;Teruel;197;Ródenas;61;34;27;2021
44;Teruel;198;Royuela;212;115;97;2021
44;Teruel;199;Rubiales;42;24;18;2021
44;Teruel;200;Rubielos de la Cérida;37;23;14;2021
44;Teruel;201;Rubielos de Mora;632;324;308;2021
44;Teruel;203;Salcedillo;11;7;4;2021
44;Teruel;204;Saldón;25;16;9;2021
44;Teruel;205;Samper de Calanda;731;373;358;2021
44;Teruel;206;San Agustín;138;85;53;2021
44;Teruel;207;San Martín del Río;137;70;67;2021
44;Teruel;208;Santa Cruz de Nogueras;30;13;17;2021
44;Teruel;209;Santa Eulalia;1066;544;522;2021
44;Teruel;210;Sarrión;1194;619;575;2021
44;Teruel;211;Segura de los Baños;38;24;14;2021
44;Teruel;212;Seno;44;20;24;2021
44;Teruel;213;Singra;80;48;32;2021
44;Teruel;215;Terriente;181;103;78;2021
44;Teruel;216;Teruel;35994;17166;18828;2021
44;Teruel;217;Toril y Masegoso;36;28;8;2021
44;Teruel;218;Tormón;25;15;10;2021
44;Teruel;219;Tornos;201;105;96;2021
44;Teruel;220;Torralba de los Sisones;162;88;74;2021
44;Teruel;223;Torre de Arcas;93;45;48;2021
44;Teruel;224;Torre de las Arcas;25;15;10;2021
44;Teruel;225;Torre del Compte;122;60;62;2021
44;Teruel;227;Torre los Negros;82;44;38;2021
44;Teruel;221;Torrecilla de Alcañiz;450;234;216;2021
44;Teruel;222;Torrecilla del Rebollar;122;80;42;2021
44;Teruel;226;Torrelacárcel;142;79;63;2021
44;Teruel;228;Torremocha de Jiloca;108;58;50;2021
44;Teruel;229;Torres de Albarracín;171;97;74;2021
44;Teruel;230;Torrevelilla;180;91;89;2021
44;Teruel;231;Torrijas;38;18;20;2021
44;Teruel;232;Torrijo del Campo;470;244;226;2021
44;Teruel;234;Tramacastiel;67;39;28;2021
44;Teruel;235;Tramacastilla;105;51;54;2021
44;Teruel;236;Tronchón;65;33;32;2021
44;Teruel;237;Urrea de Gaén;435;224;211;2021
44;Teruel;238;Utrillas;3003;1539;1464;2021
44;Teruel;239;Valacloche;24;14;10;2021
44;Teruel;240;Valbona;184;107;77;2021
44;Teruel;241;Valdealgorfa;589;293;296;2021
44;Teruel;243;Valdecuenca;29;17;12;2021
44;Teruel;244;Valdelinares;82;51;31;2021
44;Teruel;245;Valdeltormo;293;141;152;2021
44;Teruel;246;Valderrobres;2457;1263;1194;2021
44;Teruel;247;Valjunquera;342;176;166;2021
44;Teruel;249;Vallecillo, El;39;25;14;2021
44;Teruel;250;Veguillas de la Sierra;21;13;8;2021
44;Teruel;251;Villafranca del Campo;302;160;142;2021
44;Teruel;252;Villahermosa del Campo;88;53;35;2021
44;Teruel;256;Villanueva del Rebollar de la Sierra;42;26;16;2021
44;Teruel;257;Villar del Cobo;163;97;66;2021
44;Teruel;258;Villar del Salz;66;39;27;2021
44;Teruel;260;Villarluengo;169;97;72;2021
44;Teruel;261;Villarquemado;846;443;403;2021
44;Teruel;262;Villarroya de los Pinares;175;92;83;2021
44;Teruel;263;Villastar;548;272;276;2021
44;Teruel;264;Villel;325;181;144;2021
44;Teruel;265;Vinaceite;215;117;98;2021
44;Teruel;266;Visiedo;124;60;64;2021
44;Teruel;267;Vivel del Río Martín;75;41;34;2021
44;Teruel;268;Zoma, La;31;17;14;2021
45;Toledo;001;Ajofrín;2236;1128;1108;2021
45;Toledo;002;Alameda de la Sagra;3757;1960;1797;2021
45;Toledo;003;Albarreal de Tajo;708;371;337;2021
45;Toledo;004;Alcabón;678;344;334;2021
45;Toledo;005;Alcañizo;274;139;135;2021
45;Toledo;006;Alcaudete de la Jara;1644;832;812;2021
45;Toledo;007;Alcolea de Tajo;843;422;421;2021
45;Toledo;008;Aldea en Cabo;179;92;87;2021
45;Toledo;009;Aldeanueva de Barbarroya;495;257;238;2021
45;Toledo;010;Aldeanueva de San Bartolomé;413;210;203;2021
45;Toledo;011;Almendral de la Cañada;327;170;157;2021
45;Toledo;012;Almonacid de Toledo;843;414;429;2021
45;Toledo;013;Almorox;2318;1218;1100;2021
45;Toledo;014;Añover de Tajo;5202;2626;2576;2021
45;Toledo;015;Arcicóllar;964;475;489;2021
45;Toledo;016;Argés;6621;3307;3314;2021
45;Toledo;017;Azután;303;152;151;2021
45;Toledo;018;Barcience;940;515;425;2021
45;Toledo;019;Bargas;10611;5313;5298;2021
45;Toledo;020;Belvís de la Jara;1543;776;767;2021
45;Toledo;021;Borox;3981;2088;1893;2021
45;Toledo;022;Buenaventura;419;207;212;2021
45;Toledo;023;Burguillos de Toledo;3390;1758;1632;2021
45;Toledo;024;Burujón;1316;666;650;2021
45;Toledo;025;Cabañas de la Sagra;1955;1018;937;2021
45;Toledo;026;Cabañas de Yepes;301;156;145;2021
45;Toledo;027;Cabezamesada;330;185;145;2021
45;Toledo;028;Calera y Chozas;4641;2347;2294;2021
45;Toledo;029;Caleruela;214;106;108;2021
45;Toledo;030;Calzada de Oropesa;513;284;229;2021
45;Toledo;031;Camarena;4243;2215;2028;2021
45;Toledo;032;Camarenilla;588;300;288;2021
45;Toledo;033;Campillo de la Jara, El;356;188;168;2021
45;Toledo;034;Camuñas;1726;894;832;2021
45;Toledo;035;Cardiel de los Montes;380;208;172;2021
45;Toledo;036;Carmena;780;389;391;2021
45;Toledo;037;Carpio de Tajo, El;1817;913;904;2021
45;Toledo;038;Carranque;5022;2630;2392;2021
45;Toledo;039;Carriches;278;143;135;2021
45;Toledo;040;Casar de Escalona, El;1791;959;832;2021
45;Toledo;041;Casarrubios del Monte;6177;3233;2944;2021
45;Toledo;042;Casasbuenas;182;92;90;2021
45;Toledo;043;Castillo de Bayuela;918;463;455;2021
45;Toledo;045;Cazalegas;1854;956;898;2021
45;Toledo;046;Cebolla;3204;1587;1617;2021
45;Toledo;047;Cedillo del Condado;4025;2078;1947;2021
45;Toledo;048;Cerralbos, Los;418;229;189;2021
45;Toledo;049;Cervera de los Montes;504;260;244;2021
45;Toledo;056;Chozas de Canales;4335;2246;2089;2021
45;Toledo;057;Chueca;253;127;126;2021
45;Toledo;050;Ciruelos;616;333;283;2021
45;Toledo;051;Cobeja;2412;1261;1151;2021
45;Toledo;052;Cobisa;4377;2187;2190;2021
45;Toledo;053;Consuegra;9942;5052;4890;2021
45;Toledo;054;Corral de Almaguer;5068;2624;2444;2021
45;Toledo;055;Cuerva;1277;661;616;2021
45;Toledo;058;Domingo Pérez;325;164;161;2021
45;Toledo;059;Dosbarrios;2263;1166;1097;2021
45;Toledo;060;Erustes;191;98;93;2021
45;Toledo;061;Escalona;3441;1781;1660;2021
45;Toledo;062;Escalonilla;1397;690;707;2021
45;Toledo;063;Espinoso del Rey;435;252;183;2021
45;Toledo;064;Esquivias;5747;2919;2828;2021
45;Toledo;065;Estrella, La;205;109;96;2021
45;Toledo;066;Fuensalida;11785;5961;5824;2021
45;Toledo;067;Gálvez;3015;1519;1496;2021
45;Toledo;068;Garciotum;206;109;97;2021
45;Toledo;069;Gerindote;2395;1203;1192;2021
45;Toledo;070;Guadamur;1806;902;904;2021
45;Toledo;071;Guardia, La;2226;1131;1095;2021
45;Toledo;072;Herencias, Las;742;402;340;2021
45;Toledo;073;Herreruela de Oropesa;306;157;149;2021
45;Toledo;074;Hinojosa de San Vicente;411;228;183;2021
45;Toledo;075;Hontanar;137;82;55;2021
45;Toledo;076;Hormigos;806;454;352;2021
45;Toledo;077;Huecas;773;399;374;2021
45;Toledo;078;Huerta de Valdecarábanos;1683;842;841;2021
45;Toledo;079;Iglesuela del Tiétar, La;461;249;212;2021
45;Toledo;080;Illán de Vacas;3;3;0;2021
45;Toledo;081;Illescas;30229;15247;14982;2021
45;Toledo;082;Lagartera;1331;669;662;2021
45;Toledo;083;Layos;810;397;413;2021
45;Toledo;084;Lillo;2574;1338;1236;2021
45;Toledo;085;Lominchar;2527;1328;1199;2021
45;Toledo;086;Lucillos;591;314;277;2021
45;Toledo;087;Madridejos;10230;5090;5140;2021
45;Toledo;088;Magán;3894;1970;1924;2021
45;Toledo;089;Malpica de Tajo;1709;880;829;2021
45;Toledo;090;Manzaneque;376;184;192;2021
45;Toledo;091;Maqueda;451;227;224;2021
45;Toledo;092;Marjaliza;263;136;127;2021
45;Toledo;093;Marrupe;154;79;75;2021
45;Toledo;094;Mascaraque;413;208;205;2021
45;Toledo;095;Mata, La;823;408;415;2021
45;Toledo;096;Mazarambroz;1258;650;608;2021
45;Toledo;097;Mejorada;1293;667;626;2021
45;Toledo;098;Menasalbas;2544;1327;1217;2021
45;Toledo;099;Méntrida;5662;2900;2762;2021
45;Toledo;100;Mesegar de Tajo;206;111;95;2021
45;Toledo;101;Miguel Esteban;4809;2410;2399;2021
45;Toledo;102;Mocejón;5009;2512;2497;2021
45;Toledo;103;Mohedas de la Jara;399;218;181;2021
45;Toledo;104;Montearagón;522;273;249;2021
45;Toledo;105;Montesclaros;389;203;186;2021
45;Toledo;106;Mora;9781;4902;4879;2021
45;Toledo;107;Nambroca;4954;2530;2424;2021
45;Toledo;108;Nava de Ricomalillo, La;521;276;245;2021
45;Toledo;109;Navahermosa;3600;1878;1722;2021
45;Toledo;110;Navalcán;1925;1002;923;2021
45;Toledo;111;Navalmoralejo;56;30;26;2021
45;Toledo;112;Navalmorales, Los;2202;1125;1077;2021
45;Toledo;113;Navalucillos, Los;2011;1026;985;2021
45;Toledo;114;Navamorcuende;611;309;302;2021
45;Toledo;115;Noblejas;3721;1874;1847;2021
45;Toledo;116;Noez;879;437;442;2021
45;Toledo;117;Nombela;877;462;415;2021
45;Toledo;118;Novés;3179;1628;1551;2021
45;Toledo;119;Numancia de la Sagra;5170;2706;2464;2021
45;Toledo;120;Nuño Gómez;137;79;58;2021
45;Toledo;121;Ocaña;13023;6564;6459;2021
45;Toledo;122;Olías del Rey;8225;4179;4046;2021
45;Toledo;123;Ontígola;4743;2523;2220;2021
45;Toledo;124;Orgaz;2625;1311;1314;2021
45;Toledo;125;Oropesa;2626;1260;1366;2021
45;Toledo;126;Otero;310;167;143;2021
45;Toledo;127;Palomeque;1081;582;499;2021
45;Toledo;128;Pantoja;3408;1713;1695;2021
45;Toledo;129;Paredes de Escalona;110;58;52;2021
45;Toledo;130;Parrillas;325;171;154;2021
45;Toledo;131;Pelahustán;345;191;154;2021
45;Toledo;132;Pepino;3060;1570;1490;2021
45;Toledo;133;Polán;3908;1961;1947;2021
45;Toledo;134;Portillo de Toledo;2223;1137;1086;2021
45;Toledo;135;Puebla de Almoradiel, La;5041;2562;2479;2021
45;Toledo;136;Puebla de Montalbán, La;7841;3965;3876;2021
45;Toledo;137;Pueblanueva, La;2169;1103;1066;2021
45;Toledo;138;Puente del Arzobispo, El;1190;593;597;2021
45;Toledo;139;Puerto de San Vicente;145;80;65;2021
45;Toledo;140;Pulgar;1484;755;729;2021
45;Toledo;141;Quero;977;498;479;2021
45;Toledo;142;Quintanar de la Orden;11129;5538;5591;2021
45;Toledo;143;Quismondo;1633;827;806;2021
45;Toledo;144;Real de San Vicente, El;956;512;444;2021
45;Toledo;145;Recas;4536;2487;2049;2021
45;Toledo;146;Retamoso de la Jara;97;53;44;2021
45;Toledo;147;Rielves;768;388;380;2021
45;Toledo;148;Robledo del Mazo;260;144;116;2021
45;Toledo;149;Romeral, El;568;282;286;2021
45;Toledo;150;San Bartolomé de las Abiertas;427;223;204;2021
45;Toledo;151;San Martín de Montalbán;725;366;359;2021
45;Toledo;152;San Martín de Pusa;610;325;285;2021
45;Toledo;153;San Pablo de los Montes;1723;864;859;2021
45;Toledo;154;San Román de los Montes;1969;1023;946;2021
45;Toledo;155;Santa Ana de Pusa;346;198;148;2021
45;Toledo;156;Santa Cruz de la Zarza;4085;2081;2004;2021
45;Toledo;157;Santa Cruz del Retamar;3554;1856;1698;2021
45;Toledo;158;Santa Olalla;3391;1729;1662;2021
45;Toledo;901;Santo Domingo-Caudilla;1094;577;517;2021
45;Toledo;159;Sartajada;97;60;37;2021
45;Toledo;160;Segurilla;1346;680;666;2021
45;Toledo;161;Seseña;27466;14116;13350;2021
45;Toledo;162;Sevilleja de la Jara;640;356;284;2021
45;Toledo;163;Sonseca;11070;5614;5456;2021
45;Toledo;164;Sotillo de las Palomas;191;100;91;2021
45;Toledo;165;Talavera de la Reina;83477;40020;43457;2021
45;Toledo;166;Tembleque;1967;993;974;2021
45;Toledo;167;Toboso, El;1699;853;846;2021
45;Toledo;168;Toledo;85449;40753;44696;2021
45;Toledo;169;Torralba de Oropesa;188;101;87;2021
45;Toledo;171;Torre de Esteban Hambrán, La;1693;848;845;2021
45;Toledo;170;Torrecilla de la Jara;212;117;95;2021
45;Toledo;172;Torrico;696;352;344;2021
45;Toledo;173;Torrijos;13583;6637;6946;2021
45;Toledo;174;Totanés;346;176;170;2021
45;Toledo;175;Turleque;736;369;367;2021
45;Toledo;176;Ugena;5626;2889;2737;2021
45;Toledo;177;Urda;2420;1207;1213;2021
45;Toledo;179;Valdeverdeja;547;271;276;2021
45;Toledo;180;Valmojado;4430;2237;2193;2021
45;Toledo;181;Velada;2905;1492;1413;2021
45;Toledo;182;Ventas con Peña Aguilera, Las;1084;546;538;2021
45;Toledo;183;Ventas de Retamosa, Las;3684;1929;1755;2021
45;Toledo;184;Ventas de San Julián, Las;233;110;123;2021
45;Toledo;186;Villa de Don Fadrique, La;3576;1774;1802;2021
45;Toledo;185;Villacañas;9434;4705;4729;2021
45;Toledo;187;Villafranca de los Caballeros;4866;2435;2431;2021
45;Toledo;188;Villaluenga de la Sagra;4034;2022;2012;2021
45;Toledo;189;Villamiel de Toledo;997;515;482;2021
45;Toledo;190;Villaminaya;513;257;256;2021
45;Toledo;191;Villamuelas;613;322;291;2021
45;Toledo;192;Villanueva de Alcardete;3130;1619;1511;2021
45;Toledo;193;Villanueva de Bogas;694;361;333;2021
45;Toledo;194;Villarejo de Montalbán;73;40;33;2021
45;Toledo;195;Villarrubia de Santiago;2508;1265;1243;2021
45;Toledo;196;Villaseca de la Sagra;1858;941;917;2021
45;Toledo;197;Villasequilla;2593;1326;1267;2021
45;Toledo;198;Villatobas;2570;1325;1245;2021
45;Toledo;199;Viso de San Juan, El;5255;2793;2462;2021
45;Toledo;200;Yébenes, Los;5796;2969;2827;2021
45;Toledo;201;Yeles;5779;3025;2754;2021
45;Toledo;202;Yepes;5302;2710;2592;2021
45;Toledo;203;Yuncler;4344;2244;2100;2021
45;Toledo;204;Yunclillos;789;417;372;2021
45;Toledo;205;Yuncos;10813;5517;5296;2021
46;Valencia/València;001;Ademuz;1027;556;471;2021
46;Valencia/València;002;Ador;1772;931;841;2021
46;Valencia/València;004;Agullent;2369;1184;1185;2021
46;Valencia/València;042;Aielo de Malferit;4592;2320;2272;2021
46;Valencia/València;043;Aielo de Rugat;160;88;72;2021
46;Valencia/València;005;Alaquàs;29649;14501;15148;2021
46;Valencia/València;006;Albaida;5975;2962;3013;2021
46;Valencia/València;007;Albal;16646;8319;8327;2021
46;Valencia/València;008;Albalat de la Ribera;3368;1701;1667;2021
46;Valencia/València;009;Albalat dels Sorells;4110;2014;2096;2021
46;Valencia/València;010;Albalat dels Tarongers;1324;699;625;2021
46;Valencia/València;011;Alberic;10571;5258;5313;2021
46;Valencia/València;012;Alborache;1283;660;623;2021
46;Valencia/València;013;Alboraia/Alboraya;24904;12182;12722;2021
46;Valencia/València;014;Albuixech;4189;2030;2159;2021
46;Valencia/València;016;Alcàntera de Xúquer;1402;701;701;2021
46;Valencia/València;015;Alcàsser;10266;5145;5121;2021
46;Valencia/València;018;Alcublas;610;328;282;2021
46;Valencia/València;020;Alcúdia de Crespins, l';5144;2546;2598;2021
46;Valencia/València;019;Alcúdia, l';12193;5966;6227;2021
46;Valencia/València;021;Aldaia;32313;16121;16192;2021
46;Valencia/València;022;Alfafar;21415;10498;10917;2021
46;Valencia/València;024;Alfara de la Baronia;590;289;301;2021
46;Valencia/València;025;Alfara del Patriarca;3301;1576;1725;2021
46;Valencia/València;026;Alfarp;1564;799;765;2021
46;Valencia/València;027;Alfarrasí;1206;599;607;2021
46;Valencia/València;023;Alfauir;467;244;223;2021
46;Valencia/València;028;Algar de Palancia;499;254;245;2021
46;Valencia/València;029;Algemesí;27305;13532;13773;2021
46;Valencia/València;030;Algímia d'Alfara;1079;535;544;2021
46;Valencia/València;031;Alginet;13942;7056;6886;2021
46;Valencia/València;032;Almàssera;7433;3619;3814;2021
46;Valencia/València;033;Almiserà;264;136;128;2021
46;Valencia/València;034;Almoines;2528;1263;1265;2021
46;Valencia/València;035;Almussafes;8984;4493;4491;2021
46;Valencia/València;036;Alpuente;659;359;300;2021
46;Valencia/València;037;Alqueria de la Comtessa, l';1481;715;766;2021
46;Valencia/València;017;Alzira;44865;21930;22935;2021
46;Valencia/València;038;Andilla;315;200;115;2021
46;Valencia/València;039;Anna;2627;1327;1300;2021
46;Valencia/València;040;Antella;1127;542;585;2021
46;Valencia/València;041;Aras de los Olmos;374;215;159;2021
46;Valencia/València;003;Atzeneta d'Albaida;1139;575;564;2021
46;Valencia/València;044;Ayora;5215;2582;2633;2021
46;Valencia/València;046;Barx;1354;703;651;2021
46;Valencia/València;045;Barxeta;1604;821;783;2021
46;Valencia/València;047;Bèlgida;654;320;334;2021
46;Valencia/València;048;Bellreguard;4632;2298;2334;2021
46;Valencia/València;049;Bellús;311;161;150;2021
46;Valencia/València;050;Benagéber;184;103;81;2021
46;Valencia/València;051;Benaguasil;11369;5831;5538;2021
46;Valencia/València;052;Benavites;653;314;339;2021
46;Valencia/València;053;Beneixida;639;307;332;2021
46;Valencia/València;054;Benetússer;15430;7511;7919;2021
46;Valencia/València;055;Beniarjó;1780;891;889;2021
46;Valencia/València;056;Beniatjar;207;113;94;2021
46;Valencia/València;057;Benicolet;587;284;303;2021
46;Valencia/València;904;Benicull de Xúquer;1095;561;534;2021
46;Valencia/València;060;Benifaió;11967;5918;6049;2021
46;Valencia/València;059;Benifairó de la Valldigna;1542;772;770;2021
46;Valencia/València;058;Benifairó de les Valls;2268;1119;1149;2021
46;Valencia/València;061;Beniflá;463;229;234;2021
46;Valencia/València;062;Benigànim;5742;2917;2825;2021
46;Valencia/València;063;Benimodo;2253;1146;1107;2021
46;Valencia/València;064;Benimuslem;653;348;305;2021
46;Valencia/València;065;Beniparrell;2024;1025;999;2021
46;Valencia/València;066;Benirredrà;1547;743;804;2021
46;Valencia/València;067;Benissanó;2334;1154;1180;2021
46;Valencia/València;068;Benissoda;441;243;198;2021
46;Valencia/València;069;Benissuera;183;86;97;2021
46;Valencia/València;070;Bétera;25423;12655;12768;2021
46;Valencia/València;071;Bicorp;527;249;278;2021
46;Valencia/València;072;Bocairent;4101;2068;2033;2021
46;Valencia/València;073;Bolbaite;1336;674;662;2021
46;Valencia/València;074;Bonrepòs i Mirambell;3780;1852;1928;2021
46;Valencia/València;075;Bufali;163;90;73;2021
46;Valencia/València;076;Bugarra;728;368;360;2021
46;Valencia/València;077;Buñol;9438;4719;4719;2021
46;Valencia/València;078;Burjassot;38712;18672;20040;2021
46;Valencia/València;079;Calles;368;212;156;2021
46;Valencia/València;080;Camporrobles;1204;616;588;2021
46;Valencia/València;081;Canals;13257;6636;6621;2021
46;Valencia/València;082;Canet d'En Berenguer;6812;3468;3344;2021
46;Valencia/València;083;Carcaixent;20494;10163;10331;2021
46;Valencia/València;084;Càrcer;1822;873;949;2021
46;Valencia/València;085;Carlet;15851;7947;7904;2021
46;Valencia/València;086;Carrícola;102;49;53;2021
46;Valencia/València;087;Casas Altas;132;70;62;2021
46;Valencia/València;088;Casas Bajas;164;87;77;2021
46;Valencia/València;089;Casinos;2881;1475;1406;2021
46;Valencia/València;257;Castelló;6996;3435;3561;2021
46;Valencia/València;090;Castelló de Rugat;2316;1185;1131;2021
46;Valencia/València;091;Castellonet de la Conquesta;139;76;63;2021
46;Valencia/València;092;Castielfabib;299;160;139;2021
46;Valencia/València;093;Catadau;2846;1431;1415;2021
46;Valencia/València;094;Catarroja;28509;14086;14423;2021
46;Valencia/València;095;Caudete de las Fuentes;701;365;336;2021
46;Valencia/València;096;Cerdà;345;181;164;2021
46;Valencia/València;107;Chella;2437;1209;1228;2021
46;Valencia/València;106;Chelva;1583;805;778;2021
46;Valencia/València;108;Chera;490;264;226;2021
46;Valencia/València;109;Cheste;8871;4545;4326;2021
46;Valencia/València;111;Chiva;15769;8063;7706;2021
46;Valencia/València;112;Chulilla;700;375;325;2021
46;Valencia/València;097;Cofrentes;1122;565;557;2021
46;Valencia/València;098;Corbera;3088;1545;1543;2021
46;Valencia/València;099;Cortes de Pallás;758;423;335;2021
46;Valencia/València;100;Cotes;326;164;162;2021
46;Valencia/València;105;Cullera;22708;11428;11280;2021
46;Valencia/València;113;Daimús;3277;1623;1654;2021
46;Valencia/València;114;Domeño;670;330;340;2021
46;Valencia/València;115;Dos Aguas;312;177;135;2021
46;Valencia/València;116;Eliana, l';18302;8975;9327;2021
46;Valencia/València;117;Emperador;698;357;341;2021
46;Valencia/València;118;Enguera;4779;2398;2381;2021
46;Valencia/València;119;Ènova, l';912;471;441;2021
46;Valencia/València;120;Estivella;1491;726;765;2021
46;Valencia/València;121;Estubeny;114;56;58;2021
46;Valencia/València;122;Faura;3563;1786;1777;2021
46;Valencia/València;123;Favara;2563;1310;1253;2021
46;Valencia/València;126;Foios;7502;3698;3804;2021
46;Valencia/València;128;Font de la Figuera, la;2025;1028;997;2021
46;Valencia/València;127;Font d'En Carròs, la;3793;1891;1902;2021
46;Valencia/València;124;Fontanars dels Alforins;959;499;460;2021
46;Valencia/València;125;Fortaleny;1011;501;510;2021
46;Valencia/València;129;Fuenterrobles;694;385;309;2021
46;Valencia/València;131;Gandia;75970;37304;38666;2021
46;Valencia/València;902;Gátova;419;209;210;2021
46;Valencia/València;130;Gavarda;1035;499;536;2021
46;Valencia/València;132;Genovés, el;2785;1406;1379;2021
46;Valencia/València;133;Gestalgar;541;292;249;2021
46;Valencia/València;134;Gilet;3501;1808;1693;2021
46;Valencia/València;135;Godella;13027;6270;6757;2021
46;Valencia/València;136;Godelleta;3714;1912;1802;2021
46;Valencia/València;137;Granja de la Costera, la;281;143;138;2021
46;Valencia/València;138;Guadasséquies;459;229;230;2021
46;Valencia/València;139;Guadassuar;5938;2886;3052;2021
46;Valencia/València;140;Guardamar de la Safor;547;285;262;2021
46;Valencia/València;141;Higueruelas;524;275;249;2021
46;Valencia/València;142;Jalance;795;417;378;2021
46;Valencia/València;144;Jarafuel;772;409;363;2021
46;Valencia/València;154;Llanera de Ranes;1056;548;508;2021
46;Valencia/València;155;Llaurí;1169;597;572;2021
46;Valencia/València;147;Llíria;23648;11910;11738;2021
46;Valencia/València;152;Llocnou de la Corona;124;69;55;2021
46;Valencia/València;153;Llocnou de Sant Jeroni;557;283;274;2021
46;Valencia/València;151;Llocnou d'En Fenollet;912;475;437;2021
46;Valencia/València;156;Llombai;2651;1324;1327;2021
46;Valencia/València;157;Llosa de Ranes, la;3687;1884;1803;2021
46;Valencia/València;150;Llutxent;2315;1195;1120;2021
46;Valencia/València;148;Loriguilla;2027;1050;977;2021
46;Valencia/València;149;Losa del Obispo;531;265;266;2021
46;Valencia/València;158;Macastre;1338;713;625;2021
46;Valencia/València;159;Manises;31287;15467;15820;2021
46;Valencia/València;160;Manuel;2452;1209;1243;2021
46;Valencia/València;161;Marines;1894;991;903;2021
46;Valencia/València;162;Massalavés;1632;842;790;2021
46;Valencia/València;163;Massalfassar;2574;1284;1290;2021
46;Valencia/València;164;Massamagrell;16132;7985;8147;2021
46;Valencia/València;165;Massanassa;9845;4833;5012;2021
46;Valencia/València;166;Meliana;10926;5377;5549;2021
46;Valencia/València;167;Millares;341;171;170;2021
46;Valencia/València;168;Miramar;2740;1381;1359;2021
46;Valencia/València;169;Mislata;44320;21468;22852;2021
46;Valencia/València;170;Mogente/Moixent;4326;2171;2155;2021
46;Valencia/València;171;Moncada;21875;10672;11203;2021
46;Valencia/València;173;Montaverner;1630;801;829;2021
46;Valencia/València;174;Montesa;1149;581;568;2021
46;Valencia/València;175;Montitxelvo/Montichelvo;588;294;294;2021
46;Valencia/València;176;Montroi/Montroy;3069;1640;1429;2021
46;Valencia/València;172;Montserrat;8655;4476;4179;2021
46;Valencia/València;177;Museros;6618;3409;3209;2021
46;Valencia/València;178;Nàquera/Náquera;7301;3777;3524;2021
46;Valencia/València;179;Navarrés;3004;1495;1509;2021
46;Valencia/València;180;Novelé/Novetlè;853;417;436;2021
46;Valencia/València;181;Oliva;25119;12330;12789;2021
46;Valencia/València;183;Olleria, l';8404;4210;4194;2021
46;Valencia/València;182;Olocau;2028;1078;950;2021
46;Valencia/València;184;Ontinyent;35946;17743;18203;2021
46;Valencia/València;185;Otos;428;215;213;2021
46;Valencia/València;186;Paiporta;26401;13016;13385;2021
46;Valencia/València;187;Palma de Gandía;1660;870;790;2021
46;Valencia/València;188;Palmera;1024;516;508;2021
46;Valencia/València;189;Palomar, el;562;283;279;2021
46;Valencia/València;190;Paterna;71361;35252;36109;2021
46;Valencia/València;191;Pedralba;2852;1511;1341;2021
46;Valencia/València;192;Petrés;1012;507;505;2021
46;Valencia/València;193;Picanya;11692;5774;5918;2021
46;Valencia/València;194;Picassent;21487;10810;10677;2021
46;Valencia/València;195;Piles;2742;1370;1372;2021
46;Valencia/València;196;Pinet;161;78;83;2021
46;Valencia/València;199;Pobla de Farnals, la;8205;4126;4079;2021
46;Valencia/València;202;Pobla de Vallbona, la;25275;12763;12512;2021
46;Valencia/València;200;Pobla del Duc, la;2483;1191;1292;2021
46;Valencia/València;203;Pobla Llarga, la;4440;2228;2212;2021
46;Valencia/València;197;Polinyà de Xúquer;2495;1283;1212;2021
46;Valencia/València;198;Potries;1065;547;518;2021
46;Valencia/València;205;Puçol;19975;9839;10136;2021
46;Valencia/València;201;Puebla de San Miguel;60;38;22;2021
46;Valencia/València;204;Puig de Santa Maria, el;8737;4249;4488;2021
46;Valencia/València;101;Quart de les Valls;1050;500;550;2021
46;Valencia/València;102;Quart de Poblet;25035;12181;12854;2021
46;Valencia/València;103;Quartell;1640;786;854;2021
46;Valencia/València;104;Quatretonda;2146;1069;1077;2021
46;Valencia/València;206;Quesa;669;344;325;2021
46;Valencia/València;207;Rafelbunyol;9351;4594;4757;2021
46;Valencia/València;208;Rafelcofer;1365;664;701;2021
46;Valencia/València;209;Rafelguaraf;2358;1169;1189;2021
46;Valencia/València;210;Ráfol de Salem;449;220;229;2021
46;Valencia/València;212;Real;2250;1165;1085;2021
46;Valencia/València;211;Real de Gandia, el;2551;1285;1266;2021
46;Valencia/València;213;Requena;20235;10085;10150;2021
46;Valencia/València;214;Riba-roja de Túria;22799;11553;11246;2021
46;Valencia/València;215;Riola;1780;896;884;2021
46;Valencia/València;216;Rocafort;7445;3638;3807;2021
46;Valencia/València;217;Rotglà i Corberà;1146;568;578;2021
46;Valencia/València;218;Ròtova;1271;645;626;2021
46;Valencia/València;219;Rugat;180;99;81;2021
46;Valencia/València;220;Sagunto/Sagunt;67043;32822;34221;2021
46;Valencia/València;221;Salem;414;212;202;2021
46;Valencia/València;903;San Antonio de Benagéber;9501;4680;4821;2021
46;Valencia/València;222;Sant Joanet;519;263;256;2021
46;Valencia/València;223;Sedaví;10344;5034;5310;2021
46;Valencia/València;224;Segart;177;92;85;2021
46;Valencia/València;225;Sellent;377;192;185;2021
46;Valencia/València;226;Sempere;26;14;12;2021
46;Valencia/València;227;Senyera;1132;553;579;2021
46;Valencia/València;228;Serra;3326;1705;1621;2021
46;Valencia/València;229;Siete Aguas;1183;617;566;2021
46;Valencia/València;230;Silla;19211;9565;9646;2021
46;Valencia/València;231;Simat de la Valldigna;3286;1635;1651;2021
46;Valencia/València;232;Sinarcas;1109;589;520;2021
46;Valencia/València;233;Sollana;4911;2403;2508;2021
46;Valencia/València;234;Sot de Chera;387;214;173;2021
46;Valencia/València;235;Sueca;27617;13590;14027;2021
46;Valencia/València;236;Sumacàrcer;1072;527;545;2021
46;Valencia/València;237;Tavernes Blanques;9205;4480;4725;2021
46;Valencia/València;238;Tavernes de la Valldigna;17162;8524;8638;2021
46;Valencia/València;239;Teresa de Cofrentes;618;326;292;2021
46;Valencia/València;240;Terrateig;276;144;132;2021
46;Valencia/València;241;Titaguas;470;249;221;2021
46;Valencia/València;242;Torrebaja;403;219;184;2021
46;Valencia/València;243;Torrella;135;75;60;2021
46;Valencia/València;244;Torrent;84025;41389;42636;2021
46;Valencia/València;245;Torres Torres;672;364;308;2021
46;Valencia/València;246;Tous;1284;645;639;2021
46;Valencia/València;247;Tuéjar;1164;615;549;2021
46;Valencia/València;248;Turís;6910;3619;3291;2021
46;Valencia/València;249;Utiel;11478;5712;5766;2021
46;Valencia/València;250;València;789744;374937;414807;2021
46;Valencia/València;251;Vallada;3092;1568;1524;2021
46;Valencia/València;252;Vallanca;136;77;59;2021
46;Valencia/València;253;Vallés;152;81;71;2021
46;Valencia/València;254;Venta del Moro;1194;634;560;2021
46;Valencia/València;255;Vilallonga/Villalonga;4453;2191;2262;2021
46;Valencia/València;256;Vilamarxant;10097;5213;4884;2021
46;Valencia/València;258;Villar del Arzobispo;3578;1811;1767;2021
46;Valencia/València;259;Villargordo del Cabriel;585;296;289;2021
46;Valencia/València;260;Vinalesa;3451;1674;1777;2021
46;Valencia/València;145;Xàtiva;29459;14372;15087;2021
46;Valencia/València;143;Xeraco;5771;2902;2869;2021
46;Valencia/València;146;Xeresa;2256;1155;1101;2021
46;Valencia/València;110;Xirivella;30208;14953;15255;2021
46;Valencia/València;261;Yátova;2112;1094;1018;2021
46;Valencia/València;262;Yesa, La;230;125;105;2021
46;Valencia/València;263;Zarra;364;197;167;2021
47;Valladolid;001;Adalia;52;30;22;2021
47;Valladolid;002;Aguasal;17;11;6;2021
47;Valladolid;003;Aguilar de Campos;257;150;107;2021
47;Valladolid;004;Alaejos;1380;740;640;2021
47;Valladolid;005;Alcazarén;632;338;294;2021
47;Valladolid;006;Aldea de San Miguel;217;123;94;2021
47;Valladolid;007;Aldeamayor de San Martín;5789;3001;2788;2021
47;Valladolid;008;Almenara de Adaja;23;12;11;2021
47;Valladolid;009;Amusquillo;100;61;39;2021
47;Valladolid;010;Arroyo de la Encomienda;20716;10377;10339;2021
47;Valladolid;011;Ataquines;564;309;255;2021
47;Valladolid;012;Bahabón;98;47;51;2021
47;Valladolid;013;Barcial de la Loma;86;48;38;2021
47;Valladolid;014;Barruelo del Valle;47;29;18;2021
47;Valladolid;015;Becilla de Valderaduey;218;122;96;2021
47;Valladolid;016;Benafarces;68;35;33;2021
47;Valladolid;017;Bercero;195;110;85;2021
47;Valladolid;018;Berceruelo;38;23;15;2021
47;Valladolid;019;Berrueces;102;54;48;2021
47;Valladolid;020;Bobadilla del Campo;292;165;127;2021
47;Valladolid;021;Bocigas;80;47;33;2021
47;Valladolid;022;Bocos de Duero;69;32;37;2021
47;Valladolid;023;Boecillo;4219;2147;2072;2021
47;Valladolid;024;Bolaños de Campos;277;159;118;2021
47;Valladolid;025;Brahojos de Medina;106;55;51;2021
47;Valladolid;026;Bustillo de Chaves;63;36;27;2021
47;Valladolid;027;Cabezón de Pisuerga;3747;1907;1840;2021
47;Valladolid;028;Cabezón de Valderaduey;41;24;17;2021
47;Valladolid;029;Cabreros del Monte;63;33;30;2021
47;Valladolid;030;Campaspero;1047;584;463;2021
47;Valladolid;031;Campillo, El;219;126;93;2021
47;Valladolid;032;Camporredondo;153;90;63;2021
47;Valladolid;033;Canalejas de Peñafiel;241;136;105;2021
47;Valladolid;034;Canillas de Esgueva;78;45;33;2021
47;Valladolid;035;Carpio;965;518;447;2021
47;Valladolid;036;Casasola de Arión;235;134;101;2021
47;Valladolid;037;Castrejón de Trabancos;170;85;85;2021
47;Valladolid;038;Castrillo de Duero;103;59;44;2021
47;Valladolid;039;Castrillo-Tejeriego;162;89;73;2021
47;Valladolid;040;Castrobol;54;29;25;2021
47;Valladolid;041;Castrodeza;151;91;60;2021
47;Valladolid;042;Castromembibre;53;38;15;2021
47;Valladolid;043;Castromonte;314;169;145;2021
47;Valladolid;044;Castronuevo de Esgueva;379;204;175;2021
47;Valladolid;045;Castronuño;825;411;414;2021
47;Valladolid;046;Castroponce;148;77;71;2021
47;Valladolid;047;Castroverde de Cerrato;196;126;70;2021
47;Valladolid;048;Ceinos de Campos;209;117;92;2021
47;Valladolid;049;Cervillego de la Cruz;83;51;32;2021
47;Valladolid;050;Cigales;5299;2695;2604;2021
47;Valladolid;051;Ciguñuela;375;195;180;2021
47;Valladolid;052;Cistérniga;9109;4604;4505;2021
47;Valladolid;053;Cogeces de Íscar;142;70;72;2021
47;Valladolid;054;Cogeces del Monte;637;339;298;2021
47;Valladolid;055;Corcos;203;114;89;2021
47;Valladolid;056;Corrales de Duero;109;63;46;2021
47;Valladolid;057;Cubillas de Santa Marta;352;202;150;2021
47;Valladolid;058;Cuenca de Campos;208;108;100;2021
47;Valladolid;059;Curiel de Duero;118;77;41;2021
47;Valladolid;060;Encinas de Esgueva;221;126;95;2021
47;Valladolid;061;Esguevillas de Esgueva;269;148;121;2021
47;Valladolid;062;Fombellida;166;94;72;2021
47;Valladolid;063;Fompedraza;103;55;48;2021
47;Valladolid;064;Fontihoyuelo;36;20;16;2021
47;Valladolid;065;Fresno el Viejo;848;457;391;2021
47;Valladolid;066;Fuensaldaña;1996;1027;969;2021
47;Valladolid;067;Fuente el Sol;148;78;70;2021
47;Valladolid;068;Fuente-Olmedo;34;17;17;2021
47;Valladolid;069;Gallegos de Hornija;111;56;55;2021
47;Valladolid;070;Gatón de Campos;27;15;12;2021
47;Valladolid;071;Geria;512;239;273;2021
47;Valladolid;073;Herrín de Campos;119;64;55;2021
47;Valladolid;074;Hornillos de Eresma;174;95;79;2021
47;Valladolid;075;Íscar;6298;3164;3134;2021
47;Valladolid;076;Laguna de Duero;22633;11260;11373;2021
47;Valladolid;077;Langayo;242;152;90;2021
47;Valladolid;079;Llano de Olmedo;59;30;29;2021
47;Valladolid;078;Lomoviejo;178;97;81;2021
47;Valladolid;080;Manzanillo;49;26;23;2021
47;Valladolid;081;Marzales;43;20;23;2021
47;Valladolid;082;Matapozuelos;1039;522;517;2021
47;Valladolid;083;Matilla de los Caños;94;48;46;2021
47;Valladolid;084;Mayorga;1471;731;740;2021
47;Valladolid;086;Medina de Rioseco;4550;2235;2315;2021
47;Valladolid;085;Medina del Campo;20271;9862;10409;2021
47;Valladolid;087;Megeces;433;232;201;2021
47;Valladolid;088;Melgar de Abajo;120;64;56;2021
47;Valladolid;089;Melgar de Arriba;153;85;68;2021
47;Valladolid;090;Mojados;3311;1733;1578;2021
47;Valladolid;091;Monasterio de Vega;79;43;36;2021
47;Valladolid;092;Montealegre de Campos;103;60;43;2021
47;Valladolid;093;Montemayor de Pililla;852;463;389;2021
47;Valladolid;094;Moral de la Reina;150;83;67;2021
47;Valladolid;095;Moraleja de las Panaderas;47;25;22;2021
47;Valladolid;096;Morales de Campos;141;73;68;2021
47;Valladolid;097;Mota del Marqués;349;189;160;2021
47;Valladolid;098;Mucientes;642;322;320;2021
47;Valladolid;099;Mudarra, La;156;80;76;2021
47;Valladolid;100;Muriel;117;60;57;2021
47;Valladolid;101;Nava del Rey;1968;1016;952;2021
47;Valladolid;102;Nueva Villa de las Torres;276;161;115;2021
47;Valladolid;103;Olivares de Duero;313;180;133;2021
47;Valladolid;104;Olmedo;3574;1778;1796;2021
47;Valladolid;105;Olmos de Esgueva;185;101;84;2021
47;Valladolid;106;Olmos de Peñafiel;53;30;23;2021
47;Valladolid;109;Palazuelo de Vedija;174;88;86;2021
47;Valladolid;110;Parrilla, La;482;242;240;2021
47;Valladolid;111;Pedraja de Portillo, La;1122;577;545;2021
47;Valladolid;112;Pedrajas de San Esteban;3334;1694;1640;2021
47;Valladolid;113;Pedrosa del Rey;155;84;71;2021
47;Valladolid;114;Peñafiel;5068;2560;2508;2021
47;Valladolid;115;Peñaflor de Hornija;330;179;151;2021
47;Valladolid;116;Pesquera de Duero;434;234;200;2021
47;Valladolid;117;Piña de Esgueva;318;165;153;2021
47;Valladolid;118;Piñel de Abajo;172;97;75;2021
47;Valladolid;119;Piñel de Arriba;92;49;43;2021
47;Valladolid;121;Pollos;611;343;268;2021
47;Valladolid;122;Portillo;2383;1232;1151;2021
47;Valladolid;123;Pozal de Gallinas;537;296;241;2021
47;Valladolid;124;Pozaldez;473;251;222;2021
47;Valladolid;125;Pozuelo de la Orden;45;27;18;2021
47;Valladolid;126;Puras;42;23;19;2021
47;Valladolid;127;Quintanilla de Arriba;160;89;71;2021
47;Valladolid;129;Quintanilla de Onésimo;1031;550;481;2021
47;Valladolid;130;Quintanilla de Trigueros;105;50;55;2021
47;Valladolid;128;Quintanilla del Molar;57;28;29;2021
47;Valladolid;131;Rábano;169;89;80;2021
47;Valladolid;132;Ramiro;49;27;22;2021
47;Valladolid;133;Renedo de Esgueva;3875;1984;1891;2021
47;Valladolid;134;Roales de Campos;160;88;72;2021
47;Valladolid;135;Robladillo;89;52;37;2021
47;Valladolid;137;Roturas;29;18;11;2021
47;Valladolid;138;Rubí de Bracamonte;215;123;92;2021
47;Valladolid;139;Rueda;1204;632;572;2021
47;Valladolid;140;Saelices de Mayorga;113;69;44;2021
47;Valladolid;141;Salvador de Zapardiel;110;64;46;2021
47;Valladolid;142;San Cebrián de Mazote;122;71;51;2021
47;Valladolid;143;San Llorente;110;63;47;2021
47;Valladolid;144;San Martín de Valvení;80;43;37;2021
47;Valladolid;145;San Miguel del Arroyo;658;351;307;2021
47;Valladolid;146;San Miguel del Pino;350;180;170;2021
47;Valladolid;147;San Pablo de la Moraleja;108;59;49;2021
47;Valladolid;148;San Pedro de Latarce;461;248;213;2021
47;Valladolid;149;San Pelayo;48;23;25;2021
47;Valladolid;150;San Román de Hornija;303;141;162;2021
47;Valladolid;151;San Salvador;24;14;10;2021
47;Valladolid;156;San Vicente del Palacio;160;86;74;2021
47;Valladolid;152;Santa Eufemia del Arroyo;71;38;33;2021
47;Valladolid;153;Santervás de Campos;110;62;48;2021
47;Valladolid;154;Santibáñez de Valcorba;181;105;76;2021
47;Valladolid;155;Santovenia de Pisuerga;4604;2353;2251;2021
47;Valladolid;157;Sardón de Duero;602;319;283;2021
47;Valladolid;158;Seca, La;1066;556;510;2021
47;Valladolid;159;Serrada;1111;576;535;2021
47;Valladolid;160;Siete Iglesias de Trabancos;427;228;199;2021
47;Valladolid;161;Simancas;5315;2707;2608;2021
47;Valladolid;162;Tamariz de Campos;68;41;27;2021
47;Valladolid;163;Tiedra;285;140;145;2021
47;Valladolid;164;Tordehumos;406;217;189;2021
47;Valladolid;165;Tordesillas;8762;4436;4326;2021
47;Valladolid;169;Torre de Esgueva;66;36;30;2021
47;Valladolid;170;Torre de Peñafiel;45;28;17;2021
47;Valladolid;166;Torrecilla de la Abadesa;270;127;143;2021
47;Valladolid;167;Torrecilla de la Orden;240;119;121;2021
47;Valladolid;168;Torrecilla de la Torre;36;23;13;2021
47;Valladolid;171;Torrelobatón;390;203;187;2021
47;Valladolid;172;Torrescárcela;168;87;81;2021
47;Valladolid;173;Traspinedo;1149;606;543;2021
47;Valladolid;174;Trigueros del Valle;309;169;140;2021
47;Valladolid;175;Tudela de Duero;8648;4396;4252;2021
47;Valladolid;176;Unión de Campos, La;216;107;109;2021
47;Valladolid;177;Urones de Castroponce;108;67;41;2021
47;Valladolid;178;Urueña;191;105;86;2021
47;Valladolid;179;Valbuena de Duero;436;244;192;2021
47;Valladolid;180;Valdearcos de la Vega;52;28;24;2021
47;Valladolid;181;Valdenebro de los Valles;193;104;89;2021
47;Valladolid;182;Valdestillas;1607;825;782;2021
47;Valladolid;183;Valdunquillo;138;65;73;2021
47;Valladolid;186;Valladolid;297775;139534;158241;2021
47;Valladolid;184;Valoria la Buena;678;373;305;2021
47;Valladolid;185;Valverde de Campos;88;52;36;2021
47;Valladolid;187;Vega de Ruiponce;85;51;34;2021
47;Valladolid;188;Vega de Valdetronco;96;53;43;2021
47;Valladolid;189;Velascálvaro;168;90;78;2021
47;Valladolid;190;Velilla;115;58;57;2021
47;Valladolid;191;Velliza;118;77;41;2021
47;Valladolid;192;Ventosa de la Cuesta;98;57;41;2021
47;Valladolid;193;Viana de Cega;2160;1126;1034;2021
47;Valladolid;195;Villabáñez;492;266;226;2021
47;Valladolid;196;Villabaruz de Campos;26;11;15;2021
47;Valladolid;197;Villabrágima;1044;557;487;2021
47;Valladolid;198;Villacarralón;72;45;27;2021
47;Valladolid;199;Villacid de Campos;81;49;32;2021
47;Valladolid;200;Villaco;75;47;28;2021
47;Valladolid;203;Villafrades de Campos;61;31;30;2021
47;Valladolid;204;Villafranca de Duero;268;138;130;2021
47;Valladolid;205;Villafrechós;462;257;205;2021
47;Valladolid;206;Villafuerte;86;51;35;2021
47;Valladolid;207;Villagarcía de Campos;282;169;113;2021
47;Valladolid;208;Villagómez la Nueva;63;34;29;2021
47;Valladolid;209;Villalán de Campos;35;22;13;2021
47;Valladolid;210;Villalar de los Comuneros;473;229;244;2021
47;Valladolid;211;Villalba de la Loma;46;24;22;2021
47;Valladolid;212;Villalba de los Alcores;370;201;169;2021
47;Valladolid;213;Villalbarba;109;55;54;2021
47;Valladolid;214;Villalón de Campos;1526;751;775;2021
47;Valladolid;215;Villamuriel de Campos;49;25;24;2021
47;Valladolid;216;Villán de Tordesillas;123;69;54;2021
47;Valladolid;217;Villanubla;2828;1451;1377;2021
47;Valladolid;218;Villanueva de Duero;1227;647;580;2021
47;Valladolid;219;Villanueva de la Condesa;58;28;30;2021
47;Valladolid;220;Villanueva de los Caballeros;178;93;85;2021
47;Valladolid;221;Villanueva de los Infantes;105;62;43;2021
47;Valladolid;222;Villanueva de San Mancio;89;52;37;2021
47;Valladolid;223;Villardefrades;153;88;65;2021
47;Valladolid;224;Villarmentero de Esgueva;102;56;46;2021
47;Valladolid;225;Villasexmir;73;43;30;2021
47;Valladolid;226;Villavaquerín;162;90;72;2021
47;Valladolid;227;Villavellid;51;31;20;2021
47;Valladolid;228;Villaverde de Medina;518;275;243;2021
47;Valladolid;229;Villavicencio de los Caballeros;233;123;110;2021
47;Valladolid;194;Viloria;348;183;165;2021
47;Valladolid;230;Wamba;307;166;141;2021
47;Valladolid;231;Zaratán;6249;3203;3046;2021
47;Valladolid;232;Zarza, La;118;63;55;2021
49;Zamora;002;Abezames;58;29;29;2021
49;Zamora;003;Alcañices;1042;553;489;2021
49;Zamora;004;Alcubilla de Nogales;117;63;54;2021
49;Zamora;005;Alfaraz de Sayago;137;80;57;2021
49;Zamora;006;Algodre;135;73;62;2021
49;Zamora;007;Almaraz de Duero;407;212;195;2021
49;Zamora;008;Almeida de Sayago;423;231;192;2021
49;Zamora;009;Andavías;449;225;224;2021
49;Zamora;010;Arcenillas;429;223;206;2021
49;Zamora;011;Arcos de la Polvorosa;218;120;98;2021
49;Zamora;012;Argañín;72;36;36;2021
49;Zamora;013;Argujillo;224;116;108;2021
49;Zamora;014;Arquillinos;120;62;58;2021
49;Zamora;015;Arrabalde;218;113;105;2021
49;Zamora;016;Aspariegos;234;104;130;2021
49;Zamora;017;Asturianos;260;136;124;2021
49;Zamora;018;Ayoó de Vidriales;287;142;145;2021
49;Zamora;019;Barcial del Barco;241;127;114;2021
49;Zamora;020;Belver de los Montes;263;145;118;2021
49;Zamora;021;Benavente;17523;8428;9095;2021
49;Zamora;022;Benegiles;302;163;139;2021
49;Zamora;023;Bermillo de Sayago;1008;533;475;2021
49;Zamora;024;Bóveda de Toro, La;692;345;347;2021
49;Zamora;025;Bretó;160;91;69;2021
49;Zamora;026;Bretocino;207;110;97;2021
49;Zamora;027;Brime de Sog;128;61;67;2021
49;Zamora;028;Brime de Urz;98;61;37;2021
49;Zamora;029;Burganes de Valverde;639;338;301;2021
49;Zamora;030;Bustillo del Oro;81;45;36;2021
49;Zamora;031;Cabañas de Sayago;152;83;69;2021
49;Zamora;032;Calzadilla de Tera;289;147;142;2021
49;Zamora;033;Camarzana de Tera;767;388;379;2021
49;Zamora;034;Cañizal;428;227;201;2021
49;Zamora;035;Cañizo;220;121;99;2021
49;Zamora;036;Carbajales de Alba;491;250;241;2021
49;Zamora;037;Carbellino;175;93;82;2021
49;Zamora;038;Casaseca de Campeán;103;60;43;2021
49;Zamora;039;Casaseca de las Chanas;373;194;179;2021
49;Zamora;040;Castrillo de la Guareña;116;62;54;2021
49;Zamora;041;Castrogonzalo;456;248;208;2021
49;Zamora;042;Castronuevo;220;109;111;2021
49;Zamora;043;Castroverde de Campos;270;147;123;2021
49;Zamora;044;Cazurra;73;37;36;2021
49;Zamora;046;Cerecinos de Campos;247;137;110;2021
49;Zamora;047;Cerecinos del Carrizal;112;65;47;2021
49;Zamora;048;Cernadilla;113;57;56;2021
49;Zamora;050;Cobreros;552;304;248;2021
49;Zamora;052;Coomonte;198;111;87;2021
49;Zamora;053;Coreses;1059;547;512;2021
49;Zamora;054;Corrales del Vino;934;460;474;2021
49;Zamora;055;Cotanes del Monte;96;53;43;2021
49;Zamora;056;Cubillos;304;147;157;2021
49;Zamora;057;Cubo de Benavente;120;63;57;2021
49;Zamora;058;Cubo de Tierra del Vino, El;314;166;148;2021
49;Zamora;059;Cuelgamures;83;52;31;2021
49;Zamora;061;Entrala;147;80;67;2021
49;Zamora;062;Espadañedo;109;57;52;2021
49;Zamora;063;Faramontanos de Tábara;332;169;163;2021
49;Zamora;064;Fariza;489;252;237;2021
49;Zamora;065;Fermoselle;1136;576;560;2021
49;Zamora;066;Ferreras de Abajo;494;245;249;2021
49;Zamora;067;Ferreras de Arriba;350;193;157;2021
49;Zamora;068;Ferreruela;441;245;196;2021
49;Zamora;069;Figueruela de Arriba;317;151;166;2021
49;Zamora;071;Fonfría;744;392;352;2021
49;Zamora;075;Fresno de la Polvorosa;124;68;56;2021
49;Zamora;076;Fresno de la Ribera;362;187;175;2021
49;Zamora;077;Fresno de Sayago;159;80;79;2021
49;Zamora;078;Friera de Valverde;142;77;65;2021
49;Zamora;079;Fuente Encalada;103;56;47;2021
49;Zamora;080;Fuentelapeña;667;356;311;2021
49;Zamora;082;Fuentes de Ropel;372;198;174;2021
49;Zamora;081;Fuentesaúco;1608;816;792;2021
49;Zamora;083;Fuentesecas;44;23;21;2021
49;Zamora;084;Fuentespreadas;278;150;128;2021
49;Zamora;085;Galende;960;481;479;2021
49;Zamora;086;Gallegos del Pan;109;63;46;2021
49;Zamora;087;Gallegos del Río;464;260;204;2021
49;Zamora;088;Gamones;93;54;39;2021
49;Zamora;090;Gema;204;104;100;2021
49;Zamora;091;Granja de Moreruela;265;136;129;2021
49;Zamora;092;Granucillo;117;59;58;2021
49;Zamora;093;Guarrate;321;166;155;2021
49;Zamora;094;Hermisende;214;110;104;2021
49;Zamora;095;Hiniesta, La;304;161;143;2021
49;Zamora;096;Jambrina;149;81;68;2021
49;Zamora;097;Justel;70;47;23;2021
49;Zamora;098;Losacino;208;117;91;2021
49;Zamora;099;Losacio;90;54;36;2021
49;Zamora;100;Lubián;306;160;146;2021
49;Zamora;101;Luelmo;145;80;65;2021
49;Zamora;102;Maderal, El;177;93;84;2021
49;Zamora;103;Madridanos;455;239;216;2021
49;Zamora;104;Mahide;298;169;129;2021
49;Zamora;105;Maire de Castroponce;140;75;65;2021
49;Zamora;107;Malva;117;53;64;2021
49;Zamora;108;Manganeses de la Lampreana;448;231;217;2021
49;Zamora;109;Manganeses de la Polvorosa;627;303;324;2021
49;Zamora;110;Manzanal de Arriba;346;186;160;2021
49;Zamora;112;Manzanal de los Infantes;125;70;55;2021
49;Zamora;111;Manzanal del Barco;130;68;62;2021
49;Zamora;113;Matilla de Arzón;164;98;66;2021
49;Zamora;114;Matilla la Seca;39;22;17;2021
49;Zamora;115;Mayalde;176;99;77;2021
49;Zamora;116;Melgar de Tera;360;189;171;2021
49;Zamora;117;Micereces de Tera;443;227;216;2021
49;Zamora;118;Milles de la Polvorosa;208;116;92;2021
49;Zamora;119;Molacillos;239;130;109;2021
49;Zamora;120;Molezuelas de la Carballeda;46;25;21;2021
49;Zamora;121;Mombuey;407;218;189;2021
49;Zamora;122;Monfarracinos;971;510;461;2021
49;Zamora;123;Montamarta;559;296;263;2021
49;Zamora;124;Moral de Sayago;259;149;110;2021
49;Zamora;126;Moraleja de Sayago;283;143;140;2021
49;Zamora;125;Moraleja del Vino;1740;877;863;2021
49;Zamora;128;Morales de Rey;570;286;284;2021
49;Zamora;129;Morales de Toro;940;489;451;2021
49;Zamora;130;Morales de Valverde;155;79;76;2021
49;Zamora;127;Morales del Vino;3030;1582;1448;2021
49;Zamora;131;Moralina;232;120;112;2021
49;Zamora;132;Moreruela de los Infanzones;334;175;159;2021
49;Zamora;133;Moreruela de Tábara;310;164;146;2021
49;Zamora;134;Muelas de los Caballeros;171;99;72;2021
49;Zamora;135;Muelas del Pan;607;322;285;2021
49;Zamora;136;Muga de Sayago;350;169;181;2021
49;Zamora;137;Navianos de Valverde;176;103;73;2021
49;Zamora;138;Olmillos de Castro;208;112;96;2021
49;Zamora;139;Otero de Bodas;151;80;71;2021
49;Zamora;141;Pajares de la Lampreana;298;155;143;2021
49;Zamora;143;Palacios de Sanabria;225;115;110;2021
49;Zamora;142;Palacios del Pan;246;130;116;2021
49;Zamora;145;Pedralba de la Pradería;199;111;88;2021
49;Zamora;146;Pego, El;272;137;135;2021
49;Zamora;147;Peleagonzalo;274;133;141;2021
49;Zamora;148;Peleas de Abajo;273;125;148;2021
49;Zamora;149;Peñausende;381;199;182;2021
49;Zamora;150;Peque;126;54;72;2021
49;Zamora;151;Perdigón, El;647;341;306;2021
49;Zamora;152;Pereruela;514;280;234;2021
49;Zamora;153;Perilla de Castro;163;90;73;2021
49;Zamora;154;Pías;108;61;47;2021
49;Zamora;155;Piedrahita de Castro;97;54;43;2021
49;Zamora;156;Pinilla de Toro;205;107;98;2021
49;Zamora;157;Pino del Oro;183;96;87;2021
49;Zamora;158;Piñero, El;222;114;108;2021
49;Zamora;160;Pobladura de Valderaduey;39;23;16;2021
49;Zamora;159;Pobladura del Valle;295;157;138;2021
49;Zamora;162;Porto;156;87;69;2021
49;Zamora;163;Pozoantiguo;180;90;90;2021
49;Zamora;164;Pozuelo de Tábara;155;84;71;2021
49;Zamora;165;Prado;48;28;20;2021
49;Zamora;166;Puebla de Sanabria;1366;660;706;2021
49;Zamora;167;Pueblica de Valverde;186;98;88;2021
49;Zamora;170;Quintanilla de Urz;98;47;51;2021
49;Zamora;168;Quintanilla del Monte;104;62;42;2021
49;Zamora;169;Quintanilla del Olmo;42;23;19;2021
49;Zamora;171;Quiruelas de Vidriales;640;341;299;2021
49;Zamora;172;Rabanales;499;263;236;2021
49;Zamora;173;Rábano de Aliste;343;170;173;2021
49;Zamora;174;Requejo;141;73;68;2021
49;Zamora;175;Revellinos;257;135;122;2021
49;Zamora;176;Riofrío de Aliste;629;349;280;2021
49;Zamora;177;Rionegro del Puente;250;130;120;2021
49;Zamora;178;Roales;987;514;473;2021
49;Zamora;179;Robleda-Cervantes;392;209;183;2021
49;Zamora;180;Roelos de Sayago;143;71;72;2021
49;Zamora;181;Rosinos de la Requejada;342;182;160;2021
49;Zamora;183;Salce;89;38;51;2021
49;Zamora;184;Samir de los Caños;169;93;76;2021
49;Zamora;185;San Agustín del Pozo;183;94;89;2021
49;Zamora;186;San Cebrián de Castro;238;115;123;2021
49;Zamora;187;San Cristóbal de Entreviñas;1362;720;642;2021
49;Zamora;188;San Esteban del Molar;113;67;46;2021
49;Zamora;189;San Justo;197;106;91;2021
49;Zamora;190;San Martín de Valderaduey;50;27;23;2021
49;Zamora;191;San Miguel de la Ribera;285;144;141;2021
49;Zamora;192;San Miguel del Valle;128;67;61;2021
49;Zamora;193;San Pedro de Ceque;437;230;207;2021
49;Zamora;194;San Pedro de la Nave-Almendra;342;174;168;2021
49;Zamora;208;San Vicente de la Cabeza;350;187;163;2021
49;Zamora;209;San Vitero;473;270;203;2021
49;Zamora;197;Santa Clara de Avedillo;157;76;81;2021
49;Zamora;199;Santa Colomba de las Monjas;246;121;125;2021
49;Zamora;200;Santa Cristina de la Polvorosa;1070;551;519;2021
49;Zamora;201;Santa Croya de Tera;290;149;141;2021
49;Zamora;202;Santa Eufemia del Barco;177;102;75;2021
49;Zamora;203;Santa María de la Vega;289;149;140;2021
49;Zamora;204;Santa María de Valverde;54;27;27;2021
49;Zamora;205;Santibáñez de Tera;369;186;183;2021
49;Zamora;206;Santibáñez de Vidriales;918;464;454;2021
49;Zamora;207;Santovenia;235;121;114;2021
49;Zamora;210;Sanzoles;471;241;230;2021
49;Zamora;214;Tábara;751;372;379;2021
49;Zamora;216;Tapioles;139;80;59;2021
49;Zamora;219;Toro;8532;4198;4334;2021
49;Zamora;220;Torre del Valle, La;138;77;61;2021
49;Zamora;221;Torregamones;237;125;112;2021
49;Zamora;222;Torres del Carrizal;414;210;204;2021
49;Zamora;223;Trabazos;835;446;389;2021
49;Zamora;224;Trefacio;186;102;84;2021
49;Zamora;225;Uña de Quintana;135;72;63;2021
49;Zamora;226;Vadillo de la Guareña;248;134;114;2021
49;Zamora;227;Valcabado;397;204;193;2021
49;Zamora;228;Valdefinjas;57;34;23;2021
49;Zamora;229;Valdescorriel;126;63;63;2021
49;Zamora;230;Vallesa de la Guareña;78;42;36;2021
49;Zamora;231;Vega de Tera;309;152;157;2021
49;Zamora;232;Vega de Villalobos;92;39;53;2021
49;Zamora;233;Vegalatrave;81;43;38;2021
49;Zamora;234;Venialbo;416;225;191;2021
49;Zamora;235;Vezdemarbán;448;233;215;2021
49;Zamora;236;Vidayanes;83;43;40;2021
49;Zamora;237;Videmala;141;73;68;2021
49;Zamora;238;Villabrázaro;228;123;105;2021
49;Zamora;239;Villabuena del Puente;623;327;296;2021
49;Zamora;240;Villadepera;189;103;86;2021
49;Zamora;241;Villaescusa;244;133;111;2021
49;Zamora;242;Villafáfila;475;246;229;2021
49;Zamora;243;Villaferrueña;107;54;53;2021
49;Zamora;244;Villageriz;48;27;21;2021
49;Zamora;245;Villalazán;251;128;123;2021
49;Zamora;246;Villalba de la Lampreana;223;126;97;2021
49;Zamora;247;Villalcampo;405;207;198;2021
49;Zamora;248;Villalobos;227;119;108;2021
49;Zamora;249;Villalonso;68;35;33;2021
49;Zamora;250;Villalpando;1451;715;736;2021
49;Zamora;251;Villalube;161;87;74;2021
49;Zamora;252;Villamayor de Campos;328;167;161;2021
49;Zamora;255;Villamor de los Escuderos;384;202;182;2021
49;Zamora;256;Villanázar;273;141;132;2021
49;Zamora;257;Villanueva de Azoague;360;184;176;2021
49;Zamora;258;Villanueva de Campeán;116;61;55;2021
49;Zamora;259;Villanueva de las Peras;78;37;41;2021
49;Zamora;260;Villanueva del Campo;810;399;411;2021
49;Zamora;263;Villar de Fallaves;44;25;19;2021
49;Zamora;264;Villar del Buey;535;279;256;2021
49;Zamora;261;Villaralbo;1804;909;895;2021
49;Zamora;262;Villardeciervos;403;201;202;2021
49;Zamora;265;Villardiegua de la Ribera;113;64;49;2021
49;Zamora;266;Villárdiga;77;44;33;2021
49;Zamora;267;Villardondiego;101;58;43;2021
49;Zamora;268;Villarrín de Campos;387;204;183;2021
49;Zamora;269;Villaseco del Pan;222;103;119;2021
49;Zamora;270;Villavendimio;160;97;63;2021
49;Zamora;272;Villaveza de Valverde;70;37;33;2021
49;Zamora;271;Villaveza del Agua;179;97;82;2021
49;Zamora;273;Viñas;159;86;73;2021
49;Zamora;275;Zamora;60297;27979;32318;2021
50;Zaragoza;001;Abanto;89;53;36;2021
50;Zaragoza;002;Acered;140;82;58;2021
50;Zaragoza;003;Agón;135;79;56;2021
50;Zaragoza;004;Aguarón;616;327;289;2021
50;Zaragoza;005;Aguilón;234;134;100;2021
50;Zaragoza;006;Ainzón;1067;548;519;2021
50;Zaragoza;007;Aladrén;58;37;21;2021
50;Zaragoza;008;Alagón;7121;3568;3553;2021
50;Zaragoza;009;Alarba;112;64;48;2021
50;Zaragoza;010;Alberite de San Juan;77;46;31;2021
50;Zaragoza;011;Albeta;140;68;72;2021
50;Zaragoza;012;Alborge;111;57;54;2021
50;Zaragoza;013;Alcalá de Ebro;245;121;124;2021
50;Zaragoza;014;Alcalá de Moncayo;153;88;65;2021
50;Zaragoza;015;Alconchel de Ariza;79;45;34;2021
50;Zaragoza;016;Aldehuela de Liestos;52;37;15;2021
50;Zaragoza;017;Alfajarín;2374;1216;1158;2021
50;Zaragoza;018;Alfamén;1446;756;690;2021
50;Zaragoza;019;Alforque;62;36;26;2021
50;Zaragoza;020;Alhama de Aragón;1002;524;478;2021
50;Zaragoza;021;Almochuel;24;13;11;2021
50;Zaragoza;022;Almolda, La;555;276;279;2021
50;Zaragoza;023;Almonacid de la Cuba;234;115;119;2021
50;Zaragoza;024;Almonacid de la Sierra;771;428;343;2021
50;Zaragoza;025;Almunia de Doña Godina, La;7983;4115;3868;2021
50;Zaragoza;026;Alpartir;604;316;288;2021
50;Zaragoza;027;Ambel;252;124;128;2021
50;Zaragoza;028;Anento;91;61;30;2021
50;Zaragoza;029;Aniñón;671;354;317;2021
50;Zaragoza;030;Añón de Moncayo;205;121;84;2021
50;Zaragoza;031;Aranda de Moncayo;140;88;52;2021
50;Zaragoza;032;Arándiga;274;143;131;2021
50;Zaragoza;033;Ardisa;76;48;28;2021
50;Zaragoza;034;Ariza;1068;549;519;2021
50;Zaragoza;035;Artieda;78;46;32;2021
50;Zaragoza;036;Asín;97;54;43;2021
50;Zaragoza;037;Atea;149;90;59;2021
50;Zaragoza;038;Ateca;1729;893;836;2021
50;Zaragoza;039;Azuara;544;311;233;2021
50;Zaragoza;040;Badules;70;37;33;2021
50;Zaragoza;041;Bagüés;16;7;9;2021
50;Zaragoza;042;Balconchán;19;6;13;2021
50;Zaragoza;043;Bárboles;297;164;133;2021
50;Zaragoza;044;Bardallur;254;125;129;2021
50;Zaragoza;045;Belchite;1540;777;763;2021
50;Zaragoza;046;Belmonte de Gracián;194;107;87;2021
50;Zaragoza;047;Berdejo;40;26;14;2021
50;Zaragoza;048;Berrueco;35;21;14;2021
50;Zaragoza;901;Biel;171;102;69;2021
50;Zaragoza;050;Bijuesca;90;62;28;2021
50;Zaragoza;051;Biota;912;465;447;2021
50;Zaragoza;052;Bisimbre;87;47;40;2021
50;Zaragoza;053;Boquiñeni;778;391;387;2021
50;Zaragoza;054;Bordalba;51;32;19;2021
50;Zaragoza;055;Borja;5037;2577;2460;2021
50;Zaragoza;056;Botorrita;516;281;235;2021
50;Zaragoza;057;Brea de Aragón;1559;793;766;2021
50;Zaragoza;058;Bubierca;64;32;32;2021
50;Zaragoza;059;Bujaraloz;975;496;479;2021
50;Zaragoza;060;Bulbuente;233;127;106;2021
50;Zaragoza;061;Bureta;206;107;99;2021
50;Zaragoza;062;Burgo de Ebro, El;2538;1274;1264;2021
50;Zaragoza;063;Buste, El;69;40;29;2021
50;Zaragoza;064;Cabañas de Ebro;487;255;232;2021
50;Zaragoza;065;Cabolafuente;49;29;20;2021
50;Zaragoza;066;Cadrete;4334;2281;2053;2021
50;Zaragoza;067;Calatayud;19870;9778;10092;2021
50;Zaragoza;068;Calatorao;2921;1527;1394;2021
50;Zaragoza;069;Calcena;78;46;32;2021
50;Zaragoza;070;Calmarza;64;36;28;2021
50;Zaragoza;071;Campillo de Aragón;132;78;54;2021
50;Zaragoza;072;Carenas;182;105;77;2021
50;Zaragoza;073;Cariñena;3370;1705;1665;2021
50;Zaragoza;074;Caspe;10183;5401;4782;2021
50;Zaragoza;075;Castejón de Alarba;78;49;29;2021
50;Zaragoza;076;Castejón de las Armas;82;43;39;2021
50;Zaragoza;077;Castejón de Valdejasa;216;104;112;2021
50;Zaragoza;078;Castiliscar;248;131;117;2021
50;Zaragoza;079;Cervera de la Cañada;264;149;115;2021
50;Zaragoza;080;Cerveruela;37;24;13;2021
50;Zaragoza;081;Cetina;578;296;282;2021
50;Zaragoza;092;Chiprana;503;266;237;2021
50;Zaragoza;093;Chodes;100;55;45;2021
50;Zaragoza;082;Cimballa;93;45;48;2021
50;Zaragoza;083;Cinco Olivas;105;51;54;2021
50;Zaragoza;084;Clarés de Ribota;68;38;30;2021
50;Zaragoza;085;Codo;206;109;97;2021
50;Zaragoza;086;Codos;237;155;82;2021
50;Zaragoza;087;Contamina;33;18;15;2021
50;Zaragoza;088;Cosuenda;335;171;164;2021
50;Zaragoza;089;Cuarte de Huerva;13773;7006;6767;2021
50;Zaragoza;090;Cubel;146;68;78;2021
50;Zaragoza;091;Cuerlas, Las;42;22;20;2021
50;Zaragoza;094;Daroca;1914;930;984;2021
50;Zaragoza;095;Ejea de los Caballeros;17036;8758;8278;2021
50;Zaragoza;096;Embid de Ariza;32;18;14;2021
50;Zaragoza;098;Encinacorba;186;100;86;2021
50;Zaragoza;099;Épila;4368;2258;2110;2021
50;Zaragoza;100;Erla;356;181;175;2021
50;Zaragoza;101;Escatrón;1120;556;564;2021
50;Zaragoza;102;Fabara;1096;595;501;2021
50;Zaragoza;104;Farlete;378;187;191;2021
50;Zaragoza;105;Fayón;382;209;173;2021
50;Zaragoza;106;Fayos, Los;134;73;61;2021
50;Zaragoza;107;Figueruelas;1239;618;621;2021
50;Zaragoza;108;Fombuena;59;36;23;2021
50;Zaragoza;109;Frago, El;115;73;42;2021
50;Zaragoza;110;Frasno, El;394;215;179;2021
50;Zaragoza;111;Fréscano;200;111;89;2021
50;Zaragoza;113;Fuendejalón;766;411;355;2021
50;Zaragoza;114;Fuendetodos;142;82;60;2021
50;Zaragoza;115;Fuentes de Ebro;4600;2382;2218;2021
50;Zaragoza;116;Fuentes de Jiloca;211;117;94;2021
50;Zaragoza;117;Gallocanta;128;69;59;2021
50;Zaragoza;118;Gallur;2555;1297;1258;2021
50;Zaragoza;119;Gelsa;997;524;473;2021
50;Zaragoza;120;Godojos;49;27;22;2021
50;Zaragoza;121;Gotor;311;157;154;2021
50;Zaragoza;122;Grisel;83;49;34;2021
50;Zaragoza;123;Grisén;605;318;287;2021
50;Zaragoza;124;Herrera de los Navarros;496;274;222;2021
50;Zaragoza;125;Ibdes;388;198;190;2021
50;Zaragoza;126;Illueca;2778;1387;1391;2021
50;Zaragoza;128;Isuerre;33;17;16;2021
50;Zaragoza;129;Jaraba;282;154;128;2021
50;Zaragoza;130;Jarque de Moncayo;413;216;197;2021
50;Zaragoza;131;Jaulín;275;146;129;2021
50;Zaragoza;132;Joyosa, La;1132;579;553;2021
50;Zaragoza;133;Lagata;114;61;53;2021
50;Zaragoza;134;Langa del Castillo;116;60;56;2021
50;Zaragoza;135;Layana;92;52;40;2021
50;Zaragoza;136;Lécera;642;339;303;2021
50;Zaragoza;138;Lechón;47;28;19;2021
50;Zaragoza;137;Leciñena;1132;579;553;2021
50;Zaragoza;139;Letux;343;184;159;2021
50;Zaragoza;140;Litago;190;112;78;2021
50;Zaragoza;141;Lituénigo;119;63;56;2021
50;Zaragoza;142;Lobera de Onsella;25;13;12;2021
50;Zaragoza;143;Longares;876;532;344;2021
50;Zaragoza;144;Longás;36;24;12;2021
50;Zaragoza;146;Lucena de Jalón;227;124;103;2021
50;Zaragoza;147;Luceni;987;493;494;2021
50;Zaragoza;148;Luesia;342;183;159;2021
50;Zaragoza;149;Luesma;40;23;17;2021
50;Zaragoza;150;Lumpiaque;836;436;400;2021
50;Zaragoza;151;Luna;709;370;339;2021
50;Zaragoza;152;Maella;2062;1118;944;2021
50;Zaragoza;153;Magallón;1133;578;555;2021
50;Zaragoza;154;Mainar;162;88;74;2021
50;Zaragoza;155;Malanquilla;95;60;35;2021
50;Zaragoza;156;Maleján;260;136;124;2021
50;Zaragoza;160;Mallén;2977;1546;1431;2021
50;Zaragoza;157;Malón;371;186;185;2021
50;Zaragoza;159;Maluenda;920;455;465;2021
50;Zaragoza;161;Manchones;104;56;48;2021
50;Zaragoza;162;Mara;167;86;81;2021
50;Zaragoza;163;María de Huerva;6021;3037;2984;2021
50;Zaragoza;902;Marracos;92;49;43;2021
50;Zaragoza;164;Mediana de Aragón;465;230;235;2021
50;Zaragoza;165;Mequinenza;2292;1162;1130;2021
50;Zaragoza;166;Mesones de Isuela;265;135;130;2021
50;Zaragoza;167;Mezalocha;238;136;102;2021
50;Zaragoza;168;Mianos;28;14;14;2021
50;Zaragoza;169;Miedes de Aragón;429;226;203;2021
50;Zaragoza;170;Monegrillo;389;214;175;2021
50;Zaragoza;171;Moneva;121;73;48;2021
50;Zaragoza;172;Monreal de Ariza;193;111;82;2021
50;Zaragoza;173;Monterde;135;87;48;2021
50;Zaragoza;174;Montón;89;53;36;2021
50;Zaragoza;175;Morata de Jalón;1077;537;540;2021
50;Zaragoza;176;Morata de Jiloca;260;149;111;2021
50;Zaragoza;177;Morés;338;181;157;2021
50;Zaragoza;178;Moros;304;157;147;2021
50;Zaragoza;179;Moyuela;262;145;117;2021
50;Zaragoza;180;Mozota;124;62;62;2021
50;Zaragoza;181;Muel;1436;739;697;2021
50;Zaragoza;182;Muela, La;6125;3184;2941;2021
50;Zaragoza;183;Munébrega;360;193;167;2021
50;Zaragoza;184;Murero;97;54;43;2021
50;Zaragoza;185;Murillo de Gállego;187;110;77;2021
50;Zaragoza;186;Navardún;34;21;13;2021
50;Zaragoza;187;Nigüella;62;38;24;2021
50;Zaragoza;188;Nombrevilla;35;20;15;2021
50;Zaragoza;189;Nonaspe;998;541;457;2021
50;Zaragoza;190;Novallas;833;444;389;2021
50;Zaragoza;191;Novillas;502;249;253;2021
50;Zaragoza;192;Nuévalos;297;164;133;2021
50;Zaragoza;193;Nuez de Ebro;880;447;433;2021
50;Zaragoza;194;Olvés;105;59;46;2021
50;Zaragoza;195;Orcajo;58;36;22;2021
50;Zaragoza;196;Orera;116;61;55;2021
50;Zaragoza;197;Orés;107;66;41;2021
50;Zaragoza;198;Oseja;45;29;16;2021
50;Zaragoza;199;Osera de Ebro;395;202;193;2021
50;Zaragoza;200;Paniza;609;325;284;2021
50;Zaragoza;201;Paracuellos de Jiloca;567;296;271;2021
50;Zaragoza;202;Paracuellos de la Ribera;131;71;60;2021
50;Zaragoza;203;Pastriz;1294;628;666;2021
50;Zaragoza;204;Pedrola;3572;1850;1722;2021
50;Zaragoza;205;Pedrosas, Las;96;47;49;2021
50;Zaragoza;206;Perdiguera;567;305;262;2021
50;Zaragoza;207;Piedratajada;93;52;41;2021
50;Zaragoza;208;Pina de Ebro;2390;1224;1166;2021
50;Zaragoza;209;Pinseque;4184;2136;2048;2021
50;Zaragoza;210;Pintanos, Los;38;26;12;2021
50;Zaragoza;211;Plasencia de Jalón;309;173;136;2021
50;Zaragoza;212;Pleitas;33;14;19;2021
50;Zaragoza;213;Plenas;100;54;46;2021
50;Zaragoza;214;Pomer;25;18;7;2021
50;Zaragoza;215;Pozuel de Ariza;17;10;7;2021
50;Zaragoza;216;Pozuelo de Aragón;265;140;125;2021
50;Zaragoza;217;Pradilla de Ebro;534;289;245;2021
50;Zaragoza;218;Puebla de Albortón;125;74;51;2021
50;Zaragoza;219;Puebla de Alfindén, La;6446;3287;3159;2021
50;Zaragoza;220;Puendeluna;49;30;19;2021
50;Zaragoza;221;Purujosa;26;16;10;2021
50;Zaragoza;222;Quinto;1937;981;956;2021
50;Zaragoza;223;Remolinos;1052;536;516;2021
50;Zaragoza;224;Retascón;65;35;30;2021
50;Zaragoza;225;Ricla;2922;1572;1350;2021
50;Zaragoza;227;Romanos;132;67;65;2021
50;Zaragoza;228;Rueda de Jalón;313;170;143;2021
50;Zaragoza;229;Ruesca;76;36;40;2021
50;Zaragoza;241;Sabiñán;686;365;321;2021
50;Zaragoza;230;Sádaba;1294;662;632;2021
50;Zaragoza;231;Salillas de Jalón;338;167;171;2021
50;Zaragoza;232;Salvatierra de Esca;210;106;104;2021
50;Zaragoza;233;Samper del Salz;101;54;47;2021
50;Zaragoza;234;San Martín de la Virgen de Moncayo;276;157;119;2021
50;Zaragoza;235;San Mateo de Gállego;3415;1750;1665;2021
50;Zaragoza;236;Santa Cruz de Grío;102;65;37;2021
50;Zaragoza;237;Santa Cruz de Moncayo;134;72;62;2021
50;Zaragoza;238;Santa Eulalia de Gállego;103;61;42;2021
50;Zaragoza;239;Santed;64;41;23;2021
50;Zaragoza;240;Sástago;1122;568;554;2021
50;Zaragoza;242;Sediles;108;62;46;2021
50;Zaragoza;243;Sestrica;338;192;146;2021
50;Zaragoza;244;Sierra de Luna;285;144;141;2021
50;Zaragoza;245;Sigüés;79;40;39;2021
50;Zaragoza;246;Sisamón;33;22;11;2021
50;Zaragoza;247;Sobradiel;1150;548;602;2021
50;Zaragoza;248;Sos del Rey Católico;574;304;270;2021
50;Zaragoza;249;Tabuenca;320;188;132;2021
50;Zaragoza;250;Talamantes;64;32;32;2021
50;Zaragoza;251;Tarazona;10494;5225;5269;2021
50;Zaragoza;252;Tauste;6777;3398;3379;2021
50;Zaragoza;253;Terrer;530;290;240;2021
50;Zaragoza;254;Tierga;190;103;87;2021
50;Zaragoza;255;Tobed;225;121;104;2021
50;Zaragoza;256;Torralba de los Frailes;74;39;35;2021
50;Zaragoza;257;Torralba de Ribota;163;89;74;2021
50;Zaragoza;258;Torralbilla;59;36;23;2021
50;Zaragoza;259;Torrehermosa;63;33;30;2021
50;Zaragoza;260;Torrelapaja;35;24;11;2021
50;Zaragoza;261;Torrellas;241;123;118;2021
50;Zaragoza;262;Torres de Berrellén;1460;751;709;2021
50;Zaragoza;263;Torrijo de la Cañada;204;120;84;2021
50;Zaragoza;264;Tosos;176;103;73;2021
50;Zaragoza;265;Trasmoz;82;42;40;2021
50;Zaragoza;266;Trasobares;129;77;52;2021
50;Zaragoza;267;Uncastillo;634;300;334;2021
50;Zaragoza;268;Undués de Lerda;56;32;24;2021
50;Zaragoza;269;Urrea de Jalón;447;259;188;2021
50;Zaragoza;270;Urriés;49;24;25;2021
50;Zaragoza;271;Used;271;145;126;2021
50;Zaragoza;272;Utebo;18856;9390;9466;2021
50;Zaragoza;274;Val de San Martín;59;36;23;2021
50;Zaragoza;273;Valdehorna;29;16;13;2021
50;Zaragoza;275;Valmadrid;98;63;35;2021
50;Zaragoza;276;Valpalmas;135;65;70;2021
50;Zaragoza;277;Valtorres;63;30;33;2021
50;Zaragoza;278;Velilla de Ebro;203;109;94;2021
50;Zaragoza;279;Velilla de Jiloca;76;35;41;2021
50;Zaragoza;280;Vera de Moncayo;314;167;147;2021
50;Zaragoza;281;Vierlas;83;45;38;2021
50;Zaragoza;283;Villadoz;90;53;37;2021
50;Zaragoza;284;Villafeliche;147;85;62;2021
50;Zaragoza;285;Villafranca de Ebro;848;429;419;2021
50;Zaragoza;286;Villalba de Perejil;100;51;49;2021
50;Zaragoza;287;Villalengua;291;161;130;2021
50;Zaragoza;903;Villamayor de Gállego;2768;1387;1381;2021
50;Zaragoza;288;Villanueva de Gállego;4725;2366;2359;2021
50;Zaragoza;290;Villanueva de Huerva;412;215;197;2021
50;Zaragoza;289;Villanueva de Jiloca;57;28;29;2021
50;Zaragoza;291;Villar de los Navarros;130;74;56;2021
50;Zaragoza;292;Villarreal de Huerva;272;155;117;2021
50;Zaragoza;293;Villarroya de la Sierra;445;236;209;2021
50;Zaragoza;294;Villarroya del Campo;89;48;41;2021
50;Zaragoza;282;Vilueña, La;71;36;35;2021
50;Zaragoza;295;Vistabella;51;29;22;2021
50;Zaragoza;296;Zaida, La;432;221;211;2021
50;Zaragoza;297;Zaragoza;675301;323111;352190;2021
50;Zaragoza;298;Zuera;8591;4427;4164;2021
02;Albacete;001;Abengibre;739;363;376;2022
02;Albacete;002;Alatoz;496;276;220;2022
02;Albacete;003;Albacete;172357;84230;88127;2022
02;Albacete;004;Albatana;670;342;328;2022
02;Albacete;005;Alborea;663;338;325;2022
02;Albacete;006;Alcadozo;634;343;291;2022
02;Albacete;007;Alcalá del Júcar;1148;622;526;2022
02;Albacete;008;Alcaraz;1307;681;626;2022
02;Albacete;009;Almansa;24224;12024;12200;2022
02;Albacete;010;Alpera;2245;1171;1074;2022
02;Albacete;011;Ayna;582;319;263;2022
02;Albacete;012;Balazote;2388;1227;1161;2022
02;Albacete;014;Ballestero, El;427;222;205;2022
02;Albacete;013;Balsa de Ves;126;74;52;2022
02;Albacete;015;Barrax;1831;943;888;2022
02;Albacete;016;Bienservida;574;312;262;2022
02;Albacete;017;Bogarra;756;393;363;2022
02;Albacete;018;Bonete;1006;532;474;2022
02;Albacete;019;Bonillo, El;2698;1368;1330;2022
02;Albacete;020;Carcelén;483;253;230;2022
02;Albacete;021;Casas de Juan Núñez;1356;731;625;2022
02;Albacete;022;Casas de Lázaro;321;177;144;2022
02;Albacete;023;Casas de Ves;561;296;265;2022
02;Albacete;024;Casas-Ibáñez;4547;2291;2256;2022
02;Albacete;025;Caudete;10135;5167;4968;2022
02;Albacete;026;Cenizate;1183;592;591;2022
02;Albacete;029;Chinchilla de Monte-Aragón;4497;2341;2156;2022
02;Albacete;027;Corral-Rubio;300;160;140;2022
02;Albacete;028;Cotillas;129;72;57;2022
02;Albacete;030;Elche de la Sierra;3553;1743;1810;2022
02;Albacete;031;Férez;614;310;304;2022
02;Albacete;032;Fuensanta;281;154;127;2022
02;Albacete;033;Fuente-Álamo;2461;1286;1175;2022
02;Albacete;034;Fuentealbilla;1821;938;883;2022
02;Albacete;035;Gineta, La;2568;1338;1230;2022
02;Albacete;036;Golosalvo;98;52;46;2022
02;Albacete;037;Hellín;30492;15323;15169;2022
02;Albacete;038;Herrera, La;304;162;142;2022
02;Albacete;039;Higueruela;1125;585;540;2022
02;Albacete;040;Hoya-Gonzalo;561;304;257;2022
02;Albacete;041;Jorquera;350;194;156;2022
02;Albacete;042;Letur;901;445;456;2022
02;Albacete;043;Lezuza;1300;675;625;2022
02;Albacete;044;Liétor;1096;568;528;2022
02;Albacete;045;Madrigueras;4644;2379;2265;2022
02;Albacete;046;Mahora;1430;737;693;2022
02;Albacete;047;Masegoso;114;66;48;2022
02;Albacete;048;Minaya;1442;738;704;2022
02;Albacete;049;Molinicos;837;430;407;2022
02;Albacete;050;Montalvos;88;51;37;2022
02;Albacete;051;Montealegre del Castillo;2056;1066;990;2022
02;Albacete;052;Motilleja;660;360;300;2022
02;Albacete;053;Munera;3422;1751;1671;2022
02;Albacete;054;Navas de Jorquera;528;279;249;2022
02;Albacete;055;Nerpio;1180;658;522;2022
02;Albacete;056;Ontur;1934;975;959;2022
02;Albacete;057;Ossa de Montiel;2215;1123;1092;2022
02;Albacete;058;Paterna del Madera;329;186;143;2022
02;Albacete;060;Peñas de San Pedro;1433;842;591;2022
02;Albacete;059;Peñascosa;323;184;139;2022
02;Albacete;061;Pétrola;663;349;314;2022
02;Albacete;062;Povedilla;388;217;171;2022
02;Albacete;901;Pozo Cañada;2763;1400;1363;2022
02;Albacete;063;Pozohondo;1569;821;748;2022
02;Albacete;064;Pozo-Lorente;391;206;185;2022
02;Albacete;065;Pozuelo;461;249;212;2022
02;Albacete;066;Recueja, La;221;124;97;2022
02;Albacete;067;Riópar;1318;677;641;2022
02;Albacete;068;Robledo;385;209;176;2022
02;Albacete;069;Roda, La;15497;7820;7677;2022
02;Albacete;070;Salobre;438;226;212;2022
02;Albacete;071;San Pedro;1142;590;552;2022
02;Albacete;072;Socovos;1743;904;839;2022
02;Albacete;073;Tarazona de la Mancha;6183;3188;2995;2022
02;Albacete;074;Tobarra;7758;4010;3748;2022
02;Albacete;075;Valdeganga;1919;977;942;2022
02;Albacete;076;Vianos;313;162;151;2022
02;Albacete;077;Villa de Ves;60;34;26;2022
02;Albacete;078;Villalgordo del Júcar;1072;567;505;2022
02;Albacete;079;Villamalea;4000;2047;1953;2022
02;Albacete;080;Villapalacios;555;288;267;2022
02;Albacete;081;Villarrobledo;24886;12299;12587;2022
02;Albacete;082;Villatoya;106;60;46;2022
02;Albacete;083;Villavaliente;202;124;78;2022
02;Albacete;084;Villaverde de Guadalimar;321;180;141;2022
02;Albacete;085;Viveros;335;174;161;2022
02;Albacete;086;Yeste;2495;1299;1196;2022
03;Alicante/Alacant;002;Agost;4948;2502;2446;2022
03;Alicante/Alacant;003;Agres;589;325;264;2022
03;Alicante/Alacant;004;Aigües;1085;549;536;2022
03;Alicante/Alacant;005;Albatera;12864;6519;6345;2022
03;Alicante/Alacant;006;Alcalalí;1349;672;677;2022
03;Alicante/Alacant;008;Alcoleja;196;105;91;2022
03;Alicante/Alacant;007;Alcosser;254;125;129;2022
03;Alicante/Alacant;009;Alcoy/Alcoi;58960;28912;30048;2022
03;Alicante/Alacant;010;Alfafara;417;199;218;2022
03;Alicante/Alacant;011;Alfàs del Pi, l';20668;10226;10442;2022
03;Alicante/Alacant;012;Algorfa;3513;1777;1736;2022
03;Alicante/Alacant;013;Algueña;1351;681;670;2022
03;Alicante/Alacant;014;Alicante/Alacant;338577;163548;175029;2022
03;Alicante/Alacant;015;Almoradí;21401;10737;10664;2022
03;Alicante/Alacant;016;Almudaina;112;55;57;2022
03;Alicante/Alacant;017;Alqueria d'Asnar, l';489;246;243;2022
03;Alicante/Alacant;018;Altea;23010;11305;11705;2022
03;Alicante/Alacant;019;Aspe;21191;10671;10520;2022
03;Alicante/Alacant;001;Atzúbia, l';616;319;297;2022
03;Alicante/Alacant;020;Balones;126;66;60;2022
03;Alicante/Alacant;021;Banyeres de Mariola;7201;3633;3568;2022
03;Alicante/Alacant;022;Benasau;171;82;89;2022
03;Alicante/Alacant;023;Beneixama;1705;852;853;2022
03;Alicante/Alacant;024;Benejúzar;5480;2754;2726;2022
03;Alicante/Alacant;025;Benferri;1955;1016;939;2022
03;Alicante/Alacant;026;Beniarbeig;2267;1156;1111;2022
03;Alicante/Alacant;027;Beniardá;218;106;112;2022
03;Alicante/Alacant;028;Beniarrés;1078;555;523;2022
03;Alicante/Alacant;030;Benidoleig;1232;606;626;2022
03;Alicante/Alacant;031;Benidorm;69738;34629;35109;2022
03;Alicante/Alacant;032;Benifallim;106;56;50;2022
03;Alicante/Alacant;033;Benifato;139;74;65;2022
03;Alicante/Alacant;029;Benigembla;512;255;257;2022
03;Alicante/Alacant;034;Benijófar;3427;1667;1760;2022
03;Alicante/Alacant;035;Benilloba;740;387;353;2022
03;Alicante/Alacant;036;Benillup;108;58;50;2022
03;Alicante/Alacant;037;Benimantell;499;251;248;2022
03;Alicante/Alacant;038;Benimarfull;410;213;197;2022
03;Alicante/Alacant;039;Benimassot;93;51;42;2022
03;Alicante/Alacant;040;Benimeli;419;194;225;2022
03;Alicante/Alacant;041;Benissa;11871;5846;6025;2022
03;Alicante/Alacant;042;Benitachell/Poble Nou de Benitatxell, el;4687;2283;2404;2022
03;Alicante/Alacant;043;Biar;3612;1770;1842;2022
03;Alicante/Alacant;044;Bigastro;7130;3591;3539;2022
03;Alicante/Alacant;045;Bolulla;413;214;199;2022
03;Alicante/Alacant;046;Busot;3343;1686;1657;2022
03;Alicante/Alacant;049;Callosa de Segura;19315;9832;9483;2022
03;Alicante/Alacant;048;Callosa d'en Sarrià;7653;3953;3700;2022
03;Alicante/Alacant;047;Calp;24096;12058;12038;2022
03;Alicante/Alacant;050;Campello, el;29409;14314;15095;2022
03;Alicante/Alacant;051;Campo de Mirra/Camp de Mirra, el;433;223;210;2022
03;Alicante/Alacant;052;Cañada;1191;594;597;2022
03;Alicante/Alacant;053;Castalla;11097;5646;5451;2022
03;Alicante/Alacant;054;Castell de Castells;426;225;201;2022
03;Alicante/Alacant;075;Castell de Guadalest, el;258;129;129;2022
03;Alicante/Alacant;055;Catral;8976;4509;4467;2022
03;Alicante/Alacant;056;Cocentaina;11298;5683;5615;2022
03;Alicante/Alacant;057;Confrides;282;154;128;2022
03;Alicante/Alacant;058;Cox;7431;3766;3665;2022
03;Alicante/Alacant;059;Crevillent;29881;15120;14761;2022
03;Alicante/Alacant;061;Daya Nueva;1758;860;898;2022
03;Alicante/Alacant;062;Daya Vieja;683;338;345;2022
03;Alicante/Alacant;063;Dénia;43899;21350;22549;2022
03;Alicante/Alacant;064;Dolores;7799;3893;3906;2022
03;Alicante/Alacant;065;Elche/Elx;235580;116931;118649;2022
03;Alicante/Alacant;066;Elda;52297;25483;26814;2022
03;Alicante/Alacant;067;Fageca;104;53;51;2022
03;Alicante/Alacant;068;Famorca;48;26;22;2022
03;Alicante/Alacant;069;Finestrat;7909;4059;3850;2022
03;Alicante/Alacant;077;Fondó de les Neus, el/Hondón de las Nieves;2684;1388;1296;2022
03;Alicante/Alacant;070;Formentera del Segura;4446;2268;2178;2022
03;Alicante/Alacant;072;Gaianes;548;277;271;2022
03;Alicante/Alacant;071;Gata de Gorgos;6364;3235;3129;2022
03;Alicante/Alacant;073;Gorga;270;144;126;2022
03;Alicante/Alacant;074;Granja de Rocamora;2626;1355;1271;2022
03;Alicante/Alacant;076;Guardamar del Segura;16138;7852;8286;2022
03;Alicante/Alacant;078;Hondón de los Frailes;1261;639;622;2022
03;Alicante/Alacant;079;Ibi;23677;11872;11805;2022
03;Alicante/Alacant;080;Jacarilla;2039;1035;1004;2022
03;Alicante/Alacant;082;Jávea/Xàbia;28731;14346;14385;2022
03;Alicante/Alacant;083;Jijona/Xixona;6860;3317;3543;2022
03;Alicante/Alacant;085;Llíber;967;481;486;2022
03;Alicante/Alacant;084;Lorcha/Orxa, l';565;283;282;2022
03;Alicante/Alacant;086;Millena;243;131;112;2022
03;Alicante/Alacant;088;Monforte del Cid;8619;4502;4117;2022
03;Alicante/Alacant;089;Monóvar/Monòver;12387;6167;6220;2022
03;Alicante/Alacant;903;Montesinos, Los;5217;2657;2560;2022
03;Alicante/Alacant;091;Murla;540;254;286;2022
03;Alicante/Alacant;092;Muro de Alcoy;9303;4646;4657;2022
03;Alicante/Alacant;090;Mutxamel;26192;13088;13104;2022
03;Alicante/Alacant;093;Novelda;25592;12691;12901;2022
03;Alicante/Alacant;094;Nucia, la;18624;9442;9182;2022
03;Alicante/Alacant;095;Ondara;7085;3563;3522;2022
03;Alicante/Alacant;096;Onil;7580;3796;3784;2022
03;Alicante/Alacant;097;Orba;2348;1156;1192;2022
03;Alicante/Alacant;099;Orihuela;80784;40021;40763;2022
03;Alicante/Alacant;098;Orxeta;812;414;398;2022
03;Alicante/Alacant;100;Parcent;997;496;501;2022
03;Alicante/Alacant;101;Pedreguer;8280;4129;4151;2022
03;Alicante/Alacant;102;Pego;10295;5113;5182;2022
03;Alicante/Alacant;103;Penàguila;287;148;139;2022
03;Alicante/Alacant;104;Petrer;33978;16816;17162;2022
03;Alicante/Alacant;902;Pilar de la Horadada;22949;11753;11196;2022
03;Alicante/Alacant;105;Pinós, el/Pinoso;8084;4097;3987;2022
03;Alicante/Alacant;106;Planes;695;375;320;2022
03;Alicante/Alacant;901;Poblets, els;2735;1288;1447;2022
03;Alicante/Alacant;107;Polop;5186;2636;2550;2022
03;Alicante/Alacant;060;Quatretondeta;133;73;60;2022
03;Alicante/Alacant;109;Rafal;4634;2299;2335;2022
03;Alicante/Alacant;110;Ràfol d'Almúnia, el;731;371;360;2022
03;Alicante/Alacant;111;Redován;8123;4219;3904;2022
03;Alicante/Alacant;112;Relleu;1171;613;558;2022
03;Alicante/Alacant;113;Rojales;16943;8564;8379;2022
03;Alicante/Alacant;114;Romana, la;2605;1370;1235;2022
03;Alicante/Alacant;115;Sagra;435;208;227;2022
03;Alicante/Alacant;116;Salinas;1678;861;817;2022
03;Alicante/Alacant;118;San Fulgencio;9091;4573;4518;2022
03;Alicante/Alacant;904;San Isidro;2154;1111;1043;2022
03;Alicante/Alacant;120;San Miguel de Salinas;6659;3343;3316;2022
03;Alicante/Alacant;122;San Vicente del Raspeig/Sant Vicent del Raspeig;59138;29262;29876;2022
03;Alicante/Alacant;117;Sanet y Negrals;734;364;370;2022
03;Alicante/Alacant;119;Sant Joan d'Alacant;24450;11789;12661;2022
03;Alicante/Alacant;121;Santa Pola;36174;18186;17988;2022
03;Alicante/Alacant;123;Sax;9988;5011;4977;2022
03;Alicante/Alacant;124;Sella;592;307;285;2022
03;Alicante/Alacant;125;Senija;623;321;302;2022
03;Alicante/Alacant;127;Tàrbena;624;328;296;2022
03;Alicante/Alacant;128;Teulada;11944;5929;6015;2022
03;Alicante/Alacant;129;Tibi;1731;906;825;2022
03;Alicante/Alacant;130;Tollos;30;20;10;2022
03;Alicante/Alacant;131;Tormos;332;161;171;2022
03;Alicante/Alacant;132;Torremanzanas/Torre de les Maçanes, la;683;365;318;2022
03;Alicante/Alacant;133;Torrevieja;83547;41023;42524;2022
03;Alicante/Alacant;134;Vall d'Alcalà, la;164;90;74;2022
03;Alicante/Alacant;136;Vall de Gallinera, la;579;304;275;2022
03;Alicante/Alacant;137;Vall de Laguar, la;890;444;446;2022
03;Alicante/Alacant;135;Vall d'Ebo, la;219;113;106;2022
03;Alicante/Alacant;138;Verger, el;4986;2470;2516;2022
03;Alicante/Alacant;139;Villajoyosa/Vila Joiosa, la;34828;17259;17569;2022
03;Alicante/Alacant;140;Villena;33969;17041;16928;2022
03;Alicante/Alacant;081;Xaló;2931;1469;1462;2022
04;Almería;001;Abla;1247;642;605;2022
04;Almería;002;Abrucena;1221;643;578;2022
04;Almería;003;Adra;25300;12962;12338;2022
04;Almería;004;Albanchez;735;387;348;2022
04;Almería;005;Alboloduy;615;299;316;2022
04;Almería;006;Albox;12087;6172;5915;2022
04;Almería;007;Alcolea;831;431;400;2022
04;Almería;008;Alcóntar;538;297;241;2022
04;Almería;009;Alcudia de Monteagud;133;69;64;2022
04;Almería;010;Alhabia;685;361;324;2022
04;Almería;011;Alhama de Almería;3757;1887;1870;2022
04;Almería;012;Alicún;214;105;109;2022
04;Almería;013;Almería;199237;97026;102211;2022
04;Almería;014;Almócita;201;109;92;2022
04;Almería;015;Alsodux;129;73;56;2022
04;Almería;016;Antas;3339;1730;1609;2022
04;Almería;017;Arboleas;4532;2267;2265;2022
04;Almería;018;Armuña de Almanzora;313;155;158;2022
04;Almería;019;Bacares;240;127;113;2022
04;Almería;904;Balanegra;2886;1508;1378;2022
04;Almería;020;Bayárcal;312;166;146;2022
04;Almería;021;Bayarque;226;108;118;2022
04;Almería;022;Bédar;1009;516;493;2022
04;Almería;023;Beires;138;72;66;2022
04;Almería;024;Benahadux;4605;2288;2317;2022
04;Almería;026;Benitagla;53;30;23;2022
04;Almería;027;Benizalón;253;143;110;2022
04;Almería;028;Bentarique;239;133;106;2022
04;Almería;029;Berja;12807;6588;6219;2022
04;Almería;030;Canjáyar;1163;611;552;2022
04;Almería;031;Cantoria;3533;1785;1748;2022
04;Almería;032;Carboneras;8210;4228;3982;2022
04;Almería;033;Castro de Filabres;115;63;52;2022
04;Almería;036;Chercos;301;154;147;2022
04;Almería;037;Chirivel;1511;785;726;2022
04;Almería;034;Cóbdar;160;86;74;2022
04;Almería;035;Cuevas del Almanzora;14790;7666;7124;2022
04;Almería;038;Dalías;4141;2047;2094;2022
04;Almería;902;Ejido, El;87500;45452;42048;2022
04;Almería;041;Enix;554;306;248;2022
04;Almería;043;Felix;697;402;295;2022
04;Almería;044;Fines;2161;1135;1026;2022
04;Almería;045;Fiñana;1978;1004;974;2022
04;Almería;046;Fondón;1045;540;505;2022
04;Almería;047;Gádor;3018;1574;1444;2022
04;Almería;048;Gallardos, Los;2991;1495;1496;2022
04;Almería;049;Garrucha;10027;5331;4696;2022
04;Almería;050;Gérgal;1115;609;506;2022
04;Almería;051;Huécija;503;249;254;2022
04;Almería;052;Huércal de Almería;18384;9341;9043;2022
04;Almería;053;Huércal-Overa;20093;9997;10096;2022
04;Almería;054;Íllar;456;243;213;2022
04;Almería;055;Instinción;467;245;222;2022
04;Almería;056;Laroya;200;113;87;2022
04;Almería;057;Láujar de Andarax;1587;795;792;2022
04;Almería;058;Líjar;383;202;181;2022
04;Almería;059;Lubrín;1457;742;715;2022
04;Almería;060;Lucainena de las Torres;595;307;288;2022
04;Almería;061;Lúcar;803;398;405;2022
04;Almería;062;Macael;5393;2758;2635;2022
04;Almería;063;María;1228;625;603;2022
04;Almería;064;Mojácar;7527;3680;3847;2022
04;Almería;903;Mojonera, La;8824;4897;3927;2022
04;Almería;065;Nacimiento;512;270;242;2022
04;Almería;066;Níjar;31816;17820;13996;2022
04;Almería;067;Ohanes;551;287;264;2022
04;Almería;068;Olula de Castro;192;106;86;2022
04;Almería;069;Olula del Río;6259;3183;3076;2022
04;Almería;070;Oria;2212;1154;1058;2022
04;Almería;071;Padules;424;224;200;2022
04;Almería;072;Partaloa;1003;498;505;2022
04;Almería;073;Paterna del Río;395;223;172;2022
04;Almería;074;Pechina;4224;2175;2049;2022
04;Almería;075;Pulpí;10493;5420;5073;2022
04;Almería;076;Purchena;1550;802;748;2022
04;Almería;077;Rágol;288;145;143;2022
04;Almería;078;Rioja;1510;775;735;2022
04;Almería;079;Roquetas de Mar;102881;53233;49648;2022
04;Almería;080;Santa Cruz de Marchena;219;115;104;2022
04;Almería;081;Santa Fe de Mondújar;476;253;223;2022
04;Almería;082;Senés;285;159;126;2022
04;Almería;083;Serón;2062;1060;1002;2022
04;Almería;084;Sierro;384;203;181;2022
04;Almería;085;Somontín;445;218;227;2022
04;Almería;086;Sorbas;2505;1302;1203;2022
04;Almería;087;Suflí;203;111;92;2022
04;Almería;088;Tabernas;4025;2120;1905;2022
04;Almería;089;Taberno;949;468;481;2022
04;Almería;090;Tahal;346;184;162;2022
04;Almería;091;Terque;386;202;184;2022
04;Almería;092;Tíjola;3520;1762;1758;2022
04;Almería;901;Tres Villas, Las;573;319;254;2022
04;Almería;093;Turre;4067;2110;1957;2022
04;Almería;094;Turrillas;270;150;120;2022
04;Almería;095;Uleila del Campo;812;406;406;2022
04;Almería;096;Urrácal;371;195;176;2022
04;Almería;097;Velefique;248;137;111;2022
04;Almería;098;Vélez-Blanco;1925;987;938;2022
04;Almería;099;Vélez-Rubio;6528;3172;3356;2022
04;Almería;100;Vera;18224;9299;8925;2022
04;Almería;101;Viator;6066;3106;2960;2022
04;Almería;102;Vícar;27631;15065;12566;2022
04;Almería;103;Zurgena;2912;1478;1434;2022
01;Araba/Álava;051;Agurain/Salvatierra;5069;2545;2524;2022
01;Araba/Álava;001;Alegría-Dulantzi;2960;1530;1430;2022
01;Araba/Álava;002;Amurrio;10281;5103;5178;2022
01;Araba/Álava;049;Añana;156;97;59;2022
01;Araba/Álava;003;Aramaio;1431;741;690;2022
01;Araba/Álava;006;Armiñón;235;120;115;2022
01;Araba/Álava;037;Arraia-Maeztu;804;445;359;2022
01;Araba/Álava;008;Arratzua-Ubarrundia;1031;550;481;2022
01;Araba/Álava;004;Artziniega;1810;889;921;2022
01;Araba/Álava;009;Asparrena;1637;827;810;2022
01;Araba/Álava;010;Ayala/Aiara;2921;1481;1440;2022
01;Araba/Álava;011;Baños de Ebro/Mañueta;296;170;126;2022
01;Araba/Álava;013;Barrundia;914;499;415;2022
01;Araba/Álava;014;Berantevilla;452;240;212;2022
01;Araba/Álava;016;Bernedo;560;320;240;2022
01;Araba/Álava;017;Campezo/Kanpezu;1094;577;517;2022
01;Araba/Álava;021;Elburgo/Burgelu;629;331;298;2022
01;Araba/Álava;022;Elciego;971;486;485;2022
01;Araba/Álava;023;Elvillar/Bilar;316;149;167;2022
01;Araba/Álava;047;Erriberabeitia;1416;766;650;2022
01;Araba/Álava;046;Erriberagoitia/Ribera Alta;820;481;339;2022
01;Araba/Álava;056;Harana/Valle de Arana;226;126;100;2022
01;Araba/Álava;901;Iruña Oka/Iruña de Oca;3551;1886;1665;2022
01;Araba/Álava;027;Iruraiz-Gauna;537;296;241;2022
01;Araba/Álava;019;Kripan;176;92;84;2022
01;Araba/Álava;020;Kuartango;421;241;180;2022
01;Araba/Álava;028;Labastida/Bastida;1538;787;751;2022
01;Araba/Álava;030;Lagrán;175;100;75;2022
01;Araba/Álava;031;Laguardia;1483;771;712;2022
01;Araba/Álava;032;Lanciego/Lantziego;724;378;346;2022
01;Araba/Álava;902;Lantarón;931;522;409;2022
01;Araba/Álava;033;Lapuebla de Labarca;870;448;422;2022
01;Araba/Álava;036;Laudio/Llodio;17906;8683;9223;2022
01;Araba/Álava;058;Legutio;2017;1064;953;2022
01;Araba/Álava;034;Leza;217;112;105;2022
01;Araba/Álava;039;Moreda de Álava/Moreda Araba;216;112;104;2022
01;Araba/Álava;041;Navaridas;200;113;87;2022
01;Araba/Álava;042;Okondo;1187;626;561;2022
01;Araba/Álava;043;Oyón-Oion;3408;1728;1680;2022
01;Araba/Álava;044;Peñacerrada-Urizaharra;310;179;131;2022
01;Araba/Álava;052;Samaniego;311;152;159;2022
01;Araba/Álava;053;San Millán/Donemiliaga;718;392;326;2022
01;Araba/Álava;054;Urkabustaiz;1408;733;675;2022
01;Araba/Álava;055;Valdegovía/Gaubea;1097;588;509;2022
01;Araba/Álava;057;Villabuena de Álava/Eskuernaga;291;153;138;2022
01;Araba/Álava;059;Vitoria-Gasteiz;253672;123291;130381;2022
01;Araba/Álava;060;Yécora/Iekora;247;126;121;2022
01;Araba/Álava;061;Zalduondo;195;106;89;2022
01;Araba/Álava;062;Zambrana;425;228;197;2022
01;Araba/Álava;018;Zigoitia;1822;984;838;2022
01;Araba/Álava;063;Zuia;2330;1221;1109;2022
33;Asturias;001;Allande;1574;785;789;2022
33;Asturias;002;Aller;10201;5040;5161;2022
33;Asturias;003;Amieva;603;343;260;2022
33;Asturias;004;Avilés;75877;35814;40063;2022
33;Asturias;005;Belmonte de Miranda;1425;761;664;2022
33;Asturias;006;Bimenes;1672;812;860;2022
33;Asturias;007;Boal;1442;733;709;2022
33;Asturias;008;Cabrales;1907;963;944;2022
33;Asturias;009;Cabranes;1112;570;542;2022
33;Asturias;010;Candamo;1943;951;992;2022
33;Asturias;012;Cangas de Onís;6260;3029;3231;2022
33;Asturias;011;Cangas del Narcea;11817;5768;6049;2022
33;Asturias;013;Caravia;508;270;238;2022
33;Asturias;014;Carreño;10226;4927;5299;2022
33;Asturias;015;Caso;1443;822;621;2022
33;Asturias;016;Castrillón;22235;10769;11466;2022
33;Asturias;017;Castropol;3288;1615;1673;2022
33;Asturias;018;Coaña;3285;1620;1665;2022
33;Asturias;019;Colunga;3220;1593;1627;2022
33;Asturias;020;Corvera de Asturias;15563;7605;7958;2022
33;Asturias;021;Cudillero;4928;2428;2500;2022
33;Asturias;022;Degaña;821;418;403;2022
33;Asturias;023;Franco, El;3736;1832;1904;2022
33;Asturias;024;Gijón;267706;125827;141879;2022
33;Asturias;025;Gozón;10433;5111;5322;2022
33;Asturias;026;Grado;9598;4663;4935;2022
33;Asturias;027;Grandas de Salime;774;396;378;2022
33;Asturias;028;Ibias;1152;657;495;2022
33;Asturias;029;Illano;305;153;152;2022
33;Asturias;030;Illas;1062;535;527;2022
33;Asturias;031;Langreo;38262;18208;20054;2022
33;Asturias;032;Laviana;12584;6046;6538;2022
33;Asturias;033;Lena;10499;5053;5446;2022
33;Asturias;035;Llanera;13792;6809;6983;2022
33;Asturias;036;Llanes;13545;6595;6950;2022
33;Asturias;037;Mieres;36574;17390;19184;2022
33;Asturias;038;Morcín;2560;1284;1276;2022
33;Asturias;039;Muros de Nalón;1963;948;1015;2022
33;Asturias;040;Nava;5236;2568;2668;2022
33;Asturias;041;Navia;8263;3989;4274;2022
33;Asturias;042;Noreña;5088;2433;2655;2022
33;Asturias;043;Onís;735;401;334;2022
33;Asturias;044;Oviedo;215167;99535;115632;2022
33;Asturias;045;Parres;5233;2570;2663;2022
33;Asturias;046;Peñamellera Alta;529;282;247;2022
33;Asturias;047;Peñamellera Baja;1225;612;613;2022
33;Asturias;048;Pesoz;138;76;62;2022
33;Asturias;049;Piloña;6862;3349;3513;2022
33;Asturias;050;Ponga;561;337;224;2022
33;Asturias;051;Pravia;7905;3855;4050;2022
33;Asturias;052;Proaza;715;420;295;2022
33;Asturias;053;Quirós;1202;702;500;2022
33;Asturias;054;Regueras, Las;1888;955;933;2022
33;Asturias;055;Ribadedeva;1724;842;882;2022
33;Asturias;056;Ribadesella;5642;2672;2970;2022
33;Asturias;057;Ribera de Arriba;1865;938;927;2022
33;Asturias;058;Riosa;1805;914;891;2022
33;Asturias;059;Salas;4828;2390;2438;2022
33;Asturias;061;San Martín de Oscos;349;177;172;2022
33;Asturias;060;San Martín del Rey Aurelio;15505;7432;8073;2022
33;Asturias;063;San Tirso de Abres;408;197;211;2022
33;Asturias;062;Santa Eulalia de Oscos;434;220;214;2022
33;Asturias;064;Santo Adriano;272;129;143;2022
33;Asturias;065;Sariego;1285;623;662;2022
33;Asturias;066;Siero;51792;25331;26461;2022
33;Asturias;067;Sobrescobio;829;444;385;2022
33;Asturias;068;Somiedo;1100;647;453;2022
33;Asturias;069;Soto del Barco;3851;1900;1951;2022
33;Asturias;070;Tapia de Casariego;3671;1783;1888;2022
33;Asturias;071;Taramundi;592;279;313;2022
33;Asturias;072;Teverga;1579;869;710;2022
33;Asturias;073;Tineo;9009;4562;4447;2022
33;Asturias;034;Valdés;11099;5454;5645;2022
33;Asturias;074;Vegadeo;3895;1880;2015;2022
33;Asturias;075;Villanueva de Oscos;263;134;129;2022
33;Asturias;076;Villaviciosa;14984;7437;7547;2022
33;Asturias;077;Villayón;1130;583;547;2022
33;Asturias;078;Yernes y Tameza;133;70;63;2022
05;Ávila;001;Adanero;214;114;100;2022
05;Ávila;002;Adrada, La;2750;1412;1338;2022
05;Ávila;005;Albornos;172;88;84;2022
05;Ávila;007;Aldeanueva de Santa Cruz;104;54;50;2022
05;Ávila;008;Aldeaseca;217;105;112;2022
05;Ávila;010;Aldehuela, La;148;76;72;2022
05;Ávila;012;Amavida;133;75;58;2022
05;Ávila;013;Arenal, El;938;465;473;2022
05;Ávila;014;Arenas de San Pedro;6465;3142;3323;2022
05;Ávila;015;Arevalillo;68;33;35;2022
05;Ávila;016;Arévalo;7884;3828;4056;2022
05;Ávila;017;Aveinte;80;46;34;2022
05;Ávila;018;Avellaneda;27;16;11;2022
05;Ávila;019;Ávila;57730;27490;30240;2022
05;Ávila;021;Barco de Ávila, El;2249;1076;1173;2022
05;Ávila;022;Barraco, El;1956;1004;952;2022
05;Ávila;023;Barromán;176;96;80;2022
05;Ávila;024;Becedas;172;93;79;2022
05;Ávila;025;Becedillas;78;41;37;2022
05;Ávila;026;Bercial de Zapardiel;190;100;90;2022
05;Ávila;027;Berlanas, Las;338;178;160;2022
05;Ávila;029;Bernuy-Zapardiel;90;50;40;2022
05;Ávila;030;Berrocalejo de Aragona;53;30;23;2022
05;Ávila;033;Blascomillán;173;90;83;2022
05;Ávila;034;Blasconuño de Matacabras;14;9;5;2022
05;Ávila;035;Blascosancho;99;50;49;2022
05;Ávila;036;Bohodón, El;111;60;51;2022
05;Ávila;037;Bohoyo;230;129;101;2022
05;Ávila;038;Bonilla de la Sierra;124;75;49;2022
05;Ávila;039;Brabos;41;26;15;2022
05;Ávila;040;Bularros;59;39;20;2022
05;Ávila;041;Burgohondo;1196;627;569;2022
05;Ávila;042;Cabezas de Alambre;157;74;83;2022
05;Ávila;043;Cabezas del Pozo;79;39;40;2022
05;Ávila;044;Cabezas del Villar;244;135;109;2022
05;Ávila;045;Cabizuela;85;43;42;2022
05;Ávila;046;Canales;37;22;15;2022
05;Ávila;047;Candeleda;5044;2544;2500;2022
05;Ávila;048;Cantiveros;97;58;39;2022
05;Ávila;049;Cardeñosa;425;230;195;2022
05;Ávila;051;Carrera, La;157;89;68;2022
05;Ávila;052;Casas del Puerto;80;44;36;2022
05;Ávila;053;Casasola;67;38;29;2022
05;Ávila;054;Casavieja;1418;735;683;2022
05;Ávila;055;Casillas;649;348;301;2022
05;Ávila;056;Castellanos de Zapardiel;90;51;39;2022
05;Ávila;057;Cebreros;3213;1670;1543;2022
05;Ávila;058;Cepeda la Mora;74;41;33;2022
05;Ávila;067;Chamartín;63;36;27;2022
05;Ávila;059;Cillán;75;46;29;2022
05;Ávila;060;Cisla;102;55;47;2022
05;Ávila;061;Colilla, La;358;188;170;2022
05;Ávila;062;Collado de Contreras;148;76;72;2022
05;Ávila;063;Collado del Mirón;27;16;11;2022
05;Ávila;064;Constanzana;101;59;42;2022
05;Ávila;065;Crespos;481;254;227;2022
05;Ávila;066;Cuevas del Valle;523;284;239;2022
05;Ávila;903;Diego del Carpio;116;68;48;2022
05;Ávila;069;Donjimeno;69;38;31;2022
05;Ávila;070;Donvidas;30;19;11;2022
05;Ávila;072;Espinosa de los Caballeros;104;53;51;2022
05;Ávila;073;Flores de Ávila;279;150;129;2022
05;Ávila;074;Fontiveros;719;374;345;2022
05;Ávila;075;Fresnedilla;106;54;52;2022
05;Ávila;076;Fresno, El;593;310;283;2022
05;Ávila;077;Fuente el Saúz;160;88;72;2022
05;Ávila;078;Fuentes de Año;92;53;39;2022
05;Ávila;079;Gallegos de Altamiros;58;35;23;2022
05;Ávila;080;Gallegos de Sobrinos;47;23;24;2022
05;Ávila;081;Garganta del Villar;41;27;14;2022
05;Ávila;082;Gavilanes;573;315;258;2022
05;Ávila;083;Gemuño;154;80;74;2022
05;Ávila;085;Gil García;41;20;21;2022
05;Ávila;084;Gilbuena;58;36;22;2022
05;Ávila;086;Gimialcón;72;45;27;2022
05;Ávila;087;Gotarrendura;174;66;108;2022
05;Ávila;088;Grandes y San Martín;33;16;17;2022
05;Ávila;089;Guisando;497;250;247;2022
05;Ávila;090;Gutierre-Muñoz;63;34;29;2022
05;Ávila;092;Hernansancho;153;86;67;2022
05;Ávila;093;Herradón de Pinares;501;280;221;2022
05;Ávila;094;Herreros de Suso;140;77;63;2022
05;Ávila;095;Higuera de las Dueñas;270;153;117;2022
05;Ávila;096;Hija de Dios, La;86;52;34;2022
05;Ávila;097;Horcajada, La;482;247;235;2022
05;Ávila;099;Horcajo de las Torres;469;264;205;2022
05;Ávila;100;Hornillo, El;270;146;124;2022
05;Ávila;102;Hoyo de Pinares, El;2169;1118;1051;2022
05;Ávila;101;Hoyocasero;276;162;114;2022
05;Ávila;103;Hoyorredondo;58;31;27;2022
05;Ávila;106;Hoyos de Miguel Muñoz;25;13;12;2022
05;Ávila;104;Hoyos del Collado;29;17;12;2022
05;Ávila;105;Hoyos del Espino;364;189;175;2022
05;Ávila;107;Hurtumpascual;45;27;18;2022
05;Ávila;108;Junciana;39;23;16;2022
05;Ávila;109;Langa;456;234;222;2022
05;Ávila;110;Lanzahíta;819;428;391;2022
05;Ávila;113;Llanos de Tormes, Los;62;32;30;2022
05;Ávila;112;Losar del Barco, El;101;57;44;2022
05;Ávila;114;Madrigal de las Altas Torres;1350;683;667;2022
05;Ávila;115;Maello;669;358;311;2022
05;Ávila;116;Malpartida de Corneja;101;50;51;2022
05;Ávila;117;Mamblas;198;113;85;2022
05;Ávila;118;Mancera de Arriba;70;38;32;2022
05;Ávila;119;Manjabálago y Ortigosa de Rioalmar;20;11;9;2022
05;Ávila;120;Marlín;29;20;9;2022
05;Ávila;121;Martiherrero;338;176;162;2022
05;Ávila;122;Martínez;117;63;54;2022
05;Ávila;123;Mediana de Voltoya;116;61;55;2022
05;Ávila;124;Medinilla;89;44;45;2022
05;Ávila;125;Mengamuñoz;61;30;31;2022
05;Ávila;126;Mesegar de Corneja;57;35;22;2022
05;Ávila;127;Mijares;726;398;328;2022
05;Ávila;128;Mingorría;385;195;190;2022
05;Ávila;129;Mirón, El;109;67;42;2022
05;Ávila;130;Mironcillo;112;58;54;2022
05;Ávila;131;Mirueña de los Infanzones;90;51;39;2022
05;Ávila;132;Mombeltrán;933;487;446;2022
05;Ávila;133;Monsalupe;60;31;29;2022
05;Ávila;134;Moraleja de Matacabras;57;30;27;2022
05;Ávila;135;Muñana;463;247;216;2022
05;Ávila;136;Muñico;79;44;35;2022
05;Ávila;138;Muñogalindo;309;152;157;2022
05;Ávila;139;Muñogrande;73;40;33;2022
05;Ávila;140;Muñomer del Peco;109;56;53;2022
05;Ávila;141;Muñopepe;102;57;45;2022
05;Ávila;142;Muñosancho;89;47;42;2022
05;Ávila;143;Muñotello;56;29;27;2022
05;Ávila;144;Narrillos del Álamo;63;35;28;2022
05;Ávila;145;Narrillos del Rebollar;40;26;14;2022
05;Ávila;149;Narros de Saldueña;106;57;49;2022
05;Ávila;147;Narros del Castillo;153;83;70;2022
05;Ávila;148;Narros del Puerto;31;17;14;2022
05;Ávila;152;Nava de Arévalo;695;360;335;2022
05;Ávila;153;Nava del Barco;87;43;44;2022
05;Ávila;151;Navacepedilla de Corneja;91;49;42;2022
05;Ávila;154;Navadijos;37;26;11;2022
05;Ávila;155;Navaescurial;44;26;18;2022
05;Ávila;156;Navahondilla;366;220;146;2022
05;Ávila;157;Navalacruz;215;124;91;2022
05;Ávila;158;Navalmoral;356;185;171;2022
05;Ávila;159;Navalonguilla;205;103;102;2022
05;Ávila;160;Navalosa;317;182;135;2022
05;Ávila;161;Navalperal de Pinares;761;402;359;2022
05;Ávila;162;Navalperal de Tormes;81;46;35;2022
05;Ávila;163;Navaluenga;2136;1066;1070;2022
05;Ávila;164;Navaquesera;24;11;13;2022
05;Ávila;165;Navarredonda de Gredos;429;217;212;2022
05;Ávila;166;Navarredondilla;156;80;76;2022
05;Ávila;167;Navarrevisca;289;168;121;2022
05;Ávila;168;Navas del Marqués, Las;5268;2701;2567;2022
05;Ávila;169;Navatalgordo;238;132;106;2022
05;Ávila;170;Navatejares;58;27;31;2022
05;Ávila;171;Neila de San Miguel;64;35;29;2022
05;Ávila;172;Niharra;164;99;65;2022
05;Ávila;173;Ojos-Albos;83;47;36;2022
05;Ávila;174;Orbita;79;46;33;2022
05;Ávila;175;Oso, El;144;83;61;2022
05;Ávila;176;Padiernos;287;157;130;2022
05;Ávila;177;Pajares de Adaja;127;69;58;2022
05;Ávila;178;Palacios de Goda;384;205;179;2022
05;Ávila;179;Papatrigo;230;111;119;2022
05;Ávila;180;Parral, El;59;36;23;2022
05;Ávila;181;Pascualcobo;42;27;15;2022
05;Ávila;182;Pedro Bernardo;797;420;377;2022
05;Ávila;183;Pedro-Rodríguez;138;72;66;2022
05;Ávila;184;Peguerinos;282;158;124;2022
05;Ávila;185;Peñalba de Ávila;109;60;49;2022
05;Ávila;186;Piedrahíta;1720;834;886;2022
05;Ávila;187;Piedralaves;2123;1055;1068;2022
05;Ávila;188;Poveda;43;24;19;2022
05;Ávila;189;Poyales del Hoyo;463;255;208;2022
05;Ávila;190;Pozanco;49;29;20;2022
05;Ávila;191;Pradosegar;122;69;53;2022
05;Ávila;192;Puerto Castilla;111;70;41;2022
05;Ávila;193;Rasueros;161;90;71;2022
05;Ávila;194;Riocabado;133;78;55;2022
05;Ávila;195;Riofrío;194;121;73;2022
05;Ávila;196;Rivilla de Barajas;58;26;32;2022
05;Ávila;197;Salobral;110;60;50;2022
05;Ávila;198;Salvadiós;74;38;36;2022
05;Ávila;199;San Bartolomé de Béjar;47;24;23;2022
05;Ávila;200;San Bartolomé de Corneja;38;22;16;2022
05;Ávila;201;San Bartolomé de Pinares;510;282;228;2022
05;Ávila;206;San Esteban de los Patos;20;13;7;2022
05;Ávila;208;San Esteban de Zapardiel;41;22;19;2022
05;Ávila;207;San Esteban del Valle;759;394;365;2022
05;Ávila;209;San García de Ingelmos;67;44;23;2022
05;Ávila;901;San Juan de Gredos;251;143;108;2022
05;Ávila;210;San Juan de la Encinilla;73;36;37;2022
05;Ávila;211;San Juan de la Nava;443;238;205;2022
05;Ávila;212;San Juan del Molinillo;200;113;87;2022
05;Ávila;213;San Juan del Olmo;86;55;31;2022
05;Ávila;214;San Lorenzo de Tormes;35;17;18;2022
05;Ávila;215;San Martín de la Vega del Alberche;162;96;66;2022
05;Ávila;216;San Martín del Pimpollar;213;126;87;2022
05;Ávila;217;San Miguel de Corneja;55;31;24;2022
05;Ávila;218;San Miguel de Serrezuela;106;56;50;2022
05;Ávila;219;San Pascual;43;26;17;2022
05;Ávila;220;San Pedro del Arroyo;452;239;213;2022
05;Ávila;231;San Vicente de Arévalo;169;94;75;2022
05;Ávila;204;Sanchidrián;715;368;347;2022
05;Ávila;205;Sanchorreja;84;40;44;2022
05;Ávila;222;Santa Cruz de Pinares;158;92;66;2022
05;Ávila;221;Santa Cruz del Valle;329;169;160;2022
05;Ávila;226;Santa María de los Caballeros;61;38;23;2022
05;Ávila;224;Santa María del Arroyo;111;60;51;2022
05;Ávila;225;Santa María del Berrocal;388;202;186;2022
05;Ávila;902;Santa María del Cubillo;305;174;131;2022
05;Ávila;227;Santa María del Tiétar;499;262;237;2022
05;Ávila;228;Santiago del Collado;171;107;64;2022
05;Ávila;904;Santiago del Tormes;112;62;50;2022
05;Ávila;229;Santo Domingo de las Posadas;72;40;32;2022
05;Ávila;230;Santo Tomé de Zabarcos;72;42;30;2022
05;Ávila;232;Serrada, La;125;67;58;2022
05;Ávila;233;Serranillos;244;130;114;2022
05;Ávila;234;Sigeres;42;20;22;2022
05;Ávila;235;Sinlabajos;148;69;79;2022
05;Ávila;236;Solana de Ávila;110;64;46;2022
05;Ávila;237;Solana de Rioalmar;152;89;63;2022
05;Ávila;238;Solosancho;792;422;370;2022
05;Ávila;239;Sotalbo;239;138;101;2022
05;Ávila;240;Sotillo de la Adrada;4762;2365;2397;2022
05;Ávila;241;Tiemblo, El;4373;2214;2159;2022
05;Ávila;242;Tiñosillos;760;391;369;2022
05;Ávila;243;Tolbaños;82;48;34;2022
05;Ávila;244;Tormellas;37;23;14;2022
05;Ávila;245;Tornadizos de Ávila;451;221;230;2022
05;Ávila;247;Torre, La;238;128;110;2022
05;Ávila;246;Tórtoles;43;23;20;2022
05;Ávila;249;Umbrías;100;52;48;2022
05;Ávila;251;Vadillo de la Sierra;63;42;21;2022
05;Ávila;252;Valdecasa;61;37;24;2022
05;Ávila;253;Vega de Santa María;76;39;37;2022
05;Ávila;254;Velayos;214;106;108;2022
05;Ávila;256;Villaflor;104;56;48;2022
05;Ávila;257;Villafranca de la Sierra;143;83;60;2022
05;Ávila;905;Villanueva de Ávila;247;132;115;2022
05;Ávila;258;Villanueva de Gómez;116;66;50;2022
05;Ávila;259;Villanueva del Aceral;106;53;53;2022
05;Ávila;260;Villanueva del Campillo;110;61;49;2022
05;Ávila;261;Villar de Corneja;38;23;15;2022
05;Ávila;262;Villarejo del Valle;322;177;145;2022
05;Ávila;263;Villatoro;156;93;63;2022
05;Ávila;264;Viñegra de Moraña;46;24;22;2022
05;Ávila;265;Vita;84;49;35;2022
05;Ávila;266;Zapardiel de la Cañada;88;48;40;2022
05;Ávila;267;Zapardiel de la Ribera;92;49;43;2022
06;Badajoz;001;Acedera;816;418;398;2022
06;Badajoz;002;Aceuchal;5456;2714;2742;2022
06;Badajoz;003;Ahillones;826;414;412;2022
06;Badajoz;004;Alange;1844;951;893;2022
06;Badajoz;005;Albuera, La;2014;1042;972;2022
06;Badajoz;006;Alburquerque;5144;2563;2581;2022
06;Badajoz;007;Alconchel;1644;835;809;2022
06;Badajoz;008;Alconera;750;372;378;2022
06;Badajoz;009;Aljucén;243;134;109;2022
06;Badajoz;010;Almendral;1207;605;602;2022
06;Badajoz;011;Almendralejo;33669;16636;17033;2022
06;Badajoz;012;Arroyo de San Serván;4054;2042;2012;2022
06;Badajoz;013;Atalaya;285;149;136;2022
06;Badajoz;014;Azuaga;7636;3781;3855;2022
06;Badajoz;015;Badajoz;150146;72634;77512;2022
06;Badajoz;016;Barcarrota;3445;1754;1691;2022
06;Badajoz;017;Baterno;248;135;113;2022
06;Badajoz;018;Benquerencia de la Serena;808;403;405;2022
06;Badajoz;019;Berlanga;2241;1108;1133;2022
06;Badajoz;020;Bienvenida;2070;1065;1005;2022
06;Badajoz;021;Bodonal de la Sierra;1008;510;498;2022
06;Badajoz;022;Burguillos del Cerro;3047;1495;1552;2022
06;Badajoz;023;Cabeza del Buey;4682;2331;2351;2022
06;Badajoz;024;Cabeza la Vaca;1296;664;632;2022
06;Badajoz;025;Calamonte;6115;3030;3085;2022
06;Badajoz;026;Calera de León;933;476;457;2022
06;Badajoz;027;Calzadilla de los Barros;716;358;358;2022
06;Badajoz;028;Campanario;4787;2374;2413;2022
06;Badajoz;029;Campillo de Llerena;1325;663;662;2022
06;Badajoz;030;Capilla;161;84;77;2022
06;Badajoz;031;Carmonita;525;262;263;2022
06;Badajoz;032;Carrascalejo, El;84;42;42;2022
06;Badajoz;033;Casas de Don Pedro;1436;745;691;2022
06;Badajoz;034;Casas de Reina;194;99;95;2022
06;Badajoz;035;Castilblanco;864;439;425;2022
06;Badajoz;036;Castuera;5637;2793;2844;2022
06;Badajoz;042;Cheles;1159;573;586;2022
06;Badajoz;037;Codosera, La;2025;1063;962;2022
06;Badajoz;038;Cordobilla de Lácara;855;447;408;2022
06;Badajoz;039;Coronada, La;2172;1053;1119;2022
06;Badajoz;040;Corte de Peleas;1187;584;603;2022
06;Badajoz;041;Cristina;558;286;272;2022
06;Badajoz;043;Don Álvaro;807;433;374;2022
06;Badajoz;044;Don Benito;37310;18390;18920;2022
06;Badajoz;045;Entrín Bajo;557;286;271;2022
06;Badajoz;046;Esparragalejo;1480;729;751;2022
06;Badajoz;047;Esparragosa de la Serena;975;488;487;2022
06;Badajoz;048;Esparragosa de Lares;883;440;443;2022
06;Badajoz;049;Feria;1073;511;562;2022
06;Badajoz;050;Fregenal de la Sierra;4773;2327;2446;2022
06;Badajoz;051;Fuenlabrada de los Montes;1755;863;892;2022
06;Badajoz;052;Fuente de Cantos;4667;2320;2347;2022
06;Badajoz;053;Fuente del Arco;680;348;332;2022
06;Badajoz;054;Fuente del Maestre;6659;3294;3365;2022
06;Badajoz;055;Fuentes de León;2232;1100;1132;2022
06;Badajoz;056;Garbayuela;502;266;236;2022
06;Badajoz;057;Garlitos;543;275;268;2022
06;Badajoz;058;Garrovilla, La;2317;1141;1176;2022
06;Badajoz;059;Granja de Torrehermosa;1940;965;975;2022
06;Badajoz;903;Guadiana;2414;1189;1225;2022
06;Badajoz;060;Guareña;6771;3401;3370;2022
06;Badajoz;061;Haba, La;1214;609;605;2022
06;Badajoz;062;Helechosa de los Montes;597;341;256;2022
06;Badajoz;063;Herrera del Duque;3467;1736;1731;2022
06;Badajoz;064;Higuera de la Serena;924;470;454;2022
06;Badajoz;065;Higuera de Llerena;340;179;161;2022
06;Badajoz;066;Higuera de Vargas;1934;980;954;2022
06;Badajoz;067;Higuera la Real;2216;1129;1087;2022
06;Badajoz;068;Hinojosa del Valle;479;233;246;2022
06;Badajoz;069;Hornachos;3487;1741;1746;2022
06;Badajoz;070;Jerez de los Caballeros;9167;4509;4658;2022
06;Badajoz;071;Lapa, La;288;145;143;2022
06;Badajoz;073;Llera;822;418;404;2022
06;Badajoz;074;Llerena;5670;2817;2853;2022
06;Badajoz;072;Lobón;2761;1417;1344;2022
06;Badajoz;075;Magacela;507;262;245;2022
06;Badajoz;076;Maguilla;961;483;478;2022
06;Badajoz;077;Malcocinado;344;191;153;2022
06;Badajoz;078;Malpartida de la Serena;528;273;255;2022
06;Badajoz;079;Manchita;750;379;371;2022
06;Badajoz;080;Medellín;2232;1136;1096;2022
06;Badajoz;081;Medina de las Torres;1161;600;561;2022
06;Badajoz;082;Mengabril;485;264;221;2022
06;Badajoz;083;Mérida;59324;28829;30495;2022
06;Badajoz;084;Mirandilla;1231;618;613;2022
06;Badajoz;085;Monesterio;4302;2211;2091;2022
06;Badajoz;086;Montemolín;1322;636;686;2022
06;Badajoz;087;Monterrubio de la Serena;2269;1125;1144;2022
06;Badajoz;088;Montijo;15427;7642;7785;2022
06;Badajoz;089;Morera, La;700;360;340;2022
06;Badajoz;090;Nava de Santiago, La;911;452;459;2022
06;Badajoz;091;Navalvillar de Pela;4371;2195;2176;2022
06;Badajoz;092;Nogales;633;313;320;2022
06;Badajoz;093;Oliva de la Frontera;5010;2519;2491;2022
06;Badajoz;094;Oliva de Mérida;1674;846;828;2022
06;Badajoz;095;Olivenza;11832;5891;5941;2022
06;Badajoz;096;Orellana de la Sierra;252;133;119;2022
06;Badajoz;097;Orellana la Vieja;2603;1327;1276;2022
06;Badajoz;098;Palomas;662;332;330;2022
06;Badajoz;099;Parra, La;1302;671;631;2022
06;Badajoz;100;Peñalsordo;851;425;426;2022
06;Badajoz;101;Peraleda del Zaucejo;500;253;247;2022
06;Badajoz;102;Puebla de Alcocer;1139;557;582;2022
06;Badajoz;103;Puebla de la Calzada;5856;2940;2916;2022
06;Badajoz;104;Puebla de la Reina;709;347;362;2022
06;Badajoz;107;Puebla de Obando;1842;942;900;2022
06;Badajoz;108;Puebla de Sancho Pérez;2642;1347;1295;2022
06;Badajoz;105;Puebla del Maestre;660;342;318;2022
06;Badajoz;106;Puebla del Prior;460;234;226;2022
06;Badajoz;902;Pueblonuevo del Guadiana;1971;982;989;2022
06;Badajoz;109;Quintana de la Serena;4536;2291;2245;2022
06;Badajoz;110;Reina;150;79;71;2022
06;Badajoz;111;Rena;610;320;290;2022
06;Badajoz;112;Retamal de Llerena;435;227;208;2022
06;Badajoz;113;Ribera del Fresno;3234;1623;1611;2022
06;Badajoz;114;Risco;121;58;63;2022
06;Badajoz;115;Roca de la Sierra, La;1435;702;733;2022
06;Badajoz;116;Salvaleón;1701;860;841;2022
06;Badajoz;117;Salvatierra de los Barros;1590;778;812;2022
06;Badajoz;119;San Pedro de Mérida;851;440;411;2022
06;Badajoz;123;San Vicente de Alcántara;5291;2658;2633;2022
06;Badajoz;118;Sancti-Spíritus;161;90;71;2022
06;Badajoz;120;Santa Amalia;3942;1980;1962;2022
06;Badajoz;121;Santa Marta;4125;2075;2050;2022
06;Badajoz;122;Santos de Maimona, Los;8072;4051;4021;2022
06;Badajoz;124;Segura de León;1818;913;905;2022
06;Badajoz;125;Siruela;1841;934;907;2022
06;Badajoz;126;Solana de los Barros;2553;1274;1279;2022
06;Badajoz;127;Talarrubias;3285;1633;1652;2022
06;Badajoz;128;Talavera la Real;5276;2645;2631;2022
06;Badajoz;129;Táliga;663;331;332;2022
06;Badajoz;130;Tamurejo;201;103;98;2022
06;Badajoz;131;Torre de Miguel Sesmero;1228;628;600;2022
06;Badajoz;132;Torremayor;985;482;503;2022
06;Badajoz;133;Torremejía;2236;1164;1072;2022
06;Badajoz;134;Trasierra;612;326;286;2022
06;Badajoz;135;Trujillanos;1401;719;682;2022
06;Badajoz;136;Usagre;1765;871;894;2022
06;Badajoz;137;Valdecaballeros;1075;561;514;2022
06;Badajoz;901;Valdelacalzada;2755;1386;1369;2022
06;Badajoz;138;Valdetorres;1161;571;590;2022
06;Badajoz;139;Valencia de las Torres;512;275;237;2022
06;Badajoz;140;Valencia del Mombuey;718;374;344;2022
06;Badajoz;141;Valencia del Ventoso;1921;963;958;2022
06;Badajoz;146;Valle de la Serena;1127;573;554;2022
06;Badajoz;147;Valle de Matamoros;344;174;170;2022
06;Badajoz;148;Valle de Santa Ana;1132;557;575;2022
06;Badajoz;142;Valverde de Burguillos;273;142;131;2022
06;Badajoz;143;Valverde de Leganés;4172;2081;2091;2022
06;Badajoz;144;Valverde de Llerena;562;282;280;2022
06;Badajoz;145;Valverde de Mérida;1023;518;505;2022
06;Badajoz;149;Villafranca de los Barros;12429;6129;6300;2022
06;Badajoz;150;Villagarcía de la Torre;905;460;445;2022
06;Badajoz;151;Villagonzalo;1217;591;626;2022
06;Badajoz;152;Villalba de los Barros;1446;720;726;2022
06;Badajoz;153;Villanueva de la Serena;25873;12551;13322;2022
06;Badajoz;154;Villanueva del Fresno;3316;1671;1645;2022
06;Badajoz;156;Villar de Rena;1332;688;644;2022
06;Badajoz;155;Villar del Rey;2089;1119;970;2022
06;Badajoz;157;Villarta de los Montes;403;203;200;2022
06;Badajoz;158;Zafra;16702;8026;8676;2022
06;Badajoz;159;Zahínos;2776;1379;1397;2022
06;Badajoz;160;Zalamea de la Serena;3460;1740;1720;2022
06;Badajoz;162;Zarza, La;3386;1693;1693;2022
06;Badajoz;161;Zarza-Capilla;305;152;153;2022
07;Balears, Illes;002;Alaior;9606;4814;4792;2022
07;Balears, Illes;001;Alaró;5811;2825;2986;2022
07;Balears, Illes;003;Alcúdia;20717;10491;10226;2022
07;Balears, Illes;004;Algaida;6075;3073;3002;2022
07;Balears, Illes;005;Andratx;11735;5916;5819;2022
07;Balears, Illes;901;Ariany;912;477;435;2022
07;Balears, Illes;006;Artà;8062;4023;4039;2022
07;Balears, Illes;007;Banyalbufar;566;304;262;2022
07;Balears, Illes;008;Binissalem;9027;4498;4529;2022
07;Balears, Illes;009;Búger;1111;588;523;2022
07;Balears, Illes;010;Bunyola;7121;3499;3622;2022
07;Balears, Illes;011;Calvià;52458;26175;26283;2022
07;Balears, Illes;012;Campanet;2719;1358;1361;2022
07;Balears, Illes;013;Campos;11618;5815;5803;2022
07;Balears, Illes;014;Capdepera;12081;6093;5988;2022
07;Balears, Illes;064;Castell, Es;7525;3817;3708;2022
07;Balears, Illes;015;Ciutadella de Menorca;30811;15336;15475;2022
07;Balears, Illes;016;Consell;4230;2096;2134;2022
07;Balears, Illes;017;Costitx;1446;714;732;2022
07;Balears, Illes;018;Deià;674;328;346;2022
07;Balears, Illes;026;Eivissa;50715;25550;25165;2022
07;Balears, Illes;019;Escorca;187;112;75;2022
07;Balears, Illes;020;Esporles;5182;2546;2636;2022
07;Balears, Illes;021;Estellencs;336;175;161;2022
07;Balears, Illes;022;Felanitx;18357;9219;9138;2022
07;Balears, Illes;023;Ferreries;4944;2479;2465;2022
07;Balears, Illes;024;Formentera;11418;5938;5480;2022
07;Balears, Illes;025;Fornalutx;710;354;356;2022
07;Balears, Illes;027;Inca;34093;17155;16938;2022
07;Balears, Illes;028;Lloret de Vistalegre;1514;762;752;2022
07;Balears, Illes;029;Lloseta;6312;3155;3157;2022
07;Balears, Illes;030;Llubí;2392;1191;1201;2022
07;Balears, Illes;031;Llucmajor;38722;19595;19127;2022
07;Balears, Illes;033;Manacor;45352;22720;22632;2022
07;Balears, Illes;034;Mancor de la Vall;1596;817;779;2022
07;Balears, Illes;032;Maó;29445;14287;15158;2022
07;Balears, Illes;035;Maria de la Salut;2273;1174;1099;2022
07;Balears, Illes;036;Marratxí;38902;19542;19360;2022
07;Balears, Illes;037;Mercadal, Es;5676;2878;2798;2022
07;Balears, Illes;902;Migjorn Gran, Es;1507;750;757;2022
07;Balears, Illes;038;Montuïri;3119;1576;1543;2022
07;Balears, Illes;039;Muro;7667;3882;3785;2022
07;Balears, Illes;040;Palma;415940;203175;212765;2022
07;Balears, Illes;041;Petra;3067;1509;1558;2022
07;Balears, Illes;044;Pobla, Sa;14005;7079;6926;2022
07;Balears, Illes;042;Pollença;17126;8534;8592;2022
07;Balears, Illes;043;Porreres;5645;2856;2789;2022
07;Balears, Illes;045;Puigpunyent;2075;1026;1049;2022
07;Balears, Illes;059;Salines, Ses;5039;2519;2520;2022
07;Balears, Illes;046;Sant Antoni de Portmany;27431;14334;13097;2022
07;Balears, Illes;049;Sant Joan;2179;1079;1100;2022
07;Balears, Illes;050;Sant Joan de Labritja;6703;3401;3302;2022
07;Balears, Illes;048;Sant Josep de sa Talaia;28813;14785;14028;2022
07;Balears, Illes;051;Sant Llorenç des Cardassar;9035;4537;4498;2022
07;Balears, Illes;052;Sant Lluís;6953;3509;3444;2022
07;Balears, Illes;053;Santa Eugènia;1771;888;883;2022
07;Balears, Illes;054;Santa Eulària des Riu;40548;20454;20094;2022
07;Balears, Illes;055;Santa Margalida;12776;6555;6221;2022
07;Balears, Illes;056;Santa María del Camí;7483;3734;3749;2022
07;Balears, Illes;057;Santanyí;12321;6199;6122;2022
07;Balears, Illes;058;Selva;4243;2090;2153;2022
07;Balears, Illes;047;Sencelles;3659;1851;1808;2022
07;Balears, Illes;060;Sineu;4232;2109;2123;2022
07;Balears, Illes;061;Sóller;13454;6659;6795;2022
07;Balears, Illes;062;Son Servera;11752;5837;5915;2022
07;Balears, Illes;063;Valldemossa;2085;1049;1036;2022
07;Balears, Illes;065;Vilafranca de Bonany;3600;1831;1769;2022
08;Barcelona;001;Abrera;12697;6414;6283;2022
08;Barcelona;002;Aguilar de Segarra;287;154;133;2022
08;Barcelona;014;Aiguafreda;2552;1249;1303;2022
08;Barcelona;003;Alella;10079;4931;5148;2022
08;Barcelona;004;Alpens;281;150;131;2022
08;Barcelona;005;Ametlla del Vallès, L';9020;4529;4491;2022
08;Barcelona;006;Arenys de Mar;16155;7854;8301;2022
08;Barcelona;007;Arenys de Munt;9278;4685;4593;2022
08;Barcelona;008;Argençola;216;116;100;2022
08;Barcelona;009;Argentona;12745;6329;6416;2022
08;Barcelona;010;Artés;5902;2972;2930;2022
08;Barcelona;011;Avià;2237;1117;1120;2022
08;Barcelona;012;Avinyó;2270;1148;1122;2022
08;Barcelona;013;Avinyonet del Penedès;1706;912;794;2022
08;Barcelona;015;Badalona;223506;110151;113355;2022
08;Barcelona;904;Badia del Vallès;13163;6464;6699;2022
08;Barcelona;016;Bagà;2167;1082;1085;2022
08;Barcelona;017;Balenyà;3948;1984;1964;2022
08;Barcelona;018;Balsareny;3249;1623;1626;2022
08;Barcelona;252;Barberà del Vallès;33082;16250;16832;2022
08;Barcelona;019;Barcelona;1636193;778674;857519;2022
08;Barcelona;020;Begues;7450;3725;3725;2022
08;Barcelona;021;Bellprat;74;46;28;2022
08;Barcelona;022;Berga;16762;8273;8489;2022
08;Barcelona;023;Bigues i Riells del Fai;9757;4961;4796;2022
08;Barcelona;024;Borredà;448;251;197;2022
08;Barcelona;025;Bruc, El;2218;1181;1037;2022
08;Barcelona;026;Brull, El;278;150;128;2022
08;Barcelona;027;Cabanyes, Les;999;512;487;2022
08;Barcelona;028;Cabrera d'Anoia;1606;850;756;2022
08;Barcelona;029;Cabrera de Mar;4848;2429;2419;2022
08;Barcelona;030;Cabrils;7729;3821;3908;2022
08;Barcelona;031;Calaf;3590;1812;1778;2022
08;Barcelona;034;Calders;1101;569;532;2022
08;Barcelona;033;Caldes de Montbui;17932;8949;8983;2022
08;Barcelona;032;Caldes d'Estrac;3148;1519;1629;2022
08;Barcelona;035;Calella;19363;9393;9970;2022
08;Barcelona;037;Calldetenes;2532;1296;1236;2022
08;Barcelona;038;Callús;2122;1043;1079;2022
08;Barcelona;036;Calonge de Segarra;195;98;97;2022
08;Barcelona;039;Campins;557;284;273;2022
08;Barcelona;040;Canet de Mar;14845;7216;7629;2022
08;Barcelona;041;Canovelles;16761;8632;8129;2022
08;Barcelona;042;Cànoves i Samalús;3289;1672;1617;2022
08;Barcelona;043;Canyelles;5007;2613;2394;2022
08;Barcelona;044;Capellades;5344;2655;2689;2022
08;Barcelona;045;Capolat;89;42;47;2022
08;Barcelona;046;Cardedeu;18785;9154;9631;2022
08;Barcelona;047;Cardona;4575;2248;2327;2022
08;Barcelona;048;Carme;754;391;363;2022
08;Barcelona;049;Casserres;1646;820;826;2022
08;Barcelona;057;Castell de l'Areny;69;38;31;2022
08;Barcelona;052;Castellar de n'Hug;176;95;81;2022
08;Barcelona;050;Castellar del Riu;175;99;76;2022
08;Barcelona;051;Castellar del Vallès;24933;12344;12589;2022
08;Barcelona;053;Castellbell i el Vilar;3889;2003;1886;2022
08;Barcelona;054;Castellbisbal;12735;6403;6332;2022
08;Barcelona;055;Castellcir;778;404;374;2022
08;Barcelona;056;Castelldefels;67307;32948;34359;2022
08;Barcelona;058;Castellet i la Gornal;2474;1281;1193;2022
08;Barcelona;060;Castellfollit de Riubregós;159;87;72;2022
08;Barcelona;059;Castellfollit del Boix;460;232;228;2022
08;Barcelona;061;Castellgalí;2236;1142;1094;2022
08;Barcelona;062;Castellnou de Bages;1431;761;670;2022
08;Barcelona;063;Castellolí;636;307;329;2022
08;Barcelona;064;Castellterçol;2655;1360;1295;2022
08;Barcelona;065;Castellví de la Marca;1614;833;781;2022
08;Barcelona;066;Castellví de Rosanes;2096;1034;1062;2022
08;Barcelona;067;Centelles;7641;3754;3887;2022
08;Barcelona;268;Cercs;1169;582;587;2022
08;Barcelona;266;Cerdanyola del Vallès;57291;27889;29402;2022
08;Barcelona;068;Cervelló;9307;4697;4610;2022
08;Barcelona;069;Collbató;4726;2426;2300;2022
08;Barcelona;070;Collsuspina;398;199;199;2022
08;Barcelona;071;Copons;333;167;166;2022
08;Barcelona;072;Corbera de Llobregat;15210;7650;7560;2022
08;Barcelona;073;Cornellà de Llobregat;89039;43139;45900;2022
08;Barcelona;074;Cubelles;16386;8257;8129;2022
08;Barcelona;075;Dosrius;5710;2872;2838;2022
08;Barcelona;076;Esparreguera;22365;11287;11078;2022
08;Barcelona;077;Esplugues de Llobregat;46414;22106;24308;2022
08;Barcelona;078;Espunyola, L';265;132;133;2022
08;Barcelona;254;Esquirol, L';2245;1117;1128;2022
08;Barcelona;079;Estany, L';391;213;178;2022
08;Barcelona;134;Figaró-Montmany;1108;537;571;2022
08;Barcelona;080;Fígols;45;28;17;2022
08;Barcelona;082;Fogars de la Selva;1564;809;755;2022
08;Barcelona;081;Fogars de Montclús;493;265;228;2022
08;Barcelona;083;Folgueroles;2254;1135;1119;2022
08;Barcelona;084;Fonollosa;1546;781;765;2022
08;Barcelona;085;Font-rubí;1446;768;678;2022
08;Barcelona;086;Franqueses del Vallès, Les;20322;10248;10074;2022
08;Barcelona;090;Gaià;179;94;85;2022
08;Barcelona;087;Gallifa;186;96;90;2022
08;Barcelona;088;Garriga, La;16788;8095;8693;2022
08;Barcelona;089;Gavà;46974;22982;23992;2022
08;Barcelona;091;Gelida;7814;3921;3893;2022
08;Barcelona;092;Gironella;4940;2453;2487;2022
08;Barcelona;093;Gisclareny;28;18;10;2022
08;Barcelona;094;Granada, La;2207;1104;1103;2022
08;Barcelona;095;Granera;80;51;29;2022
08;Barcelona;096;Granollers;61983;30569;31414;2022
08;Barcelona;097;Gualba;1610;816;794;2022
08;Barcelona;099;Guardiola de Berguedà;918;481;437;2022
08;Barcelona;100;Gurb;2702;1392;1310;2022
08;Barcelona;101;Hospitalet de Llobregat, L';265444;128539;136905;2022
08;Barcelona;162;Hostalets de Pierola, Els;3127;1593;1534;2022
08;Barcelona;102;Igualada;40767;20027;20740;2022
08;Barcelona;103;Jorba;806;415;391;2022
08;Barcelona;104;Llacuna, La;942;497;445;2022
08;Barcelona;105;Llagosta, La;13155;6451;6704;2022
08;Barcelona;107;Lliçà d'Amunt;15801;8046;7755;2022
08;Barcelona;108;Lliçà de Vall;6760;3443;3317;2022
08;Barcelona;106;Llinars del Vallès;10205;5056;5149;2022
08;Barcelona;109;Lluçà;279;137;142;2022
08;Barcelona;110;Malgrat de Mar;19093;9455;9638;2022
08;Barcelona;111;Malla;272;137;135;2022
08;Barcelona;112;Manlleu;20883;10478;10405;2022
08;Barcelona;113;Manresa;77452;37964;39488;2022
08;Barcelona;242;Marganell;282;143;139;2022
08;Barcelona;114;Martorell;28684;14637;14047;2022
08;Barcelona;115;Martorelles;4859;2454;2405;2022
08;Barcelona;116;Masies de Roda, Les;733;371;362;2022
08;Barcelona;117;Masies de Voltregà, Les;3133;1551;1582;2022
08;Barcelona;118;Masnou, El;23829;11464;12365;2022
08;Barcelona;119;Masquefa;9744;4966;4778;2022
08;Barcelona;120;Matadepera;9752;4871;4881;2022
08;Barcelona;121;Mataró;128956;63951;65005;2022
08;Barcelona;122;Mediona;2517;1292;1225;2022
08;Barcelona;138;Moià;6548;3374;3174;2022
08;Barcelona;123;Molins de Rei;26242;12806;13436;2022
08;Barcelona;124;Mollet del Vallès;51294;25268;26026;2022
08;Barcelona;128;Monistrol de Calders;742;397;345;2022
08;Barcelona;127;Monistrol de Montserrat;3166;1625;1541;2022
08;Barcelona;125;Montcada i Reixac;36666;18069;18597;2022
08;Barcelona;130;Montclar;136;69;67;2022
08;Barcelona;131;Montesquiu;1059;526;533;2022
08;Barcelona;126;Montgat;12277;6058;6219;2022
08;Barcelona;132;Montmajor;484;243;241;2022
08;Barcelona;133;Montmaneu;166;91;75;2022
08;Barcelona;135;Montmeló;8793;4304;4489;2022
08;Barcelona;136;Montornès del Vallès;16707;8423;8284;2022
08;Barcelona;137;Montseny;370;188;182;2022
08;Barcelona;129;Muntanyola;700;368;332;2022
08;Barcelona;139;Mura;232;119;113;2022
08;Barcelona;140;Navarcles;6067;2955;3112;2022
08;Barcelona;141;Navàs;6018;2965;3053;2022
08;Barcelona;142;Nou de Berguedà, La;179;93;86;2022
08;Barcelona;143;Òdena;3728;1920;1808;2022
08;Barcelona;145;Olèrdola;3884;2030;1854;2022
08;Barcelona;146;Olesa de Bonesvalls;2016;1052;964;2022
08;Barcelona;147;Olesa de Montserrat;24272;12129;12143;2022
08;Barcelona;148;Olivella;4339;2238;2101;2022
08;Barcelona;149;Olost;1206;597;609;2022
08;Barcelona;144;Olvan;876;436;440;2022
08;Barcelona;150;Orís;347;179;168;2022
08;Barcelona;151;Oristà;573;295;278;2022
08;Barcelona;152;Orpí;159;82;77;2022
08;Barcelona;153;Òrrius;793;399;394;2022
08;Barcelona;154;Pacs del Penedès;935;467;468;2022
08;Barcelona;155;Palafolls;9661;4845;4816;2022
08;Barcelona;156;Palau-solità i Plegamans;14911;7291;7620;2022
08;Barcelona;157;Pallejà;11593;5760;5833;2022
08;Barcelona;905;Palma de Cervelló, La;3026;1494;1532;2022
08;Barcelona;158;Papiol, El;4274;2133;2141;2022
08;Barcelona;159;Parets del Vallès;18889;9422;9467;2022
08;Barcelona;160;Perafita;418;213;205;2022
08;Barcelona;161;Piera;16787;8616;8171;2022
08;Barcelona;163;Pineda de Mar;28083;13947;14136;2022
08;Barcelona;164;Pla del Penedès, El;1335;677;658;2022
08;Barcelona;165;Pobla de Claramunt, La;2275;1159;1116;2022
08;Barcelona;166;Pobla de Lillet, La;1079;524;555;2022
08;Barcelona;167;Polinyà;8451;4252;4199;2022
08;Barcelona;182;Pont de Vilomara i Rocafort, El;4024;2082;1942;2022
08;Barcelona;168;Pontons;507;278;229;2022
08;Barcelona;169;Prat de Llobregat, El;65030;31752;33278;2022
08;Barcelona;171;Prats de Lluçanès;2627;1325;1302;2022
08;Barcelona;170;Prats de Rei, Els;554;298;256;2022
08;Barcelona;230;Premià de Dalt;10400;5179;5221;2022
08;Barcelona;172;Premià de Mar;28518;13898;14620;2022
08;Barcelona;174;Puigdàlber;555;268;287;2022
08;Barcelona;175;Puig-reig;4327;2153;2174;2022
08;Barcelona;176;Pujalt;204;113;91;2022
08;Barcelona;177;Quar, La;47;29;18;2022
08;Barcelona;178;Rajadell;545;283;262;2022
08;Barcelona;179;Rellinars;915;480;435;2022
08;Barcelona;180;Ripollet;39031;19232;19799;2022
08;Barcelona;181;Roca del Vallès, La;10776;5411;5365;2022
08;Barcelona;183;Roda de Ter;6555;3276;3279;2022
08;Barcelona;184;Rubí;79007;39072;39935;2022
08;Barcelona;185;Rubió;244;141;103;2022
08;Barcelona;901;Rupit i Pruit;279;139;140;2022
08;Barcelona;187;Sabadell;215760;104747;111013;2022
08;Barcelona;188;Sagàs;157;81;76;2022
08;Barcelona;190;Saldes;298;169;129;2022
08;Barcelona;191;Sallent;6805;3312;3493;2022
08;Barcelona;194;Sant Adrià de Besòs;36918;18068;18850;2022
08;Barcelona;195;Sant Agustí de Lluçanès;100;51;49;2022
08;Barcelona;196;Sant Andreu de la Barca;26965;13304;13661;2022
08;Barcelona;197;Sant Andreu de Llavaneres;11593;5694;5899;2022
08;Barcelona;198;Sant Antoni de Vilamajor;6483;3204;3279;2022
08;Barcelona;199;Sant Bartomeu del Grau;924;485;439;2022
08;Barcelona;200;Sant Boi de Llobregat;83371;40584;42787;2022
08;Barcelona;201;Sant Boi de Lluçanès;575;295;280;2022
08;Barcelona;203;Sant Cebrià de Vallalta;3619;1882;1737;2022
08;Barcelona;202;Sant Celoni;18285;9112;9173;2022
08;Barcelona;204;Sant Climent de Llobregat;4170;2086;2084;2022
08;Barcelona;205;Sant Cugat del Vallès;95725;46536;49189;2022
08;Barcelona;206;Sant Cugat Sesgarrigues;1009;490;519;2022
08;Barcelona;207;Sant Esteve de Palautordera;3043;1504;1539;2022
08;Barcelona;208;Sant Esteve Sesrovires;7889;3962;3927;2022
08;Barcelona;210;Sant Feliu de Codines;6460;3262;3198;2022
08;Barcelona;211;Sant Feliu de Llobregat;45642;22155;23487;2022
08;Barcelona;212;Sant Feliu Sasserra;611;327;284;2022
08;Barcelona;209;Sant Fost de Campsentelles;9064;4521;4543;2022
08;Barcelona;213;Sant Fruitós de Bages;9025;4452;4573;2022
08;Barcelona;215;Sant Hipòlit de Voltregà;3644;1841;1803;2022
08;Barcelona;193;Sant Iscle de Vallalta;1433;765;668;2022
08;Barcelona;216;Sant Jaume de Frontanyà;31;16;15;2022
08;Barcelona;218;Sant Joan de Vilatorrada;10820;5396;5424;2022
08;Barcelona;217;Sant Joan Despí;34039;16538;17501;2022
08;Barcelona;903;Sant Julià de Cerdanyola;241;134;107;2022
08;Barcelona;220;Sant Julià de Vilatorta;3193;1581;1612;2022
08;Barcelona;221;Sant Just Desvern;19806;9570;10236;2022
08;Barcelona;222;Sant Llorenç d'Hortons;2503;1263;1240;2022
08;Barcelona;223;Sant Llorenç Savall;2524;1260;1264;2022
08;Barcelona;225;Sant Martí d'Albars;119;57;62;2022
08;Barcelona;224;Sant Martí de Centelles;1232;621;611;2022
08;Barcelona;226;Sant Martí de Tous;1243;626;617;2022
08;Barcelona;227;Sant Martí Sarroca;3313;1654;1659;2022
08;Barcelona;228;Sant Martí Sesgueioles;361;187;174;2022
08;Barcelona;229;Sant Mateu de Bages;628;321;307;2022
08;Barcelona;231;Sant Pere de Ribes;31688;15769;15919;2022
08;Barcelona;232;Sant Pere de Riudebitlles;2404;1213;1191;2022
08;Barcelona;233;Sant Pere de Torelló;2514;1293;1221;2022
08;Barcelona;234;Sant Pere de Vilamajor;4815;2439;2376;2022
08;Barcelona;189;Sant Pere Sallavinera;167;89;78;2022
08;Barcelona;235;Sant Pol de Mar;5680;2779;2901;2022
08;Barcelona;236;Sant Quintí de Mediona;2393;1212;1181;2022
08;Barcelona;237;Sant Quirze de Besora;2142;1035;1107;2022
08;Barcelona;238;Sant Quirze del Vallès;20180;9870;10310;2022
08;Barcelona;239;Sant Quirze Safaja;672;360;312;2022
08;Barcelona;240;Sant Sadurní d'Anoia;12863;6344;6519;2022
08;Barcelona;241;Sant Sadurní d'Osormort;90;53;37;2022
08;Barcelona;098;Sant Salvador de Guardiola;3351;1714;1637;2022
08;Barcelona;262;Sant Vicenç de Castellet;9949;5001;4948;2022
08;Barcelona;264;Sant Vicenç de Montalt;6661;3309;3352;2022
08;Barcelona;265;Sant Vicenç de Torelló;2077;1041;1036;2022
08;Barcelona;263;Sant Vicenç dels Horts;28079;13904;14175;2022
08;Barcelona;243;Santa Cecília de Voltregà;185;103;82;2022
08;Barcelona;244;Santa Coloma de Cervelló;8309;4059;4250;2022
08;Barcelona;245;Santa Coloma de Gramenet;117981;58173;59808;2022
08;Barcelona;246;Santa Eugènia de Berga;2256;1156;1100;2022
08;Barcelona;247;Santa Eulàlia de Riuprimer;1401;700;701;2022
08;Barcelona;248;Santa Eulàlia de Ronçana;7740;3883;3857;2022
08;Barcelona;249;Santa Fe del Penedès;370;182;188;2022
08;Barcelona;250;Santa Margarida de Montbui;10294;5189;5105;2022
08;Barcelona;251;Santa Margarida i els Monjos;7624;3875;3749;2022
08;Barcelona;253;Santa Maria de Besora;159;83;76;2022
08;Barcelona;256;Santa Maria de Martorelles;889;445;444;2022
08;Barcelona;255;Santa Maria de Merlès;184;92;92;2022
08;Barcelona;257;Santa Maria de Miralles;138;74;64;2022
08;Barcelona;259;Santa Maria de Palautordera;9777;4895;4882;2022
08;Barcelona;258;Santa Maria d'Oló;1063;530;533;2022
08;Barcelona;260;Santa Perpètua de Mogoda;25930;13018;12912;2022
08;Barcelona;261;Santa Susanna;3755;1874;1881;2022
08;Barcelona;192;Santpedor;7612;3777;3835;2022
08;Barcelona;267;Sentmenat;9417;4761;4656;2022
08;Barcelona;269;Seva;3736;1924;1812;2022
08;Barcelona;270;Sitges;31222;15696;15526;2022
08;Barcelona;271;Sobremunt;83;34;49;2022
08;Barcelona;272;Sora;219;120;99;2022
08;Barcelona;273;Subirats;3241;1678;1563;2022
08;Barcelona;274;Súria;5921;2873;3048;2022
08;Barcelona;276;Tagamanent;340;178;162;2022
08;Barcelona;277;Talamanca;219;122;97;2022
08;Barcelona;278;Taradell;6699;3349;3350;2022
08;Barcelona;275;Tavèrnoles;329;166;163;2022
08;Barcelona;280;Tavertet;116;62;54;2022
08;Barcelona;281;Teià;6635;3260;3375;2022
08;Barcelona;279;Terrassa;224114;110205;113909;2022
08;Barcelona;282;Tiana;9110;4402;4708;2022
08;Barcelona;283;Tona;8368;4140;4228;2022
08;Barcelona;284;Tordera;18022;9134;8888;2022
08;Barcelona;285;Torelló;14726;7365;7361;2022
08;Barcelona;286;Torre de Claramunt, La;3966;2058;1908;2022
08;Barcelona;287;Torrelavit;1457;748;709;2022
08;Barcelona;288;Torrelles de Foix;2557;1359;1198;2022
08;Barcelona;289;Torrelles de Llobregat;6186;3072;3114;2022
08;Barcelona;290;Ullastrell;2139;1060;1079;2022
08;Barcelona;291;Vacarisses;7325;3779;3546;2022
08;Barcelona;292;Vallbona d'Anoia;1387;713;674;2022
08;Barcelona;293;Vallcebre;268;144;124;2022
08;Barcelona;294;Vallgorguina;3144;1603;1541;2022
08;Barcelona;295;Vallirana;15658;7803;7855;2022
08;Barcelona;296;Vallromanes;2632;1357;1275;2022
08;Barcelona;297;Veciana;182;100;82;2022
08;Barcelona;298;Vic;47545;24069;23476;2022
08;Barcelona;299;Vilada;439;237;202;2022
08;Barcelona;301;Viladecans;66720;32992;33728;2022
08;Barcelona;300;Viladecavalls;7644;3794;3850;2022
08;Barcelona;305;Vilafranca del Penedès;40056;19469;20587;2022
08;Barcelona;306;Vilalba Sasserra;748;379;369;2022
08;Barcelona;303;Vilanova de Sau;320;153;167;2022
08;Barcelona;302;Vilanova del Camí;12699;6370;6329;2022
08;Barcelona;902;Vilanova del Vallès;5557;2809;2748;2022
08;Barcelona;307;Vilanova i la Geltrú;68152;32987;35165;2022
08;Barcelona;214;Vilassar de Dalt;9128;4521;4607;2022
08;Barcelona;219;Vilassar de Mar;21067;10148;10919;2022
08;Barcelona;304;Vilobí del Penedès;1130;589;541;2022
08;Barcelona;308;Viver i Serrateix;166;85;81;2022
48;Bizkaia;001;Abadiño;7708;3860;3848;2022
48;Bizkaia;002;Abanto y Ciérvana-Abanto Zierbena;9369;4648;4721;2022
48;Bizkaia;911;Ajangiz;480;252;228;2022
48;Bizkaia;912;Alonsotegi;2960;1463;1497;2022
48;Bizkaia;003;Amorebieta-Etxano;19587;9636;9951;2022
48;Bizkaia;004;Amoroto;398;204;194;2022
48;Bizkaia;005;Arakaldo;158;75;83;2022
48;Bizkaia;006;Arantzazu;401;199;202;2022
48;Bizkaia;093;Areatza;1249;611;638;2022
48;Bizkaia;009;Arrankudiaga;1008;498;510;2022
48;Bizkaia;914;Arratzu;432;204;228;2022
48;Bizkaia;010;Arrieta;576;299;277;2022
48;Bizkaia;011;Arrigorriaga;11954;5836;6118;2022
48;Bizkaia;023;Artea;746;374;372;2022
48;Bizkaia;008;Artzentales;720;378;342;2022
48;Bizkaia;091;Atxondo;1372;697;675;2022
48;Bizkaia;070;Aulesti;655;323;332;2022
48;Bizkaia;012;Bakio;2812;1405;1407;2022
48;Bizkaia;090;Balmaseda;7636;3674;3962;2022
48;Bizkaia;013;Barakaldo;100535;48586;51949;2022
48;Bizkaia;014;Barrika;1547;778;769;2022
48;Bizkaia;015;Basauri;40324;19505;20819;2022
48;Bizkaia;092;Bedia;1102;531;571;2022
48;Bizkaia;016;Berango;7347;3598;3749;2022
48;Bizkaia;017;Bermeo;16755;8237;8518;2022
48;Bizkaia;018;Berriatua;1220;671;549;2022
48;Bizkaia;019;Berriz;4535;2254;2281;2022
48;Bizkaia;020;Bilbao;344127;162828;181299;2022
48;Bizkaia;021;Busturia;1667;831;836;2022
48;Bizkaia;901;Derio;6819;3332;3487;2022
48;Bizkaia;026;Dima;1454;751;703;2022
48;Bizkaia;027;Durango;29609;14421;15188;2022
48;Bizkaia;028;Ea;824;439;385;2022
48;Bizkaia;031;Elantxobe;349;169;180;2022
48;Bizkaia;032;Elorrio;7309;3593;3716;2022
48;Bizkaia;902;Erandio;24446;11844;12602;2022
48;Bizkaia;033;Ereño;267;151;116;2022
48;Bizkaia;034;Ermua;15589;7724;7865;2022
48;Bizkaia;079;Errigoiti;504;268;236;2022
48;Bizkaia;029;Etxebarri;11780;5882;5898;2022
48;Bizkaia;030;Etxebarria;787;402;385;2022
48;Bizkaia;906;Forua;910;444;466;2022
48;Bizkaia;035;Fruiz;550;270;280;2022
48;Bizkaia;036;Galdakao;29285;14384;14901;2022
48;Bizkaia;037;Galdames;837;446;391;2022
48;Bizkaia;038;Gamiz-Fika;1391;699;692;2022
48;Bizkaia;039;Garai;334;164;170;2022
48;Bizkaia;040;Gatika;1642;826;816;2022
48;Bizkaia;041;Gautegiz Arteaga;866;431;435;2022
48;Bizkaia;046;Gernika-Lumo;16855;8085;8770;2022
48;Bizkaia;044;Getxo;76365;35776;40589;2022
48;Bizkaia;047;Gizaburuaga;192;97;95;2022
48;Bizkaia;042;Gordexola;1711;874;837;2022
48;Bizkaia;043;Gorliz;6031;2987;3044;2022
48;Bizkaia;045;Güeñes;6737;3261;3476;2022
48;Bizkaia;048;Ibarrangelu;680;347;333;2022
48;Bizkaia;094;Igorre;4330;2140;2190;2022
48;Bizkaia;049;Ispaster;731;384;347;2022
48;Bizkaia;910;Iurreta;3695;1822;1873;2022
48;Bizkaia;050;Izurtza;210;129;81;2022
48;Bizkaia;022;Karrantza Harana/Valle de Carranza;2712;1400;1312;2022
48;Bizkaia;907;Kortezubi;441;213;228;2022
48;Bizkaia;051;Lanestosa;261;142;119;2022
48;Bizkaia;052;Larrabetzu;2049;1005;1044;2022
48;Bizkaia;053;Laukiz;1227;602;625;2022
48;Bizkaia;054;Leioa;32172;15739;16433;2022
48;Bizkaia;057;Lekeitio;7178;3548;3630;2022
48;Bizkaia;055;Lemoa;3530;1770;1760;2022
48;Bizkaia;056;Lemoiz;1314;685;629;2022
48;Bizkaia;081;Lezama;2477;1238;1239;2022
48;Bizkaia;903;Loiu;2318;1123;1195;2022
48;Bizkaia;058;Mallabia;1185;601;584;2022
48;Bizkaia;059;Mañaria;530;271;259;2022
48;Bizkaia;060;Markina-Xemein;5042;2550;2492;2022
48;Bizkaia;061;Maruri-Jatabe;1036;528;508;2022
48;Bizkaia;062;Mendata;393;205;188;2022
48;Bizkaia;063;Mendexa;425;221;204;2022
48;Bizkaia;064;Meñaka;751;395;356;2022
48;Bizkaia;066;Morga;422;220;202;2022
48;Bizkaia;068;Mundaka;1866;922;944;2022
48;Bizkaia;069;Mungia;17662;8585;9077;2022
48;Bizkaia;007;Munitibar-Arbatzegi Gerrikaitz;473;257;216;2022
48;Bizkaia;908;Murueta;327;175;152;2022
48;Bizkaia;071;Muskiz;7367;3563;3804;2022
48;Bizkaia;067;Muxika;1483;771;712;2022
48;Bizkaia;909;Nabarniz;261;129;132;2022
48;Bizkaia;073;Ondarroa;8246;4115;4131;2022
48;Bizkaia;075;Orozko;2664;1314;1350;2022
48;Bizkaia;083;Ortuella;8466;4113;4353;2022
48;Bizkaia;072;Otxandio;1336;685;651;2022
48;Bizkaia;077;Plentzia;4376;2140;2236;2022
48;Bizkaia;078;Portugalete;44800;21413;23387;2022
48;Bizkaia;082;Santurtzi;45749;21943;23806;2022
48;Bizkaia;084;Sestao;27533;13319;14214;2022
48;Bizkaia;904;Sondika;4521;2184;2337;2022
48;Bizkaia;085;Sopela;14635;7238;7397;2022
48;Bizkaia;086;Sopuerta;2698;1339;1359;2022
48;Bizkaia;076;Sukarrieta;361;195;166;2022
48;Bizkaia;087;Trucios-Turtzioz;516;270;246;2022
48;Bizkaia;088;Ubide;164;87;77;2022
48;Bizkaia;065;Ugao-Miraballes;4128;2080;2048;2022
48;Bizkaia;089;Urduliz;5247;2604;2643;2022
48;Bizkaia;074;Urduña/Orduña;4166;2143;2023;2022
48;Bizkaia;080;Valle de Trápaga-Trapagaran;11918;5785;6133;2022
48;Bizkaia;095;Zaldibar;3020;1534;1486;2022
48;Bizkaia;096;Zalla;8300;4069;4231;2022
48;Bizkaia;905;Zamudio;3256;1617;1639;2022
48;Bizkaia;097;Zaratamo;1628;813;815;2022
48;Bizkaia;024;Zeanuri;1271;636;635;2022
48;Bizkaia;025;Zeberio;1084;552;532;2022
48;Bizkaia;913;Zierbena;1485;785;700;2022
48;Bizkaia;915;Ziortza-Bolibar;405;213;192;2022
09;Burgos;001;Abajas;29;19;10;2022
09;Burgos;003;Adrada de Haza;199;97;102;2022
09;Burgos;006;Aguas Cándidas;62;40;22;2022
09;Burgos;007;Aguilar de Bureba;51;32;19;2022
09;Burgos;009;Albillos;220;114;106;2022
09;Burgos;010;Alcocero de Mola;40;26;14;2022
09;Burgos;011;Alfoz de Bricia;76;49;27;2022
09;Burgos;907;Alfoz de Quintanadueñas;2201;1159;1042;2022
09;Burgos;012;Alfoz de Santa Gadea;103;56;47;2022
09;Burgos;013;Altable;47;28;19;2022
09;Burgos;014;Altos, Los;178;107;71;2022
09;Burgos;016;Ameyugo;121;61;60;2022
09;Burgos;017;Anguix;162;105;57;2022
09;Burgos;018;Aranda de Duero;33172;16123;17049;2022
09;Burgos;019;Arandilla;153;98;55;2022
09;Burgos;020;Arauzo de Miel;278;156;122;2022
09;Burgos;021;Arauzo de Salce;46;26;20;2022
09;Burgos;022;Arauzo de Torre;74;46;28;2022
09;Burgos;023;Arcos;1840;964;876;2022
09;Burgos;024;Arenillas de Riopisuerga;176;107;69;2022
09;Burgos;025;Arija;108;57;51;2022
09;Burgos;026;Arlanzón;416;252;164;2022
09;Burgos;027;Arraya de Oca;45;25;20;2022
09;Burgos;029;Atapuerca;182;106;76;2022
09;Burgos;030;Ausines, Los;138;85;53;2022
09;Burgos;032;Avellanosa de Muñó;100;54;46;2022
09;Burgos;033;Bahabón de Esgueva;81;44;37;2022
09;Burgos;034;Balbases, Los;316;173;143;2022
09;Burgos;035;Baños de Valdearados;332;192;140;2022
09;Burgos;036;Bañuelos de Bureba;34;20;14;2022
09;Burgos;037;Barbadillo de Herreros;110;68;42;2022
09;Burgos;038;Barbadillo del Mercado;141;76;65;2022
09;Burgos;039;Barbadillo del Pez;68;40;28;2022
09;Burgos;041;Barrio de Muñó;32;18;14;2022
09;Burgos;043;Barrios de Bureba, Los;179;102;77;2022
09;Burgos;044;Barrios de Colina;56;30;26;2022
09;Burgos;045;Basconcillos del Tozo;293;171;122;2022
09;Burgos;046;Bascuñana;20;13;7;2022
09;Burgos;047;Belbimbre;56;30;26;2022
09;Burgos;048;Belorado;1787;908;879;2022
09;Burgos;050;Berberana;52;30;22;2022
09;Burgos;051;Berlangas de Roa;182;98;84;2022
09;Burgos;052;Berzosa de Bureba;27;20;7;2022
09;Burgos;054;Bozoó;100;60;40;2022
09;Burgos;055;Brazacorta;48;31;17;2022
09;Burgos;056;Briviesca;6374;3193;3181;2022
09;Burgos;057;Bugedo;195;120;75;2022
09;Burgos;058;Buniel;602;331;271;2022
09;Burgos;059;Burgos;173483;82601;90882;2022
09;Burgos;060;Busto de Bureba;138;78;60;2022
09;Burgos;061;Cabañes de Esgueva;163;90;73;2022
09;Burgos;062;Cabezón de la Sierra;40;16;24;2022
09;Burgos;064;Caleruega;415;208;207;2022
09;Burgos;065;Campillo de Aranda;177;99;78;2022
09;Burgos;066;Campolara;54;37;17;2022
09;Burgos;067;Canicosa de la Sierra;426;228;198;2022
09;Burgos;068;Cantabrana;23;14;9;2022
09;Burgos;070;Carazo;30;20;10;2022
09;Burgos;071;Carcedo de Bureba;43;21;22;2022
09;Burgos;072;Carcedo de Burgos;465;244;221;2022
09;Burgos;073;Cardeñadijo;1425;772;653;2022
09;Burgos;074;Cardeñajimeno;1205;639;566;2022
09;Burgos;075;Cardeñuela Riopico;107;62;45;2022
09;Burgos;076;Carrias;25;19;6;2022
09;Burgos;077;Cascajares de Bureba;27;13;14;2022
09;Burgos;078;Cascajares de la Sierra;31;17;14;2022
09;Burgos;079;Castellanos de Castro;48;29;19;2022
09;Burgos;083;Castil de Peones;26;15;11;2022
09;Burgos;082;Castildelgado;37;21;16;2022
09;Burgos;084;Castrillo de la Reina;168;111;57;2022
09;Burgos;085;Castrillo de la Vega;627;335;292;2022
09;Burgos;088;Castrillo de Riopisuerga;56;34;22;2022
09;Burgos;086;Castrillo del Val;829;470;359;2022
09;Burgos;090;Castrillo Mota de Judíos;48;25;23;2022
09;Burgos;091;Castrojeriz;767;414;353;2022
09;Burgos;063;Cavia;243;142;101;2022
09;Burgos;093;Cayuela;189;104;85;2022
09;Burgos;094;Cebrecos;52;33;19;2022
09;Burgos;095;Celada del Camino;96;45;51;2022
09;Burgos;098;Cerezo de Río Tirón;512;277;235;2022
09;Burgos;100;Cerratón de Juarros;55;36;19;2022
09;Burgos;101;Ciadoncha;78;48;30;2022
09;Burgos;102;Cillaperlata;36;24;12;2022
09;Burgos;103;Cilleruelo de Abajo;208;125;83;2022
09;Burgos;104;Cilleruelo de Arriba;43;23;20;2022
09;Burgos;105;Ciruelos de Cervera;101;60;41;2022
09;Burgos;108;Cogollos;601;336;265;2022
09;Burgos;109;Condado de Treviño;1428;781;647;2022
09;Burgos;110;Contreras;83;54;29;2022
09;Burgos;112;Coruña del Conde;104;66;38;2022
09;Burgos;113;Covarrubias;533;284;249;2022
09;Burgos;114;Cubillo del Campo;101;58;43;2022
09;Burgos;115;Cubo de Bureba;107;62;45;2022
09;Burgos;117;Cueva de Roa, La;101;54;47;2022
09;Burgos;119;Cuevas de San Clemente;41;17;24;2022
09;Burgos;120;Encío;43;20;23;2022
09;Burgos;122;Espinosa de Cervera;82;53;29;2022
09;Burgos;124;Espinosa de los Monteros;1642;852;790;2022
09;Burgos;123;Espinosa del Camino;42;24;18;2022
09;Burgos;125;Estépar;630;371;259;2022
09;Burgos;127;Fontioso;45;28;17;2022
09;Burgos;128;Frandovínez;97;55;42;2022
09;Burgos;129;Fresneda de la Sierra Tirón;94;60;34;2022
09;Burgos;130;Fresneña;67;44;23;2022
09;Burgos;131;Fresnillo de las Dueñas;687;352;335;2022
09;Burgos;132;Fresno de Río Tirón;172;101;71;2022
09;Burgos;133;Fresno de Rodilla;47;27;20;2022
09;Burgos;134;Frías;267;141;126;2022
09;Burgos;135;Fuentebureba;42;23;19;2022
09;Burgos;136;Fuentecén;219;119;100;2022
09;Burgos;137;Fuentelcésped;254;128;126;2022
09;Burgos;138;Fuentelisendo;115;63;52;2022
09;Burgos;139;Fuentemolinos;94;65;29;2022
09;Burgos;140;Fuentenebro;146;86;60;2022
09;Burgos;141;Fuentespina;779;411;368;2022
09;Burgos;143;Galbarros;29;18;11;2022
09;Burgos;144;Gallega, La;44;29;15;2022
09;Burgos;148;Grijalba;110;55;55;2022
09;Burgos;149;Grisaleña;61;40;21;2022
09;Burgos;151;Gumiel de Izán;579;318;261;2022
09;Burgos;152;Gumiel de Mercado;381;204;177;2022
09;Burgos;154;Hacinas;151;92;59;2022
09;Burgos;155;Haza;29;20;9;2022
09;Burgos;159;Hontanas;73;43;30;2022
09;Burgos;160;Hontangas;95;60;35;2022
09;Burgos;162;Hontoria de la Cantera;155;85;70;2022
09;Burgos;164;Hontoria de Valdearados;165;100;65;2022
09;Burgos;163;Hontoria del Pinar;622;338;284;2022
09;Burgos;166;Hormazas, Las;98;52;46;2022
09;Burgos;167;Hornillos del Camino;54;29;25;2022
09;Burgos;168;Horra, La;314;175;139;2022
09;Burgos;169;Hortigüela;107;71;36;2022
09;Burgos;170;Hoyales de Roa;214;114;100;2022
09;Burgos;172;Huérmeces;173;101;72;2022
09;Burgos;173;Huerta de Arriba;127;70;57;2022
09;Burgos;174;Huerta de Rey;894;481;413;2022
09;Burgos;175;Humada;118;80;38;2022
09;Burgos;176;Hurones;53;37;16;2022
09;Burgos;177;Ibeas de Juarros;1418;756;662;2022
09;Burgos;178;Ibrillos;36;25;11;2022
09;Burgos;179;Iglesiarrubia;45;23;22;2022
09;Burgos;180;Iglesias;146;78;68;2022
09;Burgos;181;Isar;283;148;135;2022
09;Burgos;182;Itero del Castillo;86;50;36;2022
09;Burgos;183;Jaramillo de la Fuente;44;30;14;2022
09;Burgos;184;Jaramillo Quemado;9;8;1;2022
09;Burgos;189;Junta de Traslaloma;118;65;53;2022
09;Burgos;190;Junta de Villalba de Losa;84;45;39;2022
09;Burgos;191;Jurisdicción de Lara;40;24;16;2022
09;Burgos;192;Jurisdicción de San Zadornil;66;41;25;2022
09;Burgos;194;Lerma;2584;1294;1290;2022
09;Burgos;195;Llano de Bureba;51;36;15;2022
09;Burgos;196;Madrigal del Monte;142;85;57;2022
09;Burgos;197;Madrigalejo del Monte;183;113;70;2022
09;Burgos;198;Mahamud;107;57;50;2022
09;Burgos;199;Mambrilla de Castrejón;107;64;43;2022
09;Burgos;200;Mambrillas de Lara;47;29;18;2022
09;Burgos;201;Mamolar;26;16;10;2022
09;Burgos;202;Manciles;22;14;8;2022
09;Burgos;206;Mazuela;58;34;24;2022
09;Burgos;208;Mecerreyes;194;108;86;2022
09;Burgos;209;Medina de Pomar;5856;2948;2908;2022
09;Burgos;211;Melgar de Fernamental;1535;848;687;2022
09;Burgos;213;Merindad de Cuesta-Urria;268;153;115;2022
09;Burgos;214;Merindad de Montija;733;438;295;2022
09;Burgos;906;Merindad de Río Ubierna;1392;787;605;2022
09;Burgos;215;Merindad de Sotoscueva;404;231;173;2022
09;Burgos;216;Merindad de Valdeporres;413;216;197;2022
09;Burgos;217;Merindad de Valdivielso;386;215;171;2022
09;Burgos;218;Milagros;433;231;202;2022
09;Burgos;219;Miranda de Ebro;35239;17332;17907;2022
09;Burgos;220;Miraveche;94;60;34;2022
09;Burgos;221;Modúbar de la Emparedada;789;428;361;2022
09;Burgos;223;Monasterio de la Sierra;42;26;16;2022
09;Burgos;224;Monasterio de Rodilla;163;88;75;2022
09;Burgos;225;Moncalvillo;81;47;34;2022
09;Burgos;226;Monterrubio de la Demanda;56;34;22;2022
09;Burgos;227;Montorio;154;87;67;2022
09;Burgos;228;Moradillo de Roa;161;88;73;2022
09;Burgos;229;Nava de Roa;200;107;93;2022
09;Burgos;230;Navas de Bureba;27;13;14;2022
09;Burgos;231;Nebreda;53;35;18;2022
09;Burgos;232;Neila;139;79;60;2022
09;Burgos;235;Olmedillo de Roa;196;113;83;2022
09;Burgos;236;Olmillos de Muñó;36;21;15;2022
09;Burgos;238;Oña;976;514;462;2022
09;Burgos;239;Oquillas;51;27;24;2022
09;Burgos;241;Orbaneja Riopico;355;202;153;2022
09;Burgos;242;Padilla de Abajo;70;42;28;2022
09;Burgos;243;Padilla de Arriba;84;54;30;2022
09;Burgos;244;Padrones de Bureba;47;22;25;2022
09;Burgos;246;Palacios de la Sierra;710;367;343;2022
09;Burgos;247;Palacios de Riopisuerga;21;11;10;2022
09;Burgos;248;Palazuelos de la Sierra;92;56;36;2022
09;Burgos;249;Palazuelos de Muñó;55;30;25;2022
09;Burgos;250;Pampliega;286;158;128;2022
09;Burgos;251;Pancorbo;421;220;201;2022
09;Burgos;253;Pardilla;119;72;47;2022
09;Burgos;255;Partido de la Sierra en Tobalina;81;50;31;2022
09;Burgos;256;Pedrosa de Duero;492;301;191;2022
09;Burgos;259;Pedrosa de Río Úrbel;258;152;106;2022
09;Burgos;257;Pedrosa del Páramo;87;53;34;2022
09;Burgos;258;Pedrosa del Príncipe;168;95;73;2022
09;Burgos;261;Peñaranda de Duero;510;259;251;2022
09;Burgos;262;Peral de Arlanza;175;97;78;2022
09;Burgos;265;Piérnigas;42;25;17;2022
09;Burgos;266;Pineda de la Sierra;99;65;34;2022
09;Burgos;267;Pineda Trasmonte;110;65;45;2022
09;Burgos;268;Pinilla de los Barruecos;98;59;39;2022
09;Burgos;269;Pinilla de los Moros;37;20;17;2022
09;Burgos;270;Pinilla Trasmonte;171;98;73;2022
09;Burgos;272;Poza de la Sal;284;157;127;2022
09;Burgos;273;Prádanos de Bureba;55;33;22;2022
09;Burgos;274;Pradoluengo;1096;560;536;2022
09;Burgos;275;Presencio;199;119;80;2022
09;Burgos;276;Puebla de Arganzón, La;526;280;246;2022
09;Burgos;277;Puentedura;120;77;43;2022
09;Burgos;279;Quemada;259;159;100;2022
09;Burgos;281;Quintana del Pidio;150;80;70;2022
09;Burgos;280;Quintanabureba;33;19;14;2022
09;Burgos;283;Quintanaélez;45;24;21;2022
09;Burgos;287;Quintanaortuño;268;144;124;2022
09;Burgos;288;Quintanapalla;113;55;58;2022
09;Burgos;289;Quintanar de la Sierra;1557;816;741;2022
09;Burgos;292;Quintanavides;70;40;30;2022
09;Burgos;294;Quintanilla de la Mata;117;72;45;2022
09;Burgos;901;Quintanilla del Agua y Tordueles;343;190;153;2022
09;Burgos;295;Quintanilla del Coco;52;26;26;2022
09;Burgos;298;Quintanilla San García;73;43;30;2022
09;Burgos;301;Quintanilla Vivar;878;474;404;2022
09;Burgos;297;Quintanillas, Las;380;224;156;2022
09;Burgos;302;Rabanera del Pinar;96;58;38;2022
09;Burgos;303;Rábanos;80;48;32;2022
09;Burgos;304;Rabé de las Calzadas;226;116;110;2022
09;Burgos;306;Rebolledo de la Torre;94;54;40;2022
09;Burgos;307;Redecilla del Camino;107;64;43;2022
09;Burgos;308;Redecilla del Campo;65;37;28;2022
09;Burgos;309;Regumiel de la Sierra;323;177;146;2022
09;Burgos;310;Reinoso;15;11;4;2022
09;Burgos;311;Retuerta;65;40;25;2022
09;Burgos;314;Revilla del Campo;102;62;40;2022
09;Burgos;316;Revilla Vallejera;111;65;46;2022
09;Burgos;312;Revilla y Ahedo, La;94;54;40;2022
09;Burgos;315;Revillarruz;601;316;285;2022
09;Burgos;317;Rezmondo;20;8;12;2022
09;Burgos;318;Riocavado de la Sierra;56;37;19;2022
09;Burgos;321;Roa;2201;1122;1079;2022
09;Burgos;323;Rojas;64;43;21;2022
09;Burgos;325;Royuela de Río Franco;178;105;73;2022
09;Burgos;326;Rubena;193;110;83;2022
09;Burgos;327;Rublacedo de Abajo;28;13;15;2022
09;Burgos;328;Rucandio;67;32;35;2022
09;Burgos;329;Salas de Bureba;134;77;57;2022
09;Burgos;330;Salas de los Infantes;1970;1024;946;2022
09;Burgos;332;Saldaña de Burgos;184;111;73;2022
09;Burgos;334;Salinillas de Bureba;50;37;13;2022
09;Burgos;335;San Adrián de Juarros;95;61;34;2022
09;Burgos;337;San Juan del Monte;151;84;67;2022
09;Burgos;338;San Mamés de Burgos;317;180;137;2022
09;Burgos;339;San Martín de Rubiales;140;86;54;2022
09;Burgos;340;San Millán de Lara;65;48;17;2022
09;Burgos;360;San Vicente del Valle;29;20;9;2022
09;Burgos;343;Santa Cecilia;105;64;41;2022
09;Burgos;345;Santa Cruz de la Salceda;139;81;58;2022
09;Burgos;346;Santa Cruz del Valle Urbión;103;68;35;2022
09;Burgos;347;Santa Gadea del Cid;155;84;71;2022
09;Burgos;348;Santa Inés;146;82;64;2022
09;Burgos;350;Santa María del Campo;516;281;235;2022
09;Burgos;351;Santa María del Invierno;62;45;17;2022
09;Burgos;352;Santa María del Mercadillo;97;66;31;2022
09;Burgos;353;Santa María Rivarredonda;93;58;35;2022
09;Burgos;354;Santa Olalla de Bureba;40;27;13;2022
09;Burgos;355;Santibáñez de Esgueva;85;47;38;2022
09;Burgos;356;Santibáñez del Val;57;34;23;2022
09;Burgos;358;Santo Domingo de Silos;264;168;96;2022
09;Burgos;361;Sargentes de la Lora;119;67;52;2022
09;Burgos;362;Sarracín;264;139;125;2022
09;Burgos;363;Sasamón;957;546;411;2022
09;Burgos;365;Sequera de Haza, La;26;19;7;2022
09;Burgos;366;Solarana;80;48;32;2022
09;Burgos;368;Sordillos;26;16;10;2022
09;Burgos;369;Sotillo de la Ribera;485;252;233;2022
09;Burgos;372;Sotragero;294;163;131;2022
09;Burgos;373;Sotresgudo;433;257;176;2022
09;Burgos;374;Susinos del Páramo;115;72;43;2022
09;Burgos;375;Tamarón;44;25;19;2022
09;Burgos;377;Tardajos;812;441;371;2022
09;Burgos;378;Tejada;34;19;15;2022
09;Burgos;380;Terradillos de Esgueva;69;34;35;2022
09;Burgos;381;Tinieblas de la Sierra;27;14;13;2022
09;Burgos;382;Tobar;26;19;7;2022
09;Burgos;384;Tordómar;324;179;145;2022
09;Burgos;386;Torrecilla del Monte;78;44;34;2022
09;Burgos;387;Torregalindo;123;76;47;2022
09;Burgos;388;Torrelara;34;20;14;2022
09;Burgos;389;Torrepadre;72;42;30;2022
09;Burgos;390;Torresandino;583;306;277;2022
09;Burgos;391;Tórtoles de Esgueva;406;225;181;2022
09;Burgos;392;Tosantos;51;27;24;2022
09;Burgos;394;Trespaderne;735;366;369;2022
09;Burgos;395;Tubilla del Agua;135;86;49;2022
09;Burgos;396;Tubilla del Lago;165;87;78;2022
09;Burgos;398;Úrbel del Castillo;67;43;24;2022
09;Burgos;400;Vadocondes;369;200;169;2022
09;Burgos;403;Valdeande;99;59;40;2022
09;Burgos;405;Valdezate;122;69;53;2022
09;Burgos;406;Valdorros;333;191;142;2022
09;Burgos;408;Vallarta de Bureba;43;27;16;2022
09;Burgos;904;Valle de las Navas;536;316;220;2022
09;Burgos;908;Valle de Losa;497;284;213;2022
09;Burgos;409;Valle de Manzanedo;132;68;64;2022
09;Burgos;410;Valle de Mena;4030;2033;1997;2022
09;Burgos;411;Valle de Oca;165;97;68;2022
09;Burgos;902;Valle de Santibáñez;476;278;198;2022
09;Burgos;905;Valle de Sedano;417;239;178;2022
09;Burgos;412;Valle de Tobalina;896;494;402;2022
09;Burgos;413;Valle de Valdebezana;459;249;210;2022
09;Burgos;414;Valle de Valdelaguna;196;119;77;2022
09;Burgos;415;Valle de Valdelucio;333;186;147;2022
09;Burgos;416;Valle de Zamanzas;46;31;15;2022
09;Burgos;417;Vallejera;39;22;17;2022
09;Burgos;418;Valles de Palenzuela;81;40;41;2022
09;Burgos;419;Valluércanes;67;45;22;2022
09;Burgos;407;Valmala;27;13;14;2022
09;Burgos;422;Vid de Bureba, La;24;14;10;2022
09;Burgos;421;Vid y Barrios, La;260;150;110;2022
09;Burgos;423;Vileña;25;15;10;2022
09;Burgos;427;Villadiego;1478;817;661;2022
09;Burgos;428;Villaescusa de Roa;100;54;46;2022
09;Burgos;429;Villaescusa la Sombría;57;40;17;2022
09;Burgos;430;Villaespasa;28;17;11;2022
09;Burgos;431;Villafranca Montes de Oca;116;70;46;2022
09;Burgos;432;Villafruela;154;92;62;2022
09;Burgos;433;Villagalijo;52;30;22;2022
09;Burgos;434;Villagonzalo Pedernales;1856;978;878;2022
09;Burgos;437;Villahoz;299;165;134;2022
09;Burgos;438;Villalba de Duero;714;378;336;2022
09;Burgos;439;Villalbilla de Burgos;1462;787;675;2022
09;Burgos;440;Villalbilla de Gumiel;86;54;32;2022
09;Burgos;441;Villaldemiro;95;55;40;2022
09;Burgos;442;Villalmanzo;423;228;195;2022
09;Burgos;443;Villamayor de los Montes;160;80;80;2022
09;Burgos;444;Villamayor de Treviño;61;32;29;2022
09;Burgos;445;Villambistia;45;33;12;2022
09;Burgos;446;Villamedianilla;9;6;3;2022
09;Burgos;447;Villamiel de la Sierra;44;27;17;2022
09;Burgos;448;Villangómez;223;135;88;2022
09;Burgos;449;Villanueva de Argaño;118;67;51;2022
09;Burgos;450;Villanueva de Carazo;24;15;9;2022
09;Burgos;451;Villanueva de Gumiel;284;147;137;2022
09;Burgos;454;Villanueva de Teba;43;28;15;2022
09;Burgos;455;Villaquirán de la Puebla;46;26;20;2022
09;Burgos;456;Villaquirán de los Infantes;151;80;71;2022
09;Burgos;903;Villarcayo de Merindad de Castilla la Vieja;3942;2029;1913;2022
09;Burgos;458;Villariezo;717;391;326;2022
09;Burgos;460;Villasandino;172;97;75;2022
09;Burgos;463;Villasur de Herreros;278;169;109;2022
09;Burgos;464;Villatuelda;46;24;22;2022
09;Burgos;466;Villaverde del Monte;115;69;46;2022
09;Burgos;467;Villaverde-Mogina;74;51;23;2022
09;Burgos;471;Villayerno Morquillas;210;108;102;2022
09;Burgos;472;Villazopeque;54;30;24;2022
09;Burgos;473;Villegas;94;51;43;2022
09;Burgos;476;Villoruebo;69;45;24;2022
09;Burgos;424;Viloria de Rioja;37;23;14;2022
09;Burgos;425;Vilviestre del Pinar;528;295;233;2022
09;Burgos;478;Vizcaínos;47;35;12;2022
09;Burgos;480;Zael;121;61;60;2022
09;Burgos;482;Zarzosa de Río Pisuerga;32;21;11;2022
09;Burgos;483;Zazuar;199;103;96;2022
09;Burgos;485;Zuñeda;57;30;27;2022
10;Cáceres;001;Abadía;340;185;155;2022
10;Cáceres;002;Abertura;388;195;193;2022
10;Cáceres;003;Acebo;542;263;279;2022
10;Cáceres;004;Acehúche;816;416;400;2022
10;Cáceres;005;Aceituna;588;301;287;2022
10;Cáceres;006;Ahigal;1371;685;686;2022
10;Cáceres;903;Alagón del Río;924;456;468;2022
10;Cáceres;007;Albalá;665;345;320;2022
10;Cáceres;008;Alcántara;1361;670;691;2022
10;Cáceres;009;Alcollarín;269;138;131;2022
10;Cáceres;010;Alcuéscar;2470;1278;1192;2022
10;Cáceres;012;Aldea del Cano;617;295;322;2022
10;Cáceres;013;Aldea del Obispo, La;305;165;140;2022
10;Cáceres;011;Aldeacentenera;585;308;277;2022
10;Cáceres;014;Aldeanueva de la Vera;2025;999;1026;2022
10;Cáceres;015;Aldeanueva del Camino;742;368;374;2022
10;Cáceres;016;Aldehuela de Jerte;365;191;174;2022
10;Cáceres;017;Alía;761;400;361;2022
10;Cáceres;018;Aliseda;1751;897;854;2022
10;Cáceres;019;Almaraz;1687;864;823;2022
10;Cáceres;020;Almoharín;1782;879;903;2022
10;Cáceres;021;Arroyo de la Luz;5596;2769;2827;2022
10;Cáceres;023;Arroyomolinos;827;425;402;2022
10;Cáceres;022;Arroyomolinos de la Vera;412;206;206;2022
10;Cáceres;024;Baños de Montemayor;739;346;393;2022
10;Cáceres;025;Barrado;353;183;170;2022
10;Cáceres;026;Belvís de Monroy;737;388;349;2022
10;Cáceres;027;Benquerencia;79;47;32;2022
10;Cáceres;028;Berrocalejo;106;57;49;2022
10;Cáceres;029;Berzocana;404;211;193;2022
10;Cáceres;030;Bohonal de Ibor;491;243;248;2022
10;Cáceres;031;Botija;185;98;87;2022
10;Cáceres;032;Brozas;1774;874;900;2022
10;Cáceres;033;Cabañas del Castillo;402;207;195;2022
10;Cáceres;034;Cabezabellosa;343;170;173;2022
10;Cáceres;035;Cabezuela del Valle;2152;1091;1061;2022
10;Cáceres;036;Cabrero;347;192;155;2022
10;Cáceres;037;Cáceres;95456;45716;49740;2022
10;Cáceres;038;Cachorrilla;91;45;46;2022
10;Cáceres;039;Cadalso;414;208;206;2022
10;Cáceres;040;Calzadilla;473;244;229;2022
10;Cáceres;041;Caminomorisco;1155;606;549;2022
10;Cáceres;042;Campillo de Deleitosa;81;37;44;2022
10;Cáceres;043;Campo Lugar;822;410;412;2022
10;Cáceres;044;Cañamero;1641;866;775;2022
10;Cáceres;045;Cañaveral;1018;505;513;2022
10;Cáceres;046;Carbajo;196;101;95;2022
10;Cáceres;047;Carcaboso;1088;551;537;2022
10;Cáceres;048;Carrascalejo;233;121;112;2022
10;Cáceres;049;Casar de Cáceres;4481;2206;2275;2022
10;Cáceres;050;Casar de Palomero;1036;528;508;2022
10;Cáceres;051;Casares de las Hurdes;374;194;180;2022
10;Cáceres;052;Casas de Don Antonio;184;93;91;2022
10;Cáceres;053;Casas de Don Gómez;286;153;133;2022
10;Cáceres;056;Casas de Millán;558;283;275;2022
10;Cáceres;057;Casas de Miravete;119;75;44;2022
10;Cáceres;054;Casas del Castañar;538;272;266;2022
10;Cáceres;055;Casas del Monte;775;402;373;2022
10;Cáceres;058;Casatejada;1342;691;651;2022
10;Cáceres;059;Casillas de Coria;337;168;169;2022
10;Cáceres;060;Castañar de Ibor;1025;526;499;2022
10;Cáceres;061;Ceclavín;1779;901;878;2022
10;Cáceres;062;Cedillo;432;222;210;2022
10;Cáceres;063;Cerezo;151;75;76;2022
10;Cáceres;064;Cilleros;1590;804;786;2022
10;Cáceres;065;Collado de la Vera;237;132;105;2022
10;Cáceres;066;Conquista de la Sierra;201;115;86;2022
10;Cáceres;067;Coria;12308;6038;6270;2022
10;Cáceres;068;Cuacos de Yuste;828;421;407;2022
10;Cáceres;069;Cumbre, La;831;420;411;2022
10;Cáceres;070;Deleitosa;675;349;326;2022
10;Cáceres;071;Descargamaría;106;60;46;2022
10;Cáceres;072;Eljas;876;447;429;2022
10;Cáceres;073;Escurial;869;454;415;2022
10;Cáceres;075;Fresnedoso de Ibor;262;141;121;2022
10;Cáceres;076;Galisteo;860;427;433;2022
10;Cáceres;077;Garciaz;696;357;339;2022
10;Cáceres;079;Garganta la Olla;919;487;432;2022
10;Cáceres;078;Garganta, La;363;194;169;2022
10;Cáceres;080;Gargantilla;379;195;184;2022
10;Cáceres;081;Gargüera;177;95;82;2022
10;Cáceres;082;Garrovillas de Alconétar;1988;973;1015;2022
10;Cáceres;083;Garvín;96;52;44;2022
10;Cáceres;084;Gata;1395;713;682;2022
10;Cáceres;085;Gordo, El;371;197;174;2022
10;Cáceres;086;Granja, La;326;164;162;2022
10;Cáceres;087;Guadalupe;1787;892;895;2022
10;Cáceres;088;Guijo de Coria;186;99;87;2022
10;Cáceres;089;Guijo de Galisteo;1525;761;764;2022
10;Cáceres;090;Guijo de Granadilla;494;259;235;2022
10;Cáceres;091;Guijo de Santa Bárbara;382;200;182;2022
10;Cáceres;092;Herguijuela;267;141;126;2022
10;Cáceres;093;Hernán-Pérez;424;206;218;2022
10;Cáceres;094;Herrera de Alcántara;230;124;106;2022
10;Cáceres;095;Herreruela;321;165;156;2022
10;Cáceres;096;Hervás;3972;1946;2026;2022
10;Cáceres;097;Higuera de Albalat;104;60;44;2022
10;Cáceres;098;Hinojal;377;194;183;2022
10;Cáceres;099;Holguera;618;309;309;2022
10;Cáceres;100;Hoyos;878;431;447;2022
10;Cáceres;101;Huélaga;212;102;110;2022
10;Cáceres;102;Ibahernando;542;269;273;2022
10;Cáceres;103;Jaraicejo;447;218;229;2022
10;Cáceres;104;Jaraíz de la Vera;6585;3310;3275;2022
10;Cáceres;105;Jarandilla de la Vera;2860;1409;1451;2022
10;Cáceres;106;Jarilla;137;70;67;2022
10;Cáceres;107;Jerte;1256;624;632;2022
10;Cáceres;108;Ladrillar;184;105;79;2022
10;Cáceres;109;Logrosán;1936;985;951;2022
10;Cáceres;110;Losar de la Vera;2653;1345;1308;2022
10;Cáceres;111;Madrigal de la Vera;1543;808;735;2022
10;Cáceres;112;Madrigalejo;1712;873;839;2022
10;Cáceres;113;Madroñera;2383;1191;1192;2022
10;Cáceres;114;Majadas;1312;656;656;2022
10;Cáceres;115;Malpartida de Cáceres;4074;2032;2042;2022
10;Cáceres;116;Malpartida de Plasencia;4635;2292;2343;2022
10;Cáceres;117;Marchagaz;243;134;109;2022
10;Cáceres;118;Mata de Alcántara;292;152;140;2022
10;Cáceres;119;Membrío;591;294;297;2022
10;Cáceres;120;Mesas de Ibor;157;80;77;2022
10;Cáceres;121;Miajadas;9458;4695;4763;2022
10;Cáceres;122;Millanes;247;123;124;2022
10;Cáceres;123;Mirabel;662;332;330;2022
10;Cáceres;124;Mohedas de Granadilla;828;417;411;2022
10;Cáceres;125;Monroy;903;463;440;2022
10;Cáceres;126;Montánchez;1628;814;814;2022
10;Cáceres;127;Montehermoso;5666;2895;2771;2022
10;Cáceres;128;Moraleja;6691;3329;3362;2022
10;Cáceres;129;Morcillo;362;171;191;2022
10;Cáceres;130;Navaconcejo;2054;1040;1014;2022
10;Cáceres;131;Navalmoral de la Mata;16784;8108;8676;2022
10;Cáceres;132;Navalvillar de Ibor;387;192;195;2022
10;Cáceres;133;Navas del Madroño;1256;619;637;2022
10;Cáceres;134;Navezuelas;641;328;313;2022
10;Cáceres;135;Nuñomoral;1218;651;567;2022
10;Cáceres;136;Oliva de Plasencia;285;165;120;2022
10;Cáceres;137;Palomero;391;204;187;2022
10;Cáceres;138;Pasarón de la Vera;600;292;308;2022
10;Cáceres;139;Pedroso de Acim;73;43;30;2022
10;Cáceres;140;Peraleda de la Mata;1416;718;698;2022
10;Cáceres;141;Peraleda de San Román;304;174;130;2022
10;Cáceres;142;Perales del Puerto;931;469;462;2022
10;Cáceres;143;Pescueza;125;54;71;2022
10;Cáceres;144;Pesga, La;1006;522;484;2022
10;Cáceres;145;Piedras Albas;129;63;66;2022
10;Cáceres;146;Pinofranqueado;1686;883;803;2022
10;Cáceres;147;Piornal;1503;763;740;2022
10;Cáceres;148;Plasencia;39247;18853;20394;2022
10;Cáceres;149;Plasenzuela;483;239;244;2022
10;Cáceres;150;Portaje;371;188;183;2022
10;Cáceres;151;Portezuelo;219;117;102;2022
10;Cáceres;152;Pozuelo de Zarzón;437;221;216;2022
10;Cáceres;905;Pueblonuevo de Miramontes;767;383;384;2022
10;Cáceres;153;Puerto de Santa Cruz;277;143;134;2022
10;Cáceres;154;Rebollar;200;103;97;2022
10;Cáceres;155;Riolobos;1197;599;598;2022
10;Cáceres;156;Robledillo de Gata;86;52;34;2022
10;Cáceres;157;Robledillo de la Vera;252;126;126;2022
10;Cáceres;158;Robledillo de Trujillo;349;182;167;2022
10;Cáceres;159;Robledollano;282;152;130;2022
10;Cáceres;160;Romangordo;255;131;124;2022
10;Cáceres;901;Rosalejo;1378;710;668;2022
10;Cáceres;161;Ruanes;80;41;39;2022
10;Cáceres;162;Salorino;554;288;266;2022
10;Cáceres;163;Salvatierra de Santiago;264;137;127;2022
10;Cáceres;164;San Martín de Trevejo;750;371;379;2022
10;Cáceres;165;Santa Ana;279;143;136;2022
10;Cáceres;166;Santa Cruz de la Sierra;320;162;158;2022
10;Cáceres;167;Santa Cruz de Paniagua;288;163;125;2022
10;Cáceres;168;Santa Marta de Magasca;302;153;149;2022
10;Cáceres;169;Santiago de Alcántara;475;232;243;2022
10;Cáceres;170;Santiago del Campo;239;125;114;2022
10;Cáceres;171;Santibáñez el Alto;342;186;156;2022
10;Cáceres;172;Santibáñez el Bajo;734;380;354;2022
10;Cáceres;173;Saucedilla;888;465;423;2022
10;Cáceres;174;Segura de Toro;177;90;87;2022
10;Cáceres;175;Serradilla;1490;748;742;2022
10;Cáceres;176;Serrejón;414;218;196;2022
10;Cáceres;177;Sierra de Fuentes;2020;1044;976;2022
10;Cáceres;178;Talaván;789;407;382;2022
10;Cáceres;179;Talaveruela de la Vera;307;155;152;2022
10;Cáceres;180;Talayuela;7266;3835;3431;2022
10;Cáceres;181;Tejeda de Tiétar;778;413;365;2022
10;Cáceres;904;Tiétar;869;470;399;2022
10;Cáceres;182;Toril;154;97;57;2022
10;Cáceres;183;Tornavacas;1017;541;476;2022
10;Cáceres;184;Torno, El;847;442;405;2022
10;Cáceres;187;Torre de Don Miguel;487;258;229;2022
10;Cáceres;188;Torre de Santa María;531;262;269;2022
10;Cáceres;185;Torrecilla de los Ángeles;648;339;309;2022
10;Cáceres;186;Torrecillas de la Tiesa;1067;539;528;2022
10;Cáceres;190;Torrejón el Rubio;532;264;268;2022
10;Cáceres;189;Torrejoncillo;2854;1388;1466;2022
10;Cáceres;191;Torremenga;592;310;282;2022
10;Cáceres;192;Torremocha;763;383;380;2022
10;Cáceres;193;Torreorgaz;1673;825;848;2022
10;Cáceres;194;Torrequemada;574;280;294;2022
10;Cáceres;195;Trujillo;8695;4269;4426;2022
10;Cáceres;196;Valdastillas;323;165;158;2022
10;Cáceres;197;Valdecañas de Tajo;119;61;58;2022
10;Cáceres;198;Valdefuentes;1122;538;584;2022
10;Cáceres;199;Valdehúncar;185;101;84;2022
10;Cáceres;200;Valdelacasa de Tajo;341;181;160;2022
10;Cáceres;201;Valdemorales;210;104;106;2022
10;Cáceres;202;Valdeobispo;651;318;333;2022
10;Cáceres;203;Valencia de Alcántara;5272;2587;2685;2022
10;Cáceres;204;Valverde de la Vera;445;230;215;2022
10;Cáceres;205;Valverde del Fresno;2162;1088;1074;2022
10;Cáceres;902;Vegaviana;849;435;414;2022
10;Cáceres;206;Viandar de la Vera;215;108;107;2022
10;Cáceres;207;Villa del Campo;451;217;234;2022
10;Cáceres;208;Villa del Rey;115;57;58;2022
10;Cáceres;209;Villamesías;256;131;125;2022
10;Cáceres;210;Villamiel;392;196;196;2022
10;Cáceres;211;Villanueva de la Sierra;476;242;234;2022
10;Cáceres;212;Villanueva de la Vera;2108;1062;1046;2022
10;Cáceres;214;Villar de Plasencia;237;124;113;2022
10;Cáceres;213;Villar del Pedroso;554;285;269;2022
10;Cáceres;215;Villasbuenas de Gata;379;189;190;2022
10;Cáceres;216;Zarza de Granadilla;1803;916;887;2022
10;Cáceres;217;Zarza de Montánchez;516;266;250;2022
10;Cáceres;218;Zarza la Mayor;1176;585;591;2022
10;Cáceres;219;Zorita;1297;646;651;2022
11;Cádiz;001;Alcalá de los Gazules;5227;2672;2555;2022
11;Cádiz;002;Alcalá del Valle;4982;2493;2489;2022
11;Cádiz;003;Algar;1433;731;702;2022
11;Cádiz;004;Algeciras;122368;60299;62069;2022
11;Cádiz;005;Algodonales;5504;2788;2716;2022
11;Cádiz;006;Arcos de la Frontera;30953;15424;15529;2022
11;Cádiz;007;Barbate;22872;11438;11434;2022
11;Cádiz;008;Barrios, Los;24069;12092;11977;2022
11;Cádiz;901;Benalup-Casas Viejas;7160;3627;3533;2022
11;Cádiz;009;Benaocaz;695;374;321;2022
11;Cádiz;010;Bornos;7607;3800;3807;2022
11;Cádiz;011;Bosque, El;2209;1114;1095;2022
11;Cádiz;012;Cádiz;113066;53373;59693;2022
11;Cádiz;013;Castellar de la Frontera;3043;1505;1538;2022
11;Cádiz;015;Chiclana de la Frontera;87493;43699;43794;2022
11;Cádiz;016;Chipiona;19592;9797;9795;2022
11;Cádiz;014;Conil de la Frontera;23497;11801;11696;2022
11;Cádiz;017;Espera;3820;1896;1924;2022
11;Cádiz;018;Gastor, El;1699;855;844;2022
11;Cádiz;019;Grazalema;2005;998;1007;2022
11;Cádiz;020;Jerez de la Frontera;212730;103879;108851;2022
11;Cádiz;021;Jimena de la Frontera;6681;3409;3272;2022
11;Cádiz;022;Línea de la Concepción, La;63271;31012;32259;2022
11;Cádiz;023;Medina Sidonia;11739;5927;5812;2022
11;Cádiz;024;Olvera;7974;3920;4054;2022
11;Cádiz;025;Paterna de Rivera;5451;2824;2627;2022
11;Cádiz;026;Prado del Rey;5647;2797;2850;2022
11;Cádiz;027;Puerto de Santa María, El;89435;43737;45698;2022
11;Cádiz;028;Puerto Real;41963;21091;20872;2022
11;Cádiz;029;Puerto Serrano;6971;3530;3441;2022
11;Cádiz;030;Rota;29491;14641;14850;2022
11;Cádiz;031;San Fernando;94120;45869;48251;2022
11;Cádiz;902;San José del Valle;4453;2281;2172;2022
11;Cádiz;903;San Martín del Tesorillo;2797;1446;1351;2022
11;Cádiz;033;San Roque;33018;16416;16602;2022
11;Cádiz;032;Sanlúcar de Barrameda;69727;34730;34997;2022
11;Cádiz;034;Setenil de las Bodegas;2675;1382;1293;2022
11;Cádiz;035;Tarifa;18564;9318;9246;2022
11;Cádiz;036;Torre Alháquime;803;405;398;2022
11;Cádiz;037;Trebujena;7010;3490;3520;2022
11;Cádiz;038;Ubrique;16383;8070;8313;2022
11;Cádiz;039;Vejer de la Frontera;12656;6303;6353;2022
11;Cádiz;040;Villaluenga del Rosario;462;237;225;2022
11;Cádiz;041;Villamartín;12095;6069;6026;2022
11;Cádiz;042;Zahara;1371;688;683;2022
39;Cantabria;001;Alfoz de Lloredo;2466;1284;1182;2022
39;Cantabria;002;Ampuero;4384;2196;2188;2022
39;Cantabria;003;Anievas;267;147;120;2022
39;Cantabria;004;Arenas de Iguña;1734;870;864;2022
39;Cantabria;005;Argoños;1848;945;903;2022
39;Cantabria;006;Arnuero;2170;1092;1078;2022
39;Cantabria;007;Arredondo;471;271;200;2022
39;Cantabria;008;Astillero, El;18153;8861;9292;2022
39;Cantabria;009;Bárcena de Cicero;4503;2316;2187;2022
39;Cantabria;010;Bárcena de Pie de Concha;663;335;328;2022
39;Cantabria;011;Bareyo;2149;1081;1068;2022
39;Cantabria;012;Cabezón de la Sal;8208;3925;4283;2022
39;Cantabria;013;Cabezón de Liébana;574;322;252;2022
39;Cantabria;014;Cabuérniga;994;524;470;2022
39;Cantabria;015;Camaleño;966;547;419;2022
39;Cantabria;016;Camargo;30374;14824;15550;2022
39;Cantabria;027;Campoo de Enmedio;3704;1887;1817;2022
39;Cantabria;017;Campoo de Yuso;688;372;316;2022
39;Cantabria;018;Cartes;5781;2896;2885;2022
39;Cantabria;019;Castañeda;3067;1559;1508;2022
39;Cantabria;020;Castro-Urdiales;33109;16397;16712;2022
39;Cantabria;021;Cieza;548;280;268;2022
39;Cantabria;022;Cillorigo de Liébana;1306;679;627;2022
39;Cantabria;023;Colindres;8512;4192;4320;2022
39;Cantabria;024;Comillas;2126;1006;1120;2022
39;Cantabria;025;Corrales de Buelna, Los;10742;5232;5510;2022
39;Cantabria;026;Corvera de Toranzo;2115;1066;1049;2022
39;Cantabria;028;Entrambasaguas;5418;2710;2708;2022
39;Cantabria;029;Escalante;759;393;366;2022
39;Cantabria;030;Guriezo;2432;1282;1150;2022
39;Cantabria;031;Hazas de Cesto;1697;842;855;2022
39;Cantabria;032;Hermandad de Campoo de Suso;1601;883;718;2022
39;Cantabria;033;Herrerías;594;336;258;2022
39;Cantabria;034;Lamasón;258;165;93;2022
39;Cantabria;035;Laredo;10967;5219;5748;2022
39;Cantabria;036;Liendo;1235;637;598;2022
39;Cantabria;037;Liérganes;2423;1202;1221;2022
39;Cantabria;038;Limpias;1993;996;997;2022
39;Cantabria;039;Luena;622;333;289;2022
39;Cantabria;040;Marina de Cudeyo;5170;2583;2587;2022
39;Cantabria;041;Mazcuerras;2095;1081;1014;2022
39;Cantabria;042;Medio Cudeyo;7663;3713;3950;2022
39;Cantabria;043;Meruelo;2212;1097;1115;2022
39;Cantabria;044;Miengo;5123;2642;2481;2022
39;Cantabria;045;Miera;391;203;188;2022
39;Cantabria;046;Molledo;1495;730;765;2022
39;Cantabria;047;Noja;2664;1332;1332;2022
39;Cantabria;048;Penagos;2207;1112;1095;2022
39;Cantabria;049;Peñarrubia;317;168;149;2022
39;Cantabria;050;Pesaguero;287;166;121;2022
39;Cantabria;051;Pesquera;79;47;32;2022
39;Cantabria;052;Piélagos;26279;13006;13273;2022
39;Cantabria;053;Polaciones;216;134;82;2022
39;Cantabria;054;Polanco;6126;3035;3091;2022
39;Cantabria;055;Potes;1330;627;703;2022
39;Cantabria;056;Puente Viesgo;2894;1465;1429;2022
39;Cantabria;057;Ramales de la Victoria;2958;1488;1470;2022
39;Cantabria;058;Rasines;996;508;488;2022
39;Cantabria;059;Reinosa;8660;4079;4581;2022
39;Cantabria;060;Reocín;8455;4169;4286;2022
39;Cantabria;061;Ribamontán al Mar;4695;2408;2287;2022
39;Cantabria;062;Ribamontán al Monte;2436;1249;1187;2022
39;Cantabria;063;Rionansa;1026;570;456;2022
39;Cantabria;064;Riotuerto;1659;799;860;2022
39;Cantabria;065;Rozas de Valdearroyo, Las;261;146;115;2022
39;Cantabria;066;Ruente;1045;565;480;2022
39;Cantabria;067;Ruesga;815;450;365;2022
39;Cantabria;068;Ruiloba;759;392;367;2022
39;Cantabria;069;San Felices de Buelna;2373;1198;1175;2022
39;Cantabria;070;San Miguel de Aguayo;154;79;75;2022
39;Cantabria;071;San Pedro del Romeral;460;253;207;2022
39;Cantabria;072;San Roque de Riomiera;337;201;136;2022
39;Cantabria;080;San Vicente de la Barquera;4030;1965;2065;2022
39;Cantabria;073;Santa Cruz de Bezana;13482;6599;6883;2022
39;Cantabria;074;Santa María de Cayón;9192;4569;4623;2022
39;Cantabria;075;Santander;171693;79116;92577;2022
39;Cantabria;076;Santillana del Mar;4250;2070;2180;2022
39;Cantabria;077;Santiurde de Reinosa;242;141;101;2022
39;Cantabria;078;Santiurde de Toranzo;1711;905;806;2022
39;Cantabria;079;Santoña;10857;5273;5584;2022
39;Cantabria;081;Saro;520;271;249;2022
39;Cantabria;082;Selaya;1849;932;917;2022
39;Cantabria;083;Soba;1131;629;502;2022
39;Cantabria;084;Solórzano;1068;564;504;2022
39;Cantabria;085;Suances;9115;4484;4631;2022
39;Cantabria;086;Tojos, Los;380;229;151;2022
39;Cantabria;087;Torrelavega;51142;24053;27089;2022
39;Cantabria;088;Tresviso;54;36;18;2022
39;Cantabria;089;Tudanca;150;102;48;2022
39;Cantabria;090;Udías;951;479;472;2022
39;Cantabria;095;Val de San Vicente;2801;1420;1381;2022
39;Cantabria;091;Valdáliga;2162;1116;1046;2022
39;Cantabria;092;Valdeolea;905;487;418;2022
39;Cantabria;093;Valdeprado del Río;322;184;138;2022
39;Cantabria;094;Valderredible;945;537;408;2022
39;Cantabria;101;Valle de Villaverde;266;148;118;2022
39;Cantabria;096;Vega de Liébana;713;373;340;2022
39;Cantabria;097;Vega de Pas;730;387;343;2022
39;Cantabria;098;Villacarriedo;1640;848;792;2022
39;Cantabria;099;Villaescusa;3937;1941;1996;2022
39;Cantabria;100;Villafufre;1030;531;499;2022
39;Cantabria;102;Voto;2876;1530;1346;2022
12;Castellón/Castelló;002;Aín;136;72;64;2022
12;Castellón/Castelló;003;Albocàsser;1264;639;625;2022
12;Castellón/Castelló;004;Alcalà de Xivert;6831;3487;3344;2022
12;Castellón/Castelló;005;Alcora, l';10468;5266;5202;2022
12;Castellón/Castelló;006;Alcudia de Veo;195;105;90;2022
12;Castellón/Castelló;007;Alfondeguilla;877;435;442;2022
12;Castellón/Castelló;008;Algimia de Almonacid;247;135;112;2022
12;Castellón/Castelló;009;Almassora;27383;13735;13648;2022
12;Castellón/Castelló;010;Almedíjar;269;146;123;2022
12;Castellón/Castelló;011;Almenara;6388;3201;3187;2022
12;Castellón/Castelló;901;Alqueries, les/Alquerías del Niño Perdido;4511;2263;2248;2022
12;Castellón/Castelló;012;Altura;3667;1890;1777;2022
12;Castellón/Castelló;013;Arañuel;162;85;77;2022
12;Castellón/Castelló;014;Ares del Maestrat;173;103;70;2022
12;Castellón/Castelló;015;Argelita;153;84;69;2022
12;Castellón/Castelló;016;Artana;1979;1013;966;2022
12;Castellón/Castelló;001;Atzeneta del Maestrat;1287;654;633;2022
12;Castellón/Castelló;017;Ayódar;156;89;67;2022
12;Castellón/Castelló;018;Azuébar;318;174;144;2022
12;Castellón/Castelló;020;Barracas;185;98;87;2022
12;Castellón/Castelló;022;Bejís;393;223;170;2022
12;Castellón/Castelló;024;Benafer;171;89;82;2022
12;Castellón/Castelló;025;Benafigos;136;81;55;2022
12;Castellón/Castelló;026;Benassal;1040;529;511;2022
12;Castellón/Castelló;027;Benicarló;27780;13863;13917;2022
12;Castellón/Castelló;028;Benicasim/Benicàssim;19507;9633;9874;2022
12;Castellón/Castelló;029;Benlloc;1092;555;537;2022
12;Castellón/Castelló;021;Betxí;5587;2773;2814;2022
12;Castellón/Castelló;032;Borriana/Burriana;35019;17343;17676;2022
12;Castellón/Castelló;031;Borriol;5749;2953;2796;2022
12;Castellón/Castelló;033;Cabanes;3079;1565;1514;2022
12;Castellón/Castelló;034;Càlig;1990;998;992;2022
12;Castellón/Castelló;036;Canet lo Roig;680;345;335;2022
12;Castellón/Castelló;037;Castell de Cabres;20;12;8;2022
12;Castellón/Castelló;038;Castellfort;188;99;89;2022
12;Castellón/Castelló;039;Castellnovo;893;455;438;2022
12;Castellón/Castelló;040;Castelló de la Plana;171857;82969;88888;2022
12;Castellón/Castelló;041;Castillo de Villamalefa;112;73;39;2022
12;Castellón/Castelló;042;Catí;711;356;355;2022
12;Castellón/Castelló;043;Caudiel;674;350;324;2022
12;Castellón/Castelló;044;Cervera del Maestre;593;284;309;2022
12;Castellón/Castelló;053;Chilches/Xilxes;2846;1464;1382;2022
12;Castellón/Castelló;055;Chodos/Xodos;120;72;48;2022
12;Castellón/Castelló;056;Chóvar;304;158;146;2022
12;Castellón/Castelló;045;Cinctorres;412;200;212;2022
12;Castellón/Castelló;046;Cirat;226;130;96;2022
12;Castellón/Castelló;048;Cortes de Arenoso;293;152;141;2022
12;Castellón/Castelló;049;Costur;528;279;249;2022
12;Castellón/Castelló;050;Coves de Vinromà, les;1791;909;882;2022
12;Castellón/Castelló;051;Culla;499;255;244;2022
12;Castellón/Castelló;057;Eslida;742;368;374;2022
12;Castellón/Castelló;058;Espadilla;92;52;40;2022
12;Castellón/Castelló;059;Fanzara;283;145;138;2022
12;Castellón/Castelló;060;Figueroles;518;258;260;2022
12;Castellón/Castelló;061;Forcall;465;223;242;2022
12;Castellón/Castelló;063;Fuente la Reina;58;34;24;2022
12;Castellón/Castelló;064;Fuentes de Ayódar;95;53;42;2022
12;Castellón/Castelló;065;Gaibiel;201;111;90;2022
12;Castellón/Castelló;067;Geldo;643;322;321;2022
12;Castellón/Castelló;068;Herbers;63;40;23;2022
12;Castellón/Castelló;069;Higueras;46;24;22;2022
12;Castellón/Castelló;070;Jana, la;669;343;326;2022
12;Castellón/Castelló;071;Jérica;1655;841;814;2022
12;Castellón/Castelló;074;Llosa, la;969;471;498;2022
12;Castellón/Castelló;072;Llucena/Lucena del Cid;1325;662;663;2022
12;Castellón/Castelló;073;Ludiente;140;80;60;2022
12;Castellón/Castelló;075;Mata de Morella, la;179;98;81;2022
12;Castellón/Castelló;076;Matet;78;50;28;2022
12;Castellón/Castelló;077;Moncofa;7338;3747;3591;2022
12;Castellón/Castelló;078;Montán;375;191;184;2022
12;Castellón/Castelló;079;Montanejos;553;294;259;2022
12;Castellón/Castelló;080;Morella;2475;1210;1265;2022
12;Castellón/Castelló;081;Navajas;781;409;372;2022
12;Castellón/Castelló;082;Nules;13449;6728;6721;2022
12;Castellón/Castelló;083;Olocau del Rey;119;62;57;2022
12;Castellón/Castelló;084;Onda;25099;12566;12533;2022
12;Castellón/Castelló;085;Oropesa del Mar/Orpesa;10184;5205;4979;2022
12;Castellón/Castelló;087;Palanques;38;23;15;2022
12;Castellón/Castelló;088;Pavías;74;45;29;2022
12;Castellón/Castelló;089;Peníscola/Peñíscola;8210;4174;4036;2022
12;Castellón/Castelló;090;Pina de Montalgrao;113;61;52;2022
12;Castellón/Castelló;093;Pobla de Benifassà, la;225;129;96;2022
12;Castellón/Castelló;094;Pobla Tornesa, la;1304;668;636;2022
12;Castellón/Castelló;091;Portell de Morella;178;89;89;2022
12;Castellón/Castelló;092;Puebla de Arenoso;162;89;73;2022
12;Castellón/Castelló;095;Ribesalbes;1159;603;556;2022
12;Castellón/Castelló;096;Rossell;886;469;417;2022
12;Castellón/Castelló;097;Sacañet;52;38;14;2022
12;Castellón/Castelló;098;Salzadella, la;671;348;323;2022
12;Castellón/Castelló;101;San Rafael del Río;484;236;248;2022
12;Castellón/Castelló;902;Sant Joan de Moró;3387;1745;1642;2022
12;Castellón/Castelló;099;Sant Jordi/San Jorge;1171;616;555;2022
12;Castellón/Castelló;100;Sant Mateu;1954;963;991;2022
12;Castellón/Castelló;102;Santa Magdalena de Pulpis;776;404;372;2022
12;Castellón/Castelló;104;Segorbe;9146;4545;4601;2022
12;Castellón/Castelló;103;Serratella, la;103;51;52;2022
12;Castellón/Castelló;105;Sierra Engarcerán;997;528;469;2022
12;Castellón/Castelló;106;Soneja;1520;758;762;2022
12;Castellón/Castelló;107;Sot de Ferrer;447;238;209;2022
12;Castellón/Castelló;108;Sueras/Suera;565;299;266;2022
12;Castellón/Castelló;109;Tales;853;434;419;2022
12;Castellón/Castelló;110;Teresa;253;131;122;2022
12;Castellón/Castelló;111;Tírig;417;214;203;2022
12;Castellón/Castelló;112;Todolella;156;91;65;2022
12;Castellón/Castelló;113;Toga;104;56;48;2022
12;Castellón/Castelló;114;Torás;249;137;112;2022
12;Castellón/Castelló;115;Toro, El;238;131;107;2022
12;Castellón/Castelló;116;Torralba del Pinar;60;28;32;2022
12;Castellón/Castelló;119;Torre d'En Besora, la;165;92;73;2022
12;Castellón/Castelló;120;Torre d'en Doménec, la;167;87;80;2022
12;Castellón/Castelló;117;Torreblanca;5682;2912;2770;2022
12;Castellón/Castelló;118;Torrechiva;89;46;43;2022
12;Castellón/Castelló;121;Traiguera;1323;675;648;2022
12;Castellón/Castelló;122;Useras/Useres, les;949;504;445;2022
12;Castellón/Castelló;124;Vall d'Alba;2959;1544;1415;2022
12;Castellón/Castelló;125;Vall de Almonacid;287;147;140;2022
12;Castellón/Castelló;126;Vall d'Uixó, la;31388;15423;15965;2022
12;Castellón/Castelló;123;Vallat;54;27;27;2022
12;Castellón/Castelló;127;Vallibona;61;36;25;2022
12;Castellón/Castelló;128;Vilafamés;1864;1003;861;2022
12;Castellón/Castelló;129;Vilafranca/Villafranca del Cid;2154;1074;1080;2022
12;Castellón/Castelló;132;Vilanova d'Alcolea;571;296;275;2022
12;Castellón/Castelló;134;Vilar de Canes;170;87;83;2022
12;Castellón/Castelló;135;Vila-real;51369;25532;25837;2022
12;Castellón/Castelló;136;Vilavella, la;3084;1533;1551;2022
12;Castellón/Castelló;130;Villahermosa del Río;463;260;203;2022
12;Castellón/Castelló;131;Villamalur;85;57;28;2022
12;Castellón/Castelló;133;Villanueva de Viver;89;48;41;2022
12;Castellón/Castelló;137;Villores;53;26;27;2022
12;Castellón/Castelló;138;Vinaròs;29120;14380;14740;2022
12;Castellón/Castelló;139;Vistabella del Maestrat;334;181;153;2022
12;Castellón/Castelló;140;Viver;1691;866;825;2022
12;Castellón/Castelló;052;Xert;679;336;343;2022
12;Castellón/Castelló;141;Zorita del Maestrazgo;107;56;51;2022
12;Castellón/Castelló;142;Zucaina;174;97;77;2022
51;Ceuta;001;Ceuta;83117;41927;41190;2022
13;Ciudad Real;001;Abenójar;1314;680;634;2022
13;Ciudad Real;002;Agudo;1615;811;804;2022
13;Ciudad Real;003;Alamillo;464;243;221;2022
13;Ciudad Real;004;Albaladejo;1074;554;520;2022
13;Ciudad Real;005;Alcázar de San Juan;30516;14842;15674;2022
13;Ciudad Real;006;Alcoba;535;273;262;2022
13;Ciudad Real;007;Alcolea de Calatrava;1370;693;677;2022
13;Ciudad Real;008;Alcubillas;452;221;231;2022
13;Ciudad Real;009;Aldea del Rey;1580;796;784;2022
13;Ciudad Real;010;Alhambra;983;503;480;2022
13;Ciudad Real;011;Almadén;5069;2444;2625;2022
13;Ciudad Real;012;Almadenejos;391;200;191;2022
13;Ciudad Real;013;Almagro;8907;4394;4513;2022
13;Ciudad Real;014;Almedina;489;261;228;2022
13;Ciudad Real;015;Almodóvar del Campo;5873;2953;2920;2022
13;Ciudad Real;016;Almuradiel;740;372;368;2022
13;Ciudad Real;017;Anchuras;265;140;125;2022
13;Ciudad Real;903;Arenales de San Gregorio;571;294;277;2022
13;Ciudad Real;018;Arenas de San Juan;1031;532;499;2022
13;Ciudad Real;019;Argamasilla de Alba;6846;3443;3403;2022
13;Ciudad Real;020;Argamasilla de Calatrava;5849;2916;2933;2022
13;Ciudad Real;021;Arroba de los Montes;402;219;183;2022
13;Ciudad Real;022;Ballesteros de Calatrava;367;182;185;2022
13;Ciudad Real;023;Bolaños de Calatrava;11910;6137;5773;2022
13;Ciudad Real;024;Brazatortas;1005;528;477;2022
13;Ciudad Real;025;Cabezarados;300;164;136;2022
13;Ciudad Real;026;Cabezarrubias del Puerto;484;256;228;2022
13;Ciudad Real;027;Calzada de Calatrava;3704;1863;1841;2022
13;Ciudad Real;028;Campo de Criptana;13142;6588;6554;2022
13;Ciudad Real;029;Cañada de Calatrava;104;59;45;2022
13;Ciudad Real;030;Caracuel de Calatrava;125;74;51;2022
13;Ciudad Real;031;Carrión de Calatrava;3131;1581;1550;2022
13;Ciudad Real;032;Carrizosa;1154;579;575;2022
13;Ciudad Real;033;Castellar de Santiago;1819;922;897;2022
13;Ciudad Real;038;Chillón;1758;844;914;2022
13;Ciudad Real;034;Ciudad Real;74850;35458;39392;2022
13;Ciudad Real;035;Corral de Calatrava;1089;535;554;2022
13;Ciudad Real;036;Cortijos, Los;865;462;403;2022
13;Ciudad Real;037;Cózar;913;463;450;2022
13;Ciudad Real;039;Daimiel;17680;8878;8802;2022
13;Ciudad Real;040;Fernán Caballero;977;492;485;2022
13;Ciudad Real;041;Fontanarejo;246;143;103;2022
13;Ciudad Real;042;Fuencaliente;1012;524;488;2022
13;Ciudad Real;043;Fuenllana;214;113;101;2022
13;Ciudad Real;044;Fuente el Fresno;3085;1585;1500;2022
13;Ciudad Real;045;Granátula de Calatrava;716;349;367;2022
13;Ciudad Real;046;Guadalmez;718;349;369;2022
13;Ciudad Real;047;Herencia;8432;4288;4144;2022
13;Ciudad Real;048;Hinojosas de Calatrava;505;264;241;2022
13;Ciudad Real;049;Horcajo de los Montes;821;422;399;2022
13;Ciudad Real;050;Labores, Las;557;286;271;2022
13;Ciudad Real;904;Llanos del Caudillo;693;345;348;2022
13;Ciudad Real;051;Luciana;368;200;168;2022
13;Ciudad Real;052;Malagón;7801;3858;3943;2022
13;Ciudad Real;053;Manzanares;17738;8787;8951;2022
13;Ciudad Real;054;Membrilla;5904;2952;2952;2022
13;Ciudad Real;055;Mestanza;644;339;305;2022
13;Ciudad Real;056;Miguelturra;15744;7911;7833;2022
13;Ciudad Real;057;Montiel;1233;645;588;2022
13;Ciudad Real;058;Moral de Calatrava;5178;2627;2551;2022
13;Ciudad Real;059;Navalpino;203;108;95;2022
13;Ciudad Real;060;Navas de Estena;292;158;134;2022
13;Ciudad Real;061;Pedro Muñoz;7480;3780;3700;2022
13;Ciudad Real;062;Picón;667;348;319;2022
13;Ciudad Real;063;Piedrabuena;4363;2213;2150;2022
13;Ciudad Real;064;Poblete;2802;1444;1358;2022
13;Ciudad Real;065;Porzuna;3505;1813;1692;2022
13;Ciudad Real;066;Pozuelo de Calatrava;3629;1856;1773;2022
13;Ciudad Real;067;Pozuelos de Calatrava, Los;352;189;163;2022
13;Ciudad Real;068;Puebla de Don Rodrigo;1119;618;501;2022
13;Ciudad Real;069;Puebla del Príncipe;671;356;315;2022
13;Ciudad Real;070;Puerto Lápice;896;443;453;2022
13;Ciudad Real;071;Puertollano;45539;21948;23591;2022
13;Ciudad Real;072;Retuerta del Bullaque;911;500;411;2022
13;Ciudad Real;901;Robledo, El;1061;559;502;2022
13;Ciudad Real;902;Ruidera;555;269;286;2022
13;Ciudad Real;073;Saceruela;526;276;250;2022
13;Ciudad Real;074;San Carlos del Valle;1099;567;532;2022
13;Ciudad Real;075;San Lorenzo de Calatrava;206;115;91;2022
13;Ciudad Real;076;Santa Cruz de los Cáñamos;513;248;265;2022
13;Ciudad Real;077;Santa Cruz de Mudela;3950;1966;1984;2022
13;Ciudad Real;078;Socuéllamos;12098;6089;6009;2022
13;Ciudad Real;080;Solana del Pino;328;171;157;2022
13;Ciudad Real;079;Solana, La;15313;7793;7520;2022
13;Ciudad Real;081;Terrinches;622;328;294;2022
13;Ciudad Real;082;Tomelloso;36024;17951;18073;2022
13;Ciudad Real;083;Torralba de Calatrava;3052;1516;1536;2022
13;Ciudad Real;084;Torre de Juan Abad;1003;496;507;2022
13;Ciudad Real;085;Torrenueva;2659;1348;1311;2022
13;Ciudad Real;086;Valdemanco del Esteras;164;87;77;2022
13;Ciudad Real;087;Valdepeñas;30071;14680;15391;2022
13;Ciudad Real;088;Valenzuela de Calatrava;661;309;352;2022
13;Ciudad Real;089;Villahermosa;1772;875;897;2022
13;Ciudad Real;090;Villamanrique;1083;527;556;2022
13;Ciudad Real;091;Villamayor de Calatrava;607;297;310;2022
13;Ciudad Real;092;Villanueva de la Fuente;1965;1010;955;2022
13;Ciudad Real;093;Villanueva de los Infantes;4828;2397;2431;2022
13;Ciudad Real;094;Villanueva de San Carlos;278;145;133;2022
13;Ciudad Real;095;Villar del Pozo;54;32;22;2022
13;Ciudad Real;096;Villarrubia de los Ojos;9667;4830;4837;2022
13;Ciudad Real;097;Villarta de San Juan;2713;1365;1348;2022
13;Ciudad Real;098;Viso del Marqués;2183;1062;1121;2022
14;Córdoba;001;Adamuz;4125;2098;2027;2022
14;Córdoba;002;Aguilar de la Frontera;13318;6629;6689;2022
14;Córdoba;003;Alcaracejos;1493;729;764;2022
14;Córdoba;004;Almedinilla;2350;1178;1172;2022
14;Córdoba;005;Almodóvar del Río;8093;4042;4051;2022
14;Córdoba;006;Añora;1509;748;761;2022
14;Córdoba;007;Baena;18764;9403;9361;2022
14;Córdoba;008;Belalcázar;3166;1536;1630;2022
14;Córdoba;009;Belmez;2862;1394;1468;2022
14;Córdoba;010;Benamejí;4974;2461;2513;2022
14;Córdoba;011;Blázquez, Los;661;337;324;2022
14;Córdoba;012;Bujalance;7257;3626;3631;2022
14;Córdoba;013;Cabra;20097;9788;10309;2022
14;Córdoba;014;Cañete de las Torres;2859;1471;1388;2022
14;Córdoba;015;Carcabuey;2367;1199;1168;2022
14;Córdoba;016;Cardeña;1455;732;723;2022
14;Córdoba;017;Carlota, La;14324;7125;7199;2022
14;Córdoba;018;Carpio, El;4353;2146;2207;2022
14;Córdoba;019;Castro del Río;7711;3797;3914;2022
14;Córdoba;020;Conquista;380;192;188;2022
14;Córdoba;021;Córdoba;319515;153368;166147;2022
14;Córdoba;022;Doña Mencía;4583;2220;2363;2022
14;Córdoba;023;Dos Torres;2402;1205;1197;2022
14;Córdoba;024;Encinas Reales;2266;1115;1151;2022
14;Córdoba;025;Espejo;3245;1629;1616;2022
14;Córdoba;026;Espiel;2423;1220;1203;2022
14;Córdoba;027;Fernán-Núñez;9646;4793;4853;2022
14;Córdoba;901;Fuente Carreteros;1109;574;535;2022
14;Córdoba;028;Fuente la Lancha;329;160;169;2022
14;Córdoba;029;Fuente Obejuna;4462;2317;2145;2022
14;Córdoba;030;Fuente Palmera;9879;4926;4953;2022
14;Córdoba;031;Fuente-Tójar;663;318;345;2022
14;Córdoba;032;Granjuela, La;414;203;211;2022
14;Córdoba;033;Guadalcázar;1552;778;774;2022
14;Córdoba;902;Guijarrosa, La;1341;689;652;2022
14;Córdoba;034;Guijo, El;344;181;163;2022
14;Córdoba;035;Hinojosa del Duque;6640;3268;3372;2022
14;Córdoba;036;Hornachuelos;4450;2217;2233;2022
14;Córdoba;037;Iznájar;4002;2031;1971;2022
14;Córdoba;038;Lucena;42645;21230;21415;2022
14;Córdoba;039;Luque;2926;1472;1454;2022
14;Córdoba;040;Montalbán de Córdoba;4494;2212;2282;2022
14;Córdoba;041;Montemayor;3869;1951;1918;2022
14;Córdoba;042;Montilla;22490;11149;11341;2022
14;Córdoba;043;Montoro;9203;4546;4657;2022
14;Córdoba;044;Monturque;1933;967;966;2022
14;Córdoba;045;Moriles;3673;1839;1834;2022
14;Córdoba;046;Nueva Carteya;5347;2719;2628;2022
14;Córdoba;047;Obejo;2054;1075;979;2022
14;Córdoba;048;Palenciana;1461;740;721;2022
14;Córdoba;049;Palma del Río;20810;10331;10479;2022
14;Córdoba;050;Pedro Abad;2809;1410;1399;2022
14;Córdoba;051;Pedroche;1481;738;743;2022
14;Córdoba;052;Peñarroya-Pueblonuevo;10419;5046;5373;2022
14;Córdoba;053;Posadas;7267;3600;3667;2022
14;Córdoba;054;Pozoblanco;17102;8287;8815;2022
14;Córdoba;055;Priego de Córdoba;22092;10780;11312;2022
14;Córdoba;056;Puente Genil;29748;14675;15073;2022
14;Córdoba;057;Rambla, La;7525;3771;3754;2022
14;Córdoba;058;Rute;9801;4899;4902;2022
14;Córdoba;059;San Sebastián de los Ballesteros;835;423;412;2022
14;Córdoba;061;Santa Eufemia;734;365;369;2022
14;Córdoba;060;Santaella;4637;2338;2299;2022
14;Córdoba;062;Torrecampo;1032;509;523;2022
14;Córdoba;063;Valenzuela;1079;542;537;2022
14;Córdoba;064;Valsequillo;347;169;178;2022
14;Córdoba;065;Victoria, La;2316;1151;1165;2022
14;Córdoba;066;Villa del Río;6993;3484;3509;2022
14;Córdoba;067;Villafranca de Córdoba;4872;2494;2378;2022
14;Córdoba;068;Villaharta;632;308;324;2022
14;Córdoba;069;Villanueva de Córdoba;8587;4252;4335;2022
14;Córdoba;070;Villanueva del Duque;1431;721;710;2022
14;Córdoba;071;Villanueva del Rey;1007;492;515;2022
14;Córdoba;072;Villaralto;1111;557;554;2022
14;Córdoba;073;Villaviciosa de Córdoba;3160;1617;1543;2022
14;Córdoba;074;Viso, El;2528;1272;1256;2022
14;Córdoba;075;Zuheros;631;319;312;2022
15;Coruña, A;001;Abegondo;5534;2729;2805;2022
15;Coruña, A;002;Ames;32095;15451;16644;2022
15;Coruña, A;003;Aranga;1837;937;900;2022
15;Coruña, A;004;Ares;6033;2962;3071;2022
15;Coruña, A;005;Arteixo;33076;16342;16734;2022
15;Coruña, A;006;Arzúa;5918;2949;2969;2022
15;Coruña, A;007;Baña, A;3333;1576;1757;2022
15;Coruña, A;008;Bergondo;6892;3368;3524;2022
15;Coruña, A;009;Betanzos;13066;6212;6854;2022
15;Coruña, A;010;Boimorto;1890;940;950;2022
15;Coruña, A;011;Boiro;18976;9204;9772;2022
15;Coruña, A;012;Boqueixón;4188;2048;2140;2022
15;Coruña, A;013;Brión;8069;3884;4185;2022
15;Coruña, A;014;Cabana de Bergantiños;4195;2029;2166;2022
15;Coruña, A;015;Cabanas;3340;1625;1715;2022
15;Coruña, A;016;Camariñas;5188;2534;2654;2022
15;Coruña, A;017;Cambre;24505;11949;12556;2022
15;Coruña, A;018;Capela, A;1225;599;626;2022
15;Coruña, A;019;Carballo;31432;15361;16071;2022
15;Coruña, A;901;Cariño;3699;1824;1875;2022
15;Coruña, A;020;Carnota;3845;1826;2019;2022
15;Coruña, A;021;Carral;6649;3259;3390;2022
15;Coruña, A;022;Cedeira;6626;3295;3331;2022
15;Coruña, A;023;Cee;7573;3610;3963;2022
15;Coruña, A;024;Cerceda;5019;2478;2541;2022
15;Coruña, A;025;Cerdido;1060;520;540;2022
15;Coruña, A;027;Coirós;1913;950;963;2022
15;Coruña, A;028;Corcubión;1670;836;834;2022
15;Coruña, A;029;Coristanco;5807;2778;3029;2022
15;Coruña, A;030;Coruña, A;244700;113439;131261;2022
15;Coruña, A;031;Culleredo;30790;14792;15998;2022
15;Coruña, A;032;Curtis;4104;2076;2028;2022
15;Coruña, A;033;Dodro;2675;1276;1399;2022
15;Coruña, A;034;Dumbría;2909;1393;1516;2022
15;Coruña, A;035;Fene;12702;6034;6668;2022
15;Coruña, A;036;Ferrol;64158;30176;33982;2022
15;Coruña, A;037;Fisterra;4726;2398;2328;2022
15;Coruña, A;038;Frades;2273;1118;1155;2022
15;Coruña, A;039;Irixoa;1318;668;650;2022
15;Coruña, A;041;Laracha, A;11505;5690;5815;2022
15;Coruña, A;040;Laxe;2977;1492;1485;2022
15;Coruña, A;042;Lousame;3210;1601;1609;2022
15;Coruña, A;043;Malpica de Bergantiños;5296;2589;2707;2022
15;Coruña, A;044;Mañón;1287;636;651;2022
15;Coruña, A;045;Mazaricos;3761;1793;1968;2022
15;Coruña, A;046;Melide;7438;3648;3790;2022
15;Coruña, A;047;Mesía;2457;1232;1225;2022
15;Coruña, A;048;Miño;6624;3302;3322;2022
15;Coruña, A;049;Moeche;1191;570;621;2022
15;Coruña, A;050;Monfero;1865;949;916;2022
15;Coruña, A;051;Mugardos;5246;2552;2694;2022
15;Coruña, A;053;Muros;8365;4034;4331;2022
15;Coruña, A;052;Muxía;4486;2161;2325;2022
15;Coruña, A;054;Narón;38938;18858;20080;2022
15;Coruña, A;055;Neda;4972;2421;2551;2022
15;Coruña, A;056;Negreira;6811;3291;3520;2022
15;Coruña, A;057;Noia;14140;6770;7370;2022
15;Coruña, A;058;Oleiros;37271;17991;19280;2022
15;Coruña, A;059;Ordes;12589;6136;6453;2022
15;Coruña, A;060;Oroso;7572;3724;3848;2022
15;Coruña, A;061;Ortigueira;5420;2561;2859;2022
15;Coruña, A;062;Outes;6108;2924;3184;2022
15;Coruña, A;902;Oza-Cesuras;5247;2661;2586;2022
15;Coruña, A;064;Paderne;2420;1198;1222;2022
15;Coruña, A;065;Padrón;8349;4034;4315;2022
15;Coruña, A;066;Pino, O;4576;2301;2275;2022
15;Coruña, A;067;Pobra do Caramiñal, A;9290;4559;4731;2022
15;Coruña, A;068;Ponteceso;5429;2729;2700;2022
15;Coruña, A;069;Pontedeume;7563;3617;3946;2022
15;Coruña, A;070;Pontes de García Rodríguez, As;9974;4880;5094;2022
15;Coruña, A;071;Porto do Son;9153;4552;4601;2022
15;Coruña, A;072;Rianxo;10949;5373;5576;2022
15;Coruña, A;073;Ribeira;26897;13300;13597;2022
15;Coruña, A;074;Rois;4445;2126;2319;2022
15;Coruña, A;075;Sada;16627;8145;8482;2022
15;Coruña, A;076;San Sadurniño;2792;1385;1407;2022
15;Coruña, A;077;Santa Comba;9365;4553;4812;2022
15;Coruña, A;078;Santiago de Compostela;98179;45721;52458;2022
15;Coruña, A;079;Santiso;1509;784;725;2022
15;Coruña, A;080;Sobrado;1767;916;851;2022
15;Coruña, A;081;Somozas, As;1073;544;529;2022
15;Coruña, A;082;Teo;18918;9237;9681;2022
15;Coruña, A;083;Toques;1089;558;531;2022
15;Coruña, A;084;Tordoia;3192;1515;1677;2022
15;Coruña, A;085;Touro;3451;1707;1744;2022
15;Coruña, A;086;Trazo;3034;1485;1549;2022
15;Coruña, A;088;Val do Dubra;3783;1820;1963;2022
15;Coruña, A;087;Valdoviño;6924;3385;3539;2022
15;Coruña, A;089;Vedra;5005;2460;2545;2022
15;Coruña, A;091;Vilarmaior;1245;631;614;2022
15;Coruña, A;090;Vilasantar;1239;655;584;2022
15;Coruña, A;092;Vimianzo;6851;3310;3541;2022
15;Coruña, A;093;Zas;4308;2076;2232;2022
16;Cuenca;001;Abia de la Obispalía;60;37;23;2022
16;Cuenca;002;Acebrón, El;231;110;121;2022
16;Cuenca;003;Alarcón;152;69;83;2022
16;Cuenca;004;Albaladejo del Cuende;230;122;108;2022
16;Cuenca;005;Albalate de las Nogueras;259;134;125;2022
16;Cuenca;006;Albendea;122;57;65;2022
16;Cuenca;007;Alberca de Záncara, La;1585;800;785;2022
16;Cuenca;008;Alcalá de la Vega;79;45;34;2022
16;Cuenca;009;Alcantud;51;29;22;2022
16;Cuenca;010;Alcázar del Rey;134;73;61;2022
16;Cuenca;011;Alcohujate;26;12;14;2022
16;Cuenca;012;Alconchel de la Estrella;77;45;32;2022
16;Cuenca;013;Algarra;22;12;10;2022
16;Cuenca;014;Aliaguilla;634;330;304;2022
16;Cuenca;015;Almarcha, La;425;233;192;2022
16;Cuenca;016;Almendros;234;128;106;2022
16;Cuenca;017;Almodóvar del Pinar;386;202;184;2022
16;Cuenca;018;Almonacid del Marquesado;424;217;207;2022
16;Cuenca;019;Altarejos;205;108;97;2022
16;Cuenca;020;Arandilla del Arroyo;9;6;3;2022
16;Cuenca;905;Arcas;1994;998;996;2022
16;Cuenca;022;Arcos de la Sierra;73;44;29;2022
16;Cuenca;024;Arguisuelas;133;65;68;2022
16;Cuenca;025;Arrancacepas;18;10;8;2022
16;Cuenca;026;Atalaya del Cañavate;110;58;52;2022
16;Cuenca;027;Barajas de Melo;987;528;459;2022
16;Cuenca;029;Barchín del Hoyo;97;65;32;2022
16;Cuenca;030;Bascuñana de San Pedro;24;20;4;2022
16;Cuenca;031;Beamud;41;22;19;2022
16;Cuenca;032;Belinchón;383;195;188;2022
16;Cuenca;033;Belmonte;1782;884;898;2022
16;Cuenca;034;Belmontejo;141;82;59;2022
16;Cuenca;035;Beteta;229;114;115;2022
16;Cuenca;036;Boniches;141;69;72;2022
16;Cuenca;038;Buciegas;36;25;11;2022
16;Cuenca;039;Buenache de Alarcón;447;238;209;2022
16;Cuenca;040;Buenache de la Sierra;106;60;46;2022
16;Cuenca;041;Buendía;415;226;189;2022
16;Cuenca;042;Campillo de Altobuey;1262;635;627;2022
16;Cuenca;043;Campillos-Paravientos;103;60;43;2022
16;Cuenca;044;Campillos-Sierra;29;15;14;2022
16;Cuenca;901;Campos del Paraíso;691;357;334;2022
16;Cuenca;045;Canalejas del Arroyo;168;95;73;2022
16;Cuenca;046;Cañada del Hoyo;231;123;108;2022
16;Cuenca;047;Cañada Juncosa;231;126;105;2022
16;Cuenca;048;Cañamares;445;245;200;2022
16;Cuenca;049;Cañavate, El;136;61;75;2022
16;Cuenca;050;Cañaveras;244;121;123;2022
16;Cuenca;051;Cañaveruelas;129;66;63;2022
16;Cuenca;052;Cañete;792;411;381;2022
16;Cuenca;053;Cañizares;429;234;195;2022
16;Cuenca;055;Carboneras de Guadazaón;794;412;382;2022
16;Cuenca;056;Cardenete;474;250;224;2022
16;Cuenca;057;Carrascosa;68;43;25;2022
16;Cuenca;058;Carrascosa de Haro;98;48;50;2022
16;Cuenca;060;Casas de Benítez;816;402;414;2022
16;Cuenca;061;Casas de Fernando Alonso;1144;595;549;2022
16;Cuenca;062;Casas de Garcimolina;31;19;12;2022
16;Cuenca;063;Casas de Guijarro;108;57;51;2022
16;Cuenca;064;Casas de Haro;844;447;397;2022
16;Cuenca;065;Casas de los Pinos;415;202;213;2022
16;Cuenca;066;Casasimarro;3140;1639;1501;2022
16;Cuenca;067;Castejón;124;72;52;2022
16;Cuenca;068;Castillejo de Iniesta;115;62;53;2022
16;Cuenca;070;Castillejo-Sierra;28;14;14;2022
16;Cuenca;072;Castillo de Garcimuñoz;128;78;50;2022
16;Cuenca;071;Castillo-Albaráñez;22;10;12;2022
16;Cuenca;073;Cervera del Llano;217;109;108;2022
16;Cuenca;023;Chillarón de Cuenca;721;381;340;2022
16;Cuenca;081;Chumillas;58;34;24;2022
16;Cuenca;074;Cierva, La;37;21;16;2022
16;Cuenca;078;Cuenca;53389;25274;28115;2022
16;Cuenca;079;Cueva del Hierro;35;22;13;2022
16;Cuenca;082;Enguídanos;299;160;139;2022
16;Cuenca;083;Fresneda de Altarejos;35;19;16;2022
16;Cuenca;084;Fresneda de la Sierra;46;27;19;2022
16;Cuenca;085;Frontera, La;144;77;67;2022
16;Cuenca;086;Fuente de Pedro Naharro;1211;630;581;2022
16;Cuenca;087;Fuentelespino de Haro;235;122;113;2022
16;Cuenca;088;Fuentelespino de Moya;103;54;49;2022
16;Cuenca;904;Fuentenava de Jábaga;546;286;260;2022
16;Cuenca;089;Fuentes;467;240;227;2022
16;Cuenca;091;Fuertescusa;69;37;32;2022
16;Cuenca;092;Gabaldón;151;92;59;2022
16;Cuenca;093;Garaballa;58;30;28;2022
16;Cuenca;094;Gascueña;142;84;58;2022
16;Cuenca;095;Graja de Campalbo;96;54;42;2022
16;Cuenca;096;Graja de Iniesta;362;191;171;2022
16;Cuenca;097;Henarejos;129;67;62;2022
16;Cuenca;098;Herrumblar, El;733;370;363;2022
16;Cuenca;099;Hinojosa, La;191;95;96;2022
16;Cuenca;100;Hinojosos, Los;759;384;375;2022
16;Cuenca;101;Hito, El;151;79;72;2022
16;Cuenca;102;Honrubia;1530;761;769;2022
16;Cuenca;103;Hontanaya;256;141;115;2022
16;Cuenca;104;Hontecillas;62;31;31;2022
16;Cuenca;106;Horcajo de Santiago;3572;1832;1740;2022
16;Cuenca;107;Huélamo;73;40;33;2022
16;Cuenca;108;Huelves;72;38;34;2022
16;Cuenca;109;Huérguina;50;27;23;2022
16;Cuenca;110;Huerta de la Obispalía;116;70;46;2022
16;Cuenca;111;Huerta del Marquesado;170;93;77;2022
16;Cuenca;112;Huete;1716;884;832;2022
16;Cuenca;113;Iniesta;4340;2150;2190;2022
16;Cuenca;115;Laguna del Marquesado;56;32;24;2022
16;Cuenca;116;Lagunaseca;55;32;23;2022
16;Cuenca;117;Landete;1217;627;590;2022
16;Cuenca;118;Ledaña;1563;774;789;2022
16;Cuenca;119;Leganiel;221;118;103;2022
16;Cuenca;121;Majadas, Las;233;121;112;2022
16;Cuenca;122;Mariana;312;164;148;2022
16;Cuenca;123;Masegosa;62;36;26;2022
16;Cuenca;124;Mesas, Las;2296;1175;1121;2022
16;Cuenca;125;Minglanilla;2268;1161;1107;2022
16;Cuenca;126;Mira;924;468;456;2022
16;Cuenca;128;Monreal del Llano;50;29;21;2022
16;Cuenca;129;Montalbanejo;93;46;47;2022
16;Cuenca;130;Montalbo;691;354;337;2022
16;Cuenca;131;Monteagudo de las Salinas;120;73;47;2022
16;Cuenca;132;Mota de Altarejos;34;21;13;2022
16;Cuenca;133;Mota del Cuervo;6069;3022;3047;2022
16;Cuenca;134;Motilla del Palancar;6026;2998;3028;2022
16;Cuenca;135;Moya;128;76;52;2022
16;Cuenca;137;Narboneta;41;24;17;2022
16;Cuenca;139;Olivares de Júcar;294;154;140;2022
16;Cuenca;140;Olmeda de la Cuesta;21;13;8;2022
16;Cuenca;141;Olmeda del Rey;134;67;67;2022
16;Cuenca;142;Olmedilla de Alarcón;136;78;58;2022
16;Cuenca;143;Olmedilla de Eliz;17;14;3;2022
16;Cuenca;145;Osa de la Vega;447;231;216;2022
16;Cuenca;146;Pajarón;77;36;41;2022
16;Cuenca;147;Pajaroncillo;63;41;22;2022
16;Cuenca;148;Palomares del Campo;560;282;278;2022
16;Cuenca;149;Palomera;169;81;88;2022
16;Cuenca;150;Paracuellos;96;49;47;2022
16;Cuenca;151;Paredes;55;32;23;2022
16;Cuenca;152;Parra de las Vegas, La;33;24;9;2022
16;Cuenca;153;Pedernoso, El;1125;565;560;2022
16;Cuenca;154;Pedroñeras, Las;6583;3385;3198;2022
16;Cuenca;155;Peral, El;650;374;276;2022
16;Cuenca;156;Peraleja, La;97;61;36;2022
16;Cuenca;157;Pesquera, La;212;114;98;2022
16;Cuenca;158;Picazo, El;674;345;329;2022
16;Cuenca;159;Pinarejo;189;96;93;2022
16;Cuenca;160;Pineda de Gigüela;62;41;21;2022
16;Cuenca;161;Piqueras del Castillo;46;27;19;2022
16;Cuenca;162;Portalrubio de Guadamejud;31;16;15;2022
16;Cuenca;163;Portilla;58;31;27;2022
16;Cuenca;165;Poyatos;58;32;26;2022
16;Cuenca;166;Pozoamargo;279;152;127;2022
16;Cuenca;908;Pozorrubielos de la Mancha;173;93;80;2022
16;Cuenca;167;Pozorrubio de Santiago;322;154;168;2022
16;Cuenca;169;Pozuelo, El;43;28;15;2022
16;Cuenca;170;Priego;885;444;441;2022
16;Cuenca;171;Provencio, El;2387;1193;1194;2022
16;Cuenca;172;Puebla de Almenara;311;168;143;2022
16;Cuenca;174;Puebla del Salvador;192;103;89;2022
16;Cuenca;175;Quintanar del Rey;7632;3924;3708;2022
16;Cuenca;176;Rada de Haro;49;30;19;2022
16;Cuenca;177;Reíllo;105;56;49;2022
16;Cuenca;181;Rozalén del Monte;58;29;29;2022
16;Cuenca;185;Saceda-Trasierra;37;24;13;2022
16;Cuenca;186;Saelices;450;233;217;2022
16;Cuenca;187;Salinas del Manzano;67;39;28;2022
16;Cuenca;188;Salmeroncillos;101;59;42;2022
16;Cuenca;189;Salvacañete;291;144;147;2022
16;Cuenca;190;San Clemente;6827;3429;3398;2022
16;Cuenca;191;San Lorenzo de la Parrilla;1066;554;512;2022
16;Cuenca;192;San Martín de Boniches;46;26;20;2022
16;Cuenca;193;San Pedro Palmiches;49;28;21;2022
16;Cuenca;194;Santa Cruz de Moya;230;117;113;2022
16;Cuenca;196;Santa María de los Llanos;680;360;320;2022
16;Cuenca;195;Santa María del Campo Rus;522;268;254;2022
16;Cuenca;197;Santa María del Val;61;32;29;2022
16;Cuenca;198;Sisante;1618;829;789;2022
16;Cuenca;199;Solera de Gabaldón;36;22;14;2022
16;Cuenca;909;Sotorribas;696;362;334;2022
16;Cuenca;202;Talayuelas;856;457;399;2022
16;Cuenca;203;Tarancón;15799;7805;7994;2022
16;Cuenca;204;Tébar;287;154;133;2022
16;Cuenca;205;Tejadillos;113;51;62;2022
16;Cuenca;206;Tinajas;196;107;89;2022
16;Cuenca;209;Torralba;109;65;44;2022
16;Cuenca;211;Torrejoncillo del Rey;345;191;154;2022
16;Cuenca;212;Torrubia del Campo;296;146;150;2022
16;Cuenca;213;Torrubia del Castillo;41;27;14;2022
16;Cuenca;215;Tragacete;277;156;121;2022
16;Cuenca;216;Tresjuncos;268;147;121;2022
16;Cuenca;217;Tribaldos;99;55;44;2022
16;Cuenca;218;Uclés;222;115;107;2022
16;Cuenca;219;Uña;84;46;38;2022
16;Cuenca;906;Valdecolmenas, Los;74;48;26;2022
16;Cuenca;224;Valdemeca;74;43;31;2022
16;Cuenca;225;Valdemorillo de la Sierra;54;32;22;2022
16;Cuenca;227;Valdemoro-Sierra;104;59;45;2022
16;Cuenca;228;Valdeolivas;218;136;82;2022
16;Cuenca;902;Valdetórtola;127;72;55;2022
16;Cuenca;903;Valeras, Las;1499;796;703;2022
16;Cuenca;231;Valhermoso de la Fuente;42;22;20;2022
16;Cuenca;173;Valle de Altomira, El;206;111;95;2022
16;Cuenca;234;Valsalobre;21;11;10;2022
16;Cuenca;236;Valverde de Júcar;1091;541;550;2022
16;Cuenca;237;Valverdejo;94;48;46;2022
16;Cuenca;238;Vara de Rey;460;240;220;2022
16;Cuenca;239;Vega del Codorno;132;81;51;2022
16;Cuenca;240;Vellisca;114;63;51;2022
16;Cuenca;242;Villaconejos de Trabaque;323;168;155;2022
16;Cuenca;243;Villaescusa de Haro;474;244;230;2022
16;Cuenca;244;Villagarcía del Llano;697;348;349;2022
16;Cuenca;245;Villalba de la Sierra;484;238;246;2022
16;Cuenca;246;Villalba del Rey;481;258;223;2022
16;Cuenca;247;Villalgordo del Marquesado;66;39;27;2022
16;Cuenca;248;Villalpardo;1013;504;509;2022
16;Cuenca;249;Villamayor de Santiago;2433;1248;1185;2022
16;Cuenca;250;Villanueva de Guadamejud;64;41;23;2022
16;Cuenca;251;Villanueva de la Jara;2287;1156;1131;2022
16;Cuenca;253;Villar de Cañas;385;209;176;2022
16;Cuenca;254;Villar de Domingo García;222;112;110;2022
16;Cuenca;255;Villar de la Encina;161;83;78;2022
16;Cuenca;263;Villar de Olalla;1356;724;632;2022
16;Cuenca;258;Villar del Humo;169;92;77;2022
16;Cuenca;259;Villar del Infantado;39;22;17;2022
16;Cuenca;910;Villar y Velasco;79;44;35;2022
16;Cuenca;264;Villarejo de Fuentes;392;196;196;2022
16;Cuenca;265;Villarejo de la Peñuela;23;13;10;2022
16;Cuenca;266;Villarejo-Periesteban;383;195;188;2022
16;Cuenca;269;Villares del Saz;468;245;223;2022
16;Cuenca;270;Villarrubio;189;102;87;2022
16;Cuenca;271;Villarta;789;390;399;2022
16;Cuenca;272;Villas de la Ventosa;210;119;91;2022
16;Cuenca;273;Villaverde y Pasaconsol;338;180;158;2022
16;Cuenca;274;Víllora;141;79;62;2022
16;Cuenca;275;Vindel;12;8;4;2022
16;Cuenca;276;Yémeda;17;12;5;2022
16;Cuenca;277;Zafra de Záncara;100;56;44;2022
16;Cuenca;278;Zafrilla;55;29;26;2022
16;Cuenca;279;Zarza de Tajo;268;147;121;2022
16;Cuenca;280;Zarzuela;154;86;68;2022
20;Gipuzkoa;001;Abaltzisketa;309;169;140;2022
20;Gipuzkoa;002;Aduna;486;259;227;2022
20;Gipuzkoa;016;Aia;2094;1104;990;2022
20;Gipuzkoa;003;Aizarnazabal;774;392;382;2022
20;Gipuzkoa;004;Albiztur;316;163;153;2022
20;Gipuzkoa;005;Alegia;1740;901;839;2022
20;Gipuzkoa;006;Alkiza;357;175;182;2022
20;Gipuzkoa;906;Altzaga;178;86;92;2022
20;Gipuzkoa;007;Altzo;428;224;204;2022
20;Gipuzkoa;008;Amezketa;948;507;441;2022
20;Gipuzkoa;009;Andoain;14504;7193;7311;2022
20;Gipuzkoa;010;Anoeta;2079;1070;1009;2022
20;Gipuzkoa;011;Antzuola;2071;1034;1037;2022
20;Gipuzkoa;012;Arama;192;94;98;2022
20;Gipuzkoa;013;Aretxabaleta;7069;3546;3523;2022
20;Gipuzkoa;055;Arrasate/Mondragón;21760;10694;11066;2022
20;Gipuzkoa;014;Asteasu;1557;794;763;2022
20;Gipuzkoa;903;Astigarraga;7417;3770;3647;2022
20;Gipuzkoa;015;Ataun;1660;849;811;2022
20;Gipuzkoa;017;Azkoitia;11617;5782;5835;2022
20;Gipuzkoa;018;Azpeitia;15154;7600;7554;2022
20;Gipuzkoa;904;Baliarrain;152;86;66;2022
20;Gipuzkoa;019;Beasain;13877;6973;6904;2022
20;Gipuzkoa;020;Beizama;136;87;49;2022
20;Gipuzkoa;021;Belauntza;269;142;127;2022
20;Gipuzkoa;022;Berastegi;1102;563;539;2022
20;Gipuzkoa;074;Bergara;14513;7195;7318;2022
20;Gipuzkoa;023;Berrobi;581;303;278;2022
20;Gipuzkoa;024;Bidania-Goiatz;527;283;244;2022
20;Gipuzkoa;029;Deba;5395;2669;2726;2022
20;Gipuzkoa;069;Donostia/San Sebastián;187849;88786;99063;2022
20;Gipuzkoa;030;Eibar;27282;13261;14021;2022
20;Gipuzkoa;031;Elduain;247;124;123;2022
20;Gipuzkoa;033;Elgeta;1122;565;557;2022
20;Gipuzkoa;032;Elgoibar;11480;5645;5835;2022
20;Gipuzkoa;067;Errenteria;39023;18851;20172;2022
20;Gipuzkoa;066;Errezil;565;298;267;2022
20;Gipuzkoa;034;Eskoriatza;4160;2081;2079;2022
20;Gipuzkoa;035;Ezkio-Itsaso;609;314;295;2022
20;Gipuzkoa;038;Gabiria;503;271;232;2022
20;Gipuzkoa;037;Gaintza;128;74;54;2022
20;Gipuzkoa;907;Gaztelu;173;89;84;2022
20;Gipuzkoa;039;Getaria;2825;1408;1417;2022
20;Gipuzkoa;040;Hernani;20375;9960;10415;2022
20;Gipuzkoa;041;Hernialde;314;164;150;2022
20;Gipuzkoa;036;Hondarribia;16904;8399;8505;2022
20;Gipuzkoa;042;Ibarra;4143;2046;2097;2022
20;Gipuzkoa;043;Idiazabal;2271;1148;1123;2022
20;Gipuzkoa;044;Ikaztegieta;483;252;231;2022
20;Gipuzkoa;045;Irun;62635;30701;31934;2022
20;Gipuzkoa;046;Irura;1885;994;891;2022
20;Gipuzkoa;047;Itsasondo;643;331;312;2022
20;Gipuzkoa;048;Larraul;258;146;112;2022
20;Gipuzkoa;902;Lasarte-Oria;18949;9173;9776;2022
20;Gipuzkoa;049;Lazkao;5962;2987;2975;2022
20;Gipuzkoa;050;Leaburu;385;204;181;2022
20;Gipuzkoa;051;Legazpi;8337;4190;4147;2022
20;Gipuzkoa;052;Legorreta;1432;714;718;2022
20;Gipuzkoa;068;Leintz-Gatzaga;206;116;90;2022
20;Gipuzkoa;053;Lezo;6011;2991;3020;2022
20;Gipuzkoa;054;Lizartza;629;327;302;2022
20;Gipuzkoa;901;Mendaro;1977;994;983;2022
20;Gipuzkoa;057;Mutiloa;259;135;124;2022
20;Gipuzkoa;056;Mutriku;5304;2665;2639;2022
20;Gipuzkoa;063;Oiartzun;10362;5140;5222;2022
20;Gipuzkoa;058;Olaberria;914;465;449;2022
20;Gipuzkoa;059;Oñati;11515;5708;5807;2022
20;Gipuzkoa;076;Ordizia;10424;5183;5241;2022
20;Gipuzkoa;905;Orendain;246;116;130;2022
20;Gipuzkoa;060;Orexa;114;64;50;2022
20;Gipuzkoa;061;Orio;6062;3040;3022;2022
20;Gipuzkoa;062;Ormaiztegi;1242;628;614;2022
20;Gipuzkoa;064;Pasaia;15711;7547;8164;2022
20;Gipuzkoa;070;Segura;1469;733;736;2022
20;Gipuzkoa;065;Soraluze-Placencia de las Armas;3842;1926;1916;2022
20;Gipuzkoa;071;Tolosa;19886;9626;10260;2022
20;Gipuzkoa;072;Urnieta;6181;3110;3071;2022
20;Gipuzkoa;077;Urretxu;6738;3332;3406;2022
20;Gipuzkoa;073;Usurbil;6166;3081;3085;2022
20;Gipuzkoa;075;Villabona;5833;2903;2930;2022
20;Gipuzkoa;078;Zaldibia;1673;852;821;2022
20;Gipuzkoa;079;Zarautz;23101;11227;11874;2022
20;Gipuzkoa;025;Zegama;1538;777;761;2022
20;Gipuzkoa;026;Zerain;276;132;144;2022
20;Gipuzkoa;027;Zestoa;3750;1964;1786;2022
20;Gipuzkoa;028;Zizurkil;2996;1511;1485;2022
20;Gipuzkoa;081;Zumaia;10153;5037;5116;2022
20;Gipuzkoa;080;Zumarraga;9636;4754;4882;2022
17;Girona;001;Agullana;903;455;448;2022
17;Girona;002;Aiguaviva;780;387;393;2022
17;Girona;003;Albanyà;180;94;86;2022
17;Girona;004;Albons;797;415;382;2022
17;Girona;006;Alp;1717;894;823;2022
17;Girona;007;Amer;2422;1185;1237;2022
17;Girona;008;Anglès;5682;2851;2831;2022
17;Girona;009;Arbúcies;6474;3335;3139;2022
17;Girona;010;Argelaguer;439;224;215;2022
17;Girona;011;Armentera, L';1043;532;511;2022
17;Girona;012;Avinyonet de Puigventós;1676;831;845;2022
17;Girona;015;Banyoles;20187;10012;10175;2022
17;Girona;016;Bàscara;1034;535;499;2022
17;Girona;013;Begur;4177;2086;2091;2022
17;Girona;018;Bellcaire d'Empordà;713;344;369;2022
17;Girona;019;Besalú;2480;1182;1298;2022
17;Girona;020;Bescanó;5156;2605;2551;2022
17;Girona;021;Beuda;202;106;96;2022
17;Girona;022;Bisbal d'Empordà, La;11163;5592;5571;2022
17;Girona;234;Biure;249;135;114;2022
17;Girona;023;Blanes;40579;20198;20381;2022
17;Girona;029;Boadella i les Escaules;258;129;129;2022
17;Girona;024;Bolvir;518;267;251;2022
17;Girona;025;Bordils;1815;912;903;2022
17;Girona;026;Borrassà;776;403;373;2022
17;Girona;027;Breda;3842;1895;1947;2022
17;Girona;028;Brunyola i Sant Martí Sapresa;388;201;187;2022
17;Girona;031;Cabanelles;279;151;128;2022
17;Girona;030;Cabanes;949;498;451;2022
17;Girona;032;Cadaqués;2889;1415;1474;2022
17;Girona;033;Caldes de Malavella;8196;4099;4097;2022
17;Girona;034;Calonge i Sant Antoni;11712;5838;5874;2022
17;Girona;035;Camós;715;355;360;2022
17;Girona;036;Campdevànol;3217;1576;1641;2022
17;Girona;037;Campelles;162;87;75;2022
17;Girona;038;Campllong;535;267;268;2022
17;Girona;039;Camprodon;2469;1200;1269;2022
17;Girona;040;Canet d'Adri;750;388;362;2022
17;Girona;041;Cantallops;330;168;162;2022
17;Girona;042;Capmany;672;350;322;2022
17;Girona;044;Cassà de la Selva;10680;5471;5209;2022
17;Girona;046;Castellfollit de la Roca;926;476;450;2022
17;Girona;047;Castelló d'Empúries;11611;5893;5718;2022
17;Girona;048;Castell-Platja d'Aro;11757;5809;5948;2022
17;Girona;189;Cellera de Ter, La;1967;964;1003;2022
17;Girona;049;Celrà;5503;2747;2756;2022
17;Girona;050;Cervià de Ter;999;513;486;2022
17;Girona;051;Cistella;307;149;158;2022
17;Girona;054;Colera;468;234;234;2022
17;Girona;055;Colomers;204;98;106;2022
17;Girona;057;Corçà;1268;651;617;2022
17;Girona;056;Cornellà del Terri;2407;1208;1199;2022
17;Girona;058;Crespià;276;143;133;2022
17;Girona;901;Cruïlles, Monells i Sant Sadurní de l'Heura;1338;676;662;2022
17;Girona;060;Darnius;535;277;258;2022
17;Girona;061;Das;267;141;126;2022
17;Girona;062;Escala, L';10520;5322;5198;2022
17;Girona;063;Espinelves;248;125;123;2022
17;Girona;064;Espolla;408;207;201;2022
17;Girona;065;Esponellà;489;256;233;2022
17;Girona;005;Far d'Empordà, El;625;320;305;2022
17;Girona;066;Figueres;47088;23198;23890;2022
17;Girona;067;Flaçà;1130;550;580;2022
17;Girona;068;Foixà;288;148;140;2022
17;Girona;069;Fontanals de Cerdanya;533;275;258;2022
17;Girona;070;Fontanilles;163;93;70;2022
17;Girona;071;Fontcoberta;1466;732;734;2022
17;Girona;902;Forallac;1765;853;912;2022
17;Girona;073;Fornells de la Selva;2693;1339;1354;2022
17;Girona;074;Fortià;778;389;389;2022
17;Girona;075;Garrigàs;458;238;220;2022
17;Girona;076;Garrigoles;177;96;81;2022
17;Girona;077;Garriguella;922;465;457;2022
17;Girona;078;Ger;512;273;239;2022
17;Girona;079;Girona;102666;49352;53314;2022
17;Girona;080;Gombrèn;200;98;102;2022
17;Girona;081;Gualta;439;254;185;2022
17;Girona;082;Guils de Cerdanya;573;303;270;2022
17;Girona;083;Hostalric;4370;2201;2169;2022
17;Girona;084;Isòvol;318;182;136;2022
17;Girona;085;Jafre;386;201;185;2022
17;Girona;086;Jonquera, La;3317;1669;1648;2022
17;Girona;087;Juià;334;179;155;2022
17;Girona;088;Lladó;827;412;415;2022
17;Girona;089;Llagostera;9024;4543;4481;2022
17;Girona;090;Llambilles;731;375;356;2022
17;Girona;091;Llanars;533;269;264;2022
17;Girona;092;Llançà;4905;2408;2497;2022
17;Girona;093;Llers;1245;626;619;2022
17;Girona;094;Llívia;1495;799;696;2022
17;Girona;095;Lloret de Mar;38941;19790;19151;2022
17;Girona;096;Llosses, Les;205;119;86;2022
17;Girona;102;Maçanet de Cabrenys;724;362;362;2022
17;Girona;103;Maçanet de la Selva;7572;3915;3657;2022
17;Girona;097;Madremanya;302;148;154;2022
17;Girona;098;Maià de Montcal;462;255;207;2022
17;Girona;100;Masarac;294;155;139;2022
17;Girona;101;Massanes;825;438;387;2022
17;Girona;099;Meranges;111;61;50;2022
17;Girona;105;Mieres;341;174;167;2022
17;Girona;106;Mollet de Peralada;202;104;98;2022
17;Girona;107;Molló;365;173;192;2022
17;Girona;109;Montagut i Oix;958;509;449;2022
17;Girona;110;Mont-ras;1676;848;828;2022
17;Girona;111;Navata;1465;718;747;2022
17;Girona;112;Ogassa;222;123;99;2022
17;Girona;114;Olot;36716;18588;18128;2022
17;Girona;115;Ordis;373;199;174;2022
17;Girona;116;Osor;423;230;193;2022
17;Girona;117;Palafrugell;23396;11670;11726;2022
17;Girona;118;Palamós;18145;8853;9292;2022
17;Girona;119;Palau de Santa Eulàlia;115;65;50;2022
17;Girona;121;Palau-sator;327;179;148;2022
17;Girona;120;Palau-saverdera;1472;743;729;2022
17;Girona;123;Palol de Revardit;457;231;226;2022
17;Girona;124;Pals;2548;1319;1229;2022
17;Girona;125;Pardines;165;90;75;2022
17;Girona;126;Parlavà;415;205;210;2022
17;Girona;128;Pau;579;284;295;2022
17;Girona;129;Pedret i Marzà;181;89;92;2022
17;Girona;130;Pera, La;438;220;218;2022
17;Girona;132;Peralada;1974;972;1002;2022
17;Girona;133;Planes d'Hostoles, Les;1745;883;862;2022
17;Girona;134;Planoles;307;171;136;2022
17;Girona;135;Pont de Molins;542;275;267;2022
17;Girona;136;Pontós;274;150;124;2022
17;Girona;137;Porqueres;4712;2324;2388;2022
17;Girona;140;Port de la Selva, El;1015;521;494;2022
17;Girona;138;Portbou;1090;539;551;2022
17;Girona;139;Preses, Les;1875;930;945;2022
17;Girona;141;Puigcerdà;9484;4731;4753;2022
17;Girona;142;Quart;3906;1980;1926;2022
17;Girona;043;Queralbs;191;98;93;2022
17;Girona;143;Rabós;210;101;109;2022
17;Girona;144;Regencós;271;146;125;2022
17;Girona;145;Ribes de Freser;1810;923;887;2022
17;Girona;146;Riells i Viabrea;4279;2177;2102;2022
17;Girona;147;Ripoll;10641;5284;5357;2022
17;Girona;148;Riudarenes;2337;1213;1124;2022
17;Girona;149;Riudaura;511;258;253;2022
17;Girona;150;Riudellots de la Selva;2072;1051;1021;2022
17;Girona;151;Riumors;244;128;116;2022
17;Girona;152;Roses;19907;10102;9805;2022
17;Girona;153;Rupià;300;152;148;2022
17;Girona;154;Sales de Llierca;169;84;85;2022
17;Girona;155;Salt;32517;17139;15378;2022
17;Girona;157;Sant Andreu Salou;162;79;83;2022
17;Girona;183;Sant Aniol de Finestres;363;184;179;2022
17;Girona;158;Sant Climent Sescebes;696;421;275;2022
17;Girona;159;Sant Feliu de Buixalleu;839;431;408;2022
17;Girona;160;Sant Feliu de Guíxols;22149;10841;11308;2022
17;Girona;161;Sant Feliu de Pallerols;1495;766;729;2022
17;Girona;162;Sant Ferriol;256;140;116;2022
17;Girona;163;Sant Gregori;4085;2086;1999;2022
17;Girona;164;Sant Hilari Sacalm;5836;2950;2886;2022
17;Girona;165;Sant Jaume de Llierca;842;414;428;2022
17;Girona;167;Sant Joan de les Abadesses;3274;1625;1649;2022
17;Girona;168;Sant Joan de Mollet;515;258;257;2022
17;Girona;185;Sant Joan les Fonts;3054;1550;1504;2022
17;Girona;166;Sant Jordi Desvalls;830;406;424;2022
17;Girona;169;Sant Julià de Ramis;3623;1821;1802;2022
17;Girona;903;Sant Julià del Llor i Bonmatí;1347;684;663;2022
17;Girona;171;Sant Llorenç de la Muga;267;143;124;2022
17;Girona;172;Sant Martí de Llémena;679;346;333;2022
17;Girona;173;Sant Martí Vell;261;140;121;2022
17;Girona;174;Sant Miquel de Campmajor;239;133;106;2022
17;Girona;175;Sant Miquel de Fluvià;808;414;394;2022
17;Girona;176;Sant Mori;159;80;79;2022
17;Girona;177;Sant Pau de Segúries;732;372;360;2022
17;Girona;178;Sant Pere Pescador;2079;1114;965;2022
17;Girona;180;Santa Coloma de Farners;13557;6851;6706;2022
17;Girona;181;Santa Cristina d'Aro;5585;2819;2766;2022
17;Girona;182;Santa Llogaia d'Àlguema;379;190;189;2022
17;Girona;184;Santa Pau;1605;808;797;2022
17;Girona;186;Sarrià de Ter;5294;2607;2687;2022
17;Girona;187;Saus, Camallera i Llampaies;865;438;427;2022
17;Girona;188;Selva de Mar, La;220;111;109;2022
17;Girona;190;Serinyà;1153;582;571;2022
17;Girona;191;Serra de Daró;233;124;109;2022
17;Girona;192;Setcases;200;112;88;2022
17;Girona;193;Sils;6507;3358;3149;2022
17;Girona;052;Siurana;178;84;94;2022
17;Girona;194;Susqueda;96;55;41;2022
17;Girona;195;Tallada d'Empordà, La;480;254;226;2022
17;Girona;196;Terrades;345;167;178;2022
17;Girona;197;Torrent;166;92;74;2022
17;Girona;198;Torroella de Fluvià;741;378;363;2022
17;Girona;199;Torroella de Montgrí;12061;6143;5918;2022
17;Girona;200;Tortellà;823;391;432;2022
17;Girona;201;Toses;185;104;81;2022
17;Girona;202;Tossa de Mar;5956;3052;2904;2022
17;Girona;204;Ullà;1195;655;540;2022
17;Girona;205;Ullastret;250;127;123;2022
17;Girona;203;Ultramort;224;116;108;2022
17;Girona;206;Urús;214;112;102;2022
17;Girona;014;Vajol, La;87;49;38;2022
17;Girona;208;Vall de Bianya, La;1345;673;672;2022
17;Girona;207;Vall d'en Bas, La;3143;1590;1553;2022
17;Girona;170;Vallfogona de Ripollès;222;116;106;2022
17;Girona;209;Vall-llobrega;926;463;463;2022
17;Girona;210;Ventalló;911;456;455;2022
17;Girona;211;Verges;1162;576;586;2022
17;Girona;212;Vidrà;181;91;90;2022
17;Girona;213;Vidreres;8167;4217;3950;2022
17;Girona;214;Vilabertran;991;497;494;2022
17;Girona;215;Vilablareix;3396;1691;1705;2022
17;Girona;217;Viladamat;479;242;237;2022
17;Girona;216;Viladasens;216;116;100;2022
17;Girona;218;Vilademuls;840;437;403;2022
17;Girona;220;Viladrau;1103;556;547;2022
17;Girona;221;Vilafant;5562;2740;2822;2022
17;Girona;223;Vilajuïga;1142;567;575;2022
17;Girona;224;Vilallonga de Ter;410;224;186;2022
17;Girona;225;Vilamacolum;386;222;164;2022
17;Girona;226;Vilamalla;1166;593;573;2022
17;Girona;227;Vilamaniscle;204;113;91;2022
17;Girona;228;Vilanant;401;199;202;2022
17;Girona;230;Vila-sacra;785;377;408;2022
17;Girona;222;Vilaür;162;84;78;2022
17;Girona;233;Vilobí d'Onyar;3304;1701;1603;2022
17;Girona;232;Vilopriu;223;119;104;2022
18;Granada;001;Agrón;247;130;117;2022
18;Granada;002;Alamedilla;567;293;274;2022
18;Granada;003;Albolote;19199;9426;9773;2022
18;Granada;004;Albondón;724;398;326;2022
18;Granada;005;Albuñán;407;210;197;2022
18;Granada;006;Albuñol;7420;4118;3302;2022
18;Granada;007;Albuñuelas;787;394;393;2022
18;Granada;010;Aldeire;603;313;290;2022
18;Granada;011;Alfacar;5585;2833;2752;2022
18;Granada;012;Algarinejo;2436;1253;1183;2022
18;Granada;013;Alhama de Granada;5703;2997;2706;2022
18;Granada;014;Alhendín;9941;5018;4923;2022
18;Granada;015;Alicún de Ortega;458;232;226;2022
18;Granada;016;Almegíjar;328;156;172;2022
18;Granada;017;Almuñécar;26748;13268;13480;2022
18;Granada;904;Alpujarra de la Sierra;922;521;401;2022
18;Granada;018;Alquife;586;296;290;2022
18;Granada;020;Arenas del Rey;623;328;295;2022
18;Granada;021;Armilla;24629;12116;12513;2022
18;Granada;022;Atarfe;19452;9758;9694;2022
18;Granada;023;Baza;20376;10100;10276;2022
18;Granada;024;Beas de Granada;986;514;472;2022
18;Granada;025;Beas de Guadix;319;159;160;2022
18;Granada;027;Benalúa;3260;1608;1652;2022
18;Granada;028;Benalúa de las Villas;1058;547;511;2022
18;Granada;029;Benamaurel;2275;1134;1141;2022
18;Granada;030;Bérchules;694;378;316;2022
18;Granada;032;Bubión;323;169;154;2022
18;Granada;033;Busquístar;302;163;139;2022
18;Granada;034;Cacín;547;285;262;2022
18;Granada;035;Cádiar;1542;814;728;2022
18;Granada;036;Cájar;5389;2660;2729;2022
18;Granada;114;Calahorra, La;664;340;324;2022
18;Granada;037;Calicasas;658;328;330;2022
18;Granada;038;Campotéjar;1231;624;607;2022
18;Granada;039;Caniles;4018;2057;1961;2022
18;Granada;040;Cáñar;400;214;186;2022
18;Granada;042;Capileira;578;283;295;2022
18;Granada;043;Carataunas;201;111;90;2022
18;Granada;044;Cástaras;233;141;92;2022
18;Granada;045;Castilléjar;1312;689;623;2022
18;Granada;046;Castril;2019;1049;970;2022
18;Granada;047;Cenes de la Vega;8121;4030;4091;2022
18;Granada;059;Chauchina;5667;2799;2868;2022
18;Granada;061;Chimeneas;1254;666;588;2022
18;Granada;062;Churriana de la Vega;16026;7892;8134;2022
18;Granada;048;Cijuela;3537;1816;1721;2022
18;Granada;049;Cogollos de Guadix;636;358;278;2022
18;Granada;050;Cogollos de la Vega;2042;1043;999;2022
18;Granada;051;Colomera;1291;681;610;2022
18;Granada;053;Cortes de Baza;1824;906;918;2022
18;Granada;054;Cortes y Graena;994;514;480;2022
18;Granada;912;Cuevas del Campo;1767;889;878;2022
18;Granada;056;Cúllar;4017;1992;2025;2022
18;Granada;057;Cúllar Vega;7681;3890;3791;2022
18;Granada;063;Darro;1652;846;806;2022
18;Granada;064;Dehesas de Guadix;404;195;209;2022
18;Granada;065;Dehesas Viejas;666;343;323;2022
18;Granada;066;Deifontes;2615;1320;1295;2022
18;Granada;067;Diezma;763;411;352;2022
18;Granada;068;Dílar;2188;1096;1092;2022
18;Granada;069;Dólar;614;325;289;2022
18;Granada;915;Domingo Pérez de Granada;849;445;404;2022
18;Granada;070;Dúdar;355;191;164;2022
18;Granada;071;Dúrcal;7216;3627;3589;2022
18;Granada;072;Escúzar;835;440;395;2022
18;Granada;074;Ferreira;305;158;147;2022
18;Granada;076;Fonelas;981;509;472;2022
18;Granada;077;Fornes;519;274;245;2022
18;Granada;078;Freila;906;478;428;2022
18;Granada;079;Fuente Vaqueros;4451;2248;2203;2022
18;Granada;905;Gabias, Las;22312;11273;11039;2022
18;Granada;082;Galera;1116;569;547;2022
18;Granada;083;Gobernador;210;105;105;2022
18;Granada;084;Gójar;6096;3084;3012;2022
18;Granada;085;Gor;735;393;342;2022
18;Granada;086;Gorafe;377;196;181;2022
18;Granada;087;Granada;228682;105522;123160;2022
18;Granada;088;Guadahortuna;1836;936;900;2022
18;Granada;089;Guadix;18493;9189;9304;2022
18;Granada;906;Guájares, Los;1100;597;503;2022
18;Granada;093;Gualchos;5292;2837;2455;2022
18;Granada;094;Güéjar Sierra;2880;1537;1343;2022
18;Granada;095;Güevéjar;2664;1381;1283;2022
18;Granada;096;Huélago;373;193;180;2022
18;Granada;097;Huéneja;1207;647;560;2022
18;Granada;098;Huéscar;7246;3582;3664;2022
18;Granada;099;Huétor de Santillán;1923;986;937;2022
18;Granada;100;Huétor Tájar;10543;5319;5224;2022
18;Granada;101;Huétor Vega;12089;6075;6014;2022
18;Granada;102;Íllora;10020;5067;4953;2022
18;Granada;103;Ítrabo;937;462;475;2022
18;Granada;105;Iznalloz;5142;2627;2515;2022
18;Granada;106;Játar;579;319;260;2022
18;Granada;107;Jayena;1008;518;490;2022
18;Granada;108;Jérez del Marquesado;956;483;473;2022
18;Granada;109;Jete;1008;533;475;2022
18;Granada;111;Jun;3991;2024;1967;2022
18;Granada;112;Juviles;134;76;58;2022
18;Granada;115;Láchar;3657;1868;1789;2022
18;Granada;116;Lanjarón;3615;1817;1798;2022
18;Granada;117;Lanteira;566;301;265;2022
18;Granada;119;Lecrín;2225;1128;1097;2022
18;Granada;120;Lentegí;335;168;167;2022
18;Granada;121;Lobras;135;68;67;2022
18;Granada;122;Loja;20555;10273;10282;2022
18;Granada;123;Lugros;304;158;146;2022
18;Granada;124;Lújar;483;260;223;2022
18;Granada;126;Malahá, La;1810;906;904;2022
18;Granada;127;Maracena;22293;10889;11404;2022
18;Granada;128;Marchal;414;199;215;2022
18;Granada;132;Moclín;3607;1790;1817;2022
18;Granada;133;Molvízar;2731;1405;1326;2022
18;Granada;134;Monachil;8182;4194;3988;2022
18;Granada;135;Montefrío;5406;2819;2587;2022
18;Granada;136;Montejícar;2058;1067;991;2022
18;Granada;137;Montillana;1083;576;507;2022
18;Granada;138;Moraleda de Zafayona;3123;1585;1538;2022
18;Granada;909;Morelábor;582;310;272;2022
18;Granada;140;Motril;58798;28845;29953;2022
18;Granada;141;Murtas;463;261;202;2022
18;Granada;903;Nevada;1086;560;526;2022
18;Granada;143;Nigüelas;1225;628;597;2022
18;Granada;144;Nívar;1099;569;530;2022
18;Granada;145;Ogíjares;14627;7263;7364;2022
18;Granada;146;Orce;1148;577;571;2022
18;Granada;147;Órgiva;5791;2890;2901;2022
18;Granada;148;Otívar;1004;517;487;2022
18;Granada;150;Padul;9158;4575;4583;2022
18;Granada;151;Pampaneira;319;161;158;2022
18;Granada;152;Pedro Martínez;1120;562;558;2022
18;Granada;153;Peligros;11624;5749;5875;2022
18;Granada;154;Peza, La;1149;597;552;2022
18;Granada;910;Pinar, El;896;474;422;2022
18;Granada;157;Pinos Genil;1530;795;735;2022
18;Granada;158;Pinos Puente;9804;4876;4928;2022
18;Granada;159;Píñar;1106;601;505;2022
18;Granada;161;Polícar;262;139;123;2022
18;Granada;162;Polopos;1630;900;730;2022
18;Granada;163;Pórtugos;397;202;195;2022
18;Granada;164;Puebla de Don Fadrique;2197;1126;1071;2022
18;Granada;165;Pulianas;5495;2765;2730;2022
18;Granada;167;Purullena;2329;1180;1149;2022
18;Granada;168;Quéntar;972;508;464;2022
18;Granada;170;Rubite;403;226;177;2022
18;Granada;171;Salar;2612;1306;1306;2022
18;Granada;173;Salobreña;12477;6224;6253;2022
18;Granada;174;Santa Cruz del Comercio;539;275;264;2022
18;Granada;175;Santa Fe;15042;7399;7643;2022
18;Granada;176;Soportújar;265;142;123;2022
18;Granada;177;Sorvilán;535;298;237;2022
18;Granada;901;Taha, La;727;357;370;2022
18;Granada;178;Torre-Cardela;709;385;324;2022
18;Granada;916;Torrenueva Costa;3038;1592;1446;2022
18;Granada;179;Torvizcón;650;346;304;2022
18;Granada;180;Trevélez;712;377;335;2022
18;Granada;181;Turón;235;144;91;2022
18;Granada;182;Ugíjar;2555;1264;1291;2022
18;Granada;914;Valderrubio;2045;1007;1038;2022
18;Granada;907;Valle del Zalabí;2087;1068;1019;2022
18;Granada;902;Valle, El;917;458;459;2022
18;Granada;183;Válor;678;359;319;2022
18;Granada;911;Vegas del Genil;11874;6045;5829;2022
18;Granada;184;Vélez de Benaudalla;2960;1495;1465;2022
18;Granada;185;Ventas de Huelma;641;356;285;2022
18;Granada;149;Villa de Otura;7362;3717;3645;2022
18;Granada;908;Villamena;954;488;466;2022
18;Granada;187;Villanueva de las Torres;536;296;240;2022
18;Granada;188;Villanueva Mesía;2031;990;1041;2022
18;Granada;189;Víznar;987;514;473;2022
18;Granada;192;Zafarraya;2123;1124;999;2022
18;Granada;913;Zagra;931;501;430;2022
18;Granada;193;Zubia, La;19593;9691;9902;2022
18;Granada;194;Zújar;2501;1280;1221;2022
19;Guadalajara;001;Abánades;61;37;24;2022
19;Guadalajara;002;Ablanque;63;35;28;2022
19;Guadalajara;003;Adobes;28;16;12;2022
19;Guadalajara;004;Alaminos;56;27;29;2022
19;Guadalajara;005;Alarilla;136;84;52;2022
19;Guadalajara;006;Albalate de Zorita;1056;586;470;2022
19;Guadalajara;007;Albares;518;268;250;2022
19;Guadalajara;008;Albendiego;46;31;15;2022
19;Guadalajara;009;Alcocer;315;161;154;2022
19;Guadalajara;010;Alcolea de las Peñas;12;8;4;2022
19;Guadalajara;011;Alcolea del Pinar;326;189;137;2022
19;Guadalajara;013;Alcoroches;122;73;49;2022
19;Guadalajara;015;Aldeanueva de Guadalajara;106;63;43;2022
19;Guadalajara;016;Algar de Mesa;48;34;14;2022
19;Guadalajara;017;Algora;80;50;30;2022
19;Guadalajara;018;Alhóndiga;158;91;67;2022
19;Guadalajara;019;Alique;13;6;7;2022
19;Guadalajara;020;Almadrones;54;36;18;2022
19;Guadalajara;021;Almoguera;1284;649;635;2022
19;Guadalajara;022;Almonacid de Zorita;659;337;322;2022
19;Guadalajara;023;Alocén;159;80;79;2022
19;Guadalajara;024;Alovera;13142;6701;6441;2022
19;Guadalajara;027;Alustante;145;85;60;2022
19;Guadalajara;031;Angón;10;8;2;2022
19;Guadalajara;032;Anguita;155;84;71;2022
19;Guadalajara;033;Anquela del Ducado;54;32;22;2022
19;Guadalajara;034;Anquela del Pedregal;26;15;11;2022
19;Guadalajara;036;Aranzueque;358;195;163;2022
19;Guadalajara;037;Arbancón;145;86;59;2022
19;Guadalajara;038;Arbeteta;19;15;4;2022
19;Guadalajara;039;Argecilla;70;47;23;2022
19;Guadalajara;040;Armallones;50;28;22;2022
19;Guadalajara;041;Armuña de Tajuña;254;128;126;2022
19;Guadalajara;042;Arroyo de las Fraguas;23;12;11;2022
19;Guadalajara;043;Atanzón;97;64;33;2022
19;Guadalajara;044;Atienza;398;231;167;2022
19;Guadalajara;045;Auñón;151;84;67;2022
19;Guadalajara;046;Azuqueca de Henares;35182;17735;17447;2022
19;Guadalajara;047;Baides;60;30;30;2022
19;Guadalajara;048;Baños de Tajo;17;12;5;2022
19;Guadalajara;049;Bañuelos;14;12;2;2022
19;Guadalajara;050;Barriopedro;19;12;7;2022
19;Guadalajara;051;Berninches;52;35;17;2022
19;Guadalajara;052;Bodera, La;22;15;7;2022
19;Guadalajara;053;Brihuega;2511;1308;1203;2022
19;Guadalajara;054;Budia;197;117;80;2022
19;Guadalajara;055;Bujalaro;44;22;22;2022
19;Guadalajara;057;Bustares;71;43;28;2022
19;Guadalajara;058;Cabanillas del Campo;10968;5518;5450;2022
19;Guadalajara;059;Campillo de Dueñas;80;48;32;2022
19;Guadalajara;060;Campillo de Ranas;109;71;38;2022
19;Guadalajara;061;Campisábalos;67;46;21;2022
19;Guadalajara;064;Canredondo;76;48;28;2022
19;Guadalajara;065;Cantalojas;135;76;59;2022
19;Guadalajara;066;Cañizar;57;34;23;2022
19;Guadalajara;067;Cardoso de la Sierra, El;49;31;18;2022
19;Guadalajara;070;Casa de Uceda;92;51;41;2022
19;Guadalajara;071;Casar, El;12919;6524;6395;2022
19;Guadalajara;073;Casas de San Galindo;21;15;6;2022
19;Guadalajara;074;Caspueñas;119;74;45;2022
19;Guadalajara;075;Castejón de Henares;61;39;22;2022
19;Guadalajara;076;Castellar de la Muela;27;14;13;2022
19;Guadalajara;078;Castilforte;56;36;20;2022
19;Guadalajara;079;Castilnuevo;6;5;1;2022
19;Guadalajara;080;Cendejas de Enmedio;67;35;32;2022
19;Guadalajara;081;Cendejas de la Torre;24;17;7;2022
19;Guadalajara;082;Centenera;144;83;61;2022
19;Guadalajara;103;Checa;286;174;112;2022
19;Guadalajara;104;Chequilla;16;9;7;2022
19;Guadalajara;106;Chillarón del Rey;85;47;38;2022
19;Guadalajara;105;Chiloeches;3858;1998;1860;2022
19;Guadalajara;086;Cifuentes;1625;822;803;2022
19;Guadalajara;087;Cincovillas;27;14;13;2022
19;Guadalajara;088;Ciruelas;120;68;52;2022
19;Guadalajara;089;Ciruelos del Pinar;24;14;10;2022
19;Guadalajara;090;Cobeta;108;53;55;2022
19;Guadalajara;091;Cogollor;20;13;7;2022
19;Guadalajara;092;Cogolludo;563;329;234;2022
19;Guadalajara;095;Condemios de Abajo;11;9;2;2022
19;Guadalajara;096;Condemios de Arriba;106;62;44;2022
19;Guadalajara;097;Congostrina;13;10;3;2022
19;Guadalajara;098;Copernal;34;23;11;2022
19;Guadalajara;099;Corduente;324;184;140;2022
19;Guadalajara;102;Cubillo de Uceda, El;121;69;52;2022
19;Guadalajara;107;Driebes;355;197;158;2022
19;Guadalajara;108;Durón;109;62;47;2022
19;Guadalajara;109;Embid;28;17;11;2022
19;Guadalajara;110;Escamilla;63;42;21;2022
19;Guadalajara;111;Escariche;186;114;72;2022
19;Guadalajara;112;Escopete;68;37;31;2022
19;Guadalajara;113;Espinosa de Henares;625;318;307;2022
19;Guadalajara;114;Esplegares;33;18;15;2022
19;Guadalajara;115;Establés;29;17;12;2022
19;Guadalajara;116;Estriégana;12;9;3;2022
19;Guadalajara;117;Fontanar;2567;1344;1223;2022
19;Guadalajara;118;Fuembellida;12;8;4;2022
19;Guadalajara;119;Fuencemillán;79;49;30;2022
19;Guadalajara;120;Fuentelahiguera de Albatages;130;76;54;2022
19;Guadalajara;121;Fuentelencina;314;165;149;2022
19;Guadalajara;122;Fuentelsaz;88;45;43;2022
19;Guadalajara;123;Fuentelviejo;52;31;21;2022
19;Guadalajara;124;Fuentenovilla;568;318;250;2022
19;Guadalajara;125;Gajanejos;61;37;24;2022
19;Guadalajara;126;Galápagos;2600;1353;1247;2022
19;Guadalajara;127;Galve de Sorbe;96;52;44;2022
19;Guadalajara;129;Gascueña de Bornova;30;18;12;2022
19;Guadalajara;130;Guadalajara;87452;42094;45358;2022
19;Guadalajara;132;Henche;82;43;39;2022
19;Guadalajara;133;Heras de Ayuso;231;128;103;2022
19;Guadalajara;134;Herrería;24;15;9;2022
19;Guadalajara;135;Hiendelaencina;115;72;43;2022
19;Guadalajara;136;Hijes;19;11;8;2022
19;Guadalajara;138;Hita;325;182;143;2022
19;Guadalajara;139;Hombrados;45;27;18;2022
19;Guadalajara;142;Hontoba;390;220;170;2022
19;Guadalajara;143;Horche;2751;1381;1370;2022
19;Guadalajara;145;Hortezuela de Océn;38;23;15;2022
19;Guadalajara;146;Huerce, La;54;32;22;2022
19;Guadalajara;147;Huérmeces del Cerro;42;31;11;2022
19;Guadalajara;148;Huertahernando;57;37;20;2022
19;Guadalajara;150;Hueva;97;60;37;2022
19;Guadalajara;151;Humanes;1644;835;809;2022
19;Guadalajara;152;Illana;799;443;356;2022
19;Guadalajara;153;Iniéstola;22;15;7;2022
19;Guadalajara;154;Inviernas, Las;61;42;19;2022
19;Guadalajara;155;Irueste;81;52;29;2022
19;Guadalajara;156;Jadraque;1393;731;662;2022
19;Guadalajara;157;Jirueque;49;34;15;2022
19;Guadalajara;159;Ledanca;107;52;55;2022
19;Guadalajara;160;Loranca de Tajuña;1318;715;603;2022
19;Guadalajara;161;Lupiana;286;154;132;2022
19;Guadalajara;162;Luzaga;65;36;29;2022
19;Guadalajara;163;Luzón;65;32;33;2022
19;Guadalajara;165;Majaelrayo;54;34;20;2022
19;Guadalajara;166;Málaga del Fresno;174;97;77;2022
19;Guadalajara;167;Malaguilla;172;96;76;2022
19;Guadalajara;168;Mandayona;298;145;153;2022
19;Guadalajara;169;Mantiel;31;21;10;2022
19;Guadalajara;170;Maranchón;225;120;105;2022
19;Guadalajara;171;Marchamalo;8030;4029;4001;2022
19;Guadalajara;172;Masegoso de Tajuña;57;33;24;2022
19;Guadalajara;173;Matarrubia;64;42;22;2022
19;Guadalajara;174;Matillas;103;56;47;2022
19;Guadalajara;175;Mazarete;24;11;13;2022
19;Guadalajara;176;Mazuecos;260;144;116;2022
19;Guadalajara;177;Medranda;68;34;34;2022
19;Guadalajara;178;Megina;36;23;13;2022
19;Guadalajara;179;Membrillera;117;68;49;2022
19;Guadalajara;181;Miedes de Atienza;54;36;18;2022
19;Guadalajara;182;Mierla, La;38;24;14;2022
19;Guadalajara;184;Millana;110;66;44;2022
19;Guadalajara;183;Milmarcos;70;43;27;2022
19;Guadalajara;185;Miñosa, La;29;17;12;2022
19;Guadalajara;186;Mirabueno;83;51;32;2022
19;Guadalajara;187;Miralrío;64;35;29;2022
19;Guadalajara;188;Mochales;38;19;19;2022
19;Guadalajara;189;Mohernando;167;94;73;2022
19;Guadalajara;190;Molina de Aragón;3234;1598;1636;2022
19;Guadalajara;191;Monasterio;15;7;8;2022
19;Guadalajara;192;Mondéjar;2757;1435;1322;2022
19;Guadalajara;193;Montarrón;26;17;9;2022
19;Guadalajara;194;Moratilla de los Meleros;107;61;46;2022
19;Guadalajara;195;Morenilla;52;29;23;2022
19;Guadalajara;196;Muduex;103;56;47;2022
19;Guadalajara;197;Navas de Jadraque, Las;33;22;11;2022
19;Guadalajara;198;Negredo;16;8;8;2022
19;Guadalajara;199;Ocentejo;16;11;5;2022
19;Guadalajara;200;Olivar, El;61;36;25;2022
19;Guadalajara;201;Olmeda de Cobeta;59;30;29;2022
19;Guadalajara;202;Olmeda de Jadraque, La;14;11;3;2022
19;Guadalajara;203;Ordial, El;39;24;15;2022
19;Guadalajara;204;Orea;189;115;74;2022
19;Guadalajara;208;Pálmaces de Jadraque;42;28;14;2022
19;Guadalajara;209;Pardos;39;22;17;2022
19;Guadalajara;210;Paredes de Sigüenza;23;10;13;2022
19;Guadalajara;211;Pareja;463;280;183;2022
19;Guadalajara;212;Pastrana;850;422;428;2022
19;Guadalajara;213;Pedregal, El;63;43;20;2022
19;Guadalajara;214;Peñalén;78;45;33;2022
19;Guadalajara;215;Peñalver;154;97;57;2022
19;Guadalajara;216;Peralejos de las Truchas;149;79;70;2022
19;Guadalajara;217;Peralveche;47;32;15;2022
19;Guadalajara;218;Pinilla de Jadraque;52;33;19;2022
19;Guadalajara;219;Pinilla de Molina;12;10;2;2022
19;Guadalajara;220;Pioz;5013;2609;2404;2022
19;Guadalajara;221;Piqueras;42;30;12;2022
19;Guadalajara;222;Pobo de Dueñas, El;101;52;49;2022
19;Guadalajara;223;Poveda de la Sierra;116;62;54;2022
19;Guadalajara;224;Pozo de Almoguera;110;67;43;2022
19;Guadalajara;225;Pozo de Guadalajara;1555;837;718;2022
19;Guadalajara;226;Prádena de Atienza;41;28;13;2022
19;Guadalajara;227;Prados Redondos;54;39;15;2022
19;Guadalajara;228;Puebla de Beleña;49;30;19;2022
19;Guadalajara;229;Puebla de Valles;58;34;24;2022
19;Guadalajara;230;Quer;945;502;443;2022
19;Guadalajara;231;Rebollosa de Jadraque;11;8;3;2022
19;Guadalajara;232;Recuenco, El;61;36;25;2022
19;Guadalajara;233;Renera;104;68;36;2022
19;Guadalajara;234;Retiendas;50;34;16;2022
19;Guadalajara;235;Riba de Saelices;115;69;46;2022
19;Guadalajara;237;Rillo de Gallo;47;27;20;2022
19;Guadalajara;238;Riofrío del Llano;58;36;22;2022
19;Guadalajara;239;Robledillo de Mohernando;148;87;61;2022
19;Guadalajara;240;Robledo de Corpes;42;21;21;2022
19;Guadalajara;241;Romanillos de Atienza;32;22;10;2022
19;Guadalajara;242;Romanones;112;58;54;2022
19;Guadalajara;243;Rueda de la Sierra;41;28;13;2022
19;Guadalajara;244;Sacecorbo;99;58;41;2022
19;Guadalajara;245;Sacedón;1547;792;755;2022
19;Guadalajara;246;Saelices de la Sal;48;28;20;2022
19;Guadalajara;247;Salmerón;128;74;54;2022
19;Guadalajara;248;San Andrés del Congosto;73;47;26;2022
19;Guadalajara;249;San Andrés del Rey;36;19;17;2022
19;Guadalajara;250;Santiuste;14;10;4;2022
19;Guadalajara;251;Saúca;52;31;21;2022
19;Guadalajara;252;Sayatón;63;34;29;2022
19;Guadalajara;254;Selas;40;20;20;2022
19;Guadalajara;901;Semillas;35;22;13;2022
19;Guadalajara;255;Setiles;86;49;37;2022
19;Guadalajara;256;Sienes;48;28;20;2022
19;Guadalajara;257;Sigüenza;4359;2221;2138;2022
19;Guadalajara;258;Solanillos del Extremo;87;56;31;2022
19;Guadalajara;259;Somolinos;31;17;14;2022
19;Guadalajara;260;Sotillo, El;35;17;18;2022
19;Guadalajara;261;Sotodosos;31;18;13;2022
19;Guadalajara;262;Tamajón;147;83;64;2022
19;Guadalajara;263;Taragudo;43;27;16;2022
19;Guadalajara;264;Taravilla;33;23;10;2022
19;Guadalajara;265;Tartanedo;147;87;60;2022
19;Guadalajara;266;Tendilla;315;173;142;2022
19;Guadalajara;267;Terzaga;20;12;8;2022
19;Guadalajara;268;Tierzo;36;21;15;2022
19;Guadalajara;269;Toba, La;76;50;26;2022
19;Guadalajara;271;Tordellego;49;28;21;2022
19;Guadalajara;270;Tordelrábano;12;8;4;2022
19;Guadalajara;272;Tordesilos;93;55;38;2022
19;Guadalajara;274;Torija;1663;863;800;2022
19;Guadalajara;279;Torre del Burgo;474;273;201;2022
19;Guadalajara;277;Torrecuadrada de Molina;21;14;7;2022
19;Guadalajara;278;Torrecuadradilla;28;17;11;2022
19;Guadalajara;280;Torrejón del Rey;6002;3114;2888;2022
19;Guadalajara;281;Torremocha de Jadraque;18;10;8;2022
19;Guadalajara;282;Torremocha del Campo;183;106;77;2022
19;Guadalajara;283;Torremocha del Pinar;40;18;22;2022
19;Guadalajara;284;Torremochuela;8;6;2;2022
19;Guadalajara;285;Torrubia;23;15;8;2022
19;Guadalajara;286;Tórtola de Henares;1331;713;618;2022
19;Guadalajara;287;Tortuera;181;94;87;2022
19;Guadalajara;288;Tortuero;18;13;5;2022
19;Guadalajara;289;Traíd;24;15;9;2022
19;Guadalajara;290;Trijueque;1478;794;684;2022
19;Guadalajara;291;Trillo;1401;732;669;2022
19;Guadalajara;293;Uceda;3048;1563;1485;2022
19;Guadalajara;294;Ujados;28;13;15;2022
19;Guadalajara;296;Utande;34;26;8;2022
19;Guadalajara;297;Valdarachas;47;24;23;2022
19;Guadalajara;298;Valdearenas;76;49;27;2022
19;Guadalajara;299;Valdeavellano;108;58;50;2022
19;Guadalajara;300;Valdeaveruelo;1177;612;565;2022
19;Guadalajara;301;Valdeconcha;39;22;17;2022
19;Guadalajara;302;Valdegrudas;53;34;19;2022
19;Guadalajara;303;Valdelcubo;38;25;13;2022
19;Guadalajara;304;Valdenuño Fernández;308;168;140;2022
19;Guadalajara;305;Valdepeñas de la Sierra;147;89;58;2022
19;Guadalajara;306;Valderrebollo;23;12;11;2022
19;Guadalajara;307;Valdesotos;27;17;10;2022
19;Guadalajara;308;Valfermoso de Tajuña;74;45;29;2022
19;Guadalajara;309;Valhermoso;26;16;10;2022
19;Guadalajara;310;Valtablado del Río;8;5;3;2022
19;Guadalajara;311;Valverde de los Arroyos;88;49;39;2022
19;Guadalajara;314;Viana de Jadraque;41;28;13;2022
19;Guadalajara;317;Villanueva de Alcorón;135;79;56;2022
19;Guadalajara;318;Villanueva de Argecilla;39;21;18;2022
19;Guadalajara;319;Villanueva de la Torre;6559;3333;3226;2022
19;Guadalajara;321;Villares de Jadraque;49;31;18;2022
19;Guadalajara;322;Villaseca de Henares;26;14;12;2022
19;Guadalajara;323;Villaseca de Uceda;45;24;21;2022
19;Guadalajara;324;Villel de Mesa;173;102;71;2022
19;Guadalajara;325;Viñuelas;182;91;91;2022
19;Guadalajara;326;Yebes;4936;2532;2404;2022
19;Guadalajara;327;Yebra;451;241;210;2022
19;Guadalajara;329;Yélamos de Abajo;65;32;33;2022
19;Guadalajara;330;Yélamos de Arriba;82;49;33;2022
19;Guadalajara;331;Yunquera de Henares;4329;2203;2126;2022
19;Guadalajara;332;Yunta, La;90;53;37;2022
19;Guadalajara;333;Zaorejas;101;67;34;2022
19;Guadalajara;334;Zarzuela de Jadraque;54;37;17;2022
19;Guadalajara;335;Zorita de los Canes;60;34;26;2022
21;Huelva;001;Alájar;802;412;390;2022
21;Huelva;002;Aljaraque;22078;10980;11098;2022
21;Huelva;003;Almendro, El;848;439;409;2022
21;Huelva;004;Almonaster la Real;1785;948;837;2022
21;Huelva;005;Almonte;25448;12370;13078;2022
21;Huelva;006;Alosno;3940;1947;1993;2022
21;Huelva;007;Aracena;8240;4055;4185;2022
21;Huelva;008;Aroche;3024;1511;1513;2022
21;Huelva;009;Arroyomolinos de León;951;481;470;2022
21;Huelva;010;Ayamonte;21725;10902;10823;2022
21;Huelva;011;Beas;4465;2217;2248;2022
21;Huelva;012;Berrocal;302;154;148;2022
21;Huelva;013;Bollullos Par del Condado;14293;7077;7216;2022
21;Huelva;014;Bonares;6093;3034;3059;2022
21;Huelva;015;Cabezas Rubias;705;369;336;2022
21;Huelva;016;Cala;1155;586;569;2022
21;Huelva;017;Calañas;2734;1382;1352;2022
21;Huelva;018;Campillo, El;2018;982;1036;2022
21;Huelva;019;Campofrío;742;383;359;2022
21;Huelva;020;Cañaveral de León;393;197;196;2022
21;Huelva;021;Cartaya;20717;10533;10184;2022
21;Huelva;022;Castaño del Robledo;227;127;100;2022
21;Huelva;023;Cerro de Andévalo, El;2286;1142;1144;2022
21;Huelva;030;Chucena;2229;1115;1114;2022
21;Huelva;024;Corteconcepción;561;295;266;2022
21;Huelva;025;Cortegana;4636;2343;2293;2022
21;Huelva;026;Cortelazor;302;142;160;2022
21;Huelva;027;Cumbres de Enmedio;59;31;28;2022
21;Huelva;028;Cumbres de San Bartolomé;377;196;181;2022
21;Huelva;029;Cumbres Mayores;1737;860;877;2022
21;Huelva;031;Encinasola;1275;645;630;2022
21;Huelva;032;Escacena del Campo;2288;1100;1188;2022
21;Huelva;033;Fuenteheridos;778;402;376;2022
21;Huelva;034;Galaroza;1373;686;687;2022
21;Huelva;035;Gibraleón;12930;6485;6445;2022
21;Huelva;036;Granada de Río-Tinto, La;254;126;128;2022
21;Huelva;037;Granado, El;507;263;244;2022
21;Huelva;038;Higuera de la Sierra;1320;688;632;2022
21;Huelva;039;Hinojales;335;168;167;2022
21;Huelva;040;Hinojos;3951;1992;1959;2022
21;Huelva;041;Huelva;141854;68050;73804;2022
21;Huelva;042;Isla Cristina;21523;10801;10722;2022
21;Huelva;043;Jabugo;2243;1123;1120;2022
21;Huelva;044;Lepe;28617;14791;13826;2022
21;Huelva;045;Linares de la Sierra;276;134;142;2022
21;Huelva;046;Lucena del Puerto;3213;1691;1522;2022
21;Huelva;047;Manzanilla;2119;1091;1028;2022
21;Huelva;048;Marines, Los;410;216;194;2022
21;Huelva;049;Minas de Riotinto;3738;1801;1937;2022
21;Huelva;050;Moguer;22643;11407;11236;2022
21;Huelva;051;Nava, La;247;130;117;2022
21;Huelva;052;Nerva;5100;2462;2638;2022
21;Huelva;053;Niebla;4196;2112;2084;2022
21;Huelva;054;Palma del Condado, La;10770;5360;5410;2022
21;Huelva;055;Palos de la Frontera;12483;6418;6065;2022
21;Huelva;056;Paterna del Campo;3478;1772;1706;2022
21;Huelva;057;Paymogo;1124;557;567;2022
21;Huelva;058;Puebla de Guzmán;3092;1586;1506;2022
21;Huelva;059;Puerto Moral;281;137;144;2022
21;Huelva;060;Punta Umbría;16167;8238;7929;2022
21;Huelva;061;Rociana del Condado;7866;3933;3933;2022
21;Huelva;062;Rosal de la Frontera;1698;844;854;2022
21;Huelva;063;San Bartolomé de la Torre;3906;1964;1942;2022
21;Huelva;064;San Juan del Puerto;9532;4774;4758;2022
21;Huelva;066;San Silvestre de Guzmán;659;345;314;2022
21;Huelva;065;Sanlúcar de Guadiana;402;199;203;2022
21;Huelva;067;Santa Ana la Real;473;219;254;2022
21;Huelva;068;Santa Bárbara de Casa;1075;536;539;2022
21;Huelva;069;Santa Olalla del Cala;2028;1040;988;2022
21;Huelva;070;Trigueros;7926;3933;3993;2022
21;Huelva;071;Valdelarco;239;111;128;2022
21;Huelva;072;Valverde del Camino;12721;6250;6471;2022
21;Huelva;073;Villablanca;2945;1482;1463;2022
21;Huelva;074;Villalba del Alcor;3316;1641;1675;2022
21;Huelva;075;Villanueva de las Cruces;377;184;193;2022
21;Huelva;076;Villanueva de los Castillejos;2923;1495;1428;2022
21;Huelva;077;Villarrasa;2190;1098;1092;2022
21;Huelva;078;Zalamea la Real;3026;1519;1507;2022
21;Huelva;902;Zarza-Perrunal, La;1230;622;608;2022
21;Huelva;079;Zufre;774;405;369;2022
22;Huesca;001;Abiego;278;139;139;2022
22;Huesca;002;Abizanda;151;76;75;2022
22;Huesca;003;Adahuesca;204;117;87;2022
22;Huesca;004;Agüero;145;80;65;2022
22;Huesca;907;Aínsa-Sobrarbe;2315;1166;1149;2022
22;Huesca;006;Aisa;339;184;155;2022
22;Huesca;007;Albalate de Cinca;1125;616;509;2022
22;Huesca;008;Albalatillo;204;110;94;2022
22;Huesca;009;Albelda;694;356;338;2022
22;Huesca;011;Albero Alto;117;66;51;2022
22;Huesca;012;Albero Bajo;134;71;63;2022
22;Huesca;013;Alberuela de Tubo;305;155;150;2022
22;Huesca;014;Alcalá de Gurrea;230;121;109;2022
22;Huesca;015;Alcalá del Obispo;374;212;162;2022
22;Huesca;016;Alcampell;623;295;328;2022
22;Huesca;017;Alcolea de Cinca;1160;627;533;2022
22;Huesca;018;Alcubierre;399;217;182;2022
22;Huesca;019;Alerre;213;115;98;2022
22;Huesca;020;Alfántega;124;67;57;2022
22;Huesca;021;Almudévar;2394;1217;1177;2022
22;Huesca;022;Almunia de San Juan;707;367;340;2022
22;Huesca;023;Almuniente;453;236;217;2022
22;Huesca;024;Alquézar;354;184;170;2022
22;Huesca;025;Altorricón;1416;771;645;2022
22;Huesca;027;Angüés;368;196;172;2022
22;Huesca;028;Ansó;406;204;202;2022
22;Huesca;029;Antillón;136;71;65;2022
22;Huesca;032;Aragüés del Puerto;117;65;52;2022
22;Huesca;035;Arén;318;172;146;2022
22;Huesca;036;Argavieso;126;76;50;2022
22;Huesca;037;Arguis;153;84;69;2022
22;Huesca;039;Ayerbe;1059;526;533;2022
22;Huesca;040;Azanuy-Alins;174;86;88;2022
22;Huesca;041;Azara;160;84;76;2022
22;Huesca;042;Azlor;148;68;80;2022
22;Huesca;043;Baélls;90;51;39;2022
22;Huesca;044;Bailo;273;164;109;2022
22;Huesca;045;Baldellou;79;43;36;2022
22;Huesca;046;Ballobar;864;446;418;2022
22;Huesca;047;Banastás;333;171;162;2022
22;Huesca;048;Barbastro;17214;8442;8772;2022
22;Huesca;049;Barbués;90;55;35;2022
22;Huesca;050;Barbuñales;98;49;49;2022
22;Huesca;051;Bárcabo;108;59;49;2022
22;Huesca;052;Belver de Cinca;1330;770;560;2022
22;Huesca;053;Benabarre;1175;607;568;2022
22;Huesca;054;Benasque;2282;1230;1052;2022
22;Huesca;246;Beranuy;72;40;32;2022
22;Huesca;055;Berbegal;335;180;155;2022
22;Huesca;057;Bielsa;480;255;225;2022
22;Huesca;058;Bierge;251;141;110;2022
22;Huesca;059;Biescas;1584;835;749;2022
22;Huesca;060;Binaced;1621;883;738;2022
22;Huesca;061;Binéfar;9927;5278;4649;2022
22;Huesca;062;Bisaurri;173;91;82;2022
22;Huesca;063;Biscarrués;193;102;91;2022
22;Huesca;064;Blecua y Torres;188;101;87;2022
22;Huesca;066;Boltaña;1097;586;511;2022
22;Huesca;067;Bonansa;91;51;40;2022
22;Huesca;068;Borau;90;50;40;2022
22;Huesca;069;Broto;577;322;255;2022
22;Huesca;072;Caldearenas;241;141;100;2022
22;Huesca;074;Campo;460;245;215;2022
22;Huesca;075;Camporrélls;136;70;66;2022
22;Huesca;076;Canal de Berdún;346;189;157;2022
22;Huesca;077;Candasnos;396;217;179;2022
22;Huesca;078;Canfranc;612;347;265;2022
22;Huesca;079;Capdesaso;204;85;119;2022
22;Huesca;080;Capella;352;187;165;2022
22;Huesca;081;Casbas de Huesca;301;171;130;2022
22;Huesca;083;Castejón de Monegros;512;271;241;2022
22;Huesca;084;Castejón de Sos;805;405;400;2022
22;Huesca;082;Castejón del Puente;333;175;158;2022
22;Huesca;085;Castelflorite;100;49;51;2022
22;Huesca;086;Castiello de Jaca;249;139;110;2022
22;Huesca;087;Castigaleu;88;55;33;2022
22;Huesca;088;Castillazuelo;164;86;78;2022
22;Huesca;089;Castillonroy;328;170;158;2022
22;Huesca;094;Chalamera;117;63;54;2022
22;Huesca;095;Chía;87;54;33;2022
22;Huesca;096;Chimillas;402;206;196;2022
22;Huesca;090;Colungo;123;69;54;2022
22;Huesca;099;Esplús;656;342;314;2022
22;Huesca;102;Estada;206;117;89;2022
22;Huesca;103;Estadilla;812;415;397;2022
22;Huesca;105;Estopiñán del Castillo;117;62;55;2022
22;Huesca;106;Fago;25;15;10;2022
22;Huesca;107;Fanlo;106;67;39;2022
22;Huesca;109;Fiscal;361;198;163;2022
22;Huesca;110;Fonz;857;431;426;2022
22;Huesca;111;Foradada del Toscar;168;92;76;2022
22;Huesca;112;Fraga;15294;7819;7475;2022
22;Huesca;113;Fueva, La;609;328;281;2022
22;Huesca;114;Gistaín;129;74;55;2022
22;Huesca;115;Grado, El;405;208;197;2022
22;Huesca;116;Grañén;1727;899;828;2022
22;Huesca;117;Graus;3420;1698;1722;2022
22;Huesca;119;Gurrea de Gállego;1460;751;709;2022
22;Huesca;122;Hoz de Jaca;77;40;37;2022
22;Huesca;908;Hoz y Costean;240;134;106;2022
22;Huesca;124;Huerto;230;125;105;2022
22;Huesca;125;Huesca;53305;25507;27798;2022
22;Huesca;126;Ibieca;110;61;49;2022
22;Huesca;127;Igriés;703;370;333;2022
22;Huesca;128;Ilche;188;97;91;2022
22;Huesca;129;Isábena;239;123;116;2022
22;Huesca;130;Jaca;13437;6594;6843;2022
22;Huesca;131;Jasa;105;62;43;2022
22;Huesca;133;Labuerda;146;81;65;2022
22;Huesca;135;Laluenga;202;104;98;2022
22;Huesca;136;Lalueza;888;463;425;2022
22;Huesca;137;Lanaja;1189;631;558;2022
22;Huesca;139;Laperdiguera;95;51;44;2022
22;Huesca;141;Lascellas-Ponzano;135;84;51;2022
22;Huesca;142;Lascuarre;141;72;69;2022
22;Huesca;143;Laspaúles;228;127;101;2022
22;Huesca;144;Laspuña;286;155;131;2022
22;Huesca;149;Loarre;353;192;161;2022
22;Huesca;150;Loporzano;574;321;253;2022
22;Huesca;151;Loscorrales;98;47;51;2022
22;Huesca;905;Lupiñén-Ortilla;354;180;174;2022
22;Huesca;155;Monesma y Cajigar;66;36;30;2022
22;Huesca;156;Monflorite-Lascasas;442;240;202;2022
22;Huesca;157;Montanuy;224;130;94;2022
22;Huesca;158;Monzón;17650;8915;8735;2022
22;Huesca;160;Naval;263;142;121;2022
22;Huesca;162;Novales;155;78;77;2022
22;Huesca;163;Nueno;584;332;252;2022
22;Huesca;164;Olvena;67;33;34;2022
22;Huesca;165;Ontiñena;514;266;248;2022
22;Huesca;167;Osso de Cinca;650;366;284;2022
22;Huesca;168;Palo;30;16;14;2022
22;Huesca;170;Panticosa;887;466;421;2022
22;Huesca;172;Peñalba;757;446;311;2022
22;Huesca;173;Peñas de Riglos, Las;260;163;97;2022
22;Huesca;174;Peralta de Alcofea;596;304;292;2022
22;Huesca;175;Peralta de Calasanz;221;124;97;2022
22;Huesca;176;Peraltilla;223;107;116;2022
22;Huesca;177;Perarrúa;108;59;49;2022
22;Huesca;178;Pertusa;125;74;51;2022
22;Huesca;181;Piracés;95;48;47;2022
22;Huesca;182;Plan;283;150;133;2022
22;Huesca;184;Poleñino;193;101;92;2022
22;Huesca;186;Pozán de Vero;241;120;121;2022
22;Huesca;187;Puebla de Castro, La;415;221;194;2022
22;Huesca;188;Puente de Montañana;94;44;50;2022
22;Huesca;902;Puente la Reina de Jaca;261;140;121;2022
22;Huesca;189;Puértolas;216;115;101;2022
22;Huesca;190;Pueyo de Araguás, El;168;93;75;2022
22;Huesca;193;Pueyo de Santa Cruz;318;154;164;2022
22;Huesca;195;Quicena;295;142;153;2022
22;Huesca;197;Robres;537;280;257;2022
22;Huesca;199;Sabiñánigo;9371;4699;4672;2022
22;Huesca;200;Sahún;308;150;158;2022
22;Huesca;201;Salas Altas;316;164;152;2022
22;Huesca;202;Salas Bajas;190;94;96;2022
22;Huesca;203;Salillas;102;58;44;2022
22;Huesca;204;Sallent de Gállego;1557;781;776;2022
22;Huesca;205;San Esteban de Litera;586;305;281;2022
22;Huesca;207;San Juan de Plan;158;86;72;2022
22;Huesca;903;San Miguel del Cinca;801;411;390;2022
22;Huesca;206;Sangarrén;219;117;102;2022
22;Huesca;208;Santa Cilia;254;129;125;2022
22;Huesca;209;Santa Cruz de la Serós;194;109;85;2022
22;Huesca;906;Santa María de Dulcis;201;108;93;2022
22;Huesca;212;Santaliestra y San Quílez;79;47;32;2022
22;Huesca;213;Sariñena;4164;2169;1995;2022
22;Huesca;214;Secastilla;151;70;81;2022
22;Huesca;215;Seira;159;88;71;2022
22;Huesca;217;Sena;496;262;234;2022
22;Huesca;218;Senés de Alcubierre;46;22;24;2022
22;Huesca;220;Sesa;160;91;69;2022
22;Huesca;221;Sesué;128;66;62;2022
22;Huesca;222;Siétamo;697;393;304;2022
22;Huesca;223;Sopeira;93;51;42;2022
22;Huesca;904;Sotonera, La;919;488;431;2022
22;Huesca;225;Tamarite de Litera;3445;1775;1670;2022
22;Huesca;226;Tardienta;937;464;473;2022
22;Huesca;227;Tella-Sin;228;129;99;2022
22;Huesca;228;Tierz;822;406;416;2022
22;Huesca;229;Tolva;132;71;61;2022
22;Huesca;230;Torla-Ordesa;307;163;144;2022
22;Huesca;232;Torralba de Aragón;105;61;44;2022
22;Huesca;233;Torre la Ribera;101;53;48;2022
22;Huesca;234;Torrente de Cinca;1151;617;534;2022
22;Huesca;235;Torres de Alcanadre;85;49;36;2022
22;Huesca;236;Torres de Barbués;256;122;134;2022
22;Huesca;239;Tramaced;110;68;42;2022
22;Huesca;242;Valfarta;58;37;21;2022
22;Huesca;243;Valle de Bardají;58;37;21;2022
22;Huesca;901;Valle de Hecho;810;436;374;2022
22;Huesca;244;Valle de Lierp;53;33;20;2022
22;Huesca;245;Velilla de Cinca;476;249;227;2022
22;Huesca;909;Vencillón;415;222;193;2022
22;Huesca;247;Viacamp y Litera;39;25;14;2022
22;Huesca;248;Vicién;128;73;55;2022
22;Huesca;249;Villanova;170;89;81;2022
22;Huesca;250;Villanúa;560;300;260;2022
22;Huesca;251;Villanueva de Sigena;370;200;170;2022
22;Huesca;252;Yebra de Basa;154;93;61;2022
22;Huesca;253;Yésero;58;32;26;2022
22;Huesca;254;Zaidín;1872;974;898;2022
23;Jaén;001;Albanchez de Mágina;993;516;477;2022
23;Jaén;002;Alcalá la Real;21556;10645;10911;2022
23;Jaén;003;Alcaudete;10347;5090;5257;2022
23;Jaén;004;Aldeaquemada;463;248;215;2022
23;Jaén;005;Andújar;36030;17618;18412;2022
23;Jaén;006;Arjona;5397;2662;2735;2022
23;Jaén;007;Arjonilla;3535;1792;1743;2022
23;Jaén;008;Arquillos;1698;855;843;2022
23;Jaén;905;Arroyo del Ojanco;2227;1129;1098;2022
23;Jaén;009;Baeza;15773;7815;7958;2022
23;Jaén;010;Bailén;17377;8609;8768;2022
23;Jaén;011;Baños de la Encina;2594;1340;1254;2022
23;Jaén;012;Beas de Segura;5112;2657;2455;2022
23;Jaén;902;Bedmar y Garcíez;2637;1343;1294;2022
23;Jaén;014;Begíjar;3008;1507;1501;2022
23;Jaén;015;Bélmez de la Moraleda;1519;738;781;2022
23;Jaén;016;Benatae;448;228;220;2022
23;Jaén;017;Cabra del Santo Cristo;1745;915;830;2022
23;Jaén;018;Cambil;2642;1389;1253;2022
23;Jaén;019;Campillo de Arenas;1705;856;849;2022
23;Jaén;020;Canena;1802;938;864;2022
23;Jaén;021;Carboneros;593;308;285;2022
23;Jaén;901;Cárcheles;1310;684;626;2022
23;Jaén;024;Carolina, La;14960;7402;7558;2022
23;Jaén;025;Castellar;3209;1616;1593;2022
23;Jaén;026;Castillo de Locubín;3960;1966;1994;2022
23;Jaén;027;Cazalilla;745;376;369;2022
23;Jaén;028;Cazorla;7183;3473;3710;2022
23;Jaén;029;Chiclana de Segura;902;462;440;2022
23;Jaén;030;Chilluévar;1397;688;709;2022
23;Jaén;031;Escañuela;932;459;473;2022
23;Jaén;032;Espeluy;606;300;306;2022
23;Jaén;033;Frailes;1565;786;779;2022
23;Jaén;034;Fuensanta de Martos;3023;1529;1494;2022
23;Jaén;035;Fuerte del Rey;1309;682;627;2022
23;Jaén;037;Génave;573;305;268;2022
23;Jaén;038;Guardia de Jaén, La;5151;2633;2518;2022
23;Jaén;039;Guarromán;2748;1377;1371;2022
23;Jaén;041;Higuera de Calatrava;609;322;287;2022
23;Jaén;042;Hinojares;335;175;160;2022
23;Jaén;043;Hornos;589;291;298;2022
23;Jaén;044;Huelma;5615;2779;2836;2022
23;Jaén;045;Huesa;2445;1238;1207;2022
23;Jaén;046;Ibros;2787;1397;1390;2022
23;Jaén;047;Iruela, La;1910;967;943;2022
23;Jaén;048;Iznatoraf;905;454;451;2022
23;Jaén;049;Jabalquinto;1968;984;984;2022
23;Jaén;050;Jaén;111669;53690;57979;2022
23;Jaén;051;Jamilena;3314;1655;1659;2022
23;Jaén;052;Jimena;1253;611;642;2022
23;Jaén;053;Jódar;11533;5744;5789;2022
23;Jaén;040;Lahiguera;1638;810;828;2022
23;Jaén;054;Larva;459;237;222;2022
23;Jaén;055;Linares;55729;27232;28497;2022
23;Jaén;056;Lopera;3616;1847;1769;2022
23;Jaén;057;Lupión;830;405;425;2022
23;Jaén;058;Mancha Real;11350;5659;5691;2022
23;Jaén;059;Marmolejo;6660;3315;3345;2022
23;Jaén;060;Martos;24329;12064;12265;2022
23;Jaén;061;Mengíbar;9965;4958;5007;2022
23;Jaén;062;Montizón;1606;820;786;2022
23;Jaén;063;Navas de San Juan;4465;2248;2217;2022
23;Jaén;064;Noalejo;1856;936;920;2022
23;Jaén;065;Orcera;1752;885;867;2022
23;Jaén;066;Peal de Becerro;5345;2677;2668;2022
23;Jaén;067;Pegalajar;2823;1426;1397;2022
23;Jaén;069;Porcuna;6080;3064;3016;2022
23;Jaén;070;Pozo Alcón;4633;2384;2249;2022
23;Jaén;071;Puente de Génave;2175;1112;1063;2022
23;Jaén;072;Puerta de Segura, La;2245;1128;1117;2022
23;Jaén;073;Quesada;5106;2595;2511;2022
23;Jaén;074;Rus;3465;1758;1707;2022
23;Jaén;075;Sabiote;3863;1905;1958;2022
23;Jaén;076;Santa Elena;883;458;425;2022
23;Jaén;077;Santiago de Calatrava;655;345;310;2022
23;Jaén;904;Santiago-Pontones;2777;1436;1341;2022
23;Jaén;079;Santisteban del Puerto;4434;2289;2145;2022
23;Jaén;080;Santo Tomé;2105;1072;1033;2022
23;Jaén;081;Segura de la Sierra;1729;861;868;2022
23;Jaén;082;Siles;2168;1109;1059;2022
23;Jaén;084;Sorihuela del Guadalimar;1053;547;506;2022
23;Jaén;085;Torreblascopedro;2460;1249;1211;2022
23;Jaén;086;Torredelcampo;13922;6977;6945;2022
23;Jaén;087;Torredonjimeno;13467;6642;6825;2022
23;Jaén;088;Torreperogil;7130;3508;3622;2022
23;Jaén;090;Torres;1360;703;657;2022
23;Jaén;091;Torres de Albánchez;758;399;359;2022
23;Jaén;092;Úbeda;34062;16656;17406;2022
23;Jaén;093;Valdepeñas de Jaén;3597;1787;1810;2022
23;Jaén;094;Vilches;4317;2168;2149;2022
23;Jaén;095;Villacarrillo;10484;5286;5198;2022
23;Jaén;096;Villanueva de la Reina;3013;1518;1495;2022
23;Jaén;097;Villanueva del Arzobispo;7968;4082;3886;2022
23;Jaén;098;Villardompardo;935;466;469;2022
23;Jaén;099;Villares, Los;6120;3074;3046;2022
23;Jaén;101;Villarrodrigo;375;201;174;2022
23;Jaén;903;Villatorres;4293;2194;2099;2022
24;León;001;Acebedo;185;103;82;2022
24;León;002;Algadefe;285;147;138;2022
24;León;003;Alija del Infantado;569;302;267;2022
24;León;004;Almanza;603;344;259;2022
24;León;005;Antigua, La;333;191;142;2022
24;León;006;Ardón;569;312;257;2022
24;León;007;Arganza;778;386;392;2022
24;León;008;Astorga;10392;4874;5518;2022
24;León;009;Balboa;271;149;122;2022
24;León;010;Bañeza, La;10024;4801;5223;2022
24;León;011;Barjas;157;88;69;2022
24;León;012;Barrios de Luna, Los;299;171;128;2022
24;León;014;Bembibre;8279;3982;4297;2022
24;León;015;Benavides;2390;1182;1208;2022
24;León;016;Benuza;464;279;185;2022
24;León;017;Bercianos del Páramo;528;273;255;2022
24;León;018;Bercianos del Real Camino;187;101;86;2022
24;León;019;Berlanga del Bierzo;350;157;193;2022
24;León;020;Boca de Huérgano;438;255;183;2022
24;León;021;Boñar;1823;927;896;2022
24;León;022;Borrenes;306;166;140;2022
24;León;023;Brazuelo;340;201;139;2022
24;León;024;Burgo Ranero, El;697;370;327;2022
24;León;025;Burón;290;171;119;2022
24;León;026;Bustillo del Páramo;1094;564;530;2022
24;León;027;Cabañas Raras;1339;696;643;2022
24;León;028;Cabreros del Río;403;218;185;2022
24;León;029;Cabrillanes;713;378;335;2022
24;León;030;Cacabelos;4874;2400;2474;2022
24;León;031;Calzada del Coto;224;131;93;2022
24;León;032;Campazas;106;51;55;2022
24;León;033;Campo de Villavidel;201;112;89;2022
24;León;034;Camponaraya;4109;2032;2077;2022
24;León;036;Candín;248;138;110;2022
24;León;037;Cármenes;329;188;141;2022
24;León;038;Carracedelo;3434;1726;1708;2022
24;León;039;Carrizo;2234;1123;1111;2022
24;León;040;Carrocera;458;237;221;2022
24;León;041;Carucedo;501;252;249;2022
24;León;042;Castilfalé;63;37;26;2022
24;León;043;Castrillo de Cabrera;106;64;42;2022
24;León;044;Castrillo de la Valduerna;144;70;74;2022
24;León;046;Castrocalbón;931;479;452;2022
24;León;047;Castrocontrigo;701;385;316;2022
24;León;049;Castropodame;1577;820;757;2022
24;León;050;Castrotierra de Valmadrigal;109;55;54;2022
24;León;051;Cea;389;207;182;2022
24;León;052;Cebanico;142;84;58;2022
24;León;053;Cebrones del Río;437;245;192;2022
24;León;065;Chozas de Abajo;2625;1353;1272;2022
24;León;054;Cimanes de la Vega;453;237;216;2022
24;León;055;Cimanes del Tejar;744;406;338;2022
24;León;056;Cistierna;2986;1463;1523;2022
24;León;057;Congosto;1447;718;729;2022
24;León;058;Corbillos de los Oteros;187;104;83;2022
24;León;059;Corullón;858;430;428;2022
24;León;060;Crémenes;522;285;237;2022
24;León;061;Cuadros;2049;1034;1015;2022
24;León;062;Cubillas de los Oteros;137;75;62;2022
24;León;063;Cubillas de Rueda;388;211;177;2022
24;León;064;Cubillos del Sil;1789;931;858;2022
24;León;066;Destriana;438;209;229;2022
24;León;067;Encinedo;603;323;280;2022
24;León;068;Ercina, La;440;242;198;2022
24;León;069;Escobar de Campos;31;19;12;2022
24;León;070;Fabero;4239;2075;2164;2022
24;León;071;Folgoso de la Ribera;1026;498;528;2022
24;León;073;Fresno de la Vega;472;239;233;2022
24;León;074;Fuentes de Carbajal;79;50;29;2022
24;León;076;Garrafe de Torío;1580;852;728;2022
24;León;077;Gordaliza del Pino;244;115;129;2022
24;León;078;Gordoncillo;330;159;171;2022
24;León;079;Gradefes;941;520;421;2022
24;León;080;Grajal de Campos;214;107;107;2022
24;León;081;Gusendos de los Oteros;126;64;62;2022
24;León;082;Hospital de Órbigo;981;489;492;2022
24;León;083;Igüeña;1108;577;531;2022
24;León;084;Izagre;146;73;73;2022
24;León;086;Joarilla de las Matas;259;137;122;2022
24;León;087;Laguna Dalga;633;344;289;2022
24;León;088;Laguna de Negrillos;1043;525;518;2022
24;León;089;León;120951;54652;66299;2022
24;León;092;Llamas de la Ribera;810;427;383;2022
24;León;090;Lucillo;376;198;178;2022
24;León;091;Luyego;562;310;252;2022
24;León;093;Magaz de Cepeda;357;192;165;2022
24;León;094;Mansilla de las Mulas;1679;840;839;2022
24;León;095;Mansilla Mayor;327;176;151;2022
24;León;096;Maraña;112;69;43;2022
24;León;097;Matadeón de los Oteros;230;121;109;2022
24;León;098;Matallana de Torío;1269;653;616;2022
24;León;099;Matanza;175;95;80;2022
24;León;100;Molinaseca;851;462;389;2022
24;León;101;Murias de Paredes;346;181;165;2022
24;León;102;Noceda del Bierzo;612;314;298;2022
24;León;103;Oencia;267;152;115;2022
24;León;104;Omañas, Las;248;132;116;2022
24;León;105;Onzonilla;1845;947;898;2022
24;León;106;Oseja de Sajambre;236;143;93;2022
24;León;107;Pajares de los Oteros;235;142;93;2022
24;León;108;Palacios de la Valduerna;366;182;184;2022
24;León;109;Palacios del Sil;886;484;402;2022
24;León;110;Páramo del Sil;1217;629;588;2022
24;León;112;Peranzanes;264;153;111;2022
24;León;113;Pobladura de Pelayo García;372;191;181;2022
24;León;114;Pola de Gordón, La;2929;1473;1456;2022
24;León;115;Ponferrada;63052;29806;33246;2022
24;León;116;Posada de Valdeón;420;240;180;2022
24;León;117;Pozuelo del Páramo;408;201;207;2022
24;León;118;Prado de la Guzpeña;103;60;43;2022
24;León;119;Priaranza del Bierzo;742;368;374;2022
24;León;120;Prioro;335;197;138;2022
24;León;121;Puebla de Lillo;666;380;286;2022
24;León;122;Puente de Domingo Flórez;1421;741;680;2022
24;León;123;Quintana del Castillo;709;393;316;2022
24;León;124;Quintana del Marco;353;194;159;2022
24;León;125;Quintana y Congosto;398;212;186;2022
24;León;127;Regueras de Arriba;264;139;125;2022
24;León;129;Reyero;125;65;60;2022
24;León;130;Riaño;475;258;217;2022
24;León;131;Riego de la Vega;731;392;339;2022
24;León;132;Riello;614;351;263;2022
24;León;133;Rioseco de Tapia;386;216;170;2022
24;León;134;Robla, La;3654;1803;1851;2022
24;León;136;Roperuelos del Páramo;511;261;250;2022
24;León;137;Sabero;1088;556;532;2022
24;León;139;Sahagún;2434;1194;1240;2022
24;León;141;San Adrián del Valle;100;57;43;2022
24;León;142;San Andrés del Rabanedo;29888;14221;15667;2022
24;León;144;San Cristóbal de la Polantera;653;339;314;2022
24;León;145;San Emiliano;626;353;273;2022
24;León;146;San Esteban de Nogales;251;132;119;2022
24;León;148;San Justo de la Vega;1765;914;851;2022
24;León;149;San Millán de los Caballeros;176;95;81;2022
24;León;150;San Pedro Bercianos;231;124;107;2022
24;León;143;Sancedo;536;270;266;2022
24;León;151;Santa Colomba de Curueño;495;253;242;2022
24;León;152;Santa Colomba de Somoza;529;290;239;2022
24;León;153;Santa Cristina de Valmadrigal;273;140;133;2022
24;León;154;Santa Elena de Jamuz;1046;546;500;2022
24;León;155;Santa María de la Isla;462;240;222;2022
24;León;158;Santa María de Ordás;333;183;150;2022
24;León;156;Santa María del Monte de Cea;215;120;95;2022
24;León;157;Santa María del Páramo;3065;1502;1563;2022
24;León;159;Santa Marina del Rey;1801;904;897;2022
24;León;160;Santas Martas;753;399;354;2022
24;León;161;Santiago Millas;352;196;156;2022
24;León;162;Santovenia de la Valdoncina;2084;1057;1027;2022
24;León;163;Sariegos;5306;2649;2657;2022
24;León;164;Sena de Luna;375;180;195;2022
24;León;165;Sobrado;294;150;144;2022
24;León;166;Soto de la Vega;1490;777;713;2022
24;León;167;Soto y Amío;753;381;372;2022
24;León;168;Toral de los Guzmanes;513;287;226;2022
24;León;206;Toral de los Vados;1792;883;909;2022
24;León;169;Toreno;2980;1494;1486;2022
24;León;170;Torre del Bierzo;2068;1051;1017;2022
24;León;171;Trabadelo;338;191;147;2022
24;León;172;Truchas;418;225;193;2022
24;León;173;Turcia;993;507;486;2022
24;León;174;Urdiales del Páramo;466;252;214;2022
24;León;185;Val de San Lorenzo;493;238;255;2022
24;León;175;Valdefresno;2280;1187;1093;2022
24;León;176;Valdefuentes del Páramo;315;170;145;2022
24;León;177;Valdelugueros;501;282;219;2022
24;León;178;Valdemora;64;28;36;2022
24;León;179;Valdepiélago;293;173;120;2022
24;León;180;Valdepolo;1190;647;543;2022
24;León;181;Valderas;1566;800;766;2022
24;León;182;Valderrey;422;217;205;2022
24;León;183;Valderrueda;820;443;377;2022
24;León;184;Valdesamario;186;109;77;2022
24;León;187;Valdevimbre;928;474;454;2022
24;León;188;Valencia de Don Juan;5176;2547;2629;2022
24;León;191;Vallecillo;114;68;46;2022
24;León;189;Valverde de la Virgen;7559;3913;3646;2022
24;León;190;Valverde-Enrique;152;76;76;2022
24;León;193;Vecilla, La;411;224;187;2022
24;León;196;Vega de Espinareda;2018;1029;989;2022
24;León;197;Vega de Infanzones;835;423;412;2022
24;León;198;Vega de Valcarce;579;293;286;2022
24;León;194;Vegacervera;266;137;129;2022
24;León;199;Vegaquemada;428;244;184;2022
24;León;201;Vegas del Condado;1154;660;494;2022
24;León;202;Villablino;8086;3911;4175;2022
24;León;203;Villabraz;99;56;43;2022
24;León;205;Villadangos del Páramo;1221;653;568;2022
24;León;207;Villademor de la Vega;290;150;140;2022
24;León;209;Villafranca del Bierzo;2756;1328;1428;2022
24;León;210;Villagatón;650;359;291;2022
24;León;211;Villamandos;288;156;132;2022
24;León;901;Villamanín;905;464;441;2022
24;León;212;Villamañán;1076;552;524;2022
24;León;213;Villamartín de Don Sancho;156;84;72;2022
24;León;214;Villamejil;677;366;311;2022
24;León;215;Villamol;144;74;70;2022
24;León;216;Villamontán de la Valduerna;701;359;342;2022
24;León;217;Villamoratiel de las Matas;131;73;58;2022
24;León;218;Villanueva de las Manzanas;499;259;240;2022
24;León;219;Villaobispo de Otero;537;299;238;2022
24;León;902;Villaornate y Castro;333;169;164;2022
24;León;221;Villaquejida;808;411;397;2022
24;León;222;Villaquilambre;18589;9213;9376;2022
24;León;223;Villarejo de Órbigo;2930;1429;1501;2022
24;León;224;Villares de Órbigo;575;308;267;2022
24;León;225;Villasabariego;1127;580;547;2022
24;León;226;Villaselán;185;106;79;2022
24;León;227;Villaturiel;1878;991;887;2022
24;León;228;Villazala;619;331;288;2022
24;León;229;Villazanzo de Valderaduey;385;224;161;2022
24;León;230;Zotes del Páramo;412;233;179;2022
25;Lleida;001;Abella de la Conca;167;85;82;2022
25;Lleida;002;Àger;580;318;262;2022
25;Lleida;003;Agramunt;5479;2766;2713;2022
25;Lleida;038;Aitona;2521;1320;1201;2022
25;Lleida;004;Alamús, Els;781;389;392;2022
25;Lleida;005;Alàs i Cerc;329;161;168;2022
25;Lleida;006;Albagés, L';348;185;163;2022
25;Lleida;007;Albatàrrec;2217;1141;1076;2022
25;Lleida;008;Albesa;1579;859;720;2022
25;Lleida;009;Albi, L';755;387;368;2022
25;Lleida;010;Alcanó;240;123;117;2022
25;Lleida;011;Alcarràs;9637;5030;4607;2022
25;Lleida;012;Alcoletge;3470;1828;1642;2022
25;Lleida;013;Alfarràs;2795;1456;1339;2022
25;Lleida;014;Alfés;300;163;137;2022
25;Lleida;015;Algerri;422;233;189;2022
25;Lleida;016;Alguaire;3040;1613;1427;2022
25;Lleida;017;Alins;285;148;137;2022
25;Lleida;019;Almacelles;6922;3701;3221;2022
25;Lleida;020;Almatret;302;172;130;2022
25;Lleida;021;Almenar;3401;1810;1591;2022
25;Lleida;022;Alòs de Balaguer;121;69;52;2022
25;Lleida;023;Alpicat;6333;3173;3160;2022
25;Lleida;024;Alt Àneu;441;250;191;2022
25;Lleida;027;Anglesola;1350;676;674;2022
25;Lleida;029;Arbeca;2100;1089;1011;2022
25;Lleida;031;Arres;61;41;20;2022
25;Lleida;032;Arsèguel;80;46;34;2022
25;Lleida;033;Artesa de Lleida;1505;802;703;2022
25;Lleida;034;Artesa de Segre;3470;1792;1678;2022
25;Lleida;036;Aspa;221;113;108;2022
25;Lleida;037;Avellanes i Santa Linya, Les;459;254;205;2022
25;Lleida;039;Baix Pallars;345;183;162;2022
25;Lleida;040;Balaguer;17460;8936;8524;2022
25;Lleida;041;Barbens;979;542;437;2022
25;Lleida;042;Baronia de Rialb, La;229;120;109;2022
25;Lleida;044;Bassella;223;117;106;2022
25;Lleida;045;Bausen;66;33;33;2022
25;Lleida;046;Belianes;508;251;257;2022
25;Lleida;170;Bellaguarda;288;152;136;2022
25;Lleida;047;Bellcaire d'Urgell;1229;630;599;2022
25;Lleida;048;Bell-lloc d'Urgell;2342;1173;1169;2022
25;Lleida;049;Bellmunt d'Urgell;178;90;88;2022
25;Lleida;050;Bellpuig;5168;2756;2412;2022
25;Lleida;051;Bellver de Cerdanya;2176;1129;1047;2022
25;Lleida;052;Bellvís;2243;1141;1102;2022
25;Lleida;053;Benavent de Segrià;1563;822;741;2022
25;Lleida;055;Biosca;182;99;83;2022
25;Lleida;057;Bòrdes, Es;282;154;128;2022
25;Lleida;058;Borges Blanques, Les;6248;3188;3060;2022
25;Lleida;059;Bossòst;1121;544;577;2022
25;Lleida;056;Bovera;263;146;117;2022
25;Lleida;060;Cabanabona;62;27;35;2022
25;Lleida;061;Cabó;98;49;49;2022
25;Lleida;062;Camarasa;786;400;386;2022
25;Lleida;063;Canejan;92;46;46;2022
25;Lleida;904;Castell de Mur;171;96;75;2022
25;Lleida;064;Castellar de la Ribera;135;68;67;2022
25;Lleida;067;Castelldans;895;474;421;2022
25;Lleida;068;Castellnou de Seana;715;375;340;2022
25;Lleida;069;Castelló de Farfanya;508;268;240;2022
25;Lleida;070;Castellserà;961;491;470;2022
25;Lleida;071;Cava;51;34;17;2022
25;Lleida;072;Cervera;9393;4794;4599;2022
25;Lleida;073;Cervià de les Garrigues;642;345;297;2022
25;Lleida;074;Ciutadilla;190;99;91;2022
25;Lleida;075;Clariana de Cardener;162;86;76;2022
25;Lleida;076;Cogul, El;151;83;68;2022
25;Lleida;077;Coll de Nargó;548;278;270;2022
25;Lleida;163;Coma i la Pedra, La;278;161;117;2022
25;Lleida;161;Conca de Dalt;427;221;206;2022
25;Lleida;078;Corbins;1462;803;659;2022
25;Lleida;079;Cubells;356;188;168;2022
25;Lleida;081;Espluga Calba, L';331;169;162;2022
25;Lleida;082;Espot;377;204;173;2022
25;Lleida;088;Estamariu;128;74;54;2022
25;Lleida;085;Estaràs;169;86;83;2022
25;Lleida;086;Esterri d'Àneu;841;417;424;2022
25;Lleida;087;Esterri de Cardós;62;30;32;2022
25;Lleida;089;Farrera;121;67;54;2022
25;Lleida;908;Fígols i Alinyà;266;148;118;2022
25;Lleida;092;Floresta, La;154;88;66;2022
25;Lleida;093;Fondarella;778;387;391;2022
25;Lleida;094;Foradada;191;110;81;2022
25;Lleida;096;Fuliola, La;1238;630;608;2022
25;Lleida;097;Fulleda;98;48;50;2022
25;Lleida;098;Gavet de la Conca;261;132;129;2022
25;Lleida;912;Gimenells i el Pla de la Font;1109;594;515;2022
25;Lleida;099;Golmés;1893;958;935;2022
25;Lleida;100;Gósol;233;129;104;2022
25;Lleida;101;Granadella, La;724;397;327;2022
25;Lleida;102;Granja d'Escarp, La;923;520;403;2022
25;Lleida;103;Granyanella;136;79;57;2022
25;Lleida;105;Granyena de les Garrigues;147;88;59;2022
25;Lleida;104;Granyena de Segarra;157;82;75;2022
25;Lleida;109;Guimerà;261;139;122;2022
25;Lleida;903;Guingueta d'Àneu, La;298;163;135;2022
25;Lleida;110;Guissona;7390;3966;3424;2022
25;Lleida;111;Guixers;132;81;51;2022
25;Lleida;115;Isona i Conca Dellà;1057;578;479;2022
25;Lleida;112;Ivars de Noguera;327;176;151;2022
25;Lleida;113;Ivars d'Urgell;1560;834;726;2022
25;Lleida;114;Ivorra;100;55;45;2022
25;Lleida;910;Josa i Tuixén;105;63;42;2022
25;Lleida;118;Juncosa;401;208;193;2022
25;Lleida;119;Juneda;3558;1902;1656;2022
25;Lleida;121;Les;970;488;482;2022
25;Lleida;122;Linyola;2723;1377;1346;2022
25;Lleida;123;Lladorre;254;133;121;2022
25;Lleida;124;Lladurs;190;104;86;2022
25;Lleida;125;Llardecans;421;225;196;2022
25;Lleida;126;Llavorsí;343;171;172;2022
25;Lleida;120;Lleida;140797;69874;70923;2022
25;Lleida;127;Lles de Cerdanya;286;166;120;2022
25;Lleida;128;Llimiana;146;83;63;2022
25;Lleida;129;Llobera;202;115;87;2022
25;Lleida;133;Maials;911;506;405;2022
25;Lleida;130;Maldà;234;117;117;2022
25;Lleida;131;Massalcoreig;589;332;257;2022
25;Lleida;132;Massoteres;220;122;98;2022
25;Lleida;134;Menàrguens;774;414;360;2022
25;Lleida;135;Miralcamp;1364;703;661;2022
25;Lleida;137;Mollerussa;14730;7592;7138;2022
25;Lleida;136;Molsosa, La;99;49;50;2022
25;Lleida;139;Montellà i Martinet;615;329;286;2022
25;Lleida;140;Montferrer i Castellbò;1083;587;496;2022
25;Lleida;138;Montgai;647;339;308;2022
25;Lleida;142;Montoliu de Lleida;494;257;237;2022
25;Lleida;141;Montoliu de Segarra;180;99;81;2022
25;Lleida;143;Montornès de Segarra;92;43;49;2022
25;Lleida;145;Nalec;95;53;42;2022
25;Lleida;025;Naut Aran;1923;1011;912;2022
25;Lleida;146;Navès;305;155;150;2022
25;Lleida;148;Odèn;252;148;104;2022
25;Lleida;149;Oliana;1849;929;920;2022
25;Lleida;150;Oliola;196;105;91;2022
25;Lleida;151;Olius;985;518;467;2022
25;Lleida;152;Oluges, Les;166;90;76;2022
25;Lleida;153;Omellons, Els;198;104;94;2022
25;Lleida;154;Omells de na Gaia, Els;127;69;58;2022
25;Lleida;155;Organyà;796;403;393;2022
25;Lleida;156;Os de Balaguer;1046;531;515;2022
25;Lleida;157;Ossó de Sió;193;94;99;2022
25;Lleida;158;Palau d'Anglesola, El;2191;1088;1103;2022
25;Lleida;164;Penelles;430;249;181;2022
25;Lleida;165;Peramola;348;174;174;2022
25;Lleida;166;Pinell de Solsonès;190;107;83;2022
25;Lleida;167;Pinós;291;159;132;2022
25;Lleida;911;Plans de Sió, Els;490;272;218;2022
25;Lleida;168;Poal, El;667;343;324;2022
25;Lleida;169;Pobla de Cérvoles, La;209;114;95;2022
25;Lleida;171;Pobla de Segur, La;3055;1529;1526;2022
25;Lleida;030;Pont de Bar, El;163;98;65;2022
25;Lleida;173;Pont de Suert, El;2336;1183;1153;2022
25;Lleida;172;Ponts;2661;1358;1303;2022
25;Lleida;174;Portella, La;718;411;307;2022
25;Lleida;175;Prats i Sansor;260;138;122;2022
25;Lleida;176;Preixana;404;213;191;2022
25;Lleida;177;Preixens;422;213;209;2022
25;Lleida;179;Prullans;264;124;140;2022
25;Lleida;180;Puiggròs;257;133;124;2022
25;Lleida;181;Puigverd d'Agramunt;253;147;106;2022
25;Lleida;182;Puigverd de Lleida;1398;718;680;2022
25;Lleida;183;Rialp;675;334;341;2022
25;Lleida;905;Ribera d'Ondara;441;228;213;2022
25;Lleida;185;Ribera d'Urgellet;920;471;449;2022
25;Lleida;186;Riner;280;138;142;2022
25;Lleida;913;Riu de Cerdanya;100;59;41;2022
25;Lleida;189;Rosselló;3278;1687;1591;2022
25;Lleida;190;Salàs de Pallars;345;184;161;2022
25;Lleida;191;Sanaüja;392;202;190;2022
25;Lleida;196;Sant Esteve de la Sarga;123;75;48;2022
25;Lleida;192;Sant Guim de Freixenet;1120;584;536;2022
25;Lleida;197;Sant Guim de la Plana;182;98;84;2022
25;Lleida;193;Sant Llorenç de Morunys;1000;491;509;2022
25;Lleida;902;Sant Martí de Riucorb;646;340;306;2022
25;Lleida;194;Sant Ramon;480;258;222;2022
25;Lleida;201;Sarroca de Bellera;113;64;49;2022
25;Lleida;200;Sarroca de Lleida;365;200;165;2022
25;Lleida;202;Senterada;161;93;68;2022
25;Lleida;035;Sentiu de Sió, La;417;216;201;2022
25;Lleida;204;Seròs;1890;1016;874;2022
25;Lleida;203;Seu d'Urgell, La;12261;5958;6303;2022
25;Lleida;205;Sidamon;759;407;352;2022
25;Lleida;206;Soleràs, El;330;182;148;2022
25;Lleida;207;Solsona;9131;4531;4600;2022
25;Lleida;208;Soriguera;429;229;200;2022
25;Lleida;209;Sort;2192;1094;1098;2022
25;Lleida;210;Soses;1784;953;831;2022
25;Lleida;211;Sudanell;873;484;389;2022
25;Lleida;212;Sunyer;332;182;150;2022
25;Lleida;215;Talarn;562;349;213;2022
25;Lleida;216;Talavera;291;160;131;2022
25;Lleida;217;Tàrrega;17810;8848;8962;2022
25;Lleida;218;Tarrés;105;50;55;2022
25;Lleida;219;Tarroja de Segarra;175;95;80;2022
25;Lleida;220;Térmens;1363;702;661;2022
25;Lleida;221;Tírvia;132;62;70;2022
25;Lleida;222;Tiurana;71;31;40;2022
25;Lleida;223;Torà;1224;613;611;2022
25;Lleida;224;Torms, Els;149;77;72;2022
25;Lleida;225;Tornabous;847;456;391;2022
25;Lleida;227;Torre de Cabdella, La;764;389;375;2022
25;Lleida;226;Torrebesses;300;168;132;2022
25;Lleida;228;Torrefarrera;4730;2393;2337;2022
25;Lleida;907;Torrefeta i Florejacs;621;340;281;2022
25;Lleida;230;Torregrossa;2155;1121;1034;2022
25;Lleida;231;Torrelameu;765;460;305;2022
25;Lleida;232;Torres de Segre;2248;1171;1077;2022
25;Lleida;233;Torre-serona;387;204;183;2022
25;Lleida;234;Tremp;5847;2878;2969;2022
25;Lleida;043;Vall de Boí, La;1090;581;509;2022
25;Lleida;901;Vall de Cardós;386;212;174;2022
25;Lleida;238;Vallbona de les Monges;227;118;109;2022
25;Lleida;240;Vallfogona de Balaguer;1935;968;967;2022
25;Lleida;906;Valls d'Aguilar, Les;274;153;121;2022
25;Lleida;239;Valls de Valira, Les;794;411;383;2022
25;Lleida;909;Vansa i Fórnols, La;166;85;81;2022
25;Lleida;242;Verdú;851;395;456;2022
25;Lleida;243;Vielha e Mijaran;5581;2852;2729;2022
25;Lleida;244;Vilagrassa;605;324;281;2022
25;Lleida;245;Vilaller;532;286;246;2022
25;Lleida;247;Vilamòs;172;99;73;2022
25;Lleida;248;Vilanova de Bellpuig;1179;596;583;2022
25;Lleida;254;Vilanova de la Barca;1110;611;499;2022
25;Lleida;249;Vilanova de l'Aguda;200;99;101;2022
25;Lleida;250;Vilanova de Meià;413;249;164;2022
25;Lleida;251;Vilanova de Segrià;1021;547;474;2022
25;Lleida;252;Vila-sana;767;380;387;2022
25;Lleida;253;Vilosell, El;195;103;92;2022
25;Lleida;255;Vinaixa;465;244;221;2022
27;Lugo;001;Abadín;2259;1112;1147;2022
27;Lugo;002;Alfoz;1585;765;820;2022
27;Lugo;003;Antas de Ulla;1918;953;965;2022
27;Lugo;004;Baleira;1158;625;533;2022
27;Lugo;901;Baralla;2436;1274;1162;2022
27;Lugo;005;Barreiros;3020;1461;1559;2022
27;Lugo;006;Becerreá;2755;1373;1382;2022
27;Lugo;007;Begonte;2951;1482;1469;2022
27;Lugo;008;Bóveda;1414;708;706;2022
27;Lugo;902;Burela;9430;4742;4688;2022
27;Lugo;009;Carballedo;2065;1041;1024;2022
27;Lugo;010;Castro de Rei;5033;2495;2538;2022
27;Lugo;011;Castroverde;2592;1332;1260;2022
27;Lugo;012;Cervantes;1250;725;525;2022
27;Lugo;013;Cervo;4192;2060;2132;2022
27;Lugo;016;Chantada;8083;3902;4181;2022
27;Lugo;014;Corgo, O;3429;1764;1665;2022
27;Lugo;015;Cospeito;4342;2134;2208;2022
27;Lugo;017;Folgoso do Courel;985;507;478;2022
27;Lugo;018;Fonsagrada, A;3265;1715;1550;2022
27;Lugo;019;Foz;10118;4892;5226;2022
27;Lugo;020;Friol;3627;1845;1782;2022
27;Lugo;022;Guitiriz;5328;2689;2639;2022
27;Lugo;023;Guntín;2627;1345;1282;2022
27;Lugo;024;Incio, O;1536;781;755;2022
27;Lugo;026;Láncara;2501;1277;1224;2022
27;Lugo;027;Lourenzá;2115;1025;1090;2022
27;Lugo;028;Lugo;97211;44906;52305;2022
27;Lugo;029;Meira;1742;878;864;2022
27;Lugo;030;Mondoñedo;3503;1648;1855;2022
27;Lugo;031;Monforte de Lemos;18081;8605;9476;2022
27;Lugo;032;Monterroso;3585;1785;1800;2022
27;Lugo;033;Muras;606;305;301;2022
27;Lugo;034;Navia de Suarna;997;552;445;2022
27;Lugo;035;Negueira de Muñiz;228;125;103;2022
27;Lugo;037;Nogais, As;991;529;462;2022
27;Lugo;038;Ourol;999;517;482;2022
27;Lugo;039;Outeiro de Rei;5296;2718;2578;2022
27;Lugo;040;Palas de Rei;3319;1675;1644;2022
27;Lugo;041;Pantón;2435;1208;1227;2022
27;Lugo;042;Paradela;1683;842;841;2022
27;Lugo;043;Páramo, O;1322;653;669;2022
27;Lugo;044;Pastoriza, A;2879;1457;1422;2022
27;Lugo;045;Pedrafita do Cebreiro;936;504;432;2022
27;Lugo;047;Pobra do Brollón, A;1551;769;782;2022
27;Lugo;046;Pol;1612;802;810;2022
27;Lugo;048;Pontenova, A;2191;1057;1134;2022
27;Lugo;049;Portomarín;1352;701;651;2022
27;Lugo;050;Quiroga;3125;1468;1657;2022
27;Lugo;056;Rábade;1503;748;755;2022
27;Lugo;051;Ribadeo;9811;4638;5173;2022
27;Lugo;052;Ribas de Sil;937;472;465;2022
27;Lugo;053;Ribeira de Piquín;500;260;240;2022
27;Lugo;054;Riotorto;1187;596;591;2022
27;Lugo;055;Samos;1202;641;561;2022
27;Lugo;057;Sarria;13214;6440;6774;2022
27;Lugo;058;Saviñao, O;3547;1779;1768;2022
27;Lugo;059;Sober;2213;1073;1140;2022
27;Lugo;060;Taboada;2646;1276;1370;2022
27;Lugo;061;Trabada;1107;539;568;2022
27;Lugo;062;Triacastela;629;309;320;2022
27;Lugo;063;Valadouro, O;1938;923;1015;2022
27;Lugo;064;Vicedo, O;1665;822;843;2022
27;Lugo;065;Vilalba;13881;6667;7214;2022
27;Lugo;066;Viveiro;15231;7461;7770;2022
27;Lugo;021;Xermade;1768;862;906;2022
27;Lugo;025;Xove;3352;1733;1619;2022
28;Madrid;001;Acebeda, La;62;32;30;2022
28;Madrid;002;Ajalvir;4751;2473;2278;2022
28;Madrid;003;Alameda del Valle;241;137;104;2022
28;Madrid;004;Álamo, El;10123;4972;5151;2022
28;Madrid;005;Alcalá de Henares;196888;95472;101416;2022
28;Madrid;006;Alcobendas;117041;55907;61134;2022
28;Madrid;007;Alcorcón;170296;81673;88623;2022
28;Madrid;008;Aldea del Fresno;3227;1653;1574;2022
28;Madrid;009;Algete;20767;10181;10586;2022
28;Madrid;010;Alpedrete;15006;7380;7626;2022
28;Madrid;011;Ambite;648;324;324;2022
28;Madrid;012;Anchuelo;1354;702;652;2022
28;Madrid;013;Aranjuez;59762;29046;30716;2022
28;Madrid;014;Arganda del Rey;57553;28729;28824;2022
28;Madrid;015;Arroyomolinos;34833;17313;17520;2022
28;Madrid;016;Atazar, El;107;60;47;2022
28;Madrid;017;Batres;1823;941;882;2022
28;Madrid;018;Becerril de la Sierra;6197;3085;3112;2022
28;Madrid;019;Belmonte de Tajo;1769;910;859;2022
28;Madrid;021;Berrueco, El;801;406;395;2022
28;Madrid;020;Berzosa del Lozoya;227;129;98;2022
28;Madrid;022;Boadilla del Monte;62627;30630;31997;2022
28;Madrid;023;Boalo, El;8216;4100;4116;2022
28;Madrid;024;Braojos;218;132;86;2022
28;Madrid;025;Brea de Tajo;541;307;234;2022
28;Madrid;026;Brunete;10845;5335;5510;2022
28;Madrid;027;Buitrago del Lozoya;1948;931;1017;2022
28;Madrid;028;Bustarviejo;2706;1350;1356;2022
28;Madrid;029;Cabanillas de la Sierra;874;453;421;2022
28;Madrid;030;Cabrera, La;2805;1383;1422;2022
28;Madrid;031;Cadalso de los Vidrios;3193;1664;1529;2022
28;Madrid;032;Camarma de Esteruelas;7595;3837;3758;2022
28;Madrid;033;Campo Real;6651;3365;3286;2022
28;Madrid;034;Canencia;455;242;213;2022
28;Madrid;035;Carabaña;2210;1105;1105;2022
28;Madrid;036;Casarrubuelos;3961;2032;1929;2022
28;Madrid;037;Cenicientos;2089;1045;1044;2022
28;Madrid;038;Cercedilla;7533;3740;3793;2022
28;Madrid;039;Cervera de Buitrago;169;100;69;2022
28;Madrid;051;Chapinería;2512;1266;1246;2022
28;Madrid;052;Chinchón;5658;2838;2820;2022
28;Madrid;040;Ciempozuelos;25383;12799;12584;2022
28;Madrid;041;Cobeña;7551;3697;3854;2022
28;Madrid;046;Collado Mediano;7456;3702;3754;2022
28;Madrid;047;Collado Villalba;64263;31170;33093;2022
28;Madrid;043;Colmenar de Oreja;8462;4295;4167;2022
28;Madrid;042;Colmenar del Arroyo;1936;1020;916;2022
28;Madrid;045;Colmenar Viejo;53389;26267;27122;2022
28;Madrid;044;Colmenarejo;9473;4652;4821;2022
28;Madrid;048;Corpa;764;384;380;2022
28;Madrid;049;Coslada;80596;39281;41315;2022
28;Madrid;050;Cubas de la Sagra;6698;3352;3346;2022
28;Madrid;053;Daganzo de Arriba;10650;5310;5340;2022
28;Madrid;054;Escorial, El;16618;8200;8418;2022
28;Madrid;055;Estremera;1410;720;690;2022
28;Madrid;056;Fresnedillas de la Oliva;1784;898;886;2022
28;Madrid;057;Fresno de Torote;2444;1294;1150;2022
28;Madrid;058;Fuenlabrada;189891;93170;96721;2022
28;Madrid;059;Fuente el Saz de Jarama;7034;3530;3504;2022
28;Madrid;060;Fuentidueña de Tajo;2250;1139;1111;2022
28;Madrid;061;Galapagar;34834;16914;17920;2022
28;Madrid;062;Garganta de los Montes;395;214;181;2022
28;Madrid;063;Gargantilla del Lozoya y Pinilla de Buitrago;361;206;155;2022
28;Madrid;064;Gascones;212;114;98;2022
28;Madrid;065;Getafe;183219;89393;93826;2022
28;Madrid;066;Griñón;10491;5189;5302;2022
28;Madrid;067;Guadalix de la Sierra;6672;3355;3317;2022
28;Madrid;068;Guadarrama;16921;8343;8578;2022
28;Madrid;069;Hiruela, La;75;50;25;2022
28;Madrid;070;Horcajo de la Sierra-Aoslos;201;107;94;2022
28;Madrid;071;Horcajuelo de la Sierra;110;58;52;2022
28;Madrid;072;Hoyo de Manzanares;8811;4443;4368;2022
28;Madrid;073;Humanes de Madrid;19838;9869;9969;2022
28;Madrid;074;Leganés;186660;90038;96622;2022
28;Madrid;075;Loeches;8944;4496;4448;2022
28;Madrid;076;Lozoya;602;322;280;2022
28;Madrid;901;Lozoyuela-Navas-Sieteiglesias;1461;759;702;2022
28;Madrid;078;Madarcos;63;32;31;2022
28;Madrid;079;Madrid;3280782;1531214;1749568;2022
28;Madrid;080;Majadahonda;72179;34148;38031;2022
28;Madrid;082;Manzanares el Real;9247;4667;4580;2022
28;Madrid;083;Meco;15143;7635;7508;2022
28;Madrid;084;Mejorada del Campo;23897;11830;12067;2022
28;Madrid;085;Miraflores de la Sierra;6711;3440;3271;2022
28;Madrid;086;Molar, El;9437;4774;4663;2022
28;Madrid;087;Molinos, Los;4699;2323;2376;2022
28;Madrid;088;Montejo de la Sierra;372;183;189;2022
28;Madrid;089;Moraleja de Enmedio;5368;2701;2667;2022
28;Madrid;090;Moralzarzal;13905;6937;6968;2022
28;Madrid;091;Morata de Tajuña;7960;4009;3951;2022
28;Madrid;092;Móstoles;208761;101318;107443;2022
28;Madrid;093;Navacerrada;3218;1594;1624;2022
28;Madrid;094;Navalafuente;1574;810;764;2022
28;Madrid;095;Navalagamella;2809;1442;1367;2022
28;Madrid;096;Navalcarnero;31379;15585;15794;2022
28;Madrid;097;Navarredonda y San Mamés;138;85;53;2022
28;Madrid;099;Navas del Rey;3134;1625;1509;2022
28;Madrid;100;Nuevo Baztán;6760;3468;3292;2022
28;Madrid;101;Olmeda de las Fuentes;376;193;183;2022
28;Madrid;102;Orusco de Tajuña;1326;695;631;2022
28;Madrid;104;Paracuellos de Jarama;26450;13246;13204;2022
28;Madrid;106;Parla;130577;64847;65730;2022
28;Madrid;107;Patones;536;257;279;2022
28;Madrid;108;Pedrezuela;6307;3175;3132;2022
28;Madrid;109;Pelayos de la Presa;2867;1454;1413;2022
28;Madrid;110;Perales de Tajuña;3117;1573;1544;2022
28;Madrid;111;Pezuela de las Torres;931;492;439;2022
28;Madrid;112;Pinilla del Valle;198;106;92;2022
28;Madrid;113;Pinto;54088;26726;27362;2022
28;Madrid;114;Piñuécar-Gandullas;184;96;88;2022
28;Madrid;115;Pozuelo de Alarcón;87728;41989;45739;2022
28;Madrid;116;Pozuelo del Rey;1178;611;567;2022
28;Madrid;117;Prádena del Rincón;147;84;63;2022
28;Madrid;118;Puebla de la Sierra;84;51;33;2022
28;Madrid;902;Puentes Viejas;697;386;311;2022
28;Madrid;119;Quijorna;3683;1852;1831;2022
28;Madrid;120;Rascafría;1736;939;797;2022
28;Madrid;121;Redueña;298;165;133;2022
28;Madrid;122;Ribatejada;871;454;417;2022
28;Madrid;123;Rivas-Vaciamadrid;96690;47889;48801;2022
28;Madrid;124;Robledillo de la Jara;114;59;55;2022
28;Madrid;125;Robledo de Chavela;4587;2400;2187;2022
28;Madrid;126;Robregordo;70;39;31;2022
28;Madrid;127;Rozas de Madrid, Las;95725;46232;49493;2022
28;Madrid;128;Rozas de Puerto Real;577;336;241;2022
28;Madrid;129;San Agustín del Guadalix;13608;6636;6972;2022
28;Madrid;130;San Fernando de Henares;38904;18960;19944;2022
28;Madrid;131;San Lorenzo de El Escorial;18423;8811;9612;2022
28;Madrid;132;San Martín de la Vega;19927;10128;9799;2022
28;Madrid;133;San Martín de Valdeiglesias;8812;4383;4429;2022
28;Madrid;134;San Sebastián de los Reyes;91083;44203;46880;2022
28;Madrid;135;Santa María de la Alameda;1499;802;697;2022
28;Madrid;136;Santorcaz;941;473;468;2022
28;Madrid;137;Santos de la Humosa, Los;2751;1414;1337;2022
28;Madrid;138;Serna del Monte, La;108;59;49;2022
28;Madrid;140;Serranillos del Valle;4509;2218;2291;2022
28;Madrid;141;Sevilla la Nueva;9361;4599;4762;2022
28;Madrid;143;Somosierra;87;50;37;2022
28;Madrid;144;Soto del Real;9188;4522;4666;2022
28;Madrid;145;Talamanca de Jarama;4210;2053;2157;2022
28;Madrid;146;Tielmes;2783;1410;1373;2022
28;Madrid;147;Titulcia;1336;702;634;2022
28;Madrid;148;Torrejón de Ardoz;134733;66136;68597;2022
28;Madrid;149;Torrejón de la Calzada;9947;4936;5011;2022
28;Madrid;150;Torrejón de Velasco;4685;2321;2364;2022
28;Madrid;151;Torrelaguna;4940;2459;2481;2022
28;Madrid;152;Torrelodones;24775;11945;12830;2022
28;Madrid;153;Torremocha de Jarama;1097;565;532;2022
28;Madrid;154;Torres de la Alameda;7714;3951;3763;2022
28;Madrid;903;Tres Cantos;50187;24325;25862;2022
28;Madrid;155;Valdaracete;627;322;305;2022
28;Madrid;156;Valdeavero;1701;877;824;2022
28;Madrid;157;Valdelaguna;1016;509;507;2022
28;Madrid;158;Valdemanco;1033;534;499;2022
28;Madrid;159;Valdemaqueda;798;401;397;2022
28;Madrid;160;Valdemorillo;13453;6773;6680;2022
28;Madrid;161;Valdemoro;79100;38886;40214;2022
28;Madrid;162;Valdeolmos-Alalpardo;4396;2245;2151;2022
28;Madrid;163;Valdepiélagos;621;319;302;2022
28;Madrid;164;Valdetorres de Jarama;4830;2418;2412;2022
28;Madrid;165;Valdilecha;3104;1604;1500;2022
28;Madrid;166;Valverde de Alcalá;532;282;250;2022
28;Madrid;167;Velilla de San Antonio;12770;6409;6361;2022
28;Madrid;168;Vellón, El;2124;1106;1018;2022
28;Madrid;169;Venturada;2445;1271;1174;2022
28;Madrid;171;Villa del Prado;7092;3607;3485;2022
28;Madrid;170;Villaconejos;3456;1774;1682;2022
28;Madrid;172;Villalbilla;15866;7986;7880;2022
28;Madrid;173;Villamanrique de Tajo;757;394;363;2022
28;Madrid;174;Villamanta;2714;1380;1334;2022
28;Madrid;175;Villamantilla;1567;768;799;2022
28;Madrid;176;Villanueva de la Cañada;22845;11120;11725;2022
28;Madrid;178;Villanueva de Perales;1623;832;791;2022
28;Madrid;177;Villanueva del Pardillo;17382;8416;8966;2022
28;Madrid;179;Villar del Olmo;2219;1102;1117;2022
28;Madrid;180;Villarejo de Salvanés;7629;3790;3839;2022
28;Madrid;181;Villaviciosa de Odón;28152;13619;14533;2022
28;Madrid;182;Villavieja del Lozoya;284;150;134;2022
28;Madrid;183;Zarzalejo;1773;903;870;2022
29;Málaga;001;Alameda;5451;2757;2694;2022
29;Málaga;002;Alcaucín;2487;1269;1218;2022
29;Málaga;003;Alfarnate;1039;534;505;2022
29;Málaga;004;Alfarnatejo;364;189;175;2022
29;Málaga;005;Algarrobo;6625;3305;3320;2022
29;Málaga;006;Algatocín;826;439;387;2022
29;Málaga;007;Alhaurín de la Torre;42531;21153;21378;2022
29;Málaga;008;Alhaurín el Grande;26436;13183;13253;2022
29;Málaga;009;Almáchar;1840;936;904;2022
29;Málaga;010;Almargen;1927;976;951;2022
29;Málaga;011;Almogía;3885;2021;1864;2022
29;Málaga;012;Álora;13382;6765;6617;2022
29;Málaga;013;Alozaina;2089;1050;1039;2022
29;Málaga;014;Alpandeire;266;133;133;2022
29;Málaga;015;Antequera;41184;20163;21021;2022
29;Málaga;016;Árchez;396;198;198;2022
29;Málaga;017;Archidona;8024;4079;3945;2022
29;Málaga;018;Ardales;2520;1272;1248;2022
29;Málaga;019;Arenas;1249;641;608;2022
29;Málaga;020;Arriate;4110;2026;2084;2022
29;Málaga;021;Atajate;183;103;80;2022
29;Málaga;022;Benadalid;239;118;121;2022
29;Málaga;023;Benahavís;8763;4368;4395;2022
29;Málaga;024;Benalauría;434;229;205;2022
29;Málaga;025;Benalmádena;73160;35839;37321;2022
29;Málaga;026;Benamargosa;1519;785;734;2022
29;Málaga;027;Benamocarra;3085;1541;1544;2022
29;Málaga;028;Benaoján;1459;742;717;2022
29;Málaga;029;Benarrabá;446;231;215;2022
29;Málaga;030;Borge, El;921;470;451;2022
29;Málaga;031;Burgo, El;1791;905;886;2022
29;Málaga;032;Campillos;8372;4204;4168;2022
29;Málaga;033;Canillas de Aceituno;1722;903;819;2022
29;Málaga;034;Canillas de Albaida;796;387;409;2022
29;Málaga;035;Cañete la Real;1584;776;808;2022
29;Málaga;036;Carratraca;718;377;341;2022
29;Málaga;037;Cartajima;256;133;123;2022
29;Málaga;038;Cártama;27712;14028;13684;2022
29;Málaga;039;Casabermeja;3813;1976;1837;2022
29;Málaga;040;Casarabonela;2524;1357;1167;2022
29;Málaga;041;Casares;7700;3946;3754;2022
29;Málaga;042;Coín;24309;12169;12140;2022
29;Málaga;043;Colmenar;3488;1799;1689;2022
29;Málaga;044;Comares;1320;707;613;2022
29;Málaga;045;Cómpeta;3814;1909;1905;2022
29;Málaga;046;Cortes de la Frontera;2986;1545;1441;2022
29;Málaga;047;Cuevas Bajas;1353;656;697;2022
29;Málaga;049;Cuevas de San Marcos;3632;1824;1808;2022
29;Málaga;048;Cuevas del Becerro;1609;788;821;2022
29;Málaga;050;Cútar;590;309;281;2022
29;Málaga;051;Estepona;74493;36530;37963;2022
29;Málaga;052;Faraján;270;132;138;2022
29;Málaga;053;Frigiliana;3282;1625;1657;2022
29;Málaga;054;Fuengirola;83226;40454;42772;2022
29;Málaga;055;Fuente de Piedra;2787;1392;1395;2022
29;Málaga;056;Gaucín;1608;825;783;2022
29;Málaga;057;Genalguacil;393;196;197;2022
29;Málaga;058;Guaro;2302;1167;1135;2022
29;Málaga;059;Humilladero;3282;1629;1653;2022
29;Málaga;060;Igualeja;729;366;363;2022
29;Málaga;061;Istán;1587;789;798;2022
29;Málaga;062;Iznate;899;472;427;2022
29;Málaga;063;Jimera de Líbar;403;211;192;2022
29;Málaga;064;Jubrique;545;271;274;2022
29;Málaga;065;Júzcar;247;142;105;2022
29;Málaga;066;Macharaviaya;513;280;233;2022
29;Málaga;067;Málaga;579076;278086;300990;2022
29;Málaga;068;Manilva;17157;8631;8526;2022
29;Málaga;069;Marbella;150725;72195;78530;2022
29;Málaga;070;Mijas;89502;44451;45051;2022
29;Málaga;071;Moclinejo;1243;645;598;2022
29;Málaga;072;Mollina;5376;2678;2698;2022
29;Málaga;073;Monda;2844;1498;1346;2022
29;Málaga;903;Montecorto;582;310;272;2022
29;Málaga;074;Montejaque;938;469;469;2022
29;Málaga;075;Nerja;21450;10529;10921;2022
29;Málaga;076;Ojén;4218;2151;2067;2022
29;Málaga;077;Parauta;272;138;134;2022
29;Málaga;079;Periana;3234;1679;1555;2022
29;Málaga;080;Pizarra;9661;4841;4820;2022
29;Málaga;081;Pujerra;274;138;136;2022
29;Málaga;082;Rincón de la Victoria;50569;24731;25838;2022
29;Málaga;083;Riogordo;2762;1447;1315;2022
29;Málaga;084;Ronda;33401;16205;17196;2022
29;Málaga;085;Salares;175;88;87;2022
29;Málaga;086;Sayalonga;1641;845;796;2022
29;Málaga;087;Sedella;598;341;257;2022
29;Málaga;904;Serrato;458;226;232;2022
29;Málaga;088;Sierra de Yeguas;3393;1707;1686;2022
29;Málaga;089;Teba;3729;1875;1854;2022
29;Málaga;090;Tolox;2309;1160;1149;2022
29;Málaga;901;Torremolinos;68819;34437;34382;2022
29;Málaga;091;Torrox;19997;10044;9953;2022
29;Málaga;092;Totalán;750;382;368;2022
29;Málaga;093;Valle de Abdalajís;2473;1245;1228;2022
29;Málaga;094;Vélez-Málaga;83899;41352;42547;2022
29;Málaga;095;Villanueva de Algaidas;4146;2116;2030;2022
29;Málaga;902;Villanueva de la Concepción;3295;1588;1707;2022
29;Málaga;098;Villanueva de Tapia;1417;716;701;2022
29;Málaga;096;Villanueva del Rosario;3339;1636;1703;2022
29;Málaga;097;Villanueva del Trabuco;5340;2666;2674;2022
29;Málaga;099;Viñuela;2106;1098;1008;2022
29;Málaga;100;Yunquera;2841;1450;1391;2022
52;Melilla;001;Melilla;85170;42990;42180;2022
30;Murcia;001;Abanilla;6146;3112;3034;2022
30;Murcia;002;Abarán;12992;6492;6500;2022
30;Murcia;003;Águilas;36403;18178;18225;2022
30;Murcia;004;Albudeite;1390;708;682;2022
30;Murcia;005;Alcantarilla;42630;21148;21482;2022
30;Murcia;902;Alcázares, Los;17603;9008;8595;2022
30;Murcia;006;Aledo;1110;550;560;2022
30;Murcia;007;Alguazas;9965;5148;4817;2022
30;Murcia;008;Alhama de Murcia;22691;11485;11206;2022
30;Murcia;009;Archena;19622;10290;9332;2022
30;Murcia;010;Beniel;11578;6045;5533;2022
30;Murcia;011;Blanca;6681;3437;3244;2022
30;Murcia;012;Bullas;11627;5833;5794;2022
30;Murcia;013;Calasparra;10163;5164;4999;2022
30;Murcia;014;Campos del Río;2090;1000;1090;2022
30;Murcia;015;Caravaca de la Cruz;25722;12839;12883;2022
30;Murcia;016;Cartagena;216961;107794;109167;2022
30;Murcia;017;Cehegín;14710;7352;7358;2022
30;Murcia;018;Ceutí;12391;6260;6131;2022
30;Murcia;019;Cieza;35298;17742;17556;2022
30;Murcia;020;Fortuna;10843;5735;5108;2022
30;Murcia;021;Fuente Álamo de Murcia;17589;9181;8408;2022
30;Murcia;022;Jumilla;26596;13915;12681;2022
30;Murcia;023;Librilla;5619;2863;2756;2022
30;Murcia;024;Lorca;97151;49758;47393;2022
30;Murcia;025;Lorquí;7510;3822;3688;2022
30;Murcia;026;Mazarrón;33700;17416;16284;2022
30;Murcia;027;Molina de Segura;74762;37281;37481;2022
30;Murcia;028;Moratalla;7753;3934;3819;2022
30;Murcia;029;Mula;17231;8810;8421;2022
30;Murcia;030;Murcia;462979;227012;235967;2022
30;Murcia;031;Ojós;522;268;254;2022
30;Murcia;032;Pliego;3901;2019;1882;2022
30;Murcia;033;Puerto Lumbreras;16564;8501;8063;2022
30;Murcia;034;Ricote;1275;679;596;2022
30;Murcia;035;San Javier;34468;17315;17153;2022
30;Murcia;036;San Pedro del Pinatar;26827;13482;13345;2022
30;Murcia;901;Santomera;16125;8060;8065;2022
30;Murcia;037;Torre-Pacheco;38140;19652;18488;2022
30;Murcia;038;Torres de Cotillas, Las;21980;11135;10845;2022
30;Murcia;039;Totana;32329;16577;15752;2022
30;Murcia;040;Ulea;882;459;423;2022
30;Murcia;041;Unión, La;20656;10451;10205;2022
30;Murcia;042;Villanueva del Río Segura;3469;1761;1708;2022
30;Murcia;043;Yecla;35234;17737;17497;2022
31;Navarra;001;Abáigar;80;48;32;2022
31;Navarra;002;Abárzuza/Abartzuza;527;264;263;2022
31;Navarra;003;Abaurregaina/Abaurrea Alta;120;75;45;2022
31;Navarra;004;Abaurrepea/Abaurrea Baja;31;19;12;2022
31;Navarra;005;Aberin;371;201;170;2022
31;Navarra;006;Ablitas;2557;1290;1267;2022
31;Navarra;007;Adiós;165;97;68;2022
31;Navarra;008;Aguilar de Codés;76;44;32;2022
31;Navarra;009;Aibar/Oibar;784;412;372;2022
31;Navarra;011;Allín/Allin;879;472;407;2022
31;Navarra;012;Allo;939;484;455;2022
31;Navarra;010;Altsasu/Alsasua;7504;3789;3715;2022
31;Navarra;013;Améscoa Baja;732;407;325;2022
31;Navarra;014;Ancín/Antzin;332;187;145;2022
31;Navarra;015;Andosilla;2818;1423;1395;2022
31;Navarra;016;Ansoáin/Antsoain;10588;5175;5413;2022
31;Navarra;017;Anue;490;258;232;2022
31;Navarra;018;Añorbe;605;330;275;2022
31;Navarra;019;Aoiz/Agoitz;2892;1463;1429;2022
31;Navarra;020;Araitz;512;285;227;2022
31;Navarra;025;Arakil;967;505;462;2022
31;Navarra;021;Aranarache/Aranaratxe;71;42;29;2022
31;Navarra;023;Aranguren;12156;6123;6033;2022
31;Navarra;024;Arano;111;61;50;2022
31;Navarra;022;Arantza;591;316;275;2022
31;Navarra;026;Aras;154;83;71;2022
31;Navarra;027;Arbizu;1124;590;534;2022
31;Navarra;028;Arce/Artzi;278;155;123;2022
31;Navarra;029;Arcos, Los;1139;560;579;2022
31;Navarra;030;Arellano;156;86;70;2022
31;Navarra;031;Areso;270;140;130;2022
31;Navarra;032;Arguedas;2312;1183;1129;2022
31;Navarra;033;Aria;48;30;18;2022
31;Navarra;034;Aribe;36;20;16;2022
31;Navarra;035;Armañanzas;51;27;24;2022
31;Navarra;036;Arróniz;1036;553;483;2022
31;Navarra;037;Arruazu;106;56;50;2022
31;Navarra;038;Artajona;1762;912;850;2022
31;Navarra;039;Artazu;113;58;55;2022
31;Navarra;040;Atez/Atetz;212;120;92;2022
31;Navarra;058;Auritz/Burguete;230;123;107;2022
31;Navarra;041;Ayegui/Aiegi;2488;1301;1187;2022
31;Navarra;042;Azagra;3802;1921;1881;2022
31;Navarra;043;Azuelo;26;10;16;2022
31;Navarra;044;Bakaiku;355;186;169;2022
31;Navarra;901;Barañáin/Barañain;19537;9470;10067;2022
31;Navarra;045;Barásoain;621;323;298;2022
31;Navarra;046;Barbarin;48;26;22;2022
31;Navarra;047;Bargota;256;124;132;2022
31;Navarra;048;Barillas;257;140;117;2022
31;Navarra;049;Basaburua;842;482;360;2022
31;Navarra;050;Baztan;7851;3978;3873;2022
31;Navarra;137;Beintza-Labaien;213;127;86;2022
31;Navarra;051;Beire;311;154;157;2022
31;Navarra;052;Belascoáin;121;62;59;2022
31;Navarra;250;Bera;3771;1860;1911;2022
31;Navarra;053;Berbinzana;648;330;318;2022
31;Navarra;905;Beriáin;4100;2010;2090;2022
31;Navarra;902;Berrioplano/Berriobeiti;7453;3800;3653;2022
31;Navarra;903;Berriozar;10765;5405;5360;2022
31;Navarra;054;Bertizarana;599;300;299;2022
31;Navarra;055;Betelu;369;189;180;2022
31;Navarra;253;Bidaurreta;167;85;82;2022
31;Navarra;056;Biurrun-Olcoz;235;126;109;2022
31;Navarra;057;Buñuel;2223;1084;1139;2022
31;Navarra;059;Burgui/Burgi;203;118;85;2022
31;Navarra;060;Burlada/Burlata;20398;9862;10536;2022
31;Navarra;061;Busto, El;51;25;26;2022
31;Navarra;062;Cabanillas;1370;709;661;2022
31;Navarra;063;Cabredo;78;45;33;2022
31;Navarra;064;Cadreita;2083;1092;991;2022
31;Navarra;065;Caparroso;2783;1474;1309;2022
31;Navarra;066;Cárcar;1124;575;549;2022
31;Navarra;067;Carcastillo;2428;1237;1191;2022
31;Navarra;068;Cascante;3950;1952;1998;2022
31;Navarra;069;Cáseda;946;494;452;2022
31;Navarra;070;Castejón;4311;2145;2166;2022
31;Navarra;071;Castillonuevo;16;10;6;2022
31;Navarra;193;Cendea de Olza/Oltza Zendea;1871;925;946;2022
31;Navarra;072;Cintruénigo;8106;4191;3915;2022
31;Navarra;074;Cirauqui/Zirauki;465;241;224;2022
31;Navarra;075;Ciriza/Ziritza;161;76;85;2022
31;Navarra;076;Cizur;3920;2014;1906;2022
31;Navarra;077;Corella;8336;4210;4126;2022
31;Navarra;078;Cortes;3184;1621;1563;2022
31;Navarra;079;Desojo;68;39;29;2022
31;Navarra;080;Dicastillo;595;310;285;2022
31;Navarra;081;Donamaria;465;231;234;2022
31;Navarra;221;Doneztebe/Santesteban;1823;905;918;2022
31;Navarra;083;Echarri/Etxarri;71;35;36;2022
31;Navarra;087;Elgorriaga;215;108;107;2022
31;Navarra;089;Enériz/Eneritz;297;149;148;2022
31;Navarra;090;Eratsun;150;89;61;2022
31;Navarra;091;Ergoiena;373;202;171;2022
31;Navarra;092;Erro;796;451;345;2022
31;Navarra;094;Eslava;101;48;53;2022
31;Navarra;095;Esparza de Salazar/Espartza Zaraitzu;74;40;34;2022
31;Navarra;096;Espronceda;105;57;48;2022
31;Navarra;097;Estella-Lizarra;13977;6764;7213;2022
31;Navarra;098;Esteribar;2792;1451;1341;2022
31;Navarra;099;Etayo;65;37;28;2022
31;Navarra;082;Etxalar;830;437;393;2022
31;Navarra;084;Etxarri Aranatz;2506;1290;1216;2022
31;Navarra;085;Etxauri;633;317;316;2022
31;Navarra;100;Eulate;275;152;123;2022
31;Navarra;101;Ezcabarte;1817;953;864;2022
31;Navarra;093;Ezcároz/Ezkaroze;305;169;136;2022
31;Navarra;102;Ezkurra;138;94;44;2022
31;Navarra;103;Ezprogui;47;22;25;2022
31;Navarra;104;Falces;2332;1195;1137;2022
31;Navarra;105;Fitero;2046;1018;1028;2022
31;Navarra;106;Fontellas;1016;527;489;2022
31;Navarra;107;Funes;2504;1333;1171;2022
31;Navarra;108;Fustiñana;2459;1222;1237;2022
31;Navarra;109;Galar;2299;1187;1112;2022
31;Navarra;110;Gallipienzo/Galipentzu;103;59;44;2022
31;Navarra;111;Gallués/Galoze;92;60;32;2022
31;Navarra;112;Garaioa;91;52;39;2022
31;Navarra;113;Garde;134;76;58;2022
31;Navarra;114;Garínoain;534;284;250;2022
31;Navarra;115;Garralda;190;96;94;2022
31;Navarra;116;Genevilla;57;36;21;2022
31;Navarra;117;Goizueta;694;362;332;2022
31;Navarra;118;Goñi;163;98;65;2022
31;Navarra;119;Güesa/Gorza;34;21;13;2022
31;Navarra;120;Guesálaz/Gesalatz;438;253;185;2022
31;Navarra;121;Guirguillano;70;37;33;2022
31;Navarra;256;Hiriberri/Villanueva de Aezkoa;99;54;45;2022
31;Navarra;122;Huarte/Uharte;7312;3680;3632;2022
31;Navarra;124;Ibargoiti;282;159;123;2022
31;Navarra;259;Igantzi;583;310;273;2022
31;Navarra;125;Igúzquiza;307;152;155;2022
31;Navarra;126;Imotz;418;231;187;2022
31;Navarra;127;Irañeta;167;90;77;2022
31;Navarra;904;Irurtzun;2299;1201;1098;2022
31;Navarra;128;Isaba/Izaba;410;194;216;2022
31;Navarra;129;Ituren;515;258;257;2022
31;Navarra;130;Iturmendi;420;217;203;2022
31;Navarra;131;Iza/Itza;1328;721;607;2022
31;Navarra;132;Izagaondoa;162;107;55;2022
31;Navarra;133;Izalzu/Itzaltzu;37;21;16;2022
31;Navarra;134;Jaurrieta;179;103;76;2022
31;Navarra;135;Javier;122;27;95;2022
31;Navarra;136;Juslapeña;574;308;266;2022
31;Navarra;138;Lakuntza;1283;669;614;2022
31;Navarra;139;Lana;155;90;65;2022
31;Navarra;140;Lantz;151;86;65;2022
31;Navarra;141;Lapoblación;124;73;51;2022
31;Navarra;142;Larraga;2062;1081;981;2022
31;Navarra;143;Larraona;102;50;52;2022
31;Navarra;144;Larraun;907;491;416;2022
31;Navarra;145;Lazagurría;185;96;89;2022
31;Navarra;146;Leache/Leatxe;32;16;16;2022
31;Navarra;147;Legarda;137;73;64;2022
31;Navarra;148;Legaria;108;48;60;2022
31;Navarra;149;Leitza;3029;1555;1474;2022
31;Navarra;908;Lekunberri;1656;840;816;2022
31;Navarra;150;Leoz/Leotz;220;140;80;2022
31;Navarra;151;Lerga;42;25;17;2022
31;Navarra;152;Lerín;1756;917;839;2022
31;Navarra;153;Lesaka;2752;1400;1352;2022
31;Navarra;154;Lezaun;247;142;105;2022
31;Navarra;155;Liédena;316;163;153;2022
31;Navarra;156;Lizoain-Arriasgoiti/Lizoainibar-Arriasgoiti;309;182;127;2022
31;Navarra;157;Lodosa;4861;2462;2399;2022
31;Navarra;158;Lónguida/Longida;271;143;128;2022
31;Navarra;159;Lumbier;1297;702;595;2022
31;Navarra;160;Luquin;132;67;65;2022
31;Navarra;248;Luzaide/Valcarlos;317;179;138;2022
31;Navarra;161;Mañeru;436;227;209;2022
31;Navarra;162;Marañón;49;28;21;2022
31;Navarra;163;Marcilla;2879;1445;1434;2022
31;Navarra;164;Mélida;714;364;350;2022
31;Navarra;165;Mendavia;3560;1795;1765;2022
31;Navarra;166;Mendaza;297;150;147;2022
31;Navarra;167;Mendigorria;1124;594;530;2022
31;Navarra;168;Metauten;284;159;125;2022
31;Navarra;169;Milagro;3505;1797;1708;2022
31;Navarra;170;Mirafuentes;59;29;30;2022
31;Navarra;171;Miranda de Arga;875;464;411;2022
31;Navarra;172;Monreal/Elo;486;269;217;2022
31;Navarra;173;Monteagudo;1109;574;535;2022
31;Navarra;174;Morentin;114;56;58;2022
31;Navarra;175;Mues;82;45;37;2022
31;Navarra;176;Murchante;4156;2103;2053;2022
31;Navarra;177;Murieta;347;177;170;2022
31;Navarra;178;Murillo el Cuende;664;346;318;2022
31;Navarra;179;Murillo el Fruto;663;356;307;2022
31;Navarra;180;Muruzábal;261;121;140;2022
31;Navarra;181;Navascués/Nabaskoze;118;67;51;2022
31;Navarra;182;Nazar;40;21;19;2022
31;Navarra;088;Noáin (Valle de Elorz)/Noain (Elortzibar);8367;4192;4175;2022
31;Navarra;183;Obanos;938;462;476;2022
31;Navarra;185;Ochagavía/Otsagabia;495;272;223;2022
31;Navarra;184;Oco;73;37;36;2022
31;Navarra;186;Odieta;367;199;168;2022
31;Navarra;187;Oiz;124;70;54;2022
31;Navarra;188;Olaibar;395;222;173;2022
31;Navarra;189;Olazti/Olazagutía;1490;764;726;2022
31;Navarra;190;Olejua;49;28;21;2022
31;Navarra;191;Olite/Erriberri;3980;2008;1972;2022
31;Navarra;192;Olóriz/Oloritz;212;122;90;2022
31;Navarra;195;Orbaizeta;191;92;99;2022
31;Navarra;196;Orbara;33;18;15;2022
31;Navarra;197;Orísoain;72;42;30;2022
31;Navarra;906;Orkoien;4095;2052;2043;2022
31;Navarra;198;Oronz/Orontze;49;25;24;2022
31;Navarra;199;Oroz-Betelu/Orotz-Betelu;139;79;60;2022
31;Navarra;211;Orreaga/Roncesvalles;19;11;8;2022
31;Navarra;200;Oteiza;931;494;437;2022
31;Navarra;201;Pamplona/Iruña;203418;96027;107391;2022
31;Navarra;202;Peralta/Azkoien;5938;3006;2932;2022
31;Navarra;203;Petilla de Aragón;30;17;13;2022
31;Navarra;204;Piedramillera;40;24;16;2022
31;Navarra;205;Pitillas;521;250;271;2022
31;Navarra;206;Puente la Reina/Gares;2905;1487;1418;2022
31;Navarra;207;Pueyo/Puiu;333;186;147;2022
31;Navarra;208;Ribaforada;3721;1937;1784;2022
31;Navarra;209;Romanzado;184;99;85;2022
31;Navarra;210;Roncal/Erronkari;219;111;108;2022
31;Navarra;212;Sada;139;78;61;2022
31;Navarra;213;Saldías;120;66;54;2022
31;Navarra;214;Salinas de Oro/Jaitz;106;57;49;2022
31;Navarra;215;San Adrián;6373;3185;3188;2022
31;Navarra;217;San Martín de Unx;370;195;175;2022
31;Navarra;216;Sangüesa/Zangoza;4882;2475;2407;2022
31;Navarra;219;Sansol;101;48;53;2022
31;Navarra;220;Santacara;868;445;423;2022
31;Navarra;222;Sarriés/Sartze;58;41;17;2022
31;Navarra;223;Sartaguda;1312;676;636;2022
31;Navarra;224;Sesma;1186;609;577;2022
31;Navarra;225;Sorlada;45;24;21;2022
31;Navarra;226;Sunbilla;677;345;332;2022
31;Navarra;227;Tafalla;10576;5268;5308;2022
31;Navarra;228;Tiebas-Muruarte de Reta;635;345;290;2022
31;Navarra;229;Tirapu;56;31;25;2022
31;Navarra;230;Torralba del Río;99;55;44;2022
31;Navarra;231;Torres del Río;121;62;59;2022
31;Navarra;232;Tudela;37247;18408;18839;2022
31;Navarra;233;Tulebras;152;68;84;2022
31;Navarra;234;Ucar;191;111;80;2022
31;Navarra;123;Uharte Arakil;791;418;373;2022
31;Navarra;235;Ujué/Uxue;175;97;78;2022
31;Navarra;236;Ultzama;1647;849;798;2022
31;Navarra;237;Unciti;234;134;100;2022
31;Navarra;238;Unzué/Untzue;157;83;74;2022
31;Navarra;239;Urdazubi/Urdax;330;171;159;2022
31;Navarra;240;Urdiain;636;329;307;2022
31;Navarra;241;Urraul Alto;138;89;49;2022
31;Navarra;242;Urraul Bajo;324;149;175;2022
31;Navarra;244;Urroz;177;97;80;2022
31;Navarra;243;Urroz-Villa;399;207;192;2022
31;Navarra;245;Urzainqui/Urzainki;85;52;33;2022
31;Navarra;246;Uterga;165;95;70;2022
31;Navarra;247;Uztárroz/Uztarroze;147;72;75;2022
31;Navarra;086;Valle de Egüés/Eguesibar;21795;10907;10888;2022
31;Navarra;194;Valle de Ollo/Ollaran;425;227;198;2022
31;Navarra;260;Valle de Yerri/Deierri;1568;819;749;2022
31;Navarra;249;Valtierra;2439;1231;1208;2022
31;Navarra;251;Viana;4366;2219;2147;2022
31;Navarra;252;Vidángoz/Bidankoze;80;48;32;2022
31;Navarra;254;Villafranca;2945;1520;1425;2022
31;Navarra;255;Villamayor de Monjardín;114;57;57;2022
31;Navarra;257;Villatuerta;1272;625;647;2022
31;Navarra;258;Villava/Atarrabia;10022;4845;5177;2022
31;Navarra;261;Yesa;304;174;130;2022
31;Navarra;262;Zabalza/Zabaltza;297;157;140;2022
31;Navarra;073;Ziordia;346;186;160;2022
31;Navarra;907;Zizur Mayor/Zizur Nagusia;15497;7589;7908;2022
31;Navarra;263;Zubieta;296;152;144;2022
31;Navarra;264;Zugarramurdi;202;98;104;2022
31;Navarra;265;Zúñiga;74;48;26;2022
32;Ourense;001;Allariz;6348;3135;3213;2022
32;Ourense;002;Amoeiro;2369;1196;1173;2022
32;Ourense;003;Arnoia, A;1015;502;513;2022
32;Ourense;004;Avión;1770;813;957;2022
32;Ourense;005;Baltar;910;485;425;2022
32;Ourense;006;Bande;1463;742;721;2022
32;Ourense;007;Baños de Molgas;1489;742;747;2022
32;Ourense;008;Barbadás;11061;5387;5674;2022
32;Ourense;009;Barco de Valdeorras, O;13350;6472;6878;2022
32;Ourense;010;Beade;372;193;179;2022
32;Ourense;011;Beariz;978;435;543;2022
32;Ourense;012;Blancos, Os;732;399;333;2022
32;Ourense;013;Boborás;2219;1056;1163;2022
32;Ourense;014;Bola, A;1088;519;569;2022
32;Ourense;015;Bolo, O;824;417;407;2022
32;Ourense;016;Calvos de Randín;678;351;327;2022
32;Ourense;018;Carballeda de Avia;1219;596;623;2022
32;Ourense;017;Carballeda de Valdeorras;1409;727;682;2022
32;Ourense;019;Carballiño, O;13932;6479;7453;2022
32;Ourense;020;Cartelle;2578;1266;1312;2022
32;Ourense;022;Castrelo de Miño;1315;667;648;2022
32;Ourense;021;Castrelo do Val;969;493;476;2022
32;Ourense;023;Castro Caldelas;1177;600;577;2022
32;Ourense;024;Celanova;5619;2639;2980;2022
32;Ourense;025;Cenlle;1119;551;568;2022
32;Ourense;029;Chandrexa de Queixa;495;259;236;2022
32;Ourense;026;Coles;3138;1577;1561;2022
32;Ourense;027;Cortegada;1036;507;529;2022
32;Ourense;028;Cualedro;1627;854;773;2022
32;Ourense;030;Entrimo;1118;534;584;2022
32;Ourense;031;Esgos;1104;558;546;2022
32;Ourense;033;Gomesende;686;342;344;2022
32;Ourense;034;Gudiña, A;1180;589;591;2022
32;Ourense;035;Irixo, O;1366;657;709;2022
32;Ourense;038;Larouco;440;208;232;2022
32;Ourense;039;Laza;1205;632;573;2022
32;Ourense;040;Leiro;1522;742;780;2022
32;Ourense;041;Lobeira;774;390;384;2022
32;Ourense;042;Lobios;1703;851;852;2022
32;Ourense;043;Maceda;2853;1422;1431;2022
32;Ourense;044;Manzaneda;828;403;425;2022
32;Ourense;045;Maside;2753;1363;1390;2022
32;Ourense;046;Melón;1137;555;582;2022
32;Ourense;047;Merca, A;1966;982;984;2022
32;Ourense;048;Mezquita, A;1005;524;481;2022
32;Ourense;049;Montederramo;701;376;325;2022
32;Ourense;050;Monterrei;2461;1255;1206;2022
32;Ourense;051;Muíños;1424;714;710;2022
32;Ourense;052;Nogueira de Ramuín;2081;1062;1019;2022
32;Ourense;053;Oímbra;1730;948;782;2022
32;Ourense;054;Ourense;103756;47089;56667;2022
32;Ourense;055;Paderne de Allariz;1395;697;698;2022
32;Ourense;056;Padrenda;1637;799;838;2022
32;Ourense;057;Parada de Sil;531;284;247;2022
32;Ourense;058;Pereiro de Aguiar, O;6609;3419;3190;2022
32;Ourense;059;Peroxa, A;1805;890;915;2022
32;Ourense;060;Petín;883;445;438;2022
32;Ourense;061;Piñor;1146;596;550;2022
32;Ourense;063;Pobra de Trives, A;2019;1000;1019;2022
32;Ourense;064;Pontedeva;479;237;242;2022
32;Ourense;062;Porqueira;835;389;446;2022
32;Ourense;065;Punxín;744;354;390;2022
32;Ourense;066;Quintela de Leirado;626;290;336;2022
32;Ourense;067;Rairiz de Veiga;1216;627;589;2022
32;Ourense;068;Ramirás;1500;710;790;2022
32;Ourense;069;Ribadavia;5003;2468;2535;2022
32;Ourense;071;Riós;1432;722;710;2022
32;Ourense;072;Rúa, A;4186;2084;2102;2022
32;Ourense;073;Rubiá;1376;666;710;2022
32;Ourense;074;San Amaro;1042;500;542;2022
32;Ourense;075;San Cibrao das Viñas;5558;2807;2751;2022
32;Ourense;076;San Cristovo de Cea;2042;1008;1034;2022
32;Ourense;070;San Xoán de Río;508;258;250;2022
32;Ourense;077;Sandiás;1170;555;615;2022
32;Ourense;078;Sarreaus;1107;542;565;2022
32;Ourense;079;Taboadela;1471;750;721;2022
32;Ourense;080;Teixeira, A;345;179;166;2022
32;Ourense;081;Toén;2388;1223;1165;2022
32;Ourense;082;Trasmiras;1261;625;636;2022
32;Ourense;083;Veiga, A;901;469;432;2022
32;Ourense;084;Verea;944;460;484;2022
32;Ourense;085;Verín;13625;6554;7071;2022
32;Ourense;086;Viana do Bolo;2781;1409;1372;2022
32;Ourense;087;Vilamarín;1847;948;899;2022
32;Ourense;088;Vilamartín de Valdeorras;1825;930;895;2022
32;Ourense;089;Vilar de Barrio;1206;611;595;2022
32;Ourense;090;Vilar de Santos;792;390;402;2022
32;Ourense;091;Vilardevós;1726;914;812;2022
32;Ourense;092;Vilariño de Conso;505;295;210;2022
32;Ourense;032;Xinzo de Limia;9611;4659;4952;2022
32;Ourense;036;Xunqueira de Ambía;1388;694;694;2022
32;Ourense;037;Xunqueira de Espadanedo;723;360;363;2022
34;Palencia;001;Abarca de Campos;43;25;18;2022
34;Palencia;003;Abia de las Torres;169;93;76;2022
34;Palencia;004;Aguilar de Campoo;6646;3219;3427;2022
34;Palencia;005;Alar del Rey;909;447;462;2022
34;Palencia;006;Alba de Cerrato;79;46;33;2022
34;Palencia;009;Amayuelas de Arriba;40;25;15;2022
34;Palencia;010;Ampudia;600;303;297;2022
34;Palencia;011;Amusco;415;233;182;2022
34;Palencia;012;Antigüedad;347;192;155;2022
34;Palencia;015;Arconada;42;26;16;2022
34;Palencia;017;Astudillo;1031;518;513;2022
34;Palencia;018;Autilla del Pino;215;121;94;2022
34;Palencia;019;Autillo de Campos;133;70;63;2022
34;Palencia;020;Ayuela;54;34;20;2022
34;Palencia;022;Baltanás;1206;613;593;2022
34;Palencia;024;Baquerín de Campos;27;17;10;2022
34;Palencia;025;Bárcena de Campos;50;25;25;2022
34;Palencia;027;Barruelo de Santullán;1203;598;605;2022
34;Palencia;028;Báscones de Ojeda;138;70;68;2022
34;Palencia;029;Becerril de Campos;755;383;372;2022
34;Palencia;031;Belmonte de Campos;32;16;16;2022
34;Palencia;032;Berzosilla;40;22;18;2022
34;Palencia;033;Boada de Campos;19;14;5;2022
34;Palencia;035;Boadilla de Rioseco;111;63;48;2022
34;Palencia;034;Boadilla del Camino;122;69;53;2022
34;Palencia;036;Brañosera;252;141;111;2022
34;Palencia;037;Buenavista de Valdavia;311;178;133;2022
34;Palencia;038;Bustillo de la Vega;278;157;121;2022
34;Palencia;039;Bustillo del Páramo de Carrión;53;32;21;2022
34;Palencia;041;Calahorra de Boedo;89;42;47;2022
34;Palencia;042;Calzada de los Molinos;313;174;139;2022
34;Palencia;045;Capillas;68;38;30;2022
34;Palencia;046;Cardeñosa de Volpejera;54;30;24;2022
34;Palencia;047;Carrión de los Condes;2005;959;1046;2022
34;Palencia;048;Castil de Vela;60;29;31;2022
34;Palencia;049;Castrejón de la Peña;332;177;155;2022
34;Palencia;050;Castrillo de Don Juan;190;106;84;2022
34;Palencia;051;Castrillo de Onielo;108;54;54;2022
34;Palencia;052;Castrillo de Villavega;171;95;76;2022
34;Palencia;053;Castromocho;211;109;102;2022
34;Palencia;055;Cervatos de la Cueza;261;144;117;2022
34;Palencia;056;Cervera de Pisuerga;2256;1116;1140;2022
34;Palencia;057;Cevico de la Torre;490;250;240;2022
34;Palencia;058;Cevico Navero;189;112;77;2022
34;Palencia;059;Cisneros;413;207;206;2022
34;Palencia;060;Cobos de Cerrato;132;75;57;2022
34;Palencia;061;Collazos de Boedo;97;57;40;2022
34;Palencia;062;Congosto de Valdavia;147;88;59;2022
34;Palencia;063;Cordovilla la Real;124;69;55;2022
34;Palencia;066;Cubillas de Cerrato;64;37;27;2022
34;Palencia;067;Dehesa de Montejo;136;79;57;2022
34;Palencia;068;Dehesa de Romanos;49;31;18;2022
34;Palencia;069;Dueñas;2592;1316;1276;2022
34;Palencia;070;Espinosa de Cerrato;129;71;58;2022
34;Palencia;071;Espinosa de Villagonzalo;164;88;76;2022
34;Palencia;072;Frechilla;136;68;68;2022
34;Palencia;073;Fresno del Río;184;88;96;2022
34;Palencia;074;Frómista;768;389;379;2022
34;Palencia;076;Fuentes de Nava;610;316;294;2022
34;Palencia;077;Fuentes de Valdepero;502;258;244;2022
34;Palencia;079;Grijota;2606;1350;1256;2022
34;Palencia;080;Guardo;5695;2807;2888;2022
34;Palencia;081;Guaza de Campos;56;35;21;2022
34;Palencia;082;Hérmedes de Cerrato;78;40;38;2022
34;Palencia;083;Herrera de Pisuerga;1894;925;969;2022
34;Palencia;084;Herrera de Valdecañas;149;82;67;2022
34;Palencia;086;Hontoria de Cerrato;102;54;48;2022
34;Palencia;087;Hornillos de Cerrato;153;85;68;2022
34;Palencia;088;Husillos;371;196;175;2022
34;Palencia;089;Itero de la Vega;150;86;64;2022
34;Palencia;091;Lagartos;126;72;54;2022
34;Palencia;092;Lantadilla;288;154;134;2022
34;Palencia;094;Ledigos;64;31;33;2022
34;Palencia;903;Loma de Ucieza;189;115;74;2022
34;Palencia;096;Lomas;44;29;15;2022
34;Palencia;098;Magaz de Pisuerga;1010;528;482;2022
34;Palencia;099;Manquillos;52;35;17;2022
34;Palencia;100;Mantinos;141;83;58;2022
34;Palencia;101;Marcilla de Campos;48;22;26;2022
34;Palencia;102;Mazariegos;212;129;83;2022
34;Palencia;103;Mazuecos de Valdeginate;90;57;33;2022
34;Palencia;104;Melgar de Yuso;255;145;110;2022
34;Palencia;106;Meneses de Campos;104;57;47;2022
34;Palencia;107;Micieces de Ojeda;72;43;29;2022
34;Palencia;108;Monzón de Campos;594;314;280;2022
34;Palencia;109;Moratinos;63;35;28;2022
34;Palencia;110;Mudá;80;47;33;2022
34;Palencia;112;Nogal de las Huertas;40;23;17;2022
34;Palencia;113;Olea de Boedo;37;14;23;2022
34;Palencia;114;Olmos de Ojeda;195;121;74;2022
34;Palencia;116;Osornillo;56;31;25;2022
34;Palencia;901;Osorno la Mayor;1159;604;555;2022
34;Palencia;120;Palencia;76302;35937;40365;2022
34;Palencia;121;Palenzuela;212;120;92;2022
34;Palencia;122;Páramo de Boedo;105;63;42;2022
34;Palencia;123;Paredes de Nava;1899;975;924;2022
34;Palencia;124;Payo de Ojeda;63;39;24;2022
34;Palencia;125;Pedraza de Campos;76;42;34;2022
34;Palencia;126;Pedrosa de la Vega;298;168;130;2022
34;Palencia;127;Perales;103;49;54;2022
34;Palencia;904;Pernía, La;316;185;131;2022
34;Palencia;129;Pino del Río;169;102;67;2022
34;Palencia;130;Piña de Campos;199;106;93;2022
34;Palencia;131;Población de Arroyo;52;28;24;2022
34;Palencia;132;Población de Campos;132;76;56;2022
34;Palencia;133;Población de Cerrato;107;62;45;2022
34;Palencia;134;Polentinos;47;24;23;2022
34;Palencia;135;Pomar de Valdivia;477;262;215;2022
34;Palencia;136;Poza de la Vega;167;97;70;2022
34;Palencia;137;Pozo de Urama;20;14;6;2022
34;Palencia;139;Prádanos de Ojeda;178;99;79;2022
34;Palencia;140;Puebla de Valdavia, La;86;47;39;2022
34;Palencia;141;Quintana del Puente;290;158;132;2022
34;Palencia;143;Quintanilla de Onsoña;180;100;80;2022
34;Palencia;146;Reinoso de Cerrato;56;35;21;2022
34;Palencia;147;Renedo de la Vega;198;106;92;2022
34;Palencia;149;Requena de Campos;24;13;11;2022
34;Palencia;151;Respenda de la Peña;146;90;56;2022
34;Palencia;152;Revenga de Campos;142;70;72;2022
34;Palencia;154;Revilla de Collazos;80;45;35;2022
34;Palencia;155;Ribas de Campos;147;75;72;2022
34;Palencia;156;Riberos de la Cueza;57;35;22;2022
34;Palencia;157;Saldaña;2905;1495;1410;2022
34;Palencia;158;Salinas de Pisuerga;313;165;148;2022
34;Palencia;159;San Cebrián de Campos;424;244;180;2022
34;Palencia;160;San Cebrián de Mudá;151;84;67;2022
34;Palencia;161;San Cristóbal de Boedo;23;15;8;2022
34;Palencia;163;San Mamés de Campos;43;22;21;2022
34;Palencia;165;San Román de la Cuba;59;35;24;2022
34;Palencia;167;Santa Cecilia del Alcor;105;61;44;2022
34;Palencia;168;Santa Cruz de Boedo;50;31;19;2022
34;Palencia;169;Santervás de la Vega;420;237;183;2022
34;Palencia;170;Santibáñez de Ecla;48;26;22;2022
34;Palencia;171;Santibáñez de la Peña;978;479;499;2022
34;Palencia;174;Santoyo;187;103;84;2022
34;Palencia;175;Serna, La;89;56;33;2022
34;Palencia;177;Soto de Cerrato;187;106;81;2022
34;Palencia;176;Sotobañado y Priorato;155;90;65;2022
34;Palencia;178;Tabanera de Cerrato;141;75;66;2022
34;Palencia;179;Tabanera de Valdavia;23;14;9;2022
34;Palencia;180;Támara de Campos;73;39;34;2022
34;Palencia;181;Tariego de Cerrato;478;255;223;2022
34;Palencia;182;Torquemada;948;512;436;2022
34;Palencia;184;Torremormojón;44;26;18;2022
34;Palencia;185;Triollo;75;43;32;2022
34;Palencia;186;Valbuena de Pisuerga;50;25;25;2022
34;Palencia;189;Valdeolmillos;55;31;24;2022
34;Palencia;190;Valderrábano;47;25;22;2022
34;Palencia;192;Valde-Ucieza;84;53;31;2022
34;Palencia;196;Valle de Cerrato;89;52;37;2022
34;Palencia;902;Valle del Retortillo;178;95;83;2022
34;Palencia;199;Velilla del Río Carrión;1173;602;571;2022
34;Palencia;023;Venta de Baños;6324;3197;3127;2022
34;Palencia;201;Vertavillo;167;87;80;2022
34;Palencia;093;Vid de Ojeda, La;87;53;34;2022
34;Palencia;202;Villabasta de Valdavia;34;20;14;2022
34;Palencia;204;Villacidaler;46;27;19;2022
34;Palencia;205;Villaconancio;57;34;23;2022
34;Palencia;206;Villada;875;442;433;2022
34;Palencia;208;Villaeles de Valdavia;51;32;19;2022
34;Palencia;210;Villahán;97;55;42;2022
34;Palencia;211;Villaherreros;226;120;106;2022
34;Palencia;213;Villalaco;59;33;26;2022
34;Palencia;214;Villalba de Guardo;200;106;94;2022
34;Palencia;215;Villalcázar de Sirga;175;90;85;2022
34;Palencia;216;Villalcón;58;33;25;2022
34;Palencia;217;Villalobón;1826;911;915;2022
34;Palencia;218;Villaluenga de la Vega;553;322;231;2022
34;Palencia;220;Villamartín de Campos;181;98;83;2022
34;Palencia;221;Villamediana;184;108;76;2022
34;Palencia;222;Villameriel;109;62;47;2022
34;Palencia;223;Villamoronta;242;143;99;2022
34;Palencia;224;Villamuera de la Cueza;38;25;13;2022
34;Palencia;225;Villamuriel de Cerrato;6485;3341;3144;2022
34;Palencia;227;Villanueva del Rebollar;65;34;31;2022
34;Palencia;228;Villanuño de Valdavia;94;52;42;2022
34;Palencia;229;Villaprovedo;50;34;16;2022
34;Palencia;230;Villarmentero de Campos;19;12;7;2022
34;Palencia;231;Villarrabé;186;100;86;2022
34;Palencia;232;Villarramiel;795;422;373;2022
34;Palencia;233;Villasarracino;127;77;50;2022
34;Palencia;234;Villasila de Valdavia;64;43;21;2022
34;Palencia;236;Villaturde;154;83;71;2022
34;Palencia;237;Villaumbrales;650;322;328;2022
34;Palencia;238;Villaviudas;361;169;192;2022
34;Palencia;240;Villerías de Campos;82;41;41;2022
34;Palencia;241;Villodre;17;10;7;2022
34;Palencia;242;Villodrigo;100;52;48;2022
34;Palencia;243;Villoldo;335;177;158;2022
34;Palencia;245;Villota del Páramo;307;177;130;2022
34;Palencia;246;Villovieco;68;36;32;2022
35;Palmas, Las;001;Agaete;5633;2841;2792;2022
35;Palmas, Las;002;Agüimes;32067;16164;15903;2022
35;Palmas, Las;020;Aldea de San Nicolás, La;7536;3895;3641;2022
35;Palmas, Las;003;Antigua;12940;6801;6139;2022
35;Palmas, Las;004;Arrecife;63750;31987;31763;2022
35;Palmas, Las;005;Artenara;1030;594;436;2022
35;Palmas, Las;006;Arucas;38369;19054;19315;2022
35;Palmas, Las;007;Betancuria;789;412;377;2022
35;Palmas, Las;008;Firgas;7581;3836;3745;2022
35;Palmas, Las;009;Gáldar;24567;12299;12268;2022
35;Palmas, Las;010;Haría;5382;2755;2627;2022
35;Palmas, Las;011;Ingenio;31932;16054;15878;2022
35;Palmas, Las;012;Mogán;20331;10452;9879;2022
35;Palmas, Las;013;Moya;7870;4001;3869;2022
35;Palmas, Las;014;Oliva, La;27945;14474;13471;2022
35;Palmas, Las;015;Pájara;20751;10782;9969;2022
35;Palmas, Las;016;Palmas de Gran Canaria, Las;378797;182267;196530;2022
35;Palmas, Las;017;Puerto del Rosario;42024;21078;20946;2022
35;Palmas, Las;018;San Bartolomé;18989;9439;9550;2022
35;Palmas, Las;019;San Bartolomé de Tirajana;52936;27721;25215;2022
35;Palmas, Las;021;Santa Brígida;18341;9172;9169;2022
35;Palmas, Las;022;Santa Lucía de Tirajana;74560;37048;37512;2022
35;Palmas, Las;023;Santa María de Guía de Gran Canaria;13838;6903;6935;2022
35;Palmas, Las;024;Teguise;23411;11736;11675;2022
35;Palmas, Las;025;Tejeda;1813;992;821;2022
35;Palmas, Las;026;Telde;102472;50312;52160;2022
35;Palmas, Las;027;Teror;12667;6489;6178;2022
35;Palmas, Las;028;Tías;21083;10724;10359;2022
35;Palmas, Las;029;Tinajo;6573;3356;3217;2022
35;Palmas, Las;030;Tuineje;15572;7908;7664;2022
35;Palmas, Las;032;Valleseco;3750;1958;1792;2022
35;Palmas, Las;031;Valsequillo de Gran Canaria;9490;4770;4720;2022
35;Palmas, Las;033;Vega de San Mateo;7682;3946;3736;2022
35;Palmas, Las;034;Yaiza;16924;8744;8180;2022
36;Pontevedra;020;Agolada;2252;1124;1128;2022
36;Pontevedra;001;Arbo;2622;1362;1260;2022
36;Pontevedra;003;Baiona;12349;6083;6266;2022
36;Pontevedra;002;Barro;3637;1784;1853;2022
36;Pontevedra;004;Bueu;11978;5883;6095;2022
36;Pontevedra;005;Caldas de Reis;9678;4672;5006;2022
36;Pontevedra;006;Cambados;13671;6595;7076;2022
36;Pontevedra;007;Campo Lameiro;1721;817;904;2022
36;Pontevedra;008;Cangas;26832;13325;13507;2022
36;Pontevedra;009;Cañiza, A;5115;2512;2603;2022
36;Pontevedra;010;Catoira;3295;1597;1698;2022
36;Pontevedra;902;Cerdedo-Cotobade;5697;2771;2926;2022
36;Pontevedra;013;Covelo;2480;1283;1197;2022
36;Pontevedra;014;Crecente;1937;942;995;2022
36;Pontevedra;015;Cuntis;4592;2182;2410;2022
36;Pontevedra;016;Dozón;1028;529;499;2022
36;Pontevedra;017;Estrada, A;20106;9680;10426;2022
36;Pontevedra;018;Forcarei;3194;1533;1661;2022
36;Pontevedra;019;Fornelos de Montes;1621;779;842;2022
36;Pontevedra;021;Gondomar;14970;7469;7501;2022
36;Pontevedra;022;Grove, O;10809;5314;5495;2022
36;Pontevedra;023;Guarda, A;10013;4932;5081;2022
36;Pontevedra;901;Illa de Arousa, A;4878;2404;2474;2022
36;Pontevedra;024;Lalín;20201;9859;10342;2022
36;Pontevedra;025;Lama, A;2499;1253;1246;2022
36;Pontevedra;026;Marín;24034;11918;12116;2022
36;Pontevedra;027;Meaño;5292;2575;2717;2022
36;Pontevedra;028;Meis;4735;2285;2450;2022
36;Pontevedra;029;Moaña;19474;9455;10019;2022
36;Pontevedra;030;Mondariz;4448;2210;2238;2022
36;Pontevedra;031;Mondariz-Balneario;680;346;334;2022
36;Pontevedra;032;Moraña;4133;2005;2128;2022
36;Pontevedra;033;Mos;15199;7522;7677;2022
36;Pontevedra;034;Neves, As;3746;1844;1902;2022
36;Pontevedra;035;Nigrán;18054;8868;9186;2022
36;Pontevedra;036;Oia;3080;1522;1558;2022
36;Pontevedra;037;Pazos de Borbén;2998;1469;1529;2022
36;Pontevedra;041;Poio;17276;8541;8735;2022
36;Pontevedra;043;Ponte Caldelas;5575;2676;2899;2022
36;Pontevedra;042;Ponteareas;23049;11152;11897;2022
36;Pontevedra;044;Pontecesures;3079;1513;1566;2022
36;Pontevedra;038;Pontevedra;82828;39139;43689;2022
36;Pontevedra;039;Porriño, O;20408;10023;10385;2022
36;Pontevedra;040;Portas;2851;1374;1477;2022
36;Pontevedra;045;Redondela;29055;14052;15003;2022
36;Pontevedra;046;Ribadumia;5193;2542;2651;2022
36;Pontevedra;047;Rodeiro;2317;1151;1166;2022
36;Pontevedra;048;Rosal, O;6450;3153;3297;2022
36;Pontevedra;049;Salceda de Caselas;9380;4680;4700;2022
36;Pontevedra;050;Salvaterra de Miño;10079;5017;5062;2022
36;Pontevedra;051;Sanxenxo;17760;8793;8967;2022
36;Pontevedra;052;Silleda;8860;4325;4535;2022
36;Pontevedra;053;Soutomaior;7543;3758;3785;2022
36;Pontevedra;054;Tomiño;13779;6934;6845;2022
36;Pontevedra;055;Tui;17375;8476;8899;2022
36;Pontevedra;056;Valga;5752;2807;2945;2022
36;Pontevedra;057;Vigo;292374;137820;154554;2022
36;Pontevedra;059;Vila de Cruces;5063;2521;2542;2022
36;Pontevedra;058;Vilaboa;6004;2951;3053;2022
36;Pontevedra;060;Vilagarcía de Arousa;37677;18020;19657;2022
36;Pontevedra;061;Vilanova de Arousa;10240;4961;5279;2022
26;Rioja, La;001;Ábalos;260;149;111;2022
26;Rioja, La;002;Agoncillo;1175;648;527;2022
26;Rioja, La;003;Aguilar del Río Alhama;442;231;211;2022
26;Rioja, La;004;Ajamil de Cameros;68;46;22;2022
26;Rioja, La;005;Albelda de Iregua;3591;1840;1751;2022
26;Rioja, La;006;Alberite;2582;1319;1263;2022
26;Rioja, La;007;Alcanadre;647;332;315;2022
26;Rioja, La;008;Aldeanueva de Ebro;2786;1451;1335;2022
26;Rioja, La;009;Alesanco;481;254;227;2022
26;Rioja, La;010;Alesón;90;51;39;2022
26;Rioja, La;011;Alfaro;9727;4880;4847;2022
26;Rioja, La;012;Almarza de Cameros;37;23;14;2022
26;Rioja, La;013;Anguciana;446;248;198;2022
26;Rioja, La;014;Anguiano;524;286;238;2022
26;Rioja, La;015;Arenzana de Abajo;267;137;130;2022
26;Rioja, La;016;Arenzana de Arriba;36;24;12;2022
26;Rioja, La;017;Arnedillo;450;219;231;2022
26;Rioja, La;018;Arnedo;15017;7509;7508;2022
26;Rioja, La;019;Arrúbal;568;305;263;2022
26;Rioja, La;020;Ausejo;786;418;368;2022
26;Rioja, La;021;Autol;4788;2404;2384;2022
26;Rioja, La;022;Azofra;209;116;93;2022
26;Rioja, La;023;Badarán;500;254;246;2022
26;Rioja, La;024;Bañares;206;109;97;2022
26;Rioja, La;026;Baños de Río Tobía;1589;805;784;2022
26;Rioja, La;025;Baños de Rioja;82;49;33;2022
26;Rioja, La;027;Berceo;143;90;53;2022
26;Rioja, La;028;Bergasa;160;88;72;2022
26;Rioja, La;029;Bergasillas Bajera;33;17;16;2022
26;Rioja, La;030;Bezares;25;12;13;2022
26;Rioja, La;031;Bobadilla;93;48;45;2022
26;Rioja, La;032;Brieva de Cameros;46;30;16;2022
26;Rioja, La;033;Briñas;190;89;101;2022
26;Rioja, La;034;Briones;722;381;341;2022
26;Rioja, La;035;Cabezón de Cameros;19;12;7;2022
26;Rioja, La;036;Calahorra;24654;12093;12561;2022
26;Rioja, La;037;Camprovín;171;94;77;2022
26;Rioja, La;038;Canales de la Sierra;83;55;28;2022
26;Rioja, La;039;Canillas de Río Tuerto;40;22;18;2022
26;Rioja, La;040;Cañas;89;48;41;2022
26;Rioja, La;041;Cárdenas;128;70;58;2022
26;Rioja, La;042;Casalarreina;1074;531;543;2022
26;Rioja, La;043;Castañares de Rioja;395;188;207;2022
26;Rioja, La;044;Castroviejo;48;28;20;2022
26;Rioja, La;045;Cellorigo;9;4;5;2022
26;Rioja, La;046;Cenicero;2073;1069;1004;2022
26;Rioja, La;047;Cervera del Río Alhama;2273;1187;1086;2022
26;Rioja, La;048;Cidamón;23;12;11;2022
26;Rioja, La;049;Cihuri;186;95;91;2022
26;Rioja, La;050;Cirueña;194;122;72;2022
26;Rioja, La;051;Clavijo;300;173;127;2022
26;Rioja, La;052;Cordovín;153;75;78;2022
26;Rioja, La;053;Corera;286;146;140;2022
26;Rioja, La;054;Cornago;310;179;131;2022
26;Rioja, La;055;Corporales;36;23;13;2022
26;Rioja, La;056;Cuzcurrita de Río Tirón;526;283;243;2022
26;Rioja, La;057;Daroca de Rioja;56;35;21;2022
26;Rioja, La;058;Enciso;172;110;62;2022
26;Rioja, La;059;Entrena;1632;855;777;2022
26;Rioja, La;060;Estollo;82;51;31;2022
26;Rioja, La;061;Ezcaray;2055;1076;979;2022
26;Rioja, La;062;Foncea;93;55;38;2022
26;Rioja, La;063;Fonzaleche;138;89;49;2022
26;Rioja, La;064;Fuenmayor;3227;1629;1598;2022
26;Rioja, La;065;Galbárruli;75;47;28;2022
26;Rioja, La;066;Galilea;387;197;190;2022
26;Rioja, La;067;Gallinero de Cameros;17;10;7;2022
26;Rioja, La;068;Gimileo;109;60;49;2022
26;Rioja, La;069;Grañón;250;137;113;2022
26;Rioja, La;070;Grávalos;178;98;80;2022
26;Rioja, La;071;Haro;11634;5754;5880;2022
26;Rioja, La;072;Herce;321;164;157;2022
26;Rioja, La;073;Herramélluri;104;57;47;2022
26;Rioja, La;074;Hervías;127;67;60;2022
26;Rioja, La;075;Hormilla;443;231;212;2022
26;Rioja, La;076;Hormilleja;132;66;66;2022
26;Rioja, La;077;Hornillos de Cameros;23;15;8;2022
26;Rioja, La;078;Hornos de Moncalvillo;95;54;41;2022
26;Rioja, La;079;Huércanos;860;476;384;2022
26;Rioja, La;080;Igea;639;359;280;2022
26;Rioja, La;081;Jalón de Cameros;22;10;12;2022
26;Rioja, La;082;Laguna de Cameros;109;64;45;2022
26;Rioja, La;083;Lagunilla del Jubera;334;181;153;2022
26;Rioja, La;084;Lardero;11094;5572;5522;2022
26;Rioja, La;086;Ledesma de la Cogolla;16;12;4;2022
26;Rioja, La;087;Leiva;238;117;121;2022
26;Rioja, La;088;Leza de Río Leza;40;22;18;2022
26;Rioja, La;089;Logroño;150020;71044;78976;2022
26;Rioja, La;091;Lumbreras de Cameros;144;103;41;2022
26;Rioja, La;092;Manjarrés;110;65;45;2022
26;Rioja, La;093;Mansilla de la Sierra;52;39;13;2022
26;Rioja, La;094;Manzanares de Rioja;58;35;23;2022
26;Rioja, La;095;Matute;93;55;38;2022
26;Rioja, La;096;Medrano;339;181;158;2022
26;Rioja, La;098;Munilla;109;60;49;2022
26;Rioja, La;099;Murillo de Río Leza;1609;819;790;2022
26;Rioja, La;100;Muro de Aguas;63;40;23;2022
26;Rioja, La;101;Muro en Cameros;35;19;16;2022
26;Rioja, La;102;Nájera;8069;3971;4098;2022
26;Rioja, La;103;Nalda;1210;658;552;2022
26;Rioja, La;104;Navajún;9;7;2;2022
26;Rioja, La;105;Navarrete;3016;1506;1510;2022
26;Rioja, La;106;Nestares;87;50;37;2022
26;Rioja, La;107;Nieva de Cameros;86;56;30;2022
26;Rioja, La;109;Ochánduri;79;47;32;2022
26;Rioja, La;108;Ocón;315;192;123;2022
26;Rioja, La;110;Ojacastro;187;111;76;2022
26;Rioja, La;111;Ollauri;311;165;146;2022
26;Rioja, La;112;Ortigosa de Cameros;219;136;83;2022
26;Rioja, La;113;Pazuengos;27;22;5;2022
26;Rioja, La;114;Pedroso;89;55;34;2022
26;Rioja, La;115;Pinillos;21;10;11;2022
26;Rioja, La;117;Pradejón;3853;1996;1857;2022
26;Rioja, La;118;Pradillo;65;35;30;2022
26;Rioja, La;119;Préjano;204;113;91;2022
26;Rioja, La;120;Quel;2088;1105;983;2022
26;Rioja, La;121;Rabanera;31;23;8;2022
26;Rioja, La;122;Rasillo de Cameros, El;145;81;64;2022
26;Rioja, La;123;Redal, El;150;85;65;2022
26;Rioja, La;124;Ribafrecha;1027;534;493;2022
26;Rioja, La;125;Rincón de Soto;3942;2045;1897;2022
26;Rioja, La;126;Robres del Castillo;26;17;9;2022
26;Rioja, La;127;Rodezno;212;119;93;2022
26;Rioja, La;128;Sajazarra;124;71;53;2022
26;Rioja, La;129;San Asensio;1113;590;523;2022
26;Rioja, La;130;San Millán de la Cogolla;216;143;73;2022
26;Rioja, La;131;San Millán de Yécora;34;24;10;2022
26;Rioja, La;132;San Román de Cameros;126;81;45;2022
26;Rioja, La;139;San Torcuato;69;37;32;2022
26;Rioja, La;142;San Vicente de la Sonsierra;1031;534;497;2022
26;Rioja, La;134;Santa Coloma;92;56;36;2022
26;Rioja, La;135;Santa Engracia del Jubera;181;111;70;2022
26;Rioja, La;136;Santa Eulalia Bajera;111;64;47;2022
26;Rioja, La;138;Santo Domingo de la Calzada;6242;3123;3119;2022
26;Rioja, La;140;Santurde de Rioja;277;148;129;2022
26;Rioja, La;141;Santurdejo;100;61;39;2022
26;Rioja, La;143;Sojuela;570;312;258;2022
26;Rioja, La;144;Sorzano;225;124;101;2022
26;Rioja, La;145;Sotés;267;148;119;2022
26;Rioja, La;146;Soto en Cameros;81;47;34;2022
26;Rioja, La;147;Terroba;37;18;19;2022
26;Rioja, La;148;Tirgo;178;90;88;2022
26;Rioja, La;149;Tobía;50;27;23;2022
26;Rioja, La;150;Tormantos;114;63;51;2022
26;Rioja, La;153;Torre en Cameros;10;8;2;2022
26;Rioja, La;151;Torrecilla en Cameros;427;237;190;2022
26;Rioja, La;152;Torrecilla sobre Alesanco;48;29;19;2022
26;Rioja, La;154;Torremontalbo;9;8;1;2022
26;Rioja, La;155;Treviana;144;74;70;2022
26;Rioja, La;157;Tricio;371;184;187;2022
26;Rioja, La;158;Tudelilla;320;173;147;2022
26;Rioja, La;160;Uruñuela;984;502;482;2022
26;Rioja, La;161;Valdemadera;13;9;4;2022
26;Rioja, La;162;Valgañón;141;81;60;2022
26;Rioja, La;163;Ventosa;205;106;99;2022
26;Rioja, La;164;Ventrosa;53;32;21;2022
26;Rioja, La;165;Viguera;390;221;169;2022
26;Rioja, La;166;Villalba de Rioja;162;97;65;2022
26;Rioja, La;167;Villalobar de Rioja;67;48;19;2022
26;Rioja, La;168;Villamediana de Iregua;8745;4406;4339;2022
26;Rioja, La;169;Villanueva de Cameros;72;44;28;2022
26;Rioja, La;170;Villar de Arnedo, El;593;319;274;2022
26;Rioja, La;171;Villar de Torre;162;100;62;2022
26;Rioja, La;172;Villarejo;34;25;9;2022
26;Rioja, La;173;Villarroya;5;3;2;2022
26;Rioja, La;174;Villarta-Quintana;136;79;57;2022
26;Rioja, La;175;Villavelayo;40;26;14;2022
26;Rioja, La;176;Villaverde de Rioja;55;32;23;2022
26;Rioja, La;177;Villoslada de Cameros;351;228;123;2022
26;Rioja, La;178;Viniegra de Abajo;79;51;28;2022
26;Rioja, La;179;Viniegra de Arriba;39;26;13;2022
26;Rioja, La;180;Zarratón;258;137;121;2022
26;Rioja, La;181;Zarzosa;12;9;3;2022
26;Rioja, La;183;Zorraquín;91;45;46;2022
37;Salamanca;001;Abusejo;161;84;77;2022
37;Salamanca;002;Agallas;131;69;62;2022
37;Salamanca;003;Ahigal de los Aceiteros;101;56;45;2022
37;Salamanca;004;Ahigal de Villarino;27;15;12;2022
37;Salamanca;005;Alameda de Gardón, La;70;35;35;2022
37;Salamanca;006;Alamedilla, La;117;60;57;2022
37;Salamanca;007;Alaraz;449;237;212;2022
37;Salamanca;008;Alba de Tormes;5092;2563;2529;2022
37;Salamanca;009;Alba de Yeltes;211;117;94;2022
37;Salamanca;010;Alberca, La;1071;524;547;2022
37;Salamanca;011;Alberguería de Argañán, La;105;55;50;2022
37;Salamanca;012;Alconada;142;77;65;2022
37;Salamanca;015;Aldea del Obispo;275;151;124;2022
37;Salamanca;013;Aldeacipreste;98;53;45;2022
37;Salamanca;014;Aldeadávila de la Ribera;1159;574;585;2022
37;Salamanca;016;Aldealengua;674;337;337;2022
37;Salamanca;017;Aldeanueva de Figueroa;239;129;110;2022
37;Salamanca;018;Aldeanueva de la Sierra;106;66;40;2022
37;Salamanca;019;Aldearrodrigo;148;81;67;2022
37;Salamanca;020;Aldearrubia;524;284;240;2022
37;Salamanca;021;Aldeaseca de Alba;72;38;34;2022
37;Salamanca;022;Aldeaseca de la Frontera;251;129;122;2022
37;Salamanca;023;Aldeatejada;2417;1224;1193;2022
37;Salamanca;024;Aldeavieja de Tormes;104;56;48;2022
37;Salamanca;025;Aldehuela de la Bóveda;285;154;131;2022
37;Salamanca;026;Aldehuela de Yeltes;191;101;90;2022
37;Salamanca;027;Almenara de Tormes;303;167;136;2022
37;Salamanca;028;Almendra;135;77;58;2022
37;Salamanca;029;Anaya de Alba;185;109;76;2022
37;Salamanca;030;Añover de Tormes;89;47;42;2022
37;Salamanca;031;Arabayona de Mógica;338;191;147;2022
37;Salamanca;032;Arapiles;693;371;322;2022
37;Salamanca;033;Arcediano;97;50;47;2022
37;Salamanca;034;Arco, El;91;45;46;2022
37;Salamanca;035;Armenteros;182;111;71;2022
37;Salamanca;037;Atalaya, La;104;59;45;2022
37;Salamanca;038;Babilafuente;936;490;446;2022
37;Salamanca;039;Bañobárez;286;146;140;2022
37;Salamanca;040;Barbadillo;409;220;189;2022
37;Salamanca;041;Barbalos;74;42;32;2022
37;Salamanca;042;Barceo;48;29;19;2022
37;Salamanca;044;Barruecopardo;422;235;187;2022
37;Salamanca;045;Bastida, La;31;18;13;2022
37;Salamanca;046;Béjar;12099;5726;6373;2022
37;Salamanca;047;Beleña;215;114;101;2022
37;Salamanca;049;Bermellar;121;64;57;2022
37;Salamanca;050;Berrocal de Huebra;77;43;34;2022
37;Salamanca;051;Berrocal de Salvatierra;79;44;35;2022
37;Salamanca;052;Boada;283;146;137;2022
37;Salamanca;054;Bodón, El;251;137;114;2022
37;Salamanca;055;Bogajo;136;74;62;2022
37;Salamanca;056;Bouza, La;57;25;32;2022
37;Salamanca;057;Bóveda del Río Almar;215;117;98;2022
37;Salamanca;058;Brincones;51;27;24;2022
37;Salamanca;059;Buenamadre;119;60;59;2022
37;Salamanca;060;Buenavista;356;192;164;2022
37;Salamanca;061;Cabaco, El;232;123;109;2022
37;Salamanca;063;Cabeza de Béjar, La;57;36;21;2022
37;Salamanca;065;Cabeza del Caballo;247;138;109;2022
37;Salamanca;062;Cabezabellosa de la Calzada;72;42;30;2022
37;Salamanca;067;Cabrerizos;4276;2129;2147;2022
37;Salamanca;068;Cabrillas;333;168;165;2022
37;Salamanca;069;Calvarrasa de Abajo;1173;606;567;2022
37;Salamanca;070;Calvarrasa de Arriba;590;317;273;2022
37;Salamanca;071;Calzada de Béjar, La;87;51;36;2022
37;Salamanca;072;Calzada de Don Diego;140;76;64;2022
37;Salamanca;073;Calzada de Valdunciel;706;356;350;2022
37;Salamanca;074;Campillo de Azaba;146;87;59;2022
37;Salamanca;077;Campo de Peñaranda, El;263;153;110;2022
37;Salamanca;078;Candelario;871;445;426;2022
37;Salamanca;079;Canillas de Abajo;78;52;26;2022
37;Salamanca;080;Cantagallo;275;143;132;2022
37;Salamanca;081;Cantalapiedra;904;460;444;2022
37;Salamanca;082;Cantalpino;803;433;370;2022
37;Salamanca;083;Cantaracillo;193;106;87;2022
37;Salamanca;085;Carbajosa de la Sagrada;7424;3696;3728;2022
37;Salamanca;086;Carpio de Azaba;115;63;52;2022
37;Salamanca;087;Carrascal de Barregas;1356;700;656;2022
37;Salamanca;088;Carrascal del Obispo;193;106;87;2022
37;Salamanca;089;Casafranca;59;30;29;2022
37;Salamanca;090;Casas del Conde, Las;64;29;35;2022
37;Salamanca;091;Casillas de Flores;185;87;98;2022
37;Salamanca;092;Castellanos de Moriscos;2918;1507;1411;2022
37;Salamanca;185;Castellanos de Villiquera;673;360;313;2022
37;Salamanca;096;Castillejo de Martín Viejo;215;129;86;2022
37;Salamanca;097;Castraz;36;23;13;2022
37;Salamanca;098;Cepeda;290;149;141;2022
37;Salamanca;099;Cereceda de la Sierra;65;33;32;2022
37;Salamanca;100;Cerezal de Peñahorcada;71;36;35;2022
37;Salamanca;101;Cerralbo;126;69;57;2022
37;Salamanca;102;Cerro, El;380;195;185;2022
37;Salamanca;103;Cespedosa de Tormes;509;274;235;2022
37;Salamanca;114;Chagarcía Medianero;62;34;28;2022
37;Salamanca;104;Cilleros de la Bastida;23;12;11;2022
37;Salamanca;106;Cipérez;247;129;118;2022
37;Salamanca;107;Ciudad Rodrigo;11973;5744;6229;2022
37;Salamanca;108;Coca de Alba;104;55;49;2022
37;Salamanca;109;Colmenar de Montemayor;175;103;72;2022
37;Salamanca;110;Cordovilla;109;60;49;2022
37;Salamanca;112;Cristóbal;169;99;70;2022
37;Salamanca;113;Cubo de Don Sancho, El;412;213;199;2022
37;Salamanca;115;Dios le Guarde;117;62;55;2022
37;Salamanca;116;Doñinos de Ledesma;64;32;32;2022
37;Salamanca;117;Doñinos de Salamanca;2251;1184;1067;2022
37;Salamanca;118;Éjeme;126;74;52;2022
37;Salamanca;120;Encina de San Silvestre;115;54;61;2022
37;Salamanca;119;Encina, La;101;58;43;2022
37;Salamanca;121;Encinas de Abajo;611;320;291;2022
37;Salamanca;122;Encinas de Arriba;235;117;118;2022
37;Salamanca;123;Encinasola de los Comendadores;156;88;68;2022
37;Salamanca;124;Endrinal;205;115;90;2022
37;Salamanca;125;Escurial de la Sierra;232;128;104;2022
37;Salamanca;126;Espadaña;33;21;12;2022
37;Salamanca;127;Espeja;219;119;100;2022
37;Salamanca;128;Espino de la Orbada;253;140;113;2022
37;Salamanca;129;Florida de Liébana;243;136;107;2022
37;Salamanca;130;Forfoleda;198;113;85;2022
37;Salamanca;131;Frades de la Sierra;180;99;81;2022
37;Salamanca;132;Fregeneda, La;314;154;160;2022
37;Salamanca;133;Fresnedoso;99;56;43;2022
37;Salamanca;134;Fresno Alhándiga;194;106;88;2022
37;Salamanca;135;Fuente de San Esteban, La;1280;646;634;2022
37;Salamanca;136;Fuenteguinaldo;667;327;340;2022
37;Salamanca;137;Fuenteliante;91;45;46;2022
37;Salamanca;138;Fuenterroble de Salvatierra;260;134;126;2022
37;Salamanca;139;Fuentes de Béjar;223;116;107;2022
37;Salamanca;140;Fuentes de Oñoro;1113;604;509;2022
37;Salamanca;141;Gajates;142;70;72;2022
37;Salamanca;142;Galindo y Perahuy;659;371;288;2022
37;Salamanca;143;Galinduste;404;195;209;2022
37;Salamanca;144;Galisancho;346;189;157;2022
37;Salamanca;145;Gallegos de Argañán;257;128;129;2022
37;Salamanca;146;Gallegos de Solmirón;116;67;49;2022
37;Salamanca;147;Garcibuey;193;110;83;2022
37;Salamanca;148;Garcihernández;426;221;205;2022
37;Salamanca;149;Garcirrey;56;32;24;2022
37;Salamanca;150;Gejuelo del Barro;34;20;14;2022
37;Salamanca;151;Golpejas;148;78;70;2022
37;Salamanca;152;Gomecello;407;216;191;2022
37;Salamanca;154;Guadramiro;134;83;51;2022
37;Salamanca;155;Guijo de Ávila;73;41;32;2022
37;Salamanca;156;Guijuelo;5495;2759;2736;2022
37;Salamanca;157;Herguijuela de Ciudad Rodrigo;69;41;28;2022
37;Salamanca;158;Herguijuela de la Sierra;234;131;103;2022
37;Salamanca;159;Herguijuela del Campo;68;36;32;2022
37;Salamanca;160;Hinojosa de Duero;612;316;296;2022
37;Salamanca;161;Horcajo de Montemayor;120;66;54;2022
37;Salamanca;162;Horcajo Medianero;223;115;108;2022
37;Salamanca;163;Hoya, La;28;18;10;2022
37;Salamanca;164;Huerta;278;154;124;2022
37;Salamanca;165;Iruelos;28;11;17;2022
37;Salamanca;166;Ituero de Azaba;209;109;100;2022
37;Salamanca;167;Juzbado;197;100;97;2022
37;Salamanca;168;Lagunilla;430;240;190;2022
37;Salamanca;169;Larrodrigo;188;109;79;2022
37;Salamanca;170;Ledesma;1528;750;778;2022
37;Salamanca;171;Ledrada;451;226;225;2022
37;Salamanca;172;Linares de Riofrío;935;519;416;2022
37;Salamanca;173;Lumbrales;1534;778;756;2022
37;Salamanca;175;Machacón;442;230;212;2022
37;Salamanca;174;Macotera;999;512;487;2022
37;Salamanca;176;Madroñal;140;79;61;2022
37;Salamanca;177;Maíllo, El;276;155;121;2022
37;Salamanca;178;Malpartida;90;47;43;2022
37;Salamanca;179;Mancera de Abajo;210;110;100;2022
37;Salamanca;180;Manzano, El;62;32;30;2022
37;Salamanca;181;Martiago;267;146;121;2022
37;Salamanca;183;Martín de Yeltes;400;203;197;2022
37;Salamanca;182;Martinamor;77;49;28;2022
37;Salamanca;184;Masueco;264;137;127;2022
37;Salamanca;186;Mata de Ledesma, La;106;60;46;2022
37;Salamanca;187;Matilla de los Caños del Río;644;316;328;2022
37;Salamanca;188;Maya, La;165;96;69;2022
37;Salamanca;189;Membribe de la Sierra;104;62;42;2022
37;Salamanca;190;Mieza;180;92;88;2022
37;Salamanca;191;Milano, El;95;59;36;2022
37;Salamanca;192;Miranda de Azán;457;248;209;2022
37;Salamanca;193;Miranda del Castañar;396;213;183;2022
37;Salamanca;194;Mogarraz;240;125;115;2022
37;Salamanca;195;Molinillo;43;25;18;2022
37;Salamanca;196;Monforte de la Sierra;59;29;30;2022
37;Salamanca;197;Monleón;94;56;38;2022
37;Salamanca;198;Monleras;228;113;115;2022
37;Salamanca;199;Monsagro;135;75;60;2022
37;Salamanca;200;Montejo;213;118;95;2022
37;Salamanca;201;Montemayor del Río;271;144;127;2022
37;Salamanca;202;Monterrubio de Armuña;1335;692;643;2022
37;Salamanca;203;Monterrubio de la Sierra;142;79;63;2022
37;Salamanca;204;Morasverdes;232;120;112;2022
37;Salamanca;205;Morille;224;120;104;2022
37;Salamanca;206;Moríñigo;89;47;42;2022
37;Salamanca;207;Moriscos;523;285;238;2022
37;Salamanca;208;Moronta;76;48;28;2022
37;Salamanca;209;Mozárbez;510;270;240;2022
37;Salamanca;211;Narros de Matalayegua;215;119;96;2022
37;Salamanca;213;Nava de Béjar;82;49;33;2022
37;Salamanca;214;Nava de Francia;125;68;57;2022
37;Salamanca;215;Nava de Sotrobal;164;96;68;2022
37;Salamanca;212;Navacarros;129;69;60;2022
37;Salamanca;216;Navales;315;170;145;2022
37;Salamanca;217;Navalmoral de Béjar;57;28;29;2022
37;Salamanca;218;Navamorales;42;27;15;2022
37;Salamanca;219;Navarredonda de la Rinconada;163;85;78;2022
37;Salamanca;221;Navasfrías;395;213;182;2022
37;Salamanca;222;Negrilla de Palencia;80;44;36;2022
37;Salamanca;223;Olmedo de Camaces;100;55;45;2022
37;Salamanca;224;Orbada, La;184;95;89;2022
37;Salamanca;225;Pajares de la Laguna;104;57;47;2022
37;Salamanca;226;Palacios del Arzobispo;159;81;78;2022
37;Salamanca;228;Palaciosrubios;322;169;153;2022
37;Salamanca;229;Palencia de Negrilla;147;89;58;2022
37;Salamanca;230;Parada de Arriba;262;135;127;2022
37;Salamanca;231;Parada de Rubiales;258;138;120;2022
37;Salamanca;232;Paradinas de San Juan;395;235;160;2022
37;Salamanca;233;Pastores;52;30;22;2022
37;Salamanca;234;Payo, El;305;150;155;2022
37;Salamanca;235;Pedraza de Alba;218;114;104;2022
37;Salamanca;236;Pedrosillo de Alba;124;71;53;2022
37;Salamanca;237;Pedrosillo de los Aires;322;189;133;2022
37;Salamanca;238;Pedrosillo el Ralo;127;64;63;2022
37;Salamanca;239;Pedroso de la Armuña, El;211;108;103;2022
37;Salamanca;240;Pelabravo;1284;684;600;2022
37;Salamanca;241;Pelarrodríguez;166;98;68;2022
37;Salamanca;242;Pelayos;76;46;30;2022
37;Salamanca;243;Peña, La;80;42;38;2022
37;Salamanca;244;Peñacaballera;142;70;72;2022
37;Salamanca;245;Peñaparda;326;165;161;2022
37;Salamanca;246;Peñaranda de Bracamonte;6099;2998;3101;2022
37;Salamanca;247;Peñarandilla;179;99;80;2022
37;Salamanca;248;Peralejos de Abajo;170;88;82;2022
37;Salamanca;249;Peralejos de Arriba;36;24;12;2022
37;Salamanca;250;Pereña de la Ribera;318;178;140;2022
37;Salamanca;251;Peromingo;121;57;64;2022
37;Salamanca;252;Pinedas;104;62;42;2022
37;Salamanca;253;Pino de Tormes, El;155;86;69;2022
37;Salamanca;254;Pitiegua;183;104;79;2022
37;Salamanca;255;Pizarral;49;31;18;2022
37;Salamanca;256;Poveda de las Cintas;205;117;88;2022
37;Salamanca;257;Pozos de Hinojo;57;31;26;2022
37;Salamanca;258;Puebla de Azaba;150;83;67;2022
37;Salamanca;259;Puebla de San Medel;38;22;16;2022
37;Salamanca;260;Puebla de Yeltes;148;80;68;2022
37;Salamanca;261;Puente del Congosto;213;123;90;2022
37;Salamanca;262;Puertas;68;40;28;2022
37;Salamanca;263;Puerto de Béjar;359;171;188;2022
37;Salamanca;264;Puerto Seguro;61;27;34;2022
37;Salamanca;265;Rágama;209;102;107;2022
37;Salamanca;266;Redonda, La;65;37;28;2022
37;Salamanca;267;Retortillo;180;92;88;2022
37;Salamanca;268;Rinconada de la Sierra, La;103;62;41;2022
37;Salamanca;269;Robleda;458;256;202;2022
37;Salamanca;270;Robliza de Cojos;199;107;92;2022
37;Salamanca;271;Rollán;346;186;160;2022
37;Salamanca;272;Saelices el Chico;171;98;73;2022
37;Salamanca;273;Sagrada, La;88;49;39;2022
37;Salamanca;303;Sahugo, El;176;96;80;2022
37;Salamanca;274;Salamanca;142412;64452;77960;2022
37;Salamanca;275;Saldeana;102;60;42;2022
37;Salamanca;276;Salmoral;116;68;48;2022
37;Salamanca;277;Salvatierra de Tormes;76;38;38;2022
37;Salamanca;278;San Cristóbal de la Cuesta;1069;558;511;2022
37;Salamanca;284;San Esteban de la Sierra;367;204;163;2022
37;Salamanca;285;San Felices de los Gallegos;355;191;164;2022
37;Salamanca;286;San Martín del Castañar;251;136;115;2022
37;Salamanca;287;San Miguel de Valero;332;172;160;2022
37;Salamanca;036;San Miguel del Robledo;51;29;22;2022
37;Salamanca;288;San Morales;345;189;156;2022
37;Salamanca;289;San Muñoz;210;106;104;2022
37;Salamanca;291;San Pedro de Rozados;277;156;121;2022
37;Salamanca;290;San Pedro del Valle;138;80;58;2022
37;Salamanca;292;San Pelayo de Guareña;98;57;41;2022
37;Salamanca;280;Sanchón de la Ribera;77;39;38;2022
37;Salamanca;281;Sanchón de la Sagrada;37;21;16;2022
37;Salamanca;282;Sanchotello;230;114;116;2022
37;Salamanca;279;Sancti-Spíritus;741;401;340;2022
37;Salamanca;283;Sando;120;69;51;2022
37;Salamanca;293;Santa María de Sando;99;51;48;2022
37;Salamanca;294;Santa Marta de Tormes;14661;7138;7523;2022
37;Salamanca;296;Santiago de la Puebla;297;155;142;2022
37;Salamanca;297;Santibáñez de Béjar;461;229;232;2022
37;Salamanca;298;Santibáñez de la Sierra;171;97;74;2022
37;Salamanca;299;Santiz;254;139;115;2022
37;Salamanca;300;Santos, Los;601;305;296;2022
37;Salamanca;301;Sardón de los Frailes;101;56;45;2022
37;Salamanca;302;Saucelle;266;134;132;2022
37;Salamanca;304;Sepulcro-Hilario;163;88;75;2022
37;Salamanca;305;Sequeros;235;112;123;2022
37;Salamanca;306;Serradilla del Arroyo;251;137;114;2022
37;Salamanca;307;Serradilla del Llano;144;78;66;2022
37;Salamanca;309;Sierpe, La;41;21;20;2022
37;Salamanca;310;Sieteiglesias de Tormes;184;87;97;2022
37;Salamanca;311;Sobradillo;193;100;93;2022
37;Salamanca;312;Sorihuela;259;131;128;2022
37;Salamanca;313;Sotoserrano;543;291;252;2022
37;Salamanca;314;Tabera de Abajo;105;58;47;2022
37;Salamanca;315;Tala, La;78;44;34;2022
37;Salamanca;316;Tamames;811;408;403;2022
37;Salamanca;317;Tarazona de Guareña;275;150;125;2022
37;Salamanca;318;Tardáguila;193;118;75;2022
37;Salamanca;319;Tejado, El;84;46;38;2022
37;Salamanca;320;Tejeda y Segoyuela;92;52;40;2022
37;Salamanca;321;Tenebrón;135;74;61;2022
37;Salamanca;322;Terradillos;3094;1539;1555;2022
37;Salamanca;323;Topas;512;268;244;2022
37;Salamanca;324;Tordillos;332;180;152;2022
37;Salamanca;325;Tornadizo, El;91;52;39;2022
37;Salamanca;327;Torresmenudas;192;105;87;2022
37;Salamanca;328;Trabanca;175;86;89;2022
37;Salamanca;329;Tremedal de Tormes;37;19;18;2022
37;Salamanca;330;Valdecarros;334;171;163;2022
37;Salamanca;331;Valdefuentes de Sangusín;192;107;85;2022
37;Salamanca;332;Valdehijaderos;79;45;34;2022
37;Salamanca;333;Valdelacasa;206;116;90;2022
37;Salamanca;334;Valdelageve;66;36;30;2022
37;Salamanca;335;Valdelosa;404;205;199;2022
37;Salamanca;336;Valdemierque;60;38;22;2022
37;Salamanca;337;Valderrodrigo;134;71;63;2022
37;Salamanca;338;Valdunciel;110;57;53;2022
37;Salamanca;339;Valero;297;167;130;2022
37;Salamanca;343;Vallejera de Riofrío;69;38;31;2022
37;Salamanca;340;Valsalabroso;125;69;56;2022
37;Salamanca;341;Valverde de Valdelacasa;61;31;30;2022
37;Salamanca;342;Valverdón;278;143;135;2022
37;Salamanca;344;Vecinos;237;117;120;2022
37;Salamanca;345;Vega de Tirados;160;81;79;2022
37;Salamanca;346;Veguillas, Las;278;137;141;2022
37;Salamanca;347;Vellés, La;505;273;232;2022
37;Salamanca;348;Ventosa del Río Almar;98;57;41;2022
37;Salamanca;349;Vídola, La;104;52;52;2022
37;Salamanca;351;Villaflores;258;130;128;2022
37;Salamanca;352;Villagonzalo de Tormes;228;138;90;2022
37;Salamanca;353;Villalba de los Llanos;120;71;49;2022
37;Salamanca;354;Villamayor;7402;3678;3724;2022
37;Salamanca;355;Villanueva del Conde;180;91;89;2022
37;Salamanca;356;Villar de Argañán;99;54;45;2022
37;Salamanca;357;Villar de Ciervo;263;140;123;2022
37;Salamanca;358;Villar de Gallimazo;201;137;64;2022
37;Salamanca;359;Villar de la Yegua;160;86;74;2022
37;Salamanca;360;Villar de Peralonso;207;110;97;2022
37;Salamanca;361;Villar de Samaniego;81;44;37;2022
37;Salamanca;362;Villares de la Reina;6494;3216;3278;2022
37;Salamanca;363;Villares de Yeltes;104;48;56;2022
37;Salamanca;364;Villarino de los Aires;764;403;361;2022
37;Salamanca;365;Villarmayor;166;94;72;2022
37;Salamanca;366;Villarmuerto;39;27;12;2022
37;Salamanca;367;Villasbuenas;179;99;80;2022
37;Salamanca;368;Villasdardo;23;8;15;2022
37;Salamanca;369;Villaseco de los Gamitos;129;74;55;2022
37;Salamanca;370;Villaseco de los Reyes;313;183;130;2022
37;Salamanca;371;Villasrubias;252;134;118;2022
37;Salamanca;372;Villaverde de Guareña;139;76;63;2022
37;Salamanca;373;Villavieja de Yeltes;714;374;340;2022
37;Salamanca;374;Villoria;1325;670;655;2022
37;Salamanca;375;Villoruela;754;375;379;2022
37;Salamanca;350;Vilvestre;405;201;204;2022
37;Salamanca;376;Vitigudino;2380;1139;1241;2022
37;Salamanca;377;Yecla de Yeltes;224;114;110;2022
37;Salamanca;378;Zamarra;79;45;34;2022
37;Salamanca;379;Zamayón;197;117;80;2022
37;Salamanca;380;Zarapicos;60;34;26;2022
37;Salamanca;381;Zarza de Pumareda, La;139;86;53;2022
37;Salamanca;382;Zorita de la Frontera;159;80;79;2022
38;Santa Cruz de Tenerife;001;Adeje;49270;24793;24477;2022
38;Santa Cruz de Tenerife;002;Agulo;1085;545;540;2022
38;Santa Cruz de Tenerife;003;Alajeró;2029;1078;951;2022
38;Santa Cruz de Tenerife;004;Arafo;5623;2823;2800;2022
38;Santa Cruz de Tenerife;005;Arico;8754;4485;4269;2022
38;Santa Cruz de Tenerife;006;Arona;82982;41920;41062;2022
38;Santa Cruz de Tenerife;007;Barlovento;1897;953;944;2022
38;Santa Cruz de Tenerife;008;Breña Alta;7199;3517;3682;2022
38;Santa Cruz de Tenerife;009;Breña Baja;5885;2975;2910;2022
38;Santa Cruz de Tenerife;010;Buenavista del Norte;4753;2371;2382;2022
38;Santa Cruz de Tenerife;011;Candelaria;28485;13774;14711;2022
38;Santa Cruz de Tenerife;012;Fasnia;2849;1498;1351;2022
38;Santa Cruz de Tenerife;013;Frontera;4329;2168;2161;2022
38;Santa Cruz de Tenerife;014;Fuencaliente de la Palma;1800;907;893;2022
38;Santa Cruz de Tenerife;015;Garachico;4920;2458;2462;2022
38;Santa Cruz de Tenerife;016;Garafía;1830;943;887;2022
38;Santa Cruz de Tenerife;017;Granadilla de Abona;52447;26168;26279;2022
38;Santa Cruz de Tenerife;018;Guancha, La;5561;2707;2854;2022
38;Santa Cruz de Tenerife;019;Guía de Isora;21711;10763;10948;2022
38;Santa Cruz de Tenerife;020;Güímar;21224;10457;10767;2022
38;Santa Cruz de Tenerife;021;Hermigua;1795;931;864;2022
38;Santa Cruz de Tenerife;022;Icod de los Vinos;23496;11542;11954;2022
38;Santa Cruz de Tenerife;024;Llanos de Aridane, Los;20551;9924;10627;2022
38;Santa Cruz de Tenerife;025;Matanza de Acentejo, La;9054;4539;4515;2022
38;Santa Cruz de Tenerife;026;Orotava, La;42434;20776;21658;2022
38;Santa Cruz de Tenerife;027;Paso, El;7901;3949;3952;2022
38;Santa Cruz de Tenerife;901;Pinar de El Hierro, El;1971;1031;940;2022
38;Santa Cruz de Tenerife;028;Puerto de la Cruz;30349;14801;15548;2022
38;Santa Cruz de Tenerife;029;Puntagorda;2293;1160;1133;2022
38;Santa Cruz de Tenerife;030;Puntallana;2547;1266;1281;2022
38;Santa Cruz de Tenerife;031;Realejos, Los;37076;18168;18908;2022
38;Santa Cruz de Tenerife;032;Rosario, El;17750;9022;8728;2022
38;Santa Cruz de Tenerife;033;San Andrés y Sauces;4170;2096;2074;2022
38;Santa Cruz de Tenerife;023;San Cristóbal de La Laguna;157815;76000;81815;2022
38;Santa Cruz de Tenerife;034;San Juan de la Rambla;4864;2430;2434;2022
38;Santa Cruz de Tenerife;035;San Miguel de Abona;21915;11074;10841;2022
38;Santa Cruz de Tenerife;036;San Sebastián de la Gomera;9342;4663;4679;2022
38;Santa Cruz de Tenerife;037;Santa Cruz de la Palma;15361;7376;7985;2022
38;Santa Cruz de Tenerife;038;Santa Cruz de Tenerife;208688;99312;109376;2022
38;Santa Cruz de Tenerife;039;Santa Úrsula;15114;7501;7613;2022
38;Santa Cruz de Tenerife;040;Santiago del Teide;11162;5537;5625;2022
38;Santa Cruz de Tenerife;041;Sauzal, El;9005;4485;4520;2022
38;Santa Cruz de Tenerife;042;Silos, Los;4644;2319;2325;2022
38;Santa Cruz de Tenerife;043;Tacoronte;24592;12252;12340;2022
38;Santa Cruz de Tenerife;044;Tanque, El;2813;1377;1436;2022
38;Santa Cruz de Tenerife;045;Tazacorte;4502;2309;2193;2022
38;Santa Cruz de Tenerife;046;Tegueste;11359;5602;5757;2022
38;Santa Cruz de Tenerife;047;Tijarafe;2598;1322;1276;2022
38;Santa Cruz de Tenerife;049;Valle Gran Rey;4674;2392;2282;2022
38;Santa Cruz de Tenerife;050;Vallehermoso;2873;1497;1376;2022
38;Santa Cruz de Tenerife;048;Valverde;5123;2558;2565;2022
38;Santa Cruz de Tenerife;051;Victoria de Acentejo, La;9170;4552;4618;2022
38;Santa Cruz de Tenerife;052;Vilaflor de Chasna;1767;897;870;2022
38;Santa Cruz de Tenerife;053;Villa de Mazo;4905;2488;2417;2022
40;Segovia;001;Abades;839;411;428;2022
40;Segovia;002;Adrada de Pirón;38;21;17;2022
40;Segovia;003;Adrados;120;68;52;2022
40;Segovia;004;Aguilafuente;564;285;279;2022
40;Segovia;005;Alconada de Maderuelo;24;15;9;2022
40;Segovia;012;Aldea Real;283;153;130;2022
40;Segovia;006;Aldealcorvo;19;11;8;2022
40;Segovia;007;Aldealengua de Pedraza;81;49;32;2022
40;Segovia;008;Aldealengua de Santa María;61;32;29;2022
40;Segovia;009;Aldeanueva de la Serrezuela;41;28;13;2022
40;Segovia;010;Aldeanueva del Codonal;114;61;53;2022
40;Segovia;013;Aldeasoña;65;36;29;2022
40;Segovia;014;Aldehorno;52;31;21;2022
40;Segovia;015;Aldehuela del Codonal;23;12;11;2022
40;Segovia;016;Aldeonte;55;32;23;2022
40;Segovia;017;Anaya;126;61;65;2022
40;Segovia;018;Añe;69;40;29;2022
40;Segovia;019;Arahuetes;26;21;5;2022
40;Segovia;020;Arcones;171;87;84;2022
40;Segovia;021;Arevalillo de Cega;20;13;7;2022
40;Segovia;022;Armuña;244;138;106;2022
40;Segovia;024;Ayllón;1154;600;554;2022
40;Segovia;025;Barbolla;141;82;59;2022
40;Segovia;026;Basardilla;157;75;82;2022
40;Segovia;028;Bercial;98;52;46;2022
40;Segovia;029;Bercimuel;31;17;14;2022
40;Segovia;030;Bernardos;489;275;214;2022
40;Segovia;031;Bernuy de Porreros;903;467;436;2022
40;Segovia;032;Boceguillas;682;343;339;2022
40;Segovia;033;Brieva;94;53;41;2022
40;Segovia;034;Caballar;72;43;29;2022
40;Segovia;035;Cabañas de Polendos;190;99;91;2022
40;Segovia;036;Cabezuela;643;330;313;2022
40;Segovia;037;Calabazas de Fuentidueña;28;17;11;2022
40;Segovia;039;Campo de San Pedro;251;141;110;2022
40;Segovia;040;Cantalejo;3461;1720;1741;2022
40;Segovia;041;Cantimpalos;1334;710;624;2022
40;Segovia;161;Carabias;44;32;12;2022
40;Segovia;043;Carbonero el Mayor;2476;1265;1211;2022
40;Segovia;044;Carrascal del Río;146;78;68;2022
40;Segovia;045;Casla;160;84;76;2022
40;Segovia;046;Castillejo de Mesleón;117;64;53;2022
40;Segovia;047;Castro de Fuentidueña;47;29;18;2022
40;Segovia;048;Castrojimeno;31;16;15;2022
40;Segovia;049;Castroserna de Abajo;33;19;14;2022
40;Segovia;051;Castroserracín;39;19;20;2022
40;Segovia;052;Cedillo de la Torre;89;45;44;2022
40;Segovia;053;Cerezo de Abajo;122;67;55;2022
40;Segovia;054;Cerezo de Arriba;135;73;62;2022
40;Segovia;065;Chañe;703;363;340;2022
40;Segovia;055;Cilleruelo de San Mamés;36;24;12;2022
40;Segovia;056;Cobos de Fuentidueña;42;19;23;2022
40;Segovia;057;Coca;1716;869;847;2022
40;Segovia;058;Codorniz;326;163;163;2022
40;Segovia;059;Collado Hermoso;130;69;61;2022
40;Segovia;060;Condado de Castilnovo;86;45;41;2022
40;Segovia;061;Corral de Ayllón;79;44;35;2022
40;Segovia;902;Cozuelos de Fuentidueña;117;63;54;2022
40;Segovia;062;Cubillo;74;47;27;2022
40;Segovia;063;Cuéllar;9588;4820;4768;2022
40;Segovia;905;Cuevas de Provanco;129;76;53;2022
40;Segovia;068;Domingo García;30;19;11;2022
40;Segovia;069;Donhierro;83;47;36;2022
40;Segovia;070;Duruelo;184;110;74;2022
40;Segovia;071;Encinas;40;22;18;2022
40;Segovia;072;Encinillas;331;184;147;2022
40;Segovia;073;Escalona del Prado;489;259;230;2022
40;Segovia;074;Escarabajosa de Cabezas;289;152;137;2022
40;Segovia;075;Escobar de Polendos;174;97;77;2022
40;Segovia;076;Espinar, El;9662;4872;4790;2022
40;Segovia;077;Espirdo;1457;766;691;2022
40;Segovia;078;Fresneda de Cuéllar;172;100;72;2022
40;Segovia;079;Fresno de Cantespino;317;178;139;2022
40;Segovia;080;Fresno de la Fuente;73;40;33;2022
40;Segovia;081;Frumales;118;65;53;2022
40;Segovia;082;Fuente de Santa Cruz;103;54;49;2022
40;Segovia;083;Fuente el Olmo de Fuentidueña;180;81;99;2022
40;Segovia;084;Fuente el Olmo de Íscar;45;26;19;2022
40;Segovia;086;Fuentepelayo;786;415;371;2022
40;Segovia;087;Fuentepiñel;78;45;33;2022
40;Segovia;088;Fuenterrebollo;332;176;156;2022
40;Segovia;089;Fuentesaúco de Fuentidueña;237;126;111;2022
40;Segovia;091;Fuentesoto;101;60;41;2022
40;Segovia;092;Fuentidueña;135;78;57;2022
40;Segovia;093;Gallegos;101;54;47;2022
40;Segovia;094;Garcillán;521;280;241;2022
40;Segovia;095;Gomezserracín;657;340;317;2022
40;Segovia;097;Grajera;250;145;105;2022
40;Segovia;099;Honrubia de la Cuesta;59;35;24;2022
40;Segovia;100;Hontalbilla;298;167;131;2022
40;Segovia;101;Hontanares de Eresma;1558;817;741;2022
40;Segovia;103;Huertos, Los;176;95;81;2022
40;Segovia;104;Ituero y Lama;424;220;204;2022
40;Segovia;105;Juarros de Riomoros;49;30;19;2022
40;Segovia;106;Juarros de Voltoya;193;98;95;2022
40;Segovia;107;Labajos;102;59;43;2022
40;Segovia;108;Laguna de Contreras;105;64;41;2022
40;Segovia;109;Languilla;75;44;31;2022
40;Segovia;110;Lastras de Cuéllar;322;173;149;2022
40;Segovia;111;Lastras del Pozo;60;31;29;2022
40;Segovia;112;Lastrilla, La;4348;2213;2135;2022
40;Segovia;113;Losa, La;537;298;239;2022
40;Segovia;115;Maderuelo;115;67;48;2022
40;Segovia;903;Marazoleja;103;68;35;2022
40;Segovia;118;Marazuela;53;32;21;2022
40;Segovia;119;Martín Miguel;236;142;94;2022
40;Segovia;120;Martín Muñoz de la Dehesa;245;129;116;2022
40;Segovia;121;Martín Muñoz de las Posadas;261;147;114;2022
40;Segovia;122;Marugán;730;404;326;2022
40;Segovia;124;Mata de Cuéllar;263;139;124;2022
40;Segovia;123;Matabuena;175;98;77;2022
40;Segovia;125;Matilla, La;77;46;31;2022
40;Segovia;126;Melque de Cercos;62;35;27;2022
40;Segovia;127;Membibre de la Hoz;39;21;18;2022
40;Segovia;128;Migueláñez;130;70;60;2022
40;Segovia;129;Montejo de Arévalo;171;97;74;2022
40;Segovia;130;Montejo de la Vega de la Serrezuela;138;79;59;2022
40;Segovia;131;Monterrubio;60;33;27;2022
40;Segovia;132;Moral de Hornuez;45;28;17;2022
40;Segovia;134;Mozoncillo;858;469;389;2022
40;Segovia;135;Muñopedro;317;166;151;2022
40;Segovia;136;Muñoveros;127;61;66;2022
40;Segovia;138;Nava de la Asunción;2751;1413;1338;2022
40;Segovia;139;Navafría;290;158;132;2022
40;Segovia;140;Navalilla;99;51;48;2022
40;Segovia;141;Navalmanzano;1033;544;489;2022
40;Segovia;142;Navares de Ayuso;50;25;25;2022
40;Segovia;143;Navares de Enmedio;91;53;38;2022
40;Segovia;144;Navares de las Cuevas;22;16;6;2022
40;Segovia;145;Navas de Oro;1272;646;626;2022
40;Segovia;904;Navas de Riofrío;413;193;220;2022
40;Segovia;146;Navas de San Antonio;356;191;165;2022
40;Segovia;148;Nieva;255;124;131;2022
40;Segovia;149;Olombrada;517;281;236;2022
40;Segovia;150;Orejana;67;39;28;2022
40;Segovia;151;Ortigosa de Pestaño;46;24;22;2022
40;Segovia;901;Ortigosa del Monte;567;291;276;2022
40;Segovia;152;Otero de Herreros;962;482;480;2022
40;Segovia;154;Pajarejos;24;12;12;2022
40;Segovia;155;Palazuelos de Eresma;5743;2981;2762;2022
40;Segovia;156;Pedraza;341;189;152;2022
40;Segovia;157;Pelayos del Arroyo;46;25;21;2022
40;Segovia;158;Perosillo;16;12;4;2022
40;Segovia;159;Pinarejos;173;100;73;2022
40;Segovia;160;Pinarnegrillo;106;60;46;2022
40;Segovia;162;Prádena;501;263;238;2022
40;Segovia;163;Puebla de Pedraza;48;27;21;2022
40;Segovia;164;Rapariegos;198;102;96;2022
40;Segovia;181;Real Sitio de San Ildefonso;5188;2536;2652;2022
40;Segovia;165;Rebollo;75;39;36;2022
40;Segovia;166;Remondo;298;148;150;2022
40;Segovia;168;Riaguas de San Bartolomé;29;20;9;2022
40;Segovia;170;Riaza;2128;1129;999;2022
40;Segovia;171;Ribota;48;34;14;2022
40;Segovia;172;Riofrío de Riaza;37;23;14;2022
40;Segovia;173;Roda de Eresma;225;124;101;2022
40;Segovia;174;Sacramenia;358;174;184;2022
40;Segovia;176;Samboal;464;248;216;2022
40;Segovia;177;San Cristóbal de Cuéllar;152;86;66;2022
40;Segovia;178;San Cristóbal de la Vega;88;47;41;2022
40;Segovia;906;San Cristóbal de Segovia;3110;1561;1549;2022
40;Segovia;182;San Martín y Mudrián;235;115;120;2022
40;Segovia;183;San Miguel de Bernuy;135;68;67;2022
40;Segovia;184;San Pedro de Gaíllos;282;153;129;2022
40;Segovia;179;Sanchonuño;998;494;504;2022
40;Segovia;180;Sangarcía;303;171;132;2022
40;Segovia;185;Santa María la Real de Nieva;883;494;389;2022
40;Segovia;186;Santa Marta del Cerro;39;20;19;2022
40;Segovia;188;Santiuste de Pedraza;80;55;25;2022
40;Segovia;189;Santiuste de San Juan Bautista;539;292;247;2022
40;Segovia;190;Santo Domingo de Pirón;47;26;21;2022
40;Segovia;191;Santo Tomé del Puerto;252;139;113;2022
40;Segovia;192;Sauquillo de Cabezas;139;77;62;2022
40;Segovia;193;Sebúlcor;265;140;125;2022
40;Segovia;194;Segovia;50802;23726;27076;2022
40;Segovia;195;Sepúlveda;1001;506;495;2022
40;Segovia;196;Sequera de Fresno;43;28;15;2022
40;Segovia;198;Sotillo;29;16;13;2022
40;Segovia;199;Sotosalbos;133;74;59;2022
40;Segovia;200;Tabanera la Luenga;52;27;25;2022
40;Segovia;201;Tolocirio;42;19;23;2022
40;Segovia;206;Torre Val de San Pedro;193;100;93;2022
40;Segovia;202;Torreadrada;52;28;24;2022
40;Segovia;203;Torrecaballeros;1410;735;675;2022
40;Segovia;204;Torrecilla del Pinar;179;96;83;2022
40;Segovia;205;Torreiglesias;263;133;130;2022
40;Segovia;207;Trescasas;1090;561;529;2022
40;Segovia;208;Turégano;978;504;474;2022
40;Segovia;210;Urueñas;104;69;35;2022
40;Segovia;211;Valdeprados;64;36;28;2022
40;Segovia;212;Valdevacas de Montejo;31;16;15;2022
40;Segovia;213;Valdevacas y Guijar;93;53;40;2022
40;Segovia;218;Valle de Tabladillo;76;45;31;2022
40;Segovia;219;Vallelado;721;379;342;2022
40;Segovia;220;Valleruela de Pedraza;79;37;42;2022
40;Segovia;221;Valleruela de Sepúlveda;53;25;28;2022
40;Segovia;214;Valseca;223;122;101;2022
40;Segovia;215;Valtiendas;82;51;31;2022
40;Segovia;216;Valverde del Majano;1107;560;547;2022
40;Segovia;222;Veganzones;212;113;99;2022
40;Segovia;223;Vegas de Matute;325;187;138;2022
40;Segovia;224;Ventosilla y Tejadilla;18;12;6;2022
40;Segovia;225;Villacastín;1524;784;740;2022
40;Segovia;228;Villaverde de Íscar;577;304;273;2022
40;Segovia;229;Villaverde de Montejo;28;17;11;2022
40;Segovia;230;Villeguillo;114;65;49;2022
40;Segovia;231;Yanguas de Eresma;125;70;55;2022
40;Segovia;233;Zarzuela del Monte;499;258;241;2022
40;Segovia;234;Zarzuela del Pinar;413;216;197;2022
41;Sevilla;001;Aguadulce;2043;1005;1038;2022
41;Sevilla;002;Alanís;1689;845;844;2022
41;Sevilla;003;Albaida del Aljarafe;3236;1594;1642;2022
41;Sevilla;004;Alcalá de Guadaíra;75917;37690;38227;2022
41;Sevilla;005;Alcalá del Río;12315;6265;6050;2022
41;Sevilla;006;Alcolea del Río;3308;1654;1654;2022
41;Sevilla;007;Algaba, La;16491;8155;8336;2022
41;Sevilla;008;Algámitas;1252;651;601;2022
41;Sevilla;009;Almadén de la Plata;1326;685;641;2022
41;Sevilla;010;Almensilla;6415;3205;3210;2022
41;Sevilla;011;Arahal;19476;9673;9803;2022
41;Sevilla;012;Aznalcázar;4664;2373;2291;2022
41;Sevilla;013;Aznalcóllar;6011;3050;2961;2022
41;Sevilla;014;Badolatosa;3112;1610;1502;2022
41;Sevilla;015;Benacazón;7299;3671;3628;2022
41;Sevilla;016;Bollullos de la Mitación;11136;5567;5569;2022
41;Sevilla;017;Bormujos;22536;11168;11368;2022
41;Sevilla;018;Brenes;12652;6270;6382;2022
41;Sevilla;019;Burguillos;6907;3500;3407;2022
41;Sevilla;020;Cabezas de San Juan, Las;16386;8170;8216;2022
41;Sevilla;021;Camas;27443;13432;14011;2022
41;Sevilla;022;Campana, La;5177;2584;2593;2022
41;Sevilla;023;Cantillana;10751;5419;5332;2022
41;Sevilla;901;Cañada Rosal;3379;1668;1711;2022
41;Sevilla;024;Carmona;29279;14757;14522;2022
41;Sevilla;025;Carrión de los Céspedes;2562;1254;1308;2022
41;Sevilla;026;Casariche;5332;2732;2600;2022
41;Sevilla;027;Castilblanco de los Arroyos;5027;2536;2491;2022
41;Sevilla;028;Castilleja de Guzmán;2866;1470;1396;2022
41;Sevilla;029;Castilleja de la Cuesta;17230;8355;8875;2022
41;Sevilla;030;Castilleja del Campo;624;310;314;2022
41;Sevilla;031;Castillo de las Guardas, El;1529;805;724;2022
41;Sevilla;032;Cazalla de la Sierra;4700;2320;2380;2022
41;Sevilla;033;Constantina;5779;2886;2893;2022
41;Sevilla;034;Coria del Río;30714;15255;15459;2022
41;Sevilla;035;Coripe;1220;590;630;2022
41;Sevilla;036;Coronil, El;4720;2373;2347;2022
41;Sevilla;037;Corrales, Los;3984;2031;1953;2022
41;Sevilla;903;Cuervo de Sevilla, El;8623;4349;4274;2022
41;Sevilla;038;Dos Hermanas;137561;67448;70113;2022
41;Sevilla;039;Écija;39743;19581;20162;2022
41;Sevilla;040;Espartinas;16401;8262;8139;2022
41;Sevilla;041;Estepa;12390;6165;6225;2022
41;Sevilla;042;Fuentes de Andalucía;7173;3569;3604;2022
41;Sevilla;043;Garrobo, El;821;419;402;2022
41;Sevilla;044;Gelves;10317;5116;5201;2022
41;Sevilla;045;Gerena;7774;3878;3896;2022
41;Sevilla;046;Gilena;3702;1871;1831;2022
41;Sevilla;047;Gines;13507;6651;6856;2022
41;Sevilla;048;Guadalcanal;2589;1297;1292;2022
41;Sevilla;049;Guillena;13279;6704;6575;2022
41;Sevilla;050;Herrera;6503;3238;3265;2022
41;Sevilla;051;Huévar del Aljarafe;3209;1655;1554;2022
41;Sevilla;902;Isla Mayor;5767;2877;2890;2022
41;Sevilla;052;Lantejuela;3865;1972;1893;2022
41;Sevilla;053;Lebrija;27665;13815;13850;2022
41;Sevilla;054;Lora de Estepa;883;460;423;2022
41;Sevilla;055;Lora del Río;18417;9064;9353;2022
41;Sevilla;056;Luisiana, La;4588;2314;2274;2022
41;Sevilla;057;Madroño, El;290;148;142;2022
41;Sevilla;058;Mairena del Alcor;23938;11979;11959;2022
41;Sevilla;059;Mairena del Aljarafe;47161;22853;24308;2022
41;Sevilla;060;Marchena;19264;9561;9703;2022
41;Sevilla;061;Marinaleda;2579;1313;1266;2022
41;Sevilla;062;Martín de la Jara;2643;1368;1275;2022
41;Sevilla;063;Molares, Los;3559;1813;1746;2022
41;Sevilla;064;Montellano;6976;3499;3477;2022
41;Sevilla;065;Morón de la Frontera;27357;13458;13899;2022
41;Sevilla;066;Navas de la Concepción, Las;1552;761;791;2022
41;Sevilla;067;Olivares;9444;4732;4712;2022
41;Sevilla;068;Osuna;17442;8660;8782;2022
41;Sevilla;069;Palacios y Villafranca, Los;38662;19311;19351;2022
41;Sevilla;904;Palmar de Troya, El;2343;1168;1175;2022
41;Sevilla;070;Palomares del Río;9083;4551;4532;2022
41;Sevilla;071;Paradas;6832;3391;3441;2022
41;Sevilla;072;Pedrera;5110;2527;2583;2022
41;Sevilla;073;Pedroso, El;2039;1007;1032;2022
41;Sevilla;074;Peñaflor;3685;1856;1829;2022
41;Sevilla;075;Pilas;13964;6983;6981;2022
41;Sevilla;076;Pruna;2563;1306;1257;2022
41;Sevilla;077;Puebla de Cazalla, La;10903;5445;5458;2022
41;Sevilla;078;Puebla de los Infantes, La;2990;1468;1522;2022
41;Sevilla;079;Puebla del Río, La;11855;5808;6047;2022
41;Sevilla;080;Real de la Jara, El;1510;752;758;2022
41;Sevilla;081;Rinconada, La;39509;19600;19909;2022
41;Sevilla;082;Roda de Andalucía, La;4230;2088;2142;2022
41;Sevilla;083;Ronquillo, El;1474;745;729;2022
41;Sevilla;084;Rubio, El;3352;1669;1683;2022
41;Sevilla;085;Salteras;5616;2723;2893;2022
41;Sevilla;086;San Juan de Aznalfarache;22138;10658;11480;2022
41;Sevilla;088;San Nicolás del Puerto;602;312;290;2022
41;Sevilla;087;Sanlúcar la Mayor;14120;6955;7165;2022
41;Sevilla;089;Santiponce;8507;4220;4287;2022
41;Sevilla;090;Saucejo, El;4233;2103;2130;2022
41;Sevilla;091;Sevilla;681998;323275;358723;2022
41;Sevilla;092;Tocina;9484;4713;4771;2022
41;Sevilla;093;Tomares;25341;12518;12823;2022
41;Sevilla;094;Umbrete;9253;4601;4652;2022
41;Sevilla;095;Utrera;51402;25336;26066;2022
41;Sevilla;096;Valencina de la Concepción;7988;3895;4093;2022
41;Sevilla;097;Villamanrique de la Condesa;4580;2238;2342;2022
41;Sevilla;100;Villanueva de San Juan;1037;521;516;2022
41;Sevilla;098;Villanueva del Ariscal;6715;3262;3453;2022
41;Sevilla;099;Villanueva del Río y Minas;4934;2479;2455;2022
41;Sevilla;101;Villaverde del Río;7711;3909;3802;2022
41;Sevilla;102;Viso del Alcor, El;19161;9558;9603;2022
42;Soria;001;Abejar;273;141;132;2022
42;Soria;003;Adradas;60;35;25;2022
42;Soria;004;Ágreda;2983;1535;1448;2022
42;Soria;006;Alconaba;199;130;69;2022
42;Soria;007;Alcubilla de Avellaneda;119;61;58;2022
42;Soria;008;Alcubilla de las Peñas;54;34;20;2022
42;Soria;009;Aldealafuente;80;48;32;2022
42;Soria;010;Aldealices;22;15;7;2022
42;Soria;011;Aldealpozo;18;8;10;2022
42;Soria;012;Aldealseñor;27;17;10;2022
42;Soria;013;Aldehuela de Periáñez;35;18;17;2022
42;Soria;014;Aldehuelas, Las;58;34;24;2022
42;Soria;015;Alentisque;26;16;10;2022
42;Soria;016;Aliud;22;16;6;2022
42;Soria;017;Almajano;178;92;86;2022
42;Soria;018;Almaluez;132;78;54;2022
42;Soria;019;Almarza;612;355;257;2022
42;Soria;020;Almazán;5438;2770;2668;2022
42;Soria;021;Almazul;60;41;19;2022
42;Soria;022;Almenar de Soria;233;144;89;2022
42;Soria;023;Alpanseque;53;32;21;2022
42;Soria;024;Arancón;82;53;29;2022
42;Soria;025;Arcos de Jalón;1507;772;735;2022
42;Soria;026;Arenillas;53;29;24;2022
42;Soria;027;Arévalo de la Sierra;72;46;26;2022
42;Soria;028;Ausejo de la Sierra;93;51;42;2022
42;Soria;029;Baraona;128;73;55;2022
42;Soria;030;Barca;110;71;39;2022
42;Soria;031;Barcones;26;16;10;2022
42;Soria;032;Bayubas de Abajo;139;78;61;2022
42;Soria;033;Bayubas de Arriba;60;35;25;2022
42;Soria;034;Beratón;36;20;16;2022
42;Soria;035;Berlanga de Duero;870;449;421;2022
42;Soria;036;Blacos;39;20;19;2022
42;Soria;037;Bliecos;27;17;10;2022
42;Soria;038;Borjabad;33;20;13;2022
42;Soria;039;Borobia;239;133;106;2022
42;Soria;041;Buberos;29;15;14;2022
42;Soria;042;Buitrago;71;38;33;2022
42;Soria;043;Burgo de Osma-Ciudad de Osma;5023;2522;2501;2022
42;Soria;044;Cabrejas del Campo;50;30;20;2022
42;Soria;045;Cabrejas del Pinar;325;185;140;2022
42;Soria;046;Calatañazor;47;27;20;2022
42;Soria;048;Caltojar;53;36;17;2022
42;Soria;049;Candilichera;95;60;35;2022
42;Soria;050;Cañamaque;25;18;7;2022
42;Soria;051;Carabantes;13;7;6;2022
42;Soria;052;Caracena;14;10;4;2022
42;Soria;053;Carrascosa de Abajo;17;11;6;2022
42;Soria;054;Carrascosa de la Sierra;18;13;5;2022
42;Soria;055;Casarejos;154;81;73;2022
42;Soria;056;Castilfrío de la Sierra;37;22;15;2022
42;Soria;058;Castillejo de Robledo;108;65;43;2022
42;Soria;057;Castilruiz;150;81;69;2022
42;Soria;059;Centenera de Andaluz;22;11;11;2022
42;Soria;060;Cerbón;30;21;9;2022
42;Soria;061;Cidones;306;185;121;2022
42;Soria;062;Cigudosa;19;12;7;2022
42;Soria;063;Cihuela;43;28;15;2022
42;Soria;064;Ciria;74;40;34;2022
42;Soria;065;Cirujales del Río;20;15;5;2022
42;Soria;068;Coscurita;68;45;23;2022
42;Soria;069;Covaleda;1601;828;773;2022
42;Soria;070;Cubilla;25;16;9;2022
42;Soria;071;Cubo de la Solana;166;96;70;2022
42;Soria;073;Cueva de Ágreda;72;45;27;2022
42;Soria;075;Dévanos;77;44;33;2022
42;Soria;076;Deza;194;106;88;2022
42;Soria;078;Duruelo de la Sierra;1063;550;513;2022
42;Soria;079;Escobosa de Almazán;20;13;7;2022
42;Soria;080;Espeja de San Marcelino;151;89;62;2022
42;Soria;081;Espejón;136;71;65;2022
42;Soria;082;Estepa de San Juan;10;7;3;2022
42;Soria;083;Frechilla de Almazán;21;11;10;2022
42;Soria;084;Fresno de Caracena;19;13;6;2022
42;Soria;085;Fuentearmegil;154;92;62;2022
42;Soria;086;Fuentecambrón;33;20;13;2022
42;Soria;087;Fuentecantos;67;34;33;2022
42;Soria;088;Fuentelmonge;62;36;26;2022
42;Soria;089;Fuentelsaz de Soria;63;33;30;2022
42;Soria;090;Fuentepinilla;81;51;30;2022
42;Soria;092;Fuentes de Magaña;54;33;21;2022
42;Soria;093;Fuentestrún;39;26;13;2022
42;Soria;094;Garray;759;406;353;2022
42;Soria;095;Golmayo;2893;1503;1390;2022
42;Soria;096;Gómara;291;157;134;2022
42;Soria;097;Gormaz;25;18;7;2022
42;Soria;098;Herrera de Soria;11;8;3;2022
42;Soria;100;Hinojosa del Campo;26;18;8;2022
42;Soria;103;Langa de Duero;706;378;328;2022
42;Soria;105;Liceras;48;27;21;2022
42;Soria;106;Losilla, La;13;9;4;2022
42;Soria;107;Magaña;66;38;28;2022
42;Soria;108;Maján;8;5;3;2022
42;Soria;110;Matalebreras;66;45;21;2022
42;Soria;111;Matamala de Almazán;269;148;121;2022
42;Soria;113;Medinaceli;658;336;322;2022
42;Soria;115;Miño de Medinaceli;83;50;33;2022
42;Soria;116;Miño de San Esteban;44;29;15;2022
42;Soria;117;Molinos de Duero;169;95;74;2022
42;Soria;118;Momblona;18;15;3;2022
42;Soria;119;Monteagudo de las Vicarías;186;92;94;2022
42;Soria;120;Montejo de Tiermes;141;90;51;2022
42;Soria;121;Montenegro de Cameros;46;31;15;2022
42;Soria;123;Morón de Almazán;198;106;92;2022
42;Soria;124;Muriel de la Fuente;57;38;19;2022
42;Soria;125;Muriel Viejo;78;52;26;2022
42;Soria;127;Nafría de Ucero;31;18;13;2022
42;Soria;128;Narros;49;30;19;2022
42;Soria;129;Navaleno;745;395;350;2022
42;Soria;130;Nepas;51;35;16;2022
42;Soria;131;Nolay;57;33;24;2022
42;Soria;132;Noviercas;156;88;68;2022
42;Soria;134;Ólvega;3673;1877;1796;2022
42;Soria;135;Oncala;65;44;21;2022
42;Soria;139;Pinilla del Campo;19;11;8;2022
42;Soria;140;Portillo de Soria;13;9;4;2022
42;Soria;141;Póveda de Soria, La;114;67;47;2022
42;Soria;142;Pozalmuro;52;27;25;2022
42;Soria;144;Quintana Redonda;503;282;221;2022
42;Soria;145;Quintanas de Gormaz;137;84;53;2022
42;Soria;148;Quiñonería;10;5;5;2022
42;Soria;149;Rábanos, Los;458;252;206;2022
42;Soria;151;Rebollar;38;20;18;2022
42;Soria;152;Recuerda;67;42;25;2022
42;Soria;153;Rello;14;8;6;2022
42;Soria;154;Renieblas;109;71;38;2022
42;Soria;155;Retortillo de Soria;152;87;65;2022
42;Soria;156;Reznos;25;15;10;2022
42;Soria;157;Riba de Escalote, La;9;7;2;2022
42;Soria;158;Rioseco de Soria;129;79;50;2022
42;Soria;159;Rollamienta;45;30;15;2022
42;Soria;160;Royo, El;250;139;111;2022
42;Soria;161;Salduero;145;78;67;2022
42;Soria;162;San Esteban de Gormaz;2910;1531;1379;2022
42;Soria;163;San Felices;61;38;23;2022
42;Soria;164;San Leonardo de Yagüe;2037;1038;999;2022
42;Soria;165;San Pedro Manrique;643;360;283;2022
42;Soria;166;Santa Cruz de Yanguas;57;33;24;2022
42;Soria;167;Santa María de Huerta;250;140;110;2022
42;Soria;168;Santa María de las Hoyas;96;56;40;2022
42;Soria;171;Serón de Nágima;117;66;51;2022
42;Soria;172;Soliedra;31;17;14;2022
42;Soria;173;Soria;39450;18624;20826;2022
42;Soria;174;Sotillo del Rincón;189;106;83;2022
42;Soria;175;Suellacabras;27;13;14;2022
42;Soria;176;Tajahuerce;24;13;11;2022
42;Soria;177;Tajueco;58;35;23;2022
42;Soria;178;Talveila;109;66;43;2022
42;Soria;181;Tardelcuende;432;229;203;2022
42;Soria;182;Taroda;46;26;20;2022
42;Soria;183;Tejado;91;55;36;2022
42;Soria;184;Torlengua;49;30;19;2022
42;Soria;185;Torreblacos;26;13;13;2022
42;Soria;187;Torrubia de Soria;60;41;19;2022
42;Soria;188;Trévago;60;29;31;2022
42;Soria;189;Ucero;85;48;37;2022
42;Soria;190;Vadillo;81;43;38;2022
42;Soria;191;Valdeavellano de Tera;207;109;98;2022
42;Soria;192;Valdegeña;39;29;10;2022
42;Soria;193;Valdelagua del Cerro;13;8;5;2022
42;Soria;194;Valdemaluque;148;71;77;2022
42;Soria;195;Valdenebro;90;53;37;2022
42;Soria;196;Valdeprado;9;4;5;2022
42;Soria;197;Valderrodilla;65;35;30;2022
42;Soria;198;Valtajeros;22;13;9;2022
42;Soria;200;Velamazán;66;45;21;2022
42;Soria;201;Velilla de la Sierra;28;17;11;2022
42;Soria;202;Velilla de los Ajos;18;11;7;2022
42;Soria;204;Viana de Duero;54;38;16;2022
42;Soria;205;Villaciervos;78;47;31;2022
42;Soria;206;Villanueva de Gormaz;8;6;2;2022
42;Soria;207;Villar del Ala;48;26;22;2022
42;Soria;208;Villar del Campo;26;16;10;2022
42;Soria;209;Villar del Río;161;97;64;2022
42;Soria;211;Villares de Soria, Los;78;45;33;2022
42;Soria;212;Villasayas;65;44;21;2022
42;Soria;213;Villaseca de Arciel;24;15;9;2022
42;Soria;215;Vinuesa;840;441;399;2022
42;Soria;216;Vizmanos;26;17;9;2022
42;Soria;217;Vozmediano;35;23;12;2022
42;Soria;218;Yanguas;106;66;40;2022
42;Soria;219;Yelo;44;28;16;2022
43;Tarragona;001;Aiguamúrcia;961;497;464;2022
43;Tarragona;002;Albinyana;2581;1324;1257;2022
43;Tarragona;003;Albiol, L';528;282;246;2022
43;Tarragona;004;Alcanar;9612;4852;4760;2022
43;Tarragona;005;Alcover;5290;2620;2670;2022
43;Tarragona;904;Aldea, L';4332;2351;1981;2022
43;Tarragona;006;Aldover;862;442;420;2022
43;Tarragona;007;Aleixar, L';924;477;447;2022
43;Tarragona;008;Alfara de Carles;359;198;161;2022
43;Tarragona;009;Alforja;1928;978;950;2022
43;Tarragona;010;Alió;496;247;249;2022
43;Tarragona;011;Almoster;1334;666;668;2022
43;Tarragona;012;Altafulla;5609;2729;2880;2022
43;Tarragona;013;Ametlla de Mar, L';7209;3655;3554;2022
43;Tarragona;906;Ampolla, L';3563;1828;1735;2022
43;Tarragona;014;Amposta;21807;11090;10717;2022
43;Tarragona;016;Arboç, L';5604;2852;2752;2022
43;Tarragona;015;Arbolí;122;74;48;2022
43;Tarragona;017;Argentera, L';126;72;54;2022
43;Tarragona;018;Arnes;448;222;226;2022
43;Tarragona;019;Ascó;1601;828;773;2022
43;Tarragona;020;Banyeres del Penedès;3271;1643;1628;2022
43;Tarragona;021;Barberà de la Conca;486;267;219;2022
43;Tarragona;022;Batea;1863;925;938;2022
43;Tarragona;023;Bellmunt del Priorat;272;136;136;2022
43;Tarragona;024;Bellvei;2346;1189;1157;2022
43;Tarragona;025;Benifallet;739;360;379;2022
43;Tarragona;026;Benissanet;1169;641;528;2022
43;Tarragona;027;Bisbal de Falset, La;219;125;94;2022
43;Tarragona;028;Bisbal del Penedès, La;4062;2139;1923;2022
43;Tarragona;029;Blancafort;394;205;189;2022
43;Tarragona;030;Bonastre;742;387;355;2022
43;Tarragona;031;Borges del Camp, Les;2148;1104;1044;2022
43;Tarragona;032;Bot;566;290;276;2022
43;Tarragona;033;Botarell;1102;567;535;2022
43;Tarragona;034;Bràfim;687;344;343;2022
43;Tarragona;035;Cabacés;304;161;143;2022
43;Tarragona;036;Cabra del Camp;1254;664;590;2022
43;Tarragona;037;Calafell;29102;14601;14501;2022
43;Tarragona;903;Camarles;3309;1680;1629;2022
43;Tarragona;038;Cambrils;35675;17472;18203;2022
43;Tarragona;907;Canonja, La;5873;2871;3002;2022
43;Tarragona;039;Capafonts;121;68;53;2022
43;Tarragona;040;Capçanes;407;208;199;2022
43;Tarragona;041;Caseres;233;116;117;2022
43;Tarragona;042;Castellvell del Camp;2946;1474;1472;2022
43;Tarragona;043;Catllar, El;4921;2568;2353;2022
43;Tarragona;045;Colldejou;172;97;75;2022
43;Tarragona;046;Conesa;109;53;56;2022
43;Tarragona;047;Constantí;6685;3427;3258;2022
43;Tarragona;048;Corbera d'Ebre;993;530;463;2022
43;Tarragona;049;Cornudella de Montsant;978;527;451;2022
43;Tarragona;050;Creixell;3981;2004;1977;2022
43;Tarragona;051;Cunit;14622;7169;7453;2022
43;Tarragona;901;Deltebre;11656;5882;5774;2022
43;Tarragona;053;Duesaigües;232;128;104;2022
43;Tarragona;054;Espluga de Francolí, L';3698;1807;1891;2022
43;Tarragona;055;Falset;2740;1380;1360;2022
43;Tarragona;056;Fatarella, La;891;440;451;2022
43;Tarragona;057;Febró, La;39;24;15;2022
43;Tarragona;058;Figuera, La;123;71;52;2022
43;Tarragona;059;Figuerola del Camp;332;168;164;2022
43;Tarragona;060;Flix;3426;1722;1704;2022
43;Tarragona;061;Forès;48;28;20;2022
43;Tarragona;062;Freginals;388;213;175;2022
43;Tarragona;063;Galera, La;700;361;339;2022
43;Tarragona;064;Gandesa;3100;1577;1523;2022
43;Tarragona;065;Garcia;527;263;264;2022
43;Tarragona;066;Garidells, Els;196;98;98;2022
43;Tarragona;067;Ginestar;790;423;367;2022
43;Tarragona;068;Godall;609;297;312;2022
43;Tarragona;069;Gratallops;236;130;106;2022
43;Tarragona;070;Guiamets, Els;279;140;139;2022
43;Tarragona;071;Horta de Sant Joan;1154;595;559;2022
43;Tarragona;072;Lloar, El;104;53;51;2022
43;Tarragona;073;Llorac;96;52;44;2022
43;Tarragona;074;Llorenç del Penedès;2393;1177;1216;2022
43;Tarragona;076;Marçà;593;314;279;2022
43;Tarragona;075;Margalef;107;65;42;2022
43;Tarragona;077;Mas de Barberans;556;274;282;2022
43;Tarragona;078;Masdenverge;1129;587;542;2022
43;Tarragona;079;Masllorenç;547;299;248;2022
43;Tarragona;080;Masó, La;285;149;136;2022
43;Tarragona;081;Maspujols;859;443;416;2022
43;Tarragona;082;Masroig, El;479;263;216;2022
43;Tarragona;083;Milà, El;189;89;100;2022
43;Tarragona;084;Miravet;682;357;325;2022
43;Tarragona;085;Molar, El;296;153;143;2022
43;Tarragona;086;Montblanc;7410;3774;3636;2022
43;Tarragona;088;Montbrió del Camp;3073;1588;1485;2022
43;Tarragona;089;Montferri;419;227;192;2022
43;Tarragona;090;Montmell, El;1863;997;866;2022
43;Tarragona;091;Mont-ral;173;97;76;2022
43;Tarragona;092;Mont-roig del Camp;13101;6734;6367;2022
43;Tarragona;093;Móra d'Ebre;5585;2806;2779;2022
43;Tarragona;094;Móra la Nova;3198;1598;1600;2022
43;Tarragona;095;Morell, El;3803;1956;1847;2022
43;Tarragona;096;Morera de Montsant, La;160;87;73;2022
43;Tarragona;097;Nou de Gaià, La;636;315;321;2022
43;Tarragona;098;Nulles;541;288;253;2022
43;Tarragona;100;Pallaresos, Els;4930;2477;2453;2022
43;Tarragona;099;Palma d'Ebre, La;341;173;168;2022
43;Tarragona;101;Passanant i Belltall;170;103;67;2022
43;Tarragona;102;Paüls;566;287;279;2022
43;Tarragona;103;Perafort;1292;666;626;2022
43;Tarragona;104;Perelló, El;2885;1483;1402;2022
43;Tarragona;105;Piles, Les;224;123;101;2022
43;Tarragona;106;Pinell de Brai, El;1000;498;502;2022
43;Tarragona;107;Pira;489;261;228;2022
43;Tarragona;108;Pla de Santa Maria, El;2340;1207;1133;2022
43;Tarragona;109;Pobla de Mafumet, La;4052;2040;2012;2022
43;Tarragona;110;Pobla de Massaluca, La;340;193;147;2022
43;Tarragona;111;Pobla de Montornès, La;3101;1594;1507;2022
43;Tarragona;112;Poboleda;327;162;165;2022
43;Tarragona;113;Pont d'Armentera, El;492;251;241;2022
43;Tarragona;141;Pontils;133;75;58;2022
43;Tarragona;114;Porrera;429;223;206;2022
43;Tarragona;115;Pradell de la Teixeta;172;85;87;2022
43;Tarragona;116;Prades;625;332;293;2022
43;Tarragona;117;Prat de Comte;186;98;88;2022
43;Tarragona;118;Pratdip;693;367;326;2022
43;Tarragona;119;Puigpelat;1199;628;571;2022
43;Tarragona;120;Querol;572;325;247;2022
43;Tarragona;121;Rasquera;822;402;420;2022
43;Tarragona;122;Renau;152;82;70;2022
43;Tarragona;123;Reus;106741;51724;55017;2022
43;Tarragona;124;Riba, La;552;301;251;2022
43;Tarragona;125;Riba-roja d'Ebre;1131;603;528;2022
43;Tarragona;126;Riera de Gaià, La;1752;878;874;2022
43;Tarragona;127;Riudecanyes;1279;668;611;2022
43;Tarragona;128;Riudecols;1198;620;578;2022
43;Tarragona;129;Riudoms;6721;3401;3320;2022
43;Tarragona;130;Rocafort de Queralt;241;128;113;2022
43;Tarragona;131;Roda de Berà;7591;3869;3722;2022
43;Tarragona;132;Rodonyà;506;276;230;2022
43;Tarragona;133;Roquetes;8193;4199;3994;2022
43;Tarragona;134;Rourell, El;395;212;183;2022
43;Tarragona;135;Salomó;543;281;262;2022
43;Tarragona;905;Salou;29028;14868;14160;2022
43;Tarragona;136;Sant Carles de la Ràpita;14767;7196;7571;2022
43;Tarragona;137;Sant Jaume dels Domenys;2695;1380;1315;2022
43;Tarragona;902;Sant Jaume d'Enveja;3669;1852;1817;2022
43;Tarragona;138;Santa Bàrbara;3791;1933;1858;2022
43;Tarragona;139;Santa Coloma de Queralt;2755;1383;1372;2022
43;Tarragona;140;Santa Oliva;3560;1803;1757;2022
43;Tarragona;142;Sarral;1578;801;777;2022
43;Tarragona;143;Savallà del Comtat;52;27;25;2022
43;Tarragona;144;Secuita, La;1765;883;882;2022
43;Tarragona;145;Selva del Camp, La;5696;2847;2849;2022
43;Tarragona;146;Senan;44;29;15;2022
43;Tarragona;044;Sénia, La;5475;2747;2728;2022
43;Tarragona;147;Solivella;628;328;300;2022
43;Tarragona;148;Tarragona;134883;65555;69328;2022
43;Tarragona;149;Tivenys;923;468;455;2022
43;Tarragona;150;Tivissa;1643;837;806;2022
43;Tarragona;151;Torre de Fontaubella, La;125;65;60;2022
43;Tarragona;152;Torre de l'Espanyol, La;598;309;289;2022
43;Tarragona;153;Torredembarra;17256;8437;8819;2022
43;Tarragona;154;Torroja del Priorat;141;79;62;2022
43;Tarragona;155;Tortosa;33890;16886;17004;2022
43;Tarragona;156;Ulldecona;6241;3296;2945;2022
43;Tarragona;157;Ulldemolins;409;222;187;2022
43;Tarragona;158;Vallclara;88;54;34;2022
43;Tarragona;159;Vallfogona de Riucorb;89;52;37;2022
43;Tarragona;160;Vallmoll;1882;949;933;2022
43;Tarragona;161;Valls;24727;12443;12284;2022
43;Tarragona;162;Vandellòs i l'Hospitalet de l'Infant;6750;3366;3384;2022
43;Tarragona;163;Vendrell, El;39072;19298;19774;2022
43;Tarragona;164;Vespella de Gaià;496;266;230;2022
43;Tarragona;165;Vilabella;711;367;344;2022
43;Tarragona;175;Vilalba dels Arcs;634;317;317;2022
43;Tarragona;166;Vilallonga del Camp;2398;1214;1184;2022
43;Tarragona;168;Vilanova de Prades;107;55;52;2022
43;Tarragona;167;Vilanova d'Escornalbou;594;309;285;2022
43;Tarragona;169;Vilaplana;540;286;254;2022
43;Tarragona;170;Vila-rodona;1341;713;628;2022
43;Tarragona;171;Vila-seca;22681;11410;11271;2022
43;Tarragona;172;Vilaverd;453;247;206;2022
43;Tarragona;173;Vilella Alta, La;136;72;64;2022
43;Tarragona;174;Vilella Baixa, La;202;112;90;2022
43;Tarragona;176;Vimbodí i Poblet;884;479;405;2022
43;Tarragona;177;Vinebre;407;214;193;2022
43;Tarragona;178;Vinyols i els Arcs;2258;1176;1082;2022
43;Tarragona;052;Xerta;1150;570;580;2022
44;Teruel;001;Ababuj;72;44;28;2022
44;Teruel;002;Abejuela;56;34;22;2022
44;Teruel;003;Aguatón;16;7;9;2022
44;Teruel;004;Aguaviva;556;271;285;2022
44;Teruel;005;Aguilar del Alfambra;81;44;37;2022
44;Teruel;006;Alacón;219;113;106;2022
44;Teruel;007;Alba;181;105;76;2022
44;Teruel;008;Albalate del Arzobispo;1959;1006;953;2022
44;Teruel;009;Albarracín;1008;513;495;2022
44;Teruel;010;Albentosa;275;146;129;2022
44;Teruel;011;Alcaine;46;29;17;2022
44;Teruel;012;Alcalá de la Selva;383;209;174;2022
44;Teruel;013;Alcañiz;16054;7997;8057;2022
44;Teruel;014;Alcorisa;3252;1660;1592;2022
44;Teruel;016;Alfambra;490;260;230;2022
44;Teruel;017;Aliaga;323;188;135;2022
44;Teruel;021;Allepuz;124;61;63;2022
44;Teruel;022;Alloza;553;287;266;2022
44;Teruel;023;Allueva;21;14;7;2022
44;Teruel;018;Almohaja;16;11;5;2022
44;Teruel;019;Alobras;67;46;21;2022
44;Teruel;020;Alpeñés;20;12;8;2022
44;Teruel;024;Anadón;33;21;12;2022
44;Teruel;025;Andorra;7201;3617;3584;2022
44;Teruel;026;Arcos de las Salinas;117;71;46;2022
44;Teruel;027;Arens de Lledó;214;107;107;2022
44;Teruel;028;Argente;208;104;104;2022
44;Teruel;029;Ariño;665;333;332;2022
44;Teruel;031;Azaila;105;59;46;2022
44;Teruel;032;Bádenas;19;11;8;2022
44;Teruel;033;Báguena;271;152;119;2022
44;Teruel;034;Bañón;157;89;68;2022
44;Teruel;035;Barrachina;116;63;53;2022
44;Teruel;036;Bea;33;21;12;2022
44;Teruel;037;Beceite;550;278;272;2022
44;Teruel;039;Bello;230;112;118;2022
44;Teruel;038;Belmonte de San José;136;66;70;2022
44;Teruel;040;Berge;231;119;112;2022
44;Teruel;041;Bezas;63;41;22;2022
44;Teruel;042;Blancas;140;84;56;2022
44;Teruel;043;Blesa;88;58;30;2022
44;Teruel;044;Bordón;111;62;49;2022
44;Teruel;045;Bronchales;435;243;192;2022
44;Teruel;046;Bueña;51;27;24;2022
44;Teruel;047;Burbáguena;278;163;115;2022
44;Teruel;048;Cabra de Mora;69;43;26;2022
44;Teruel;049;Calaceite;993;490;503;2022
44;Teruel;050;Calamocha;4485;2234;2251;2022
44;Teruel;051;Calanda;3755;1886;1869;2022
44;Teruel;052;Calomarde;77;44;33;2022
44;Teruel;053;Camañas;137;75;62;2022
44;Teruel;054;Camarena de la Sierra;123;69;54;2022
44;Teruel;055;Camarillas;84;50;34;2022
44;Teruel;056;Caminreal;625;330;295;2022
44;Teruel;059;Cantavieja;707;370;337;2022
44;Teruel;060;Cañada de Benatanduz;35;22;13;2022
44;Teruel;061;Cañada de Verich, La;97;55;42;2022
44;Teruel;062;Cañada Vellida;38;27;11;2022
44;Teruel;063;Cañizar del Olivar;103;60;43;2022
44;Teruel;064;Cascante del Río;66;38;28;2022
44;Teruel;065;Castejón de Tornos;53;34;19;2022
44;Teruel;066;Castel de Cabra;95;53;42;2022
44;Teruel;070;Castellar, El;55;37;18;2022
44;Teruel;071;Castellote;677;345;332;2022
44;Teruel;067;Castelnou;113;61;52;2022
44;Teruel;068;Castelserás;793;420;373;2022
44;Teruel;074;Cedrillas;634;319;315;2022
44;Teruel;075;Celadas;362;206;156;2022
44;Teruel;076;Cella;2611;1347;1264;2022
44;Teruel;077;Cerollera, La;74;48;26;2022
44;Teruel;080;Codoñera, La;317;165;152;2022
44;Teruel;082;Corbalán;110;56;54;2022
44;Teruel;084;Cortes de Aragón;62;28;34;2022
44;Teruel;085;Cosa;50;35;15;2022
44;Teruel;086;Cretas;563;285;278;2022
44;Teruel;087;Crivillén;90;49;41;2022
44;Teruel;088;Cuba, La;42;25;17;2022
44;Teruel;089;Cubla;60;40;20;2022
44;Teruel;090;Cucalón;78;49;29;2022
44;Teruel;092;Cuervo, El;72;36;36;2022
44;Teruel;093;Cuevas de Almudén;126;69;57;2022
44;Teruel;094;Cuevas Labradas;133;70;63;2022
44;Teruel;096;Ejulve;186;96;90;2022
44;Teruel;097;Escorihuela;138;70;68;2022
44;Teruel;099;Escucha;773;422;351;2022
44;Teruel;100;Estercuel;205;114;91;2022
44;Teruel;101;Ferreruela de Huerva;70;40;30;2022
44;Teruel;102;Fonfría;30;19;11;2022
44;Teruel;103;Formiche Alto;159;89;70;2022
44;Teruel;105;Fórnoles;86;47;39;2022
44;Teruel;106;Fortanete;209;121;88;2022
44;Teruel;107;Foz-Calanda;273;139;134;2022
44;Teruel;108;Fresneda, La;462;251;211;2022
44;Teruel;109;Frías de Albarracín;105;66;39;2022
44;Teruel;110;Fuenferrada;35;24;11;2022
44;Teruel;111;Fuentes Calientes;89;52;37;2022
44;Teruel;112;Fuentes Claras;434;235;199;2022
44;Teruel;113;Fuentes de Rubielos;160;86;74;2022
44;Teruel;114;Fuentespalda;293;154;139;2022
44;Teruel;115;Galve;150;79;71;2022
44;Teruel;116;Gargallo;98;52;46;2022
44;Teruel;117;Gea de Albarracín;434;242;192;2022
44;Teruel;118;Ginebrosa, La;200;111;89;2022
44;Teruel;119;Griegos;140;83;57;2022
44;Teruel;120;Guadalaviar;249;134;115;2022
44;Teruel;121;Gúdar;73;41;32;2022
44;Teruel;122;Híjar;1751;885;866;2022
44;Teruel;123;Hinojosa de Jarque;106;59;47;2022
44;Teruel;124;Hoz de la Vieja, La;90;48;42;2022
44;Teruel;125;Huesa del Común;71;43;28;2022
44;Teruel;126;Iglesuela del Cid, La;395;207;188;2022
44;Teruel;127;Jabaloyas;65;40;25;2022
44;Teruel;128;Jarque de la Val;56;28;28;2022
44;Teruel;129;Jatiel;46;29;17;2022
44;Teruel;130;Jorcas;36;20;16;2022
44;Teruel;131;Josa;42;29;13;2022
44;Teruel;132;Lagueruela;71;43;28;2022
44;Teruel;133;Lanzuela;25;17;8;2022
44;Teruel;135;Libros;102;63;39;2022
44;Teruel;136;Lidón;53;29;24;2022
44;Teruel;137;Linares de Mora;235;133;102;2022
44;Teruel;141;Lledó;171;91;80;2022
44;Teruel;138;Loscos;118;71;47;2022
44;Teruel;142;Maicas;31;19;12;2022
44;Teruel;143;Manzanera;533;294;239;2022
44;Teruel;144;Martín del Río;372;177;195;2022
44;Teruel;145;Mas de las Matas;1255;648;607;2022
44;Teruel;146;Mata de los Olmos, La;270;143;127;2022
44;Teruel;147;Mazaleón;487;255;232;2022
44;Teruel;148;Mezquita de Jarque;84;45;39;2022
44;Teruel;149;Mirambel;111;65;46;2022
44;Teruel;150;Miravete de la Sierra;27;20;7;2022
44;Teruel;151;Molinos;227;121;106;2022
44;Teruel;152;Monforte de Moyuela;75;50;25;2022
44;Teruel;153;Monreal del Campo;2499;1245;1254;2022
44;Teruel;154;Monroyo;312;174;138;2022
44;Teruel;155;Montalbán;1209;616;593;2022
44;Teruel;156;Monteagudo del Castillo;43;24;19;2022
44;Teruel;157;Monterde de Albarracín;55;32;23;2022
44;Teruel;158;Mora de Rubielos;1569;782;787;2022
44;Teruel;159;Moscardón;52;28;24;2022
44;Teruel;160;Mosqueruela;551;300;251;2022
44;Teruel;161;Muniesa;571;311;260;2022
44;Teruel;163;Noguera de Albarracín;138;80;58;2022
44;Teruel;164;Nogueras;27;19;8;2022
44;Teruel;165;Nogueruelas;205;121;84;2022
44;Teruel;167;Obón;35;21;14;2022
44;Teruel;168;Odón;214;106;108;2022
44;Teruel;169;Ojos Negros;328;186;142;2022
44;Teruel;171;Olba;266;142;124;2022
44;Teruel;172;Oliete;330;180;150;2022
44;Teruel;173;Olmos, Los;120;67;53;2022
44;Teruel;174;Orihuela del Tremedal;454;253;201;2022
44;Teruel;175;Orrios;123;67;56;2022
44;Teruel;176;Palomar de Arroyos;172;102;70;2022
44;Teruel;177;Pancrudo;123;72;51;2022
44;Teruel;178;Parras de Castellote, Las;60;35;25;2022
44;Teruel;179;Peñarroya de Tastavins;450;239;211;2022
44;Teruel;180;Peracense;78;42;36;2022
44;Teruel;181;Peralejos;85;44;41;2022
44;Teruel;182;Perales del Alfambra;264;130;134;2022
44;Teruel;183;Pitarque;69;35;34;2022
44;Teruel;184;Plou;47;29;18;2022
44;Teruel;185;Pobo, El;106;70;36;2022
44;Teruel;187;Portellada, La;236;120;116;2022
44;Teruel;189;Pozondón;48;29;19;2022
44;Teruel;190;Pozuel del Campo;60;32;28;2022
44;Teruel;191;Puebla de Híjar, La;914;470;444;2022
44;Teruel;192;Puebla de Valverde, La;448;240;208;2022
44;Teruel;193;Puertomingalvo;141;73;68;2022
44;Teruel;194;Ráfales;146;85;61;2022
44;Teruel;195;Rillo;86;52;34;2022
44;Teruel;196;Riodeva;136;64;72;2022
44;Teruel;197;Ródenas;62;34;28;2022
44;Teruel;198;Royuela;225;119;106;2022
44;Teruel;199;Rubiales;43;24;19;2022
44;Teruel;200;Rubielos de la Cérida;32;19;13;2022
44;Teruel;201;Rubielos de Mora;624;324;300;2022
44;Teruel;203;Salcedillo;11;7;4;2022
44;Teruel;204;Saldón;22;15;7;2022
44;Teruel;205;Samper de Calanda;731;378;353;2022
44;Teruel;206;San Agustín;134;82;52;2022
44;Teruel;207;San Martín del Río;132;70;62;2022
44;Teruel;208;Santa Cruz de Nogueras;25;14;11;2022
44;Teruel;209;Santa Eulalia;1033;524;509;2022
44;Teruel;210;Sarrión;1201;618;583;2022
44;Teruel;211;Segura de los Baños;42;27;15;2022
44;Teruel;212;Seno;43;19;24;2022
44;Teruel;213;Singra;80;47;33;2022
44;Teruel;215;Terriente;191;110;81;2022
44;Teruel;216;Teruel;35900;17094;18806;2022
44;Teruel;217;Toril y Masegoso;37;28;9;2022
44;Teruel;218;Tormón;26;17;9;2022
44;Teruel;219;Tornos;196;105;91;2022
44;Teruel;220;Torralba de los Sisones;151;81;70;2022
44;Teruel;223;Torre de Arcas;82;38;44;2022
44;Teruel;224;Torre de las Arcas;24;14;10;2022
44;Teruel;225;Torre del Compte;125;65;60;2022
44;Teruel;227;Torre los Negros;81;42;39;2022
44;Teruel;221;Torrecilla de Alcañiz;460;244;216;2022
44;Teruel;222;Torrecilla del Rebollar;121;78;43;2022
44;Teruel;226;Torrelacárcel;140;78;62;2022
44;Teruel;228;Torremocha de Jiloca;106;58;48;2022
44;Teruel;229;Torres de Albarracín;168;97;71;2022
44;Teruel;230;Torrevelilla;170;88;82;2022
44;Teruel;231;Torrijas;35;15;20;2022
44;Teruel;232;Torrijo del Campo;482;253;229;2022
44;Teruel;234;Tramacastiel;66;39;27;2022
44;Teruel;235;Tramacastilla;117;57;60;2022
44;Teruel;236;Tronchón;61;31;30;2022
44;Teruel;237;Urrea de Gaén;440;223;217;2022
44;Teruel;238;Utrillas;3011;1540;1471;2022
44;Teruel;239;Valacloche;26;14;12;2022
44;Teruel;240;Valbona;188;108;80;2022
44;Teruel;241;Valdealgorfa;591;289;302;2022
44;Teruel;243;Valdecuenca;31;19;12;2022
44;Teruel;244;Valdelinares;78;47;31;2022
44;Teruel;245;Valdeltormo;301;144;157;2022
44;Teruel;246;Valderrobres;2498;1291;1207;2022
44;Teruel;247;Valjunquera;337;170;167;2022
44;Teruel;249;Vallecillo, El;41;25;16;2022
44;Teruel;250;Veguillas de la Sierra;21;13;8;2022
44;Teruel;251;Villafranca del Campo;301;155;146;2022
44;Teruel;252;Villahermosa del Campo;90;55;35;2022
44;Teruel;256;Villanueva del Rebollar de la Sierra;44;25;19;2022
44;Teruel;257;Villar del Cobo;165;97;68;2022
44;Teruel;258;Villar del Salz;63;38;25;2022
44;Teruel;260;Villarluengo;174;100;74;2022
44;Teruel;261;Villarquemado;857;450;407;2022
44;Teruel;262;Villarroya de los Pinares;172;92;80;2022
44;Teruel;263;Villastar;543;271;272;2022
44;Teruel;264;Villel;329;183;146;2022
44;Teruel;265;Vinaceite;211;113;98;2022
44;Teruel;266;Visiedo;118;55;63;2022
44;Teruel;267;Vivel del Río Martín;68;37;31;2022
44;Teruel;268;Zoma, La;30;16;14;2022
45;Toledo;001;Ajofrín;2290;1157;1133;2022
45;Toledo;002;Alameda de la Sagra;3908;2036;1872;2022
45;Toledo;003;Albarreal de Tajo;692;362;330;2022
45;Toledo;004;Alcabón;743;374;369;2022
45;Toledo;005;Alcañizo;277;135;142;2022
45;Toledo;006;Alcaudete de la Jara;1614;816;798;2022
45;Toledo;007;Alcolea de Tajo;824;415;409;2022
45;Toledo;008;Aldea en Cabo;187;96;91;2022
45;Toledo;009;Aldeanueva de Barbarroya;482;250;232;2022
45;Toledo;010;Aldeanueva de San Bartolomé;416;209;207;2022
45;Toledo;011;Almendral de la Cañada;322;166;156;2022
45;Toledo;012;Almonacid de Toledo;885;433;452;2022
45;Toledo;013;Almorox;2317;1208;1109;2022
45;Toledo;014;Añover de Tajo;5225;2643;2582;2022
45;Toledo;015;Arcicóllar;1004;498;506;2022
45;Toledo;016;Argés;6829;3411;3418;2022
45;Toledo;017;Azután;296;144;152;2022
45;Toledo;018;Barcience;1003;542;461;2022
45;Toledo;019;Bargas;10807;5430;5377;2022
45;Toledo;020;Belvís de la Jara;1497;769;728;2022
45;Toledo;021;Borox;4032;2129;1903;2022
45;Toledo;022;Buenaventura;403;203;200;2022
45;Toledo;023;Burguillos de Toledo;3473;1811;1662;2022
45;Toledo;024;Burujón;1304;666;638;2022
45;Toledo;025;Cabañas de la Sagra;2041;1052;989;2022
45;Toledo;026;Cabañas de Yepes;304;157;147;2022
45;Toledo;027;Cabezamesada;319;174;145;2022
45;Toledo;028;Calera y Chozas;4716;2392;2324;2022
45;Toledo;029;Caleruela;202;100;102;2022
45;Toledo;030;Calzada de Oropesa;510;280;230;2022
45;Toledo;031;Camarena;4283;2212;2071;2022
45;Toledo;032;Camarenilla;610;308;302;2022
45;Toledo;033;Campillo de la Jara, El;336;183;153;2022
45;Toledo;034;Camuñas;1742;903;839;2022
45;Toledo;035;Cardiel de los Montes;394;217;177;2022
45;Toledo;036;Carmena;777;394;383;2022
45;Toledo;037;Carpio de Tajo, El;1826;914;912;2022
45;Toledo;038;Carranque;5155;2682;2473;2022
45;Toledo;039;Carriches;276;137;139;2022
45;Toledo;040;Casar de Escalona, El;1891;1015;876;2022
45;Toledo;041;Casarrubios del Monte;6441;3368;3073;2022
45;Toledo;042;Casasbuenas;188;96;92;2022
45;Toledo;043;Castillo de Bayuela;895;444;451;2022
45;Toledo;045;Cazalegas;1927;998;929;2022
45;Toledo;046;Cebolla;3201;1591;1610;2022
45;Toledo;047;Cedillo del Condado;4101;2118;1983;2022
45;Toledo;048;Cerralbos, Los;397;215;182;2022
45;Toledo;049;Cervera de los Montes;508;262;246;2022
45;Toledo;056;Chozas de Canales;4523;2322;2201;2022
45;Toledo;057;Chueca;249;124;125;2022
45;Toledo;050;Ciruelos;630;340;290;2022
45;Toledo;051;Cobeja;2482;1292;1190;2022
45;Toledo;052;Cobisa;4427;2212;2215;2022
45;Toledo;053;Consuegra;9886;5018;4868;2022
45;Toledo;054;Corral de Almaguer;4827;2497;2330;2022
45;Toledo;055;Cuerva;1248;649;599;2022
45;Toledo;058;Domingo Pérez;306;156;150;2022
45;Toledo;059;Dosbarrios;2273;1167;1106;2022
45;Toledo;060;Erustes;206;109;97;2022
45;Toledo;061;Escalona;3573;1846;1727;2022
45;Toledo;062;Escalonilla;1440;712;728;2022
45;Toledo;063;Espinoso del Rey;437;255;182;2022
45;Toledo;064;Esquivias;5740;2910;2830;2022
45;Toledo;065;Estrella, La;194;107;87;2022
45;Toledo;066;Fuensalida;12004;6044;5960;2022
45;Toledo;067;Gálvez;2986;1499;1487;2022
45;Toledo;068;Garciotum;216;105;111;2022
45;Toledo;069;Gerindote;2518;1258;1260;2022
45;Toledo;070;Guadamur;1774;887;887;2022
45;Toledo;071;Guardia, La;2163;1100;1063;2022
45;Toledo;072;Herencias, Las;768;410;358;2022
45;Toledo;073;Herreruela de Oropesa;304;160;144;2022
45;Toledo;074;Hinojosa de San Vicente;394;217;177;2022
45;Toledo;075;Hontanar;146;87;59;2022
45;Toledo;076;Hormigos;881;489;392;2022
45;Toledo;077;Huecas;810;416;394;2022
45;Toledo;078;Huerta de Valdecarábanos;1726;872;854;2022
45;Toledo;079;Iglesuela del Tiétar, La;471;254;217;2022
45;Toledo;080;Illán de Vacas;3;3;0;2022
45;Toledo;081;Illescas;30553;15336;15217;2022
45;Toledo;082;Lagartera;1292;639;653;2022
45;Toledo;083;Layos;845;428;417;2022
45;Toledo;084;Lillo;2543;1326;1217;2022
45;Toledo;085;Lominchar;2510;1317;1193;2022
45;Toledo;086;Lucillos;571;300;271;2022
45;Toledo;087;Madridejos;10202;5079;5123;2022
45;Toledo;088;Magán;3875;1957;1918;2022
45;Toledo;089;Malpica de Tajo;1688;865;823;2022
45;Toledo;090;Manzaneque;382;185;197;2022
45;Toledo;091;Maqueda;459;233;226;2022
45;Toledo;092;Marjaliza;253;130;123;2022
45;Toledo;093;Marrupe;147;76;71;2022
45;Toledo;094;Mascaraque;414;212;202;2022
45;Toledo;095;Mata, La;854;416;438;2022
45;Toledo;096;Mazarambroz;1259;652;607;2022
45;Toledo;097;Mejorada;1354;697;657;2022
45;Toledo;098;Menasalbas;2513;1309;1204;2022
45;Toledo;099;Méntrida;5722;2933;2789;2022
45;Toledo;100;Mesegar de Tajo;203;109;94;2022
45;Toledo;101;Miguel Esteban;4791;2405;2386;2022
45;Toledo;102;Mocejón;5004;2501;2503;2022
45;Toledo;103;Mohedas de la Jara;389;209;180;2022
45;Toledo;104;Montearagón;533;284;249;2022
45;Toledo;105;Montesclaros;384;197;187;2022
45;Toledo;106;Mora;9796;4921;4875;2022
45;Toledo;107;Nambroca;5020;2556;2464;2022
45;Toledo;108;Nava de Ricomalillo, La;493;262;231;2022
45;Toledo;109;Navahermosa;3586;1879;1707;2022
45;Toledo;110;Navalcán;1888;987;901;2022
45;Toledo;111;Navalmoralejo;51;26;25;2022
45;Toledo;112;Navalmorales, Los;2163;1117;1046;2022
45;Toledo;113;Navalucillos, Los;1987;1007;980;2022
45;Toledo;114;Navamorcuende;595;296;299;2022
45;Toledo;115;Noblejas;3857;1927;1930;2022
45;Toledo;116;Noez;942;468;474;2022
45;Toledo;117;Nombela;881;472;409;2022
45;Toledo;118;Novés;3236;1674;1562;2022
45;Toledo;119;Numancia de la Sagra;5287;2753;2534;2022
45;Toledo;120;Nuño Gómez;145;81;64;2022
45;Toledo;121;Ocaña;13185;6600;6585;2022
45;Toledo;122;Olías del Rey;8469;4287;4182;2022
45;Toledo;123;Ontígola;4752;2527;2225;2022
45;Toledo;124;Orgaz;2584;1298;1286;2022
45;Toledo;125;Oropesa;2607;1250;1357;2022
45;Toledo;126;Otero;357;190;167;2022
45;Toledo;127;Palomeque;1126;612;514;2022
45;Toledo;128;Pantoja;3506;1746;1760;2022
45;Toledo;129;Paredes de Escalona;122;66;56;2022
45;Toledo;130;Parrillas;337;178;159;2022
45;Toledo;131;Pelahustán;342;196;146;2022
45;Toledo;132;Pepino;3003;1538;1465;2022
45;Toledo;133;Polán;3870;1929;1941;2022
45;Toledo;134;Portillo de Toledo;2234;1132;1102;2022
45;Toledo;135;Puebla de Almoradiel, La;4953;2523;2430;2022
45;Toledo;136;Puebla de Montalbán, La;7838;3958;3880;2022
45;Toledo;137;Pueblanueva, La;2166;1106;1060;2022
45;Toledo;138;Puente del Arzobispo, El;1153;574;579;2022
45;Toledo;139;Puerto de San Vicente;140;77;63;2022
45;Toledo;140;Pulgar;1491;762;729;2022
45;Toledo;141;Quero;985;507;478;2022
45;Toledo;142;Quintanar de la Orden;11069;5497;5572;2022
45;Toledo;143;Quismondo;1673;834;839;2022
45;Toledo;144;Real de San Vicente, El;973;524;449;2022
45;Toledo;145;Recas;4552;2499;2053;2022
45;Toledo;146;Retamoso de la Jara;97;54;43;2022
45;Toledo;147;Rielves;760;384;376;2022
45;Toledo;148;Robledo del Mazo;249;133;116;2022
45;Toledo;149;Romeral, El;555;274;281;2022
45;Toledo;150;San Bartolomé de las Abiertas;533;284;249;2022
45;Toledo;151;San Martín de Montalbán;699;353;346;2022
45;Toledo;152;San Martín de Pusa;585;315;270;2022
45;Toledo;153;San Pablo de los Montes;1696;857;839;2022
45;Toledo;154;San Román de los Montes;2047;1052;995;2022
45;Toledo;155;Santa Ana de Pusa;358;204;154;2022
45;Toledo;156;Santa Cruz de la Zarza;4097;2079;2018;2022
45;Toledo;157;Santa Cruz del Retamar;3682;1911;1771;2022
45;Toledo;158;Santa Olalla;3387;1715;1672;2022
45;Toledo;901;Santo Domingo-Caudilla;1111;583;528;2022
45;Toledo;159;Sartajada;107;66;41;2022
45;Toledo;160;Segurilla;1366;694;672;2022
45;Toledo;161;Seseña;28102;14431;13671;2022
45;Toledo;162;Sevilleja de la Jara;643;361;282;2022
45;Toledo;163;Sonseca;11084;5604;5480;2022
45;Toledo;164;Sotillo de las Palomas;183;93;90;2022
45;Toledo;165;Talavera de la Reina;83247;39935;43312;2022
45;Toledo;166;Tembleque;1949;992;957;2022
45;Toledo;167;Toboso, El;1663;830;833;2022
45;Toledo;168;Toledo;85085;40504;44581;2022
45;Toledo;169;Torralba de Oropesa;193;103;90;2022
45;Toledo;171;Torre de Esteban Hambrán, La;1703;853;850;2022
45;Toledo;170;Torrecilla de la Jara;208;115;93;2022
45;Toledo;172;Torrico;691;353;338;2022
45;Toledo;173;Torrijos;13678;6692;6986;2022
45;Toledo;174;Totanés;358;182;176;2022
45;Toledo;175;Turleque;721;368;353;2022
45;Toledo;176;Ugena;5615;2888;2727;2022
45;Toledo;177;Urda;2417;1206;1211;2022
45;Toledo;179;Valdeverdeja;550;277;273;2022
45;Toledo;180;Valmojado;4503;2279;2224;2022
45;Toledo;181;Velada;2865;1477;1388;2022
45;Toledo;182;Ventas con Peña Aguilera, Las;1109;554;555;2022
45;Toledo;183;Ventas de Retamosa, Las;3806;2021;1785;2022
45;Toledo;184;Ventas de San Julián, Las;222;104;118;2022
45;Toledo;186;Villa de Don Fadrique, La;3572;1773;1799;2022
45;Toledo;185;Villacañas;9418;4705;4713;2022
45;Toledo;187;Villafranca de los Caballeros;4884;2450;2434;2022
45;Toledo;188;Villaluenga de la Sagra;4081;2045;2036;2022
45;Toledo;189;Villamiel de Toledo;1021;521;500;2022
45;Toledo;190;Villaminaya;508;256;252;2022
45;Toledo;191;Villamuelas;610;318;292;2022
45;Toledo;192;Villanueva de Alcardete;3062;1581;1481;2022
45;Toledo;193;Villanueva de Bogas;699;362;337;2022
45;Toledo;194;Villarejo de Montalbán;75;40;35;2022
45;Toledo;195;Villarrubia de Santiago;2509;1262;1247;2022
45;Toledo;196;Villaseca de la Sagra;1864;936;928;2022
45;Toledo;197;Villasequilla;2563;1316;1247;2022
45;Toledo;198;Villatobas;2595;1336;1259;2022
45;Toledo;199;Viso de San Juan, El;5533;2945;2588;2022
45;Toledo;200;Yébenes, Los;5752;2943;2809;2022
45;Toledo;201;Yeles;5868;3090;2778;2022
45;Toledo;202;Yepes;5268;2675;2593;2022
45;Toledo;203;Yuncler;4582;2368;2214;2022
45;Toledo;204;Yunclillos;806;422;384;2022
45;Toledo;205;Yuncos;10630;5416;5214;2022
46;Valencia/València;001;Ademuz;1000;535;465;2022
46;Valencia/València;002;Ador;1706;894;812;2022
46;Valencia/València;004;Agullent;2361;1174;1187;2022
46;Valencia/València;042;Aielo de Malferit;4589;2317;2272;2022
46;Valencia/València;043;Aielo de Rugat;166;89;77;2022
46;Valencia/València;005;Alaquàs;29537;14432;15105;2022
46;Valencia/València;006;Albaida;5989;2967;3022;2022
46;Valencia/València;007;Albal;16845;8440;8405;2022
46;Valencia/València;008;Albalat de la Ribera;3444;1735;1709;2022
46;Valencia/València;009;Albalat dels Sorells;4084;2011;2073;2022
46;Valencia/València;010;Albalat dels Tarongers;1368;721;647;2022
46;Valencia/València;011;Alberic;10710;5336;5374;2022
46;Valencia/València;012;Alborache;1328;684;644;2022
46;Valencia/València;013;Alboraia/Alboraya;25149;12273;12876;2022
46;Valencia/València;014;Albuixech;4201;2028;2173;2022
46;Valencia/València;016;Alcàntera de Xúquer;1427;720;707;2022
46;Valencia/València;015;Alcàsser;10396;5193;5203;2022
46;Valencia/València;018;Alcublas;607;317;290;2022
46;Valencia/València;020;Alcúdia de Crespins, l';5224;2574;2650;2022
46;Valencia/València;019;Alcúdia, l';12176;5997;6179;2022
46;Valencia/València;021;Aldaia;32656;16327;16329;2022
46;Valencia/València;022;Alfafar;21480;10551;10929;2022
46;Valencia/València;024;Alfara de la Baronia;606;297;309;2022
46;Valencia/València;025;Alfara del Patriarca;3315;1570;1745;2022
46;Valencia/València;026;Alfarp;1596;821;775;2022
46;Valencia/València;027;Alfarrasí;1217;600;617;2022
46;Valencia/València;023;Alfauir;479;247;232;2022
46;Valencia/València;028;Algar de Palancia;498;257;241;2022
46;Valencia/València;029;Algemesí;27305;13527;13778;2022
46;Valencia/València;030;Algímia d'Alfara;1106;545;561;2022
46;Valencia/València;031;Alginet;14219;7208;7011;2022
46;Valencia/València;032;Almàssera;7482;3646;3836;2022
46;Valencia/València;033;Almiserà;260;132;128;2022
46;Valencia/València;034;Almoines;2473;1230;1243;2022
46;Valencia/València;035;Almussafes;8929;4440;4489;2022
46;Valencia/València;036;Alpuente;670;370;300;2022
46;Valencia/València;037;Alqueria de la Comtessa, l';1478;719;759;2022
46;Valencia/València;017;Alzira;45451;22170;23281;2022
46;Valencia/València;038;Andilla;316;207;109;2022
46;Valencia/València;039;Anna;2583;1290;1293;2022
46;Valencia/València;040;Antella;1130;546;584;2022
46;Valencia/València;041;Aras de los Olmos;380;219;161;2022
46;Valencia/València;003;Atzeneta d'Albaida;1146;581;565;2022
46;Valencia/València;044;Ayora;5187;2569;2618;2022
46;Valencia/València;046;Barx;1400;735;665;2022
46;Valencia/València;045;Barxeta;1576;814;762;2022
46;Valencia/València;047;Bèlgida;639;315;324;2022
46;Valencia/València;048;Bellreguard;4713;2350;2363;2022
46;Valencia/València;049;Bellús;301;156;145;2022
46;Valencia/València;050;Benagéber;170;102;68;2022
46;Valencia/València;051;Benaguasil;11568;5921;5647;2022
46;Valencia/València;052;Benavites;667;322;345;2022
46;Valencia/València;053;Beneixida;652;310;342;2022
46;Valencia/València;054;Benetússer;15493;7553;7940;2022
46;Valencia/València;055;Beniarjó;1791;893;898;2022
46;Valencia/València;056;Beniatjar;207;110;97;2022
46;Valencia/València;057;Benicolet;597;292;305;2022
46;Valencia/València;904;Benicull de Xúquer;1102;559;543;2022
46;Valencia/València;060;Benifaió;11877;5869;6008;2022
46;Valencia/València;059;Benifairó de la Valldigna;1552;774;778;2022
46;Valencia/València;058;Benifairó de les Valls;2314;1137;1177;2022
46;Valencia/València;061;Beniflá;475;230;245;2022
46;Valencia/València;062;Benigànim;5718;2906;2812;2022
46;Valencia/València;063;Benimodo;2233;1134;1099;2022
46;Valencia/València;064;Benimuslem;662;355;307;2022
46;Valencia/València;065;Beniparrell;2020;1015;1005;2022
46;Valencia/València;066;Benirredrà;1548;741;807;2022
46;Valencia/València;067;Benissanó;2345;1162;1183;2022
46;Valencia/València;068;Benissoda;456;249;207;2022
46;Valencia/València;069;Benissuera;188;91;97;2022
46;Valencia/València;070;Bétera;26289;13073;13216;2022
46;Valencia/València;071;Bicorp;524;253;271;2022
46;Valencia/València;072;Bocairent;4123;2091;2032;2022
46;Valencia/València;073;Bolbaite;1338;669;669;2022
46;Valencia/València;074;Bonrepòs i Mirambell;3831;1878;1953;2022
46;Valencia/València;075;Bufali;156;84;72;2022
46;Valencia/València;076;Bugarra;747;376;371;2022
46;Valencia/València;077;Buñol;9503;4730;4773;2022
46;Valencia/València;078;Burjassot;38880;18761;20119;2022
46;Valencia/València;079;Calles;374;215;159;2022
46;Valencia/València;080;Camporrobles;1196;607;589;2022
46;Valencia/València;081;Canals;13187;6591;6596;2022
46;Valencia/València;082;Canet d'En Berenguer;6942;3487;3455;2022
46;Valencia/València;083;Carcaixent;20498;10171;10327;2022
46;Valencia/València;084;Càrcer;1808;866;942;2022
46;Valencia/València;085;Carlet;15945;7982;7963;2022
46;Valencia/València;086;Carrícola;99;48;51;2022
46;Valencia/València;087;Casas Altas;132;70;62;2022
46;Valencia/València;088;Casas Bajas;171;91;80;2022
46;Valencia/València;089;Casinos;2994;1524;1470;2022
46;Valencia/València;257;Castelló;6932;3407;3525;2022
46;Valencia/València;090;Castelló de Rugat;2315;1173;1142;2022
46;Valencia/València;091;Castellonet de la Conquesta;137;75;62;2022
46;Valencia/València;092;Castielfabib;291;154;137;2022
46;Valencia/València;093;Catadau;2862;1449;1413;2022
46;Valencia/València;094;Catarroja;28679;14189;14490;2022
46;Valencia/València;095;Caudete de las Fuentes;701;366;335;2022
46;Valencia/València;096;Cerdà;351;181;170;2022
46;Valencia/València;107;Chella;2434;1203;1231;2022
46;Valencia/València;106;Chelva;1597;824;773;2022
46;Valencia/València;108;Chera;492;263;229;2022
46;Valencia/València;109;Cheste;8971;4625;4346;2022
46;Valencia/València;111;Chiva;16285;8306;7979;2022
46;Valencia/València;112;Chulilla;692;366;326;2022
46;Valencia/València;097;Cofrentes;1112;563;549;2022
46;Valencia/València;098;Corbera;3097;1534;1563;2022
46;Valencia/València;099;Cortes de Pallás;733;407;326;2022
46;Valencia/València;100;Cotes;323;164;159;2022
46;Valencia/València;105;Cullera;22937;11629;11308;2022
46;Valencia/València;113;Daimús;3274;1646;1628;2022
46;Valencia/València;114;Domeño;656;321;335;2022
46;Valencia/València;115;Dos Aguas;325;177;148;2022
46;Valencia/València;116;Eliana, l';18544;9102;9442;2022
46;Valencia/València;117;Emperador;705;368;337;2022
46;Valencia/València;118;Enguera;4770;2388;2382;2022
46;Valencia/València;119;Énova, l';908;466;442;2022
46;Valencia/València;120;Estivella;1559;758;801;2022
46;Valencia/València;121;Estubeny;109;53;56;2022
46;Valencia/València;122;Faura;3568;1800;1768;2022
46;Valencia/València;123;Favara;2578;1316;1262;2022
46;Valencia/València;126;Foios;7496;3670;3826;2022
46;Valencia/València;128;Font de la Figuera, la;2024;1021;1003;2022
46;Valencia/València;127;Font d'En Carròs, la;3857;1928;1929;2022
46;Valencia/València;124;Fontanars dels Alforins;953;494;459;2022
46;Valencia/València;125;Fortaleny;1026;507;519;2022
46;Valencia/València;129;Fuenterrobles;690;376;314;2022
46;Valencia/València;131;Gandia;75911;37224;38687;2022
46;Valencia/València;902;Gátova;412;207;205;2022
46;Valencia/València;130;Gavarda;1053;511;542;2022
46;Valencia/València;132;Genovés, el;2780;1406;1374;2022
46;Valencia/València;133;Gestalgar;547;291;256;2022
46;Valencia/València;134;Gilet;3601;1848;1753;2022
46;Valencia/València;135;Godella;13050;6287;6763;2022
46;Valencia/València;136;Godelleta;3942;2035;1907;2022
46;Valencia/València;137;Granja de la Costera, la;276;141;135;2022
46;Valencia/València;138;Guadasséquies;475;237;238;2022
46;Valencia/València;139;Guadassuar;5910;2864;3046;2022
46;Valencia/València;140;Guardamar de la Safor;567;292;275;2022
46;Valencia/València;141;Higueruelas;510;270;240;2022
46;Valencia/València;142;Jalance;788;416;372;2022
46;Valencia/València;144;Jarafuel;777;410;367;2022
46;Valencia/València;154;Llanera de Ranes;1066;552;514;2022
46;Valencia/València;155;Llaurí;1193;602;591;2022
46;Valencia/València;147;Llíria;24036;12116;11920;2022
46;Valencia/València;152;Llocnou de la Corona;109;58;51;2022
46;Valencia/València;153;Llocnou de Sant Jeroni;577;292;285;2022
46;Valencia/València;151;Llocnou d'En Fenollet;924;473;451;2022
46;Valencia/València;156;Llombai;2648;1324;1324;2022
46;Valencia/València;157;Llosa de Ranes, la;3652;1856;1796;2022
46;Valencia/València;150;Llutxent;2318;1188;1130;2022
46;Valencia/València;148;Loriguilla;2100;1091;1009;2022
46;Valencia/València;149;Losa del Obispo;527;268;259;2022
46;Valencia/València;158;Macastre;1387;732;655;2022
46;Valencia/València;159;Manises;31170;15445;15725;2022
46;Valencia/València;160;Manuel;2496;1242;1254;2022
46;Valencia/València;161;Marines;1942;1012;930;2022
46;Valencia/València;162;Massalavés;1696;865;831;2022
46;Valencia/València;163;Massalfassar;2587;1288;1299;2022
46;Valencia/València;164;Massamagrell;16223;8020;8203;2022
46;Valencia/València;165;Massanassa;9929;4852;5077;2022
46;Valencia/València;166;Meliana;10881;5362;5519;2022
46;Valencia/València;167;Millares;339;172;167;2022
46;Valencia/València;168;Miramar;2831;1434;1397;2022
46;Valencia/València;169;Mislata;44282;21510;22772;2022
46;Valencia/València;170;Mogente/Moixent;4365;2193;2172;2022
46;Valencia/València;171;Moncada;21913;10665;11248;2022
46;Valencia/València;173;Montaverner;1627;806;821;2022
46;Valencia/València;174;Montesa;1152;585;567;2022
46;Valencia/València;175;Montitxelvo/Montichelvo;571;280;291;2022
46;Valencia/València;176;Montroi/Montroy;3185;1686;1499;2022
46;Valencia/València;172;Montserrat;9017;4694;4323;2022
46;Valencia/València;177;Museros;6663;3405;3258;2022
46;Valencia/València;178;Nàquera/Náquera;7728;3992;3736;2022
46;Valencia/València;179;Navarrés;2989;1490;1499;2022
46;Valencia/València;180;Novelé/Novetlè;861;426;435;2022
46;Valencia/València;181;Oliva;25179;12375;12804;2022
46;Valencia/València;183;Olleria, l';8355;4194;4161;2022
46;Valencia/València;182;Olocau;2148;1138;1010;2022
46;Valencia/València;184;Ontinyent;35946;17730;18216;2022
46;Valencia/València;185;Otos;428;216;212;2022
46;Valencia/València;186;Paiporta;26567;13062;13505;2022
46;Valencia/València;187;Palma de Gandía;1686;886;800;2022
46;Valencia/València;188;Palmera;1040;519;521;2022
46;Valencia/València;189;Palomar, el;566;289;277;2022
46;Valencia/València;190;Paterna;71880;35431;36449;2022
46;Valencia/València;191;Pedralba;2966;1567;1399;2022
46;Valencia/València;192;Petrés;1057;533;524;2022
46;Valencia/València;193;Picanya;11665;5758;5907;2022
46;Valencia/València;194;Picassent;21761;10945;10816;2022
46;Valencia/València;195;Piles;2882;1432;1450;2022
46;Valencia/València;196;Pinet;155;75;80;2022
46;Valencia/València;199;Pobla de Farnals, la;8368;4204;4164;2022
46;Valencia/València;202;Pobla de Vallbona, la;25625;12906;12719;2022
46;Valencia/València;200;Pobla del Duc, la;2447;1183;1264;2022
46;Valencia/València;203;Pobla Llarga, la;4443;2225;2218;2022
46;Valencia/València;197;Polinyà de Xúquer;2493;1266;1227;2022
46;Valencia/València;198;Potries;1075;549;526;2022
46;Valencia/València;205;Puçol;20191;9956;10235;2022
46;Valencia/València;201;Puebla de San Miguel;59;37;22;2022
46;Valencia/València;204;Puig de Santa Maria, el;8792;4276;4516;2022
46;Valencia/València;101;Quart de les Valls;1049;495;554;2022
46;Valencia/València;102;Quart de Poblet;25167;12230;12937;2022
46;Valencia/València;103;Quartell;1683;801;882;2022
46;Valencia/València;104;Quatretonda;2143;1078;1065;2022
46;Valencia/València;206;Quesa;647;333;314;2022
46;Valencia/València;207;Rafelbunyol;9381;4575;4806;2022
46;Valencia/València;208;Rafelcofer;1386;681;705;2022
46;Valencia/València;209;Rafelguaraf;2360;1169;1191;2022
46;Valencia/València;210;Ráfol de Salem;443;222;221;2022
46;Valencia/València;212;Real;2287;1185;1102;2022
46;Valencia/València;211;Real de Gandia, el;2574;1294;1280;2022
46;Valencia/València;213;Requena;20058;10047;10011;2022
46;Valencia/València;214;Riba-roja de Túria;23050;11643;11407;2022
46;Valencia/València;215;Riola;1793;896;897;2022
46;Valencia/València;216;Rocafort;7603;3709;3894;2022
46;Valencia/València;217;Rotglà i Corberà;1163;576;587;2022
46;Valencia/València;218;Ròtova;1265;638;627;2022
46;Valencia/València;219;Rugat;175;96;79;2022
46;Valencia/València;220;Sagunto/Sagunt;68066;33241;34825;2022
46;Valencia/València;221;Salem;411;211;200;2022
46;Valencia/València;903;San Antonio de Benagéber;9874;4901;4973;2022
46;Valencia/València;222;Sant Joanet;534;266;268;2022
46;Valencia/València;223;Sedaví;10349;5034;5315;2022
46;Valencia/València;224;Segart;174;91;83;2022
46;Valencia/València;225;Sellent;380;195;185;2022
46;Valencia/València;226;Sempere;26;15;11;2022
46;Valencia/València;227;Senyera;1108;539;569;2022
46;Valencia/València;228;Serra;3405;1733;1672;2022
46;Valencia/València;229;Siete Aguas;1180;618;562;2022
46;Valencia/València;230;Silla;19298;9574;9724;2022
46;Valencia/València;231;Simat de la Valldigna;3271;1626;1645;2022
46;Valencia/València;232;Sinarcas;1135;597;538;2022
46;Valencia/València;233;Sollana;4915;2419;2496;2022
46;Valencia/València;234;Sot de Chera;384;207;177;2022
46;Valencia/València;235;Sueca;27738;13682;14056;2022
46;Valencia/València;236;Sumacàrcer;1054;507;547;2022
46;Valencia/València;237;Tavernes Blanques;9222;4459;4763;2022
46;Valencia/València;238;Tavernes de la Valldigna;17222;8541;8681;2022
46;Valencia/València;239;Teresa de Cofrentes;615;320;295;2022
46;Valencia/València;240;Terrateig;287;149;138;2022
46;Valencia/València;241;Titaguas;485;255;230;2022
46;Valencia/València;242;Torrebaja;408;219;189;2022
46;Valencia/València;243;Torrella;134;73;61;2022
46;Valencia/València;244;Torrent;85142;41839;43303;2022
46;Valencia/València;245;Torres Torres;703;382;321;2022
46;Valencia/València;246;Tous;1312;660;652;2022
46;Valencia/València;247;Tuéjar;1168;628;540;2022
46;Valencia/València;248;Turís;7019;3658;3361;2022
46;Valencia/València;249;Utiel;11482;5735;5747;2022
46;Valencia/València;250;València;792492;376169;416323;2022
46;Valencia/València;251;Vallada;3065;1556;1509;2022
46;Valencia/València;252;Vallanca;128;71;57;2022
46;Valencia/València;253;Vallés;151;85;66;2022
46;Valencia/València;254;Venta del Moro;1180;633;547;2022
46;Valencia/València;255;Vilallonga/Villalonga;4555;2252;2303;2022
46;Valencia/València;256;Vilamarxant;10348;5354;4994;2022
46;Valencia/València;258;Villar del Arzobispo;3581;1810;1771;2022
46;Valencia/València;259;Villargordo del Cabriel;602;303;299;2022
46;Valencia/València;260;Vinalesa;3525;1710;1815;2022
46;Valencia/València;145;Xàtiva;29637;14453;15184;2022
46;Valencia/València;143;Xeraco;5819;2903;2916;2022
46;Valencia/València;146;Xeresa;2244;1141;1103;2022
46;Valencia/València;110;Xirivella;30326;14979;15347;2022
46;Valencia/València;261;Yátova;2169;1122;1047;2022
46;Valencia/València;262;Yesa, La;227;118;109;2022
46;Valencia/València;263;Zarra;370;201;169;2022
47;Valladolid;001;Adalia;54;32;22;2022
47;Valladolid;002;Aguasal;19;12;7;2022
47;Valladolid;003;Aguilar de Campos;276;166;110;2022
47;Valladolid;004;Alaejos;1385;742;643;2022
47;Valladolid;005;Alcazarén;643;342;301;2022
47;Valladolid;006;Aldea de San Miguel;214;120;94;2022
47;Valladolid;007;Aldeamayor de San Martín;5896;3047;2849;2022
47;Valladolid;008;Almenara de Adaja;23;12;11;2022
47;Valladolid;009;Amusquillo;99;61;38;2022
47;Valladolid;010;Arroyo de la Encomienda;21369;10683;10686;2022
47;Valladolid;011;Ataquines;548;302;246;2022
47;Valladolid;012;Bahabón;93;44;49;2022
47;Valladolid;013;Barcial de la Loma;96;56;40;2022
47;Valladolid;014;Barruelo del Valle;43;25;18;2022
47;Valladolid;015;Becilla de Valderaduey;211;117;94;2022
47;Valladolid;016;Benafarces;68;38;30;2022
47;Valladolid;017;Bercero;179;101;78;2022
47;Valladolid;018;Berceruelo;38;23;15;2022
47;Valladolid;019;Berrueces;101;54;47;2022
47;Valladolid;020;Bobadilla del Campo;281;161;120;2022
47;Valladolid;021;Bocigas;77;42;35;2022
47;Valladolid;022;Bocos de Duero;85;44;41;2022
47;Valladolid;023;Boecillo;4304;2172;2132;2022
47;Valladolid;024;Bolaños de Campos;246;141;105;2022
47;Valladolid;025;Brahojos de Medina;103;54;49;2022
47;Valladolid;026;Bustillo de Chaves;68;40;28;2022
47;Valladolid;027;Cabezón de Pisuerga;3769;1908;1861;2022
47;Valladolid;028;Cabezón de Valderaduey;42;24;18;2022
47;Valladolid;029;Cabreros del Monte;53;29;24;2022
47;Valladolid;030;Campaspero;1042;583;459;2022
47;Valladolid;031;Campillo, El;202;116;86;2022
47;Valladolid;032;Camporredondo;156;91;65;2022
47;Valladolid;033;Canalejas de Peñafiel;237;131;106;2022
47;Valladolid;034;Canillas de Esgueva;69;41;28;2022
47;Valladolid;035;Carpio;967;519;448;2022
47;Valladolid;036;Casasola de Arión;217;127;90;2022
47;Valladolid;037;Castrejón de Trabancos;177;91;86;2022
47;Valladolid;038;Castrillo de Duero;116;67;49;2022
47;Valladolid;039;Castrillo-Tejeriego;161;90;71;2022
47;Valladolid;040;Castrobol;56;30;26;2022
47;Valladolid;041;Castrodeza;149;93;56;2022
47;Valladolid;042;Castromembibre;51;36;15;2022
47;Valladolid;043;Castromonte;314;168;146;2022
47;Valladolid;044;Castronuevo de Esgueva;394;211;183;2022
47;Valladolid;045;Castronuño;812;409;403;2022
47;Valladolid;046;Castroponce;139;76;63;2022
47;Valladolid;047;Castroverde de Cerrato;203;132;71;2022
47;Valladolid;048;Ceinos de Campos;197;111;86;2022
47;Valladolid;049;Cervillego de la Cruz;91;54;37;2022
47;Valladolid;050;Cigales;5286;2707;2579;2022
47;Valladolid;051;Ciguñuela;356;187;169;2022
47;Valladolid;052;Cistérniga;9129;4605;4524;2022
47;Valladolid;053;Cogeces de Íscar;144;73;71;2022
47;Valladolid;054;Cogeces del Monte;630;338;292;2022
47;Valladolid;055;Corcos;199;112;87;2022
47;Valladolid;056;Corrales de Duero;99;60;39;2022
47;Valladolid;057;Cubillas de Santa Marta;368;214;154;2022
47;Valladolid;058;Cuenca de Campos;209;109;100;2022
47;Valladolid;059;Curiel de Duero;112;72;40;2022
47;Valladolid;060;Encinas de Esgueva;210;119;91;2022
47;Valladolid;061;Esguevillas de Esgueva;269;145;124;2022
47;Valladolid;062;Fombellida;181;104;77;2022
47;Valladolid;063;Fompedraza;109;58;51;2022
47;Valladolid;064;Fontihoyuelo;37;23;14;2022
47;Valladolid;065;Fresno el Viejo;860;455;405;2022
47;Valladolid;066;Fuensaldaña;2025;1048;977;2022
47;Valladolid;067;Fuente el Sol;156;81;75;2022
47;Valladolid;068;Fuente-Olmedo;36;19;17;2022
47;Valladolid;069;Gallegos de Hornija;110;54;56;2022
47;Valladolid;070;Gatón de Campos;29;17;12;2022
47;Valladolid;071;Geria;504;239;265;2022
47;Valladolid;073;Herrín de Campos;123;66;57;2022
47;Valladolid;074;Hornillos de Eresma;174;98;76;2022
47;Valladolid;075;Íscar;6302;3176;3126;2022
47;Valladolid;076;Laguna de Duero;22642;11245;11397;2022
47;Valladolid;077;Langayo;254;159;95;2022
47;Valladolid;079;Llano de Olmedo;52;26;26;2022
47;Valladolid;078;Lomoviejo;172;93;79;2022
47;Valladolid;080;Manzanillo;54;27;27;2022
47;Valladolid;081;Marzales;45;20;25;2022
47;Valladolid;082;Matapozuelos;1001;504;497;2022
47;Valladolid;083;Matilla de los Caños;99;51;48;2022
47;Valladolid;084;Mayorga;1455;727;728;2022
47;Valladolid;086;Medina de Rioseco;4493;2221;2272;2022
47;Valladolid;085;Medina del Campo;20183;9829;10354;2022
47;Valladolid;087;Megeces;434;233;201;2022
47;Valladolid;088;Melgar de Abajo;116;63;53;2022
47;Valladolid;089;Melgar de Arriba;168;92;76;2022
47;Valladolid;090;Mojados;3312;1718;1594;2022
47;Valladolid;091;Monasterio de Vega;81;44;37;2022
47;Valladolid;092;Montealegre de Campos;104;59;45;2022
47;Valladolid;093;Montemayor de Pililla;856;460;396;2022
47;Valladolid;094;Moral de la Reina;151;81;70;2022
47;Valladolid;095;Moraleja de las Panaderas;42;24;18;2022
47;Valladolid;096;Morales de Campos;135;71;64;2022
47;Valladolid;097;Mota del Marqués;332;184;148;2022
47;Valladolid;098;Mucientes;659;334;325;2022
47;Valladolid;099;Mudarra, La;165;86;79;2022
47;Valladolid;100;Muriel;118;60;58;2022
47;Valladolid;101;Nava del Rey;1951;1004;947;2022
47;Valladolid;102;Nueva Villa de las Torres;282;162;120;2022
47;Valladolid;103;Olivares de Duero;307;174;133;2022
47;Valladolid;104;Olmedo;3554;1772;1782;2022
47;Valladolid;105;Olmos de Esgueva;186;100;86;2022
47;Valladolid;106;Olmos de Peñafiel;42;22;20;2022
47;Valladolid;109;Palazuelo de Vedija;168;84;84;2022
47;Valladolid;110;Parrilla, La;487;246;241;2022
47;Valladolid;111;Pedraja de Portillo, La;1138;587;551;2022
47;Valladolid;112;Pedrajas de San Esteban;3371;1713;1658;2022
47;Valladolid;113;Pedrosa del Rey;147;81;66;2022
47;Valladolid;114;Peñafiel;5104;2591;2513;2022
47;Valladolid;115;Peñaflor de Hornija;337;180;157;2022
47;Valladolid;116;Pesquera de Duero;428;227;201;2022
47;Valladolid;117;Piña de Esgueva;318;163;155;2022
47;Valladolid;118;Piñel de Abajo;152;86;66;2022
47;Valladolid;119;Piñel de Arriba;90;47;43;2022
47;Valladolid;121;Pollos;614;352;262;2022
47;Valladolid;122;Portillo;2382;1223;1159;2022
47;Valladolid;123;Pozal de Gallinas;527;283;244;2022
47;Valladolid;124;Pozaldez;498;266;232;2022
47;Valladolid;125;Pozuelo de la Orden;49;28;21;2022
47;Valladolid;126;Puras;44;24;20;2022
47;Valladolid;127;Quintanilla de Arriba;158;89;69;2022
47;Valladolid;129;Quintanilla de Onésimo;1014;538;476;2022
47;Valladolid;130;Quintanilla de Trigueros;104;51;53;2022
47;Valladolid;128;Quintanilla del Molar;53;26;27;2022
47;Valladolid;131;Rábano;173;90;83;2022
47;Valladolid;132;Ramiro;47;27;20;2022
47;Valladolid;133;Renedo de Esgueva;3908;1986;1922;2022
47;Valladolid;134;Roales de Campos;175;98;77;2022
47;Valladolid;135;Robladillo;87;50;37;2022
47;Valladolid;137;Roturas;30;19;11;2022
47;Valladolid;138;Rubí de Bracamonte;213;126;87;2022
47;Valladolid;139;Rueda;1140;592;548;2022
47;Valladolid;140;Saelices de Mayorga;110;69;41;2022
47;Valladolid;141;Salvador de Zapardiel;105;59;46;2022
47;Valladolid;142;San Cebrián de Mazote;114;67;47;2022
47;Valladolid;143;San Llorente;105;60;45;2022
47;Valladolid;144;San Martín de Valvení;78;43;35;2022
47;Valladolid;145;San Miguel del Arroyo;646;345;301;2022
47;Valladolid;146;San Miguel del Pino;355;184;171;2022
47;Valladolid;147;San Pablo de la Moraleja;111;61;50;2022
47;Valladolid;148;San Pedro de Latarce;448;240;208;2022
47;Valladolid;149;San Pelayo;48;22;26;2022
47;Valladolid;150;San Román de Hornija;301;143;158;2022
47;Valladolid;151;San Salvador;23;14;9;2022
47;Valladolid;156;San Vicente del Palacio;158;85;73;2022
47;Valladolid;152;Santa Eufemia del Arroyo;69;38;31;2022
47;Valladolid;153;Santervás de Campos;105;58;47;2022
47;Valladolid;154;Santibáñez de Valcorba;183;106;77;2022
47;Valladolid;155;Santovenia de Pisuerga;4612;2354;2258;2022
47;Valladolid;157;Sardón de Duero;596;320;276;2022
47;Valladolid;158;Seca, La;1066;559;507;2022
47;Valladolid;159;Serrada;1124;584;540;2022
47;Valladolid;160;Siete Iglesias de Trabancos;432;226;206;2022
47;Valladolid;161;Simancas;5423;2752;2671;2022
47;Valladolid;162;Tamariz de Campos;88;49;39;2022
47;Valladolid;163;Tiedra;289;145;144;2022
47;Valladolid;164;Tordehumos;375;204;171;2022
47;Valladolid;165;Tordesillas;8664;4371;4293;2022
47;Valladolid;169;Torre de Esgueva;60;33;27;2022
47;Valladolid;170;Torre de Peñafiel;48;29;19;2022
47;Valladolid;166;Torrecilla de la Abadesa;261;123;138;2022
47;Valladolid;167;Torrecilla de la Orden;230;115;115;2022
47;Valladolid;168;Torrecilla de la Torre;34;22;12;2022
47;Valladolid;171;Torrelobatón;391;207;184;2022
47;Valladolid;172;Torrescárcela;161;86;75;2022
47;Valladolid;173;Traspinedo;1201;632;569;2022
47;Valladolid;174;Trigueros del Valle;312;170;142;2022
47;Valladolid;175;Tudela de Duero;8636;4374;4262;2022
47;Valladolid;176;Unión de Campos, La;209;102;107;2022
47;Valladolid;177;Urones de Castroponce;101;61;40;2022
47;Valladolid;178;Urueña;203;111;92;2022
47;Valladolid;179;Valbuena de Duero;411;229;182;2022
47;Valladolid;180;Valdearcos de la Vega;49;27;22;2022
47;Valladolid;181;Valdenebro de los Valles;193;108;85;2022
47;Valladolid;182;Valdestillas;1599;823;776;2022
47;Valladolid;183;Valdunquillo;130;64;66;2022
47;Valladolid;186;Valladolid;295639;138427;157212;2022
47;Valladolid;184;Valoria la Buena;683;372;311;2022
47;Valladolid;185;Valverde de Campos;81;47;34;2022
47;Valladolid;187;Vega de Ruiponce;86;51;35;2022
47;Valladolid;188;Vega de Valdetronco;92;51;41;2022
47;Valladolid;189;Velascálvaro;163;85;78;2022
47;Valladolid;190;Velilla;114;57;57;2022
47;Valladolid;191;Velliza;119;78;41;2022
47;Valladolid;192;Ventosa de la Cuesta;99;56;43;2022
47;Valladolid;193;Viana de Cega;2194;1143;1051;2022
47;Valladolid;195;Villabáñez;499;270;229;2022
47;Valladolid;196;Villabaruz de Campos;27;13;14;2022
47;Valladolid;197;Villabrágima;1047;560;487;2022
47;Valladolid;198;Villacarralón;64;42;22;2022
47;Valladolid;199;Villacid de Campos;86;49;37;2022
47;Valladolid;200;Villaco;75;48;27;2022
47;Valladolid;203;Villafrades de Campos;61;30;31;2022
47;Valladolid;204;Villafranca de Duero;251;129;122;2022
47;Valladolid;205;Villafrechós;471;262;209;2022
47;Valladolid;206;Villafuerte;86;50;36;2022
47;Valladolid;207;Villagarcía de Campos;288;171;117;2022
47;Valladolid;208;Villagómez la Nueva;58;33;25;2022
47;Valladolid;209;Villalán de Campos;38;24;14;2022
47;Valladolid;210;Villalar de los Comuneros;493;240;253;2022
47;Valladolid;211;Villalba de la Loma;59;30;29;2022
47;Valladolid;212;Villalba de los Alcores;374;206;168;2022
47;Valladolid;213;Villalbarba;102;53;49;2022
47;Valladolid;214;Villalón de Campos;1523;752;771;2022
47;Valladolid;215;Villamuriel de Campos;47;23;24;2022
47;Valladolid;216;Villán de Tordesillas;128;72;56;2022
47;Valladolid;217;Villanubla;2886;1490;1396;2022
47;Valladolid;218;Villanueva de Duero;1238;658;580;2022
47;Valladolid;219;Villanueva de la Condesa;58;27;31;2022
47;Valladolid;220;Villanueva de los Caballeros;167;88;79;2022
47;Valladolid;221;Villanueva de los Infantes;102;61;41;2022
47;Valladolid;222;Villanueva de San Mancio;93;52;41;2022
47;Valladolid;223;Villardefrades;149;85;64;2022
47;Valladolid;224;Villarmentero de Esgueva;96;52;44;2022
47;Valladolid;225;Villasexmir;72;43;29;2022
47;Valladolid;226;Villavaquerín;163;93;70;2022
47;Valladolid;227;Villavellid;50;30;20;2022
47;Valladolid;228;Villaverde de Medina;522;284;238;2022
47;Valladolid;229;Villavicencio de los Caballeros;232;122;110;2022
47;Valladolid;194;Viloria;343;180;163;2022
47;Valladolid;230;Wamba;309;168;141;2022
47;Valladolid;231;Zaratán;6285;3204;3081;2022
47;Valladolid;232;Zarza, La;115;66;49;2022
49;Zamora;002;Abezames;65;34;31;2022
49;Zamora;003;Alcañices;1024;535;489;2022
49;Zamora;004;Alcubilla de Nogales;116;61;55;2022
49;Zamora;005;Alfaraz de Sayago;127;76;51;2022
49;Zamora;006;Algodre;135;73;62;2022
49;Zamora;007;Almaraz de Duero;401;211;190;2022
49;Zamora;008;Almeida de Sayago;414;225;189;2022
49;Zamora;009;Andavías;445;226;219;2022
49;Zamora;010;Arcenillas;447;223;224;2022
49;Zamora;011;Arcos de la Polvorosa;220;121;99;2022
49;Zamora;012;Argañín;74;37;37;2022
49;Zamora;013;Argujillo;219;113;106;2022
49;Zamora;014;Arquillinos;117;61;56;2022
49;Zamora;015;Arrabalde;218;114;104;2022
49;Zamora;016;Aspariegos;231;99;132;2022
49;Zamora;017;Asturianos;266;135;131;2022
49;Zamora;018;Ayoó de Vidriales;273;136;137;2022
49;Zamora;019;Barcial del Barco;236;122;114;2022
49;Zamora;020;Belver de los Montes;253;140;113;2022
49;Zamora;021;Benavente;17376;8366;9010;2022
49;Zamora;022;Benegiles;294;161;133;2022
49;Zamora;023;Bermillo de Sayago;1002;532;470;2022
49;Zamora;024;Bóveda de Toro, La;683;348;335;2022
49;Zamora;025;Bretó;156;90;66;2022
49;Zamora;026;Bretocino;201;106;95;2022
49;Zamora;027;Brime de Sog;124;58;66;2022
49;Zamora;028;Brime de Urz;105;63;42;2022
49;Zamora;029;Burganes de Valverde;623;330;293;2022
49;Zamora;030;Bustillo del Oro;86;49;37;2022
49;Zamora;031;Cabañas de Sayago;143;78;65;2022
49;Zamora;032;Calzadilla de Tera;302;156;146;2022
49;Zamora;033;Camarzana de Tera;735;370;365;2022
49;Zamora;034;Cañizal;415;221;194;2022
49;Zamora;035;Cañizo;217;120;97;2022
49;Zamora;036;Carbajales de Alba;487;252;235;2022
49;Zamora;037;Carbellino;176;95;81;2022
49;Zamora;038;Casaseca de Campeán;96;57;39;2022
49;Zamora;039;Casaseca de las Chanas;375;200;175;2022
49;Zamora;040;Castrillo de la Guareña;118;66;52;2022
49;Zamora;041;Castrogonzalo;441;239;202;2022
49;Zamora;042;Castronuevo;214;108;106;2022
49;Zamora;043;Castroverde de Campos;276;148;128;2022
49;Zamora;044;Cazurra;70;37;33;2022
49;Zamora;046;Cerecinos de Campos;238;133;105;2022
49;Zamora;047;Cerecinos del Carrizal;107;65;42;2022
49;Zamora;048;Cernadilla;109;55;54;2022
49;Zamora;050;Cobreros;543;296;247;2022
49;Zamora;052;Coomonte;194;107;87;2022
49;Zamora;053;Coreses;1049;541;508;2022
49;Zamora;054;Corrales del Vino;960;472;488;2022
49;Zamora;055;Cotanes del Monte;97;54;43;2022
49;Zamora;056;Cubillos;297;141;156;2022
49;Zamora;057;Cubo de Benavente;121;63;58;2022
49;Zamora;058;Cubo de Tierra del Vino, El;321;173;148;2022
49;Zamora;059;Cuelgamures;81;51;30;2022
49;Zamora;061;Entrala;137;76;61;2022
49;Zamora;062;Espadañedo;113;60;53;2022
49;Zamora;063;Faramontanos de Tábara;335;172;163;2022
49;Zamora;064;Fariza;487;249;238;2022
49;Zamora;065;Fermoselle;1128;572;556;2022
49;Zamora;066;Ferreras de Abajo;482;234;248;2022
49;Zamora;067;Ferreras de Arriba;359;201;158;2022
49;Zamora;068;Ferreruela;429;241;188;2022
49;Zamora;069;Figueruela de Arriba;294;139;155;2022
49;Zamora;071;Fonfría;755;399;356;2022
49;Zamora;075;Fresno de la Polvorosa;116;60;56;2022
49;Zamora;076;Fresno de la Ribera;353;185;168;2022
49;Zamora;077;Fresno de Sayago;156;77;79;2022
49;Zamora;078;Friera de Valverde;133;72;61;2022
49;Zamora;079;Fuente Encalada;102;55;47;2022
49;Zamora;080;Fuentelapeña;658;349;309;2022
49;Zamora;082;Fuentes de Ropel;366;194;172;2022
49;Zamora;081;Fuentesaúco;1601;805;796;2022
49;Zamora;083;Fuentesecas;48;26;22;2022
49;Zamora;084;Fuentespreadas;281;155;126;2022
49;Zamora;085;Galende;973;491;482;2022
49;Zamora;086;Gallegos del Pan;111;63;48;2022
49;Zamora;087;Gallegos del Río;478;268;210;2022
49;Zamora;088;Gamones;94;53;41;2022
49;Zamora;090;Gema;199;100;99;2022
49;Zamora;091;Granja de Moreruela;259;132;127;2022
49;Zamora;092;Granucillo;114;60;54;2022
49;Zamora;093;Guarrate;315;166;149;2022
49;Zamora;094;Hermisende;248;132;116;2022
49;Zamora;095;Hiniesta, La;309;166;143;2022
49;Zamora;096;Jambrina;145;77;68;2022
49;Zamora;097;Justel;69;46;23;2022
49;Zamora;098;Losacino;203;112;91;2022
49;Zamora;099;Losacio;86;52;34;2022
49;Zamora;100;Lubián;305;161;144;2022
49;Zamora;101;Luelmo;155;86;69;2022
49;Zamora;102;Maderal, El;175;94;81;2022
49;Zamora;103;Madridanos;467;243;224;2022
49;Zamora;104;Mahide;310;171;139;2022
49;Zamora;105;Maire de Castroponce;139;75;64;2022
49;Zamora;107;Malva;113;51;62;2022
49;Zamora;108;Manganeses de la Lampreana;454;236;218;2022
49;Zamora;109;Manganeses de la Polvorosa;623;303;320;2022
49;Zamora;110;Manzanal de Arriba;345;184;161;2022
49;Zamora;112;Manzanal de los Infantes;130;71;59;2022
49;Zamora;111;Manzanal del Barco;134;70;64;2022
49;Zamora;113;Matilla de Arzón;163;96;67;2022
49;Zamora;114;Matilla la Seca;36;20;16;2022
49;Zamora;115;Mayalde;169;96;73;2022
49;Zamora;116;Melgar de Tera;344;180;164;2022
49;Zamora;117;Micereces de Tera;438;225;213;2022
49;Zamora;118;Milles de la Polvorosa;204;113;91;2022
49;Zamora;119;Molacillos;241;133;108;2022
49;Zamora;120;Molezuelas de la Carballeda;51;26;25;2022
49;Zamora;121;Mombuey;403;217;186;2022
49;Zamora;122;Monfarracinos;978;512;466;2022
49;Zamora;123;Montamarta;558;300;258;2022
49;Zamora;124;Moral de Sayago;258;150;108;2022
49;Zamora;126;Moraleja de Sayago;290;143;147;2022
49;Zamora;125;Moraleja del Vino;1756;885;871;2022
49;Zamora;128;Morales de Rey;556;275;281;2022
49;Zamora;129;Morales de Toro;943;488;455;2022
49;Zamora;130;Morales de Valverde;165;84;81;2022
49;Zamora;127;Morales del Vino;3060;1600;1460;2022
49;Zamora;131;Moralina;227;119;108;2022
49;Zamora;132;Moreruela de los Infanzones;326;167;159;2022
49;Zamora;133;Moreruela de Tábara;302;159;143;2022
49;Zamora;134;Muelas de los Caballeros;181;105;76;2022
49;Zamora;135;Muelas del Pan;588;316;272;2022
49;Zamora;136;Muga de Sayago;340;169;171;2022
49;Zamora;137;Navianos de Valverde;171;98;73;2022
49;Zamora;138;Olmillos de Castro;207;110;97;2022
49;Zamora;139;Otero de Bodas;149;78;71;2022
49;Zamora;141;Pajares de la Lampreana;287;149;138;2022
49;Zamora;143;Palacios de Sanabria;246;125;121;2022
49;Zamora;142;Palacios del Pan;252;134;118;2022
49;Zamora;145;Pedralba de la Pradería;212;118;94;2022
49;Zamora;146;Pego, El;290;145;145;2022
49;Zamora;147;Peleagonzalo;270;134;136;2022
49;Zamora;148;Peleas de Abajo;252;115;137;2022
49;Zamora;149;Peñausende;361;188;173;2022
49;Zamora;150;Peque;130;56;74;2022
49;Zamora;151;Perdigón, El;639;337;302;2022
49;Zamora;152;Pereruela;521;282;239;2022
49;Zamora;153;Perilla de Castro;164;90;74;2022
49;Zamora;154;Pías;109;63;46;2022
49;Zamora;155;Piedrahita de Castro;106;58;48;2022
49;Zamora;156;Pinilla de Toro;200;103;97;2022
49;Zamora;157;Pino del Oro;180;93;87;2022
49;Zamora;158;Piñero, El;220;112;108;2022
49;Zamora;160;Pobladura de Valderaduey;37;21;16;2022
49;Zamora;159;Pobladura del Valle;288;156;132;2022
49;Zamora;162;Porto;160;90;70;2022
49;Zamora;163;Pozoantiguo;187;97;90;2022
49;Zamora;164;Pozuelo de Tábara;154;85;69;2022
49;Zamora;165;Prado;47;27;20;2022
49;Zamora;166;Puebla de Sanabria;1357;659;698;2022
49;Zamora;167;Pueblica de Valverde;182;96;86;2022
49;Zamora;170;Quintanilla de Urz;109;55;54;2022
49;Zamora;168;Quintanilla del Monte;104;61;43;2022
49;Zamora;169;Quintanilla del Olmo;44;25;19;2022
49;Zamora;171;Quiruelas de Vidriales;647;345;302;2022
49;Zamora;172;Rabanales;502;267;235;2022
49;Zamora;173;Rábano de Aliste;328;164;164;2022
49;Zamora;174;Requejo;130;71;59;2022
49;Zamora;175;Revellinos;252;130;122;2022
49;Zamora;176;Riofrío de Aliste;632;352;280;2022
49;Zamora;177;Rionegro del Puente;244;131;113;2022
49;Zamora;178;Roales;1001;518;483;2022
49;Zamora;179;Robleda-Cervantes;395;212;183;2022
49;Zamora;180;Roelos de Sayago;138;69;69;2022
49;Zamora;181;Rosinos de la Requejada;322;171;151;2022
49;Zamora;183;Salce;89;38;51;2022
49;Zamora;184;Samir de los Caños;163;92;71;2022
49;Zamora;185;San Agustín del Pozo;175;87;88;2022
49;Zamora;186;San Cebrián de Castro;253;124;129;2022
49;Zamora;187;San Cristóbal de Entreviñas;1375;725;650;2022
49;Zamora;188;San Esteban del Molar;108;64;44;2022
49;Zamora;189;San Justo;197;103;94;2022
49;Zamora;190;San Martín de Valderaduey;57;32;25;2022
49;Zamora;191;San Miguel de la Ribera;275;141;134;2022
49;Zamora;192;San Miguel del Valle;119;64;55;2022
49;Zamora;193;San Pedro de Ceque;439;231;208;2022
49;Zamora;194;San Pedro de la Nave-Almendra;336;176;160;2022
49;Zamora;208;San Vicente de la Cabeza;336;180;156;2022
49;Zamora;209;San Vitero;449;259;190;2022
49;Zamora;197;Santa Clara de Avedillo;163;79;84;2022
49;Zamora;199;Santa Colomba de las Monjas;246;123;123;2022
49;Zamora;200;Santa Cristina de la Polvorosa;1066;548;518;2022
49;Zamora;201;Santa Croya de Tera;291;148;143;2022
49;Zamora;202;Santa Eufemia del Barco;174;103;71;2022
49;Zamora;203;Santa María de la Vega;286;146;140;2022
49;Zamora;204;Santa María de Valverde;58;28;30;2022
49;Zamora;205;Santibáñez de Tera;360;181;179;2022
49;Zamora;206;Santibáñez de Vidriales;889;452;437;2022
49;Zamora;207;Santovenia;231;121;110;2022
49;Zamora;210;Sanzoles;467;240;227;2022
49;Zamora;214;Tábara;743;368;375;2022
49;Zamora;216;Tapioles;137;79;58;2022
49;Zamora;219;Toro;8448;4131;4317;2022
49;Zamora;220;Torre del Valle, La;137;77;60;2022
49;Zamora;221;Torregamones;240;125;115;2022
49;Zamora;222;Torres del Carrizal;415;213;202;2022
49;Zamora;223;Trabazos;855;453;402;2022
49;Zamora;224;Trefacio;185;103;82;2022
49;Zamora;225;Uña de Quintana;132;71;61;2022
49;Zamora;226;Vadillo de la Guareña;251;142;109;2022
49;Zamora;227;Valcabado;391;204;187;2022
49;Zamora;228;Valdefinjas;61;37;24;2022
49;Zamora;229;Valdescorriel;130;68;62;2022
49;Zamora;230;Vallesa de la Guareña;69;38;31;2022
49;Zamora;231;Vega de Tera;311;158;153;2022
49;Zamora;232;Vega de Villalobos;85;34;51;2022
49;Zamora;233;Vegalatrave;81;43;38;2022
49;Zamora;234;Venialbo;415;221;194;2022
49;Zamora;235;Vezdemarbán;444;233;211;2022
49;Zamora;236;Vidayanes;82;41;41;2022
49;Zamora;237;Videmala;142;71;71;2022
49;Zamora;238;Villabrázaro;239;126;113;2022
49;Zamora;239;Villabuena del Puente;599;308;291;2022
49;Zamora;240;Villadepera;183;99;84;2022
49;Zamora;241;Villaescusa;235;127;108;2022
49;Zamora;242;Villafáfila;458;234;224;2022
49;Zamora;243;Villaferrueña;107;56;51;2022
49;Zamora;244;Villageriz;45;26;19;2022
49;Zamora;245;Villalazán;254;128;126;2022
49;Zamora;246;Villalba de la Lampreana;229;130;99;2022
49;Zamora;247;Villalcampo;400;203;197;2022
49;Zamora;248;Villalobos;224;119;105;2022
49;Zamora;249;Villalonso;70;32;38;2022
49;Zamora;250;Villalpando;1436;699;737;2022
49;Zamora;251;Villalube;158;85;73;2022
49;Zamora;252;Villamayor de Campos;321;167;154;2022
49;Zamora;255;Villamor de los Escuderos;382;203;179;2022
49;Zamora;256;Villanázar;274;147;127;2022
49;Zamora;257;Villanueva de Azoague;356;186;170;2022
49;Zamora;258;Villanueva de Campeán;119;63;56;2022
49;Zamora;259;Villanueva de las Peras;86;42;44;2022
49;Zamora;260;Villanueva del Campo;787;389;398;2022
49;Zamora;263;Villar de Fallaves;46;27;19;2022
49;Zamora;264;Villar del Buey;529;278;251;2022
49;Zamora;261;Villaralbo;1763;897;866;2022
49;Zamora;262;Villardeciervos;400;200;200;2022
49;Zamora;265;Villardiegua de la Ribera;114;63;51;2022
49;Zamora;266;Villárdiga;73;42;31;2022
49;Zamora;267;Villardondiego;125;72;53;2022
49;Zamora;268;Villarrín de Campos;392;207;185;2022
49;Zamora;269;Villaseco del Pan;222;105;117;2022
49;Zamora;270;Villavendimio;152;93;59;2022
49;Zamora;272;Villaveza de Valverde;70;36;34;2022
49;Zamora;271;Villaveza del Agua;174;92;82;2022
49;Zamora;273;Viñas;160;87;73;2022
49;Zamora;275;Zamora;59475;27529;31946;2022
50;Zaragoza;001;Abanto;89;55;34;2022
50;Zaragoza;002;Acered;138;78;60;2022
50;Zaragoza;003;Agón;139;79;60;2022
50;Zaragoza;004;Aguarón;610;324;286;2022
50;Zaragoza;005;Aguilón;244;138;106;2022
50;Zaragoza;006;Ainzón;1066;551;515;2022
50;Zaragoza;007;Aladrén;59;39;20;2022
50;Zaragoza;008;Alagón;7178;3602;3576;2022
50;Zaragoza;009;Alarba;104;59;45;2022
50;Zaragoza;010;Alberite de San Juan;78;44;34;2022
50;Zaragoza;011;Albeta;144;71;73;2022
50;Zaragoza;012;Alborge;111;60;51;2022
50;Zaragoza;013;Alcalá de Ebro;239;114;125;2022
50;Zaragoza;014;Alcalá de Moncayo;157;88;69;2022
50;Zaragoza;015;Alconchel de Ariza;80;47;33;2022
50;Zaragoza;016;Aldehuela de Liestos;52;38;14;2022
50;Zaragoza;017;Alfajarín;2434;1238;1196;2022
50;Zaragoza;018;Alfamén;1477;764;713;2022
50;Zaragoza;019;Alforque;64;38;26;2022
50;Zaragoza;020;Alhama de Aragón;964;508;456;2022
50;Zaragoza;021;Almochuel;22;12;10;2022
50;Zaragoza;022;Almolda, La;549;272;277;2022
50;Zaragoza;023;Almonacid de la Cuba;234;117;117;2022
50;Zaragoza;024;Almonacid de la Sierra;756;429;327;2022
50;Zaragoza;025;Almunia de Doña Godina, La;7943;4135;3808;2022
50;Zaragoza;026;Alpartir;602;318;284;2022
50;Zaragoza;027;Ambel;253;127;126;2022
50;Zaragoza;028;Anento;101;71;30;2022
50;Zaragoza;029;Aniñón;659;342;317;2022
50;Zaragoza;030;Añón de Moncayo;202;119;83;2022
50;Zaragoza;031;Aranda de Moncayo;132;83;49;2022
50;Zaragoza;032;Arándiga;287;155;132;2022
50;Zaragoza;033;Ardisa;74;47;27;2022
50;Zaragoza;034;Ariza;1045;533;512;2022
50;Zaragoza;035;Artieda;82;47;35;2022
50;Zaragoza;036;Asín;104;57;47;2022
50;Zaragoza;037;Atea;141;84;57;2022
50;Zaragoza;038;Ateca;1690;872;818;2022
50;Zaragoza;039;Azuara;539;301;238;2022
50;Zaragoza;040;Badules;74;41;33;2022
50;Zaragoza;041;Bagüés;15;7;8;2022
50;Zaragoza;042;Balconchán;18;6;12;2022
50;Zaragoza;043;Bárboles;297;168;129;2022
50;Zaragoza;044;Bardallur;249;123;126;2022
50;Zaragoza;045;Belchite;1533;768;765;2022
50;Zaragoza;046;Belmonte de Gracián;183;100;83;2022
50;Zaragoza;047;Berdejo;42;29;13;2022
50;Zaragoza;048;Berrueco;32;19;13;2022
50;Zaragoza;901;Biel;170;102;68;2022
50;Zaragoza;050;Bijuesca;89;62;27;2022
50;Zaragoza;051;Biota;874;443;431;2022
50;Zaragoza;052;Bisimbre;80;43;37;2022
50;Zaragoza;053;Boquiñeni;790;398;392;2022
50;Zaragoza;054;Bordalba;49;30;19;2022
50;Zaragoza;055;Borja;5054;2601;2453;2022
50;Zaragoza;056;Botorrita;526;289;237;2022
50;Zaragoza;057;Brea de Aragón;1547;779;768;2022
50;Zaragoza;058;Bubierca;60;30;30;2022
50;Zaragoza;059;Bujaraloz;1013;526;487;2022
50;Zaragoza;060;Bulbuente;244;132;112;2022
50;Zaragoza;061;Bureta;213;110;103;2022
50;Zaragoza;062;Burgo de Ebro, El;2591;1294;1297;2022
50;Zaragoza;063;Buste, El;71;41;30;2022
50;Zaragoza;064;Cabañas de Ebro;491;256;235;2022
50;Zaragoza;065;Cabolafuente;49;28;21;2022
50;Zaragoza;066;Cadrete;4473;2355;2118;2022
50;Zaragoza;067;Calatayud;19776;9734;10042;2022
50;Zaragoza;068;Calatorao;2882;1502;1380;2022
50;Zaragoza;069;Calcena;74;43;31;2022
50;Zaragoza;070;Calmarza;63;35;28;2022
50;Zaragoza;071;Campillo de Aragón;127;74;53;2022
50;Zaragoza;072;Carenas;178;101;77;2022
50;Zaragoza;073;Cariñena;3345;1686;1659;2022
50;Zaragoza;074;Caspe;10220;5402;4818;2022
50;Zaragoza;075;Castejón de Alarba;73;47;26;2022
50;Zaragoza;076;Castejón de las Armas;81;43;38;2022
50;Zaragoza;077;Castejón de Valdejasa;209;102;107;2022
50;Zaragoza;078;Castiliscar;230;118;112;2022
50;Zaragoza;079;Cervera de la Cañada;264;146;118;2022
50;Zaragoza;080;Cerveruela;39;25;14;2022
50;Zaragoza;081;Cetina;570;285;285;2022
50;Zaragoza;092;Chiprana;515;267;248;2022
50;Zaragoza;093;Chodes;96;53;43;2022
50;Zaragoza;082;Cimballa;86;42;44;2022
50;Zaragoza;083;Cinco Olivas;102;50;52;2022
50;Zaragoza;084;Clarés de Ribota;71;39;32;2022
50;Zaragoza;085;Codo;208;109;99;2022
50;Zaragoza;086;Codos;232;156;76;2022
50;Zaragoza;087;Contamina;31;18;13;2022
50;Zaragoza;088;Cosuenda;326;167;159;2022
50;Zaragoza;089;Cuarte de Huerva;14169;7218;6951;2022
50;Zaragoza;090;Cubel;153;72;81;2022
50;Zaragoza;091;Cuerlas, Las;39;21;18;2022
50;Zaragoza;094;Daroca;1921;943;978;2022
50;Zaragoza;095;Ejea de los Caballeros;17124;8835;8289;2022
50;Zaragoza;096;Embid de Ariza;31;18;13;2022
50;Zaragoza;098;Encinacorba;185;95;90;2022
50;Zaragoza;099;Épila;4447;2287;2160;2022
50;Zaragoza;100;Erla;360;183;177;2022
50;Zaragoza;101;Escatrón;1156;579;577;2022
50;Zaragoza;102;Fabara;1088;594;494;2022
50;Zaragoza;104;Farlete;376;186;190;2022
50;Zaragoza;105;Fayón;397;219;178;2022
50;Zaragoza;106;Fayos, Los;131;72;59;2022
50;Zaragoza;107;Figueruelas;1226;607;619;2022
50;Zaragoza;108;Fombuena;59;35;24;2022
50;Zaragoza;109;Frago, El;117;74;43;2022
50;Zaragoza;110;Frasno, El;379;205;174;2022
50;Zaragoza;111;Fréscano;204;114;90;2022
50;Zaragoza;113;Fuendejalón;763;414;349;2022
50;Zaragoza;114;Fuendetodos;144;82;62;2022
50;Zaragoza;115;Fuentes de Ebro;4613;2387;2226;2022
50;Zaragoza;116;Fuentes de Jiloca;208;117;91;2022
50;Zaragoza;117;Gallocanta;120;67;53;2022
50;Zaragoza;118;Gallur;2563;1300;1263;2022
50;Zaragoza;119;Gelsa;1007;533;474;2022
50;Zaragoza;120;Godojos;49;27;22;2022
50;Zaragoza;121;Gotor;290;148;142;2022
50;Zaragoza;122;Grisel;82;49;33;2022
50;Zaragoza;123;Grisén;623;323;300;2022
50;Zaragoza;124;Herrera de los Navarros;523;290;233;2022
50;Zaragoza;125;Ibdes;384;201;183;2022
50;Zaragoza;126;Illueca;2746;1390;1356;2022
50;Zaragoza;128;Isuerre;33;17;16;2022
50;Zaragoza;129;Jaraba;280;157;123;2022
50;Zaragoza;130;Jarque de Moncayo;407;214;193;2022
50;Zaragoza;131;Jaulín;278;150;128;2022
50;Zaragoza;132;Joyosa, La;1119;566;553;2022
50;Zaragoza;133;Lagata;109;58;51;2022
50;Zaragoza;134;Langa del Castillo;115;60;55;2022
50;Zaragoza;135;Layana;96;56;40;2022
50;Zaragoza;136;Lécera;634;338;296;2022
50;Zaragoza;138;Lechón;47;28;19;2022
50;Zaragoza;137;Leciñena;1116;567;549;2022
50;Zaragoza;139;Letux;337;181;156;2022
50;Zaragoza;140;Litago;194;113;81;2022
50;Zaragoza;141;Lituénigo;121;64;57;2022
50;Zaragoza;142;Lobera de Onsella;26;14;12;2022
50;Zaragoza;143;Longares;882;537;345;2022
50;Zaragoza;144;Longás;42;27;15;2022
50;Zaragoza;146;Lucena de Jalón;226;124;102;2022
50;Zaragoza;147;Luceni;973;485;488;2022
50;Zaragoza;148;Luesia;333;179;154;2022
50;Zaragoza;149;Luesma;38;21;17;2022
50;Zaragoza;150;Lumpiaque;841;446;395;2022
50;Zaragoza;151;Luna;694;363;331;2022
50;Zaragoza;152;Maella;2097;1153;944;2022
50;Zaragoza;153;Magallón;1118;576;542;2022
50;Zaragoza;154;Mainar;170;95;75;2022
50;Zaragoza;155;Malanquilla;90;56;34;2022
50;Zaragoza;156;Maleján;262;137;125;2022
50;Zaragoza;160;Mallén;2937;1512;1425;2022
50;Zaragoza;157;Malón;392;192;200;2022
50;Zaragoza;159;Maluenda;905;454;451;2022
50;Zaragoza;161;Manchones;103;56;47;2022
50;Zaragoza;162;Mara;168;84;84;2022
50;Zaragoza;163;María de Huerva;6168;3101;3067;2022
50;Zaragoza;902;Marracos;91;47;44;2022
50;Zaragoza;164;Mediana de Aragón;457;227;230;2022
50;Zaragoza;165;Mequinenza;2294;1162;1132;2022
50;Zaragoza;166;Mesones de Isuela;272;139;133;2022
50;Zaragoza;167;Mezalocha;232;127;105;2022
50;Zaragoza;168;Mianos;28;15;13;2022
50;Zaragoza;169;Miedes de Aragón;424;225;199;2022
50;Zaragoza;170;Monegrillo;393;216;177;2022
50;Zaragoza;171;Moneva;115;69;46;2022
50;Zaragoza;172;Monreal de Ariza;193;114;79;2022
50;Zaragoza;173;Monterde;133;87;46;2022
50;Zaragoza;174;Montón;86;55;31;2022
50;Zaragoza;175;Morata de Jalón;1101;546;555;2022
50;Zaragoza;176;Morata de Jiloca;250;146;104;2022
50;Zaragoza;177;Morés;332;174;158;2022
50;Zaragoza;178;Moros;299;155;144;2022
50;Zaragoza;179;Moyuela;251;141;110;2022
50;Zaragoza;180;Mozota;123;65;58;2022
50;Zaragoza;181;Muel;1479;759;720;2022
50;Zaragoza;182;Muela, La;6247;3245;3002;2022
50;Zaragoza;183;Munébrega;356;193;163;2022
50;Zaragoza;184;Murero;104;59;45;2022
50;Zaragoza;185;Murillo de Gállego;197;114;83;2022
50;Zaragoza;186;Navardún;35;21;14;2022
50;Zaragoza;187;Nigüella;59;37;22;2022
50;Zaragoza;188;Nombrevilla;35;21;14;2022
50;Zaragoza;189;Nonaspe;1011;544;467;2022
50;Zaragoza;190;Novallas;845;450;395;2022
50;Zaragoza;191;Novillas;514;256;258;2022
50;Zaragoza;192;Nuévalos;279;154;125;2022
50;Zaragoza;193;Nuez de Ebro;889;453;436;2022
50;Zaragoza;194;Olvés;110;61;49;2022
50;Zaragoza;195;Orcajo;57;36;21;2022
50;Zaragoza;196;Orera;116;60;56;2022
50;Zaragoza;197;Orés;95;59;36;2022
50;Zaragoza;198;Oseja;52;34;18;2022
50;Zaragoza;199;Osera de Ebro;413;212;201;2022
50;Zaragoza;200;Paniza;604;326;278;2022
50;Zaragoza;201;Paracuellos de Jiloca;582;304;278;2022
50;Zaragoza;202;Paracuellos de la Ribera;129;72;57;2022
50;Zaragoza;203;Pastriz;1300;636;664;2022
50;Zaragoza;204;Pedrola;3625;1869;1756;2022
50;Zaragoza;205;Pedrosas, Las;97;48;49;2022
50;Zaragoza;206;Perdiguera;553;297;256;2022
50;Zaragoza;207;Piedratajada;91;52;39;2022
50;Zaragoza;208;Pina de Ebro;2433;1239;1194;2022
50;Zaragoza;209;Pinseque;4278;2188;2090;2022
50;Zaragoza;210;Pintanos, Los;37;25;12;2022
50;Zaragoza;211;Plasencia de Jalón;325;177;148;2022
50;Zaragoza;212;Pleitas;38;16;22;2022
50;Zaragoza;213;Plenas;100;54;46;2022
50;Zaragoza;214;Pomer;26;19;7;2022
50;Zaragoza;215;Pozuel de Ariza;24;13;11;2022
50;Zaragoza;216;Pozuelo de Aragón;263;137;126;2022
50;Zaragoza;217;Pradilla de Ebro;541;297;244;2022
50;Zaragoza;218;Puebla de Albortón;129;76;53;2022
50;Zaragoza;219;Puebla de Alfindén, La;6442;3289;3153;2022
50;Zaragoza;220;Puendeluna;48;30;18;2022
50;Zaragoza;221;Purujosa;27;17;10;2022
50;Zaragoza;222;Quinto;1916;976;940;2022
50;Zaragoza;223;Remolinos;1035;525;510;2022
50;Zaragoza;224;Retascón;60;32;28;2022
50;Zaragoza;225;Ricla;2932;1585;1347;2022
50;Zaragoza;227;Romanos;119;64;55;2022
50;Zaragoza;228;Rueda de Jalón;317;168;149;2022
50;Zaragoza;229;Ruesca;69;31;38;2022
50;Zaragoza;241;Sabiñán;675;355;320;2022
50;Zaragoza;230;Sádaba;1291;656;635;2022
50;Zaragoza;231;Salillas de Jalón;355;175;180;2022
50;Zaragoza;232;Salvatierra de Esca;199;99;100;2022
50;Zaragoza;233;Samper del Salz;96;50;46;2022
50;Zaragoza;234;San Martín de la Virgen de Moncayo;283;162;121;2022
50;Zaragoza;235;San Mateo de Gállego;3452;1766;1686;2022
50;Zaragoza;236;Santa Cruz de Grío;94;63;31;2022
50;Zaragoza;237;Santa Cruz de Moncayo;125;68;57;2022
50;Zaragoza;238;Santa Eulalia de Gállego;102;59;43;2022
50;Zaragoza;239;Santed;66;42;24;2022
50;Zaragoza;240;Sástago;1093;551;542;2022
50;Zaragoza;242;Sediles;106;61;45;2022
50;Zaragoza;243;Sestrica;349;199;150;2022
50;Zaragoza;244;Sierra de Luna;281;145;136;2022
50;Zaragoza;245;Sigüés;73;39;34;2022
50;Zaragoza;246;Sisamón;45;27;18;2022
50;Zaragoza;247;Sobradiel;1143;538;605;2022
50;Zaragoza;248;Sos del Rey Católico;568;301;267;2022
50;Zaragoza;249;Tabuenca;310;188;122;2022
50;Zaragoza;250;Talamantes;64;33;31;2022
50;Zaragoza;251;Tarazona;10565;5261;5304;2022
50;Zaragoza;252;Tauste;6817;3405;3412;2022
50;Zaragoza;253;Terrer;565;314;251;2022
50;Zaragoza;254;Tierga;179;101;78;2022
50;Zaragoza;255;Tobed;215;120;95;2022
50;Zaragoza;256;Torralba de los Frailes;73;40;33;2022
50;Zaragoza;257;Torralba de Ribota;168;93;75;2022
50;Zaragoza;258;Torralbilla;51;33;18;2022
50;Zaragoza;259;Torrehermosa;70;34;36;2022
50;Zaragoza;260;Torrelapaja;35;24;11;2022
50;Zaragoza;261;Torrellas;236;122;114;2022
50;Zaragoza;262;Torres de Berrellén;1476;768;708;2022
50;Zaragoza;263;Torrijo de la Cañada;201;118;83;2022
50;Zaragoza;264;Tosos;162;95;67;2022
50;Zaragoza;265;Trasmoz;89;45;44;2022
50;Zaragoza;266;Trasobares;125;74;51;2022
50;Zaragoza;267;Uncastillo;628;295;333;2022
50;Zaragoza;268;Undués de Lerda;52;30;22;2022
50;Zaragoza;269;Urrea de Jalón;448;250;198;2022
50;Zaragoza;270;Urriés;49;24;25;2022
50;Zaragoza;271;Used;269;144;125;2022
50;Zaragoza;272;Utebo;18881;9376;9505;2022
50;Zaragoza;274;Val de San Martín;60;36;24;2022
50;Zaragoza;273;Valdehorna;27;15;12;2022
50;Zaragoza;275;Valmadrid;110;67;43;2022
50;Zaragoza;276;Valpalmas;134;64;70;2022
50;Zaragoza;277;Valtorres;64;33;31;2022
50;Zaragoza;278;Velilla de Ebro;200;107;93;2022
50;Zaragoza;279;Velilla de Jiloca;71;35;36;2022
50;Zaragoza;280;Vera de Moncayo;316;169;147;2022
50;Zaragoza;281;Vierlas;80;45;35;2022
50;Zaragoza;283;Villadoz;90;49;41;2022
50;Zaragoza;284;Villafeliche;154;92;62;2022
50;Zaragoza;285;Villafranca de Ebro;848;427;421;2022
50;Zaragoza;286;Villalba de Perejil;100;46;54;2022
50;Zaragoza;287;Villalengua;287;156;131;2022
50;Zaragoza;903;Villamayor de Gállego;2827;1426;1401;2022
50;Zaragoza;288;Villanueva de Gállego;4769;2389;2380;2022
50;Zaragoza;290;Villanueva de Huerva;389;210;179;2022
50;Zaragoza;289;Villanueva de Jiloca;68;33;35;2022
50;Zaragoza;291;Villar de los Navarros;141;77;64;2022
50;Zaragoza;292;Villarreal de Huerva;266;149;117;2022
50;Zaragoza;293;Villarroya de la Sierra;435;231;204;2022
50;Zaragoza;294;Villarroya del Campo;82;47;35;2022
50;Zaragoza;282;Vilueña, La;65;33;32;2022
50;Zaragoza;295;Vistabella;52;31;21;2022
50;Zaragoza;296;Zaida, La;435;222;213;2022
50;Zaragoza;297;Zaragoza;673010;321957;351053;2022
50;Zaragoza;298;Zuera;8632;4423;4209;2022
02;Albacete;001;Abengibre;760;369;391;2023
02;Albacete;002;Alatoz;491;268;223;2023
02;Albacete;003;Albacete;173206;84585;88621;2023
02;Albacete;004;Albatana;655;332;323;2023
02;Albacete;005;Alborea;666;350;316;2023
02;Albacete;006;Alcadozo;648;355;293;2023
02;Albacete;007;Alcalá del Júcar;1129;604;525;2023
02;Albacete;008;Alcaraz;1304;678;626;2023
02;Albacete;009;Almansa;24282;12044;12238;2023
02;Albacete;010;Alpera;2268;1186;1082;2023
02;Albacete;011;Ayna;601;334;267;2023
02;Albacete;012;Balazote;2408;1236;1172;2023
02;Albacete;014;Ballestero, El;414;217;197;2023
02;Albacete;013;Balsa de Ves;134;78;56;2023
02;Albacete;015;Barrax;1849;955;894;2023
02;Albacete;016;Bienservida;567;309;258;2023
02;Albacete;017;Bogarra;740;391;349;2023
02;Albacete;018;Bonete;980;518;462;2023
02;Albacete;019;Bonillo, El;2651;1349;1302;2023
02;Albacete;020;Carcelén;481;249;232;2023
02;Albacete;021;Casas de Juan Núñez;1349;729;620;2023
02;Albacete;022;Casas de Lázaro;324;186;138;2023
02;Albacete;023;Casas de Ves;556;295;261;2023
02;Albacete;024;Casas-Ibáñez;4581;2314;2267;2023
02;Albacete;025;Caudete;10146;5188;4958;2023
02;Albacete;026;Cenizate;1143;577;566;2023
02;Albacete;029;Chinchilla de Monte-Aragón;4565;2363;2202;2023
02;Albacete;027;Corral-Rubio;302;159;143;2023
02;Albacete;028;Cotillas;131;74;57;2023
02;Albacete;030;Elche de la Sierra;3576;1751;1825;2023
02;Albacete;031;Férez;617;309;308;2023
02;Albacete;032;Fuensanta;289;157;132;2023
02;Albacete;033;Fuente-Álamo;2431;1278;1153;2023
02;Albacete;034;Fuentealbilla;1827;951;876;2023
02;Albacete;035;Gineta, La;2611;1356;1255;2023
02;Albacete;036;Golosalvo;92;50;42;2023
02;Albacete;037;Hellín;30516;15344;15172;2023
02;Albacete;038;Herrera, La;307;161;146;2023
02;Albacete;039;Higueruela;1147;600;547;2023
02;Albacete;040;Hoya-Gonzalo;614;323;291;2023
02;Albacete;041;Jorquera;346;188;158;2023
02;Albacete;042;Letur;929;466;463;2023
02;Albacete;043;Lezuza;1291;674;617;2023
02;Albacete;044;Liétor;1080;562;518;2023
02;Albacete;045;Madrigueras;4675;2386;2289;2023
02;Albacete;046;Mahora;1491;771;720;2023
02;Albacete;047;Masegoso;139;79;60;2023
02;Albacete;048;Minaya;1435;724;711;2023
02;Albacete;049;Molinicos;824;425;399;2023
02;Albacete;050;Montalvos;89;52;37;2023
02;Albacete;051;Montealegre del Castillo;2040;1065;975;2023
02;Albacete;052;Motilleja;661;362;299;2023
02;Albacete;053;Munera;3409;1764;1645;2023
02;Albacete;054;Navas de Jorquera;520;273;247;2023
02;Albacete;055;Nerpio;1174;659;515;2023
02;Albacete;056;Ontur;1913;959;954;2023
02;Albacete;057;Ossa de Montiel;2209;1135;1074;2023
02;Albacete;058;Paterna del Madera;351;193;158;2023
02;Albacete;060;Peñas de San Pedro;1447;853;594;2023
02;Albacete;059;Peñascosa;329;191;138;2023
02;Albacete;061;Pétrola;669;351;318;2023
02;Albacete;062;Povedilla;393;213;180;2023
02;Albacete;901;Pozo Cañada;2703;1374;1329;2023
02;Albacete;063;Pozohondo;1551;813;738;2023
02;Albacete;064;Pozo-Lorente;392;200;192;2023
02;Albacete;065;Pozuelo;470;255;215;2023
02;Albacete;066;Recueja, La;221;122;99;2023
02;Albacete;067;Riópar;1326;673;653;2023
02;Albacete;068;Robledo;394;215;179;2023
02;Albacete;069;Roda, La;15542;7821;7721;2023
02;Albacete;070;Salobre;435;232;203;2023
02;Albacete;071;San Pedro;1191;612;579;2023
02;Albacete;072;Socovos;1705;883;822;2023
02;Albacete;073;Tarazona de la Mancha;6138;3168;2970;2023
02;Albacete;074;Tobarra;7824;4053;3771;2023
02;Albacete;075;Valdeganga;1950;998;952;2023
02;Albacete;076;Vianos;322;166;156;2023
02;Albacete;077;Villa de Ves;61;34;27;2023
02;Albacete;078;Villalgordo del Júcar;1086;570;516;2023
02;Albacete;079;Villamalea;3929;2011;1918;2023
02;Albacete;080;Villapalacios;553;291;262;2023
02;Albacete;081;Villarrobledo;25189;12450;12739;2023
02;Albacete;082;Villatoya;114;67;47;2023
02;Albacete;083;Villavaliente;209;127;82;2023
02;Albacete;084;Villaverde de Guadalimar;311;171;140;2023
02;Albacete;085;Viveros;308;161;147;2023
02;Albacete;086;Yeste;2478;1292;1186;2023
03;Alicante/Alacant;002;Agost;5067;2566;2501;2023
03;Alicante/Alacant;003;Agres;619;338;281;2023
03;Alicante/Alacant;004;Aigües;1146;566;580;2023
03;Alicante/Alacant;014;Alacant/Alicante;349282;168377;180905;2023
03;Alicante/Alacant;005;Albatera;13092;6682;6410;2023
03;Alicante/Alacant;006;Alcalalí;1397;701;696;2023
03;Alicante/Alacant;009;Alcoi/Alcoy;59493;29124;30369;2023
03;Alicante/Alacant;008;Alcoleja;188;100;88;2023
03;Alicante/Alacant;007;Alcosser;259;130;129;2023
03;Alicante/Alacant;010;Alfafara;419;196;223;2023
03;Alicante/Alacant;011;Alfàs del Pi, l';20518;10102;10416;2023
03;Alicante/Alacant;012;Algorfa;3635;1834;1801;2023
03;Alicante/Alacant;013;Algueña;1395;714;681;2023
03;Alicante/Alacant;015;Almoradí;21874;10985;10889;2023
03;Alicante/Alacant;016;Almudaina;110;54;56;2023
03;Alicante/Alacant;017;Alqueria d'Asnar, l';511;258;253;2023
03;Alicante/Alacant;018;Altea;23820;11638;12182;2023
03;Alicante/Alacant;019;Aspe;21473;10789;10684;2023
03;Alicante/Alacant;001;Atzúbia, l';608;313;295;2023
03;Alicante/Alacant;020;Balones;119;59;60;2023
03;Alicante/Alacant;021;Banyeres de Mariola;7255;3677;3578;2023
03;Alicante/Alacant;022;Benasau;173;84;89;2023
03;Alicante/Alacant;023;Beneixama;1697;846;851;2023
03;Alicante/Alacant;024;Benejúzar;5625;2813;2812;2023
03;Alicante/Alacant;025;Benferri;2023;1046;977;2023
03;Alicante/Alacant;026;Beniarbeig;2353;1191;1162;2023
03;Alicante/Alacant;027;Beniardà;252;124;128;2023
03;Alicante/Alacant;028;Beniarrés;1089;556;533;2023
03;Alicante/Alacant;030;Benidoleig;1218;605;613;2023
03;Alicante/Alacant;031;Benidorm;72342;35817;36525;2023
03;Alicante/Alacant;032;Benifallim;111;60;51;2023
03;Alicante/Alacant;033;Benifato;140;78;62;2023
03;Alicante/Alacant;029;Benigembla;537;263;274;2023
03;Alicante/Alacant;034;Benijófar;3473;1686;1787;2023
03;Alicante/Alacant;035;Benilloba;737;388;349;2023
03;Alicante/Alacant;036;Benillup;105;55;50;2023
03;Alicante/Alacant;037;Benimantell;534;270;264;2023
03;Alicante/Alacant;038;Benimarfull;422;219;203;2023
03;Alicante/Alacant;039;Benimassot;105;56;49;2023
03;Alicante/Alacant;040;Benimeli;455;213;242;2023
03;Alicante/Alacant;041;Benissa;12279;6060;6219;2023
03;Alicante/Alacant;043;Biar;3607;1762;1845;2023
03;Alicante/Alacant;044;Bigastro;7361;3694;3667;2023
03;Alicante/Alacant;045;Bolulla;440;221;219;2023
03;Alicante/Alacant;046;Busot;3534;1763;1771;2023
03;Alicante/Alacant;049;Callosa de Segura;19484;9932;9552;2023
03;Alicante/Alacant;048;Callosa d'en Sarrià;7708;3973;3735;2023
03;Alicante/Alacant;047;Calp;25854;12795;13059;2023
03;Alicante/Alacant;051;Camp de Mirra, el/Campo de Mirra;442;230;212;2023
03;Alicante/Alacant;050;Campello, el;29993;14551;15442;2023
03;Alicante/Alacant;052;Cañada;1210;596;614;2023
03;Alicante/Alacant;053;Castalla;11365;5767;5598;2023
03;Alicante/Alacant;054;Castell de Castells;445;235;210;2023
03;Alicante/Alacant;075;Castell de Guadalest, el;274;135;139;2023
03;Alicante/Alacant;055;Catral;9275;4670;4605;2023
03;Alicante/Alacant;056;Cocentaina;11309;5695;5614;2023
03;Alicante/Alacant;057;Confrides;297;161;136;2023
03;Alicante/Alacant;058;Cox;7513;3790;3723;2023
03;Alicante/Alacant;059;Crevillent;30191;15290;14901;2023
03;Alicante/Alacant;061;Daya Nueva;1767;861;906;2023
03;Alicante/Alacant;062;Daya Vieja;667;329;338;2023
03;Alicante/Alacant;063;Dénia;45622;22205;23417;2023
03;Alicante/Alacant;064;Dolores;7919;3949;3970;2023
03;Alicante/Alacant;066;Elda;53034;25844;27190;2023
03;Alicante/Alacant;065;Elx/Elche;238293;117760;120533;2023
03;Alicante/Alacant;067;Fageca;101;50;51;2023
03;Alicante/Alacant;068;Famorca;45;24;21;2023
03;Alicante/Alacant;069;Finestrat;8836;4515;4321;2023
03;Alicante/Alacant;077;Fondó de les Neus, el/Hondón de las Nieves;2698;1381;1317;2023
03;Alicante/Alacant;070;Formentera del Segura;4618;2364;2254;2023
03;Alicante/Alacant;072;Gaianes;555;281;274;2023
03;Alicante/Alacant;071;Gata de Gorgos;6515;3324;3191;2023
03;Alicante/Alacant;073;Gorga;284;149;135;2023
03;Alicante/Alacant;074;Granja de Rocamora;2686;1385;1301;2023
03;Alicante/Alacant;076;Guardamar del Segura;17328;8442;8886;2023
03;Alicante/Alacant;078;Hondón de los Frailes;1311;673;638;2023
03;Alicante/Alacant;079;Ibi;23920;11945;11975;2023
03;Alicante/Alacant;080;Jacarilla;2108;1072;1036;2023
03;Alicante/Alacant;085;Llíber;946;474;472;2023
03;Alicante/Alacant;086;Millena;254;135;119;2023
03;Alicante/Alacant;088;Monforte del Cid;8777;4558;4219;2023
03;Alicante/Alacant;089;Monòver/Monóvar;12542;6244;6298;2023
03;Alicante/Alacant;903;Montesinos, Los;5477;2762;2715;2023
03;Alicante/Alacant;091;Murla;575;269;306;2023
03;Alicante/Alacant;092;Muro de Alcoy;9253;4633;4620;2023
03;Alicante/Alacant;090;Mutxamel;27078;13531;13547;2023
03;Alicante/Alacant;093;Novelda;25771;12801;12970;2023
03;Alicante/Alacant;094;Nucia, la;18970;9620;9350;2023
03;Alicante/Alacant;095;Ondara;7308;3639;3669;2023
03;Alicante/Alacant;096;Onil;7763;3904;3859;2023
03;Alicante/Alacant;097;Orba;2379;1165;1214;2023
03;Alicante/Alacant;099;Orihuela;82449;40745;41704;2023
03;Alicante/Alacant;084;Orxa, l'/Lorcha;587;294;293;2023
03;Alicante/Alacant;098;Orxeta;840;430;410;2023
03;Alicante/Alacant;100;Parcent;1003;489;514;2023
03;Alicante/Alacant;101;Pedreguer;8558;4267;4291;2023
03;Alicante/Alacant;102;Pego;10485;5202;5283;2023
03;Alicante/Alacant;103;Penàguila;313;156;157;2023
03;Alicante/Alacant;104;Petrer;33914;16751;17163;2023
03;Alicante/Alacant;902;Pilar de la Horadada;23428;11986;11442;2023
03;Alicante/Alacant;105;Pinós, el/Pinoso;8281;4214;4067;2023
03;Alicante/Alacant;106;Planes;699;378;321;2023
03;Alicante/Alacant;042;Poble Nou de Benitatxell, el/Benitachell;4858;2373;2485;2023
03;Alicante/Alacant;901;Poblets, els;2763;1302;1461;2023
03;Alicante/Alacant;107;Polop;5339;2679;2660;2023
03;Alicante/Alacant;060;Quatretondeta;136;77;59;2023
03;Alicante/Alacant;109;Rafal;4800;2392;2408;2023
03;Alicante/Alacant;110;Ràfol d'Almúnia, el;721;367;354;2023
03;Alicante/Alacant;111;Redován;8183;4244;3939;2023
03;Alicante/Alacant;112;Relleu;1248;640;608;2023
03;Alicante/Alacant;113;Rojales;17451;8794;8657;2023
03;Alicante/Alacant;114;Romana, la;2632;1383;1249;2023
03;Alicante/Alacant;115;Sagra;442;215;227;2023
03;Alicante/Alacant;116;Salinas;1733;885;848;2023
03;Alicante/Alacant;118;San Fulgencio;9443;4758;4685;2023
03;Alicante/Alacant;904;San Isidro;2208;1142;1066;2023
03;Alicante/Alacant;120;San Miguel de Salinas;6798;3419;3379;2023
03;Alicante/Alacant;117;Sanet y Negrals;737;372;365;2023
03;Alicante/Alacant;119;Sant Joan d'Alacant;25275;12210;13065;2023
03;Alicante/Alacant;122;Sant Vicent del Raspeig/San Vicente del Raspeig;59928;29575;30353;2023
03;Alicante/Alacant;121;Santa Pola;37816;18924;18892;2023
03;Alicante/Alacant;123;Sax;10072;5030;5042;2023
03;Alicante/Alacant;124;Sella;607;321;286;2023
03;Alicante/Alacant;125;Senija;670;344;326;2023
03;Alicante/Alacant;127;Tàrbena;630;334;296;2023
03;Alicante/Alacant;128;Teulada;12515;6249;6266;2023
03;Alicante/Alacant;129;Tibi;1808;948;860;2023
03;Alicante/Alacant;130;Tollos;40;27;13;2023
03;Alicante/Alacant;131;Tormos;339;164;175;2023
03;Alicante/Alacant;132;Torre de les Maçanes, la/Torremanzanas;714;376;338;2023
03;Alicante/Alacant;133;Torrevieja;89290;43252;46038;2023
03;Alicante/Alacant;134;Vall d'Alcalà, la;174;91;83;2023
03;Alicante/Alacant;136;Vall de Gallinera, la;581;301;280;2023
03;Alicante/Alacant;137;Vall de Laguar, la;873;436;437;2023
03;Alicante/Alacant;135;Vall d'Ebo, la;230;120;110;2023
03;Alicante/Alacant;138;Verger, el;5101;2508;2593;2023
03;Alicante/Alacant;139;Vila Joiosa, la/Villajoyosa;36093;17835;18258;2023
03;Alicante/Alacant;140;Villena;34144;17102;17042;2023
03;Alicante/Alacant;082;Xàbia/Jávea;29760;14857;14903;2023
03;Alicante/Alacant;081;Xaló;2964;1474;1490;2023
03;Alicante/Alacant;083;Xixona/Jijona;7032;3433;3599;2023
04;Almería;001;Abla;1255;650;605;2023
04;Almería;002;Abrucena;1275;675;600;2023
04;Almería;003;Adra;25195;12858;12337;2023
04;Almería;004;Albanchez;682;366;316;2023
04;Almería;005;Alboloduy;596;293;303;2023
04;Almería;006;Albox;12311;6276;6035;2023
04;Almería;007;Alcolea;803;418;385;2023
04;Almería;008;Alcóntar;560;307;253;2023
04;Almería;009;Alcudia de Monteagud;132;68;64;2023
04;Almería;010;Alhabia;708;374;334;2023
04;Almería;011;Alhama de Almería;3817;1932;1885;2023
04;Almería;012;Alicún;221;108;113;2023
04;Almería;013;Almería;200578;97592;102986;2023
04;Almería;014;Almócita;207;105;102;2023
04;Almería;015;Alsodux;146;82;64;2023
04;Almería;016;Antas;3417;1780;1637;2023
04;Almería;017;Arboleas;4439;2201;2238;2023
04;Almería;018;Armuña de Almanzora;335;167;168;2023
04;Almería;019;Bacares;237;124;113;2023
04;Almería;904;Balanegra;2931;1528;1403;2023
04;Almería;020;Bayárcal;326;170;156;2023
04;Almería;021;Bayarque;221;104;117;2023
04;Almería;022;Bédar;1012;506;506;2023
04;Almería;023;Beires;144;78;66;2023
04;Almería;024;Benahadux;4643;2294;2349;2023
04;Almería;026;Benitagla;58;33;25;2023
04;Almería;027;Benizalón;254;144;110;2023
04;Almería;028;Bentarique;241;131;110;2023
04;Almería;029;Berja;12917;6670;6247;2023
04;Almería;030;Canjáyar;1153;597;556;2023
04;Almería;031;Cantoria;3573;1804;1769;2023
04;Almería;032;Carboneras;8375;4303;4072;2023
04;Almería;033;Castro de Filabres;109;58;51;2023
04;Almería;036;Chercos;302;154;148;2023
04;Almería;037;Chirivel;1540;795;745;2023
04;Almería;034;Cóbdar;202;109;93;2023
04;Almería;035;Cuevas del Almanzora;15023;7812;7211;2023
04;Almería;038;Dalías;4202;2084;2118;2023
04;Almería;902;Ejido, El;89975;47198;42777;2023
04;Almería;041;Enix;588;323;265;2023
04;Almería;043;Felix;767;446;321;2023
04;Almería;044;Fines;2235;1184;1051;2023
04;Almería;045;Fiñana;1991;1009;982;2023
04;Almería;046;Fondón;1094;568;526;2023
04;Almería;047;Gádor;3029;1591;1438;2023
04;Almería;048;Gallardos, Los;3034;1521;1513;2023
04;Almería;049;Garrucha;10336;5397;4939;2023
04;Almería;050;Gérgal;1191;667;524;2023
04;Almería;051;Huécija;533;258;275;2023
04;Almería;052;Huércal de Almería;18507;9350;9157;2023
04;Almería;053;Huércal-Overa;20425;10163;10262;2023
04;Almería;054;Íllar;451;237;214;2023
04;Almería;055;Instinción;484;248;236;2023
04;Almería;056;Laroya;198;112;86;2023
04;Almería;057;Láujar de Andarax;1611;811;800;2023
04;Almería;058;Líjar;389;210;179;2023
04;Almería;059;Lubrín;1422;715;707;2023
04;Almería;060;Lucainena de las Torres;704;360;344;2023
04;Almería;061;Lúcar;829;415;414;2023
04;Almería;062;Macael;5381;2728;2653;2023
04;Almería;063;María;1209;625;584;2023
04;Almería;064;Mojácar;7386;3628;3758;2023
04;Almería;903;Mojonera, La;8778;4831;3947;2023
04;Almería;065;Nacimiento;508;269;239;2023
04;Almería;066;Níjar;32858;18496;14362;2023
04;Almería;067;Ohanes;550;284;266;2023
04;Almería;068;Olula de Castro;189;104;85;2023
04;Almería;069;Olula del Río;6354;3244;3110;2023
04;Almería;070;Oria;2233;1174;1059;2023
04;Almería;071;Padules;437;230;207;2023
04;Almería;072;Partaloa;924;462;462;2023
04;Almería;073;Paterna del Río;387;218;169;2023
04;Almería;074;Pechina;4358;2250;2108;2023
04;Almería;075;Pulpí;11247;5827;5420;2023
04;Almería;076;Purchena;1551;794;757;2023
04;Almería;077;Rágol;297;149;148;2023
04;Almería;078;Rioja;1594;815;779;2023
04;Almería;079;Roquetas de Mar;106510;55142;51368;2023
04;Almería;080;Santa Cruz de Marchena;237;126;111;2023
04;Almería;081;Santa Fe de Mondújar;494;256;238;2023
04;Almería;082;Senés;288;159;129;2023
04;Almería;083;Serón;2105;1095;1010;2023
04;Almería;084;Sierro;379;204;175;2023
04;Almería;085;Somontín;521;274;247;2023
04;Almería;086;Sorbas;2527;1318;1209;2023
04;Almería;087;Suflí;229;119;110;2023
04;Almería;088;Tabernas;4032;2095;1937;2023
04;Almería;089;Taberno;958;472;486;2023
04;Almería;090;Tahal;373;192;181;2023
04;Almería;091;Terque;400;211;189;2023
04;Almería;092;Tíjola;3518;1759;1759;2023
04;Almería;901;Tres Villas, Las;581;319;262;2023
04;Almería;093;Turre;4092;2103;1989;2023
04;Almería;094;Turrillas;278;154;124;2023
04;Almería;095;Uleila del Campo;820;409;411;2023
04;Almería;096;Urrácal;378;193;185;2023
04;Almería;097;Velefique;258;146;112;2023
04;Almería;098;Vélez-Blanco;1914;981;933;2023
04;Almería;099;Vélez-Rubio;6558;3189;3369;2023
04;Almería;100;Vera;18919;9632;9287;2023
04;Almería;101;Viator;6160;3135;3025;2023
04;Almería;102;Vícar;28245;15331;12914;2023
04;Almería;103;Zurgena;2972;1505;1467;2023
01;Araba/Álava;051;Agurain/Salvatierra;5085;2583;2502;2023
01;Araba/Álava;001;Alegría-Dulantzi;2975;1539;1436;2023
01;Araba/Álava;002;Amurrio;10313;5134;5179;2023
01;Araba/Álava;049;Añana;156;95;61;2023
01;Araba/Álava;003;Aramaio;1409;732;677;2023
01;Araba/Álava;006;Armiñón;232;120;112;2023
01;Araba/Álava;037;Arraia-Maeztu;812;450;362;2023
01;Araba/Álava;008;Arratzua-Ubarrundia;1043;559;484;2023
01;Araba/Álava;004;Artziniega;1832;898;934;2023
01;Araba/Álava;009;Asparrena;1609;817;792;2023
01;Araba/Álava;010;Ayala/Aiara;2918;1479;1439;2023
01;Araba/Álava;011;Baños de Ebro/Mañueta;295;168;127;2023
01;Araba/Álava;013;Barrundia;897;493;404;2023
01;Araba/Álava;014;Berantevilla;451;237;214;2023
01;Araba/Álava;016;Bernedo;540;321;219;2023
01;Araba/Álava;017;Campezo/Kanpezu;1072;564;508;2023
01;Araba/Álava;021;Elburgo/Burgelu;638;332;306;2023
01;Araba/Álava;022;Elciego;964;484;480;2023
01;Araba/Álava;023;Elvillar/Bilar;313;151;162;2023
01;Araba/Álava;047;Erriberabeitia;1423;762;661;2023
01;Araba/Álava;046;Erriberagoitia/Ribera Alta;828;494;334;2023
01;Araba/Álava;056;Harana/Valle de Arana;219;120;99;2023
01;Araba/Álava;901;Iruña Oka/Iruña de Oca;3597;1918;1679;2023
01;Araba/Álava;027;Iruraiz-Gauna;541;295;246;2023
01;Araba/Álava;019;Kripan;174;92;82;2023
01;Araba/Álava;020;Kuartango;401;232;169;2023
01;Araba/Álava;028;Labastida/Bastida;1566;815;751;2023
01;Araba/Álava;030;Lagrán;172;97;75;2023
01;Araba/Álava;031;Laguardia;1472;775;697;2023
01;Araba/Álava;032;Lanciego/Lantziego;708;361;347;2023
01;Araba/Álava;902;Lantarón;938;525;413;2023
01;Araba/Álava;033;Lapuebla de Labarca;865;445;420;2023
01;Araba/Álava;036;Laudio/Llodio;17917;8685;9232;2023
01;Araba/Álava;058;Legutio;2048;1066;982;2023
01;Araba/Álava;034;Leza;220;112;108;2023
01;Araba/Álava;039;Moreda de Álava/Moreda Araba;208;110;98;2023
01;Araba/Álava;041;Navaridas;197;108;89;2023
01;Araba/Álava;042;Okondo;1198;628;570;2023
01;Araba/Álava;043;Oyón-Oion;3405;1729;1676;2023
01;Araba/Álava;044;Peñacerrada-Urizaharra;302;180;122;2023
01;Araba/Álava;052;Samaniego;305;152;153;2023
01;Araba/Álava;053;San Millán/Donemiliaga;726;392;334;2023
01;Araba/Álava;054;Urkabustaiz;1434;750;684;2023
01;Araba/Álava;055;Valdegovía/Gaubea;1066;583;483;2023
01;Araba/Álava;057;Villabuena de Álava/Eskuernaga;285;148;137;2023
01;Araba/Álava;059;Vitoria-Gasteiz;255886;124348;131538;2023
01;Araba/Álava;060;Yécora/Iekora;249;127;122;2023
01;Araba/Álava;061;Zalduondo;196;106;90;2023
01;Araba/Álava;062;Zambrana;422;231;191;2023
01;Araba/Álava;018;Zigoitia;1821;974;847;2023
01;Araba/Álava;063;Zuia;2343;1227;1116;2023
33;Asturias;001;Allande;1552;767;785;2023
33;Asturias;002;Aller;10076;4946;5130;2023
33;Asturias;003;Amieva;599;336;263;2023
33;Asturias;004;Avilés;75518;35623;39895;2023
33;Asturias;005;Belmonte de Miranda;1399;747;652;2023
33;Asturias;006;Bimenes;1669;820;849;2023
33;Asturias;007;Boal;1412;722;690;2023
33;Asturias;008;Cabrales;1918;962;956;2023
33;Asturias;009;Cabranes;1105;561;544;2023
33;Asturias;010;Candamo;1932;944;988;2023
33;Asturias;012;Cangas de Onís;6362;3068;3294;2023
33;Asturias;011;Cangas del Narcea;11596;5640;5956;2023
33;Asturias;013;Caravia;496;260;236;2023
33;Asturias;014;Carreño;10177;4897;5280;2023
33;Asturias;015;Caso;1449;837;612;2023
33;Asturias;016;Castrillón;22103;10663;11440;2023
33;Asturias;017;Castropol;3289;1607;1682;2023
33;Asturias;018;Coaña;3304;1625;1679;2023
33;Asturias;019;Colunga;3187;1580;1607;2023
33;Asturias;020;Corvera de Asturias;15612;7641;7971;2023
33;Asturias;021;Cudillero;4909;2420;2489;2023
33;Asturias;022;Degaña;805;411;394;2023
33;Asturias;023;Franco, El;3749;1827;1922;2023
33;Asturias;024;Gijón;268313;126085;142228;2023
33;Asturias;025;Gozón;10470;5117;5353;2023
33;Asturias;026;Grado;9616;4668;4948;2023
33;Asturias;027;Grandas de Salime;765;392;373;2023
33;Asturias;028;Ibias;1121;645;476;2023
33;Asturias;029;Illano;288;149;139;2023
33;Asturias;030;Illas;1061;538;523;2023
33;Asturias;031;Langreo;37978;18080;19898;2023
33;Asturias;032;Laviana;12355;5924;6431;2023
33;Asturias;033;Lena;10312;4969;5343;2023
33;Asturias;035;Llanera;13948;6887;7061;2023
33;Asturias;036;Llanes;13524;6574;6950;2023
33;Asturias;037;Mieres;36195;17187;19008;2023
33;Asturias;038;Morcín;2540;1277;1263;2023
33;Asturias;039;Muros de Nalón;1955;949;1006;2023
33;Asturias;040;Nava;5186;2550;2636;2023
33;Asturias;041;Navia;8136;3913;4223;2023
33;Asturias;042;Noreña;5058;2430;2628;2023
33;Asturias;043;Onís;746;401;345;2023
33;Asturias;044;Oviedo;217584;100640;116944;2023
33;Asturias;045;Parres;5208;2554;2654;2023
33;Asturias;046;Peñamellera Alta;535;281;254;2023
33;Asturias;047;Peñamellera Baja;1221;604;617;2023
33;Asturias;048;Pesoz;138;75;63;2023
33;Asturias;049;Piloña;6822;3329;3493;2023
33;Asturias;050;Ponga;579;342;237;2023
33;Asturias;051;Pravia;7830;3823;4007;2023
33;Asturias;052;Proaza;709;419;290;2023
33;Asturias;053;Quirós;1175;682;493;2023
33;Asturias;054;Regueras, Las;1888;960;928;2023
33;Asturias;055;Ribadedeva;1731;842;889;2023
33;Asturias;056;Ribadesella;5548;2638;2910;2023
33;Asturias;057;Ribera de Arriba;1857;931;926;2023
33;Asturias;058;Riosa;1755;891;864;2023
33;Asturias;059;Salas;4806;2383;2423;2023
33;Asturias;061;San Martín de Oscos;344;170;174;2023
33;Asturias;060;San Martín del Rey Aurelio;15431;7395;8036;2023
33;Asturias;063;San Tirso de Abres;412;193;219;2023
33;Asturias;062;Santa Eulalia de Oscos;431;223;208;2023
33;Asturias;064;Santo Adriano;286;140;146;2023
33;Asturias;065;Sariego;1271;612;659;2023
33;Asturias;066;Siero;52194;25493;26701;2023
33;Asturias;067;Sobrescobio;851;451;400;2023
33;Asturias;068;Somiedo;1083;640;443;2023
33;Asturias;069;Soto del Barco;3818;1869;1949;2023
33;Asturias;070;Tapia de Casariego;3652;1773;1879;2023
33;Asturias;071;Taramundi;576;276;300;2023
33;Asturias;072;Teverga;1565;862;703;2023
33;Asturias;073;Tineo;8857;4477;4380;2023
33;Asturias;034;Valdés;10958;5397;5561;2023
33;Asturias;074;Vegadeo;3885;1868;2017;2023
33;Asturias;075;Villanueva de Oscos;261;132;129;2023
33;Asturias;076;Villaviciosa;15000;7421;7579;2023
33;Asturias;077;Villayón;1104;569;535;2023
33;Asturias;078;Yernes y Tameza;133;70;63;2023
05;Ávila;001;Adanero;204;115;89;2023
05;Ávila;002;Adrada, La;2727;1387;1340;2023
05;Ávila;005;Albornos;175;90;85;2023
05;Ávila;007;Aldeanueva de Santa Cruz;100;53;47;2023
05;Ávila;008;Aldeaseca;210;104;106;2023
05;Ávila;010;Aldehuela, La;148;76;72;2023
05;Ávila;012;Amavida;135;73;62;2023
05;Ávila;013;Arenal, El;964;463;501;2023
05;Ávila;014;Arenas de San Pedro;6464;3143;3321;2023
05;Ávila;015;Arevalillo;60;28;32;2023
05;Ávila;016;Arévalo;7768;3769;3999;2023
05;Ávila;017;Aveinte;75;44;31;2023
05;Ávila;018;Avellaneda;24;15;9;2023
05;Ávila;019;Ávila;57741;27485;30256;2023
05;Ávila;021;Barco de Ávila, El;2276;1097;1179;2023
05;Ávila;022;Barraco, El;2005;1010;995;2023
05;Ávila;023;Barromán;176;95;81;2023
05;Ávila;024;Becedas;164;88;76;2023
05;Ávila;025;Becedillas;70;37;33;2023
05;Ávila;026;Bercial de Zapardiel;178;94;84;2023
05;Ávila;027;Berlanas, Las;326;174;152;2023
05;Ávila;029;Bernuy-Zapardiel;88;49;39;2023
05;Ávila;030;Berrocalejo de Aragona;48;28;20;2023
05;Ávila;033;Blascomillán;169;87;82;2023
05;Ávila;034;Blasconuño de Matacabras;15;9;6;2023
05;Ávila;035;Blascosancho;106;55;51;2023
05;Ávila;036;Bohodón, El;107;56;51;2023
05;Ávila;037;Bohoyo;215;125;90;2023
05;Ávila;038;Bonilla de la Sierra;180;108;72;2023
05;Ávila;039;Brabos;39;26;13;2023
05;Ávila;040;Bularros;57;37;20;2023
05;Ávila;041;Burgohondo;1240;650;590;2023
05;Ávila;042;Cabezas de Alambre;156;74;82;2023
05;Ávila;043;Cabezas del Pozo;89;43;46;2023
05;Ávila;044;Cabezas del Villar;234;131;103;2023
05;Ávila;045;Cabizuela;88;45;43;2023
05;Ávila;046;Canales;36;20;16;2023
05;Ávila;047;Candeleda;5001;2514;2487;2023
05;Ávila;048;Cantiveros;97;57;40;2023
05;Ávila;049;Cardeñosa;419;228;191;2023
05;Ávila;051;Carrera, La;161;91;70;2023
05;Ávila;052;Casas del Puerto;85;45;40;2023
05;Ávila;053;Casasola;66;39;27;2023
05;Ávila;054;Casavieja;1410;726;684;2023
05;Ávila;055;Casillas;663;361;302;2023
05;Ávila;056;Castellanos de Zapardiel;135;75;60;2023
05;Ávila;057;Cebreros;3256;1691;1565;2023
05;Ávila;058;Cepeda la Mora;67;40;27;2023
05;Ávila;067;Chamartín;61;35;26;2023
05;Ávila;059;Cillán;72;43;29;2023
05;Ávila;060;Cisla;99;54;45;2023
05;Ávila;061;Colilla, La;366;189;177;2023
05;Ávila;062;Collado de Contreras;143;72;71;2023
05;Ávila;063;Collado del Mirón;24;14;10;2023
05;Ávila;064;Constanzana;98;58;40;2023
05;Ávila;065;Crespos;465;247;218;2023
05;Ávila;066;Cuevas del Valle;508;282;226;2023
05;Ávila;903;Diego del Carpio;108;67;41;2023
05;Ávila;069;Donjimeno;76;42;34;2023
05;Ávila;070;Donvidas;31;20;11;2023
05;Ávila;072;Espinosa de los Caballeros;102;53;49;2023
05;Ávila;073;Flores de Ávila;271;144;127;2023
05;Ávila;074;Fontiveros;716;370;346;2023
05;Ávila;075;Fresnedilla;106;52;54;2023
05;Ávila;076;Fresno, El;595;307;288;2023
05;Ávila;077;Fuente el Saúz;158;88;70;2023
05;Ávila;078;Fuentes de Año;89;52;37;2023
05;Ávila;079;Gallegos de Altamiros;58;34;24;2023
05;Ávila;080;Gallegos de Sobrinos;46;23;23;2023
05;Ávila;081;Garganta del Villar;41;27;14;2023
05;Ávila;082;Gavilanes;547;302;245;2023
05;Ávila;083;Gemuño;150;78;72;2023
05;Ávila;085;Gil García;44;22;22;2023
05;Ávila;084;Gilbuena;49;33;16;2023
05;Ávila;086;Gimialcón;74;45;29;2023
05;Ávila;087;Gotarrendura;167;61;106;2023
05;Ávila;088;Grandes y San Martín;36;17;19;2023
05;Ávila;089;Guisando;488;245;243;2023
05;Ávila;090;Gutierre-Muñoz;61;32;29;2023
05;Ávila;092;Hernansancho;147;82;65;2023
05;Ávila;093;Herradón de Pinares;487;275;212;2023
05;Ávila;094;Herreros de Suso;149;83;66;2023
05;Ávila;095;Higuera de las Dueñas;275;154;121;2023
05;Ávila;096;Hija de Dios, La;80;48;32;2023
05;Ávila;097;Horcajada, La;465;235;230;2023
05;Ávila;099;Horcajo de las Torres;454;253;201;2023
05;Ávila;100;Hornillo, El;266;146;120;2023
05;Ávila;102;Hoyo de Pinares, El;2153;1114;1039;2023
05;Ávila;101;Hoyocasero;328;187;141;2023
05;Ávila;103;Hoyorredondo;60;32;28;2023
05;Ávila;106;Hoyos de Miguel Muñoz;27;15;12;2023
05;Ávila;104;Hoyos del Collado;29;17;12;2023
05;Ávila;105;Hoyos del Espino;345;182;163;2023
05;Ávila;107;Hurtumpascual;43;26;17;2023
05;Ávila;108;Junciana;43;24;19;2023
05;Ávila;109;Langa;440;224;216;2023
05;Ávila;110;Lanzahíta;799;407;392;2023
05;Ávila;113;Llanos de Tormes, Los;65;30;35;2023
05;Ávila;112;Losar del Barco, El;116;67;49;2023
05;Ávila;114;Madrigal de las Altas Torres;1338;690;648;2023
05;Ávila;115;Maello;705;383;322;2023
05;Ávila;116;Malpartida de Corneja;99;50;49;2023
05;Ávila;117;Mamblas;197;112;85;2023
05;Ávila;118;Mancera de Arriba;71;38;33;2023
05;Ávila;119;Manjabálago y Ortigosa de Rioalmar;36;18;18;2023
05;Ávila;120;Marlín;34;21;13;2023
05;Ávila;121;Martiherrero;356;186;170;2023
05;Ávila;122;Martínez;114;61;53;2023
05;Ávila;123;Mediana de Voltoya;117;61;56;2023
05;Ávila;124;Medinilla;78;40;38;2023
05;Ávila;125;Mengamuñoz;56;29;27;2023
05;Ávila;126;Mesegar de Corneja;76;40;36;2023
05;Ávila;127;Mijares;730;405;325;2023
05;Ávila;128;Mingorría;389;202;187;2023
05;Ávila;129;Mirón, El;98;63;35;2023
05;Ávila;130;Mironcillo;109;58;51;2023
05;Ávila;131;Mirueña de los Infanzones;88;49;39;2023
05;Ávila;132;Mombeltrán;917;484;433;2023
05;Ávila;133;Monsalupe;59;32;27;2023
05;Ávila;134;Moraleja de Matacabras;53;29;24;2023
05;Ávila;135;Muñana;483;252;231;2023
05;Ávila;136;Muñico;78;45;33;2023
05;Ávila;138;Muñogalindo;301;151;150;2023
05;Ávila;139;Muñogrande;71;38;33;2023
05;Ávila;140;Muñomer del Peco;112;57;55;2023
05;Ávila;141;Muñopepe;103;53;50;2023
05;Ávila;142;Muñosancho;88;48;40;2023
05;Ávila;143;Muñotello;51;28;23;2023
05;Ávila;144;Narrillos del Álamo;60;33;27;2023
05;Ávila;145;Narrillos del Rebollar;37;24;13;2023
05;Ávila;149;Narros de Saldueña;111;57;54;2023
05;Ávila;147;Narros del Castillo;148;81;67;2023
05;Ávila;148;Narros del Puerto;28;15;13;2023
05;Ávila;152;Nava de Arévalo;677;343;334;2023
05;Ávila;153;Nava del Barco;85;44;41;2023
05;Ávila;151;Navacepedilla de Corneja;94;51;43;2023
05;Ávila;154;Navadijos;39;27;12;2023
05;Ávila;155;Navaescurial;52;31;21;2023
05;Ávila;156;Navahondilla;358;212;146;2023
05;Ávila;157;Navalacruz;218;126;92;2023
05;Ávila;158;Navalmoral;364;193;171;2023
05;Ávila;159;Navalonguilla;194;98;96;2023
05;Ávila;160;Navalosa;323;186;137;2023
05;Ávila;161;Navalperal de Pinares;792;419;373;2023
05;Ávila;162;Navalperal de Tormes;83;48;35;2023
05;Ávila;163;Navaluenga;2164;1083;1081;2023
05;Ávila;164;Navaquesera;40;20;20;2023
05;Ávila;165;Navarredonda de Gredos;442;230;212;2023
05;Ávila;166;Navarredondilla;179;100;79;2023
05;Ávila;167;Navarrevisca;304;175;129;2023
05;Ávila;168;Navas del Marqués, Las;5362;2736;2626;2023
05;Ávila;169;Navatalgordo;238;135;103;2023
05;Ávila;170;Navatejares;55;25;30;2023
05;Ávila;171;Neila de San Miguel;62;34;28;2023
05;Ávila;172;Niharra;177;102;75;2023
05;Ávila;173;Ojos-Albos;91;47;44;2023
05;Ávila;174;Orbita;70;39;31;2023
05;Ávila;175;Oso, El;136;80;56;2023
05;Ávila;176;Padiernos;276;155;121;2023
05;Ávila;177;Pajares de Adaja;135;73;62;2023
05;Ávila;178;Palacios de Goda;407;221;186;2023
05;Ávila;179;Papatrigo;221;108;113;2023
05;Ávila;180;Parral, El;61;38;23;2023
05;Ávila;181;Pascualcobo;38;25;13;2023
05;Ávila;182;Pedro Bernardo;771;405;366;2023
05;Ávila;183;Pedro-Rodríguez;135;71;64;2023
05;Ávila;184;Peguerinos;303;167;136;2023
05;Ávila;185;Peñalba de Ávila;103;58;45;2023
05;Ávila;186;Piedrahíta;1662;799;863;2023
05;Ávila;187;Piedralaves;2136;1061;1075;2023
05;Ávila;188;Poveda;34;19;15;2023
05;Ávila;189;Poyales del Hoyo;493;268;225;2023
05;Ávila;190;Pozanco;56;35;21;2023
05;Ávila;191;Pradosegar;119;67;52;2023
05;Ávila;192;Puerto Castilla;100;61;39;2023
05;Ávila;193;Rasueros;161;90;71;2023
05;Ávila;194;Riocabado;131;78;53;2023
05;Ávila;195;Riofrío;195;120;75;2023
05;Ávila;196;Rivilla de Barajas;62;29;33;2023
05;Ávila;197;Salobral;111;60;51;2023
05;Ávila;198;Salvadiós;77;39;38;2023
05;Ávila;199;San Bartolomé de Béjar;54;29;25;2023
05;Ávila;200;San Bartolomé de Corneja;37;21;16;2023
05;Ávila;201;San Bartolomé de Pinares;501;276;225;2023
05;Ávila;206;San Esteban de los Patos;20;13;7;2023
05;Ávila;208;San Esteban de Zapardiel;39;21;18;2023
05;Ávila;207;San Esteban del Valle;745;383;362;2023
05;Ávila;209;San García de Ingelmos;70;46;24;2023
05;Ávila;901;San Juan de Gredos;248;135;113;2023
05;Ávila;210;San Juan de la Encinilla;65;33;32;2023
05;Ávila;211;San Juan de la Nava;435;242;193;2023
05;Ávila;212;San Juan del Molinillo;234;124;110;2023
05;Ávila;213;San Juan del Olmo;80;52;28;2023
05;Ávila;214;San Lorenzo de Tormes;32;17;15;2023
05;Ávila;215;San Martín de la Vega del Alberche;161;97;64;2023
05;Ávila;216;San Martín del Pimpollar;220;127;93;2023
05;Ávila;217;San Miguel de Corneja;70;37;33;2023
05;Ávila;218;San Miguel de Serrezuela;103;56;47;2023
05;Ávila;219;San Pascual;43;26;17;2023
05;Ávila;220;San Pedro del Arroyo;500;265;235;2023
05;Ávila;231;San Vicente de Arévalo;166;93;73;2023
05;Ávila;204;Sanchidrián;710;369;341;2023
05;Ávila;205;Sanchorreja;80;41;39;2023
05;Ávila;222;Santa Cruz de Pinares;172;102;70;2023
05;Ávila;221;Santa Cruz del Valle;322;166;156;2023
05;Ávila;226;Santa María de los Caballeros;67;42;25;2023
05;Ávila;224;Santa María del Arroyo;101;55;46;2023
05;Ávila;225;Santa María del Berrocal;374;190;184;2023
05;Ávila;902;Santa María del Cubillo;315;177;138;2023
05;Ávila;227;Santa María del Tiétar;533;276;257;2023
05;Ávila;228;Santiago del Collado;168;106;62;2023
05;Ávila;904;Santiago del Tormes;110;60;50;2023
05;Ávila;229;Santo Domingo de las Posadas;72;38;34;2023
05;Ávila;230;Santo Tomé de Zabarcos;70;42;28;2023
05;Ávila;232;Serrada, La;137;70;67;2023
05;Ávila;233;Serranillos;279;154;125;2023
05;Ávila;234;Sigeres;41;20;21;2023
05;Ávila;235;Sinlabajos;136;63;73;2023
05;Ávila;236;Solana de Ávila;107;62;45;2023
05;Ávila;237;Solana de Rioalmar;149;87;62;2023
05;Ávila;238;Solosancho;779;418;361;2023
05;Ávila;239;Sotalbo;247;146;101;2023
05;Ávila;240;Sotillo de la Adrada;4870;2425;2445;2023
05;Ávila;241;Tiemblo, El;4445;2264;2181;2023
05;Ávila;242;Tiñosillos;759;388;371;2023
05;Ávila;243;Tolbaños;82;47;35;2023
05;Ávila;244;Tormellas;36;23;13;2023
05;Ávila;245;Tornadizos de Ávila;456;223;233;2023
05;Ávila;247;Torre, La;223;123;100;2023
05;Ávila;246;Tórtoles;37;22;15;2023
05;Ávila;249;Umbrías;103;52;51;2023
05;Ávila;251;Vadillo de la Sierra;58;37;21;2023
05;Ávila;252;Valdecasa;57;36;21;2023
05;Ávila;253;Vega de Santa María;76;38;38;2023
05;Ávila;254;Velayos;211;106;105;2023
05;Ávila;256;Villaflor;102;55;47;2023
05;Ávila;257;Villafranca de la Sierra;130;76;54;2023
05;Ávila;905;Villanueva de Ávila;230;125;105;2023
05;Ávila;258;Villanueva de Gómez;115;66;49;2023
05;Ávila;259;Villanueva del Aceral;97;45;52;2023
05;Ávila;260;Villanueva del Campillo;105;58;47;2023
05;Ávila;261;Villar de Corneja;37;23;14;2023
05;Ávila;262;Villarejo del Valle;327;176;151;2023
05;Ávila;263;Villatoro;152;85;67;2023
05;Ávila;264;Viñegra de Moraña;47;23;24;2023
05;Ávila;265;Vita;79;46;33;2023
05;Ávila;266;Zapardiel de la Cañada;83;45;38;2023
05;Ávila;267;Zapardiel de la Ribera;84;44;40;2023
06;Badajoz;001;Acedera;814;422;392;2023
06;Badajoz;002;Aceuchal;5446;2699;2747;2023
06;Badajoz;003;Ahillones;797;400;397;2023
06;Badajoz;004;Alange;1831;944;887;2023
06;Badajoz;005;Albuera, La;2002;1033;969;2023
06;Badajoz;006;Alburquerque;5063;2533;2530;2023
06;Badajoz;007;Alconchel;1634;829;805;2023
06;Badajoz;008;Alconera;758;383;375;2023
06;Badajoz;009;Aljucén;261;143;118;2023
06;Badajoz;010;Almendral;1195;604;591;2023
06;Badajoz;011;Almendralejo;33948;16755;17193;2023
06;Badajoz;012;Arroyo de San Serván;4038;2029;2009;2023
06;Badajoz;013;Atalaya;278;145;133;2023
06;Badajoz;014;Azuaga;7624;3777;3847;2023
06;Badajoz;015;Badajoz;150190;72584;77606;2023
06;Badajoz;016;Barcarrota;3452;1743;1709;2023
06;Badajoz;017;Baterno;243;133;110;2023
06;Badajoz;018;Benquerencia de la Serena;783;392;391;2023
06;Badajoz;019;Berlanga;2219;1104;1115;2023
06;Badajoz;020;Bienvenida;2031;1031;1000;2023
06;Badajoz;021;Bodonal de la Sierra;1001;507;494;2023
06;Badajoz;022;Burguillos del Cerro;3015;1485;1530;2023
06;Badajoz;023;Cabeza del Buey;4583;2289;2294;2023
06;Badajoz;024;Cabeza la Vaca;1272;662;610;2023
06;Badajoz;025;Calamonte;6095;3017;3078;2023
06;Badajoz;026;Calera de León;917;471;446;2023
06;Badajoz;027;Calzadilla de los Barros;699;353;346;2023
06;Badajoz;028;Campanario;4742;2341;2401;2023
06;Badajoz;029;Campillo de Llerena;1329;657;672;2023
06;Badajoz;030;Capilla;155;82;73;2023
06;Badajoz;031;Carmonita;518;259;259;2023
06;Badajoz;032;Carrascalejo, El;78;43;35;2023
06;Badajoz;033;Casas de Don Pedro;1380;707;673;2023
06;Badajoz;034;Casas de Reina;203;104;99;2023
06;Badajoz;035;Castilblanco;852;436;416;2023
06;Badajoz;036;Castuera;5567;2777;2790;2023
06;Badajoz;042;Cheles;1162;574;588;2023
06;Badajoz;037;Codosera, La;2004;1046;958;2023
06;Badajoz;038;Cordobilla de Lácara;838;441;397;2023
06;Badajoz;039;Coronada, La;2153;1049;1104;2023
06;Badajoz;040;Corte de Peleas;1163;571;592;2023
06;Badajoz;041;Cristina;553;280;273;2023
06;Badajoz;043;Don Álvaro;814;433;381;2023
06;Badajoz;044;Don Benito;37485;18467;19018;2023
06;Badajoz;045;Entrín Bajo;546;278;268;2023
06;Badajoz;046;Esparragalejo;1510;747;763;2023
06;Badajoz;047;Esparragosa de la Serena;960;484;476;2023
06;Badajoz;048;Esparragosa de Lares;875;435;440;2023
06;Badajoz;049;Feria;1050;505;545;2023
06;Badajoz;050;Fregenal de la Sierra;4753;2326;2427;2023
06;Badajoz;051;Fuenlabrada de los Montes;1736;847;889;2023
06;Badajoz;052;Fuente de Cantos;4638;2301;2337;2023
06;Badajoz;053;Fuente del Arco;668;345;323;2023
06;Badajoz;054;Fuente del Maestre;6626;3269;3357;2023
06;Badajoz;055;Fuentes de León;2198;1084;1114;2023
06;Badajoz;056;Garbayuela;494;260;234;2023
06;Badajoz;057;Garlitos;539;270;269;2023
06;Badajoz;058;Garrovilla, La;2297;1131;1166;2023
06;Badajoz;059;Granja de Torrehermosa;1933;957;976;2023
06;Badajoz;903;Guadiana;2416;1187;1229;2023
06;Badajoz;060;Guareña;6668;3331;3337;2023
06;Badajoz;061;Haba, La;1208;606;602;2023
06;Badajoz;062;Helechosa de los Montes;587;337;250;2023
06;Badajoz;063;Herrera del Duque;3413;1718;1695;2023
06;Badajoz;064;Higuera de la Serena;901;461;440;2023
06;Badajoz;065;Higuera de Llerena;350;179;171;2023
06;Badajoz;066;Higuera de Vargas;1882;954;928;2023
06;Badajoz;067;Higuera la Real;2199;1113;1086;2023
06;Badajoz;068;Hinojosa del Valle;477;230;247;2023
06;Badajoz;069;Hornachos;3418;1709;1709;2023
06;Badajoz;070;Jerez de los Caballeros;9147;4485;4662;2023
06;Badajoz;071;Lapa, La;294;150;144;2023
06;Badajoz;073;Llera;806;408;398;2023
06;Badajoz;074;Llerena;5650;2807;2843;2023
06;Badajoz;072;Lobón;2745;1411;1334;2023
06;Badajoz;075;Magacela;489;253;236;2023
06;Badajoz;076;Maguilla;943;473;470;2023
06;Badajoz;077;Malcocinado;356;196;160;2023
06;Badajoz;078;Malpartida de la Serena;524;271;253;2023
06;Badajoz;079;Manchita;751;381;370;2023
06;Badajoz;080;Medellín;2237;1142;1095;2023
06;Badajoz;081;Medina de las Torres;1153;600;553;2023
06;Badajoz;082;Mengabril;488;264;224;2023
06;Badajoz;083;Mérida;59461;28873;30588;2023
06;Badajoz;084;Mirandilla;1223;609;614;2023
06;Badajoz;085;Monesterio;4254;2158;2096;2023
06;Badajoz;086;Montemolín;1280;618;662;2023
06;Badajoz;087;Monterrubio de la Serena;2237;1103;1134;2023
06;Badajoz;088;Montijo;15312;7557;7755;2023
06;Badajoz;089;Morera, La;703;361;342;2023
06;Badajoz;090;Nava de Santiago, La;909;455;454;2023
06;Badajoz;091;Navalvillar de Pela;4364;2196;2168;2023
06;Badajoz;092;Nogales;627;313;314;2023
06;Badajoz;093;Oliva de la Frontera;4967;2498;2469;2023
06;Badajoz;094;Oliva de Mérida;1669;842;827;2023
06;Badajoz;095;Olivenza;11776;5844;5932;2023
06;Badajoz;096;Orellana de la Sierra;275;149;126;2023
06;Badajoz;097;Orellana la Vieja;2594;1330;1264;2023
06;Badajoz;098;Palomas;657;330;327;2023
06;Badajoz;099;Parra, La;1283;663;620;2023
06;Badajoz;100;Peñalsordo;831;413;418;2023
06;Badajoz;101;Peraleda del Zaucejo;477;242;235;2023
06;Badajoz;102;Puebla de Alcocer;1130;560;570;2023
06;Badajoz;103;Puebla de la Calzada;5812;2924;2888;2023
06;Badajoz;104;Puebla de la Reina;707;344;363;2023
06;Badajoz;107;Puebla de Obando;1816;923;893;2023
06;Badajoz;108;Puebla de Sancho Pérez;2640;1335;1305;2023
06;Badajoz;105;Puebla del Maestre;642;337;305;2023
06;Badajoz;106;Puebla del Prior;448;231;217;2023
06;Badajoz;902;Pueblonuevo del Guadiana;1953;977;976;2023
06;Badajoz;109;Quintana de la Serena;4469;2256;2213;2023
06;Badajoz;110;Reina;143;74;69;2023
06;Badajoz;111;Rena;614;321;293;2023
06;Badajoz;112;Retamal de Llerena;433;228;205;2023
06;Badajoz;113;Ribera del Fresno;3193;1599;1594;2023
06;Badajoz;114;Risco;122;58;64;2023
06;Badajoz;115;Roca de la Sierra, La;1436;709;727;2023
06;Badajoz;116;Salvaleón;1671;844;827;2023
06;Badajoz;117;Salvatierra de los Barros;1573;776;797;2023
06;Badajoz;119;San Pedro de Mérida;879;451;428;2023
06;Badajoz;123;San Vicente de Alcántara;5262;2642;2620;2023
06;Badajoz;118;Sancti-Spíritus;154;84;70;2023
06;Badajoz;120;Santa Amalia;3939;1990;1949;2023
06;Badajoz;121;Santa Marta;4136;2074;2062;2023
06;Badajoz;122;Santos de Maimona, Los;8096;4063;4033;2023
06;Badajoz;124;Segura de León;1783;896;887;2023
06;Badajoz;125;Siruela;1802;910;892;2023
06;Badajoz;126;Solana de los Barros;2538;1276;1262;2023
06;Badajoz;127;Talarrubias;3274;1646;1628;2023
06;Badajoz;128;Talavera la Real;5282;2637;2645;2023
06;Badajoz;129;Táliga;662;331;331;2023
06;Badajoz;130;Tamurejo;205;104;101;2023
06;Badajoz;131;Torre de Miguel Sesmero;1230;626;604;2023
06;Badajoz;132;Torremayor;1010;495;515;2023
06;Badajoz;133;Torremejía;2246;1173;1073;2023
06;Badajoz;134;Trasierra;607;318;289;2023
06;Badajoz;135;Trujillanos;1401;713;688;2023
06;Badajoz;136;Usagre;1747;866;881;2023
06;Badajoz;137;Valdecaballeros;1066;551;515;2023
06;Badajoz;901;Valdelacalzada;2762;1388;1374;2023
06;Badajoz;138;Valdetorres;1155;566;589;2023
06;Badajoz;139;Valencia de las Torres;502;266;236;2023
06;Badajoz;140;Valencia del Mombuey;725;375;350;2023
06;Badajoz;141;Valencia del Ventoso;1900;958;942;2023
06;Badajoz;146;Valle de la Serena;1111;567;544;2023
06;Badajoz;147;Valle de Matamoros;346;178;168;2023
06;Badajoz;148;Valle de Santa Ana;1113;548;565;2023
06;Badajoz;142;Valverde de Burguillos;280;141;139;2023
06;Badajoz;143;Valverde de Leganés;4209;2091;2118;2023
06;Badajoz;144;Valverde de Llerena;557;283;274;2023
06;Badajoz;145;Valverde de Mérida;1018;514;504;2023
06;Badajoz;149;Villafranca de los Barros;12366;6093;6273;2023
06;Badajoz;150;Villagarcía de la Torre;883;444;439;2023
06;Badajoz;151;Villagonzalo;1212;592;620;2023
06;Badajoz;152;Villalba de los Barros;1441;717;724;2023
06;Badajoz;153;Villanueva de la Serena;25751;12522;13229;2023
06;Badajoz;154;Villanueva del Fresno;3272;1664;1608;2023
06;Badajoz;156;Villar de Rena;1320;683;637;2023
06;Badajoz;155;Villar del Rey;2101;1132;969;2023
06;Badajoz;157;Villarta de los Montes;403;207;196;2023
06;Badajoz;158;Zafra;16672;7998;8674;2023
06;Badajoz;159;Zahínos;2766;1385;1381;2023
06;Badajoz;160;Zalamea de la Serena;3428;1737;1691;2023
06;Badajoz;162;Zarza, La;3369;1690;1679;2023
06;Badajoz;161;Zarza-Capilla;297;146;151;2023
07;Balears, Illes;002;Alaior;9748;4896;4852;2023
07;Balears, Illes;001;Alaró;5909;2875;3034;2023
07;Balears, Illes;003;Alcúdia;21322;10793;10529;2023
07;Balears, Illes;004;Algaida;6170;3122;3048;2023
07;Balears, Illes;005;Andratx;11833;5936;5897;2023
07;Balears, Illes;901;Ariany;963;502;461;2023
07;Balears, Illes;006;Artà;8208;4109;4099;2023
07;Balears, Illes;007;Banyalbufar;577;309;268;2023
07;Balears, Illes;008;Binissalem;9172;4537;4635;2023
07;Balears, Illes;009;Búger;1148;605;543;2023
07;Balears, Illes;010;Bunyola;7286;3549;3737;2023
07;Balears, Illes;011;Calvià;53162;26514;26648;2023
07;Balears, Illes;012;Campanet;2790;1387;1403;2023
07;Balears, Illes;013;Campos;11763;5888;5875;2023
07;Balears, Illes;014;Capdepera;12340;6251;6089;2023
07;Balears, Illes;064;Castell, Es;7670;3855;3815;2023
07;Balears, Illes;015;Ciutadella de Menorca;31443;15689;15754;2023
07;Balears, Illes;016;Consell;4304;2126;2178;2023
07;Balears, Illes;017;Costitx;1490;733;757;2023
07;Balears, Illes;018;Deià;675;328;347;2023
07;Balears, Illes;026;Eivissa;51996;26114;25882;2023
07;Balears, Illes;019;Escorca;194;118;76;2023
07;Balears, Illes;020;Esporles;5236;2562;2674;2023
07;Balears, Illes;021;Estellencs;359;192;167;2023
07;Balears, Illes;022;Felanitx;18592;9306;9286;2023
07;Balears, Illes;023;Ferreries;5051;2517;2534;2023
07;Balears, Illes;024;Formentera;11171;5746;5425;2023
07;Balears, Illes;025;Fornalutx;717;351;366;2023
07;Balears, Illes;027;Inca;34577;17389;17188;2023
07;Balears, Illes;028;Lloret de Vistalegre;1589;801;788;2023
07;Balears, Illes;029;Lloseta;6378;3181;3197;2023
07;Balears, Illes;030;Llubí;2438;1211;1227;2023
07;Balears, Illes;031;Llucmajor;39040;19628;19412;2023
07;Balears, Illes;033;Manacor;46395;23219;23176;2023
07;Balears, Illes;034;Mancor de la Vall;1639;824;815;2023
07;Balears, Illes;032;Maó;29902;14564;15338;2023
07;Balears, Illes;035;Maria de la Salut;2336;1204;1132;2023
07;Balears, Illes;036;Marratxí;39440;19798;19642;2023
07;Balears, Illes;037;Mercadal, Es;5939;3033;2906;2023
07;Balears, Illes;902;Migjorn Gran, Es;1563;779;784;2023
07;Balears, Illes;038;Montuïri;3144;1586;1558;2023
07;Balears, Illes;039;Muro;7825;3952;3873;2023
07;Balears, Illes;040;Palma;423350;206618;216732;2023
07;Balears, Illes;041;Petra;3118;1530;1588;2023
07;Balears, Illes;044;Pobla, Sa;14164;7131;7033;2023
07;Balears, Illes;042;Pollença;17279;8588;8691;2023
07;Balears, Illes;043;Porreres;5741;2913;2828;2023
07;Balears, Illes;045;Puigpunyent;2055;1021;1034;2023
07;Balears, Illes;059;Salines, Ses;5044;2496;2548;2023
07;Balears, Illes;046;Sant Antoni de Portmany;28237;14725;13512;2023
07;Balears, Illes;049;Sant Joan;2195;1079;1116;2023
07;Balears, Illes;050;Sant Joan de Labritja;6838;3465;3373;2023
07;Balears, Illes;048;Sant Josep de sa Talaia;29506;15147;14359;2023
07;Balears, Illes;051;Sant Llorenç des Cardassar;9227;4608;4619;2023
07;Balears, Illes;052;Sant Lluís;7019;3551;3468;2023
07;Balears, Illes;053;Santa Eugènia;1843;920;923;2023
07;Balears, Illes;054;Santa Eulària des Riu;41228;20837;20391;2023
07;Balears, Illes;055;Santa Margalida;13160;6782;6378;2023
07;Balears, Illes;056;Santa María del Camí;7552;3767;3785;2023
07;Balears, Illes;057;Santanyí;12480;6261;6219;2023
07;Balears, Illes;058;Selva;4289;2108;2181;2023
07;Balears, Illes;047;Sencelles;3795;1918;1877;2023
07;Balears, Illes;060;Sineu;4369;2157;2212;2023
07;Balears, Illes;061;Sóller;13610;6720;6890;2023
07;Balears, Illes;062;Son Servera;11932;5896;6036;2023
07;Balears, Illes;063;Valldemossa;2037;1031;1006;2023
07;Balears, Illes;065;Vilafranca de Bonany;3699;1868;1831;2023
08;Barcelona;001;Abrera;12848;6462;6386;2023
08;Barcelona;002;Aguilar de Segarra;294;158;136;2023
08;Barcelona;014;Aiguafreda;2567;1242;1325;2023
08;Barcelona;003;Alella;10139;4946;5193;2023
08;Barcelona;004;Alpens;273;149;124;2023
08;Barcelona;005;Ametlla del Vallès, L';9296;4666;4630;2023
08;Barcelona;006;Arenys de Mar;16342;7948;8394;2023
08;Barcelona;007;Arenys de Munt;9413;4724;4689;2023
08;Barcelona;008;Argençola;222;116;106;2023
08;Barcelona;009;Argentona;12846;6349;6497;2023
08;Barcelona;010;Artés;5994;3024;2970;2023
08;Barcelona;011;Avià;2249;1120;1129;2023
08;Barcelona;012;Avinyó;2289;1153;1136;2023
08;Barcelona;013;Avinyonet del Penedès;1732;917;815;2023
08;Barcelona;015;Badalona;225957;111330;114627;2023
08;Barcelona;904;Badia del Vallès;13074;6391;6683;2023
08;Barcelona;016;Bagà;2149;1079;1070;2023
08;Barcelona;017;Balenyà;3969;2015;1954;2023
08;Barcelona;018;Balsareny;3307;1668;1639;2023
08;Barcelona;252;Barberà del Vallès;33322;16345;16977;2023
08;Barcelona;019;Barcelona;1660122;789758;870364;2023
08;Barcelona;020;Begues;7432;3690;3742;2023
08;Barcelona;021;Bellprat;72;45;27;2023
08;Barcelona;022;Berga;16959;8350;8609;2023
08;Barcelona;023;Bigues i Riells del Fai;9949;5032;4917;2023
08;Barcelona;024;Borredà;430;243;187;2023
08;Barcelona;025;Bruc, El;2268;1195;1073;2023
08;Barcelona;026;Brull, El;287;156;131;2023
08;Barcelona;027;Cabanyes, Les;998;513;485;2023
08;Barcelona;028;Cabrera d'Anoia;1665;892;773;2023
08;Barcelona;029;Cabrera de Mar;4945;2480;2465;2023
08;Barcelona;030;Cabrils;7799;3858;3941;2023
08;Barcelona;031;Calaf;3566;1797;1769;2023
08;Barcelona;034;Calders;1097;565;532;2023
08;Barcelona;033;Caldes de Montbui;18109;9023;9086;2023
08;Barcelona;032;Caldes d'Estrac;3223;1543;1680;2023
08;Barcelona;035;Calella;19862;9569;10293;2023
08;Barcelona;037;Calldetenes;2601;1323;1278;2023
08;Barcelona;038;Callús;2099;1029;1070;2023
08;Barcelona;036;Calonge de Segarra;188;95;93;2023
08;Barcelona;039;Campins;589;302;287;2023
08;Barcelona;040;Canet de Mar;15010;7300;7710;2023
08;Barcelona;041;Canovelles;17051;8789;8262;2023
08;Barcelona;042;Cànoves i Samalús;3322;1692;1630;2023
08;Barcelona;043;Canyelles;5218;2727;2491;2023
08;Barcelona;044;Capellades;5417;2679;2738;2023
08;Barcelona;045;Capolat;88;42;46;2023
08;Barcelona;046;Cardedeu;19023;9211;9812;2023
08;Barcelona;047;Cardona;4569;2256;2313;2023
08;Barcelona;048;Carme;783;404;379;2023
08;Barcelona;049;Casserres;1630;811;819;2023
08;Barcelona;057;Castell de l'Areny;69;39;30;2023
08;Barcelona;052;Castellar de n'Hug;171;93;78;2023
08;Barcelona;050;Castellar del Riu;169;94;75;2023
08;Barcelona;051;Castellar del Vallès;25150;12432;12718;2023
08;Barcelona;053;Castellbell i el Vilar;4054;2077;1977;2023
08;Barcelona;054;Castellbisbal;12813;6423;6390;2023
08;Barcelona;055;Castellcir;778;409;369;2023
08;Barcelona;056;Castelldefels;68427;33378;35049;2023
08;Barcelona;058;Castellet i la Gornal;2572;1345;1227;2023
08;Barcelona;060;Castellfollit de Riubregós;162;88;74;2023
08;Barcelona;059;Castellfollit del Boix;461;236;225;2023
08;Barcelona;061;Castellgalí;2311;1183;1128;2023
08;Barcelona;062;Castellnou de Bages;1427;746;681;2023
08;Barcelona;063;Castellolí;651;311;340;2023
08;Barcelona;064;Castellterçol;2735;1392;1343;2023
08;Barcelona;065;Castellví de la Marca;1674;856;818;2023
08;Barcelona;066;Castellví de Rosanes;2089;1031;1058;2023
08;Barcelona;067;Centelles;7726;3788;3938;2023
08;Barcelona;268;Cercs;1196;601;595;2023
08;Barcelona;266;Cerdanyola del Vallès;57879;28138;29741;2023
08;Barcelona;068;Cervelló;9469;4788;4681;2023
08;Barcelona;069;Collbató;4828;2490;2338;2023
08;Barcelona;070;Collsuspina;387;193;194;2023
08;Barcelona;071;Copons;340;173;167;2023
08;Barcelona;072;Corbera de Llobregat;15466;7762;7704;2023
08;Barcelona;073;Cornellà de Llobregat;90303;43825;46478;2023
08;Barcelona;074;Cubelles;16914;8501;8413;2023
08;Barcelona;075;Dosrius;5910;2961;2949;2023
08;Barcelona;076;Esparreguera;22442;11357;11085;2023
08;Barcelona;077;Esplugues de Llobregat;46921;22350;24571;2023
08;Barcelona;078;Espunyola, L';266;129;137;2023
08;Barcelona;254;Esquirol, L';2263;1123;1140;2023
08;Barcelona;079;Estany, L';405;223;182;2023
08;Barcelona;134;Figaró-Montmany;1158;558;600;2023
08;Barcelona;080;Fígols;47;26;21;2023
08;Barcelona;082;Fogars de la Selva;1632;845;787;2023
08;Barcelona;081;Fogars de Montclús;482;263;219;2023
08;Barcelona;083;Folgueroles;2268;1149;1119;2023
08;Barcelona;084;Fonollosa;1558;793;765;2023
08;Barcelona;085;Font-rubí;1456;786;670;2023
08;Barcelona;086;Franqueses del Vallès, Les;20522;10343;10179;2023
08;Barcelona;090;Gaià;177;90;87;2023
08;Barcelona;087;Gallifa;183;97;86;2023
08;Barcelona;088;Garriga, La;17052;8190;8862;2023
08;Barcelona;089;Gavà;47593;23190;24403;2023
08;Barcelona;091;Gelida;7953;4011;3942;2023
08;Barcelona;092;Gironella;4980;2475;2505;2023
08;Barcelona;093;Gisclareny;27;15;12;2023
08;Barcelona;094;Granada, La;2218;1102;1116;2023
08;Barcelona;095;Granera;93;57;36;2023
08;Barcelona;096;Granollers;63092;31137;31955;2023
08;Barcelona;097;Gualba;1661;842;819;2023
08;Barcelona;099;Guardiola de Berguedà;939;483;456;2023
08;Barcelona;100;Gurb;2697;1397;1300;2023
08;Barcelona;101;Hospitalet de Llobregat, L';274455;133258;141197;2023
08;Barcelona;162;Hostalets de Pierola, Els;3188;1619;1569;2023
08;Barcelona;102;Igualada;41164;20248;20916;2023
08;Barcelona;103;Jorba;828;427;401;2023
08;Barcelona;104;Llacuna, La;952;501;451;2023
08;Barcelona;105;Llagosta, La;13169;6478;6691;2023
08;Barcelona;107;Lliçà d'Amunt;16092;8196;7896;2023
08;Barcelona;108;Lliçà de Vall;6714;3413;3301;2023
08;Barcelona;106;Llinars del Vallès;10499;5171;5328;2023
08;Barcelona;109;Lluçà;292;143;149;2023
08;Barcelona;110;Malgrat de Mar;19213;9457;9756;2023
08;Barcelona;111;Malla;266;135;131;2023
08;Barcelona;112;Manlleu;21172;10601;10571;2023
08;Barcelona;113;Manresa;78877;38646;40231;2023
08;Barcelona;242;Marganell;293;148;145;2023
08;Barcelona;114;Martorell;28760;14616;14144;2023
08;Barcelona;115;Martorelles;4904;2460;2444;2023
08;Barcelona;116;Masies de Roda, Les;751;389;362;2023
08;Barcelona;117;Masies de Voltregà, Les;3222;1593;1629;2023
08;Barcelona;118;Masnou, El;24181;11614;12567;2023
08;Barcelona;119;Masquefa;9839;5016;4823;2023
08;Barcelona;120;Matadepera;9899;4956;4943;2023
08;Barcelona;121;Mataró;129870;64330;65540;2023
08;Barcelona;122;Mediona;2628;1351;1277;2023
08;Barcelona;138;Moià;6690;3438;3252;2023
08;Barcelona;123;Molins de Rei;26555;12947;13608;2023
08;Barcelona;124;Mollet del Vallès;51824;25431;26393;2023
08;Barcelona;128;Monistrol de Calders;751;394;357;2023
08;Barcelona;127;Monistrol de Montserrat;3179;1623;1556;2023
08;Barcelona;125;Montcada i Reixac;36891;18189;18702;2023
08;Barcelona;130;Montclar;129;66;63;2023
08;Barcelona;131;Montesquiu;1110;551;559;2023
08;Barcelona;126;Montgat;12462;6155;6307;2023
08;Barcelona;132;Montmajor;482;247;235;2023
08;Barcelona;133;Montmaneu;198;109;89;2023
08;Barcelona;135;Montmeló;8825;4312;4513;2023
08;Barcelona;136;Montornès del Vallès;16800;8425;8375;2023
08;Barcelona;137;Montseny;379;193;186;2023
08;Barcelona;129;Muntanyola;721;379;342;2023
08;Barcelona;139;Mura;228;118;110;2023
08;Barcelona;140;Navarcles;6109;2976;3133;2023
08;Barcelona;141;Navàs;6150;3017;3133;2023
08;Barcelona;142;Nou de Berguedà, La;170;86;84;2023
08;Barcelona;143;Òdena;3720;1922;1798;2023
08;Barcelona;145;Olèrdola;3968;2067;1901;2023
08;Barcelona;146;Olesa de Bonesvalls;2110;1091;1019;2023
08;Barcelona;147;Olesa de Montserrat;24446;12182;12264;2023
08;Barcelona;148;Olivella;4414;2288;2126;2023
08;Barcelona;149;Olost;1218;596;622;2023
08;Barcelona;144;Olvan;890;445;445;2023
08;Barcelona;150;Orís;355;185;170;2023
08;Barcelona;151;Oristà;587;305;282;2023
08;Barcelona;152;Orpí;163;86;77;2023
08;Barcelona;153;Òrrius;799;404;395;2023
08;Barcelona;154;Pacs del Penedès;909;456;453;2023
08;Barcelona;155;Palafolls;9819;4924;4895;2023
08;Barcelona;156;Palau-solità i Plegamans;15130;7383;7747;2023
08;Barcelona;157;Pallejà;11736;5833;5903;2023
08;Barcelona;905;Palma de Cervelló, La;3040;1484;1556;2023
08;Barcelona;158;Papiol, El;4325;2160;2165;2023
08;Barcelona;159;Parets del Vallès;18893;9455;9438;2023
08;Barcelona;160;Perafita;423;219;204;2023
08;Barcelona;161;Piera;17203;8845;8358;2023
08;Barcelona;163;Pineda de Mar;28751;14229;14522;2023
08;Barcelona;164;Pla del Penedès, El;1317;670;647;2023
08;Barcelona;165;Pobla de Claramunt, La;2309;1184;1125;2023
08;Barcelona;166;Pobla de Lillet, La;1089;522;567;2023
08;Barcelona;167;Polinyà;8482;4269;4213;2023
08;Barcelona;182;Pont de Vilomara i Rocafort, El;4101;2118;1983;2023
08;Barcelona;168;Pontons;523;285;238;2023
08;Barcelona;169;Prat de Llobregat, El;65516;32022;33494;2023
08;Barcelona;171;Prats de Lluçanès;2681;1344;1337;2023
08;Barcelona;170;Prats de Rei, Els;558;299;259;2023
08;Barcelona;230;Premià de Dalt;10532;5241;5291;2023
08;Barcelona;172;Premià de Mar;28767;14018;14749;2023
08;Barcelona;174;Puigdàlber;571;279;292;2023
08;Barcelona;175;Puig-reig;4399;2207;2192;2023
08;Barcelona;176;Pujalt;219;120;99;2023
08;Barcelona;177;Quar, La;40;26;14;2023
08;Barcelona;178;Rajadell;571;299;272;2023
08;Barcelona;179;Rellinars;923;492;431;2023
08;Barcelona;180;Ripollet;39269;19373;19896;2023
08;Barcelona;181;Roca del Vallès, La;10913;5476;5437;2023
08;Barcelona;183;Roda de Ter;6680;3378;3302;2023
08;Barcelona;184;Rubí;80044;39546;40498;2023
08;Barcelona;185;Rubió;254;143;111;2023
08;Barcelona;901;Rupit i Pruit;277;135;142;2023
08;Barcelona;187;Sabadell;218300;105946;112354;2023
08;Barcelona;188;Sagàs;151;81;70;2023
08;Barcelona;190;Saldes;303;172;131;2023
08;Barcelona;191;Sallent;6835;3342;3493;2023
08;Barcelona;194;Sant Adrià de Besòs;37925;18646;19279;2023
08;Barcelona;195;Sant Agustí de Lluçanès;109;57;52;2023
08;Barcelona;196;Sant Andreu de la Barca;26910;13208;13702;2023
08;Barcelona;197;Sant Andreu de Llavaneres;11831;5781;6050;2023
08;Barcelona;198;Sant Antoni de Vilamajor;6577;3269;3308;2023
08;Barcelona;199;Sant Bartomeu del Grau;945;499;446;2023
08;Barcelona;200;Sant Boi de Llobregat;83919;40828;43091;2023
08;Barcelona;201;Sant Boi de Lluçanès;572;296;276;2023
08;Barcelona;203;Sant Cebrià de Vallalta;3792;1966;1826;2023
08;Barcelona;202;Sant Celoni;18479;9202;9277;2023
08;Barcelona;204;Sant Climent de Llobregat;4190;2095;2095;2023
08;Barcelona;205;Sant Cugat del Vallès;97530;47492;50038;2023
08;Barcelona;206;Sant Cugat Sesgarrigues;1026;502;524;2023
08;Barcelona;207;Sant Esteve de Palautordera;3045;1507;1538;2023
08;Barcelona;208;Sant Esteve Sesrovires;7906;3936;3970;2023
08;Barcelona;210;Sant Feliu de Codines;6527;3298;3229;2023
08;Barcelona;211;Sant Feliu de Llobregat;46056;22369;23687;2023
08;Barcelona;212;Sant Feliu Sasserra;620;326;294;2023
08;Barcelona;209;Sant Fost de Campsentelles;9197;4561;4636;2023
08;Barcelona;213;Sant Fruitós de Bages;9156;4531;4625;2023
08;Barcelona;215;Sant Hipòlit de Voltregà;3711;1865;1846;2023
08;Barcelona;193;Sant Iscle de Vallalta;1441;752;689;2023
08;Barcelona;216;Sant Jaume de Frontanyà;29;15;14;2023
08;Barcelona;218;Sant Joan de Vilatorrada;10959;5440;5519;2023
08;Barcelona;217;Sant Joan Despí;34568;16725;17843;2023
08;Barcelona;903;Sant Julià de Cerdanyola;242;135;107;2023
08;Barcelona;220;Sant Julià de Vilatorta;3230;1604;1626;2023
08;Barcelona;221;Sant Just Desvern;20462;9858;10604;2023
08;Barcelona;222;Sant Llorenç d'Hortons;2572;1299;1273;2023
08;Barcelona;223;Sant Llorenç Savall;2545;1271;1274;2023
08;Barcelona;225;Sant Martí d'Albars;121;60;61;2023
08;Barcelona;224;Sant Martí de Centelles;1247;629;618;2023
08;Barcelona;226;Sant Martí de Tous;1268;638;630;2023
08;Barcelona;227;Sant Martí Sarroca;3380;1692;1688;2023
08;Barcelona;228;Sant Martí Sesgueioles;359;186;173;2023
08;Barcelona;229;Sant Mateu de Bages;633;326;307;2023
08;Barcelona;231;Sant Pere de Ribes;31786;15702;16084;2023
08;Barcelona;232;Sant Pere de Riudebitlles;2462;1244;1218;2023
08;Barcelona;233;Sant Pere de Torelló;2568;1320;1248;2023
08;Barcelona;234;Sant Pere de Vilamajor;4862;2460;2402;2023
08;Barcelona;189;Sant Pere Sallavinera;162;84;78;2023
08;Barcelona;235;Sant Pol de Mar;5791;2829;2962;2023
08;Barcelona;236;Sant Quintí de Mediona;2407;1229;1178;2023
08;Barcelona;237;Sant Quirze de Besora;2115;1026;1089;2023
08;Barcelona;238;Sant Quirze del Vallès;20241;9900;10341;2023
08;Barcelona;239;Sant Quirze Safaja;677;363;314;2023
08;Barcelona;240;Sant Sadurní d'Anoia;12945;6373;6572;2023
08;Barcelona;241;Sant Sadurní d'Osormort;89;53;36;2023
08;Barcelona;098;Sant Salvador de Guardiola;3430;1753;1677;2023
08;Barcelona;262;Sant Vicenç de Castellet;10068;5067;5001;2023
08;Barcelona;264;Sant Vicenç de Montalt;6701;3333;3368;2023
08;Barcelona;265;Sant Vicenç de Torelló;2083;1047;1036;2023
08;Barcelona;263;Sant Vicenç dels Horts;28406;14094;14312;2023
08;Barcelona;243;Santa Cecília de Voltregà;184;102;82;2023
08;Barcelona;244;Santa Coloma de Cervelló;8393;4077;4316;2023
08;Barcelona;245;Santa Coloma de Gramenet;119862;59151;60711;2023
08;Barcelona;246;Santa Eugènia de Berga;2303;1179;1124;2023
08;Barcelona;247;Santa Eulàlia de Riuprimer;1450;728;722;2023
08;Barcelona;248;Santa Eulàlia de Ronçana;7846;3928;3918;2023
08;Barcelona;249;Santa Fe del Penedès;362;179;183;2023
08;Barcelona;250;Santa Margarida de Montbui;10456;5247;5209;2023
08;Barcelona;251;Santa Margarida i els Monjos;7650;3887;3763;2023
08;Barcelona;253;Santa Maria de Besora;165;89;76;2023
08;Barcelona;256;Santa Maria de Martorelles;881;446;435;2023
08;Barcelona;255;Santa Maria de Merlès;174;89;85;2023
08;Barcelona;257;Santa Maria de Miralles;138;74;64;2023
08;Barcelona;259;Santa Maria de Palautordera;9872;4965;4907;2023
08;Barcelona;258;Santa Maria d'Oló;1086;543;543;2023
08;Barcelona;260;Santa Perpètua de Mogoda;25928;12977;12951;2023
08;Barcelona;261;Santa Susanna;3887;1946;1941;2023
08;Barcelona;192;Santpedor;7693;3830;3863;2023
08;Barcelona;267;Sentmenat;9474;4791;4683;2023
08;Barcelona;269;Seva;3770;1949;1821;2023
08;Barcelona;270;Sitges;31954;16010;15944;2023
08;Barcelona;271;Sobremunt;86;34;52;2023
08;Barcelona;272;Sora;217;116;101;2023
08;Barcelona;273;Subirats;3243;1674;1569;2023
08;Barcelona;274;Súria;6046;2930;3116;2023
08;Barcelona;276;Tagamanent;344;179;165;2023
08;Barcelona;277;Talamanca;223;122;101;2023
08;Barcelona;278;Taradell;6809;3423;3386;2023
08;Barcelona;275;Tavèrnoles;340;173;167;2023
08;Barcelona;280;Tavertet;126;68;58;2023
08;Barcelona;281;Teià;6696;3285;3411;2023
08;Barcelona;279;Terrassa;225277;110614;114663;2023
08;Barcelona;282;Tiana;9198;4442;4756;2023
08;Barcelona;283;Tona;8455;4162;4293;2023
08;Barcelona;284;Tordera;18409;9338;9071;2023
08;Barcelona;285;Torelló;14902;7447;7455;2023
08;Barcelona;286;Torre de Claramunt, La;4018;2096;1922;2023
08;Barcelona;287;Torrelavit;1499;777;722;2023
08;Barcelona;288;Torrelles de Foix;2608;1374;1234;2023
08;Barcelona;289;Torrelles de Llobregat;6225;3080;3145;2023
08;Barcelona;290;Ullastrell;2162;1077;1085;2023
08;Barcelona;291;Vacarisses;7460;3851;3609;2023
08;Barcelona;292;Vallbona d'Anoia;1428;732;696;2023
08;Barcelona;293;Vallcebre;273;144;129;2023
08;Barcelona;294;Vallgorguina;3204;1630;1574;2023
08;Barcelona;295;Vallirana;15823;7897;7926;2023
08;Barcelona;296;Vallromanes;2705;1389;1316;2023
08;Barcelona;297;Veciana;179;101;78;2023
08;Barcelona;298;Vic;48364;24478;23886;2023
08;Barcelona;299;Vilada;434;233;201;2023
08;Barcelona;301;Viladecans;66677;32866;33811;2023
08;Barcelona;300;Viladecavalls;7809;3866;3943;2023
08;Barcelona;305;Vilafranca del Penedès;40714;19816;20898;2023
08;Barcelona;306;Vilalba Sasserra;753;384;369;2023
08;Barcelona;303;Vilanova de Sau;310;147;163;2023
08;Barcelona;302;Vilanova del Camí;12758;6399;6359;2023
08;Barcelona;902;Vilanova del Vallès;5600;2839;2761;2023
08;Barcelona;307;Vilanova i la Geltrú;68854;33250;35604;2023
08;Barcelona;214;Vilassar de Dalt;9230;4552;4678;2023
08;Barcelona;219;Vilassar de Mar;21055;10087;10968;2023
08;Barcelona;304;Vilobí del Penedès;1141;584;557;2023
08;Barcelona;308;Viver i Serrateix;173;89;84;2023
48;Bizkaia;001;Abadiño;7708;3864;3844;2023
48;Bizkaia;002;Abanto y Ciérvana-Abanto Zierbena;9402;4674;4728;2023
48;Bizkaia;911;Ajangiz;478;250;228;2023
48;Bizkaia;912;Alonsotegi;2950;1461;1489;2023
48;Bizkaia;003;Amorebieta-Etxano;19570;9577;9993;2023
48;Bizkaia;004;Amoroto;392;206;186;2023
48;Bizkaia;005;Arakaldo;164;75;89;2023
48;Bizkaia;006;Arantzazu;389;198;191;2023
48;Bizkaia;093;Areatza;1247;605;642;2023
48;Bizkaia;009;Arrankudiaga-Zollo;991;494;497;2023
48;Bizkaia;914;Arratzu;426;199;227;2023
48;Bizkaia;010;Arrieta;581;300;281;2023
48;Bizkaia;011;Arrigorriaga;11954;5869;6085;2023
48;Bizkaia;023;Artea;754;383;371;2023
48;Bizkaia;008;Artzentales;726;381;345;2023
48;Bizkaia;091;Atxondo;1367;688;679;2023
48;Bizkaia;070;Aulesti;655;325;330;2023
48;Bizkaia;012;Bakio;2811;1397;1414;2023
48;Bizkaia;090;Balmaseda;7593;3658;3935;2023
48;Bizkaia;013;Barakaldo;101229;49025;52204;2023
48;Bizkaia;014;Barrika;1533;765;768;2023
48;Bizkaia;015;Basauri;40413;19559;20854;2023
48;Bizkaia;092;Bedia;1114;543;571;2023
48;Bizkaia;016;Berango;7454;3640;3814;2023
48;Bizkaia;017;Bermeo;16878;8291;8587;2023
48;Bizkaia;018;Berriatua;1216;661;555;2023
48;Bizkaia;019;Berriz;4543;2250;2293;2023
48;Bizkaia;020;Bilbao;346096;163991;182105;2023
48;Bizkaia;021;Busturia;1644;825;819;2023
48;Bizkaia;901;Derio;7071;3460;3611;2023
48;Bizkaia;026;Dima;1496;768;728;2023
48;Bizkaia;027;Durango;29767;14516;15251;2023
48;Bizkaia;028;Ea;822;430;392;2023
48;Bizkaia;031;Elantxobe;348;167;181;2023
48;Bizkaia;032;Elorrio;7292;3582;3710;2023
48;Bizkaia;902;Erandio;24411;11784;12627;2023
48;Bizkaia;033;Ereño;277;150;127;2023
48;Bizkaia;034;Ermua;15599;7726;7873;2023
48;Bizkaia;079;Errigoiti;509;274;235;2023
48;Bizkaia;029;Etxebarri;11975;5969;6006;2023
48;Bizkaia;030;Etxebarria;782;396;386;2023
48;Bizkaia;906;Forua;916;444;472;2023
48;Bizkaia;035;Fruiz;551;273;278;2023
48;Bizkaia;036;Galdakao;29332;14414;14918;2023
48;Bizkaia;037;Galdames;834;445;389;2023
48;Bizkaia;038;Gamiz-Fika;1395;703;692;2023
48;Bizkaia;039;Garai;334;163;171;2023
48;Bizkaia;040;Gatika;1623;811;812;2023
48;Bizkaia;041;Gautegiz Arteaga;889;443;446;2023
48;Bizkaia;046;Gernika-Lumo;17050;8203;8847;2023
48;Bizkaia;044;Getxo;76104;35602;40502;2023
48;Bizkaia;047;Gizaburuaga;197;104;93;2023
48;Bizkaia;042;Gordexola;1678;866;812;2023
48;Bizkaia;043;Gorliz;6058;2980;3078;2023
48;Bizkaia;045;Güeñes;6740;3240;3500;2023
48;Bizkaia;048;Ibarrangelu;695;358;337;2023
48;Bizkaia;094;Igorre;4296;2115;2181;2023
48;Bizkaia;049;Ispaster;731;379;352;2023
48;Bizkaia;910;Iurreta;3738;1854;1884;2023
48;Bizkaia;050;Izurtza;227;147;80;2023
48;Bizkaia;022;Karrantza Harana/Valle de Carranza;2713;1408;1305;2023
48;Bizkaia;907;Kortezubi;440;214;226;2023
48;Bizkaia;051;Lanestosa;246;135;111;2023
48;Bizkaia;052;Larrabetzu;2056;1004;1052;2023
48;Bizkaia;053;Laukiz;1225;600;625;2023
48;Bizkaia;054;Leioa;32491;15857;16634;2023
48;Bizkaia;057;Lekeitio;7143;3522;3621;2023
48;Bizkaia;055;Lemoa;3547;1781;1766;2023
48;Bizkaia;056;Lemoiz;1318;691;627;2023
48;Bizkaia;081;Lezama;2448;1220;1228;2023
48;Bizkaia;903;Loiu;2297;1105;1192;2023
48;Bizkaia;058;Mallabia;1160;591;569;2023
48;Bizkaia;059;Mañaria;533;273;260;2023
48;Bizkaia;060;Markina-Xemein;5037;2529;2508;2023
48;Bizkaia;061;Maruri-Jatabe;1069;556;513;2023
48;Bizkaia;062;Mendata;385;200;185;2023
48;Bizkaia;063;Mendexa;425;221;204;2023
48;Bizkaia;064;Meñaka;763;400;363;2023
48;Bizkaia;066;Morga;414;219;195;2023
48;Bizkaia;068;Mundaka;1843;918;925;2023
48;Bizkaia;069;Mungia;17882;8689;9193;2023
48;Bizkaia;007;Munitibar-Arbatzegi Gerrikaitz;470;255;215;2023
48;Bizkaia;908;Murueta;337;176;161;2023
48;Bizkaia;071;Muskiz;7342;3567;3775;2023
48;Bizkaia;067;Muxika;1517;796;721;2023
48;Bizkaia;909;Nabarniz;269;135;134;2023
48;Bizkaia;073;Ondarroa;8179;4069;4110;2023
48;Bizkaia;075;Orozko;2654;1318;1336;2023
48;Bizkaia;083;Ortuella;8536;4164;4372;2023
48;Bizkaia;072;Otxandio;1323;677;646;2023
48;Bizkaia;077;Plentzia;4361;2123;2238;2023
48;Bizkaia;078;Portugalete;44629;21309;23320;2023
48;Bizkaia;082;Santurtzi;46057;22074;23983;2023
48;Bizkaia;084;Sestao;27834;13413;14421;2023
48;Bizkaia;904;Sondika;4523;2177;2346;2023
48;Bizkaia;085;Sopela;14872;7374;7498;2023
48;Bizkaia;086;Sopuerta;2731;1369;1362;2023
48;Bizkaia;076;Sukarrieta;355;185;170;2023
48;Bizkaia;087;Trucios-Turtzioz;521;273;248;2023
48;Bizkaia;088;Ubide;173;86;87;2023
48;Bizkaia;065;Ugao-Miraballes;4164;2089;2075;2023
48;Bizkaia;089;Urduliz;5469;2690;2779;2023
48;Bizkaia;074;Urduña/Orduña;4179;2150;2029;2023
48;Bizkaia;080;Valle de Trápaga-Trapagaran;11911;5804;6107;2023
48;Bizkaia;095;Zaldibar;3005;1533;1472;2023
48;Bizkaia;096;Zalla;8319;4063;4256;2023
48;Bizkaia;905;Zamudio;3294;1639;1655;2023
48;Bizkaia;097;Zaratamo;1610;808;802;2023
48;Bizkaia;024;Zeanuri;1247;627;620;2023
48;Bizkaia;025;Zeberio;1081;547;534;2023
48;Bizkaia;913;Zierbena;1496;786;710;2023
48;Bizkaia;915;Ziortza-Bolibar;398;208;190;2023
09;Burgos;001;Abajas;28;18;10;2023
09;Burgos;003;Adrada de Haza;202;98;104;2023
09;Burgos;006;Aguas Cándidas;60;40;20;2023
09;Burgos;007;Aguilar de Bureba;54;34;20;2023
09;Burgos;009;Albillos;221;120;101;2023
09;Burgos;010;Alcocero de Mola;41;29;12;2023
09;Burgos;011;Alfoz de Bricia;71;47;24;2023
09;Burgos;907;Alfoz de Quintanadueñas;2180;1148;1032;2023
09;Burgos;012;Alfoz de Santa Gadea;99;52;47;2023
09;Burgos;013;Altable;46;27;19;2023
09;Burgos;014;Altos, Los;201;125;76;2023
09;Burgos;016;Ameyugo;114;57;57;2023
09;Burgos;017;Anguix;157;102;55;2023
09;Burgos;018;Aranda de Duero;33626;16349;17277;2023
09;Burgos;019;Arandilla;156;102;54;2023
09;Burgos;020;Arauzo de Miel;276;152;124;2023
09;Burgos;021;Arauzo de Salce;48;24;24;2023
09;Burgos;022;Arauzo de Torre;64;39;25;2023
09;Burgos;023;Arcos;1826;956;870;2023
09;Burgos;024;Arenillas de Riopisuerga;174;105;69;2023
09;Burgos;025;Arija;110;58;52;2023
09;Burgos;026;Arlanzón;431;260;171;2023
09;Burgos;027;Arraya de Oca;44;26;18;2023
09;Burgos;029;Atapuerca;180;106;74;2023
09;Burgos;030;Ausines, Los;162;98;64;2023
09;Burgos;032;Avellanosa de Muñó;101;55;46;2023
09;Burgos;033;Bahabón de Esgueva;78;42;36;2023
09;Burgos;034;Balbases, Los;302;166;136;2023
09;Burgos;035;Baños de Valdearados;318;183;135;2023
09;Burgos;036;Bañuelos de Bureba;34;20;14;2023
09;Burgos;037;Barbadillo de Herreros;106;65;41;2023
09;Burgos;038;Barbadillo del Mercado;141;76;65;2023
09;Burgos;039;Barbadillo del Pez;69;39;30;2023
09;Burgos;041;Barrio de Muñó;31;18;13;2023
09;Burgos;043;Barrios de Bureba, Los;186;99;87;2023
09;Burgos;044;Barrios de Colina;57;31;26;2023
09;Burgos;045;Basconcillos del Tozo;298;174;124;2023
09;Burgos;046;Bascuñana;20;14;6;2023
09;Burgos;047;Belbimbre;56;28;28;2023
09;Burgos;048;Belorado;1798;909;889;2023
09;Burgos;050;Berberana;50;29;21;2023
09;Burgos;051;Berlangas de Roa;191;108;83;2023
09;Burgos;052;Berzosa de Bureba;26;19;7;2023
09;Burgos;054;Bozoó;101;60;41;2023
09;Burgos;055;Brazacorta;47;31;16;2023
09;Burgos;056;Briviesca;6414;3217;3197;2023
09;Burgos;057;Bugedo;194;117;77;2023
09;Burgos;058;Buniel;626;346;280;2023
09;Burgos;059;Burgos;174451;82934;91517;2023
09;Burgos;060;Busto de Bureba;140;78;62;2023
09;Burgos;061;Cabañes de Esgueva;158;87;71;2023
09;Burgos;062;Cabezón de la Sierra;39;16;23;2023
09;Burgos;064;Caleruega;393;200;193;2023
09;Burgos;065;Campillo de Aranda;174;96;78;2023
09;Burgos;066;Campolara;50;35;15;2023
09;Burgos;067;Canicosa de la Sierra;422;230;192;2023
09;Burgos;068;Cantabrana;22;13;9;2023
09;Burgos;070;Carazo;41;26;15;2023
09;Burgos;071;Carcedo de Bureba;50;27;23;2023
09;Burgos;072;Carcedo de Burgos;488;261;227;2023
09;Burgos;073;Cardeñadijo;1452;786;666;2023
09;Burgos;074;Cardeñajimeno;1195;632;563;2023
09;Burgos;075;Cardeñuela Riopico;109;64;45;2023
09;Burgos;076;Carrias;24;18;6;2023
09;Burgos;077;Cascajares de Bureba;28;14;14;2023
09;Burgos;078;Cascajares de la Sierra;28;15;13;2023
09;Burgos;079;Castellanos de Castro;50;30;20;2023
09;Burgos;083;Castil de Peones;26;13;13;2023
09;Burgos;082;Castildelgado;35;20;15;2023
09;Burgos;084;Castrillo de la Reina;165;107;58;2023
09;Burgos;085;Castrillo de la Vega;613;330;283;2023
09;Burgos;088;Castrillo de Riopisuerga;57;36;21;2023
09;Burgos;086;Castrillo del Val;835;462;373;2023
09;Burgos;090;Castrillo Mota de Judíos;51;26;25;2023
09;Burgos;091;Castrojeriz;763;399;364;2023
09;Burgos;063;Cavia;245;142;103;2023
09;Burgos;093;Cayuela;183;104;79;2023
09;Burgos;094;Cebrecos;56;34;22;2023
09;Burgos;095;Celada del Camino;91;45;46;2023
09;Burgos;098;Cerezo de Río Tirón;494;274;220;2023
09;Burgos;100;Cerratón de Juarros;50;34;16;2023
09;Burgos;101;Ciadoncha;75;47;28;2023
09;Burgos;102;Cillaperlata;34;22;12;2023
09;Burgos;103;Cilleruelo de Abajo;203;124;79;2023
09;Burgos;104;Cilleruelo de Arriba;48;27;21;2023
09;Burgos;105;Ciruelos de Cervera;107;61;46;2023
09;Burgos;108;Cogollos;616;346;270;2023
09;Burgos;109;Condado de Treviño;1479;810;669;2023
09;Burgos;110;Contreras;91;55;36;2023
09;Burgos;112;Coruña del Conde;100;62;38;2023
09;Burgos;113;Covarrubias;529;288;241;2023
09;Burgos;114;Cubillo del Campo;103;56;47;2023
09;Burgos;115;Cubo de Bureba;101;58;43;2023
09;Burgos;117;Cueva de Roa, La;95;50;45;2023
09;Burgos;119;Cuevas de San Clemente;44;19;25;2023
09;Burgos;120;Encío;43;23;20;2023
09;Burgos;122;Espinosa de Cervera;82;51;31;2023
09;Burgos;124;Espinosa de los Monteros;1633;838;795;2023
09;Burgos;123;Espinosa del Camino;44;26;18;2023
09;Burgos;125;Estépar;636;366;270;2023
09;Burgos;127;Fontioso;56;32;24;2023
09;Burgos;128;Frandovínez;98;54;44;2023
09;Burgos;129;Fresneda de la Sierra Tirón;101;65;36;2023
09;Burgos;130;Fresneña;68;44;24;2023
09;Burgos;131;Fresnillo de las Dueñas;688;358;330;2023
09;Burgos;132;Fresno de Río Tirón;167;101;66;2023
09;Burgos;133;Fresno de Rodilla;47;27;20;2023
09;Burgos;134;Frías;267;140;127;2023
09;Burgos;135;Fuentebureba;43;26;17;2023
09;Burgos;136;Fuentecén;232;132;100;2023
09;Burgos;137;Fuentelcésped;266;137;129;2023
09;Burgos;138;Fuentelisendo;104;56;48;2023
09;Burgos;139;Fuentemolinos;99;67;32;2023
09;Burgos;140;Fuentenebro;135;80;55;2023
09;Burgos;141;Fuentespina;809;425;384;2023
09;Burgos;143;Galbarros;29;18;11;2023
09;Burgos;144;Gallega, La;42;29;13;2023
09;Burgos;148;Grijalba;107;54;53;2023
09;Burgos;149;Grisaleña;59;42;17;2023
09;Burgos;151;Gumiel de Izán;594;324;270;2023
09;Burgos;152;Gumiel de Mercado;385;214;171;2023
09;Burgos;154;Hacinas;150;92;58;2023
09;Burgos;155;Haza;29;20;9;2023
09;Burgos;159;Hontanas;68;40;28;2023
09;Burgos;160;Hontangas;93;60;33;2023
09;Burgos;162;Hontoria de la Cantera;168;93;75;2023
09;Burgos;164;Hontoria de Valdearados;164;100;64;2023
09;Burgos;163;Hontoria del Pinar;617;331;286;2023
09;Burgos;166;Hormazas, Las;99;53;46;2023
09;Burgos;167;Hornillos del Camino;54;29;25;2023
09;Burgos;168;Horra, La;306;170;136;2023
09;Burgos;169;Hortigüela;107;71;36;2023
09;Burgos;170;Hoyales de Roa;208;111;97;2023
09;Burgos;172;Huérmeces;157;85;72;2023
09;Burgos;173;Huerta de Arriba;125;69;56;2023
09;Burgos;174;Huerta de Rey;880;481;399;2023
09;Burgos;175;Humada;115;79;36;2023
09;Burgos;176;Hurones;54;35;19;2023
09;Burgos;177;Ibeas de Juarros;1411;748;663;2023
09;Burgos;178;Ibrillos;33;25;8;2023
09;Burgos;179;Iglesiarrubia;47;24;23;2023
09;Burgos;180;Iglesias;144;76;68;2023
09;Burgos;181;Isar;282;150;132;2023
09;Burgos;182;Itero del Castillo;78;47;31;2023
09;Burgos;183;Jaramillo de la Fuente;42;28;14;2023
09;Burgos;184;Jaramillo Quemado;10;8;2;2023
09;Burgos;189;Junta de Traslaloma;124;71;53;2023
09;Burgos;190;Junta de Villalba de Losa;80;43;37;2023
09;Burgos;191;Jurisdicción de Lara;43;26;17;2023
09;Burgos;192;Jurisdicción de San Zadornil;68;40;28;2023
09;Burgos;194;Lerma;2585;1293;1292;2023
09;Burgos;195;Llano de Bureba;48;35;13;2023
09;Burgos;196;Madrigal del Monte;148;89;59;2023
09;Burgos;197;Madrigalejo del Monte;188;111;77;2023
09;Burgos;198;Mahamud;101;57;44;2023
09;Burgos;199;Mambrilla de Castrejón;112;69;43;2023
09;Burgos;200;Mambrillas de Lara;55;32;23;2023
09;Burgos;201;Mamolar;29;15;14;2023
09;Burgos;202;Manciles;23;14;9;2023
09;Burgos;206;Mazuela;55;32;23;2023
09;Burgos;208;Mecerreyes;192;105;87;2023
09;Burgos;209;Medina de Pomar;5866;2986;2880;2023
09;Burgos;211;Melgar de Fernamental;1525;849;676;2023
09;Burgos;213;Merindad de Cuesta-Urria;274;162;112;2023
09;Burgos;214;Merindad de Montija;739;445;294;2023
09;Burgos;906;Merindad de Río Ubierna;1430;802;628;2023
09;Burgos;215;Merindad de Sotoscueva;427;247;180;2023
09;Burgos;216;Merindad de Valdeporres;418;213;205;2023
09;Burgos;217;Merindad de Valdivielso;403;224;179;2023
09;Burgos;218;Milagros;417;218;199;2023
09;Burgos;219;Miranda de Ebro;35639;17586;18053;2023
09;Burgos;220;Miraveche;94;60;34;2023
09;Burgos;221;Modúbar de la Emparedada;777;426;351;2023
09;Burgos;223;Monasterio de la Sierra;39;26;13;2023
09;Burgos;224;Monasterio de Rodilla;158;86;72;2023
09;Burgos;225;Moncalvillo;85;50;35;2023
09;Burgos;226;Monterrubio de la Demanda;58;34;24;2023
09;Burgos;227;Montorio;150;85;65;2023
09;Burgos;228;Moradillo de Roa;166;90;76;2023
09;Burgos;229;Nava de Roa;206;110;96;2023
09;Burgos;230;Navas de Bureba;26;12;14;2023
09;Burgos;231;Nebreda;52;34;18;2023
09;Burgos;232;Neila;124;69;55;2023
09;Burgos;235;Olmedillo de Roa;186;107;79;2023
09;Burgos;236;Olmillos de Muñó;35;20;15;2023
09;Burgos;238;Oña;967;502;465;2023
09;Burgos;239;Oquillas;47;25;22;2023
09;Burgos;241;Orbaneja Riopico;358;200;158;2023
09;Burgos;242;Padilla de Abajo;66;41;25;2023
09;Burgos;243;Padilla de Arriba;89;57;32;2023
09;Burgos;244;Padrones de Bureba;69;33;36;2023
09;Burgos;246;Palacios de la Sierra;695;357;338;2023
09;Burgos;247;Palacios de Riopisuerga;19;9;10;2023
09;Burgos;248;Palazuelos de la Sierra;95;56;39;2023
09;Burgos;249;Palazuelos de Muñó;55;30;25;2023
09;Burgos;250;Pampliega;288;158;130;2023
09;Burgos;251;Pancorbo;433;228;205;2023
09;Burgos;253;Pardilla;106;65;41;2023
09;Burgos;255;Partido de la Sierra en Tobalina;88;55;33;2023
09;Burgos;256;Pedrosa de Duero;478;285;193;2023
09;Burgos;259;Pedrosa de Río Úrbel;259;154;105;2023
09;Burgos;257;Pedrosa del Páramo;90;54;36;2023
09;Burgos;258;Pedrosa del Príncipe;169;95;74;2023
09;Burgos;261;Peñaranda de Duero;470;243;227;2023
09;Burgos;262;Peral de Arlanza;172;95;77;2023
09;Burgos;265;Piérnigas;37;22;15;2023
09;Burgos;266;Pineda de la Sierra;95;63;32;2023
09;Burgos;267;Pineda Trasmonte;106;65;41;2023
09;Burgos;268;Pinilla de los Barruecos;100;60;40;2023
09;Burgos;269;Pinilla de los Moros;35;20;15;2023
09;Burgos;270;Pinilla Trasmonte;166;94;72;2023
09;Burgos;272;Poza de la Sal;286;158;128;2023
09;Burgos;273;Prádanos de Bureba;59;36;23;2023
09;Burgos;274;Pradoluengo;1076;552;524;2023
09;Burgos;275;Presencio;198;115;83;2023
09;Burgos;276;Puebla de Arganzón, La;552;287;265;2023
09;Burgos;277;Puentedura;117;75;42;2023
09;Burgos;279;Quemada;249;148;101;2023
09;Burgos;281;Quintana del Pidio;150;79;71;2023
09;Burgos;280;Quintanabureba;32;18;14;2023
09;Burgos;283;Quintanaélez;49;26;23;2023
09;Burgos;287;Quintanaortuño;284;153;131;2023
09;Burgos;288;Quintanapalla;106;53;53;2023
09;Burgos;289;Quintanar de la Sierra;1534;801;733;2023
09;Burgos;292;Quintanavides;69;39;30;2023
09;Burgos;294;Quintanilla de la Mata;112;71;41;2023
09;Burgos;901;Quintanilla del Agua y Tordueles;346;189;157;2023
09;Burgos;295;Quintanilla del Coco;51;26;25;2023
09;Burgos;298;Quintanilla San García;70;40;30;2023
09;Burgos;301;Quintanilla Vivar;898;477;421;2023
09;Burgos;297;Quintanillas, Las;384;226;158;2023
09;Burgos;302;Rabanera del Pinar;101;63;38;2023
09;Burgos;303;Rábanos;83;52;31;2023
09;Burgos;304;Rabé de las Calzadas;254;125;129;2023
09;Burgos;306;Rebolledo de la Torre;96;57;39;2023
09;Burgos;307;Redecilla del Camino;104;63;41;2023
09;Burgos;308;Redecilla del Campo;68;41;27;2023
09;Burgos;309;Regumiel de la Sierra;317;181;136;2023
09;Burgos;310;Reinoso;16;12;4;2023
09;Burgos;311;Retuerta;62;37;25;2023
09;Burgos;314;Revilla del Campo;102;63;39;2023
09;Burgos;316;Revilla Vallejera;119;69;50;2023
09;Burgos;312;Revilla y Ahedo, La;95;56;39;2023
09;Burgos;315;Revillarruz;611;325;286;2023
09;Burgos;317;Rezmondo;19;7;12;2023
09;Burgos;318;Riocavado de la Sierra;54;35;19;2023
09;Burgos;321;Roa;2220;1145;1075;2023
09;Burgos;323;Rojas;59;37;22;2023
09;Burgos;325;Royuela de Río Franco;175;104;71;2023
09;Burgos;326;Rubena;202;114;88;2023
09;Burgos;327;Rublacedo de Abajo;32;15;17;2023
09;Burgos;328;Rucandio;69;33;36;2023
09;Burgos;329;Salas de Bureba;135;79;56;2023
09;Burgos;330;Salas de los Infantes;1970;1018;952;2023
09;Burgos;332;Saldaña de Burgos;203;118;85;2023
09;Burgos;334;Salinillas de Bureba;48;34;14;2023
09;Burgos;335;San Adrián de Juarros;93;60;33;2023
09;Burgos;337;San Juan del Monte;142;76;66;2023
09;Burgos;338;San Mamés de Burgos;327;190;137;2023
09;Burgos;339;San Martín de Rubiales;143;87;56;2023
09;Burgos;340;San Millán de Lara;63;46;17;2023
09;Burgos;360;San Vicente del Valle;29;19;10;2023
09;Burgos;343;Santa Cecilia;105;63;42;2023
09;Burgos;345;Santa Cruz de la Salceda;136;77;59;2023
09;Burgos;346;Santa Cruz del Valle Urbión;101;66;35;2023
09;Burgos;347;Santa Gadea del Cid;161;87;74;2023
09;Burgos;348;Santa Inés;155;87;68;2023
09;Burgos;350;Santa María del Campo;509;279;230;2023
09;Burgos;351;Santa María del Invierno;64;47;17;2023
09;Burgos;352;Santa María del Mercadillo;101;69;32;2023
09;Burgos;353;Santa María Rivarredonda;91;55;36;2023
09;Burgos;354;Santa Olalla de Bureba;41;27;14;2023
09;Burgos;355;Santibáñez de Esgueva;79;44;35;2023
09;Burgos;356;Santibáñez del Val;72;41;31;2023
09;Burgos;358;Santo Domingo de Silos;261;165;96;2023
09;Burgos;361;Sargentes de la Lora;128;72;56;2023
09;Burgos;362;Sarracín;260;137;123;2023
09;Burgos;363;Sasamón;934;530;404;2023
09;Burgos;365;Sequera de Haza, La;27;20;7;2023
09;Burgos;366;Solarana;74;45;29;2023
09;Burgos;368;Sordillos;21;12;9;2023
09;Burgos;369;Sotillo de la Ribera;479;249;230;2023
09;Burgos;372;Sotragero;296;167;129;2023
09;Burgos;373;Sotresgudo;428;253;175;2023
09;Burgos;374;Susinos del Páramo;117;72;45;2023
09;Burgos;375;Tamarón;59;31;28;2023
09;Burgos;377;Tardajos;799;427;372;2023
09;Burgos;378;Tejada;34;19;15;2023
09;Burgos;380;Terradillos de Esgueva;67;34;33;2023
09;Burgos;381;Tinieblas de la Sierra;26;14;12;2023
09;Burgos;382;Tobar;25;18;7;2023
09;Burgos;384;Tordómar;311;169;142;2023
09;Burgos;386;Torrecilla del Monte;82;46;36;2023
09;Burgos;387;Torregalindo;117;70;47;2023
09;Burgos;388;Torrelara;32;21;11;2023
09;Burgos;389;Torrepadre;69;40;29;2023
09;Burgos;390;Torresandino;576;299;277;2023
09;Burgos;391;Tórtoles de Esgueva;406;222;184;2023
09;Burgos;392;Tosantos;53;28;25;2023
09;Burgos;394;Trespaderne;733;363;370;2023
09;Burgos;395;Tubilla del Agua;140;85;55;2023
09;Burgos;396;Tubilla del Lago;167;88;79;2023
09;Burgos;398;Úrbel del Castillo;62;44;18;2023
09;Burgos;400;Vadocondes;371;200;171;2023
09;Burgos;403;Valdeande;99;60;39;2023
09;Burgos;405;Valdezate;118;68;50;2023
09;Burgos;406;Valdorros;345;199;146;2023
09;Burgos;408;Vallarta de Bureba;42;27;15;2023
09;Burgos;904;Valle de las Navas;544;317;227;2023
09;Burgos;908;Valle de Losa;501;283;218;2023
09;Burgos;409;Valle de Manzanedo;124;62;62;2023
09;Burgos;410;Valle de Mena;4096;2067;2029;2023
09;Burgos;411;Valle de Oca;164;95;69;2023
09;Burgos;902;Valle de Santibáñez;487;286;201;2023
09;Burgos;905;Valle de Sedano;428;241;187;2023
09;Burgos;412;Valle de Tobalina;879;479;400;2023
09;Burgos;413;Valle de Valdebezana;469;255;214;2023
09;Burgos;414;Valle de Valdelaguna;196;120;76;2023
09;Burgos;415;Valle de Valdelucio;326;183;143;2023
09;Burgos;416;Valle de Zamanzas;49;32;17;2023
09;Burgos;417;Vallejera;41;24;17;2023
09;Burgos;418;Valles de Palenzuela;79;41;38;2023
09;Burgos;419;Valluércanes;68;46;22;2023
09;Burgos;407;Valmala;28;14;14;2023
09;Burgos;422;Vid de Bureba, La;24;13;11;2023
09;Burgos;421;Vid y Barrios, La;262;152;110;2023
09;Burgos;423;Vileña;26;16;10;2023
09;Burgos;427;Villadiego;1468;805;663;2023
09;Burgos;428;Villaescusa de Roa;99;50;49;2023
09;Burgos;429;Villaescusa la Sombría;54;37;17;2023
09;Burgos;430;Villaespasa;26;16;10;2023
09;Burgos;431;Villafranca Montes de Oca;117;71;46;2023
09;Burgos;432;Villafruela;146;87;59;2023
09;Burgos;433;Villagalijo;56;33;23;2023
09;Burgos;434;Villagonzalo Pedernales;1862;980;882;2023
09;Burgos;437;Villahoz;310;167;143;2023
09;Burgos;438;Villalba de Duero;698;369;329;2023
09;Burgos;439;Villalbilla de Burgos;1495;795;700;2023
09;Burgos;440;Villalbilla de Gumiel;89;57;32;2023
09;Burgos;441;Villaldemiro;90;53;37;2023
09;Burgos;442;Villalmanzo;424;224;200;2023
09;Burgos;443;Villamayor de los Montes;163;81;82;2023
09;Burgos;444;Villamayor de Treviño;59;31;28;2023
09;Burgos;445;Villambistia;45;35;10;2023
09;Burgos;446;Villamedianilla;9;6;3;2023
09;Burgos;447;Villamiel de la Sierra;42;25;17;2023
09;Burgos;448;Villangómez;225;138;87;2023
09;Burgos;449;Villanueva de Argaño;121;70;51;2023
09;Burgos;450;Villanueva de Carazo;27;17;10;2023
09;Burgos;451;Villanueva de Gumiel;284;144;140;2023
09;Burgos;454;Villanueva de Teba;43;28;15;2023
09;Burgos;455;Villaquirán de la Puebla;44;27;17;2023
09;Burgos;456;Villaquirán de los Infantes;148;79;69;2023
09;Burgos;903;Villarcayo de Merindad de Castilla la Vieja;4018;2047;1971;2023
09;Burgos;458;Villariezo;719;393;326;2023
09;Burgos;460;Villasandino;177;99;78;2023
09;Burgos;463;Villasur de Herreros;274;161;113;2023
09;Burgos;464;Villatuelda;53;29;24;2023
09;Burgos;466;Villaverde del Monte;114;67;47;2023
09;Burgos;467;Villaverde-Mogina;74;51;23;2023
09;Burgos;471;Villayerno Morquillas;213;112;101;2023
09;Burgos;472;Villazopeque;52;30;22;2023
09;Burgos;473;Villegas;84;44;40;2023
09;Burgos;476;Villoruebo;69;46;23;2023
09;Burgos;424;Viloria de Rioja;37;23;14;2023
09;Burgos;425;Vilviestre del Pinar;508;284;224;2023
09;Burgos;478;Vizcaínos;47;36;11;2023
09;Burgos;480;Zael;116;58;58;2023
09;Burgos;482;Zarzosa de Río Pisuerga;31;20;11;2023
09;Burgos;483;Zazuar;206;105;101;2023
09;Burgos;485;Zuñeda;57;30;27;2023
10;Cáceres;001;Abadía;338;185;153;2023
10;Cáceres;002;Abertura;377;190;187;2023
10;Cáceres;003;Acebo;582;285;297;2023
10;Cáceres;004;Acehúche;802;406;396;2023
10;Cáceres;005;Aceituna;581;299;282;2023
10;Cáceres;006;Ahigal;1361;680;681;2023
10;Cáceres;903;Alagón del Río;913;450;463;2023
10;Cáceres;007;Albalá;657;342;315;2023
10;Cáceres;008;Alcántara;1348;672;676;2023
10;Cáceres;009;Alcollarín;255;131;124;2023
10;Cáceres;010;Alcuéscar;2459;1277;1182;2023
10;Cáceres;012;Aldea del Cano;606;298;308;2023
10;Cáceres;013;Aldea del Obispo, La;297;160;137;2023
10;Cáceres;011;Aldeacentenera;597;324;273;2023
10;Cáceres;014;Aldeanueva de la Vera;2015;984;1031;2023
10;Cáceres;015;Aldeanueva del Camino;725;361;364;2023
10;Cáceres;016;Aldehuela de Jerte;362;185;177;2023
10;Cáceres;017;Alía;755;389;366;2023
10;Cáceres;018;Aliseda;1710;874;836;2023
10;Cáceres;019;Almaraz;1647;836;811;2023
10;Cáceres;020;Almoharín;1799;892;907;2023
10;Cáceres;021;Arroyo de la Luz;5565;2747;2818;2023
10;Cáceres;023;Arroyomolinos;809;413;396;2023
10;Cáceres;022;Arroyomolinos de la Vera;425;214;211;2023
10;Cáceres;024;Baños de Montemayor;735;341;394;2023
10;Cáceres;025;Barrado;373;193;180;2023
10;Cáceres;026;Belvís de Monroy;721;372;349;2023
10;Cáceres;027;Benquerencia;86;47;39;2023
10;Cáceres;028;Berrocalejo;120;63;57;2023
10;Cáceres;029;Berzocana;396;205;191;2023
10;Cáceres;030;Bohonal de Ibor;488;238;250;2023
10;Cáceres;031;Botija;185;97;88;2023
10;Cáceres;032;Brozas;1734;859;875;2023
10;Cáceres;033;Cabañas del Castillo;400;209;191;2023
10;Cáceres;034;Cabezabellosa;344;176;168;2023
10;Cáceres;035;Cabezuela del Valle;2149;1084;1065;2023
10;Cáceres;036;Cabrero;341;189;152;2023
10;Cáceres;037;Cáceres;96215;45996;50219;2023
10;Cáceres;038;Cachorrilla;92;46;46;2023
10;Cáceres;039;Cadalso;419;212;207;2023
10;Cáceres;040;Calzadilla;459;236;223;2023
10;Cáceres;041;Caminomorisco;1132;596;536;2023
10;Cáceres;042;Campillo de Deleitosa;83;39;44;2023
10;Cáceres;043;Campo Lugar;833;413;420;2023
10;Cáceres;044;Cañamero;1615;848;767;2023
10;Cáceres;045;Cañaveral;1009;506;503;2023
10;Cáceres;046;Carbajo;179;90;89;2023
10;Cáceres;047;Carcaboso;1078;549;529;2023
10;Cáceres;048;Carrascalejo;230;119;111;2023
10;Cáceres;049;Casar de Cáceres;4431;2188;2243;2023
10;Cáceres;050;Casar de Palomero;1017;524;493;2023
10;Cáceres;051;Casares de las Hurdes;404;214;190;2023
10;Cáceres;052;Casas de Don Antonio;191;102;89;2023
10;Cáceres;053;Casas de Don Gómez;321;176;145;2023
10;Cáceres;056;Casas de Millán;549;278;271;2023
10;Cáceres;057;Casas de Miravete;114;75;39;2023
10;Cáceres;054;Casas del Castañar;579;290;289;2023
10;Cáceres;055;Casas del Monte;769;394;375;2023
10;Cáceres;058;Casatejada;1360;711;649;2023
10;Cáceres;059;Casillas de Coria;343;171;172;2023
10;Cáceres;060;Castañar de Ibor;1013;523;490;2023
10;Cáceres;061;Ceclavín;1780;902;878;2023
10;Cáceres;062;Cedillo;433;221;212;2023
10;Cáceres;063;Cerezo;144;70;74;2023
10;Cáceres;064;Cilleros;1562;792;770;2023
10;Cáceres;065;Collado de la Vera;261;136;125;2023
10;Cáceres;066;Conquista de la Sierra;190;111;79;2023
10;Cáceres;067;Coria;12166;5962;6204;2023
10;Cáceres;068;Cuacos de Yuste;833;425;408;2023
10;Cáceres;069;Cumbre, La;840;426;414;2023
10;Cáceres;070;Deleitosa;685;347;338;2023
10;Cáceres;071;Descargamaría;103;58;45;2023
10;Cáceres;072;Eljas;865;442;423;2023
10;Cáceres;073;Escurial;863;457;406;2023
10;Cáceres;075;Fresnedoso de Ibor;241;129;112;2023
10;Cáceres;076;Galisteo;858;424;434;2023
10;Cáceres;077;Garciaz;687;353;334;2023
10;Cáceres;079;Garganta la Olla;898;469;429;2023
10;Cáceres;078;Garganta, La;353;186;167;2023
10;Cáceres;080;Gargantilla;371;192;179;2023
10;Cáceres;081;Gargüera;176;93;83;2023
10;Cáceres;082;Garrovillas de Alconétar;1974;964;1010;2023
10;Cáceres;083;Garvín;99;55;44;2023
10;Cáceres;084;Gata;1372;700;672;2023
10;Cáceres;085;Gordo, El;364;196;168;2023
10;Cáceres;086;Granja, La;316;164;152;2023
10;Cáceres;087;Guadalupe;1787;888;899;2023
10;Cáceres;088;Guijo de Coria;195;107;88;2023
10;Cáceres;089;Guijo de Galisteo;1509;758;751;2023
10;Cáceres;090;Guijo de Granadilla;493;257;236;2023
10;Cáceres;091;Guijo de Santa Bárbara;378;201;177;2023
10;Cáceres;092;Herguijuela;266;140;126;2023
10;Cáceres;093;Hernán-Pérez;416;205;211;2023
10;Cáceres;094;Herrera de Alcántara;228;126;102;2023
10;Cáceres;095;Herreruela;321;165;156;2023
10;Cáceres;096;Hervás;3907;1916;1991;2023
10;Cáceres;097;Higuera de Albalat;105;59;46;2023
10;Cáceres;098;Hinojal;391;197;194;2023
10;Cáceres;099;Holguera;607;303;304;2023
10;Cáceres;100;Hoyos;851;422;429;2023
10;Cáceres;101;Huélaga;210;101;109;2023
10;Cáceres;102;Ibahernando;531;266;265;2023
10;Cáceres;103;Jaraicejo;444;213;231;2023
10;Cáceres;104;Jaraíz de la Vera;6664;3349;3315;2023
10;Cáceres;105;Jarandilla de la Vera;2845;1407;1438;2023
10;Cáceres;106;Jarilla;139;72;67;2023
10;Cáceres;107;Jerte;1238;616;622;2023
10;Cáceres;108;Ladrillar;191;113;78;2023
10;Cáceres;109;Logrosán;1913;983;930;2023
10;Cáceres;110;Losar de la Vera;2718;1367;1351;2023
10;Cáceres;111;Madrigal de la Vera;1542;809;733;2023
10;Cáceres;112;Madrigalejo;1712;861;851;2023
10;Cáceres;113;Madroñera;2357;1177;1180;2023
10;Cáceres;114;Majadas;1293;649;644;2023
10;Cáceres;115;Malpartida de Cáceres;4086;2040;2046;2023
10;Cáceres;116;Malpartida de Plasencia;4618;2282;2336;2023
10;Cáceres;117;Marchagaz;241;132;109;2023
10;Cáceres;118;Mata de Alcántara;284;146;138;2023
10;Cáceres;119;Membrío;572;284;288;2023
10;Cáceres;120;Mesas de Ibor;150;76;74;2023
10;Cáceres;121;Miajadas;9359;4653;4706;2023
10;Cáceres;122;Millanes;233;119;114;2023
10;Cáceres;123;Mirabel;650;328;322;2023
10;Cáceres;124;Mohedas de Granadilla;834;417;417;2023
10;Cáceres;125;Monroy;899;465;434;2023
10;Cáceres;126;Montánchez;1598;801;797;2023
10;Cáceres;127;Montehermoso;5619;2860;2759;2023
10;Cáceres;128;Moraleja;6585;3268;3317;2023
10;Cáceres;129;Morcillo;358;172;186;2023
10;Cáceres;130;Navaconcejo;2065;1043;1022;2023
10;Cáceres;131;Navalmoral de la Mata;16895;8162;8733;2023
10;Cáceres;132;Navalvillar de Ibor;383;196;187;2023
10;Cáceres;133;Navas del Madroño;1243;612;631;2023
10;Cáceres;134;Navezuelas;648;333;315;2023
10;Cáceres;135;Nuñomoral;1225;660;565;2023
10;Cáceres;136;Oliva de Plasencia;299;173;126;2023
10;Cáceres;137;Palomero;406;212;194;2023
10;Cáceres;138;Pasarón de la Vera;580;282;298;2023
10;Cáceres;139;Pedroso de Acim;90;52;38;2023
10;Cáceres;140;Peraleda de la Mata;1409;706;703;2023
10;Cáceres;141;Peraleda de San Román;298;173;125;2023
10;Cáceres;142;Perales del Puerto;911;461;450;2023
10;Cáceres;143;Pescueza;137;60;77;2023
10;Cáceres;144;Pesga, La;976;508;468;2023
10;Cáceres;145;Piedras Albas;130;63;67;2023
10;Cáceres;146;Pinofranqueado;1749;918;831;2023
10;Cáceres;147;Piornal;1470;751;719;2023
10;Cáceres;148;Plasencia;39412;18898;20514;2023
10;Cáceres;149;Plasenzuela;498;240;258;2023
10;Cáceres;150;Portaje;373;183;190;2023
10;Cáceres;151;Portezuelo;216;115;101;2023
10;Cáceres;152;Pozuelo de Zarzón;444;221;223;2023
10;Cáceres;905;Pueblonuevo de Miramontes;782;385;397;2023
10;Cáceres;153;Puerto de Santa Cruz;267;137;130;2023
10;Cáceres;154;Rebollar;200;105;95;2023
10;Cáceres;155;Riolobos;1190;582;608;2023
10;Cáceres;156;Robledillo de Gata;86;50;36;2023
10;Cáceres;157;Robledillo de la Vera;263;133;130;2023
10;Cáceres;158;Robledillo de Trujillo;356;183;173;2023
10;Cáceres;159;Robledollano;312;172;140;2023
10;Cáceres;160;Romangordo;246;119;127;2023
10;Cáceres;901;Rosalejo;1326;680;646;2023
10;Cáceres;161;Ruanes;75;42;33;2023
10;Cáceres;162;Salorino;538;282;256;2023
10;Cáceres;163;Salvatierra de Santiago;257;132;125;2023
10;Cáceres;164;San Martín de Trevejo;723;350;373;2023
10;Cáceres;165;Santa Ana;301;153;148;2023
10;Cáceres;166;Santa Cruz de la Sierra;319;163;156;2023
10;Cáceres;167;Santa Cruz de Paniagua;280;159;121;2023
10;Cáceres;168;Santa Marta de Magasca;284;146;138;2023
10;Cáceres;169;Santiago de Alcántara;475;230;245;2023
10;Cáceres;170;Santiago del Campo;245;124;121;2023
10;Cáceres;171;Santibáñez el Alto;361;192;169;2023
10;Cáceres;172;Santibáñez el Bajo;713;372;341;2023
10;Cáceres;173;Saucedilla;947;495;452;2023
10;Cáceres;174;Segura de Toro;181;96;85;2023
10;Cáceres;175;Serradilla;1493;749;744;2023
10;Cáceres;176;Serrejón;405;206;199;2023
10;Cáceres;177;Sierra de Fuentes;2020;1036;984;2023
10;Cáceres;178;Talaván;776;404;372;2023
10;Cáceres;179;Talaveruela de la Vera;302;155;147;2023
10;Cáceres;180;Talayuela;7273;3852;3421;2023
10;Cáceres;181;Tejeda de Tiétar;763;402;361;2023
10;Cáceres;904;Tiétar;844;456;388;2023
10;Cáceres;182;Toril;164;103;61;2023
10;Cáceres;183;Tornavacas;985;522;463;2023
10;Cáceres;184;Torno, El;838;438;400;2023
10;Cáceres;187;Torre de Don Miguel;483;250;233;2023
10;Cáceres;188;Torre de Santa María;529;263;266;2023
10;Cáceres;185;Torrecilla de los Ángeles;662;345;317;2023
10;Cáceres;186;Torrecillas de la Tiesa;1050;533;517;2023
10;Cáceres;190;Torrejón el Rubio;519;263;256;2023
10;Cáceres;189;Torrejoncillo;2819;1369;1450;2023
10;Cáceres;191;Torremenga;611;316;295;2023
10;Cáceres;192;Torremocha;739;375;364;2023
10;Cáceres;193;Torreorgaz;1682;839;843;2023
10;Cáceres;194;Torrequemada;567;278;289;2023
10;Cáceres;195;Trujillo;8605;4192;4413;2023
10;Cáceres;196;Valdastillas;311;158;153;2023
10;Cáceres;197;Valdecañas de Tajo;109;56;53;2023
10;Cáceres;198;Valdefuentes;1104;531;573;2023
10;Cáceres;199;Valdehúncar;194;105;89;2023
10;Cáceres;200;Valdelacasa de Tajo;339;178;161;2023
10;Cáceres;201;Valdemorales;215;106;109;2023
10;Cáceres;202;Valdeobispo;636;313;323;2023
10;Cáceres;203;Valencia de Alcántara;5236;2571;2665;2023
10;Cáceres;204;Valverde de la Vera;467;232;235;2023
10;Cáceres;205;Valverde del Fresno;2106;1061;1045;2023
10;Cáceres;902;Vegaviana;848;436;412;2023
10;Cáceres;206;Viandar de la Vera;225;115;110;2023
10;Cáceres;207;Villa del Campo;438;212;226;2023
10;Cáceres;208;Villa del Rey;116;58;58;2023
10;Cáceres;209;Villamesías;276;142;134;2023
10;Cáceres;210;Villamiel;379;190;189;2023
10;Cáceres;211;Villanueva de la Sierra;496;252;244;2023
10;Cáceres;212;Villanueva de la Vera;2087;1046;1041;2023
10;Cáceres;214;Villar de Plasencia;230;120;110;2023
10;Cáceres;213;Villar del Pedroso;548;279;269;2023
10;Cáceres;215;Villasbuenas de Gata;383;188;195;2023
10;Cáceres;216;Zarza de Granadilla;1799;916;883;2023
10;Cáceres;217;Zarza de Montánchez;515;265;250;2023
10;Cáceres;218;Zarza la Mayor;1134;568;566;2023
10;Cáceres;219;Zorita;1267;626;641;2023
11;Cádiz;001;Alcalá de los Gazules;5205;2672;2533;2023
11;Cádiz;002;Alcalá del Valle;4995;2497;2498;2023
11;Cádiz;003;Algar;1444;739;705;2023
11;Cádiz;004;Algeciras;123639;60849;62790;2023
11;Cádiz;005;Algodonales;5498;2780;2718;2023
11;Cádiz;006;Arcos de la Frontera;30953;15432;15521;2023
11;Cádiz;007;Barbate;22811;11374;11437;2023
11;Cádiz;008;Barrios, Los;24219;12137;12082;2023
11;Cádiz;901;Benalup-Casas Viejas;7164;3636;3528;2023
11;Cádiz;009;Benaocaz;714;386;328;2023
11;Cádiz;010;Bornos;7559;3771;3788;2023
11;Cádiz;011;Bosque, El;2224;1117;1107;2023
11;Cádiz;012;Cádiz;111811;52724;59087;2023
11;Cádiz;013;Castellar de la Frontera;3020;1490;1530;2023
11;Cádiz;015;Chiclana de la Frontera;88709;44267;44442;2023
11;Cádiz;016;Chipiona;19649;9813;9836;2023
11;Cádiz;014;Conil de la Frontera;23661;11852;11809;2023
11;Cádiz;017;Espera;3802;1897;1905;2023
11;Cádiz;018;Gastor, El;1697;864;833;2023
11;Cádiz;019;Grazalema;2002;992;1010;2023
11;Cádiz;020;Jerez de la Frontera;213231;104044;109187;2023
11;Cádiz;021;Jimena de la Frontera;6675;3396;3279;2023
11;Cádiz;022;Línea de la Concepción, La;63773;31283;32490;2023
11;Cádiz;023;Medina Sidonia;11738;5905;5833;2023
11;Cádiz;024;Olvera;7887;3881;4006;2023
11;Cádiz;025;Paterna de Rivera;5441;2816;2625;2023
11;Cádiz;026;Prado del Rey;5634;2763;2871;2023
11;Cádiz;027;Puerto de Santa María, El;89813;43850;45963;2023
11;Cádiz;028;Puerto Real;42069;21131;20938;2023
11;Cádiz;029;Puerto Serrano;6929;3516;3413;2023
11;Cádiz;030;Rota;29675;14714;14961;2023
11;Cádiz;031;San Fernando;93927;45720;48207;2023
11;Cádiz;902;San José del Valle;4486;2277;2209;2023
11;Cádiz;903;San Martín del Tesorillo;2742;1414;1328;2023
11;Cádiz;033;San Roque;33646;16742;16904;2023
11;Cádiz;032;Sanlúcar de Barrameda;69805;34770;35035;2023
11;Cádiz;034;Setenil de las Bodegas;2638;1365;1273;2023
11;Cádiz;035;Tarifa;18621;9323;9298;2023
11;Cádiz;036;Torre Alháquime;799;404;395;2023
11;Cádiz;037;Trebujena;7000;3476;3524;2023
11;Cádiz;038;Ubrique;16363;8056;8307;2023
11;Cádiz;039;Vejer de la Frontera;12864;6408;6456;2023
11;Cádiz;040;Villaluenga del Rosario;480;241;239;2023
11;Cádiz;041;Villamartín;12165;6126;6039;2023
11;Cádiz;042;Zahara;1362;688;674;2023
39;Cantabria;001;Alfoz de Lloredo;2471;1276;1195;2023
39;Cantabria;002;Ampuero;4455;2230;2225;2023
39;Cantabria;003;Anievas;268;146;122;2023
39;Cantabria;004;Arenas de Iguña;1742;880;862;2023
39;Cantabria;005;Argoños;1860;945;915;2023
39;Cantabria;006;Arnuero;2255;1135;1120;2023
39;Cantabria;007;Arredondo;478;270;208;2023
39;Cantabria;008;Astillero, El;18220;8878;9342;2023
39;Cantabria;009;Bárcena de Cicero;4653;2382;2271;2023
39;Cantabria;010;Bárcena de Pie de Concha;674;343;331;2023
39;Cantabria;011;Bareyo;2144;1067;1077;2023
39;Cantabria;012;Cabezón de la Sal;8181;3909;4272;2023
39;Cantabria;013;Cabezón de Liébana;565;320;245;2023
39;Cantabria;014;Cabuérniga;995;518;477;2023
39;Cantabria;015;Camaleño;963;536;427;2023
39;Cantabria;016;Camargo;30349;14817;15532;2023
39;Cantabria;027;Campoo de Enmedio;3763;1923;1840;2023
39;Cantabria;017;Campoo de Yuso;680;359;321;2023
39;Cantabria;018;Cartes;5800;2890;2910;2023
39;Cantabria;019;Castañeda;3160;1605;1555;2023
39;Cantabria;020;Castro-Urdiales;33225;16407;16818;2023
39;Cantabria;021;Cieza;552;281;271;2023
39;Cantabria;022;Cillorigo de Liébana;1344;708;636;2023
39;Cantabria;023;Colindres;8549;4185;4364;2023
39;Cantabria;024;Comillas;2135;1012;1123;2023
39;Cantabria;025;Corrales de Buelna, Los;10785;5267;5518;2023
39;Cantabria;026;Corvera de Toranzo;2096;1052;1044;2023
39;Cantabria;028;Entrambasaguas;5568;2778;2790;2023
39;Cantabria;029;Escalante;749;382;367;2023
39;Cantabria;030;Guriezo;2438;1271;1167;2023
39;Cantabria;031;Hazas de Cesto;1782;879;903;2023
39;Cantabria;032;Hermandad de Campoo de Suso;1588;874;714;2023
39;Cantabria;033;Herrerías;600;339;261;2023
39;Cantabria;034;Lamasón;257;161;96;2023
39;Cantabria;035;Laredo;10849;5158;5691;2023
39;Cantabria;036;Liendo;1242;639;603;2023
39;Cantabria;037;Liérganes;2397;1192;1205;2023
39;Cantabria;038;Limpias;1975;985;990;2023
39;Cantabria;039;Luena;622;337;285;2023
39;Cantabria;040;Marina de Cudeyo;5148;2562;2586;2023
39;Cantabria;041;Mazcuerras;2083;1065;1018;2023
39;Cantabria;042;Medio Cudeyo;7696;3699;3997;2023
39;Cantabria;043;Meruelo;2230;1100;1130;2023
39;Cantabria;044;Miengo;5199;2678;2521;2023
39;Cantabria;045;Miera;393;206;187;2023
39;Cantabria;046;Molledo;1476;724;752;2023
39;Cantabria;047;Noja;2741;1359;1382;2023
39;Cantabria;048;Penagos;2244;1133;1111;2023
39;Cantabria;049;Peñarrubia;316;164;152;2023
39;Cantabria;050;Pesaguero;282;158;124;2023
39;Cantabria;051;Pesquera;70;44;26;2023
39;Cantabria;052;Piélagos;26605;13175;13430;2023
39;Cantabria;053;Polaciones;210;134;76;2023
39;Cantabria;054;Polanco;6175;3059;3116;2023
39;Cantabria;055;Potes;1336;619;717;2023
39;Cantabria;056;Puente Viesgo;2884;1470;1414;2023
39;Cantabria;057;Ramales de la Victoria;3027;1516;1511;2023
39;Cantabria;058;Rasines;975;502;473;2023
39;Cantabria;059;Reinosa;8570;4021;4549;2023
39;Cantabria;060;Reocín;8422;4148;4274;2023
39;Cantabria;061;Ribamontán al Mar;4636;2369;2267;2023
39;Cantabria;062;Ribamontán al Monte;2498;1261;1237;2023
39;Cantabria;063;Rionansa;1034;575;459;2023
39;Cantabria;064;Riotuerto;1666;806;860;2023
39;Cantabria;065;Rozas de Valdearroyo, Las;262;145;117;2023
39;Cantabria;066;Ruente;1052;573;479;2023
39;Cantabria;067;Ruesga;809;446;363;2023
39;Cantabria;068;Ruiloba;778;401;377;2023
39;Cantabria;069;San Felices de Buelna;2390;1199;1191;2023
39;Cantabria;070;San Miguel de Aguayo;178;91;87;2023
39;Cantabria;071;San Pedro del Romeral;445;243;202;2023
39;Cantabria;072;San Roque de Riomiera;351;208;143;2023
39;Cantabria;080;San Vicente de la Barquera;4038;1963;2075;2023
39;Cantabria;073;Santa Cruz de Bezana;13689;6704;6985;2023
39;Cantabria;074;Santa María de Cayón;9316;4631;4685;2023
39;Cantabria;075;Santander;172726;79525;93201;2023
39;Cantabria;076;Santillana del Mar;4245;2064;2181;2023
39;Cantabria;077;Santiurde de Reinosa;247;142;105;2023
39;Cantabria;078;Santiurde de Toranzo;1732;910;822;2023
39;Cantabria;079;Santoña;10892;5291;5601;2023
39;Cantabria;081;Saro;518;271;247;2023
39;Cantabria;082;Selaya;1845;939;906;2023
39;Cantabria;083;Soba;1108;623;485;2023
39;Cantabria;084;Solórzano;1080;575;505;2023
39;Cantabria;085;Suances;9091;4454;4637;2023
39;Cantabria;086;Tojos, Los;380;227;153;2023
39;Cantabria;087;Torrelavega;51361;24196;27165;2023
39;Cantabria;088;Tresviso;58;38;20;2023
39;Cantabria;089;Tudanca;155;105;50;2023
39;Cantabria;090;Udías;945;473;472;2023
39;Cantabria;095;Val de San Vicente;2783;1416;1367;2023
39;Cantabria;091;Valdáliga;2167;1117;1050;2023
39;Cantabria;092;Valdeolea;882;480;402;2023
39;Cantabria;093;Valdeprado del Río;331;189;142;2023
39;Cantabria;094;Valderredible;954;545;409;2023
39;Cantabria;101;Valle de Villaverde;254;144;110;2023
39;Cantabria;096;Vega de Liébana;702;373;329;2023
39;Cantabria;097;Vega de Pas;741;398;343;2023
39;Cantabria;098;Villacarriedo;1674;866;808;2023
39;Cantabria;099;Villaescusa;3949;1960;1989;2023
39;Cantabria;100;Villafufre;999;518;481;2023
39;Cantabria;102;Voto;2947;1554;1393;2023
12;Castellón/Castelló;002;Aín;130;71;59;2023
12;Castellón/Castelló;003;Albocàsser;1302;655;647;2023
12;Castellón/Castelló;004;Alcalà de Xivert;7160;3620;3540;2023
12;Castellón/Castelló;005;Alcora, l';10526;5268;5258;2023
12;Castellón/Castelló;006;Alcudia de Veo;203;109;94;2023
12;Castellón/Castelló;007;Alfondeguilla;873;434;439;2023
12;Castellón/Castelló;008;Algimia de Almonacid;249;137;112;2023
12;Castellón/Castelló;009;Almassora;27989;14011;13978;2023
12;Castellón/Castelló;010;Almedíjar;280;155;125;2023
12;Castellón/Castelló;011;Almenara;6591;3302;3289;2023
12;Castellón/Castelló;901;Alqueries, les/Alquerías del Niño Perdido;4539;2281;2258;2023
12;Castellón/Castelló;012;Altura;3695;1912;1783;2023
12;Castellón/Castelló;013;Arañuel;165;91;74;2023
12;Castellón/Castelló;014;Ares del Maestrat;174;104;70;2023
12;Castellón/Castelló;015;Argelita;156;84;72;2023
12;Castellón/Castelló;016;Artana;1980;1010;970;2023
12;Castellón/Castelló;001;Atzeneta del Maestrat;1319;671;648;2023
12;Castellón/Castelló;017;Ayódar;178;96;82;2023
12;Castellón/Castelló;018;Azuébar;336;183;153;2023
12;Castellón/Castelló;020;Barracas;198;103;95;2023
12;Castellón/Castelló;022;Bejís;409;241;168;2023
12;Castellón/Castelló;024;Benafer;164;82;82;2023
12;Castellón/Castelló;025;Benafigos;135;78;57;2023
12;Castellón/Castelló;026;Benassal;1026;527;499;2023
12;Castellón/Castelló;027;Benicarló;28681;14432;14249;2023
12;Castellón/Castelló;028;Benicàssim/Benicasim;19951;9808;10143;2023
12;Castellón/Castelló;029;Benlloc;1108;562;546;2023
12;Castellón/Castelló;021;Betxí;5580;2760;2820;2023
12;Castellón/Castelló;032;Borriana/Burriana;35750;17769;17981;2023
12;Castellón/Castelló;031;Borriol;5865;3004;2861;2023
12;Castellón/Castelló;033;Cabanes;3222;1651;1571;2023
12;Castellón/Castelló;034;Càlig;2013;1013;1000;2023
12;Castellón/Castelló;036;Canet lo Roig;685;352;333;2023
12;Castellón/Castelló;037;Castell de Cabres;19;11;8;2023
12;Castellón/Castelló;038;Castellfort;188;98;90;2023
12;Castellón/Castelló;039;Castellnovo;888;456;432;2023
12;Castellón/Castelló;040;Castelló de la Plana;176238;85021;91217;2023
12;Castellón/Castelló;041;Castillo de Villamalefa;109;72;37;2023
12;Castellón/Castelló;042;Catí;724;361;363;2023
12;Castellón/Castelló;043;Caudiel;716;358;358;2023
12;Castellón/Castelló;044;Cervera del Maestre;656;317;339;2023
12;Castellón/Castelló;053;Chilches/Xilxes;2981;1531;1450;2023
12;Castellón/Castelló;056;Chóvar;310;161;149;2023
12;Castellón/Castelló;045;Cinctorres;427;207;220;2023
12;Castellón/Castelló;046;Cirat;223;127;96;2023
12;Castellón/Castelló;048;Cortes de Arenoso;304;156;148;2023
12;Castellón/Castelló;049;Costur;535;282;253;2023
12;Castellón/Castelló;050;Coves de Vinromà, les;1831;934;897;2023
12;Castellón/Castelló;051;Culla;480;247;233;2023
12;Castellón/Castelló;057;Eslida;758;383;375;2023
12;Castellón/Castelló;058;Espadilla;90;50;40;2023
12;Castellón/Castelló;059;Fanzara;294;154;140;2023
12;Castellón/Castelló;060;Figueroles;518;258;260;2023
12;Castellón/Castelló;061;Forcall;473;227;246;2023
12;Castellón/Castelló;063;Fuente la Reina;59;31;28;2023
12;Castellón/Castelló;064;Fuentes de Ayódar;98;55;43;2023
12;Castellón/Castelló;065;Gaibiel;197;109;88;2023
12;Castellón/Castelló;067;Geldo;650;325;325;2023
12;Castellón/Castelló;068;Herbers;62;39;23;2023
12;Castellón/Castelló;069;Higueras;50;24;26;2023
12;Castellón/Castelló;070;Jana, la;678;348;330;2023
12;Castellón/Castelló;071;Jérica;1794;895;899;2023
12;Castellón/Castelló;074;Llosa, la;1003;489;514;2023
12;Castellón/Castelló;072;Llucena/Lucena del Cid;1369;683;686;2023
12;Castellón/Castelló;073;Ludiente;155;88;67;2023
12;Castellón/Castelló;075;Mata de Morella, la;179;96;83;2023
12;Castellón/Castelló;076;Matet;84;52;32;2023
12;Castellón/Castelló;077;Moncofa;7747;3946;3801;2023
12;Castellón/Castelló;078;Montán;399;199;200;2023
12;Castellón/Castelló;079;Montanejos;603;313;290;2023
12;Castellón/Castelló;080;Morella;2492;1223;1269;2023
12;Castellón/Castelló;081;Navajas;840;431;409;2023
12;Castellón/Castelló;082;Nules;13827;6938;6889;2023
12;Castellón/Castelló;083;Olocau del Rey;126;66;60;2023
12;Castellón/Castelló;084;Onda;25547;12795;12752;2023
12;Castellón/Castelló;085;Orpesa/Oropesa del Mar;10958;5596;5362;2023
12;Castellón/Castelló;087;Palanques;36;21;15;2023
12;Castellón/Castelló;088;Pavías;74;45;29;2023
12;Castellón/Castelló;089;Peníscola/Peñíscola;8449;4303;4146;2023
12;Castellón/Castelló;090;Pina de Montalgrao;119;65;54;2023
12;Castellón/Castelló;093;Pobla de Benifassà, la;235;135;100;2023
12;Castellón/Castelló;094;Pobla Tornesa, la;1309;670;639;2023
12;Castellón/Castelló;091;Portell de Morella;166;85;81;2023
12;Castellón/Castelló;092;Puebla de Arenoso;169;95;74;2023
12;Castellón/Castelló;095;Ribesalbes;1135;584;551;2023
12;Castellón/Castelló;096;Rossell;891;467;424;2023
12;Castellón/Castelló;097;Sacañet;86;53;33;2023
12;Castellón/Castelló;098;Salzadella, la;660;346;314;2023
12;Castellón/Castelló;101;San Rafael del Río;494;246;248;2023
12;Castellón/Castelló;902;Sant Joan de Moró;3516;1803;1713;2023
12;Castellón/Castelló;099;Sant Jordi/San Jorge;1249;654;595;2023
12;Castellón/Castelló;100;Sant Mateu;1987;979;1008;2023
12;Castellón/Castelló;102;Santa Magdalena de Pulpis;784;411;373;2023
12;Castellón/Castelló;104;Segorbe;9425;4648;4777;2023
12;Castellón/Castelló;103;Serratella, la;110;51;59;2023
12;Castellón/Castelló;105;Sierra Engarcerán;1045;549;496;2023
12;Castellón/Castelló;106;Soneja;1508;744;764;2023
12;Castellón/Castelló;107;Sot de Ferrer;474;256;218;2023
12;Castellón/Castelló;108;Suera/Sueras;572;296;276;2023
12;Castellón/Castelló;109;Tales;852;435;417;2023
12;Castellón/Castelló;110;Teresa;250;137;113;2023
12;Castellón/Castelló;111;Tírig;430;217;213;2023
12;Castellón/Castelló;112;Todolella;144;86;58;2023
12;Castellón/Castelló;113;Toga;112;60;52;2023
12;Castellón/Castelló;114;Torás;256;137;119;2023
12;Castellón/Castelló;115;Toro, El;248;128;120;2023
12;Castellón/Castelló;116;Torralba del Pinar;69;34;35;2023
12;Castellón/Castelló;119;Torre d'en Besora, la;164;88;76;2023
12;Castellón/Castelló;120;Torre d'en Doménec, la;175;94;81;2023
12;Castellón/Castelló;117;Torreblanca;5630;2862;2768;2023
12;Castellón/Castelló;118;Torrechiva;114;58;56;2023
12;Castellón/Castelló;121;Traiguera;1336;681;655;2023
12;Castellón/Castelló;122;Useres, les/Useras;985;511;474;2023
12;Castellón/Castelló;124;Vall d'Alba;3054;1596;1458;2023
12;Castellón/Castelló;125;Vall de Almonacid;286;149;137;2023
12;Castellón/Castelló;126;Vall d'Uixó, la;31611;15488;16123;2023
12;Castellón/Castelló;123;Vallat;66;31;35;2023
12;Castellón/Castelló;127;Vallibona;62;38;24;2023
12;Castellón/Castelló;128;Vilafamés;1915;1026;889;2023
12;Castellón/Castelló;129;Vilafranca/Villafranca del Cid;2148;1089;1059;2023
12;Castellón/Castelló;132;Vilanova d'Alcolea;575;304;271;2023
12;Castellón/Castelló;134;Vilar de Canes;159;79;80;2023
12;Castellón/Castelló;135;Vila-real;51852;25739;26113;2023
12;Castellón/Castelló;136;Vilavella, la;3074;1526;1548;2023
12;Castellón/Castelló;130;Villahermosa del Río;488;265;223;2023
12;Castellón/Castelló;131;Villamalur;95;58;37;2023
12;Castellón/Castelló;133;Villanueva de Viver;110;61;49;2023
12;Castellón/Castelló;137;Villores;54;26;28;2023
12;Castellón/Castelló;138;Vinaròs;29686;14598;15088;2023
12;Castellón/Castelló;139;Vistabella del Maestrat;369;197;172;2023
12;Castellón/Castelló;140;Viver;1683;873;810;2023
12;Castellón/Castelló;052;Xert;686;342;344;2023
12;Castellón/Castelló;055;Xodos/Chodos;117;72;45;2023
12;Castellón/Castelló;141;Zorita del Maestrazgo;117;58;59;2023
12;Castellón/Castelló;142;Zucaina;176;98;78;2023
51;Ceuta;001;Ceuta;83039;41894;41145;2023
13;Ciudad Real;001;Abenójar;1328;686;642;2023
13;Ciudad Real;002;Agudo;1611;813;798;2023
13;Ciudad Real;003;Alamillo;469;241;228;2023
13;Ciudad Real;004;Albaladejo;1046;551;495;2023
13;Ciudad Real;005;Alcázar de San Juan;30928;15036;15892;2023
13;Ciudad Real;006;Alcoba;551;279;272;2023
13;Ciudad Real;007;Alcolea de Calatrava;1382;697;685;2023
13;Ciudad Real;008;Alcubillas;445;220;225;2023
13;Ciudad Real;009;Aldea del Rey;1573;787;786;2023
13;Ciudad Real;010;Alhambra;967;491;476;2023
13;Ciudad Real;011;Almadén;4968;2405;2563;2023
13;Ciudad Real;012;Almadenejos;397;203;194;2023
13;Ciudad Real;013;Almagro;8958;4433;4525;2023
13;Ciudad Real;014;Almedina;485;262;223;2023
13;Ciudad Real;015;Almodóvar del Campo;5788;2907;2881;2023
13;Ciudad Real;016;Almuradiel;746;374;372;2023
13;Ciudad Real;017;Anchuras;268;142;126;2023
13;Ciudad Real;903;Arenales de San Gregorio;597;313;284;2023
13;Ciudad Real;018;Arenas de San Juan;1022;521;501;2023
13;Ciudad Real;019;Argamasilla de Alba;6888;3468;3420;2023
13;Ciudad Real;020;Argamasilla de Calatrava;5801;2904;2897;2023
13;Ciudad Real;021;Arroba de los Montes;415;224;191;2023
13;Ciudad Real;022;Ballesteros de Calatrava;371;189;182;2023
13;Ciudad Real;023;Bolaños de Calatrava;11991;6187;5804;2023
13;Ciudad Real;024;Brazatortas;1007;535;472;2023
13;Ciudad Real;025;Cabezarados;303;164;139;2023
13;Ciudad Real;026;Cabezarrubias del Puerto;494;257;237;2023
13;Ciudad Real;027;Calzada de Calatrava;3779;1892;1887;2023
13;Ciudad Real;028;Campo de Criptana;12960;6499;6461;2023
13;Ciudad Real;029;Cañada de Calatrava;101;59;42;2023
13;Ciudad Real;030;Caracuel de Calatrava;137;82;55;2023
13;Ciudad Real;031;Carrión de Calatrava;3184;1617;1567;2023
13;Ciudad Real;032;Carrizosa;1137;569;568;2023
13;Ciudad Real;033;Castellar de Santiago;1803;917;886;2023
13;Ciudad Real;038;Chillón;1772;851;921;2023
13;Ciudad Real;034;Ciudad Real;75303;35660;39643;2023
13;Ciudad Real;035;Corral de Calatrava;1113;541;572;2023
13;Ciudad Real;036;Cortijos, Los;857;457;400;2023
13;Ciudad Real;037;Cózar;933;482;451;2023
13;Ciudad Real;039;Daimiel;17629;8871;8758;2023
13;Ciudad Real;040;Fernán Caballero;984;495;489;2023
13;Ciudad Real;041;Fontanarejo;237;134;103;2023
13;Ciudad Real;042;Fuencaliente;1008;529;479;2023
13;Ciudad Real;043;Fuenllana;204;111;93;2023
13;Ciudad Real;044;Fuente el Fresno;3072;1584;1488;2023
13;Ciudad Real;045;Granátula de Calatrava;696;340;356;2023
13;Ciudad Real;046;Guadalmez;715;349;366;2023
13;Ciudad Real;047;Herencia;8385;4270;4115;2023
13;Ciudad Real;048;Hinojosas de Calatrava;497;259;238;2023
13;Ciudad Real;049;Horcajo de los Montes;789;405;384;2023
13;Ciudad Real;050;Labores, Las;546;291;255;2023
13;Ciudad Real;904;Llanos del Caudillo;681;332;349;2023
13;Ciudad Real;051;Luciana;371;197;174;2023
13;Ciudad Real;052;Malagón;7745;3859;3886;2023
13;Ciudad Real;053;Manzanares;17732;8806;8926;2023
13;Ciudad Real;054;Membrilla;5825;2906;2919;2023
13;Ciudad Real;055;Mestanza;663;347;316;2023
13;Ciudad Real;056;Miguelturra;15769;7934;7835;2023
13;Ciudad Real;057;Montiel;1225;642;583;2023
13;Ciudad Real;058;Moral de Calatrava;5109;2581;2528;2023
13;Ciudad Real;059;Navalpino;207;106;101;2023
13;Ciudad Real;060;Navas de Estena;286;151;135;2023
13;Ciudad Real;061;Pedro Muñoz;7480;3796;3684;2023
13;Ciudad Real;062;Picón;679;355;324;2023
13;Ciudad Real;063;Piedrabuena;4352;2213;2139;2023
13;Ciudad Real;064;Poblete;2863;1458;1405;2023
13;Ciudad Real;065;Porzuna;3509;1817;1692;2023
13;Ciudad Real;066;Pozuelo de Calatrava;3709;1902;1807;2023
13;Ciudad Real;067;Pozuelos de Calatrava, Los;368;188;180;2023
13;Ciudad Real;068;Puebla de Don Rodrigo;1108;615;493;2023
13;Ciudad Real;069;Puebla del Príncipe;658;345;313;2023
13;Ciudad Real;070;Puerto Lápice;883;438;445;2023
13;Ciudad Real;071;Puertollano;45127;21706;23421;2023
13;Ciudad Real;072;Retuerta del Bullaque;880;482;398;2023
13;Ciudad Real;901;Robledo, El;1061;559;502;2023
13;Ciudad Real;902;Ruidera;540;265;275;2023
13;Ciudad Real;073;Saceruela;530;277;253;2023
13;Ciudad Real;074;San Carlos del Valle;1082;556;526;2023
13;Ciudad Real;075;San Lorenzo de Calatrava;199;110;89;2023
13;Ciudad Real;076;Santa Cruz de los Cáñamos;491;234;257;2023
13;Ciudad Real;077;Santa Cruz de Mudela;3872;1931;1941;2023
13;Ciudad Real;078;Socuéllamos;12123;6118;6005;2023
13;Ciudad Real;080;Solana del Pino;329;171;158;2023
13;Ciudad Real;079;Solana, La;15242;7787;7455;2023
13;Ciudad Real;081;Terrinches;600;313;287;2023
13;Ciudad Real;082;Tomelloso;36304;18142;18162;2023
13;Ciudad Real;083;Torralba de Calatrava;3057;1517;1540;2023
13;Ciudad Real;084;Torre de Juan Abad;970;477;493;2023
13;Ciudad Real;085;Torrenueva;2651;1335;1316;2023
13;Ciudad Real;086;Valdemanco del Esteras;161;87;74;2023
13;Ciudad Real;087;Valdepeñas;30411;14806;15605;2023
13;Ciudad Real;088;Valenzuela de Calatrava;654;309;345;2023
13;Ciudad Real;089;Villahermosa;1718;845;873;2023
13;Ciudad Real;090;Villamanrique;1084;530;554;2023
13;Ciudad Real;091;Villamayor de Calatrava;638;321;317;2023
13;Ciudad Real;092;Villanueva de la Fuente;1923;990;933;2023
13;Ciudad Real;093;Villanueva de los Infantes;4775;2385;2390;2023
13;Ciudad Real;094;Villanueva de San Carlos;277;143;134;2023
13;Ciudad Real;095;Villar del Pozo;54;31;23;2023
13;Ciudad Real;096;Villarrubia de los Ojos;9667;4847;4820;2023
13;Ciudad Real;097;Villarta de San Juan;2710;1364;1346;2023
13;Ciudad Real;098;Viso del Marqués;2135;1039;1096;2023
14;Córdoba;001;Adamuz;4092;2082;2010;2023
14;Córdoba;002;Aguilar de la Frontera;13282;6602;6680;2023
14;Córdoba;003;Alcaracejos;1493;728;765;2023
14;Córdoba;004;Almedinilla;2340;1163;1177;2023
14;Córdoba;005;Almodóvar del Río;7995;4015;3980;2023
14;Córdoba;006;Añora;1507;745;762;2023
14;Córdoba;007;Baena;18533;9278;9255;2023
14;Córdoba;008;Belalcázar;3138;1545;1593;2023
14;Córdoba;009;Belmez;2802;1351;1451;2023
14;Córdoba;010;Benamejí;4979;2454;2525;2023
14;Córdoba;011;Blázquez, Los;643;326;317;2023
14;Córdoba;012;Bujalance;7186;3591;3595;2023
14;Córdoba;013;Cabra;20070;9758;10312;2023
14;Córdoba;014;Cañete de las Torres;2829;1449;1380;2023
14;Córdoba;015;Carcabuey;2318;1182;1136;2023
14;Córdoba;016;Cardeña;1437;725;712;2023
14;Córdoba;017;Carlota, La;14258;7087;7171;2023
14;Córdoba;018;Carpio, El;4327;2135;2192;2023
14;Córdoba;019;Castro del Río;7665;3774;3891;2023
14;Córdoba;020;Conquista;371;187;184;2023
14;Córdoba;021;Córdoba;323763;155314;168449;2023
14;Córdoba;022;Doña Mencía;4511;2181;2330;2023
14;Córdoba;023;Dos Torres;2383;1199;1184;2023
14;Córdoba;024;Encinas Reales;2252;1104;1148;2023
14;Córdoba;025;Espejo;3209;1602;1607;2023
14;Córdoba;026;Espiel;2386;1205;1181;2023
14;Córdoba;027;Fernán-Núñez;9611;4756;4855;2023
14;Córdoba;901;Fuente Carreteros;1089;559;530;2023
14;Córdoba;028;Fuente la Lancha;354;179;175;2023
14;Córdoba;029;Fuente Obejuna;4415;2290;2125;2023
14;Córdoba;030;Fuente Palmera;9850;4920;4930;2023
14;Córdoba;031;Fuente-Tójar;692;335;357;2023
14;Córdoba;032;Granjuela, La;410;198;212;2023
14;Córdoba;033;Guadalcázar;1533;783;750;2023
14;Córdoba;902;Guijarrosa, La;1336;684;652;2023
14;Córdoba;034;Guijo, El;341;177;164;2023
14;Córdoba;035;Hinojosa del Duque;6579;3243;3336;2023
14;Córdoba;036;Hornachuelos;4415;2203;2212;2023
14;Córdoba;037;Iznájar;3804;1934;1870;2023
14;Córdoba;038;Lucena;42813;21264;21549;2023
14;Córdoba;039;Luque;2860;1436;1424;2023
14;Córdoba;040;Montalbán de Córdoba;4465;2199;2266;2023
14;Córdoba;041;Montemayor;3872;1960;1912;2023
14;Córdoba;042;Montilla;22298;11049;11249;2023
14;Córdoba;043;Montoro;9125;4506;4619;2023
14;Córdoba;044;Monturque;1929;970;959;2023
14;Córdoba;045;Moriles;3658;1841;1817;2023
14;Córdoba;046;Nueva Carteya;5317;2708;2609;2023
14;Córdoba;047;Obejo;2076;1094;982;2023
14;Córdoba;048;Palenciana;1441;736;705;2023
14;Córdoba;049;Palma del Río;20688;10243;10445;2023
14;Córdoba;050;Pedro Abad;2775;1400;1375;2023
14;Córdoba;051;Pedroche;1485;734;751;2023
14;Córdoba;052;Peñarroya-Pueblonuevo;10317;4986;5331;2023
14;Córdoba;053;Posadas;7256;3598;3658;2023
14;Córdoba;054;Pozoblanco;16946;8235;8711;2023
14;Córdoba;055;Priego de Córdoba;22003;10708;11295;2023
14;Córdoba;056;Puente Genil;29781;14691;15090;2023
14;Córdoba;057;Rambla, La;7473;3732;3741;2023
14;Córdoba;058;Rute;9779;4896;4883;2023
14;Córdoba;059;San Sebastián de los Ballesteros;833;423;410;2023
14;Córdoba;061;Santa Eufemia;710;351;359;2023
14;Córdoba;060;Santaella;4640;2341;2299;2023
14;Córdoba;062;Torrecampo;1003;494;509;2023
14;Córdoba;063;Valenzuela;1045;525;520;2023
14;Córdoba;064;Valsequillo;356;173;183;2023
14;Córdoba;065;Victoria, La;2312;1148;1164;2023
14;Córdoba;066;Villa del Río;6882;3428;3454;2023
14;Córdoba;067;Villafranca de Córdoba;4866;2475;2391;2023
14;Córdoba;068;Villaharta;628;303;325;2023
14;Córdoba;069;Villanueva de Córdoba;8460;4194;4266;2023
14;Córdoba;070;Villanueva del Duque;1406;710;696;2023
14;Córdoba;071;Villanueva del Rey;1000;487;513;2023
14;Córdoba;072;Villaralto;1088;550;538;2023
14;Córdoba;073;Villaviciosa de Córdoba;3085;1573;1512;2023
14;Córdoba;074;Viso, El;2507;1269;1238;2023
14;Córdoba;075;Zuheros;621;318;303;2023
15;Coruña, A;001;Abegondo;5584;2763;2821;2023
15;Coruña, A;002;Ames;32482;15617;16865;2023
15;Coruña, A;003;Aranga;1815;924;891;2023
15;Coruña, A;004;Ares;6132;3019;3113;2023
15;Coruña, A;005;Arteixo;33516;16539;16977;2023
15;Coruña, A;006;Arzúa;5901;2919;2982;2023
15;Coruña, A;007;Baña, A;3332;1577;1755;2023
15;Coruña, A;008;Bergondo;6951;3402;3549;2023
15;Coruña, A;009;Betanzos;13082;6234;6848;2023
15;Coruña, A;010;Boimorto;1849;930;919;2023
15;Coruña, A;011;Boiro;18984;9200;9784;2023
15;Coruña, A;012;Boqueixón;4146;2025;2121;2023
15;Coruña, A;013;Brión;8145;3913;4232;2023
15;Coruña, A;014;Cabana de Bergantiños;4123;2001;2122;2023
15;Coruña, A;015;Cabanas;3300;1601;1699;2023
15;Coruña, A;016;Camariñas;5151;2526;2625;2023
15;Coruña, A;017;Cambre;24739;12060;12679;2023
15;Coruña, A;018;Capela, A;1185;582;603;2023
15;Coruña, A;019;Carballo;31416;15329;16087;2023
15;Coruña, A;901;Cariño;3769;1856;1913;2023
15;Coruña, A;020;Carnota;3815;1821;1994;2023
15;Coruña, A;021;Carral;6700;3285;3415;2023
15;Coruña, A;022;Cedeira;6529;3245;3284;2023
15;Coruña, A;023;Cee;7660;3658;4002;2023
15;Coruña, A;024;Cerceda;5058;2518;2540;2023
15;Coruña, A;025;Cerdido;1033;507;526;2023
15;Coruña, A;027;Coirós;1923;949;974;2023
15;Coruña, A;028;Corcubión;1647;829;818;2023
15;Coruña, A;029;Coristanco;5779;2773;3006;2023
15;Coruña, A;030;Coruña, A;247376;114547;132829;2023
15;Coruña, A;031;Culleredo;30864;14825;16039;2023
15;Coruña, A;032;Curtis;4135;2096;2039;2023
15;Coruña, A;033;Dodro;2659;1264;1395;2023
15;Coruña, A;034;Dumbría;2856;1361;1495;2023
15;Coruña, A;035;Fene;12561;5966;6595;2023
15;Coruña, A;036;Ferrol;63890;30082;33808;2023
15;Coruña, A;037;Fisterra;4697;2380;2317;2023
15;Coruña, A;038;Frades;2246;1116;1130;2023
15;Coruña, A;039;Irixoa;1316;664;652;2023
15;Coruña, A;041;Laracha, A;11543;5688;5855;2023
15;Coruña, A;040;Laxe;2939;1472;1467;2023
15;Coruña, A;042;Lousame;3145;1562;1583;2023
15;Coruña, A;043;Malpica de Bergantiños;5241;2562;2679;2023
15;Coruña, A;044;Mañón;1244;617;627;2023
15;Coruña, A;045;Mazaricos;3737;1782;1955;2023
15;Coruña, A;046;Melide;7553;3696;3857;2023
15;Coruña, A;047;Mesía;2418;1217;1201;2023
15;Coruña, A;048;Miño;6753;3359;3394;2023
15;Coruña, A;049;Moeche;1206;586;620;2023
15;Coruña, A;050;Monfero;1838;935;903;2023
15;Coruña, A;051;Mugardos;5228;2540;2688;2023
15;Coruña, A;053;Muros;8251;3983;4268;2023
15;Coruña, A;052;Muxía;4450;2129;2321;2023
15;Coruña, A;054;Narón;39051;18891;20160;2023
15;Coruña, A;055;Neda;4910;2382;2528;2023
15;Coruña, A;056;Negreira;6901;3326;3575;2023
15;Coruña, A;057;Noia;14115;6764;7351;2023
15;Coruña, A;058;Oleiros;37809;18166;19643;2023
15;Coruña, A;059;Ordes;12669;6186;6483;2023
15;Coruña, A;060;Oroso;7622;3747;3875;2023
15;Coruña, A;061;Ortigueira;5477;2607;2870;2023
15;Coruña, A;062;Outes;6082;2915;3167;2023
15;Coruña, A;902;Oza-Cesuras;5203;2627;2576;2023
15;Coruña, A;064;Paderne;2436;1199;1237;2023
15;Coruña, A;065;Padrón;8355;4049;4306;2023
15;Coruña, A;066;Pino, O;4553;2280;2273;2023
15;Coruña, A;067;Pobra do Caramiñal, A;9227;4529;4698;2023
15;Coruña, A;068;Ponteceso;5399;2709;2690;2023
15;Coruña, A;069;Pontedeume;7520;3615;3905;2023
15;Coruña, A;070;Pontes de García Rodríguez, As;9867;4790;5077;2023
15;Coruña, A;071;Porto do Son;9125;4527;4598;2023
15;Coruña, A;072;Rianxo;10854;5344;5510;2023
15;Coruña, A;073;Ribeira;27030;13341;13689;2023
15;Coruña, A;074;Rois;4397;2096;2301;2023
15;Coruña, A;075;Sada;16874;8228;8646;2023
15;Coruña, A;076;San Sadurniño;2751;1359;1392;2023
15;Coruña, A;077;Santa Comba;9342;4545;4797;2023
15;Coruña, A;078;Santiago de Compostela;98687;45839;52848;2023
15;Coruña, A;079;Santiso;1473;764;709;2023
15;Coruña, A;080;Sobrado;1777;923;854;2023
15;Coruña, A;081;Somozas, As;1068;542;526;2023
15;Coruña, A;082;Teo;19034;9318;9716;2023
15;Coruña, A;083;Toques;1074;549;525;2023
15;Coruña, A;084;Tordoia;3168;1512;1656;2023
15;Coruña, A;085;Touro;3382;1686;1696;2023
15;Coruña, A;086;Trazo;3019;1476;1543;2023
15;Coruña, A;088;Val do Dubra;3761;1834;1927;2023
15;Coruña, A;087;Valdoviño;6889;3362;3527;2023
15;Coruña, A;089;Vedra;5019;2458;2561;2023
15;Coruña, A;091;Vilarmaior;1234;629;605;2023
15;Coruña, A;090;Vilasantar;1232;652;580;2023
15;Coruña, A;092;Vimianzo;6840;3298;3542;2023
15;Coruña, A;093;Zas;4308;2082;2226;2023
16;Cuenca;001;Abia de la Obispalía;61;38;23;2023
16;Cuenca;002;Acebrón, El;226;111;115;2023
16;Cuenca;003;Alarcón;172;79;93;2023
16;Cuenca;004;Albaladejo del Cuende;225;120;105;2023
16;Cuenca;005;Albalate de las Nogueras;267;137;130;2023
16;Cuenca;006;Albendea;118;58;60;2023
16;Cuenca;007;Alberca de Záncara, La;1553;785;768;2023
16;Cuenca;008;Alcalá de la Vega;79;46;33;2023
16;Cuenca;009;Alcantud;53;30;23;2023
16;Cuenca;010;Alcázar del Rey;159;87;72;2023
16;Cuenca;011;Alcohujate;19;10;9;2023
16;Cuenca;012;Alconchel de la Estrella;77;47;30;2023
16;Cuenca;013;Algarra;29;17;12;2023
16;Cuenca;014;Aliaguilla;620;320;300;2023
16;Cuenca;015;Almarcha, La;434;234;200;2023
16;Cuenca;016;Almendros;244;127;117;2023
16;Cuenca;017;Almodóvar del Pinar;398;207;191;2023
16;Cuenca;018;Almonacid del Marquesado;434;224;210;2023
16;Cuenca;019;Altarejos;210;116;94;2023
16;Cuenca;020;Arandilla del Arroyo;11;6;5;2023
16;Cuenca;905;Arcas;2094;1059;1035;2023
16;Cuenca;022;Arcos de la Sierra;77;45;32;2023
16;Cuenca;024;Arguisuelas;133;67;66;2023
16;Cuenca;025;Arrancacepas;16;9;7;2023
16;Cuenca;026;Atalaya del Cañavate;105;58;47;2023
16;Cuenca;027;Barajas de Melo;1012;544;468;2023
16;Cuenca;029;Barchín del Hoyo;92;60;32;2023
16;Cuenca;030;Bascuñana de San Pedro;24;20;4;2023
16;Cuenca;031;Beamud;52;29;23;2023
16;Cuenca;032;Belinchón;398;206;192;2023
16;Cuenca;033;Belmonte;1782;886;896;2023
16;Cuenca;034;Belmontejo;135;77;58;2023
16;Cuenca;035;Beteta;235;123;112;2023
16;Cuenca;036;Boniches;145;73;72;2023
16;Cuenca;038;Buciegas;38;24;14;2023
16;Cuenca;039;Buenache de Alarcón;453;238;215;2023
16;Cuenca;040;Buenache de la Sierra;114;64;50;2023
16;Cuenca;041;Buendía;418;222;196;2023
16;Cuenca;042;Campillo de Altobuey;1287;654;633;2023
16;Cuenca;043;Campillos-Paravientos;105;60;45;2023
16;Cuenca;044;Campillos-Sierra;29;14;15;2023
16;Cuenca;901;Campos del Paraíso;672;346;326;2023
16;Cuenca;045;Canalejas del Arroyo;169;91;78;2023
16;Cuenca;046;Cañada del Hoyo;244;136;108;2023
16;Cuenca;047;Cañada Juncosa;217;119;98;2023
16;Cuenca;048;Cañamares;449;242;207;2023
16;Cuenca;049;Cañavate, El;138;69;69;2023
16;Cuenca;050;Cañaveras;229;114;115;2023
16;Cuenca;051;Cañaveruelas;116;58;58;2023
16;Cuenca;052;Cañete;804;415;389;2023
16;Cuenca;053;Cañizares;442;241;201;2023
16;Cuenca;055;Carboneras de Guadazaón;774;403;371;2023
16;Cuenca;056;Cardenete;474;250;224;2023
16;Cuenca;057;Carrascosa;67;42;25;2023
16;Cuenca;058;Carrascosa de Haro;96;47;49;2023
16;Cuenca;060;Casas de Benítez;809;408;401;2023
16;Cuenca;061;Casas de Fernando Alonso;1132;592;540;2023
16;Cuenca;062;Casas de Garcimolina;34;21;13;2023
16;Cuenca;063;Casas de Guijarro;110;61;49;2023
16;Cuenca;064;Casas de Haro;848;452;396;2023
16;Cuenca;065;Casas de los Pinos;419;212;207;2023
16;Cuenca;066;Casasimarro;3157;1640;1517;2023
16;Cuenca;067;Castejón;117;68;49;2023
16;Cuenca;068;Castillejo de Iniesta;107;58;49;2023
16;Cuenca;070;Castillejo-Sierra;35;17;18;2023
16;Cuenca;072;Castillo de Garcimuñoz;131;79;52;2023
16;Cuenca;071;Castillo-Albaráñez;23;10;13;2023
16;Cuenca;073;Cervera del Llano;210;103;107;2023
16;Cuenca;023;Chillarón de Cuenca;771;399;372;2023
16;Cuenca;081;Chumillas;61;36;25;2023
16;Cuenca;074;Cierva, La;38;21;17;2023
16;Cuenca;078;Cuenca;53512;25296;28216;2023
16;Cuenca;079;Cueva del Hierro;29;17;12;2023
16;Cuenca;082;Enguídanos;315;173;142;2023
16;Cuenca;083;Fresneda de Altarejos;37;19;18;2023
16;Cuenca;084;Fresneda de la Sierra;40;24;16;2023
16;Cuenca;085;Frontera, La;146;80;66;2023
16;Cuenca;086;Fuente de Pedro Naharro;1234;648;586;2023
16;Cuenca;087;Fuentelespino de Haro;239;119;120;2023
16;Cuenca;088;Fuentelespino de Moya;107;57;50;2023
16;Cuenca;904;Fuentenava de Jábaga;579;301;278;2023
16;Cuenca;089;Fuentes;463;250;213;2023
16;Cuenca;091;Fuertescusa;70;40;30;2023
16;Cuenca;092;Gabaldón;156;92;64;2023
16;Cuenca;093;Garaballa;62;31;31;2023
16;Cuenca;094;Gascueña;140;83;57;2023
16;Cuenca;095;Graja de Campalbo;89;48;41;2023
16;Cuenca;096;Graja de Iniesta;357;187;170;2023
16;Cuenca;097;Henarejos;134;67;67;2023
16;Cuenca;098;Herrumblar, El;756;385;371;2023
16;Cuenca;099;Hinojosa, La;191;98;93;2023
16;Cuenca;100;Hinojosos, Los;731;375;356;2023
16;Cuenca;101;Hito, El;145;80;65;2023
16;Cuenca;102;Honrubia;1554;782;772;2023
16;Cuenca;103;Hontanaya;256;145;111;2023
16;Cuenca;104;Hontecillas;55;30;25;2023
16;Cuenca;106;Horcajo de Santiago;3671;1869;1802;2023
16;Cuenca;107;Huélamo;76;42;34;2023
16;Cuenca;108;Huelves;89;48;41;2023
16;Cuenca;109;Huérguina;48;26;22;2023
16;Cuenca;110;Huerta de la Obispalía;140;80;60;2023
16;Cuenca;111;Huerta del Marquesado;177;97;80;2023
16;Cuenca;112;Huete;1708;877;831;2023
16;Cuenca;113;Iniesta;4453;2220;2233;2023
16;Cuenca;115;Laguna del Marquesado;57;34;23;2023
16;Cuenca;116;Lagunaseca;49;30;19;2023
16;Cuenca;117;Landete;1230;620;610;2023
16;Cuenca;118;Ledaña;1622;818;804;2023
16;Cuenca;119;Leganiel;220;115;105;2023
16;Cuenca;121;Majadas, Las;225;117;108;2023
16;Cuenca;122;Mariana;319;169;150;2023
16;Cuenca;123;Masegosa;65;38;27;2023
16;Cuenca;124;Mesas, Las;2276;1176;1100;2023
16;Cuenca;125;Minglanilla;2280;1175;1105;2023
16;Cuenca;126;Mira;912;464;448;2023
16;Cuenca;128;Monreal del Llano;46;26;20;2023
16;Cuenca;129;Montalbanejo;87;43;44;2023
16;Cuenca;130;Montalbo;697;356;341;2023
16;Cuenca;131;Monteagudo de las Salinas;134;78;56;2023
16;Cuenca;132;Mota de Altarejos;29;20;9;2023
16;Cuenca;133;Mota del Cuervo;6108;3027;3081;2023
16;Cuenca;134;Motilla del Palancar;6119;3063;3056;2023
16;Cuenca;135;Moya;170;93;77;2023
16;Cuenca;137;Narboneta;53;34;19;2023
16;Cuenca;139;Olivares de Júcar;310;160;150;2023
16;Cuenca;140;Olmeda de la Cuesta;22;13;9;2023
16;Cuenca;141;Olmeda del Rey;127;64;63;2023
16;Cuenca;142;Olmedilla de Alarcón;133;78;55;2023
16;Cuenca;143;Olmedilla de Eliz;22;17;5;2023
16;Cuenca;145;Osa de la Vega;443;226;217;2023
16;Cuenca;146;Pajarón;78;37;41;2023
16;Cuenca;147;Pajaroncillo;58;32;26;2023
16;Cuenca;148;Palomares del Campo;557;283;274;2023
16;Cuenca;149;Palomera;189;89;100;2023
16;Cuenca;150;Paracuellos;94;50;44;2023
16;Cuenca;151;Paredes;75;42;33;2023
16;Cuenca;152;Parra de las Vegas, La;34;24;10;2023
16;Cuenca;153;Pedernoso, El;1124;562;562;2023
16;Cuenca;154;Pedroñeras, Las;6550;3357;3193;2023
16;Cuenca;155;Peral, El;654;372;282;2023
16;Cuenca;156;Peraleja, La;84;53;31;2023
16;Cuenca;157;Pesquera, La;219;117;102;2023
16;Cuenca;158;Picazo, El;690;357;333;2023
16;Cuenca;159;Pinarejo;190;94;96;2023
16;Cuenca;160;Pineda de Gigüela;60;40;20;2023
16;Cuenca;161;Piqueras del Castillo;46;28;18;2023
16;Cuenca;162;Portalrubio de Guadamejud;36;20;16;2023
16;Cuenca;163;Portilla;56;29;27;2023
16;Cuenca;165;Poyatos;74;47;27;2023
16;Cuenca;166;Pozoamargo;271;146;125;2023
16;Cuenca;908;Pozorrubielos de la Mancha;171;92;79;2023
16;Cuenca;167;Pozorrubio de Santiago;323;155;168;2023
16;Cuenca;169;Pozuelo, El;45;28;17;2023
16;Cuenca;170;Priego;903;460;443;2023
16;Cuenca;171;Provencio, El;2396;1204;1192;2023
16;Cuenca;172;Puebla de Almenara;331;172;159;2023
16;Cuenca;174;Puebla del Salvador;199;105;94;2023
16;Cuenca;175;Quintanar del Rey;7554;3885;3669;2023
16;Cuenca;176;Rada de Haro;51;32;19;2023
16;Cuenca;177;Reíllo;112;67;45;2023
16;Cuenca;181;Rozalén del Monte;59;27;32;2023
16;Cuenca;185;Saceda-Trasierra;39;25;14;2023
16;Cuenca;186;Saelices;466;246;220;2023
16;Cuenca;187;Salinas del Manzano;73;42;31;2023
16;Cuenca;188;Salmeroncillos;103;60;43;2023
16;Cuenca;189;Salvacañete;300;154;146;2023
16;Cuenca;190;San Clemente;6776;3412;3364;2023
16;Cuenca;191;San Lorenzo de la Parrilla;1106;581;525;2023
16;Cuenca;192;San Martín de Boniches;45;26;19;2023
16;Cuenca;193;San Pedro Palmiches;58;35;23;2023
16;Cuenca;194;Santa Cruz de Moya;224;112;112;2023
16;Cuenca;196;Santa María de los Llanos;683;364;319;2023
16;Cuenca;195;Santa María del Campo Rus;531;278;253;2023
16;Cuenca;197;Santa María del Val;65;37;28;2023
16;Cuenca;198;Sisante;1636;845;791;2023
16;Cuenca;199;Solera de Gabaldón;31;18;13;2023
16;Cuenca;909;Sotorribas;698;366;332;2023
16;Cuenca;202;Talayuelas;875;457;418;2023
16;Cuenca;203;Tarancón;16257;8029;8228;2023
16;Cuenca;204;Tébar;299;167;132;2023
16;Cuenca;205;Tejadillos;104;50;54;2023
16;Cuenca;206;Tinajas;189;103;86;2023
16;Cuenca;209;Torralba;109;66;43;2023
16;Cuenca;211;Torrejoncillo del Rey;342;193;149;2023
16;Cuenca;212;Torrubia del Campo;311;152;159;2023
16;Cuenca;213;Torrubia del Castillo;44;29;15;2023
16;Cuenca;215;Tragacete;268;156;112;2023
16;Cuenca;216;Tresjuncos;270;151;119;2023
16;Cuenca;217;Tribaldos;97;53;44;2023
16;Cuenca;218;Uclés;247;132;115;2023
16;Cuenca;219;Uña;88;51;37;2023
16;Cuenca;906;Valdecolmenas, Los;71;47;24;2023
16;Cuenca;224;Valdemeca;82;48;34;2023
16;Cuenca;225;Valdemorillo de la Sierra;53;32;21;2023
16;Cuenca;227;Valdemoro-Sierra;110;63;47;2023
16;Cuenca;228;Valdeolivas;211;134;77;2023
16;Cuenca;902;Valdetórtola;123;69;54;2023
16;Cuenca;903;Valeras, Las;1587;850;737;2023
16;Cuenca;231;Valhermoso de la Fuente;75;41;34;2023
16;Cuenca;173;Valle de Altomira, El;208;113;95;2023
16;Cuenca;234;Valsalobre;21;11;10;2023
16;Cuenca;236;Valverde de Júcar;1085;537;548;2023
16;Cuenca;237;Valverdejo;91;48;43;2023
16;Cuenca;238;Vara de Rey;474;238;236;2023
16;Cuenca;239;Vega del Codorno;142;84;58;2023
16;Cuenca;240;Vellisca;119;65;54;2023
16;Cuenca;242;Villaconejos de Trabaque;325;171;154;2023
16;Cuenca;243;Villaescusa de Haro;490;260;230;2023
16;Cuenca;244;Villagarcía del Llano;754;376;378;2023
16;Cuenca;245;Villalba de la Sierra;532;263;269;2023
16;Cuenca;246;Villalba del Rey;488;263;225;2023
16;Cuenca;247;Villalgordo del Marquesado;63;39;24;2023
16;Cuenca;248;Villalpardo;1008;500;508;2023
16;Cuenca;249;Villamayor de Santiago;2405;1235;1170;2023
16;Cuenca;250;Villanueva de Guadamejud;62;40;22;2023
16;Cuenca;251;Villanueva de la Jara;2292;1167;1125;2023
16;Cuenca;253;Villar de Cañas;391;212;179;2023
16;Cuenca;254;Villar de Domingo García;226;114;112;2023
16;Cuenca;255;Villar de la Encina;154;76;78;2023
16;Cuenca;263;Villar de Olalla;1425;761;664;2023
16;Cuenca;258;Villar del Humo;186;101;85;2023
16;Cuenca;259;Villar del Infantado;30;17;13;2023
16;Cuenca;910;Villar y Velasco;78;45;33;2023
16;Cuenca;264;Villarejo de Fuentes;396;198;198;2023
16;Cuenca;265;Villarejo de la Peñuela;23;13;10;2023
16;Cuenca;266;Villarejo-Periesteban;387;194;193;2023
16;Cuenca;269;Villares del Saz;464;245;219;2023
16;Cuenca;270;Villarrubio;207;114;93;2023
16;Cuenca;271;Villarta;848;420;428;2023
16;Cuenca;272;Villas de la Ventosa;219;121;98;2023
16;Cuenca;273;Villaverde y Pasaconsol;339;181;158;2023
16;Cuenca;274;Víllora;135;75;60;2023
16;Cuenca;275;Vindel;17;11;6;2023
16;Cuenca;276;Yémeda;19;13;6;2023
16;Cuenca;277;Zafra de Záncara;93;55;38;2023
16;Cuenca;278;Zafrilla;53;28;25;2023
16;Cuenca;279;Zarza de Tajo;273;150;123;2023
16;Cuenca;280;Zarzuela;148;82;66;2023
20;Gipuzkoa;001;Abaltzisketa;326;185;141;2023
20;Gipuzkoa;002;Aduna;506;270;236;2023
20;Gipuzkoa;016;Aia;2136;1124;1012;2023
20;Gipuzkoa;003;Aizarnazabal;771;394;377;2023
20;Gipuzkoa;004;Albiztur;325;169;156;2023
20;Gipuzkoa;005;Alegia;1771;923;848;2023
20;Gipuzkoa;006;Alkiza;371;181;190;2023
20;Gipuzkoa;906;Altzaga;173;85;88;2023
20;Gipuzkoa;007;Altzo;448;237;211;2023
20;Gipuzkoa;008;Amezketa;937;498;439;2023
20;Gipuzkoa;009;Andoain;14555;7221;7334;2023
20;Gipuzkoa;010;Anoeta;2095;1075;1020;2023
20;Gipuzkoa;011;Antzuola;2082;1035;1047;2023
20;Gipuzkoa;012;Arama;189;91;98;2023
20;Gipuzkoa;013;Aretxabaleta;7155;3572;3583;2023
20;Gipuzkoa;055;Arrasate/Mondragón;21867;10732;11135;2023
20;Gipuzkoa;014;Asteasu;1546;785;761;2023
20;Gipuzkoa;903;Astigarraga;7666;3900;3766;2023
20;Gipuzkoa;015;Ataun;1694;881;813;2023
20;Gipuzkoa;017;Azkoitia;11636;5774;5862;2023
20;Gipuzkoa;018;Azpeitia;15183;7606;7577;2023
20;Gipuzkoa;904;Baliarrain;149;83;66;2023
20;Gipuzkoa;019;Beasain;13970;6983;6987;2023
20;Gipuzkoa;020;Beizama;134;84;50;2023
20;Gipuzkoa;021;Belauntza;286;151;135;2023
20;Gipuzkoa;022;Berastegi;1083;556;527;2023
20;Gipuzkoa;074;Bergara;14487;7148;7339;2023
20;Gipuzkoa;023;Berrobi;575;306;269;2023
20;Gipuzkoa;024;Bidania-Goiatz;538;278;260;2023
20;Gipuzkoa;029;Deba;5393;2670;2723;2023
20;Gipuzkoa;069;Donostia/San Sebastián;188743;89152;99591;2023
20;Gipuzkoa;030;Eibar;27234;13219;14015;2023
20;Gipuzkoa;031;Elduain;237;116;121;2023
20;Gipuzkoa;033;Elgeta;1119;563;556;2023
20;Gipuzkoa;032;Elgoibar;11500;5660;5840;2023
20;Gipuzkoa;067;Errenteria;39231;18944;20287;2023
20;Gipuzkoa;066;Errezil;582;305;277;2023
20;Gipuzkoa;034;Eskoriatza;4194;2102;2092;2023
20;Gipuzkoa;035;Ezkio-Itsaso;604;307;297;2023
20;Gipuzkoa;038;Gabiria;506;268;238;2023
20;Gipuzkoa;037;Gaintza;124;71;53;2023
20;Gipuzkoa;907;Gaztelu;168;86;82;2023
20;Gipuzkoa;039;Getaria;2868;1436;1432;2023
20;Gipuzkoa;040;Hernani;20527;10053;10474;2023
20;Gipuzkoa;041;Hernialde;313;165;148;2023
20;Gipuzkoa;036;Hondarribia;16887;8384;8503;2023
20;Gipuzkoa;042;Ibarra;4130;2029;2101;2023
20;Gipuzkoa;043;Idiazabal;2275;1146;1129;2023
20;Gipuzkoa;044;Ikaztegieta;487;249;238;2023
20;Gipuzkoa;045;Irun;62920;30803;32117;2023
20;Gipuzkoa;046;Irura;1887;981;906;2023
20;Gipuzkoa;047;Itsasondo;656;337;319;2023
20;Gipuzkoa;048;Larraul;257;144;113;2023
20;Gipuzkoa;902;Lasarte-Oria;19133;9236;9897;2023
20;Gipuzkoa;049;Lazkao;6013;3008;3005;2023
20;Gipuzkoa;050;Leaburu;394;211;183;2023
20;Gipuzkoa;051;Legazpi;8341;4189;4152;2023
20;Gipuzkoa;052;Legorreta;1464;735;729;2023
20;Gipuzkoa;068;Leintz-Gatzaga;194;110;84;2023
20;Gipuzkoa;053;Lezo;6008;2978;3030;2023
20;Gipuzkoa;054;Lizartza;637;334;303;2023
20;Gipuzkoa;901;Mendaro;2010;1014;996;2023
20;Gipuzkoa;057;Mutiloa;262;131;131;2023
20;Gipuzkoa;056;Mutriku;5313;2673;2640;2023
20;Gipuzkoa;063;Oiartzun;10331;5127;5204;2023
20;Gipuzkoa;058;Olaberria;918;466;452;2023
20;Gipuzkoa;059;Oñati;11567;5709;5858;2023
20;Gipuzkoa;076;Ordizia;10641;5301;5340;2023
20;Gipuzkoa;905;Orendain;240;114;126;2023
20;Gipuzkoa;060;Orexa;108;61;47;2023
20;Gipuzkoa;061;Orio;6125;3063;3062;2023
20;Gipuzkoa;062;Ormaiztegi;1228;627;601;2023
20;Gipuzkoa;064;Pasaia;15857;7610;8247;2023
20;Gipuzkoa;070;Segura;1460;735;725;2023
20;Gipuzkoa;065;Soraluze-Placencia de las Armas;3751;1898;1853;2023
20;Gipuzkoa;071;Tolosa;20065;9711;10354;2023
20;Gipuzkoa;072;Urnieta;6200;3108;3092;2023
20;Gipuzkoa;077;Urretxu;6739;3339;3400;2023
20;Gipuzkoa;073;Usurbil;6345;3167;3178;2023
20;Gipuzkoa;075;Villabona;5826;2881;2945;2023
20;Gipuzkoa;078;Zaldibia;1735;879;856;2023
20;Gipuzkoa;079;Zarautz;23152;11229;11923;2023
20;Gipuzkoa;025;Zegama;1542;785;757;2023
20;Gipuzkoa;026;Zerain;280;133;147;2023
20;Gipuzkoa;027;Zestoa;3785;1973;1812;2023
20;Gipuzkoa;028;Zizurkil;2975;1497;1478;2023
20;Gipuzkoa;081;Zumaia;10211;5057;5154;2023
20;Gipuzkoa;080;Zumarraga;9681;4757;4924;2023
17;Girona;001;Agullana;923;455;468;2023
17;Girona;002;Aiguaviva;770;384;386;2023
17;Girona;003;Albanyà;171;88;83;2023
17;Girona;004;Albons;819;425;394;2023
17;Girona;006;Alp;1719;899;820;2023
17;Girona;007;Amer;2423;1198;1225;2023
17;Girona;008;Anglès;5884;2958;2926;2023
17;Girona;009;Arbúcies;6531;3349;3182;2023
17;Girona;010;Argelaguer;428;214;214;2023
17;Girona;011;Armentera, L';1061;539;522;2023
17;Girona;012;Avinyonet de Puigventós;1681;843;838;2023
17;Girona;015;Banyoles;20506;10175;10331;2023
17;Girona;016;Bàscara;1059;541;518;2023
17;Girona;013;Begur;4216;2098;2118;2023
17;Girona;018;Bellcaire d'Empordà;730;355;375;2023
17;Girona;019;Besalú;2518;1186;1332;2023
17;Girona;020;Bescanó;5178;2596;2582;2023
17;Girona;021;Beuda;212;109;103;2023
17;Girona;022;Bisbal d'Empordà, La;11383;5696;5687;2023
17;Girona;234;Biure;240;130;110;2023
17;Girona;023;Blanes;41653;20715;20938;2023
17;Girona;029;Boadella i les Escaules;262;131;131;2023
17;Girona;024;Bolvir;506;257;249;2023
17;Girona;025;Bordils;1794;902;892;2023
17;Girona;026;Borrassà;797;410;387;2023
17;Girona;027;Breda;3898;1909;1989;2023
17;Girona;028;Brunyola i Sant Martí Sapresa;398;204;194;2023
17;Girona;031;Cabanelles;276;152;124;2023
17;Girona;030;Cabanes;941;492;449;2023
17;Girona;032;Cadaqués;2912;1419;1493;2023
17;Girona;033;Caldes de Malavella;8418;4183;4235;2023
17;Girona;034;Calonge i Sant Antoni;12043;6001;6042;2023
17;Girona;035;Camós;719;354;365;2023
17;Girona;036;Campdevànol;3212;1584;1628;2023
17;Girona;037;Campelles;164;89;75;2023
17;Girona;038;Campllong;535;266;269;2023
17;Girona;039;Camprodon;2487;1209;1278;2023
17;Girona;040;Canet d'Adri;749;382;367;2023
17;Girona;041;Cantallops;325;168;157;2023
17;Girona;042;Capmany;668;342;326;2023
17;Girona;044;Cassà de la Selva;10836;5548;5288;2023
17;Girona;046;Castellfollit de la Roca;941;480;461;2023
17;Girona;047;Castelló d'Empúries;11731;5922;5809;2023
17;Girona;048;Castell-Platja d'Aro;12566;6094;6472;2023
17;Girona;189;Cellera de Ter, La;2012;986;1026;2023
17;Girona;049;Celrà;5486;2745;2741;2023
17;Girona;050;Cervià de Ter;1007;514;493;2023
17;Girona;051;Cistella;298;149;149;2023
17;Girona;054;Colera;479;247;232;2023
17;Girona;055;Colomers;207;104;103;2023
17;Girona;057;Corçà;1295;666;629;2023
17;Girona;056;Cornellà del Terri;2401;1204;1197;2023
17;Girona;058;Crespià;242;125;117;2023
17;Girona;901;Cruïlles, Monells i Sant Sadurní de l'Heura;1323;675;648;2023
17;Girona;060;Darnius;546;287;259;2023
17;Girona;061;Das;257;132;125;2023
17;Girona;062;Escala, L';10478;5267;5211;2023
17;Girona;063;Espinelves;248;121;127;2023
17;Girona;064;Espolla;409;205;204;2023
17;Girona;065;Esponellà;467;243;224;2023
17;Girona;005;Far d'Empordà, El;612;308;304;2023
17;Girona;066;Figueres;47879;23669;24210;2023
17;Girona;067;Flaçà;1155;559;596;2023
17;Girona;068;Foixà;292;152;140;2023
17;Girona;069;Fontanals de Cerdanya;533;278;255;2023
17;Girona;070;Fontanilles;170;95;75;2023
17;Girona;071;Fontcoberta;1439;736;703;2023
17;Girona;902;Forallac;1752;852;900;2023
17;Girona;073;Fornells de la Selva;2732;1350;1382;2023
17;Girona;074;Fortià;786;380;406;2023
17;Girona;075;Garrigàs;463;242;221;2023
17;Girona;076;Garrigoles;190;100;90;2023
17;Girona;077;Garriguella;972;495;477;2023
17;Girona;078;Ger;507;277;230;2023
17;Girona;079;Girona;104320;50165;54155;2023
17;Girona;080;Gombrèn;200;99;101;2023
17;Girona;081;Gualta;430;250;180;2023
17;Girona;082;Guils de Cerdanya;598;319;279;2023
17;Girona;083;Hostalric;4410;2208;2202;2023
17;Girona;084;Isòvol;341;188;153;2023
17;Girona;085;Jafre;388;201;187;2023
17;Girona;086;Jonquera, La;3387;1693;1694;2023
17;Girona;087;Juià;335;178;157;2023
17;Girona;088;Lladó;849;423;426;2023
17;Girona;089;Llagostera;9208;4611;4597;2023
17;Girona;090;Llambilles;715;365;350;2023
17;Girona;091;Llanars;536;269;267;2023
17;Girona;092;Llançà;4839;2374;2465;2023
17;Girona;093;Llers;1216;609;607;2023
17;Girona;094;Llívia;1506;785;721;2023
17;Girona;095;Lloret de Mar;41559;20830;20729;2023
17;Girona;096;Llosses, Les;203;117;86;2023
17;Girona;102;Maçanet de Cabrenys;750;375;375;2023
17;Girona;103;Maçanet de la Selva;7823;4035;3788;2023
17;Girona;097;Madremanya;294;143;151;2023
17;Girona;098;Maià de Montcal;466;255;211;2023
17;Girona;100;Masarac;299;161;138;2023
17;Girona;101;Massanes;832;439;393;2023
17;Girona;099;Meranges;114;63;51;2023
17;Girona;105;Mieres;353;174;179;2023
17;Girona;106;Mollet de Peralada;215;112;103;2023
17;Girona;107;Molló;376;181;195;2023
17;Girona;109;Montagut i Oix;979;512;467;2023
17;Girona;110;Mont-ras;1671;844;827;2023
17;Girona;111;Navata;1465;719;746;2023
17;Girona;112;Ogassa;228;125;103;2023
17;Girona;114;Olot;37975;19292;18683;2023
17;Girona;115;Ordis;393;211;182;2023
17;Girona;116;Osor;420;225;195;2023
17;Girona;117;Palafrugell;23848;11838;12010;2023
17;Girona;118;Palamós;18293;8930;9363;2023
17;Girona;119;Palau de Santa Eulàlia;128;73;55;2023
17;Girona;121;Palau-sator;314;172;142;2023
17;Girona;120;Palau-saverdera;1495;753;742;2023
17;Girona;123;Palol de Revardit;469;232;237;2023
17;Girona;124;Pals;2539;1307;1232;2023
17;Girona;125;Pardines;169;95;74;2023
17;Girona;126;Parlavà;413;204;209;2023
17;Girona;128;Pau;555;273;282;2023
17;Girona;129;Pedret i Marzà;182;89;93;2023
17;Girona;130;Pera, La;450;227;223;2023
17;Girona;132;Peralada;2018;994;1024;2023
17;Girona;133;Planes d'Hostoles, Les;1756;880;876;2023
17;Girona;134;Planoles;315;174;141;2023
17;Girona;135;Pont de Molins;557;276;281;2023
17;Girona;136;Pontós;281;148;133;2023
17;Girona;137;Porqueres;4723;2343;2380;2023
17;Girona;140;Port de la Selva, El;1045;529;516;2023
17;Girona;138;Portbou;1066;527;539;2023
17;Girona;139;Preses, Les;1903;945;958;2023
17;Girona;141;Puigcerdà;9764;4898;4866;2023
17;Girona;142;Quart;4026;2040;1986;2023
17;Girona;043;Queralbs;197;102;95;2023
17;Girona;143;Rabós;203;99;104;2023
17;Girona;144;Regencós;269;143;126;2023
17;Girona;145;Ribes de Freser;1839;937;902;2023
17;Girona;146;Riells i Viabrea;4426;2251;2175;2023
17;Girona;147;Ripoll;10731;5311;5420;2023
17;Girona;148;Riudarenes;2332;1188;1144;2023
17;Girona;149;Riudaura;526;261;265;2023
17;Girona;150;Riudellots de la Selva;2092;1066;1026;2023
17;Girona;151;Riumors;234;122;112;2023
17;Girona;152;Roses;20140;10214;9926;2023
17;Girona;153;Rupià;316;155;161;2023
17;Girona;154;Sales de Llierca;167;85;82;2023
17;Girona;155;Salt;33242;17517;15725;2023
17;Girona;157;Sant Andreu Salou;171;83;88;2023
17;Girona;183;Sant Aniol de Finestres;364;186;178;2023
17;Girona;158;Sant Climent Sescebes;679;402;277;2023
17;Girona;159;Sant Feliu de Buixalleu;862;443;419;2023
17;Girona;160;Sant Feliu de Guíxols;22751;11125;11626;2023
17;Girona;161;Sant Feliu de Pallerols;1601;849;752;2023
17;Girona;162;Sant Ferriol;248;138;110;2023
17;Girona;163;Sant Gregori;4201;2109;2092;2023
17;Girona;164;Sant Hilari Sacalm;5913;2988;2925;2023
17;Girona;165;Sant Jaume de Llierca;870;429;441;2023
17;Girona;167;Sant Joan de les Abadesses;3298;1637;1661;2023
17;Girona;168;Sant Joan de Mollet;524;261;263;2023
17;Girona;185;Sant Joan les Fonts;3086;1563;1523;2023
17;Girona;166;Sant Jordi Desvalls;845;409;436;2023
17;Girona;169;Sant Julià de Ramis;3723;1878;1845;2023
17;Girona;903;Sant Julià del Llor i Bonmatí;1359;703;656;2023
17;Girona;171;Sant Llorenç de la Muga;275;139;136;2023
17;Girona;172;Sant Martí de Llémena;709;364;345;2023
17;Girona;173;Sant Martí Vell;269;146;123;2023
17;Girona;174;Sant Miquel de Campmajor;247;135;112;2023
17;Girona;175;Sant Miquel de Fluvià;833;435;398;2023
17;Girona;176;Sant Mori;173;87;86;2023
17;Girona;177;Sant Pau de Segúries;742;366;376;2023
17;Girona;178;Sant Pere Pescador;2122;1126;996;2023
17;Girona;180;Santa Coloma de Farners;13634;6874;6760;2023
17;Girona;181;Santa Cristina d'Aro;5664;2879;2785;2023
17;Girona;182;Santa Llogaia d'Àlguema;382;182;200;2023
17;Girona;184;Santa Pau;1616;815;801;2023
17;Girona;186;Sarrià de Ter;5327;2646;2681;2023
17;Girona;187;Saus, Camallera i Llampaies;872;431;441;2023
17;Girona;188;Selva de Mar, La;221;109;112;2023
17;Girona;190;Serinyà;1158;592;566;2023
17;Girona;191;Serra de Daró;237;124;113;2023
17;Girona;192;Setcases;185;103;82;2023
17;Girona;193;Sils;6624;3392;3232;2023
17;Girona;052;Siurana;186;88;98;2023
17;Girona;194;Susqueda;97;59;38;2023
17;Girona;195;Tallada d'Empordà, La;475;251;224;2023
17;Girona;196;Terrades;346;166;180;2023
17;Girona;197;Torrent;170;91;79;2023
17;Girona;198;Torroella de Fluvià;768;393;375;2023
17;Girona;199;Torroella de Montgrí;12356;6316;6040;2023
17;Girona;200;Tortellà;822;385;437;2023
17;Girona;201;Toses;189;108;81;2023
17;Girona;202;Tossa de Mar;6206;3146;3060;2023
17;Girona;204;Ullà;1193;644;549;2023
17;Girona;205;Ullastret;261;135;126;2023
17;Girona;203;Ultramort;224;117;107;2023
17;Girona;206;Urús;212;109;103;2023
17;Girona;014;Vajol, La;98;57;41;2023
17;Girona;208;Vall de Bianya, La;1356;672;684;2023
17;Girona;207;Vall d'en Bas, La;3178;1599;1579;2023
17;Girona;170;Vallfogona de Ripollès;222;117;105;2023
17;Girona;209;Vall-llobrega;908;456;452;2023
17;Girona;210;Ventalló;903;458;445;2023
17;Girona;211;Verges;1165;574;591;2023
17;Girona;212;Vidrà;178;89;89;2023
17;Girona;213;Vidreres;8339;4300;4039;2023
17;Girona;214;Vilabertran;995;497;498;2023
17;Girona;215;Vilablareix;3511;1753;1758;2023
17;Girona;217;Viladamat;488;247;241;2023
17;Girona;216;Viladasens;222;122;100;2023
17;Girona;218;Vilademuls;842;434;408;2023
17;Girona;220;Viladrau;1133;568;565;2023
17;Girona;221;Vilafant;5642;2789;2853;2023
17;Girona;223;Vilajuïga;1153;572;581;2023
17;Girona;224;Vilallonga de Ter;399;218;181;2023
17;Girona;225;Vilamacolum;379;214;165;2023
17;Girona;226;Vilamalla;1188;601;587;2023
17;Girona;227;Vilamaniscle;198;112;86;2023
17;Girona;228;Vilanant;413;201;212;2023
17;Girona;230;Vila-sacra;785;376;409;2023
17;Girona;222;Vilaür;167;88;79;2023
17;Girona;233;Vilobí d'Onyar;3278;1704;1574;2023
17;Girona;232;Vilopriu;200;104;96;2023
18;Granada;001;Agrón;239;126;113;2023
18;Granada;002;Alamedilla;562;288;274;2023
18;Granada;003;Albolote;19474;9531;9943;2023
18;Granada;004;Albondón;735;400;335;2023
18;Granada;005;Albuñán;419;215;204;2023
18;Granada;006;Albuñol;7391;4089;3302;2023
18;Granada;007;Albuñuelas;785;394;391;2023
18;Granada;010;Aldeire;594;306;288;2023
18;Granada;011;Alfacar;5688;2893;2795;2023
18;Granada;012;Algarinejo;2396;1229;1167;2023
18;Granada;013;Alhama de Granada;5655;2939;2716;2023
18;Granada;014;Alhendín;10216;5154;5062;2023
18;Granada;015;Alicún de Ortega;450;227;223;2023
18;Granada;016;Almegíjar;335;165;170;2023
18;Granada;017;Almuñécar;27305;13593;13712;2023
18;Granada;904;Alpujarra de la Sierra;940;522;418;2023
18;Granada;018;Alquife;581;297;284;2023
18;Granada;020;Arenas del Rey;617;325;292;2023
18;Granada;021;Armilla;25059;12357;12702;2023
18;Granada;022;Atarfe;20024;10034;9990;2023
18;Granada;023;Baza;20579;10198;10381;2023
18;Granada;024;Beas de Granada;992;522;470;2023
18;Granada;025;Beas de Guadix;315;160;155;2023
18;Granada;027;Benalúa;3324;1631;1693;2023
18;Granada;028;Benalúa de las Villas;1030;541;489;2023
18;Granada;029;Benamaurel;2250;1122;1128;2023
18;Granada;030;Bérchules;690;379;311;2023
18;Granada;032;Bubión;309;163;146;2023
18;Granada;033;Busquístar;319;163;156;2023
18;Granada;034;Cacín;527;277;250;2023
18;Granada;035;Cádiar;1539;816;723;2023
18;Granada;036;Cájar;5447;2691;2756;2023
18;Granada;114;Calahorra, La;683;350;333;2023
18;Granada;037;Calicasas;650;322;328;2023
18;Granada;038;Campotéjar;1250;623;627;2023
18;Granada;039;Caniles;3910;1993;1917;2023
18;Granada;040;Cáñar;397;211;186;2023
18;Granada;042;Capileira;582;287;295;2023
18;Granada;043;Carataunas;234;125;109;2023
18;Granada;044;Cástaras;224;132;92;2023
18;Granada;045;Castilléjar;1288;679;609;2023
18;Granada;046;Castril;1992;1038;954;2023
18;Granada;047;Cenes de la Vega;8231;4107;4124;2023
18;Granada;059;Chauchina;5679;2800;2879;2023
18;Granada;061;Chimeneas;1238;650;588;2023
18;Granada;062;Churriana de la Vega;16445;8097;8348;2023
18;Granada;048;Cijuela;3630;1841;1789;2023
18;Granada;049;Cogollos de Guadix;658;376;282;2023
18;Granada;050;Cogollos de la Vega;2064;1056;1008;2023
18;Granada;051;Colomera;1290;679;611;2023
18;Granada;053;Cortes de Baza;1810;904;906;2023
18;Granada;054;Cortes y Graena;977;511;466;2023
18;Granada;912;Cuevas del Campo;1793;891;902;2023
18;Granada;056;Cúllar;3965;1979;1986;2023
18;Granada;057;Cúllar Vega;7770;3935;3835;2023
18;Granada;063;Darro;1658;846;812;2023
18;Granada;064;Dehesas de Guadix;395;194;201;2023
18;Granada;065;Dehesas Viejas;650;333;317;2023
18;Granada;066;Deifontes;2624;1321;1303;2023
18;Granada;067;Diezma;799;434;365;2023
18;Granada;068;Dílar;2264;1138;1126;2023
18;Granada;069;Dólar;624;333;291;2023
18;Granada;915;Domingo Pérez de Granada;836;443;393;2023
18;Granada;070;Dúdar;378;200;178;2023
18;Granada;071;Dúrcal;7233;3635;3598;2023
18;Granada;072;Escúzar;841;443;398;2023
18;Granada;074;Ferreira;317;165;152;2023
18;Granada;076;Fonelas;987;523;464;2023
18;Granada;077;Fornes;543;287;256;2023
18;Granada;078;Freila;894;469;425;2023
18;Granada;079;Fuente Vaqueros;4594;2298;2296;2023
18;Granada;905;Gabias, Las;22829;11520;11309;2023
18;Granada;082;Galera;1108;556;552;2023
18;Granada;083;Gobernador;252;128;124;2023
18;Granada;084;Gójar;6203;3129;3074;2023
18;Granada;085;Gor;757;393;364;2023
18;Granada;086;Gorafe;382;197;185;2023
18;Granada;087;Granada;230595;106426;124169;2023
18;Granada;088;Guadahortuna;1816;930;886;2023
18;Granada;089;Guadix;18527;9211;9316;2023
18;Granada;906;Guájares, Los;1157;625;532;2023
18;Granada;093;Gualchos;5308;2823;2485;2023
18;Granada;094;Güéjar Sierra;2909;1546;1363;2023
18;Granada;095;Güevéjar;2677;1390;1287;2023
18;Granada;096;Huélago;365;189;176;2023
18;Granada;097;Huéneja;1192;643;549;2023
18;Granada;098;Huéscar;7220;3576;3644;2023
18;Granada;099;Huétor de Santillán;1929;987;942;2023
18;Granada;100;Huétor Tájar;10673;5381;5292;2023
18;Granada;101;Huétor Vega;12159;6076;6083;2023
18;Granada;102;Íllora;9951;5041;4910;2023
18;Granada;103;Ítrabo;960;473;487;2023
18;Granada;105;Iznalloz;5161;2641;2520;2023
18;Granada;106;Játar;582;318;264;2023
18;Granada;107;Jayena;993;519;474;2023
18;Granada;108;Jérez del Marquesado;983;494;489;2023
18;Granada;109;Jete;994;526;468;2023
18;Granada;111;Jun;4061;2066;1995;2023
18;Granada;112;Juviles;146;78;68;2023
18;Granada;115;Láchar;3755;1902;1853;2023
18;Granada;116;Lanjarón;3664;1835;1829;2023
18;Granada;117;Lanteira;555;297;258;2023
18;Granada;119;Lecrín;2258;1141;1117;2023
18;Granada;120;Lentegí;339;170;169;2023
18;Granada;121;Lobras;149;73;76;2023
18;Granada;122;Loja;20580;10271;10309;2023
18;Granada;123;Lugros;305;156;149;2023
18;Granada;124;Lújar;480;263;217;2023
18;Granada;126;Malahá, La;1845;924;921;2023
18;Granada;127;Maracena;22275;10855;11420;2023
18;Granada;128;Marchal;411;194;217;2023
18;Granada;132;Moclín;3558;1781;1777;2023
18;Granada;133;Molvízar;2752;1423;1329;2023
18;Granada;134;Monachil;8349;4236;4113;2023
18;Granada;135;Montefrío;5376;2812;2564;2023
18;Granada;136;Montejícar;2039;1051;988;2023
18;Granada;137;Montillana;1069;575;494;2023
18;Granada;138;Moraleda de Zafayona;3130;1579;1551;2023
18;Granada;909;Morelábor;585;313;272;2023
18;Granada;140;Motril;58939;28877;30062;2023
18;Granada;141;Murtas;458;257;201;2023
18;Granada;903;Nevada;1105;572;533;2023
18;Granada;143;Nigüelas;1228;625;603;2023
18;Granada;144;Nívar;1093;561;532;2023
18;Granada;145;Ogíjares;14803;7312;7491;2023
18;Granada;146;Orce;1147;559;588;2023
18;Granada;147;Órgiva;5709;2853;2856;2023
18;Granada;148;Otívar;1034;539;495;2023
18;Granada;150;Padul;9436;4716;4720;2023
18;Granada;151;Pampaneira;310;157;153;2023
18;Granada;152;Pedro Martínez;1160;579;581;2023
18;Granada;153;Peligros;11676;5752;5924;2023
18;Granada;154;Peza, La;1128;583;545;2023
18;Granada;910;Pinar, El;867;459;408;2023
18;Granada;157;Pinos Genil;1595;816;779;2023
18;Granada;158;Pinos Puente;9664;4827;4837;2023
18;Granada;159;Píñar;1099;597;502;2023
18;Granada;161;Polícar;274;147;127;2023
18;Granada;162;Polopos;1644;901;743;2023
18;Granada;163;Pórtugos;388;199;189;2023
18;Granada;164;Puebla de Don Fadrique;2207;1125;1082;2023
18;Granada;165;Pulianas;5559;2774;2785;2023
18;Granada;167;Purullena;2313;1166;1147;2023
18;Granada;168;Quéntar;956;498;458;2023
18;Granada;170;Rubite;406;234;172;2023
18;Granada;171;Salar;2617;1312;1305;2023
18;Granada;173;Salobreña;12562;6248;6314;2023
18;Granada;174;Santa Cruz del Comercio;530;274;256;2023
18;Granada;175;Santa Fe;15105;7430;7675;2023
18;Granada;176;Soportújar;283;154;129;2023
18;Granada;177;Sorvilán;524;287;237;2023
18;Granada;901;Taha, La;769;377;392;2023
18;Granada;178;Torre-Cardela;736;389;347;2023
18;Granada;916;Torrenueva Costa;3115;1646;1469;2023
18;Granada;179;Torvizcón;618;326;292;2023
18;Granada;180;Trevélez;702;370;332;2023
18;Granada;181;Turón;219;131;88;2023
18;Granada;182;Ugíjar;2574;1284;1290;2023
18;Granada;914;Valderrubio;2060;1021;1039;2023
18;Granada;907;Valle del Zalabí;2116;1072;1044;2023
18;Granada;902;Valle, El;936;475;461;2023
18;Granada;183;Válor;676;356;320;2023
18;Granada;911;Vegas del Genil;12165;6165;6000;2023
18;Granada;184;Vélez de Benaudalla;3013;1542;1471;2023
18;Granada;185;Ventas de Huelma;651;362;289;2023
18;Granada;149;Villa de Otura;7466;3759;3707;2023
18;Granada;908;Villamena;986;510;476;2023
18;Granada;187;Villanueva de las Torres;527;292;235;2023
18;Granada;188;Villanueva Mesía;2009;975;1034;2023
18;Granada;189;Víznar;1003;524;479;2023
18;Granada;192;Zafarraya;2157;1163;994;2023
18;Granada;913;Zagra;865;447;418;2023
18;Granada;193;Zubia, La;19885;9831;10054;2023
18;Granada;194;Zújar;2568;1307;1261;2023
19;Guadalajara;001;Abánades;62;38;24;2023
19;Guadalajara;002;Ablanque;66;42;24;2023
19;Guadalajara;003;Adobes;30;18;12;2023
19;Guadalajara;004;Alaminos;62;32;30;2023
19;Guadalajara;005;Alarilla;138;84;54;2023
19;Guadalajara;006;Albalate de Zorita;1132;629;503;2023
19;Guadalajara;007;Albares;523;266;257;2023
19;Guadalajara;008;Albendiego;45;30;15;2023
19;Guadalajara;009;Alcocer;336;168;168;2023
19;Guadalajara;010;Alcolea de las Peñas;12;8;4;2023
19;Guadalajara;011;Alcolea del Pinar;329;192;137;2023
19;Guadalajara;013;Alcoroches;131;81;50;2023
19;Guadalajara;015;Aldeanueva de Guadalajara;104;63;41;2023
19;Guadalajara;016;Algar de Mesa;46;33;13;2023
19;Guadalajara;017;Algora;98;58;40;2023
19;Guadalajara;018;Alhóndiga;169;100;69;2023
19;Guadalajara;019;Alique;14;6;8;2023
19;Guadalajara;020;Almadrones;55;38;17;2023
19;Guadalajara;021;Almoguera;1415;715;700;2023
19;Guadalajara;022;Almonacid de Zorita;638;325;313;2023
19;Guadalajara;023;Alocén;154;80;74;2023
19;Guadalajara;024;Alovera;13407;6809;6598;2023
19;Guadalajara;027;Alustante;131;74;57;2023
19;Guadalajara;031;Angón;7;6;1;2023
19;Guadalajara;032;Anguita;157;82;75;2023
19;Guadalajara;033;Anquela del Ducado;56;31;25;2023
19;Guadalajara;034;Anquela del Pedregal;27;17;10;2023
19;Guadalajara;036;Aranzueque;381;200;181;2023
19;Guadalajara;037;Arbancón;145;84;61;2023
19;Guadalajara;038;Arbeteta;19;15;4;2023
19;Guadalajara;039;Argecilla;70;50;20;2023
19;Guadalajara;040;Armallones;55;31;24;2023
19;Guadalajara;041;Armuña de Tajuña;269;133;136;2023
19;Guadalajara;042;Arroyo de las Fraguas;33;18;15;2023
19;Guadalajara;043;Atanzón;94;64;30;2023
19;Guadalajara;044;Atienza;434;251;183;2023
19;Guadalajara;045;Auñón;146;78;68;2023
19;Guadalajara;046;Azuqueca de Henares;35498;17878;17620;2023
19;Guadalajara;047;Baides;56;27;29;2023
19;Guadalajara;048;Baños de Tajo;15;10;5;2023
19;Guadalajara;049;Bañuelos;13;11;2;2023
19;Guadalajara;050;Barriopedro;20;12;8;2023
19;Guadalajara;051;Berninches;50;35;15;2023
19;Guadalajara;052;Bodera, La;21;14;7;2023
19;Guadalajara;053;Brihuega;2734;1416;1318;2023
19;Guadalajara;054;Budia;208;122;86;2023
19;Guadalajara;055;Bujalaro;47;23;24;2023
19;Guadalajara;057;Bustares;68;41;27;2023
19;Guadalajara;058;Cabanillas del Campo;11034;5550;5484;2023
19;Guadalajara;059;Campillo de Dueñas;76;46;30;2023
19;Guadalajara;060;Campillo de Ranas;155;95;60;2023
19;Guadalajara;061;Campisábalos;84;58;26;2023
19;Guadalajara;064;Canredondo;87;55;32;2023
19;Guadalajara;065;Cantalojas;126;69;57;2023
19;Guadalajara;066;Cañizar;71;42;29;2023
19;Guadalajara;067;Cardoso de la Sierra, El;55;34;21;2023
19;Guadalajara;070;Casa de Uceda;100;60;40;2023
19;Guadalajara;071;Casar, El;13327;6736;6591;2023
19;Guadalajara;073;Casas de San Galindo;19;14;5;2023
19;Guadalajara;074;Caspueñas;138;83;55;2023
19;Guadalajara;075;Castejón de Henares;61;38;23;2023
19;Guadalajara;076;Castellar de la Muela;23;13;10;2023
19;Guadalajara;078;Castilforte;58;35;23;2023
19;Guadalajara;079;Castilnuevo;8;6;2;2023
19;Guadalajara;080;Cendejas de Enmedio;69;38;31;2023
19;Guadalajara;081;Cendejas de la Torre;23;17;6;2023
19;Guadalajara;082;Centenera;147;85;62;2023
19;Guadalajara;103;Checa;285;164;121;2023
19;Guadalajara;104;Chequilla;14;8;6;2023
19;Guadalajara;106;Chillarón del Rey;85;50;35;2023
19;Guadalajara;105;Chiloeches;3977;2063;1914;2023
19;Guadalajara;086;Cifuentes;1682;865;817;2023
19;Guadalajara;087;Cincovillas;23;13;10;2023
19;Guadalajara;088;Ciruelas;141;77;64;2023
19;Guadalajara;089;Ciruelos del Pinar;29;17;12;2023
19;Guadalajara;090;Cobeta;101;49;52;2023
19;Guadalajara;091;Cogollor;21;14;7;2023
19;Guadalajara;092;Cogolludo;561;324;237;2023
19;Guadalajara;095;Condemios de Abajo;12;10;2;2023
19;Guadalajara;096;Condemios de Arriba;116;67;49;2023
19;Guadalajara;097;Congostrina;13;10;3;2023
19;Guadalajara;098;Copernal;38;24;14;2023
19;Guadalajara;099;Corduente;310;175;135;2023
19;Guadalajara;102;Cubillo de Uceda, El;118;70;48;2023
19;Guadalajara;107;Driebes;349;199;150;2023
19;Guadalajara;108;Durón;115;62;53;2023
19;Guadalajara;109;Embid;30;18;12;2023
19;Guadalajara;110;Escamilla;64;41;23;2023
19;Guadalajara;111;Escariche;188;117;71;2023
19;Guadalajara;112;Escopete;68;36;32;2023
19;Guadalajara;113;Espinosa de Henares;663;340;323;2023
19;Guadalajara;114;Esplegares;37;21;16;2023
19;Guadalajara;115;Establés;29;18;11;2023
19;Guadalajara;116;Estriégana;12;9;3;2023
19;Guadalajara;117;Fontanar;2637;1379;1258;2023
19;Guadalajara;118;Fuembellida;11;7;4;2023
19;Guadalajara;119;Fuencemillán;84;53;31;2023
19;Guadalajara;120;Fuentelahiguera de Albatages;109;65;44;2023
19;Guadalajara;121;Fuentelencina;324;175;149;2023
19;Guadalajara;122;Fuentelsaz;90;46;44;2023
19;Guadalajara;123;Fuentelviejo;53;32;21;2023
19;Guadalajara;124;Fuentenovilla;587;325;262;2023
19;Guadalajara;125;Gajanejos;61;37;24;2023
19;Guadalajara;126;Galápagos;2673;1386;1287;2023
19;Guadalajara;127;Galve de Sorbe;96;53;43;2023
19;Guadalajara;129;Gascueña de Bornova;31;21;10;2023
19;Guadalajara;130;Guadalajara;89010;42787;46223;2023
19;Guadalajara;132;Henche;85;44;41;2023
19;Guadalajara;133;Heras de Ayuso;224;129;95;2023
19;Guadalajara;134;Herrería;20;12;8;2023
19;Guadalajara;135;Hiendelaencina;115;69;46;2023
19;Guadalajara;136;Hijes;20;11;9;2023
19;Guadalajara;138;Hita;319;177;142;2023
19;Guadalajara;139;Hombrados;51;28;23;2023
19;Guadalajara;142;Hontoba;431;242;189;2023
19;Guadalajara;143;Horche;2778;1396;1382;2023
19;Guadalajara;145;Hortezuela de Océn;37;21;16;2023
19;Guadalajara;146;Huerce, La;56;34;22;2023
19;Guadalajara;147;Huérmeces del Cerro;41;29;12;2023
19;Guadalajara;148;Huertahernando;56;37;19;2023
19;Guadalajara;150;Hueva;112;68;44;2023
19;Guadalajara;151;Humanes;1724;880;844;2023
19;Guadalajara;152;Illana;878;481;397;2023
19;Guadalajara;153;Iniéstola;18;13;5;2023
19;Guadalajara;154;Inviernas, Las;58;40;18;2023
19;Guadalajara;155;Irueste;68;45;23;2023
19;Guadalajara;156;Jadraque;1417;742;675;2023
19;Guadalajara;157;Jirueque;49;32;17;2023
19;Guadalajara;159;Ledanca;105;52;53;2023
19;Guadalajara;160;Loranca de Tajuña;1509;834;675;2023
19;Guadalajara;161;Lupiana;293;158;135;2023
19;Guadalajara;162;Luzaga;68;37;31;2023
19;Guadalajara;163;Luzón;64;31;33;2023
19;Guadalajara;165;Majaelrayo;53;36;17;2023
19;Guadalajara;166;Málaga del Fresno;172;102;70;2023
19;Guadalajara;167;Malaguilla;193;108;85;2023
19;Guadalajara;168;Mandayona;300;149;151;2023
19;Guadalajara;169;Mantiel;29;18;11;2023
19;Guadalajara;170;Maranchón;213;112;101;2023
19;Guadalajara;171;Marchamalo;8273;4145;4128;2023
19;Guadalajara;172;Masegoso de Tajuña;74;41;33;2023
19;Guadalajara;173;Matarrubia;70;46;24;2023
19;Guadalajara;174;Matillas;104;56;48;2023
19;Guadalajara;175;Mazarete;27;15;12;2023
19;Guadalajara;176;Mazuecos;312;175;137;2023
19;Guadalajara;177;Medranda;68;33;35;2023
19;Guadalajara;178;Megina;31;20;11;2023
19;Guadalajara;179;Membrillera;95;58;37;2023
19;Guadalajara;181;Miedes de Atienza;58;38;20;2023
19;Guadalajara;182;Mierla, La;40;24;16;2023
19;Guadalajara;184;Millana;113;67;46;2023
19;Guadalajara;183;Milmarcos;70;40;30;2023
19;Guadalajara;185;Miñosa, La;30;17;13;2023
19;Guadalajara;186;Mirabueno;90;52;38;2023
19;Guadalajara;187;Miralrío;56;34;22;2023
19;Guadalajara;188;Mochales;40;19;21;2023
19;Guadalajara;189;Mohernando;172;97;75;2023
19;Guadalajara;190;Molina de Aragón;3288;1626;1662;2023
19;Guadalajara;191;Monasterio;15;7;8;2023
19;Guadalajara;192;Mondéjar;2839;1478;1361;2023
19;Guadalajara;193;Montarrón;30;19;11;2023
19;Guadalajara;194;Moratilla de los Meleros;107;59;48;2023
19;Guadalajara;195;Morenilla;53;28;25;2023
19;Guadalajara;196;Muduex;109;60;49;2023
19;Guadalajara;197;Navas de Jadraque, Las;35;22;13;2023
19;Guadalajara;198;Negredo;13;6;7;2023
19;Guadalajara;199;Ocentejo;16;11;5;2023
19;Guadalajara;200;Olivar, El;87;44;43;2023
19;Guadalajara;201;Olmeda de Cobeta;61;31;30;2023
19;Guadalajara;202;Olmeda de Jadraque, La;19;12;7;2023
19;Guadalajara;203;Ordial, El;35;23;12;2023
19;Guadalajara;204;Orea;196;114;82;2023
19;Guadalajara;208;Pálmaces de Jadraque;46;31;15;2023
19;Guadalajara;209;Pardos;37;22;15;2023
19;Guadalajara;210;Paredes de Sigüenza;26;13;13;2023
19;Guadalajara;211;Pareja;464;277;187;2023
19;Guadalajara;212;Pastrana;901;445;456;2023
19;Guadalajara;213;Pedregal, El;63;43;20;2023
19;Guadalajara;214;Peñalén;79;44;35;2023
19;Guadalajara;215;Peñalver;181;111;70;2023
19;Guadalajara;216;Peralejos de las Truchas;158;78;80;2023
19;Guadalajara;217;Peralveche;83;59;24;2023
19;Guadalajara;218;Pinilla de Jadraque;51;34;17;2023
19;Guadalajara;219;Pinilla de Molina;11;10;1;2023
19;Guadalajara;220;Pioz;5131;2661;2470;2023
19;Guadalajara;221;Piqueras;36;26;10;2023
19;Guadalajara;222;Pobo de Dueñas, El;100;53;47;2023
19;Guadalajara;223;Poveda de la Sierra;113;63;50;2023
19;Guadalajara;224;Pozo de Almoguera;113;67;46;2023
19;Guadalajara;225;Pozo de Guadalajara;1626;875;751;2023
19;Guadalajara;226;Prádena de Atienza;56;39;17;2023
19;Guadalajara;227;Prados Redondos;50;39;11;2023
19;Guadalajara;228;Puebla de Beleña;52;36;16;2023
19;Guadalajara;229;Puebla de Valles;67;37;30;2023
19;Guadalajara;230;Quer;1031;547;484;2023
19;Guadalajara;231;Rebollosa de Jadraque;10;6;4;2023
19;Guadalajara;232;Recuenco, El;71;43;28;2023
19;Guadalajara;233;Renera;102;68;34;2023
19;Guadalajara;234;Retiendas;54;35;19;2023
19;Guadalajara;235;Riba de Saelices;103;60;43;2023
19;Guadalajara;237;Rillo de Gallo;44;26;18;2023
19;Guadalajara;238;Riofrío del Llano;64;38;26;2023
19;Guadalajara;239;Robledillo de Mohernando;178;106;72;2023
19;Guadalajara;240;Robledo de Corpes;45;24;21;2023
19;Guadalajara;241;Romanillos de Atienza;31;22;9;2023
19;Guadalajara;242;Romanones;116;64;52;2023
19;Guadalajara;243;Rueda de la Sierra;38;27;11;2023
19;Guadalajara;244;Sacecorbo;102;66;36;2023
19;Guadalajara;245;Sacedón;1566;803;763;2023
19;Guadalajara;246;Saelices de la Sal;47;28;19;2023
19;Guadalajara;247;Salmerón;144;80;64;2023
19;Guadalajara;248;San Andrés del Congosto;75;48;27;2023
19;Guadalajara;249;San Andrés del Rey;39;21;18;2023
19;Guadalajara;250;Santiuste;15;11;4;2023
19;Guadalajara;251;Saúca;47;25;22;2023
19;Guadalajara;252;Sayatón;63;35;28;2023
19;Guadalajara;254;Selas;36;18;18;2023
19;Guadalajara;901;Semillas;30;19;11;2023
19;Guadalajara;255;Setiles;81;47;34;2023
19;Guadalajara;256;Sienes;45;26;19;2023
19;Guadalajara;257;Sigüenza;4708;2428;2280;2023
19;Guadalajara;258;Solanillos del Extremo;86;58;28;2023
19;Guadalajara;259;Somolinos;27;14;13;2023
19;Guadalajara;260;Sotillo, El;34;17;17;2023
19;Guadalajara;261;Sotodosos;30;17;13;2023
19;Guadalajara;262;Tamajón;148;83;65;2023
19;Guadalajara;263;Taragudo;52;33;19;2023
19;Guadalajara;264;Taravilla;42;27;15;2023
19;Guadalajara;265;Tartanedo;162;90;72;2023
19;Guadalajara;266;Tendilla;312;167;145;2023
19;Guadalajara;267;Terzaga;19;11;8;2023
19;Guadalajara;268;Tierzo;37;19;18;2023
19;Guadalajara;269;Toba, La;74;51;23;2023
19;Guadalajara;271;Tordellego;43;23;20;2023
19;Guadalajara;270;Tordelrábano;16;12;4;2023
19;Guadalajara;272;Tordesilos;92;51;41;2023
19;Guadalajara;274;Torija;1725;889;836;2023
19;Guadalajara;279;Torre del Burgo;467;268;199;2023
19;Guadalajara;277;Torrecuadrada de Molina;19;13;6;2023
19;Guadalajara;278;Torrecuadradilla;29;17;12;2023
19;Guadalajara;280;Torrejón del Rey;6210;3236;2974;2023
19;Guadalajara;281;Torremocha de Jadraque;20;12;8;2023
19;Guadalajara;282;Torremocha del Campo;191;111;80;2023
19;Guadalajara;283;Torremocha del Pinar;35;18;17;2023
19;Guadalajara;284;Torremochuela;6;5;1;2023
19;Guadalajara;285;Torrubia;23;15;8;2023
19;Guadalajara;286;Tórtola de Henares;1382;733;649;2023
19;Guadalajara;287;Tortuera;169;86;83;2023
19;Guadalajara;288;Tortuero;20;15;5;2023
19;Guadalajara;289;Traíd;22;14;8;2023
19;Guadalajara;290;Trijueque;1560;824;736;2023
19;Guadalajara;291;Trillo;1388;736;652;2023
19;Guadalajara;293;Uceda;3143;1619;1524;2023
19;Guadalajara;294;Ujados;25;12;13;2023
19;Guadalajara;296;Utande;33;25;8;2023
19;Guadalajara;297;Valdarachas;46;23;23;2023
19;Guadalajara;298;Valdearenas;87;50;37;2023
19;Guadalajara;299;Valdeavellano;108;59;49;2023
19;Guadalajara;300;Valdeaveruelo;1206;621;585;2023
19;Guadalajara;301;Valdeconcha;47;30;17;2023
19;Guadalajara;302;Valdegrudas;51;34;17;2023
19;Guadalajara;303;Valdelcubo;38;25;13;2023
19;Guadalajara;304;Valdenuño Fernández;335;183;152;2023
19;Guadalajara;305;Valdepeñas de la Sierra;146;88;58;2023
19;Guadalajara;306;Valderrebollo;29;16;13;2023
19;Guadalajara;307;Valdesotos;29;19;10;2023
19;Guadalajara;308;Valfermoso de Tajuña;85;52;33;2023
19;Guadalajara;309;Valhermoso;21;14;7;2023
19;Guadalajara;310;Valtablado del Río;8;5;3;2023
19;Guadalajara;311;Valverde de los Arroyos;91;52;39;2023
19;Guadalajara;314;Viana de Jadraque;39;25;14;2023
19;Guadalajara;317;Villanueva de Alcorón;140;82;58;2023
19;Guadalajara;318;Villanueva de Argecilla;34;19;15;2023
19;Guadalajara;319;Villanueva de la Torre;6603;3344;3259;2023
19;Guadalajara;321;Villares de Jadraque;46;31;15;2023
19;Guadalajara;322;Villaseca de Henares;24;15;9;2023
19;Guadalajara;323;Villaseca de Uceda;49;28;21;2023
19;Guadalajara;324;Villel de Mesa;164;97;67;2023
19;Guadalajara;325;Viñuelas;186;96;90;2023
19;Guadalajara;326;Yebes;5220;2674;2546;2023
19;Guadalajara;327;Yebra;490;266;224;2023
19;Guadalajara;329;Yélamos de Abajo;59;27;32;2023
19;Guadalajara;330;Yélamos de Arriba;84;50;34;2023
19;Guadalajara;331;Yunquera de Henares;4429;2264;2165;2023
19;Guadalajara;332;Yunta, La;94;53;41;2023
19;Guadalajara;333;Zaorejas;112;75;37;2023
19;Guadalajara;334;Zarzuela de Jadraque;60;39;21;2023
19;Guadalajara;335;Zorita de los Canes;58;34;24;2023
21;Huelva;001;Alájar;780;400;380;2023
21;Huelva;002;Aljaraque;22259;11095;11164;2023
21;Huelva;003;Almendro, El;848;435;413;2023
21;Huelva;004;Almonaster la Real;1793;940;853;2023
21;Huelva;005;Almonte;25233;12515;12718;2023
21;Huelva;006;Alosno;3971;1963;2008;2023
21;Huelva;007;Aracena;8340;4118;4222;2023
21;Huelva;008;Aroche;3030;1510;1520;2023
21;Huelva;009;Arroyomolinos de León;943;474;469;2023
21;Huelva;010;Ayamonte;21645;10848;10797;2023
21;Huelva;011;Beas;4359;2179;2180;2023
21;Huelva;012;Berrocal;296;154;142;2023
21;Huelva;013;Bollullos Par del Condado;14263;7065;7198;2023
21;Huelva;014;Bonares;6101;3021;3080;2023
21;Huelva;015;Cabezas Rubias;704;369;335;2023
21;Huelva;016;Cala;1140;574;566;2023
21;Huelva;017;Calañas;2754;1396;1358;2023
21;Huelva;018;Campillo, El;2015;984;1031;2023
21;Huelva;019;Campofrío;745;378;367;2023
21;Huelva;020;Cañaveral de León;382;198;184;2023
21;Huelva;021;Cartaya;21128;10762;10366;2023
21;Huelva;022;Castaño del Robledo;222;125;97;2023
21;Huelva;023;Cerro de Andévalo, El;2272;1138;1134;2023
21;Huelva;030;Chucena;2235;1121;1114;2023
21;Huelva;024;Corteconcepción;563;295;268;2023
21;Huelva;025;Cortegana;4649;2346;2303;2023
21;Huelva;026;Cortelazor;299;144;155;2023
21;Huelva;027;Cumbres de Enmedio;63;35;28;2023
21;Huelva;028;Cumbres de San Bartolomé;366;190;176;2023
21;Huelva;029;Cumbres Mayores;1731;857;874;2023
21;Huelva;031;Encinasola;1269;640;629;2023
21;Huelva;032;Escacena del Campo;2325;1121;1204;2023
21;Huelva;033;Fuenteheridos;806;419;387;2023
21;Huelva;034;Galaroza;1381;692;689;2023
21;Huelva;035;Gibraleón;12940;6489;6451;2023
21;Huelva;036;Granada de Río-Tinto, La;247;121;126;2023
21;Huelva;037;Granado, El;498;258;240;2023
21;Huelva;038;Higuera de la Sierra;1306;677;629;2023
21;Huelva;039;Hinojales;329;165;164;2023
21;Huelva;040;Hinojos;4094;2066;2028;2023
21;Huelva;041;Huelva;142532;68375;74157;2023
21;Huelva;042;Isla Cristina;21603;10867;10736;2023
21;Huelva;043;Jabugo;2208;1109;1099;2023
21;Huelva;044;Lepe;28813;14879;13934;2023
21;Huelva;045;Linares de la Sierra;283;136;147;2023
21;Huelva;046;Lucena del Puerto;3278;1736;1542;2023
21;Huelva;047;Manzanilla;2147;1097;1050;2023
21;Huelva;048;Marines, Los;416;217;199;2023
21;Huelva;049;Minas de Riotinto;3703;1775;1928;2023
21;Huelva;050;Moguer;22956;11579;11377;2023
21;Huelva;051;Nava, La;259;136;123;2023
21;Huelva;052;Nerva;5081;2455;2626;2023
21;Huelva;053;Niebla;4244;2129;2115;2023
21;Huelva;054;Palma del Condado, La;10726;5344;5382;2023
21;Huelva;055;Palos de la Frontera;12537;6446;6091;2023
21;Huelva;056;Paterna del Campo;3465;1768;1697;2023
21;Huelva;057;Paymogo;1137;570;567;2023
21;Huelva;058;Puebla de Guzmán;3115;1600;1515;2023
21;Huelva;059;Puerto Moral;282;138;144;2023
21;Huelva;060;Punta Umbría;16069;8161;7908;2023
21;Huelva;061;Rociana del Condado;8048;3968;4080;2023
21;Huelva;062;Rosal de la Frontera;1665;811;854;2023
21;Huelva;063;San Bartolomé de la Torre;3997;2035;1962;2023
21;Huelva;064;San Juan del Puerto;9659;4856;4803;2023
21;Huelva;066;San Silvestre de Guzmán;662;343;319;2023
21;Huelva;065;Sanlúcar de Guadiana;422;209;213;2023
21;Huelva;067;Santa Ana la Real;475;223;252;2023
21;Huelva;068;Santa Bárbara de Casa;1102;548;554;2023
21;Huelva;069;Santa Olalla del Cala;2038;1038;1000;2023
21;Huelva;070;Trigueros;7989;3950;4039;2023
21;Huelva;071;Valdelarco;243;118;125;2023
21;Huelva;072;Valverde del Camino;12655;6230;6425;2023
21;Huelva;073;Villablanca;2921;1472;1449;2023
21;Huelva;074;Villalba del Alcor;3335;1633;1702;2023
21;Huelva;075;Villanueva de las Cruces;393;192;201;2023
21;Huelva;076;Villanueva de los Castillejos;2953;1500;1453;2023
21;Huelva;077;Villarrasa;2148;1077;1071;2023
21;Huelva;078;Zalamea la Real;2973;1488;1485;2023
21;Huelva;902;Zarza-Perrunal, La;1215;613;602;2023
21;Huelva;079;Zufre;753;394;359;2023
22;Huesca;001;Abiego;261;134;127;2023
22;Huesca;002;Abizanda;162;87;75;2023
22;Huesca;003;Adahuesca;210;118;92;2023
22;Huesca;004;Agüero;143;82;61;2023
22;Huesca;907;Aínsa-Sobrarbe;2297;1161;1136;2023
22;Huesca;006;Aisa;324;175;149;2023
22;Huesca;007;Albalate de Cinca;1138;630;508;2023
22;Huesca;008;Albalatillo;200;111;89;2023
22;Huesca;009;Albelda;702;357;345;2023
22;Huesca;011;Albero Alto;125;72;53;2023
22;Huesca;012;Albero Bajo;130;72;58;2023
22;Huesca;013;Alberuela de Tubo;308;159;149;2023
22;Huesca;014;Alcalá de Gurrea;231;120;111;2023
22;Huesca;015;Alcalá del Obispo;370;210;160;2023
22;Huesca;016;Alcampell;624;293;331;2023
22;Huesca;017;Alcolea de Cinca;1092;573;519;2023
22;Huesca;018;Alcubierre;412;224;188;2023
22;Huesca;019;Alerre;221;121;100;2023
22;Huesca;020;Alfántega;130;66;64;2023
22;Huesca;021;Almudévar;2439;1230;1209;2023
22;Huesca;022;Almunia de San Juan;722;374;348;2023
22;Huesca;023;Almuniente;440;230;210;2023
22;Huesca;024;Alquézar;348;179;169;2023
22;Huesca;025;Altorricón;1429;778;651;2023
22;Huesca;027;Angüés;373;198;175;2023
22;Huesca;028;Ansó;418;206;212;2023
22;Huesca;029;Antillón;133;70;63;2023
22;Huesca;032;Aragüés del Puerto;120;68;52;2023
22;Huesca;035;Arén;308;165;143;2023
22;Huesca;036;Argavieso;119;71;48;2023
22;Huesca;037;Arguis;160;85;75;2023
22;Huesca;039;Ayerbe;1073;530;543;2023
22;Huesca;040;Azanuy-Alins;175;86;89;2023
22;Huesca;041;Azara;170;91;79;2023
22;Huesca;042;Azlor;154;70;84;2023
22;Huesca;043;Baélls;91;53;38;2023
22;Huesca;044;Bailo;262;162;100;2023
22;Huesca;045;Baldellou;90;53;37;2023
22;Huesca;046;Ballobar;879;454;425;2023
22;Huesca;047;Banastás;334;168;166;2023
22;Huesca;048;Barbastro;17295;8436;8859;2023
22;Huesca;049;Barbués;86;52;34;2023
22;Huesca;050;Barbuñales;96;48;48;2023
22;Huesca;051;Bárcabo;117;64;53;2023
22;Huesca;052;Belver de Cinca;1306;750;556;2023
22;Huesca;053;Benabarre;1168;600;568;2023
22;Huesca;054;Benasque;2306;1245;1061;2023
22;Huesca;246;Beranuy;68;41;27;2023
22;Huesca;055;Berbegal;322;170;152;2023
22;Huesca;057;Bielsa;482;253;229;2023
22;Huesca;058;Bierge;253;143;110;2023
22;Huesca;059;Biescas;1602;845;757;2023
22;Huesca;060;Binaced;1577;865;712;2023
22;Huesca;061;Binéfar;10070;5320;4750;2023
22;Huesca;062;Bisaurri;183;100;83;2023
22;Huesca;063;Biscarrués;186;97;89;2023
22;Huesca;064;Blecua y Torres;186;100;86;2023
22;Huesca;066;Boltaña;1104;585;519;2023
22;Huesca;067;Bonansa;92;51;41;2023
22;Huesca;068;Borau;87;49;38;2023
22;Huesca;069;Broto;599;327;272;2023
22;Huesca;072;Caldearenas;242;144;98;2023
22;Huesca;074;Campo;463;246;217;2023
22;Huesca;075;Camporrélls;151;78;73;2023
22;Huesca;076;Canal de Berdún;337;184;153;2023
22;Huesca;077;Candasnos;418;227;191;2023
22;Huesca;078;Canfranc;596;334;262;2023
22;Huesca;079;Capdesaso;204;88;116;2023
22;Huesca;080;Capella;360;187;173;2023
22;Huesca;081;Casbas de Huesca;291;167;124;2023
22;Huesca;083;Castejón de Monegros;478;254;224;2023
22;Huesca;084;Castejón de Sos;833;420;413;2023
22;Huesca;082;Castejón del Puente;328;173;155;2023
22;Huesca;085;Castelflorite;102;51;51;2023
22;Huesca;086;Castiello de Jaca;242;134;108;2023
22;Huesca;087;Castigaleu;96;60;36;2023
22;Huesca;088;Castillazuelo;162;84;78;2023
22;Huesca;089;Castillonroy;324;173;151;2023
22;Huesca;094;Chalamera;130;71;59;2023
22;Huesca;095;Chía;92;57;35;2023
22;Huesca;096;Chimillas;396;208;188;2023
22;Huesca;090;Colungo;128;71;57;2023
22;Huesca;099;Esplús;673;350;323;2023
22;Huesca;102;Estada;203;119;84;2023
22;Huesca;103;Estadilla;840;424;416;2023
22;Huesca;105;Estopiñán del Castillo;116;60;56;2023
22;Huesca;106;Fago;26;16;10;2023
22;Huesca;107;Fanlo;113;67;46;2023
22;Huesca;109;Fiscal;386;213;173;2023
22;Huesca;110;Fonz;886;453;433;2023
22;Huesca;111;Foradada del Toscar;158;86;72;2023
22;Huesca;112;Fraga;15373;7858;7515;2023
22;Huesca;113;Fueva, La;600;318;282;2023
22;Huesca;114;Gistaín;122;71;51;2023
22;Huesca;115;Grado, El;391;203;188;2023
22;Huesca;116;Grañén;1731;891;840;2023
22;Huesca;117;Graus;3415;1687;1728;2023
22;Huesca;119;Gurrea de Gállego;1450;746;704;2023
22;Huesca;122;Hoz de Jaca;76;40;36;2023
22;Huesca;908;Hoz y Costean;240;134;106;2023
22;Huesca;124;Huerto;228;123;105;2023
22;Huesca;125;Huesca;54136;25912;28224;2023
22;Huesca;126;Ibieca;108;60;48;2023
22;Huesca;127;Igriés;719;376;343;2023
22;Huesca;128;Ilche;188;97;91;2023
22;Huesca;129;Isábena;233;117;116;2023
22;Huesca;130;Jaca;13620;6658;6962;2023
22;Huesca;131;Jasa;102;61;41;2023
22;Huesca;133;Labuerda;162;84;78;2023
22;Huesca;135;Laluenga;202;107;95;2023
22;Huesca;136;Lalueza;882;459;423;2023
22;Huesca;137;Lanaja;1173;626;547;2023
22;Huesca;139;Laperdiguera;91;46;45;2023
22;Huesca;141;Lascellas-Ponzano;135;83;52;2023
22;Huesca;142;Lascuarre;138;69;69;2023
22;Huesca;143;Laspaúles;234;125;109;2023
22;Huesca;144;Laspuña;279;159;120;2023
22;Huesca;149;Loarre;350;194;156;2023
22;Huesca;150;Loporzano;580;318;262;2023
22;Huesca;151;Loscorrales;99;49;50;2023
22;Huesca;905;Lupiñén-Ortilla;342;173;169;2023
22;Huesca;155;Monesma y Cajigar;66;37;29;2023
22;Huesca;156;Monflorite-Lascasas;468;247;221;2023
22;Huesca;157;Montanuy;241;140;101;2023
22;Huesca;158;Monzón;17839;9020;8819;2023
22;Huesca;160;Naval;265;145;120;2023
22;Huesca;162;Novales;172;79;93;2023
22;Huesca;163;Nueno;574;327;247;2023
22;Huesca;164;Olvena;67;32;35;2023
22;Huesca;165;Ontiñena;519;270;249;2023
22;Huesca;167;Osso de Cinca;638;366;272;2023
22;Huesca;168;Palo;32;16;16;2023
22;Huesca;170;Panticosa;894;474;420;2023
22;Huesca;172;Peñalba;726;424;302;2023
22;Huesca;173;Peñas de Riglos, Las;272;172;100;2023
22;Huesca;174;Peralta de Alcofea;614;308;306;2023
22;Huesca;175;Peralta de Calasanz;272;148;124;2023
22;Huesca;176;Peraltilla;225;107;118;2023
22;Huesca;177;Perarrúa;113;58;55;2023
22;Huesca;178;Pertusa;137;79;58;2023
22;Huesca;181;Piracés;96;48;48;2023
22;Huesca;182;Plan;281;146;135;2023
22;Huesca;184;Poleñino;197;102;95;2023
22;Huesca;186;Pozán de Vero;235;113;122;2023
22;Huesca;187;Puebla de Castro, La;419;219;200;2023
22;Huesca;188;Puente de Montañana;100;48;52;2023
22;Huesca;902;Puente la Reina de Jaca;276;144;132;2023
22;Huesca;189;Puértolas;222;116;106;2023
22;Huesca;190;Pueyo de Araguás, El;173;96;77;2023
22;Huesca;193;Pueyo de Santa Cruz;329;159;170;2023
22;Huesca;195;Quicena;329;157;172;2023
22;Huesca;197;Robres;523;276;247;2023
22;Huesca;199;Sabiñánigo;9423;4703;4720;2023
22;Huesca;200;Sahún;319;158;161;2023
22;Huesca;201;Salas Altas;312;164;148;2023
22;Huesca;202;Salas Bajas;191;95;96;2023
22;Huesca;203;Salillas;104;58;46;2023
22;Huesca;204;Sallent de Gállego;1554;784;770;2023
22;Huesca;205;San Esteban de Litera;620;325;295;2023
22;Huesca;207;San Juan de Plan;154;84;70;2023
22;Huesca;903;San Miguel del Cinca;799;414;385;2023
22;Huesca;206;Sangarrén;211;119;92;2023
22;Huesca;208;Santa Cilia;251;127;124;2023
22;Huesca;209;Santa Cruz de la Serós;192;109;83;2023
22;Huesca;906;Santa María de Dulcis;206;114;92;2023
22;Huesca;212;Santaliestra y San Quílez;77;48;29;2023
22;Huesca;213;Sariñena;4131;2144;1987;2023
22;Huesca;214;Secastilla;148;70;78;2023
22;Huesca;215;Seira;161;92;69;2023
22;Huesca;217;Sena;486;261;225;2023
22;Huesca;218;Senés de Alcubierre;45;21;24;2023
22;Huesca;220;Sesa;157;91;66;2023
22;Huesca;221;Sesué;126;65;61;2023
22;Huesca;222;Siétamo;686;385;301;2023
22;Huesca;223;Sopeira;91;50;41;2023
22;Huesca;904;Sotonera, La;915;489;426;2023
22;Huesca;225;Tamarite de Litera;3393;1756;1637;2023
22;Huesca;226;Tardienta;929;460;469;2023
22;Huesca;227;Tella-Sin;227;127;100;2023
22;Huesca;228;Tierz;823;405;418;2023
22;Huesca;229;Tolva;125;70;55;2023
22;Huesca;230;Torla-Ordesa;312;164;148;2023
22;Huesca;232;Torralba de Aragón;109;63;46;2023
22;Huesca;233;Torre la Ribera;97;50;47;2023
22;Huesca;234;Torrente de Cinca;1121;585;536;2023
22;Huesca;235;Torres de Alcanadre;82;47;35;2023
22;Huesca;236;Torres de Barbués;260;127;133;2023
22;Huesca;239;Tramaced;108;68;40;2023
22;Huesca;242;Valfarta;62;37;25;2023
22;Huesca;243;Valle de Bardají;60;39;21;2023
22;Huesca;901;Valle de Hecho;799;432;367;2023
22;Huesca;244;Valle de Lierp;60;38;22;2023
22;Huesca;245;Velilla de Cinca;497;264;233;2023
22;Huesca;909;Vencillón;408;221;187;2023
22;Huesca;247;Viacamp y Litera;40;25;15;2023
22;Huesca;248;Vicién;139;82;57;2023
22;Huesca;249;Villanova;176;91;85;2023
22;Huesca;250;Villanúa;553;288;265;2023
22;Huesca;251;Villanueva de Sigena;341;188;153;2023
22;Huesca;252;Yebra de Basa;161;95;66;2023
22;Huesca;253;Yésero;63;34;29;2023
22;Huesca;254;Zaidín;1784;926;858;2023
23;Jaén;001;Albanchez de Mágina;958;501;457;2023
23;Jaén;002;Alcalá la Real;21587;10672;10915;2023
23;Jaén;003;Alcaudete;10265;5048;5217;2023
23;Jaén;004;Aldeaquemada;468;245;223;2023
23;Jaén;005;Andújar;35788;17469;18319;2023
23;Jaén;006;Arjona;5349;2633;2716;2023
23;Jaén;007;Arjonilla;3539;1792;1747;2023
23;Jaén;008;Arquillos;1680;852;828;2023
23;Jaén;905;Arroyo del Ojanco;2187;1102;1085;2023
23;Jaén;009;Baeza;15723;7796;7927;2023
23;Jaén;010;Bailén;17211;8535;8676;2023
23;Jaén;011;Baños de la Encina;2558;1305;1253;2023
23;Jaén;012;Beas de Segura;4984;2576;2408;2023
23;Jaén;902;Bedmar y Garcíez;2605;1322;1283;2023
23;Jaén;014;Begíjar;2967;1493;1474;2023
23;Jaén;015;Bélmez de la Moraleda;1525;743;782;2023
23;Jaén;016;Benatae;437;223;214;2023
23;Jaén;017;Cabra del Santo Cristo;1695;885;810;2023
23;Jaén;018;Cambil;2643;1383;1260;2023
23;Jaén;019;Campillo de Arenas;1708;859;849;2023
23;Jaén;020;Canena;1780;935;845;2023
23;Jaén;021;Carboneros;606;311;295;2023
23;Jaén;901;Cárcheles;1300;686;614;2023
23;Jaén;024;Carolina, La;14801;7340;7461;2023
23;Jaén;025;Castellar;3173;1610;1563;2023
23;Jaén;026;Castillo de Locubín;3901;1930;1971;2023
23;Jaén;027;Cazalilla;738;368;370;2023
23;Jaén;028;Cazorla;7067;3432;3635;2023
23;Jaén;029;Chiclana de Segura;896;462;434;2023
23;Jaén;030;Chilluévar;1363;676;687;2023
23;Jaén;031;Escañuela;934;459;475;2023
23;Jaén;032;Espeluy;604;300;304;2023
23;Jaén;033;Frailes;1565;781;784;2023
23;Jaén;034;Fuensanta de Martos;3023;1524;1499;2023
23;Jaén;035;Fuerte del Rey;1352;703;649;2023
23;Jaén;037;Génave;561;298;263;2023
23;Jaén;038;Guardia de Jaén, La;5175;2644;2531;2023
23;Jaén;039;Guarromán;2782;1426;1356;2023
23;Jaén;041;Higuera de Calatrava;605;321;284;2023
23;Jaén;042;Hinojares;348;180;168;2023
23;Jaén;043;Hornos;574;278;296;2023
23;Jaén;044;Huelma;5559;2742;2817;2023
23;Jaén;045;Huesa;2436;1225;1211;2023
23;Jaén;046;Ibros;2737;1376;1361;2023
23;Jaén;047;Iruela, La;1881;943;938;2023
23;Jaén;048;Iznatoraf;902;451;451;2023
23;Jaén;049;Jabalquinto;1962;989;973;2023
23;Jaén;050;Jaén;111888;53724;58164;2023
23;Jaén;051;Jamilena;3319;1664;1655;2023
23;Jaén;052;Jimena;1223;595;628;2023
23;Jaén;053;Jódar;11449;5705;5744;2023
23;Jaén;040;Lahiguera;1604;794;810;2023
23;Jaén;054;Larva;444;231;213;2023
23;Jaén;055;Linares;55096;26884;28212;2023
23;Jaén;056;Lopera;3579;1830;1749;2023
23;Jaén;057;Lupión;806;392;414;2023
23;Jaén;058;Mancha Real;11375;5660;5715;2023
23;Jaén;059;Marmolejo;6586;3290;3296;2023
23;Jaén;060;Martos;24363;12087;12276;2023
23;Jaén;061;Mengíbar;10041;5014;5027;2023
23;Jaén;062;Montizón;1606;824;782;2023
23;Jaén;063;Navas de San Juan;4427;2241;2186;2023
23;Jaén;064;Noalejo;1826;931;895;2023
23;Jaén;065;Orcera;1735;869;866;2023
23;Jaén;066;Peal de Becerro;5325;2660;2665;2023
23;Jaén;067;Pegalajar;2822;1429;1393;2023
23;Jaén;069;Porcuna;5975;3008;2967;2023
23;Jaén;070;Pozo Alcón;4594;2374;2220;2023
23;Jaén;071;Puente de Génave;2168;1108;1060;2023
23;Jaén;072;Puerta de Segura, La;2226;1113;1113;2023
23;Jaén;073;Quesada;5015;2547;2468;2023
23;Jaén;074;Rus;3453;1750;1703;2023
23;Jaén;075;Sabiote;3823;1894;1929;2023
23;Jaén;076;Santa Elena;866;451;415;2023
23;Jaén;077;Santiago de Calatrava;657;345;312;2023
23;Jaén;904;Santiago-Pontones;2729;1415;1314;2023
23;Jaén;079;Santisteban del Puerto;4442;2285;2157;2023
23;Jaén;080;Santo Tomé;2081;1063;1018;2023
23;Jaén;081;Segura de la Sierra;1710;844;866;2023
23;Jaén;082;Siles;2137;1083;1054;2023
23;Jaén;084;Sorihuela del Guadalimar;1043;542;501;2023
23;Jaén;085;Torreblascopedro;2434;1237;1197;2023
23;Jaén;086;Torredelcampo;13871;6945;6926;2023
23;Jaén;087;Torredonjimeno;13301;6563;6738;2023
23;Jaén;088;Torreperogil;7108;3480;3628;2023
23;Jaén;090;Torres;1349;697;652;2023
23;Jaén;091;Torres de Albánchez;746;391;355;2023
23;Jaén;092;Úbeda;33810;16476;17334;2023
23;Jaén;093;Valdepeñas de Jaén;3566;1761;1805;2023
23;Jaén;094;Vilches;4238;2129;2109;2023
23;Jaén;095;Villacarrillo;10344;5222;5122;2023
23;Jaén;096;Villanueva de la Reina;2964;1499;1465;2023
23;Jaén;097;Villanueva del Arzobispo;7933;4091;3842;2023
23;Jaén;098;Villardompardo;920;459;461;2023
23;Jaén;099;Villares, Los;6079;3059;3020;2023
23;Jaén;101;Villarrodrigo;383;208;175;2023
23;Jaén;903;Villatorres;4261;2179;2082;2023
24;León;001;Acebedo;182;102;80;2023
24;León;002;Algadefe;290;150;140;2023
24;León;003;Alija del Infantado;593;302;291;2023
24;León;004;Almanza;626;350;276;2023
24;León;005;Antigua, La;331;192;139;2023
24;León;006;Ardón;558;308;250;2023
24;León;007;Arganza;798;405;393;2023
24;León;008;Astorga;10321;4837;5484;2023
24;León;009;Balboa;261;147;114;2023
24;León;010;Bañeza, La;10047;4805;5242;2023
24;León;011;Barjas;160;91;69;2023
24;León;012;Barrios de Luna, Los;300;173;127;2023
24;León;014;Bembibre;8196;3934;4262;2023
24;León;015;Benavides;2367;1176;1191;2023
24;León;016;Benuza;455;275;180;2023
24;León;017;Bercianos del Páramo;524;269;255;2023
24;León;018;Bercianos del Real Camino;186;101;85;2023
24;León;019;Berlanga del Bierzo;322;148;174;2023
24;León;020;Boca de Huérgano;435;256;179;2023
24;León;021;Boñar;1804;922;882;2023
24;León;022;Borrenes;304;167;137;2023
24;León;023;Brazuelo;323;178;145;2023
24;León;024;Burgo Ranero, El;683;359;324;2023
24;León;025;Burón;294;172;122;2023
24;León;026;Bustillo del Páramo;1076;561;515;2023
24;León;027;Cabañas Raras;1316;691;625;2023
24;León;028;Cabreros del Río;401;218;183;2023
24;León;029;Cabrillanes;719;381;338;2023
24;León;030;Cacabelos;4793;2363;2430;2023
24;León;031;Calzada del Coto;222;132;90;2023
24;León;032;Campazas;109;55;54;2023
24;León;033;Campo de Villavidel;200;113;87;2023
24;León;034;Camponaraya;4096;2033;2063;2023
24;León;036;Candín;283;156;127;2023
24;León;037;Cármenes;337;191;146;2023
24;León;038;Carracedelo;3431;1718;1713;2023
24;León;039;Carrizo;2208;1112;1096;2023
24;León;040;Carrocera;445;232;213;2023
24;León;041;Carucedo;495;247;248;2023
24;León;042;Castilfalé;65;39;26;2023
24;León;043;Castrillo de Cabrera;106;64;42;2023
24;León;044;Castrillo de la Valduerna;142;69;73;2023
24;León;046;Castrocalbón;925;483;442;2023
24;León;047;Castrocontrigo;682;378;304;2023
24;León;049;Castropodame;1588;823;765;2023
24;León;050;Castrotierra de Valmadrigal;107;55;52;2023
24;León;051;Cea;378;199;179;2023
24;León;052;Cebanico;144;84;60;2023
24;León;053;Cebrones del Río;435;238;197;2023
24;León;065;Chozas de Abajo;2677;1369;1308;2023
24;León;054;Cimanes de la Vega;441;222;219;2023
24;León;055;Cimanes del Tejar;742;405;337;2023
24;León;056;Cistierna;2951;1455;1496;2023
24;León;057;Congosto;1436;714;722;2023
24;León;058;Corbillos de los Oteros;183;103;80;2023
24;León;059;Corullón;849;431;418;2023
24;León;060;Crémenes;530;286;244;2023
24;León;061;Cuadros;2088;1053;1035;2023
24;León;062;Cubillas de los Oteros;138;77;61;2023
24;León;063;Cubillas de Rueda;393;211;182;2023
24;León;064;Cubillos del Sil;1741;910;831;2023
24;León;066;Destriana;431;206;225;2023
24;León;067;Encinedo;623;335;288;2023
24;León;068;Ercina, La;442;235;207;2023
24;León;069;Escobar de Campos;33;21;12;2023
24;León;070;Fabero;4112;2019;2093;2023
24;León;071;Folgoso de la Ribera;1005;488;517;2023
24;León;073;Fresno de la Vega;464;236;228;2023
24;León;074;Fuentes de Carbajal;77;50;27;2023
24;León;076;Garrafe de Torío;1646;878;768;2023
24;León;077;Gordaliza del Pino;246;119;127;2023
24;León;078;Gordoncillo;325;160;165;2023
24;León;079;Gradefes;944;521;423;2023
24;León;080;Grajal de Campos;221;114;107;2023
24;León;081;Gusendos de los Oteros;128;64;64;2023
24;León;082;Hospital de Órbigo;961;480;481;2023
24;León;083;Igüeña;1083;561;522;2023
24;León;084;Izagre;143;72;71;2023
24;León;086;Joarilla de las Matas;240;131;109;2023
24;León;087;Laguna Dalga;621;339;282;2023
24;León;088;Laguna de Negrillos;1050;535;515;2023
24;León;089;León;121281;54837;66444;2023
24;León;092;Llamas de la Ribera;798;420;378;2023
24;León;090;Lucillo;361;188;173;2023
24;León;091;Luyego;568;316;252;2023
24;León;093;Magaz de Cepeda;354;191;163;2023
24;León;094;Mansilla de las Mulas;1654;841;813;2023
24;León;095;Mansilla Mayor;324;174;150;2023
24;León;096;Maraña;120;76;44;2023
24;León;097;Matadeón de los Oteros;224;114;110;2023
24;León;098;Matallana de Torío;1258;649;609;2023
24;León;099;Matanza;174;96;78;2023
24;León;100;Molinaseca;872;478;394;2023
24;León;101;Murias de Paredes;349;189;160;2023
24;León;102;Noceda del Bierzo;613;315;298;2023
24;León;103;Oencia;284;167;117;2023
24;León;104;Omañas, Las;257;137;120;2023
24;León;105;Onzonilla;1880;968;912;2023
24;León;106;Oseja de Sajambre;230;140;90;2023
24;León;107;Pajares de los Oteros;241;144;97;2023
24;León;108;Palacios de la Valduerna;351;174;177;2023
24;León;109;Palacios del Sil;867;479;388;2023
24;León;110;Páramo del Sil;1214;623;591;2023
24;León;112;Peranzanes;270;161;109;2023
24;León;113;Pobladura de Pelayo García;354;182;172;2023
24;León;114;Pola de Gordón, La;2880;1450;1430;2023
24;León;115;Ponferrada;62963;29727;33236;2023
24;León;116;Posada de Valdeón;420;240;180;2023
24;León;117;Pozuelo del Páramo;405;195;210;2023
24;León;118;Prado de la Guzpeña;109;64;45;2023
24;León;119;Priaranza del Bierzo;731;358;373;2023
24;León;120;Prioro;347;202;145;2023
24;León;121;Puebla de Lillo;674;381;293;2023
24;León;122;Puente de Domingo Flórez;1406;729;677;2023
24;León;123;Quintana del Castillo;724;397;327;2023
24;León;124;Quintana del Marco;332;186;146;2023
24;León;125;Quintana y Congosto;416;221;195;2023
24;León;127;Regueras de Arriba;264;140;124;2023
24;León;129;Reyero;127;70;57;2023
24;León;130;Riaño;474;260;214;2023
24;León;131;Riego de la Vega;718;387;331;2023
24;León;132;Riello;603;341;262;2023
24;León;133;Rioseco de Tapia;382;212;170;2023
24;León;134;Robla, La;3637;1801;1836;2023
24;León;136;Roperuelos del Páramo;505;257;248;2023
24;León;137;Sabero;1046;532;514;2023
24;León;139;Sahagún;2456;1202;1254;2023
24;León;141;San Adrián del Valle;92;54;38;2023
24;León;142;San Andrés del Rabanedo;29961;14246;15715;2023
24;León;144;San Cristóbal de la Polantera;642;332;310;2023
24;León;145;San Emiliano;602;344;258;2023
24;León;146;San Esteban de Nogales;253;132;121;2023
24;León;148;San Justo de la Vega;1761;905;856;2023
24;León;149;San Millán de los Caballeros;177;94;83;2023
24;León;150;San Pedro Bercianos;227;121;106;2023
24;León;143;Sancedo;532;275;257;2023
24;León;151;Santa Colomba de Curueño;496;257;239;2023
24;León;152;Santa Colomba de Somoza;496;270;226;2023
24;León;153;Santa Cristina de Valmadrigal;281;142;139;2023
24;León;154;Santa Elena de Jamuz;1038;548;490;2023
24;León;155;Santa María de la Isla;453;236;217;2023
24;León;158;Santa María de Ordás;337;189;148;2023
24;León;156;Santa María del Monte de Cea;212;117;95;2023
24;León;157;Santa María del Páramo;3041;1485;1556;2023
24;León;159;Santa Marina del Rey;1772;883;889;2023
24;León;160;Santas Martas;732;390;342;2023
24;León;161;Santiago Millas;364;205;159;2023
24;León;162;Santovenia de la Valdoncina;2081;1047;1034;2023
24;León;163;Sariegos;5413;2683;2730;2023
24;León;164;Sena de Luna;395;194;201;2023
24;León;165;Sobrado;302;153;149;2023
24;León;166;Soto de la Vega;1487;783;704;2023
24;León;167;Soto y Amío;729;369;360;2023
24;León;168;Toral de los Guzmanes;499;276;223;2023
24;León;206;Toral de los Vados;1779;888;891;2023
24;León;169;Toreno;2898;1459;1439;2023
24;León;170;Torre del Bierzo;2026;1035;991;2023
24;León;171;Trabadelo;337;190;147;2023
24;León;172;Truchas;404;218;186;2023
24;León;173;Turcia;973;495;478;2023
24;León;174;Urdiales del Páramo;457;246;211;2023
24;León;185;Val de San Lorenzo;502;242;260;2023
24;León;175;Valdefresno;2302;1199;1103;2023
24;León;176;Valdefuentes del Páramo;308;167;141;2023
24;León;177;Valdelugueros;507;283;224;2023
24;León;178;Valdemora;66;28;38;2023
24;León;179;Valdepiélago;288;167;121;2023
24;León;180;Valdepolo;1197;645;552;2023
24;León;181;Valderas;1524;786;738;2023
24;León;182;Valderrey;425;220;205;2023
24;León;183;Valderrueda;831;459;372;2023
24;León;184;Valdesamario;179;103;76;2023
24;León;187;Valdevimbre;905;468;437;2023
24;León;188;Valencia de Don Juan;5185;2534;2651;2023
24;León;191;Vallecillo;105;62;43;2023
24;León;189;Valverde de la Virgen;7687;3969;3718;2023
24;León;190;Valverde-Enrique;156;78;78;2023
24;León;193;Vecilla, La;384;213;171;2023
24;León;196;Vega de Espinareda;2016;1027;989;2023
24;León;197;Vega de Infanzones;848;431;417;2023
24;León;198;Vega de Valcarce;561;285;276;2023
24;León;194;Vegacervera;262;137;125;2023
24;León;199;Vegaquemada;437;251;186;2023
24;León;201;Vegas del Condado;1157;659;498;2023
24;León;202;Villablino;7845;3793;4052;2023
24;León;203;Villabraz;113;64;49;2023
24;León;205;Villadangos del Páramo;1222;627;595;2023
24;León;207;Villademor de la Vega;284;148;136;2023
24;León;209;Villafranca del Bierzo;2694;1289;1405;2023
24;León;210;Villagatón;661;373;288;2023
24;León;211;Villamandos;282;148;134;2023
24;León;901;Villamanín;894;467;427;2023
24;León;212;Villamañán;1067;550;517;2023
24;León;213;Villamartín de Don Sancho;162;87;75;2023
24;León;214;Villamejil;652;354;298;2023
24;León;215;Villamol;134;69;65;2023
24;León;216;Villamontán de la Valduerna;693;352;341;2023
24;León;217;Villamoratiel de las Matas;127;71;56;2023
24;León;218;Villanueva de las Manzanas;496;256;240;2023
24;León;219;Villaobispo de Otero;532;292;240;2023
24;León;902;Villaornate y Castro;345;172;173;2023
24;León;221;Villaquejida;808;409;399;2023
24;León;222;Villaquilambre;18765;9309;9456;2023
24;León;223;Villarejo de Órbigo;2908;1431;1477;2023
24;León;224;Villares de Órbigo;567;304;263;2023
24;León;225;Villasabariego;1121;581;540;2023
24;León;226;Villaselán;181;103;78;2023
24;León;227;Villaturiel;1886;979;907;2023
24;León;228;Villazala;612;335;277;2023
24;León;229;Villazanzo de Valderaduey;379;220;159;2023
24;León;230;Zotes del Páramo;408;226;182;2023
25;Lleida;001;Abella de la Conca;167;87;80;2023
25;Lleida;002;Àger;582;320;262;2023
25;Lleida;003;Agramunt;5516;2773;2743;2023
25;Lleida;038;Aitona;2557;1349;1208;2023
25;Lleida;004;Alamús, Els;794;398;396;2023
25;Lleida;005;Alàs i Cerc;322;158;164;2023
25;Lleida;006;Albagés, L';356;189;167;2023
25;Lleida;007;Albatàrrec;2238;1142;1096;2023
25;Lleida;008;Albesa;1588;852;736;2023
25;Lleida;009;Albi, L';764;388;376;2023
25;Lleida;010;Alcanó;243;123;120;2023
25;Lleida;011;Alcarràs;9787;5071;4716;2023
25;Lleida;012;Alcoletge;3495;1863;1632;2023
25;Lleida;013;Alfarràs;2783;1450;1333;2023
25;Lleida;014;Alfés;286;156;130;2023
25;Lleida;015;Algerri;434;233;201;2023
25;Lleida;016;Alguaire;3012;1592;1420;2023
25;Lleida;017;Alins;282;153;129;2023
25;Lleida;019;Almacelles;6847;3685;3162;2023
25;Lleida;020;Almatret;307;172;135;2023
25;Lleida;021;Almenar;3379;1811;1568;2023
25;Lleida;022;Alòs de Balaguer;114;66;48;2023
25;Lleida;023;Alpicat;6394;3206;3188;2023
25;Lleida;024;Alt Àneu;447;257;190;2023
25;Lleida;027;Anglesola;1361;686;675;2023
25;Lleida;029;Arbeca;2109;1078;1031;2023
25;Lleida;031;Arres;71;49;22;2023
25;Lleida;032;Arsèguel;77;41;36;2023
25;Lleida;033;Artesa de Lleida;1512;802;710;2023
25;Lleida;034;Artesa de Segre;3504;1813;1691;2023
25;Lleida;036;Aspa;217;111;106;2023
25;Lleida;037;Avellanes i Santa Linya, Les;445;246;199;2023
25;Lleida;039;Baix Pallars;349;188;161;2023
25;Lleida;040;Balaguer;17649;9053;8596;2023
25;Lleida;041;Barbens;929;518;411;2023
25;Lleida;042;Baronia de Rialb, La;225;118;107;2023
25;Lleida;044;Bassella;221;120;101;2023
25;Lleida;045;Bausen;70;38;32;2023
25;Lleida;046;Belianes;510;248;262;2023
25;Lleida;170;Bellaguarda;289;151;138;2023
25;Lleida;047;Bellcaire d'Urgell;1231;626;605;2023
25;Lleida;048;Bell-lloc d'Urgell;2378;1195;1183;2023
25;Lleida;049;Bellmunt d'Urgell;176;94;82;2023
25;Lleida;050;Bellpuig;5150;2726;2424;2023
25;Lleida;051;Bellver de Cerdanya;2250;1155;1095;2023
25;Lleida;052;Bellvís;2263;1160;1103;2023
25;Lleida;053;Benavent de Segrià;1579;831;748;2023
25;Lleida;055;Biosca;184;101;83;2023
25;Lleida;057;Bòrdes, Es;278;156;122;2023
25;Lleida;058;Borges Blanques, Les;6215;3171;3044;2023
25;Lleida;059;Bossòst;1137;555;582;2023
25;Lleida;056;Bovera;258;138;120;2023
25;Lleida;060;Cabanabona;61;28;33;2023
25;Lleida;061;Cabó;99;50;49;2023
25;Lleida;062;Camarasa;786;402;384;2023
25;Lleida;063;Canejan;97;50;47;2023
25;Lleida;904;Castell de Mur;179;99;80;2023
25;Lleida;064;Castellar de la Ribera;142;73;69;2023
25;Lleida;067;Castelldans;893;466;427;2023
25;Lleida;068;Castellnou de Seana;706;372;334;2023
25;Lleida;069;Castelló de Farfanya;531;279;252;2023
25;Lleida;070;Castellserà;989;509;480;2023
25;Lleida;071;Cava;44;29;15;2023
25;Lleida;072;Cervera;9453;4820;4633;2023
25;Lleida;073;Cervià de les Garrigues;645;351;294;2023
25;Lleida;074;Ciutadilla;188;100;88;2023
25;Lleida;075;Clariana de Cardener;158;83;75;2023
25;Lleida;076;Cogul, El;155;88;67;2023
25;Lleida;077;Coll de Nargó;568;296;272;2023
25;Lleida;163;Coma i la Pedra, La;275;155;120;2023
25;Lleida;161;Conca de Dalt;436;228;208;2023
25;Lleida;078;Corbins;1486;809;677;2023
25;Lleida;079;Cubells;344;180;164;2023
25;Lleida;081;Espluga Calba, L';324;164;160;2023
25;Lleida;082;Espot;386;209;177;2023
25;Lleida;088;Estamariu;133;75;58;2023
25;Lleida;085;Estaràs;164;84;80;2023
25;Lleida;086;Esterri d'Àneu;874;434;440;2023
25;Lleida;087;Esterri de Cardós;61;31;30;2023
25;Lleida;089;Farrera;124;69;55;2023
25;Lleida;908;Fígols i Alinyà;255;148;107;2023
25;Lleida;092;Floresta, La;155;89;66;2023
25;Lleida;093;Fondarella;780;390;390;2023
25;Lleida;094;Foradada;179;100;79;2023
25;Lleida;096;Fuliola, La;1223;611;612;2023
25;Lleida;097;Fulleda;87;46;41;2023
25;Lleida;098;Gavet de la Conca;257;125;132;2023
25;Lleida;912;Gimenells i el Pla de la Font;1108;590;518;2023
25;Lleida;099;Golmés;1902;967;935;2023
25;Lleida;100;Gósol;230;126;104;2023
25;Lleida;101;Granadella, La;750;427;323;2023
25;Lleida;102;Granja d'Escarp, La;927;535;392;2023
25;Lleida;103;Granyanella;149;85;64;2023
25;Lleida;105;Granyena de les Garrigues;157;96;61;2023
25;Lleida;104;Granyena de Segarra;152;81;71;2023
25;Lleida;109;Guimerà;255;139;116;2023
25;Lleida;903;Guingueta d'Àneu, La;285;156;129;2023
25;Lleida;110;Guissona;7603;4033;3570;2023
25;Lleida;111;Guixers;131;77;54;2023
25;Lleida;115;Isona i Conca Dellà;1061;578;483;2023
25;Lleida;112;Ivars de Noguera;332;179;153;2023
25;Lleida;113;Ivars d'Urgell;1607;868;739;2023
25;Lleida;114;Ivorra;99;56;43;2023
25;Lleida;910;Josa i Tuixén;125;74;51;2023
25;Lleida;118;Juncosa;382;197;185;2023
25;Lleida;119;Juneda;3478;1845;1633;2023
25;Lleida;121;Les;994;510;484;2023
25;Lleida;122;Linyola;2744;1387;1357;2023
25;Lleida;123;Lladorre;254;131;123;2023
25;Lleida;124;Lladurs;185;100;85;2023
25;Lleida;125;Llardecans;419;226;193;2023
25;Lleida;126;Llavorsí;343;171;172;2023
25;Lleida;120;Lleida;143094;71273;71821;2023
25;Lleida;127;Lles de Cerdanya;292;172;120;2023
25;Lleida;128;Llimiana;133;75;58;2023
25;Lleida;129;Llobera;212;122;90;2023
25;Lleida;133;Maials;908;504;404;2023
25;Lleida;130;Maldà;240;120;120;2023
25;Lleida;131;Massalcoreig;563;314;249;2023
25;Lleida;132;Massoteres;215;111;104;2023
25;Lleida;134;Menàrguens;774;407;367;2023
25;Lleida;135;Miralcamp;1366;703;663;2023
25;Lleida;137;Mollerussa;15037;7747;7290;2023
25;Lleida;136;Molsosa, La;102;48;54;2023
25;Lleida;139;Montellà i Martinet;631;332;299;2023
25;Lleida;140;Montferrer i Castellbò;1093;586;507;2023
25;Lleida;138;Montgai;633;328;305;2023
25;Lleida;142;Montoliu de Lleida;483;250;233;2023
25;Lleida;141;Montoliu de Segarra;183;105;78;2023
25;Lleida;143;Montornès de Segarra;91;44;47;2023
25;Lleida;145;Nalec;94;53;41;2023
25;Lleida;025;Naut Aran;1921;1001;920;2023
25;Lleida;146;Navès;315;157;158;2023
25;Lleida;148;Odèn;248;141;107;2023
25;Lleida;149;Oliana;1864;921;943;2023
25;Lleida;150;Oliola;198;106;92;2023
25;Lleida;151;Olius;995;514;481;2023
25;Lleida;152;Oluges, Les;164;92;72;2023
25;Lleida;153;Omellons, Els;197;105;92;2023
25;Lleida;154;Omells de na Gaia, Els;120;66;54;2023
25;Lleida;155;Organyà;797;409;388;2023
25;Lleida;156;Os de Balaguer;1083;543;540;2023
25;Lleida;157;Ossó de Sió;197;100;97;2023
25;Lleida;158;Palau d'Anglesola, El;2188;1084;1104;2023
25;Lleida;164;Penelles;428;247;181;2023
25;Lleida;165;Peramola;345;175;170;2023
25;Lleida;166;Pinell de Solsonès;194;108;86;2023
25;Lleida;167;Pinós;280;153;127;2023
25;Lleida;911;Plans de Sió, Els;515;279;236;2023
25;Lleida;168;Poal, El;655;335;320;2023
25;Lleida;169;Pobla de Cérvoles, La;201;111;90;2023
25;Lleida;171;Pobla de Segur, La;3035;1524;1511;2023
25;Lleida;030;Pont de Bar, El;163;96;67;2023
25;Lleida;173;Pont de Suert, El;2371;1199;1172;2023
25;Lleida;172;Ponts;2710;1401;1309;2023
25;Lleida;174;Portella, La;753;431;322;2023
25;Lleida;175;Prats i Sansor;254;138;116;2023
25;Lleida;176;Preixana;403;209;194;2023
25;Lleida;177;Preixens;411;208;203;2023
25;Lleida;179;Prullans;269;129;140;2023
25;Lleida;180;Puiggròs;257;131;126;2023
25;Lleida;181;Puigverd d'Agramunt;260;147;113;2023
25;Lleida;182;Puigverd de Lleida;1397;722;675;2023
25;Lleida;183;Rialp;669;336;333;2023
25;Lleida;905;Ribera d'Ondara;457;237;220;2023
25;Lleida;185;Ribera d'Urgellet;938;479;459;2023
25;Lleida;186;Riner;267;128;139;2023
25;Lleida;913;Riu de Cerdanya;95;53;42;2023
25;Lleida;189;Rosselló;3329;1713;1616;2023
25;Lleida;190;Salàs de Pallars;348;190;158;2023
25;Lleida;191;Sanaüja;391;202;189;2023
25;Lleida;196;Sant Esteve de la Sarga;129;82;47;2023
25;Lleida;192;Sant Guim de Freixenet;1152;604;548;2023
25;Lleida;197;Sant Guim de la Plana;200;102;98;2023
25;Lleida;193;Sant Llorenç de Morunys;1002;489;513;2023
25;Lleida;902;Sant Martí de Riucorb;655;340;315;2023
25;Lleida;194;Sant Ramon;489;258;231;2023
25;Lleida;201;Sarroca de Bellera;119;67;52;2023
25;Lleida;200;Sarroca de Lleida;387;214;173;2023
25;Lleida;202;Senterada;160;93;67;2023
25;Lleida;035;Sentiu de Sió, La;445;226;219;2023
25;Lleida;204;Seròs;1893;1022;871;2023
25;Lleida;203;Seu d'Urgell, La;12568;6131;6437;2023
25;Lleida;205;Sidamon;766;407;359;2023
25;Lleida;206;Soleràs, El;321;171;150;2023
25;Lleida;207;Solsona;9171;4550;4621;2023
25;Lleida;208;Soriguera;440;230;210;2023
25;Lleida;209;Sort;2211;1087;1124;2023
25;Lleida;210;Soses;1855;980;875;2023
25;Lleida;211;Sudanell;885;495;390;2023
25;Lleida;212;Sunyer;331;180;151;2023
25;Lleida;215;Talarn;591;374;217;2023
25;Lleida;216;Talavera;277;153;124;2023
25;Lleida;217;Tàrrega;18268;9073;9195;2023
25;Lleida;218;Tarrés;117;58;59;2023
25;Lleida;219;Tarroja de Segarra;180;96;84;2023
25;Lleida;220;Térmens;1341;696;645;2023
25;Lleida;221;Tírvia;144;71;73;2023
25;Lleida;222;Tiurana;67;33;34;2023
25;Lleida;223;Torà;1201;609;592;2023
25;Lleida;224;Torms, Els;142;72;70;2023
25;Lleida;225;Tornabous;857;464;393;2023
25;Lleida;227;Torre de Cabdella, La;794;392;402;2023
25;Lleida;226;Torrebesses;294;154;140;2023
25;Lleida;228;Torrefarrera;4852;2466;2386;2023
25;Lleida;907;Torrefeta i Florejacs;612;329;283;2023
25;Lleida;230;Torregrossa;2186;1143;1043;2023
25;Lleida;231;Torrelameu;751;445;306;2023
25;Lleida;232;Torres de Segre;2285;1197;1088;2023
25;Lleida;233;Torre-serona;405;210;195;2023
25;Lleida;234;Tremp;5961;2937;3024;2023
25;Lleida;043;Vall de Boí, La;1090;587;503;2023
25;Lleida;901;Vall de Cardós;379;208;171;2023
25;Lleida;238;Vallbona de les Monges;222;115;107;2023
25;Lleida;240;Vallfogona de Balaguer;1990;1004;986;2023
25;Lleida;906;Valls d'Aguilar, Les;270;150;120;2023
25;Lleida;239;Valls de Valira, Les;792;412;380;2023
25;Lleida;909;Vansa i Fórnols, La;181;91;90;2023
25;Lleida;242;Verdú;884;415;469;2023
25;Lleida;243;Vielha e Mijaran;5765;2928;2837;2023
25;Lleida;244;Vilagrassa;621;332;289;2023
25;Lleida;245;Vilaller;505;280;225;2023
25;Lleida;247;Vilamòs;167;92;75;2023
25;Lleida;248;Vilanova de Bellpuig;1183;592;591;2023
25;Lleida;254;Vilanova de la Barca;1090;595;495;2023
25;Lleida;249;Vilanova de l'Aguda;196;95;101;2023
25;Lleida;250;Vilanova de Meià;442;285;157;2023
25;Lleida;251;Vilanova de Segrià;1045;563;482;2023
25;Lleida;252;Vila-sana;766;386;380;2023
25;Lleida;253;Vilosell, El;190;99;91;2023
25;Lleida;255;Vinaixa;445;234;211;2023
27;Lugo;001;Abadín;2203;1078;1125;2023
27;Lugo;002;Alfoz;1553;745;808;2023
27;Lugo;003;Antas de Ulla;1887;929;958;2023
27;Lugo;004;Baleira;1153;613;540;2023
27;Lugo;901;Baralla;2484;1307;1177;2023
27;Lugo;005;Barreiros;3020;1468;1552;2023
27;Lugo;006;Becerreá;2711;1359;1352;2023
27;Lugo;007;Begonte;2925;1468;1457;2023
27;Lugo;008;Bóveda;1405;708;697;2023
27;Lugo;902;Burela;9454;4756;4698;2023
27;Lugo;009;Carballedo;2080;1045;1035;2023
27;Lugo;010;Castro de Rei;5015;2506;2509;2023
27;Lugo;011;Castroverde;2548;1307;1241;2023
27;Lugo;012;Cervantes;1209;703;506;2023
27;Lugo;013;Cervo;4200;2057;2143;2023
27;Lugo;016;Chantada;8006;3887;4119;2023
27;Lugo;014;Corgo, O;3396;1753;1643;2023
27;Lugo;015;Cospeito;4257;2091;2166;2023
27;Lugo;017;Folgoso do Courel;1004;526;478;2023
27;Lugo;018;Fonsagrada, A;3186;1668;1518;2023
27;Lugo;019;Foz;10163;4934;5229;2023
27;Lugo;020;Friol;3616;1845;1771;2023
27;Lugo;022;Guitiriz;5194;2613;2581;2023
27;Lugo;023;Guntín;2551;1304;1247;2023
27;Lugo;024;Incio, O;1524;780;744;2023
27;Lugo;026;Láncara;2492;1274;1218;2023
27;Lugo;027;Lourenzá;2115;1031;1084;2023
27;Lugo;028;Lugo;98214;45397;52817;2023
27;Lugo;029;Meira;1753;882;871;2023
27;Lugo;030;Mondoñedo;3439;1620;1819;2023
27;Lugo;031;Monforte de Lemos;18234;8669;9565;2023
27;Lugo;032;Monterroso;3593;1783;1810;2023
27;Lugo;033;Muras;600;306;294;2023
27;Lugo;034;Navia de Suarna;988;545;443;2023
27;Lugo;035;Negueira de Muñiz;240;134;106;2023
27;Lugo;037;Nogais, As;958;507;451;2023
27;Lugo;038;Ourol;980;506;474;2023
27;Lugo;039;Outeiro de Rei;5359;2745;2614;2023
27;Lugo;040;Palas de Rei;3346;1694;1652;2023
27;Lugo;041;Pantón;2423;1196;1227;2023
27;Lugo;042;Paradela;1638;828;810;2023
27;Lugo;043;Páramo, O;1305;648;657;2023
27;Lugo;044;Pastoriza, A;2810;1416;1394;2023
27;Lugo;045;Pedrafita do Cebreiro;909;495;414;2023
27;Lugo;047;Pobra do Brollón, A;1565;774;791;2023
27;Lugo;046;Pol;1582;797;785;2023
27;Lugo;048;Pontenova, A;2126;1026;1100;2023
27;Lugo;049;Portomarín;1345;693;652;2023
27;Lugo;050;Quiroga;3099;1485;1614;2023
27;Lugo;056;Rábade;1503;741;762;2023
27;Lugo;051;Ribadeo;9828;4625;5203;2023
27;Lugo;052;Ribas de Sil;914;463;451;2023
27;Lugo;053;Ribeira de Piquín;497;263;234;2023
27;Lugo;054;Riotorto;1200;608;592;2023
27;Lugo;055;Samos;1210;643;567;2023
27;Lugo;057;Sarria;13221;6452;6769;2023
27;Lugo;058;Saviñao, O;3504;1767;1737;2023
27;Lugo;059;Sober;2178;1056;1122;2023
27;Lugo;060;Taboada;2657;1283;1374;2023
27;Lugo;061;Trabada;1107;542;565;2023
27;Lugo;062;Triacastela;622;302;320;2023
27;Lugo;063;Valadouro, O;1890;901;989;2023
27;Lugo;064;Vicedo, O;1613;789;824;2023
27;Lugo;065;Vilalba;13870;6712;7158;2023
27;Lugo;066;Viveiro;15221;7462;7759;2023
27;Lugo;021;Xermade;1734;851;883;2023
27;Lugo;025;Xove;3330;1722;1608;2023
28;Madrid;001;Acebeda, La;67;34;33;2023
28;Madrid;002;Ajalvir;4779;2483;2296;2023
28;Madrid;003;Alameda del Valle;274;144;130;2023
28;Madrid;004;Álamo, El;10322;5069;5253;2023
28;Madrid;005;Alcalá de Henares;199184;96342;102842;2023
28;Madrid;006;Alcobendas;119416;56903;62513;2023
28;Madrid;007;Alcorcón;171772;82226;89546;2023
28;Madrid;008;Aldea del Fresno;3408;1743;1665;2023
28;Madrid;009;Algete;20991;10279;10712;2023
28;Madrid;010;Alpedrete;15312;7513;7799;2023
28;Madrid;011;Ambite;684;337;347;2023
28;Madrid;012;Anchuelo;1379;719;660;2023
28;Madrid;013;Aranjuez;60668;29482;31186;2023
28;Madrid;014;Arganda del Rey;58990;29449;29541;2023
28;Madrid;015;Arroyomolinos;35972;17885;18087;2023
28;Madrid;016;Atazar, El;104;60;44;2023
28;Madrid;017;Batres;1872;966;906;2023
28;Madrid;018;Becerril de la Sierra;6277;3128;3149;2023
28;Madrid;019;Belmonte de Tajo;1840;950;890;2023
28;Madrid;021;Berrueco, El;802;412;390;2023
28;Madrid;020;Berzosa del Lozoya;217;121;96;2023
28;Madrid;022;Boadilla del Monte;64742;31617;33125;2023
28;Madrid;023;Boalo, El;8424;4201;4223;2023
28;Madrid;024;Braojos;212;128;84;2023
28;Madrid;025;Brea de Tajo;543;313;230;2023
28;Madrid;026;Brunete;11014;5366;5648;2023
28;Madrid;027;Buitrago del Lozoya;1967;957;1010;2023
28;Madrid;028;Bustarviejo;2743;1354;1389;2023
28;Madrid;029;Cabanillas de la Sierra;939;490;449;2023
28;Madrid;030;Cabrera, La;2882;1413;1469;2023
28;Madrid;031;Cadalso de los Vidrios;3173;1653;1520;2023
28;Madrid;032;Camarma de Esteruelas;7792;3947;3845;2023
28;Madrid;033;Campo Real;6781;3429;3352;2023
28;Madrid;034;Canencia;460;241;219;2023
28;Madrid;035;Carabaña;2273;1147;1126;2023
28;Madrid;036;Casarrubuelos;4062;2089;1973;2023
28;Madrid;037;Cenicientos;2097;1049;1048;2023
28;Madrid;038;Cercedilla;7648;3776;3872;2023
28;Madrid;039;Cervera de Buitrago;164;95;69;2023
28;Madrid;051;Chapinería;2604;1292;1312;2023
28;Madrid;052;Chinchón;5664;2836;2828;2023
28;Madrid;040;Ciempozuelos;25866;13030;12836;2023
28;Madrid;041;Cobeña;7698;3766;3932;2023
28;Madrid;046;Collado Mediano;7490;3722;3768;2023
28;Madrid;047;Collado Villalba;65657;31764;33893;2023
28;Madrid;043;Colmenar de Oreja;8649;4397;4252;2023
28;Madrid;042;Colmenar del Arroyo;1947;1012;935;2023
28;Madrid;045;Colmenar Viejo;55198;27226;27972;2023
28;Madrid;044;Colmenarejo;9534;4697;4837;2023
28;Madrid;048;Corpa;798;399;399;2023
28;Madrid;049;Coslada;80171;39002;41169;2023
28;Madrid;050;Cubas de la Sagra;6817;3444;3373;2023
28;Madrid;053;Daganzo de Arriba;10611;5293;5318;2023
28;Madrid;054;Escorial, El;16873;8293;8580;2023
28;Madrid;055;Estremera;1453;749;704;2023
28;Madrid;056;Fresnedillas de la Oliva;1791;905;886;2023
28;Madrid;057;Fresno de Torote;2522;1327;1195;2023
28;Madrid;058;Fuenlabrada;188736;92192;96544;2023
28;Madrid;059;Fuente el Saz de Jarama;7182;3615;3567;2023
28;Madrid;060;Fuentidueña de Tajo;2270;1131;1139;2023
28;Madrid;061;Galapagar;35273;17119;18154;2023
28;Madrid;062;Garganta de los Montes;420;228;192;2023
28;Madrid;063;Gargantilla del Lozoya y Pinilla de Buitrago;388;219;169;2023
28;Madrid;064;Gascones;229;127;102;2023
28;Madrid;065;Getafe;185899;90494;95405;2023
28;Madrid;066;Griñón;10087;5008;5079;2023
28;Madrid;067;Guadalix de la Sierra;6814;3414;3400;2023
28;Madrid;068;Guadarrama;17063;8396;8667;2023
28;Madrid;069;Hiruela, La;74;47;27;2023
28;Madrid;070;Horcajo de la Sierra-Aoslos;234;116;118;2023
28;Madrid;071;Horcajuelo de la Sierra;108;55;53;2023
28;Madrid;072;Hoyo de Manzanares;8973;4515;4458;2023
28;Madrid;073;Humanes de Madrid;19902;9908;9994;2023
28;Madrid;074;Leganés;190665;91731;98934;2023
28;Madrid;075;Loeches;9108;4568;4540;2023
28;Madrid;076;Lozoya;621;324;297;2023
28;Madrid;901;Lozoyuela-Navas-Sieteiglesias;1483;769;714;2023
28;Madrid;078;Madarcos;72;36;36;2023
28;Madrid;079;Madrid;3332035;1555507;1776528;2023
28;Madrid;080;Majadahonda;72548;34263;38285;2023
28;Madrid;082;Manzanares el Real;9386;4714;4672;2023
28;Madrid;083;Meco;15404;7725;7679;2023
28;Madrid;084;Mejorada del Campo;24274;12035;12239;2023
28;Madrid;085;Miraflores de la Sierra;6945;3544;3401;2023
28;Madrid;086;Molar, El;9759;4944;4815;2023
28;Madrid;087;Molinos, Los;4786;2383;2403;2023
28;Madrid;088;Montejo de la Sierra;381;197;184;2023
28;Madrid;089;Moraleja de Enmedio;5453;2760;2693;2023
28;Madrid;090;Moralzarzal;14124;7032;7092;2023
28;Madrid;091;Morata de Tajuña;8115;4096;4019;2023
28;Madrid;092;Móstoles;211265;102147;109118;2023
28;Madrid;093;Navacerrada;3282;1605;1677;2023
28;Madrid;094;Navalafuente;1637;831;806;2023
28;Madrid;095;Navalagamella;2982;1539;1443;2023
28;Madrid;096;Navalcarnero;31974;15867;16107;2023
28;Madrid;097;Navarredonda y San Mamés;150;95;55;2023
28;Madrid;099;Navas del Rey;3244;1689;1555;2023
28;Madrid;100;Nuevo Baztán;7050;3576;3474;2023
28;Madrid;101;Olmeda de las Fuentes;402;207;195;2023
28;Madrid;102;Orusco de Tajuña;1415;737;678;2023
28;Madrid;104;Paracuellos de Jarama;27000;13486;13514;2023
28;Madrid;106;Parla;133004;65905;67099;2023
28;Madrid;107;Patones;566;263;303;2023
28;Madrid;108;Pedrezuela;6400;3233;3167;2023
28;Madrid;109;Pelayos de la Presa;2982;1516;1466;2023
28;Madrid;110;Perales de Tajuña;3176;1589;1587;2023
28;Madrid;111;Pezuela de las Torres;977;509;468;2023
28;Madrid;112;Pinilla del Valle;204;108;96;2023
28;Madrid;113;Pinto;55208;27202;28006;2023
28;Madrid;114;Piñuécar-Gandullas;178;92;86;2023
28;Madrid;115;Pozuelo de Alarcón;88784;42429;46355;2023
28;Madrid;116;Pozuelo del Rey;1254;650;604;2023
28;Madrid;117;Prádena del Rincón;150;84;66;2023
28;Madrid;118;Puebla de la Sierra;99;57;42;2023
28;Madrid;902;Puentes Viejas;760;401;359;2023
28;Madrid;119;Quijorna;3863;1909;1954;2023
28;Madrid;120;Rascafría;1736;931;805;2023
28;Madrid;121;Redueña;304;169;135;2023
28;Madrid;122;Ribatejada;912;472;440;2023
28;Madrid;123;Rivas-Vaciamadrid;100275;49599;50676;2023
28;Madrid;124;Robledillo de la Jara;135;70;65;2023
28;Madrid;125;Robledo de Chavela;4705;2450;2255;2023
28;Madrid;126;Robregordo;79;45;34;2023
28;Madrid;127;Rozas de Madrid, Las;98086;47284;50802;2023
28;Madrid;128;Rozas de Puerto Real;578;338;240;2023
28;Madrid;129;San Agustín del Guadalix;13650;6631;7019;2023
28;Madrid;130;San Fernando de Henares;38974;18928;20046;2023
28;Madrid;131;San Lorenzo de El Escorial;18489;8826;9663;2023
28;Madrid;132;San Martín de la Vega;20304;10304;10000;2023
28;Madrid;133;San Martín de Valdeiglesias;9003;4474;4529;2023
28;Madrid;134;San Sebastián de los Reyes;92734;44957;47777;2023
28;Madrid;135;Santa María de la Alameda;1517;822;695;2023
28;Madrid;136;Santorcaz;942;474;468;2023
28;Madrid;137;Santos de la Humosa, Los;2772;1416;1356;2023
28;Madrid;138;Serna del Monte, La;106;56;50;2023
28;Madrid;140;Serranillos del Valle;4625;2268;2357;2023
28;Madrid;141;Sevilla la Nueva;9551;4668;4883;2023
28;Madrid;143;Somosierra;85;51;34;2023
28;Madrid;144;Soto del Real;9399;4636;4763;2023
28;Madrid;145;Talamanca de Jarama;4355;2110;2245;2023
28;Madrid;146;Tielmes;2742;1379;1363;2023
28;Madrid;147;Titulcia;1362;709;653;2023
28;Madrid;148;Torrejón de Ardoz;137711;67409;70302;2023
28;Madrid;149;Torrejón de la Calzada;10222;5063;5159;2023
28;Madrid;150;Torrejón de Velasco;4756;2352;2404;2023
28;Madrid;151;Torrelaguna;4949;2468;2481;2023
28;Madrid;152;Torrelodones;25115;12130;12985;2023
28;Madrid;153;Torremocha de Jarama;1144;584;560;2023
28;Madrid;154;Torres de la Alameda;7737;3977;3760;2023
28;Madrid;903;Tres Cantos;51453;24924;26529;2023
28;Madrid;155;Valdaracete;633;328;305;2023
28;Madrid;156;Valdeavero;1782;912;870;2023
28;Madrid;157;Valdelaguna;1045;529;516;2023
28;Madrid;158;Valdemanco;1066;550;516;2023
28;Madrid;159;Valdemaqueda;820;419;401;2023
28;Madrid;160;Valdemorillo;13651;6845;6806;2023
28;Madrid;161;Valdemoro;81394;40018;41376;2023
28;Madrid;162;Valdeolmos-Alalpardo;4523;2313;2210;2023
28;Madrid;163;Valdepiélagos;623;325;298;2023
28;Madrid;164;Valdetorres de Jarama;4990;2482;2508;2023
28;Madrid;165;Valdilecha;3191;1642;1549;2023
28;Madrid;166;Valverde de Alcalá;535;283;252;2023
28;Madrid;167;Velilla de San Antonio;13376;6686;6690;2023
28;Madrid;168;Vellón, El;2200;1140;1060;2023
28;Madrid;169;Venturada;2554;1327;1227;2023
28;Madrid;171;Villa del Prado;7273;3697;3576;2023
28;Madrid;170;Villaconejos;3499;1794;1705;2023
28;Madrid;172;Villalbilla;16823;8495;8328;2023
28;Madrid;173;Villamanrique de Tajo;800;418;382;2023
28;Madrid;174;Villamanta;2774;1410;1364;2023
28;Madrid;175;Villamantilla;1576;783;793;2023
28;Madrid;176;Villanueva de la Cañada;23593;11458;12135;2023
28;Madrid;178;Villanueva de Perales;1671;861;810;2023
28;Madrid;177;Villanueva del Pardillo;17731;8580;9151;2023
28;Madrid;179;Villar del Olmo;2258;1132;1126;2023
28;Madrid;180;Villarejo de Salvanés;7746;3834;3912;2023
28;Madrid;181;Villaviciosa de Odón;28750;13889;14861;2023
28;Madrid;182;Villavieja del Lozoya;314;166;148;2023
28;Madrid;183;Zarzalejo;1810;931;879;2023
29;Málaga;001;Alameda;5434;2743;2691;2023
29;Málaga;002;Alcaucín;2554;1301;1253;2023
29;Málaga;003;Alfarnate;1059;552;507;2023
29;Málaga;004;Alfarnatejo;380;196;184;2023
29;Málaga;005;Algarrobo;6773;3375;3398;2023
29;Málaga;006;Algatocín;829;442;387;2023
29;Málaga;007;Alhaurín de la Torre;43674;21662;22012;2023
29;Málaga;008;Alhaurín el Grande;26879;13381;13498;2023
29;Málaga;009;Almáchar;1848;949;899;2023
29;Málaga;010;Almargen;1924;974;950;2023
29;Málaga;011;Almogía;3967;2065;1902;2023
29;Málaga;012;Álora;13512;6812;6700;2023
29;Málaga;013;Alozaina;2065;1041;1024;2023
29;Málaga;014;Alpandeire;281;139;142;2023
29;Málaga;015;Antequera;41178;20208;20970;2023
29;Málaga;016;Árchez;391;197;194;2023
29;Málaga;017;Archidona;8050;4075;3975;2023
29;Málaga;018;Ardales;2522;1275;1247;2023
29;Málaga;019;Arenas;1264;650;614;2023
29;Málaga;020;Arriate;4068;2010;2058;2023
29;Málaga;021;Atajate;185;98;87;2023
29;Málaga;022;Benadalid;230;112;118;2023
29;Málaga;023;Benahavís;9244;4612;4632;2023
29;Málaga;024;Benalauría;460;240;220;2023
29;Málaga;025;Benalmádena;75801;37050;38751;2023
29;Málaga;026;Benamargosa;1557;802;755;2023
29;Málaga;027;Benamocarra;3079;1549;1530;2023
29;Málaga;028;Benaoján;1437;735;702;2023
29;Málaga;029;Benarrabá;454;237;217;2023
29;Málaga;030;Borge, El;925;472;453;2023
29;Málaga;031;Burgo, El;1780;906;874;2023
29;Málaga;032;Campillos;8435;4226;4209;2023
29;Málaga;033;Canillas de Aceituno;1767;920;847;2023
29;Málaga;034;Canillas de Albaida;801;393;408;2023
29;Málaga;035;Cañete la Real;1598;786;812;2023
29;Málaga;036;Carratraca;750;391;359;2023
29;Málaga;037;Cartajima;232;121;111;2023
29;Málaga;038;Cártama;28412;14352;14060;2023
29;Málaga;039;Casabermeja;3910;2037;1873;2023
29;Málaga;040;Casarabonela;2522;1351;1171;2023
29;Málaga;041;Casares;8111;4166;3945;2023
29;Málaga;042;Coín;25023;12542;12481;2023
29;Málaga;043;Colmenar;3494;1793;1701;2023
29;Málaga;044;Comares;1339;715;624;2023
29;Málaga;045;Cómpeta;3875;1939;1936;2023
29;Málaga;046;Cortes de la Frontera;3014;1566;1448;2023
29;Málaga;047;Cuevas Bajas;1337;649;688;2023
29;Málaga;049;Cuevas de San Marcos;3647;1830;1817;2023
29;Málaga;048;Cuevas del Becerro;1592;783;809;2023
29;Málaga;050;Cútar;592;304;288;2023
29;Málaga;051;Estepona;76975;37624;39351;2023
29;Málaga;052;Faraján;280;138;142;2023
29;Málaga;053;Frigiliana;3322;1662;1660;2023
29;Málaga;054;Fuengirola;85598;41521;44077;2023
29;Málaga;055;Fuente de Piedra;2891;1431;1460;2023
29;Málaga;056;Gaucín;1591;823;768;2023
29;Málaga;057;Genalguacil;410;204;206;2023
29;Málaga;058;Guaro;2307;1186;1121;2023
29;Málaga;059;Humilladero;3331;1660;1671;2023
29;Málaga;060;Igualeja;774;389;385;2023
29;Málaga;061;Istán;1621;804;817;2023
29;Málaga;062;Iznate;915;471;444;2023
29;Málaga;063;Jimera de Líbar;400;210;190;2023
29;Málaga;064;Jubrique;561;286;275;2023
29;Málaga;065;Júzcar;243;137;106;2023
29;Málaga;066;Macharaviaya;523;289;234;2023
29;Málaga;067;Málaga;586384;281265;305119;2023
29;Málaga;068;Manilva;17857;8979;8878;2023
29;Málaga;069;Marbella;156295;74623;81672;2023
29;Málaga;070;Mijas;91691;45335;46356;2023
29;Málaga;071;Moclinejo;1220;625;595;2023
29;Málaga;072;Mollina;5413;2691;2722;2023
29;Málaga;073;Monda;2937;1529;1408;2023
29;Málaga;903;Montecorto;588;314;274;2023
29;Málaga;074;Montejaque;970;487;483;2023
29;Málaga;075;Nerja;21913;10751;11162;2023
29;Málaga;076;Ojén;4480;2296;2184;2023
29;Málaga;077;Parauta;280;145;135;2023
29;Málaga;079;Periana;3290;1702;1588;2023
29;Málaga;080;Pizarra;9886;4960;4926;2023
29;Málaga;081;Pujerra;279;139;140;2023
29;Málaga;082;Rincón de la Victoria;51300;25044;26256;2023
29;Málaga;083;Riogordo;2795;1462;1333;2023
29;Málaga;084;Ronda;33329;16130;17199;2023
29;Málaga;085;Salares;187;101;86;2023
29;Málaga;086;Sayalonga;1647;865;782;2023
29;Málaga;087;Sedella;611;342;269;2023
29;Málaga;904;Serrato;447;224;223;2023
29;Málaga;088;Sierra de Yeguas;3418;1707;1711;2023
29;Málaga;089;Teba;3678;1842;1836;2023
29;Málaga;090;Tolox;2347;1200;1147;2023
29;Málaga;901;Torremolinos;70434;35209;35225;2023
29;Málaga;091;Torrox;20932;10536;10396;2023
29;Málaga;092;Totalán;767;389;378;2023
29;Málaga;093;Valle de Abdalajís;2441;1232;1209;2023
29;Málaga;094;Vélez-Málaga;85377;42009;43368;2023
29;Málaga;095;Villanueva de Algaidas;4113;2079;2034;2023
29;Málaga;902;Villanueva de la Concepción;3302;1594;1708;2023
29;Málaga;098;Villanueva de Tapia;1405;711;694;2023
29;Málaga;096;Villanueva del Rosario;3348;1638;1710;2023
29;Málaga;097;Villanueva del Trabuco;5360;2677;2683;2023
29;Málaga;099;Viñuela;2059;1071;988;2023
29;Málaga;100;Yunquera;2823;1437;1386;2023
52;Melilla;001;Melilla;85491;43047;42444;2023
30;Murcia;001;Abanilla;6216;3163;3053;2023
30;Murcia;002;Abarán;12964;6473;6491;2023
30;Murcia;003;Águilas;36862;18364;18498;2023
30;Murcia;004;Albudeite;1390;705;685;2023
30;Murcia;005;Alcantarilla;43049;21315;21734;2023
30;Murcia;902;Alcázares, Los;18598;9483;9115;2023
30;Murcia;006;Aledo;1123;554;569;2023
30;Murcia;007;Alguazas;10218;5277;4941;2023
30;Murcia;008;Alhama de Murcia;23280;11769;11511;2023
30;Murcia;009;Archena;20110;10546;9564;2023
30;Murcia;010;Beniel;11501;5978;5523;2023
30;Murcia;011;Blanca;6756;3481;3275;2023
30;Murcia;012;Bullas;11664;5864;5800;2023
30;Murcia;013;Calasparra;10161;5150;5011;2023
30;Murcia;014;Campos del Río;2143;1017;1126;2023
30;Murcia;015;Caravaca de la Cruz;25756;12850;12906;2023
30;Murcia;016;Cartagena;218050;108296;109754;2023
30;Murcia;017;Cehegín;14485;7236;7249;2023
30;Murcia;018;Ceutí;12668;6393;6275;2023
30;Murcia;019;Cieza;35286;17672;17614;2023
30;Murcia;020;Fortuna;11094;5863;5231;2023
30;Murcia;021;Fuente Álamo de Murcia;18063;9429;8634;2023
30;Murcia;022;Jumilla;26784;14030;12754;2023
30;Murcia;023;Librilla;5729;2928;2801;2023
30;Murcia;024;Lorca;98447;50526;47921;2023
30;Murcia;025;Lorquí;7706;3924;3782;2023
30;Murcia;026;Mazarrón;34462;17918;16544;2023
30;Murcia;027;Molina de Segura;76074;37879;38195;2023
30;Murcia;028;Moratalla;7588;3841;3747;2023
30;Murcia;029;Mula;17382;8843;8539;2023
30;Murcia;030;Murcia;469177;230043;239134;2023
30;Murcia;031;Ojós;539;283;256;2023
30;Murcia;032;Pliego;3937;2039;1898;2023
30;Murcia;033;Puerto Lumbreras;17346;9023;8323;2023
30;Murcia;034;Ricote;1240;662;578;2023
30;Murcia;035;San Javier;35241;17672;17569;2023
30;Murcia;036;San Pedro del Pinatar;27691;13836;13855;2023
30;Murcia;901;Santomera;16245;8087;8158;2023
30;Murcia;037;Torre-Pacheco;39037;20157;18880;2023
30;Murcia;038;Torres de Cotillas, Las;22183;11218;10965;2023
30;Murcia;039;Totana;33149;17032;16117;2023
30;Murcia;040;Ulea;874;454;420;2023
30;Murcia;041;Unión, La;20897;10569;10328;2023
30;Murcia;042;Villanueva del Río Segura;3771;1963;1808;2023
30;Murcia;043;Yecla;35521;17863;17658;2023
31;Navarra;001;Abáigar;82;47;35;2023
31;Navarra;002;Abárzuza/Abartzuza;514;253;261;2023
31;Navarra;003;Abaurregaina/Abaurrea Alta;115;70;45;2023
31;Navarra;004;Abaurrepea/Abaurrea Baja;29;18;11;2023
31;Navarra;005;Aberin;368;197;171;2023
31;Navarra;006;Ablitas;2610;1319;1291;2023
31;Navarra;007;Adiós;172;97;75;2023
31;Navarra;008;Aguilar de Codés;76;43;33;2023
31;Navarra;009;Aibar/Oibar;769;410;359;2023
31;Navarra;011;Allín/Allin;908;493;415;2023
31;Navarra;012;Allo;988;506;482;2023
31;Navarra;010;Altsasu/Alsasua;7590;3816;3774;2023
31;Navarra;013;Améscoa Baja;724;397;327;2023
31;Navarra;014;Ancín/Antzin;343;185;158;2023
31;Navarra;015;Andosilla;2882;1453;1429;2023
31;Navarra;016;Ansoáin/Antsoain;10608;5165;5443;2023
31;Navarra;017;Anue;491;263;228;2023
31;Navarra;018;Añorbe;628;341;287;2023
31;Navarra;019;Aoiz/Agoitz;2970;1489;1481;2023
31;Navarra;020;Araitz;525;286;239;2023
31;Navarra;025;Arakil;987;528;459;2023
31;Navarra;021;Aranarache/Aranaratxe;70;41;29;2023
31;Navarra;023;Aranguren;12517;6276;6241;2023
31;Navarra;024;Arano;110;62;48;2023
31;Navarra;022;Arantza;609;323;286;2023
31;Navarra;026;Aras;148;78;70;2023
31;Navarra;027;Arbizu;1126;590;536;2023
31;Navarra;028;Arce/Artzi;296;164;132;2023
31;Navarra;029;Arcos, Los;1151;570;581;2023
31;Navarra;030;Arellano;159;89;70;2023
31;Navarra;031;Areso;267;138;129;2023
31;Navarra;032;Arguedas;2313;1176;1137;2023
31;Navarra;033;Aria;49;32;17;2023
31;Navarra;034;Aribe;34;19;15;2023
31;Navarra;035;Armañanzas;54;27;27;2023
31;Navarra;036;Arróniz;1035;552;483;2023
31;Navarra;037;Arruazu;119;66;53;2023
31;Navarra;038;Artajona;1772;912;860;2023
31;Navarra;039;Artazu;116;57;59;2023
31;Navarra;040;Atez/Atetz;214;121;93;2023
31;Navarra;058;Auritz/Burguete;233;127;106;2023
31;Navarra;041;Ayegui/Aiegi;2531;1321;1210;2023
31;Navarra;042;Azagra;3749;1887;1862;2023
31;Navarra;043;Azuelo;37;12;25;2023
31;Navarra;044;Bakaiku;343;181;162;2023
31;Navarra;901;Barañáin/Barañain;19575;9424;10151;2023
31;Navarra;045;Barásoain;602;313;289;2023
31;Navarra;046;Barbarin;46;26;20;2023
31;Navarra;047;Bargota;257;125;132;2023
31;Navarra;048;Barillas;259;139;120;2023
31;Navarra;049;Basaburua;845;479;366;2023
31;Navarra;050;Baztan;7831;3959;3872;2023
31;Navarra;137;Beintza-Labaien;218;128;90;2023
31;Navarra;051;Beire;301;148;153;2023
31;Navarra;052;Belascoáin;138;67;71;2023
31;Navarra;250;Bera;3792;1865;1927;2023
31;Navarra;053;Berbinzana;672;345;327;2023
31;Navarra;905;Beriáin;4129;2039;2090;2023
31;Navarra;902;Berrioplano/Berriobeiti;7541;3832;3709;2023
31;Navarra;903;Berriozar;10919;5484;5435;2023
31;Navarra;054;Bertizarana;635;313;322;2023
31;Navarra;055;Betelu;373;191;182;2023
31;Navarra;253;Bidaurreta;165;85;80;2023
31;Navarra;056;Biurrun-Olcoz;246;131;115;2023
31;Navarra;057;Buñuel;2309;1136;1173;2023
31;Navarra;059;Burgui/Burgi;195;114;81;2023
31;Navarra;060;Burlada/Burlata;20865;10038;10827;2023
31;Navarra;061;Busto, El;52;26;26;2023
31;Navarra;062;Cabanillas;1379;712;667;2023
31;Navarra;063;Cabredo;75;42;33;2023
31;Navarra;064;Cadreita;2186;1154;1032;2023
31;Navarra;065;Caparroso;2786;1452;1334;2023
31;Navarra;066;Cárcar;1150;588;562;2023
31;Navarra;067;Carcastillo;2435;1222;1213;2023
31;Navarra;068;Cascante;4050;2016;2034;2023
31;Navarra;069;Cáseda;969;506;463;2023
31;Navarra;070;Castejón;4435;2226;2209;2023
31;Navarra;071;Castillonuevo;15;10;5;2023
31;Navarra;193;Cendea de Olza/Oltza Zendea;1836;919;917;2023
31;Navarra;072;Cintruénigo;8265;4293;3972;2023
31;Navarra;074;Cirauqui/Zirauki;467;247;220;2023
31;Navarra;075;Ciriza/Ziritza;158;79;79;2023
31;Navarra;076;Cizur;3891;1996;1895;2023
31;Navarra;077;Corella;8629;4351;4278;2023
31;Navarra;078;Cortes;3149;1609;1540;2023
31;Navarra;079;Desojo;72;37;35;2023
31;Navarra;080;Dicastillo;574;303;271;2023
31;Navarra;081;Donamaria;455;228;227;2023
31;Navarra;221;Doneztebe/Santesteban;1858;913;945;2023
31;Navarra;083;Echarri/Etxarri;75;38;37;2023
31;Navarra;087;Elgorriaga;205;102;103;2023
31;Navarra;089;Enériz/Eneritz;301;152;149;2023
31;Navarra;090;Eratsun;155;93;62;2023
31;Navarra;091;Ergoiena;380;204;176;2023
31;Navarra;092;Erro;812;453;359;2023
31;Navarra;094;Eslava;103;50;53;2023
31;Navarra;095;Esparza de Salazar/Espartza Zaraitzu;74;37;37;2023
31;Navarra;096;Espronceda;108;56;52;2023
31;Navarra;097;Estella-Lizarra;14195;6907;7288;2023
31;Navarra;098;Esteribar;2832;1454;1378;2023
31;Navarra;099;Etayo;68;38;30;2023
31;Navarra;082;Etxalar;833;441;392;2023
31;Navarra;084;Etxarri Aranatz;2521;1303;1218;2023
31;Navarra;085;Etxauri;653;334;319;2023
31;Navarra;100;Eulate;276;152;124;2023
31;Navarra;101;Ezcabarte;1837;960;877;2023
31;Navarra;093;Ezcároz/Ezkaroze;299;170;129;2023
31;Navarra;102;Ezkurra;142;97;45;2023
31;Navarra;103;Ezprogui;53;25;28;2023
31;Navarra;104;Falces;2375;1220;1155;2023
31;Navarra;105;Fitero;2146;1086;1060;2023
31;Navarra;106;Fontellas;1005;516;489;2023
31;Navarra;107;Funes;2543;1358;1185;2023
31;Navarra;108;Fustiñana;2457;1224;1233;2023
31;Navarra;109;Galar;2353;1211;1142;2023
31;Navarra;110;Gallipienzo/Galipentzu;96;53;43;2023
31;Navarra;111;Gallués/Galoze;93;62;31;2023
31;Navarra;112;Garaioa;84;50;34;2023
31;Navarra;113;Garde;139;77;62;2023
31;Navarra;114;Garínoain;523;278;245;2023
31;Navarra;115;Garralda;186;94;92;2023
31;Navarra;116;Genevilla;67;41;26;2023
31;Navarra;117;Goizueta;708;373;335;2023
31;Navarra;118;Goñi;172;102;70;2023
31;Navarra;119;Güesa/Gorza;37;22;15;2023
31;Navarra;120;Guesálaz/Gesalatz;431;243;188;2023
31;Navarra;121;Guirguillano;71;37;34;2023
31;Navarra;256;Hiriberri/Villanueva de Aezkoa;101;57;44;2023
31;Navarra;122;Huarte/Uharte;7562;3780;3782;2023
31;Navarra;124;Ibargoiti;282;158;124;2023
31;Navarra;259;Igantzi;572;305;267;2023
31;Navarra;125;Igúzquiza;301;152;149;2023
31;Navarra;126;Imotz;421;233;188;2023
31;Navarra;127;Irañeta;165;90;75;2023
31;Navarra;904;Irurtzun;2316;1200;1116;2023
31;Navarra;128;Isaba/Izaba;404;197;207;2023
31;Navarra;129;Ituren;532;262;270;2023
31;Navarra;130;Iturmendi;418;215;203;2023
31;Navarra;131;Iza/Itza;1330;717;613;2023
31;Navarra;132;Izagaondoa;159;108;51;2023
31;Navarra;133;Izalzu/Itzaltzu;38;22;16;2023
31;Navarra;134;Jaurrieta;176;104;72;2023
31;Navarra;135;Javier;122;30;92;2023
31;Navarra;136;Juslapeña/Txulapain;564;308;256;2023
31;Navarra;138;Lakuntza;1297;679;618;2023
31;Navarra;139;Lana;156;89;67;2023
31;Navarra;140;Lantz;150;86;64;2023
31;Navarra;141;Lapoblación;120;69;51;2023
31;Navarra;142;Larraga;2087;1092;995;2023
31;Navarra;143;Larraona;100;49;51;2023
31;Navarra;144;Larraun;910;494;416;2023
31;Navarra;145;Lazagurría;182;94;88;2023
31;Navarra;146;Leache/Leatxe;37;21;16;2023
31;Navarra;147;Legarda;135;74;61;2023
31;Navarra;148;Legaria;108;52;56;2023
31;Navarra;149;Leitza;3016;1550;1466;2023
31;Navarra;908;Lekunberri;1689;867;822;2023
31;Navarra;150;Leoz/Leotz;211;135;76;2023
31;Navarra;151;Lerga;49;27;22;2023
31;Navarra;152;Lerín;1798;940;858;2023
31;Navarra;153;Lesaka;2731;1380;1351;2023
31;Navarra;154;Lezaun;244;142;102;2023
31;Navarra;155;Liédena;323;169;154;2023
31;Navarra;156;Lizoain-Arriasgoiti/Lizoainibar-Arriasgoiti;303;179;124;2023
31;Navarra;157;Lodosa;4894;2491;2403;2023
31;Navarra;158;Lónguida/Longida;309;167;142;2023
31;Navarra;159;Lumbier;1326;708;618;2023
31;Navarra;160;Luquin;129;68;61;2023
31;Navarra;248;Luzaide/Valcarlos;304;166;138;2023
31;Navarra;161;Mañeru;445;233;212;2023
31;Navarra;162;Marañón;52;30;22;2023
31;Navarra;163;Marcilla;2875;1438;1437;2023
31;Navarra;164;Mélida;715;368;347;2023
31;Navarra;165;Mendavia;3496;1753;1743;2023
31;Navarra;166;Mendaza;289;144;145;2023
31;Navarra;167;Mendigorria;1191;621;570;2023
31;Navarra;168;Metauten;271;152;119;2023
31;Navarra;169;Milagro;3549;1804;1745;2023
31;Navarra;170;Mirafuentes;58;29;29;2023
31;Navarra;171;Miranda de Arga;917;490;427;2023
31;Navarra;172;Monreal/Elo;503;278;225;2023
31;Navarra;173;Monteagudo;1102;578;524;2023
31;Navarra;174;Morentin;116;54;62;2023
31;Navarra;175;Mues;79;45;34;2023
31;Navarra;176;Murchante;4237;2138;2099;2023
31;Navarra;177;Murieta;346;177;169;2023
31;Navarra;178;Murillo el Cuende;685;361;324;2023
31;Navarra;179;Murillo el Fruto;674;362;312;2023
31;Navarra;180;Muruzábal;269;126;143;2023
31;Navarra;181;Navascués/Nabaskoze;121;70;51;2023
31;Navarra;182;Nazar;46;25;21;2023
31;Navarra;088;Noáin (Valle de Elorz)/Noain (Elortzibar);8429;4233;4196;2023
31;Navarra;183;Obanos;920;454;466;2023
31;Navarra;185;Ochagavía/Otsagabia;490;266;224;2023
31;Navarra;184;Oco;68;38;30;2023
31;Navarra;186;Odieta;373;203;170;2023
31;Navarra;187;Oiz;133;72;61;2023
31;Navarra;188;Olaibar;409;230;179;2023
31;Navarra;189;Olazti/Olazagutía;1483;752;731;2023
31;Navarra;190;Olejua;49;27;22;2023
31;Navarra;191;Olite/Erriberri;4019;2022;1997;2023
31;Navarra;192;Olóriz/Oloritz;221;126;95;2023
31;Navarra;195;Orbaizeta;191;91;100;2023
31;Navarra;196;Orbara;29;15;14;2023
31;Navarra;197;Orísoain;74;44;30;2023
31;Navarra;906;Orkoien;4051;2054;1997;2023
31;Navarra;198;Oronz/Orontze;47;25;22;2023
31;Navarra;199;Oroz-Betelu/Orotz-Betelu;145;87;58;2023
31;Navarra;211;Orreaga/Roncesvalles;19;10;9;2023
31;Navarra;200;Oteiza;923;490;433;2023
31;Navarra;201;Pamplona/Iruña;205762;97080;108682;2023
31;Navarra;202;Peralta/Azkoien;5979;3038;2941;2023
31;Navarra;203;Petilla de Aragón;28;16;12;2023
31;Navarra;204;Piedramillera;41;26;15;2023
31;Navarra;205;Pitillas;530;256;274;2023
31;Navarra;206;Puente la Reina/Gares;2944;1490;1454;2023
31;Navarra;207;Pueyo/Puiu;346;189;157;2023
31;Navarra;208;Ribaforada;3715;1918;1797;2023
31;Navarra;209;Romanzado/Erromantzatua;188;102;86;2023
31;Navarra;210;Roncal/Erronkari;209;107;102;2023
31;Navarra;212;Sada;130;78;52;2023
31;Navarra;213;Saldías;124;69;55;2023
31;Navarra;214;Salinas de Oro/Jaitz;109;59;50;2023
31;Navarra;215;San Adrián;6429;3210;3219;2023
31;Navarra;217;San Martín de Unx;377;198;179;2023
31;Navarra;216;Sangüesa/Zangoza;4814;2442;2372;2023
31;Navarra;219;Sansol;87;42;45;2023
31;Navarra;220;Santacara;863;445;418;2023
31;Navarra;222;Sarriés/Sartze;62;43;19;2023
31;Navarra;223;Sartaguda;1328;683;645;2023
31;Navarra;224;Sesma;1226;638;588;2023
31;Navarra;225;Sorlada;48;29;19;2023
31;Navarra;226;Sunbilla;672;344;328;2023
31;Navarra;227;Tafalla;10698;5316;5382;2023
31;Navarra;228;Tiebas-Muruarte de Reta;660;356;304;2023
31;Navarra;229;Tirapu;54;29;25;2023
31;Navarra;230;Torralba del Río;98;52;46;2023
31;Navarra;231;Torres del Río;117;62;55;2023
31;Navarra;232;Tudela;37791;18628;19163;2023
31;Navarra;233;Tulebras;148;66;82;2023
31;Navarra;234;Ucar;190;111;79;2023
31;Navarra;123;Uharte Arakil;806;417;389;2023
31;Navarra;235;Ujué/Uxue;171;94;77;2023
31;Navarra;236;Ultzama;1636;843;793;2023
31;Navarra;237;Unciti;225;133;92;2023
31;Navarra;238;Unzué/Untzue;158;83;75;2023
31;Navarra;239;Urdazubi/Urdax;362;183;179;2023
31;Navarra;240;Urdiain;638;333;305;2023
31;Navarra;241;Urraul Alto;135;88;47;2023
31;Navarra;242;Urraul Bajo;326;149;177;2023
31;Navarra;244;Urroz;177;98;79;2023
31;Navarra;243;Urroz-Villa;418;219;199;2023
31;Navarra;245;Urzainqui/Urzainki;79;46;33;2023
31;Navarra;246;Uterga;169;94;75;2023
31;Navarra;247;Uztárroz/Uztarroze;139;68;71;2023
31;Navarra;086;Valle de Egüés/Eguesibar;22121;11037;11084;2023
31;Navarra;194;Valle de Ollo/Ollaran;435;237;198;2023
31;Navarra;260;Valle de Yerri/Deierri;1581;820;761;2023
31;Navarra;249;Valtierra;2424;1222;1202;2023
31;Navarra;251;Viana;4370;2228;2142;2023
31;Navarra;252;Vidángoz/Bidankoze;75;44;31;2023
31;Navarra;254;Villafranca;3004;1549;1455;2023
31;Navarra;255;Villamayor de Monjardín;117;59;58;2023
31;Navarra;257;Villatuerta;1266;627;639;2023
31;Navarra;258;Villava/Atarrabia;10067;4891;5176;2023
31;Navarra;261;Yesa;294;171;123;2023
31;Navarra;262;Zabalza/Zabaltza;289;155;134;2023
31;Navarra;073;Ziordia;352;187;165;2023
31;Navarra;907;Zizur Mayor/Zizur Nagusia;15715;7715;8000;2023
31;Navarra;263;Zubieta;292;149;143;2023
31;Navarra;264;Zugarramurdi;231;112;119;2023
31;Navarra;265;Zúñiga;89;52;37;2023
32;Ourense;001;Allariz;6378;3177;3201;2023
32;Ourense;002;Amoeiro;2391;1203;1188;2023
32;Ourense;003;Arnoia, A;1002;489;513;2023
32;Ourense;004;Avión;1754;799;955;2023
32;Ourense;005;Baltar;884;475;409;2023
32;Ourense;006;Bande;1482;746;736;2023
32;Ourense;007;Baños de Molgas;1535;762;773;2023
32;Ourense;008;Barbadás;11140;5385;5755;2023
32;Ourense;009;Barco de Valdeorras, O;13277;6424;6853;2023
32;Ourense;010;Beade;364;188;176;2023
32;Ourense;011;Beariz;946;431;515;2023
32;Ourense;012;Blancos, Os;716;393;323;2023
32;Ourense;013;Boborás;2232;1066;1166;2023
32;Ourense;014;Bola, A;1069;512;557;2023
32;Ourense;015;Bolo, O;806;408;398;2023
32;Ourense;016;Calvos de Randín;679;344;335;2023
32;Ourense;018;Carballeda de Avia;1218;599;619;2023
32;Ourense;017;Carballeda de Valdeorras;1373;697;676;2023
32;Ourense;019;Carballiño, O;13968;6501;7467;2023
32;Ourense;020;Cartelle;2521;1246;1275;2023
32;Ourense;022;Castrelo de Miño;1337;670;667;2023
32;Ourense;021;Castrelo do Val;989;511;478;2023
32;Ourense;023;Castro Caldelas;1222;635;587;2023
32;Ourense;024;Celanova;5709;2680;3029;2023
32;Ourense;025;Cenlle;1087;536;551;2023
32;Ourense;029;Chandrexa de Queixa;493;258;235;2023
32;Ourense;026;Coles;3176;1588;1588;2023
32;Ourense;027;Cortegada;1032;507;525;2023
32;Ourense;028;Cualedro;1606;843;763;2023
32;Ourense;030;Entrimo;1098;521;577;2023
32;Ourense;031;Esgos;1099;554;545;2023
32;Ourense;033;Gomesende;667;340;327;2023
32;Ourense;034;Gudiña, A;1180;602;578;2023
32;Ourense;035;Irixo, O;1391;674;717;2023
32;Ourense;038;Larouco;444;210;234;2023
32;Ourense;039;Laza;1167;614;553;2023
32;Ourense;040;Leiro;1481;729;752;2023
32;Ourense;041;Lobeira;768;387;381;2023
32;Ourense;042;Lobios;1786;885;901;2023
32;Ourense;043;Maceda;2878;1429;1449;2023
32;Ourense;044;Manzaneda;832;405;427;2023
32;Ourense;045;Maside;2743;1363;1380;2023
32;Ourense;046;Melón;1123;542;581;2023
32;Ourense;047;Merca, A;1954;984;970;2023
32;Ourense;048;Mezquita, A;1007;520;487;2023
32;Ourense;049;Montederramo;688;369;319;2023
32;Ourense;050;Monterrei;2424;1233;1191;2023
32;Ourense;051;Muíños;1439;721;718;2023
32;Ourense;052;Nogueira de Ramuín;2085;1054;1031;2023
32;Ourense;053;Oímbra;1730;942;788;2023
32;Ourense;054;Ourense;104250;47322;56928;2023
32;Ourense;055;Paderne de Allariz;1368;687;681;2023
32;Ourense;056;Padrenda;1614;801;813;2023
32;Ourense;057;Parada de Sil;520;281;239;2023
32;Ourense;058;Pereiro de Aguiar, O;6647;3422;3225;2023
32;Ourense;059;Peroxa, A;1779;874;905;2023
32;Ourense;060;Petín;875;442;433;2023
32;Ourense;061;Piñor;1151;593;558;2023
32;Ourense;063;Pobra de Trives, A;1977;967;1010;2023
32;Ourense;064;Pontedeva;468;231;237;2023
32;Ourense;062;Porqueira;841;395;446;2023
32;Ourense;065;Punxín;751;366;385;2023
32;Ourense;066;Quintela de Leirado;607;288;319;2023
32;Ourense;067;Rairiz de Veiga;1220;626;594;2023
32;Ourense;068;Ramirás;1521;723;798;2023
32;Ourense;069;Ribadavia;4973;2443;2530;2023
32;Ourense;071;Riós;1414;721;693;2023
32;Ourense;072;Rúa, A;4141;2076;2065;2023
32;Ourense;073;Rubiá;1384;681;703;2023
32;Ourense;074;San Amaro;1049;508;541;2023
32;Ourense;075;San Cibrao das Viñas;5675;2866;2809;2023
32;Ourense;076;San Cristovo de Cea;2003;994;1009;2023
32;Ourense;070;San Xoán de Río;518;264;254;2023
32;Ourense;077;Sandiás;1134;539;595;2023
32;Ourense;078;Sarreaus;1095;537;558;2023
32;Ourense;079;Taboadela;1487;765;722;2023
32;Ourense;080;Teixeira, A;342;180;162;2023
32;Ourense;081;Toén;2378;1219;1159;2023
32;Ourense;082;Trasmiras;1228;610;618;2023
32;Ourense;083;Veiga, A;925;490;435;2023
32;Ourense;084;Verea;964;473;491;2023
32;Ourense;085;Verín;13612;6538;7074;2023
32;Ourense;086;Viana do Bolo;2750;1385;1365;2023
32;Ourense;087;Vilamarín;1866;944;922;2023
32;Ourense;088;Vilamartín de Valdeorras;1851;937;914;2023
32;Ourense;089;Vilar de Barrio;1201;604;597;2023
32;Ourense;090;Vilar de Santos;792;393;399;2023
32;Ourense;091;Vilardevós;1702;904;798;2023
32;Ourense;092;Vilariño de Conso;521;300;221;2023
32;Ourense;032;Xinzo de Limia;9529;4604;4925;2023
32;Ourense;036;Xunqueira de Ambía;1368;691;677;2023
32;Ourense;037;Xunqueira de Espadanedo;689;345;344;2023
34;Palencia;001;Abarca de Campos;42;25;17;2023
34;Palencia;003;Abia de las Torres;167;90;77;2023
34;Palencia;004;Aguilar de Campoo;6733;3246;3487;2023
34;Palencia;005;Alar del Rey;922;467;455;2023
34;Palencia;006;Alba de Cerrato;82;48;34;2023
34;Palencia;009;Amayuelas de Arriba;36;22;14;2023
34;Palencia;010;Ampudia;589;298;291;2023
34;Palencia;011;Amusco;422;239;183;2023
34;Palencia;012;Antigüedad;340;189;151;2023
34;Palencia;015;Arconada;45;27;18;2023
34;Palencia;017;Astudillo;1036;519;517;2023
34;Palencia;018;Autilla del Pino;210;117;93;2023
34;Palencia;019;Autillo de Campos;129;67;62;2023
34;Palencia;020;Ayuela;53;35;18;2023
34;Palencia;022;Baltanás;1212;621;591;2023
34;Palencia;024;Baquerín de Campos;25;15;10;2023
34;Palencia;025;Bárcena de Campos;54;25;29;2023
34;Palencia;027;Barruelo de Santullán;1182;593;589;2023
34;Palencia;028;Báscones de Ojeda;134;71;63;2023
34;Palencia;029;Becerril de Campos;756;377;379;2023
34;Palencia;031;Belmonte de Campos;33;17;16;2023
34;Palencia;032;Berzosilla;43;24;19;2023
34;Palencia;033;Boada de Campos;19;14;5;2023
34;Palencia;035;Boadilla de Rioseco;99;60;39;2023
34;Palencia;034;Boadilla del Camino;117;68;49;2023
34;Palencia;036;Brañosera;254;142;112;2023
34;Palencia;037;Buenavista de Valdavia;309;173;136;2023
34;Palencia;038;Bustillo de la Vega;275;154;121;2023
34;Palencia;039;Bustillo del Páramo de Carrión;52;32;20;2023
34;Palencia;041;Calahorra de Boedo;87;42;45;2023
34;Palencia;042;Calzada de los Molinos;305;169;136;2023
34;Palencia;045;Capillas;71;41;30;2023
34;Palencia;046;Cardeñosa de Volpejera;59;35;24;2023
34;Palencia;047;Carrión de los Condes;2005;971;1034;2023
34;Palencia;048;Castil de Vela;57;29;28;2023
34;Palencia;049;Castrejón de la Peña;323;174;149;2023
34;Palencia;050;Castrillo de Don Juan;181;102;79;2023
34;Palencia;051;Castrillo de Onielo;99;52;47;2023
34;Palencia;052;Castrillo de Villavega;174;97;77;2023
34;Palencia;053;Castromocho;202;107;95;2023
34;Palencia;055;Cervatos de la Cueza;261;145;116;2023
34;Palencia;056;Cervera de Pisuerga;2265;1111;1154;2023
34;Palencia;057;Cevico de la Torre;466;238;228;2023
34;Palencia;058;Cevico Navero;178;105;73;2023
34;Palencia;059;Cisneros;409;201;208;2023
34;Palencia;060;Cobos de Cerrato;133;75;58;2023
34;Palencia;061;Collazos de Boedo;106;62;44;2023
34;Palencia;062;Congosto de Valdavia;141;87;54;2023
34;Palencia;063;Cordovilla la Real;129;70;59;2023
34;Palencia;066;Cubillas de Cerrato;62;36;26;2023
34;Palencia;067;Dehesa de Montejo;133;79;54;2023
34;Palencia;068;Dehesa de Romanos;53;34;19;2023
34;Palencia;069;Dueñas;2597;1315;1282;2023
34;Palencia;070;Espinosa de Cerrato;123;72;51;2023
34;Palencia;071;Espinosa de Villagonzalo;167;89;78;2023
34;Palencia;072;Frechilla;135;69;66;2023
34;Palencia;073;Fresno del Río;178;86;92;2023
34;Palencia;074;Frómista;755;380;375;2023
34;Palencia;076;Fuentes de Nava;593;308;285;2023
34;Palencia;077;Fuentes de Valdepero;481;246;235;2023
34;Palencia;079;Grijota;2690;1392;1298;2023
34;Palencia;080;Guardo;5653;2788;2865;2023
34;Palencia;081;Guaza de Campos;57;34;23;2023
34;Palencia;082;Hérmedes de Cerrato;74;38;36;2023
34;Palencia;083;Herrera de Pisuerga;1889;929;960;2023
34;Palencia;084;Herrera de Valdecañas;151;84;67;2023
34;Palencia;086;Hontoria de Cerrato;110;56;54;2023
34;Palencia;087;Hornillos de Cerrato;171;91;80;2023
34;Palencia;088;Husillos;392;217;175;2023
34;Palencia;089;Itero de la Vega;146;84;62;2023
34;Palencia;091;Lagartos;121;66;55;2023
34;Palencia;092;Lantadilla;281;150;131;2023
34;Palencia;094;Ledigos;64;33;31;2023
34;Palencia;903;Loma de Ucieza;184;114;70;2023
34;Palencia;096;Lomas;41;27;14;2023
34;Palencia;098;Magaz de Pisuerga;1011;533;478;2023
34;Palencia;099;Manquillos;52;34;18;2023
34;Palencia;100;Mantinos;143;83;60;2023
34;Palencia;101;Marcilla de Campos;49;22;27;2023
34;Palencia;102;Mazariegos;208;125;83;2023
34;Palencia;103;Mazuecos de Valdeginate;86;55;31;2023
34;Palencia;104;Melgar de Yuso;262;153;109;2023
34;Palencia;106;Meneses de Campos;96;54;42;2023
34;Palencia;107;Micieces de Ojeda;71;42;29;2023
34;Palencia;108;Monzón de Campos;578;310;268;2023
34;Palencia;109;Moratinos;65;35;30;2023
34;Palencia;110;Mudá;75;45;30;2023
34;Palencia;112;Nogal de las Huertas;44;25;19;2023
34;Palencia;113;Olea de Boedo;36;13;23;2023
34;Palencia;114;Olmos de Ojeda;179;114;65;2023
34;Palencia;116;Osornillo;59;32;27;2023
34;Palencia;901;Osorno la Mayor;1170;609;561;2023
34;Palencia;120;Palencia;76331;35884;40447;2023
34;Palencia;121;Palenzuela;213;121;92;2023
34;Palencia;122;Páramo de Boedo;105;63;42;2023
34;Palencia;123;Paredes de Nava;1895;961;934;2023
34;Palencia;124;Payo de Ojeda;59;37;22;2023
34;Palencia;125;Pedraza de Campos;76;42;34;2023
34;Palencia;126;Pedrosa de la Vega;286;162;124;2023
34;Palencia;127;Perales;115;54;61;2023
34;Palencia;904;Pernía, La;318;185;133;2023
34;Palencia;129;Pino del Río;162;98;64;2023
34;Palencia;130;Piña de Campos;196;105;91;2023
34;Palencia;131;Población de Arroyo;45;25;20;2023
34;Palencia;132;Población de Campos;126;72;54;2023
34;Palencia;133;Población de Cerrato;101;58;43;2023
34;Palencia;134;Polentinos;44;22;22;2023
34;Palencia;135;Pomar de Valdivia;484;266;218;2023
34;Palencia;136;Poza de la Vega;167;94;73;2023
34;Palencia;137;Pozo de Urama;19;14;5;2023
34;Palencia;139;Prádanos de Ojeda;178;98;80;2023
34;Palencia;140;Puebla de Valdavia, La;84;46;38;2023
34;Palencia;141;Quintana del Puente;259;140;119;2023
34;Palencia;143;Quintanilla de Onsoña;180;100;80;2023
34;Palencia;146;Reinoso de Cerrato;56;35;21;2023
34;Palencia;147;Renedo de la Vega;199;111;88;2023
34;Palencia;149;Requena de Campos;27;15;12;2023
34;Palencia;151;Respenda de la Peña;147;90;57;2023
34;Palencia;152;Revenga de Campos;136;65;71;2023
34;Palencia;154;Revilla de Collazos;78;43;35;2023
34;Palencia;155;Ribas de Campos;153;79;74;2023
34;Palencia;156;Riberos de la Cueza;55;33;22;2023
34;Palencia;157;Saldaña;2904;1489;1415;2023
34;Palencia;158;Salinas de Pisuerga;312;162;150;2023
34;Palencia;159;San Cebrián de Campos;415;242;173;2023
34;Palencia;160;San Cebrián de Mudá;146;80;66;2023
34;Palencia;161;San Cristóbal de Boedo;19;13;6;2023
34;Palencia;163;San Mamés de Campos;46;24;22;2023
34;Palencia;165;San Román de la Cuba;53;32;21;2023
34;Palencia;167;Santa Cecilia del Alcor;96;53;43;2023
34;Palencia;168;Santa Cruz de Boedo;49;29;20;2023
34;Palencia;169;Santervás de la Vega;402;226;176;2023
34;Palencia;170;Santibáñez de Ecla;47;27;20;2023
34;Palencia;171;Santibáñez de la Peña;962;464;498;2023
34;Palencia;174;Santoyo;188;104;84;2023
34;Palencia;175;Serna, La;89;53;36;2023
34;Palencia;177;Soto de Cerrato;175;100;75;2023
34;Palencia;176;Sotobañado y Priorato;158;91;67;2023
34;Palencia;178;Tabanera de Cerrato;138;74;64;2023
34;Palencia;179;Tabanera de Valdavia;23;14;9;2023
34;Palencia;180;Támara de Campos;75;39;36;2023
34;Palencia;181;Tariego de Cerrato;483;253;230;2023
34;Palencia;182;Torquemada;949;514;435;2023
34;Palencia;184;Torremormojón;45;28;17;2023
34;Palencia;185;Triollo;73;43;30;2023
34;Palencia;186;Valbuena de Pisuerga;54;28;26;2023
34;Palencia;189;Valdeolmillos;56;33;23;2023
34;Palencia;190;Valderrábano;49;26;23;2023
34;Palencia;192;Valde-Ucieza;82;51;31;2023
34;Palencia;196;Valle de Cerrato;82;45;37;2023
34;Palencia;902;Valle del Retortillo;170;93;77;2023
34;Palencia;199;Velilla del Río Carrión;1145;582;563;2023
34;Palencia;023;Venta de Baños;6284;3174;3110;2023
34;Palencia;201;Vertavillo;163;84;79;2023
34;Palencia;093;Vid de Ojeda, La;93;56;37;2023
34;Palencia;202;Villabasta de Valdavia;33;19;14;2023
34;Palencia;204;Villacidaler;46;27;19;2023
34;Palencia;205;Villaconancio;55;32;23;2023
34;Palencia;206;Villada;850;430;420;2023
34;Palencia;208;Villaeles de Valdavia;49;31;18;2023
34;Palencia;210;Villahán;99;59;40;2023
34;Palencia;211;Villaherreros;214;113;101;2023
34;Palencia;213;Villalaco;57;33;24;2023
34;Palencia;214;Villalba de Guardo;202;111;91;2023
34;Palencia;215;Villalcázar de Sirga;174;89;85;2023
34;Palencia;216;Villalcón;53;29;24;2023
34;Palencia;217;Villalobón;1871;937;934;2023
34;Palencia;218;Villaluenga de la Vega;524;302;222;2023
34;Palencia;220;Villamartín de Campos;175;95;80;2023
34;Palencia;221;Villamediana;181;110;71;2023
34;Palencia;222;Villameriel;111;64;47;2023
34;Palencia;223;Villamoronta;252;152;100;2023
34;Palencia;224;Villamuera de la Cueza;38;25;13;2023
34;Palencia;225;Villamuriel de Cerrato;6459;3315;3144;2023
34;Palencia;227;Villanueva del Rebollar;69;37;32;2023
34;Palencia;228;Villanuño de Valdavia;92;51;41;2023
34;Palencia;229;Villaprovedo;52;36;16;2023
34;Palencia;230;Villarmentero de Campos;20;13;7;2023
34;Palencia;231;Villarrabé;183;95;88;2023
34;Palencia;232;Villarramiel;819;434;385;2023
34;Palencia;233;Villasarracino;136;81;55;2023
34;Palencia;234;Villasila de Valdavia;64;43;21;2023
34;Palencia;236;Villaturde;138;72;66;2023
34;Palencia;237;Villaumbrales;643;322;321;2023
34;Palencia;238;Villaviudas;360;174;186;2023
34;Palencia;240;Villerías de Campos;73;39;34;2023
34;Palencia;241;Villodre;21;12;9;2023
34;Palencia;242;Villodrigo;107;55;52;2023
34;Palencia;243;Villoldo;336;181;155;2023
34;Palencia;245;Villota del Páramo;305;176;129;2023
34;Palencia;246;Villovieco;66;36;30;2023
35;Palmas, Las;001;Agaete;5568;2802;2766;2023
35;Palmas, Las;002;Agüimes;32643;16422;16221;2023
35;Palmas, Las;020;Aldea de San Nicolás, La;7506;3893;3613;2023
35;Palmas, Las;003;Antigua;13523;7094;6429;2023
35;Palmas, Las;004;Arrecife;64826;32459;32367;2023
35;Palmas, Las;005;Artenara;1032;598;434;2023
35;Palmas, Las;006;Arucas;38601;19090;19511;2023
35;Palmas, Las;007;Betancuria;816;434;382;2023
35;Palmas, Las;008;Firgas;7669;3887;3782;2023
35;Palmas, Las;009;Gáldar;24678;12360;12318;2023
35;Palmas, Las;010;Haría;5507;2818;2689;2023
35;Palmas, Las;011;Ingenio;32354;16294;16060;2023
35;Palmas, Las;012;Mogán;20845;10721;10124;2023
35;Palmas, Las;013;Moya;7889;3991;3898;2023
35;Palmas, Las;014;Oliva, La;29099;15055;14044;2023
35;Palmas, Las;015;Pájara;21271;10988;10283;2023
35;Palmas, Las;016;Palmas de Gran Canaria, Las;378027;181846;196181;2023
35;Palmas, Las;017;Puerto del Rosario;43390;21811;21579;2023
35;Palmas, Las;018;San Bartolomé;19200;9509;9691;2023
35;Palmas, Las;019;San Bartolomé de Tirajana;53912;28282;25630;2023
35;Palmas, Las;021;Santa Brígida;18510;9234;9276;2023
35;Palmas, Las;022;Santa Lucía de Tirajana;75677;37587;38090;2023
35;Palmas, Las;023;Santa María de Guía de Gran Canaria;13948;6945;7003;2023
35;Palmas, Las;024;Teguise;23881;11962;11919;2023
35;Palmas, Las;025;Tejeda;1844;1008;836;2023
35;Palmas, Las;026;Telde;102487;50233;52254;2023
35;Palmas, Las;027;Teror;12799;6547;6252;2023
35;Palmas, Las;028;Tías;21433;10900;10533;2023
35;Palmas, Las;029;Tinajo;6759;3428;3331;2023
35;Palmas, Las;030;Tuineje;15967;8139;7828;2023
35;Palmas, Las;032;Valleseco;3733;1950;1783;2023
35;Palmas, Las;031;Valsequillo de Gran Canaria;9667;4860;4807;2023
35;Palmas, Las;033;Vega de San Mateo;7782;3993;3789;2023
35;Palmas, Las;034;Yaiza;17415;8932;8483;2023
36;Pontevedra;020;Agolada;2254;1120;1134;2023
36;Pontevedra;001;Arbo;2647;1367;1280;2023
36;Pontevedra;003;Baiona;12407;6109;6298;2023
36;Pontevedra;002;Barro;3651;1783;1868;2023
36;Pontevedra;004;Bueu;11922;5857;6065;2023
36;Pontevedra;005;Caldas de Reis;9620;4659;4961;2023
36;Pontevedra;006;Cambados;13681;6605;7076;2023
36;Pontevedra;007;Campo Lameiro;1723;822;901;2023
36;Pontevedra;008;Cangas;26807;13288;13519;2023
36;Pontevedra;009;Cañiza, A;5090;2489;2601;2023
36;Pontevedra;010;Catoira;3289;1593;1696;2023
36;Pontevedra;902;Cerdedo-Cotobade;5687;2773;2914;2023
36;Pontevedra;013;Covelo;2426;1259;1167;2023
36;Pontevedra;014;Crecente;1978;969;1009;2023
36;Pontevedra;015;Cuntis;4549;2161;2388;2023
36;Pontevedra;016;Dozón;1017;526;491;2023
36;Pontevedra;017;Estrada, A;20081;9665;10416;2023
36;Pontevedra;018;Forcarei;3186;1518;1668;2023
36;Pontevedra;019;Fornelos de Montes;1647;802;845;2023
36;Pontevedra;021;Gondomar;15043;7502;7541;2023
36;Pontevedra;022;Grove, O;10828;5318;5510;2023
36;Pontevedra;023;Guarda, A;9998;4929;5069;2023
36;Pontevedra;901;Illa de Arousa, A;4876;2402;2474;2023
36;Pontevedra;024;Lalín;20282;9904;10378;2023
36;Pontevedra;025;Lama, A;2520;1267;1253;2023
36;Pontevedra;026;Marín;24197;11970;12227;2023
36;Pontevedra;027;Meaño;5258;2569;2689;2023
36;Pontevedra;028;Meis;4706;2262;2444;2023
36;Pontevedra;029;Moaña;19315;9387;9928;2023
36;Pontevedra;030;Mondariz;4444;2200;2244;2023
36;Pontevedra;031;Mondariz-Balneario;703;356;347;2023
36;Pontevedra;032;Moraña;4126;2008;2118;2023
36;Pontevedra;033;Mos;15076;7432;7644;2023
36;Pontevedra;034;Neves, As;3739;1841;1898;2023
36;Pontevedra;035;Nigrán;18045;8856;9189;2023
36;Pontevedra;036;Oia;3104;1528;1576;2023
36;Pontevedra;037;Pazos de Borbén;2993;1466;1527;2023
36;Pontevedra;041;Poio;17297;8520;8777;2023
36;Pontevedra;043;Ponte Caldelas;5553;2657;2896;2023
36;Pontevedra;042;Ponteareas;23154;11208;11946;2023
36;Pontevedra;044;Pontecesures;3096;1525;1571;2023
36;Pontevedra;038;Pontevedra;82535;38885;43650;2023
36;Pontevedra;039;Porriño, O;20562;10116;10446;2023
36;Pontevedra;040;Portas;2823;1362;1461;2023
36;Pontevedra;045;Redondela;28937;13994;14943;2023
36;Pontevedra;046;Ribadumia;5189;2535;2654;2023
36;Pontevedra;047;Rodeiro;2260;1142;1118;2023
36;Pontevedra;048;Rosal, O;6431;3157;3274;2023
36;Pontevedra;049;Salceda de Caselas;9421;4701;4720;2023
36;Pontevedra;050;Salvaterra de Miño;10274;5107;5167;2023
36;Pontevedra;051;Sanxenxo;17854;8827;9027;2023
36;Pontevedra;052;Silleda;8876;4343;4533;2023
36;Pontevedra;053;Soutomaior;7603;3783;3820;2023
36;Pontevedra;054;Tomiño;13836;6942;6894;2023
36;Pontevedra;055;Tui;17327;8404;8923;2023
36;Pontevedra;056;Valga;5704;2783;2921;2023
36;Pontevedra;057;Vigo;293652;138310;155342;2023
36;Pontevedra;059;Vila de Cruces;5082;2530;2552;2023
36;Pontevedra;058;Vilaboa;5950;2927;3023;2023
36;Pontevedra;060;Vilagarcía de Arousa;37689;18020;19669;2023
36;Pontevedra;061;Vilanova de Arousa;10225;4969;5256;2023
26;Rioja, La;001;Ábalos;258;146;112;2023
26;Rioja, La;002;Agoncillo;1228;665;563;2023
26;Rioja, La;003;Aguilar del Río Alhama;428;219;209;2023
26;Rioja, La;004;Ajamil de Cameros;90;55;35;2023
26;Rioja, La;005;Albelda de Iregua;3738;1921;1817;2023
26;Rioja, La;006;Alberite;2628;1348;1280;2023
26;Rioja, La;007;Alcanadre;669;347;322;2023
26;Rioja, La;008;Aldeanueva de Ebro;2726;1419;1307;2023
26;Rioja, La;009;Alesanco;474;241;233;2023
26;Rioja, La;010;Alesón;98;55;43;2023
26;Rioja, La;011;Alfaro;9823;4921;4902;2023
26;Rioja, La;012;Almarza de Cameros;39;25;14;2023
26;Rioja, La;013;Anguciana;435;244;191;2023
26;Rioja, La;014;Anguiano;499;274;225;2023
26;Rioja, La;015;Arenzana de Abajo;251;135;116;2023
26;Rioja, La;016;Arenzana de Arriba;33;23;10;2023
26;Rioja, La;017;Arnedillo;436;216;220;2023
26;Rioja, La;018;Arnedo;15201;7587;7614;2023
26;Rioja, La;019;Arrúbal;582;307;275;2023
26;Rioja, La;020;Ausejo;795;425;370;2023
26;Rioja, La;021;Autol;4834;2435;2399;2023
26;Rioja, La;022;Azofra;215;117;98;2023
26;Rioja, La;023;Badarán;496;251;245;2023
26;Rioja, La;024;Bañares;201;109;92;2023
26;Rioja, La;026;Baños de Río Tobía;1608;814;794;2023
26;Rioja, La;025;Baños de Rioja;84;52;32;2023
26;Rioja, La;027;Berceo;139;88;51;2023
26;Rioja, La;028;Bergasa;163;86;77;2023
26;Rioja, La;029;Bergasillas Bajera;39;21;18;2023
26;Rioja, La;030;Bezares;26;13;13;2023
26;Rioja, La;031;Bobadilla;97;49;48;2023
26;Rioja, La;032;Brieva de Cameros;43;27;16;2023
26;Rioja, La;033;Briñas;182;91;91;2023
26;Rioja, La;034;Briones;739;388;351;2023
26;Rioja, La;035;Cabezón de Cameros;23;15;8;2023
26;Rioja, La;036;Calahorra;24994;12250;12744;2023
26;Rioja, La;037;Camprovín;174;95;79;2023
26;Rioja, La;038;Canales de la Sierra;81;55;26;2023
26;Rioja, La;039;Canillas de Río Tuerto;50;30;20;2023
26;Rioja, La;040;Cañas;92;51;41;2023
26;Rioja, La;041;Cárdenas;132;72;60;2023
26;Rioja, La;042;Casalarreina;1062;531;531;2023
26;Rioja, La;043;Castañares de Rioja;385;177;208;2023
26;Rioja, La;044;Castroviejo;62;34;28;2023
26;Rioja, La;045;Cellorigo;10;4;6;2023
26;Rioja, La;046;Cenicero;2067;1063;1004;2023
26;Rioja, La;047;Cervera del Río Alhama;2262;1163;1099;2023
26;Rioja, La;048;Cidamón;22;11;11;2023
26;Rioja, La;049;Cihuri;207;105;102;2023
26;Rioja, La;050;Cirueña;198;123;75;2023
26;Rioja, La;051;Clavijo;296;173;123;2023
26;Rioja, La;052;Cordovín;153;76;77;2023
26;Rioja, La;053;Corera;283;142;141;2023
26;Rioja, La;054;Cornago;304;174;130;2023
26;Rioja, La;055;Corporales;38;24;14;2023
26;Rioja, La;056;Cuzcurrita de Río Tirón;566;297;269;2023
26;Rioja, La;057;Daroca de Rioja;60;38;22;2023
26;Rioja, La;058;Enciso;174;113;61;2023
26;Rioja, La;059;Entrena;1637;858;779;2023
26;Rioja, La;060;Estollo;93;55;38;2023
26;Rioja, La;061;Ezcaray;2080;1078;1002;2023
26;Rioja, La;062;Foncea;94;55;39;2023
26;Rioja, La;063;Fonzaleche;130;84;46;2023
26;Rioja, La;064;Fuenmayor;3259;1630;1629;2023
26;Rioja, La;065;Galbárruli;89;55;34;2023
26;Rioja, La;066;Galilea;394;199;195;2023
26;Rioja, La;067;Gallinero de Cameros;17;10;7;2023
26;Rioja, La;068;Gimileo;112;59;53;2023
26;Rioja, La;069;Grañón;235;130;105;2023
26;Rioja, La;070;Grávalos;170;92;78;2023
26;Rioja, La;071;Haro;11763;5798;5965;2023
26;Rioja, La;072;Herce;325;167;158;2023
26;Rioja, La;073;Herramélluri;109;58;51;2023
26;Rioja, La;074;Hervías;133;72;61;2023
26;Rioja, La;075;Hormilla;441;231;210;2023
26;Rioja, La;076;Hormilleja;131;70;61;2023
26;Rioja, La;077;Hornillos de Cameros;15;8;7;2023
26;Rioja, La;078;Hornos de Moncalvillo;96;57;39;2023
26;Rioja, La;079;Huércanos;858;475;383;2023
26;Rioja, La;080;Igea;648;366;282;2023
26;Rioja, La;081;Jalón de Cameros;23;10;13;2023
26;Rioja, La;082;Laguna de Cameros;115;64;51;2023
26;Rioja, La;083;Lagunilla del Jubera;394;218;176;2023
26;Rioja, La;084;Lardero;11321;5666;5655;2023
26;Rioja, La;086;Ledesma de la Cogolla;16;12;4;2023
26;Rioja, La;087;Leiva;246;122;124;2023
26;Rioja, La;088;Leza de Río Leza;40;24;16;2023
26;Rioja, La;089;Logroño;150583;71340;79243;2023
26;Rioja, La;091;Lumbreras de Cameros;145;100;45;2023
26;Rioja, La;092;Manjarrés;108;67;41;2023
26;Rioja, La;093;Mansilla de la Sierra;60;44;16;2023
26;Rioja, La;094;Manzanares de Rioja;58;37;21;2023
26;Rioja, La;095;Matute;86;52;34;2023
26;Rioja, La;096;Medrano;350;190;160;2023
26;Rioja, La;098;Munilla;100;57;43;2023
26;Rioja, La;099;Murillo de Río Leza;1643;833;810;2023
26;Rioja, La;100;Muro de Aguas;57;37;20;2023
26;Rioja, La;101;Muro en Cameros;40;22;18;2023
26;Rioja, La;102;Nájera;8059;3994;4065;2023
26;Rioja, La;103;Nalda;1329;720;609;2023
26;Rioja, La;104;Navajún;8;7;1;2023
26;Rioja, La;105;Navarrete;3040;1529;1511;2023
26;Rioja, La;106;Nestares;83;50;33;2023
26;Rioja, La;107;Nieva de Cameros;87;54;33;2023
26;Rioja, La;109;Ochánduri;87;51;36;2023
26;Rioja, La;108;Ocón;318;195;123;2023
26;Rioja, La;110;Ojacastro;172;102;70;2023
26;Rioja, La;111;Ollauri;312;169;143;2023
26;Rioja, La;112;Ortigosa de Cameros;222;136;86;2023
26;Rioja, La;113;Pazuengos;27;22;5;2023
26;Rioja, La;114;Pedroso;89;54;35;2023
26;Rioja, La;115;Pinillos;25;14;11;2023
26;Rioja, La;117;Pradejón;3817;1985;1832;2023
26;Rioja, La;118;Pradillo;67;37;30;2023
26;Rioja, La;119;Préjano;211;115;96;2023
26;Rioja, La;120;Quel;2151;1155;996;2023
26;Rioja, La;121;Rabanera;33;25;8;2023
26;Rioja, La;122;Rasillo de Cameros, El;149;86;63;2023
26;Rioja, La;123;Redal, El;148;87;61;2023
26;Rioja, La;124;Ribafrecha;1041;540;501;2023
26;Rioja, La;125;Rincón de Soto;4021;2092;1929;2023
26;Rioja, La;126;Robres del Castillo;27;17;10;2023
26;Rioja, La;127;Rodezno;202;114;88;2023
26;Rioja, La;128;Sajazarra;130;74;56;2023
26;Rioja, La;129;San Asensio;1097;582;515;2023
26;Rioja, La;130;San Millán de la Cogolla;214;144;70;2023
26;Rioja, La;131;San Millán de Yécora;35;25;10;2023
26;Rioja, La;132;San Román de Cameros;126;79;47;2023
26;Rioja, La;139;San Torcuato;63;33;30;2023
26;Rioja, La;142;San Vicente de la Sonsierra;1010;535;475;2023
26;Rioja, La;134;Santa Coloma;98;57;41;2023
26;Rioja, La;135;Santa Engracia del Jubera;198;119;79;2023
26;Rioja, La;136;Santa Eulalia Bajera;117;67;50;2023
26;Rioja, La;138;Santo Domingo de la Calzada;6283;3135;3148;2023
26;Rioja, La;140;Santurde de Rioja;280;150;130;2023
26;Rioja, La;141;Santurdejo;101;60;41;2023
26;Rioja, La;143;Sojuela;603;333;270;2023
26;Rioja, La;144;Sorzano;221;124;97;2023
26;Rioja, La;145;Sotés;260;143;117;2023
26;Rioja, La;146;Soto en Cameros;86;50;36;2023
26;Rioja, La;147;Terroba;41;20;21;2023
26;Rioja, La;148;Tirgo;171;89;82;2023
26;Rioja, La;149;Tobía;46;26;20;2023
26;Rioja, La;150;Tormantos;122;71;51;2023
26;Rioja, La;153;Torre en Cameros;9;7;2;2023
26;Rioja, La;151;Torrecilla en Cameros;434;243;191;2023
26;Rioja, La;152;Torrecilla sobre Alesanco;54;32;22;2023
26;Rioja, La;154;Torremontalbo;8;7;1;2023
26;Rioja, La;155;Treviana;141;75;66;2023
26;Rioja, La;157;Tricio;356;178;178;2023
26;Rioja, La;158;Tudelilla;356;191;165;2023
26;Rioja, La;160;Uruñuela;984;505;479;2023
26;Rioja, La;161;Valdemadera;12;9;3;2023
26;Rioja, La;162;Valgañón;137;81;56;2023
26;Rioja, La;163;Ventosa;194;99;95;2023
26;Rioja, La;164;Ventrosa;51;30;21;2023
26;Rioja, La;165;Viguera;378;219;159;2023
26;Rioja, La;166;Villalba de Rioja;169;95;74;2023
26;Rioja, La;167;Villalobar de Rioja;72;46;26;2023
26;Rioja, La;168;Villamediana de Iregua;8954;4494;4460;2023
26;Rioja, La;169;Villanueva de Cameros;74;45;29;2023
26;Rioja, La;170;Villar de Arnedo, El;616;332;284;2023
26;Rioja, La;171;Villar de Torre;153;96;57;2023
26;Rioja, La;172;Villarejo;28;22;6;2023
26;Rioja, La;173;Villarroya;3;2;1;2023
26;Rioja, La;174;Villarta-Quintana;136;79;57;2023
26;Rioja, La;175;Villavelayo;42;28;14;2023
26;Rioja, La;176;Villaverde de Rioja;76;44;32;2023
26;Rioja, La;177;Villoslada de Cameros;348;223;125;2023
26;Rioja, La;178;Viniegra de Abajo;73;47;26;2023
26;Rioja, La;179;Viniegra de Arriba;41;28;13;2023
26;Rioja, La;180;Zarratón;259;134;125;2023
26;Rioja, La;181;Zarzosa;13;9;4;2023
26;Rioja, La;183;Zorraquín;86;44;42;2023
37;Salamanca;001;Abusejo;150;79;71;2023
37;Salamanca;002;Agallas;126;71;55;2023
37;Salamanca;003;Ahigal de los Aceiteros;94;52;42;2023
37;Salamanca;004;Ahigal de Villarino;31;18;13;2023
37;Salamanca;005;Alameda de Gardón, La;79;38;41;2023
37;Salamanca;006;Alamedilla, La;108;54;54;2023
37;Salamanca;007;Alaraz;437;229;208;2023
37;Salamanca;008;Alba de Tormes;5058;2547;2511;2023
37;Salamanca;009;Alba de Yeltes;201;110;91;2023
37;Salamanca;010;Alberca, La;1061;515;546;2023
37;Salamanca;011;Alberguería de Argañán, La;103;57;46;2023
37;Salamanca;012;Alconada;140;78;62;2023
37;Salamanca;015;Aldea del Obispo;275;150;125;2023
37;Salamanca;013;Aldeacipreste;94;52;42;2023
37;Salamanca;014;Aldeadávila de la Ribera;1131;571;560;2023
37;Salamanca;016;Aldealengua;668;337;331;2023
37;Salamanca;017;Aldeanueva de Figueroa;254;136;118;2023
37;Salamanca;018;Aldeanueva de la Sierra;106;68;38;2023
37;Salamanca;019;Aldearrodrigo;146;81;65;2023
37;Salamanca;020;Aldearrubia;514;274;240;2023
37;Salamanca;021;Aldeaseca de Alba;66;39;27;2023
37;Salamanca;022;Aldeaseca de la Frontera;254;131;123;2023
37;Salamanca;023;Aldeatejada;2518;1275;1243;2023
37;Salamanca;024;Aldeavieja de Tormes;100;54;46;2023
37;Salamanca;025;Aldehuela de la Bóveda;271;145;126;2023
37;Salamanca;026;Aldehuela de Yeltes;191;104;87;2023
37;Salamanca;027;Almenara de Tormes;299;162;137;2023
37;Salamanca;028;Almendra;125;68;57;2023
37;Salamanca;029;Anaya de Alba;187;111;76;2023
37;Salamanca;030;Añover de Tormes;89;48;41;2023
37;Salamanca;031;Arabayona de Mógica;333;190;143;2023
37;Salamanca;032;Arapiles;725;393;332;2023
37;Salamanca;033;Arcediano;100;53;47;2023
37;Salamanca;034;Arco, El;93;45;48;2023
37;Salamanca;035;Armenteros;256;159;97;2023
37;Salamanca;037;Atalaya, La;100;53;47;2023
37;Salamanca;038;Babilafuente;927;488;439;2023
37;Salamanca;039;Bañobárez;280;142;138;2023
37;Salamanca;040;Barbadillo;395;217;178;2023
37;Salamanca;041;Barbalos;71;42;29;2023
37;Salamanca;042;Barceo;48;29;19;2023
37;Salamanca;044;Barruecopardo;418;235;183;2023
37;Salamanca;045;Bastida, La;28;15;13;2023
37;Salamanca;046;Béjar;12021;5697;6324;2023
37;Salamanca;047;Beleña;277;136;141;2023
37;Salamanca;049;Bermellar;131;67;64;2023
37;Salamanca;050;Berrocal de Huebra;75;40;35;2023
37;Salamanca;051;Berrocal de Salvatierra;72;41;31;2023
37;Salamanca;052;Boada;273;142;131;2023
37;Salamanca;054;Bodón, El;245;135;110;2023
37;Salamanca;055;Bogajo;130;72;58;2023
37;Salamanca;056;Bouza, La;47;19;28;2023
37;Salamanca;057;Bóveda del Río Almar;199;104;95;2023
37;Salamanca;058;Brincones;60;32;28;2023
37;Salamanca;059;Buenamadre;116;58;58;2023
37;Salamanca;060;Buenavista;373;193;180;2023
37;Salamanca;061;Cabaco, El;238;124;114;2023
37;Salamanca;063;Cabeza de Béjar, La;58;40;18;2023
37;Salamanca;065;Cabeza del Caballo;248;133;115;2023
37;Salamanca;062;Cabezabellosa de la Calzada;75;47;28;2023
37;Salamanca;067;Cabrerizos;4224;2110;2114;2023
37;Salamanca;068;Cabrillas;324;164;160;2023
37;Salamanca;069;Calvarrasa de Abajo;1191;618;573;2023
37;Salamanca;070;Calvarrasa de Arriba;597;318;279;2023
37;Salamanca;071;Calzada de Béjar, La;88;51;37;2023
37;Salamanca;072;Calzada de Don Diego;137;72;65;2023
37;Salamanca;073;Calzada de Valdunciel;702;350;352;2023
37;Salamanca;074;Campillo de Azaba;141;87;54;2023
37;Salamanca;077;Campo de Peñaranda, El;263;151;112;2023
37;Salamanca;078;Candelario;841;433;408;2023
37;Salamanca;079;Canillas de Abajo;75;50;25;2023
37;Salamanca;080;Cantagallo;275;140;135;2023
37;Salamanca;081;Cantalapiedra;909;457;452;2023
37;Salamanca;082;Cantalpino;817;440;377;2023
37;Salamanca;083;Cantaracillo;188;98;90;2023
37;Salamanca;085;Carbajosa de la Sagrada;7555;3747;3808;2023
37;Salamanca;086;Carpio de Azaba;111;59;52;2023
37;Salamanca;087;Carrascal de Barregas;1415;736;679;2023
37;Salamanca;088;Carrascal del Obispo;192;107;85;2023
37;Salamanca;089;Casafranca;72;35;37;2023
37;Salamanca;090;Casas del Conde, Las;61;29;32;2023
37;Salamanca;091;Casillas de Flores;179;87;92;2023
37;Salamanca;092;Castellanos de Moriscos;2989;1533;1456;2023
37;Salamanca;185;Castellanos de Villiquera;683;361;322;2023
37;Salamanca;096;Castillejo de Martín Viejo;219;131;88;2023
37;Salamanca;097;Castraz;37;24;13;2023
37;Salamanca;098;Cepeda;290;147;143;2023
37;Salamanca;099;Cereceda de la Sierra;66;34;32;2023
37;Salamanca;100;Cerezal de Peñahorcada;73;37;36;2023
37;Salamanca;101;Cerralbo;119;64;55;2023
37;Salamanca;102;Cerro, El;368;186;182;2023
37;Salamanca;103;Cespedosa de Tormes;501;268;233;2023
37;Salamanca;114;Chagarcía Medianero;80;45;35;2023
37;Salamanca;104;Cilleros de la Bastida;21;12;9;2023
37;Salamanca;106;Cipérez;242;126;116;2023
37;Salamanca;107;Ciudad Rodrigo;11810;5653;6157;2023
37;Salamanca;108;Coca de Alba;102;51;51;2023
37;Salamanca;109;Colmenar de Montemayor;179;107;72;2023
37;Salamanca;110;Cordovilla;111;62;49;2023
37;Salamanca;112;Cristóbal;166;100;66;2023
37;Salamanca;113;Cubo de Don Sancho, El;396;209;187;2023
37;Salamanca;115;Dios le Guarde;122;66;56;2023
37;Salamanca;116;Doñinos de Ledesma;67;35;32;2023
37;Salamanca;117;Doñinos de Salamanca;2288;1206;1082;2023
37;Salamanca;118;Éjeme;144;83;61;2023
37;Salamanca;120;Encina de San Silvestre;111;52;59;2023
37;Salamanca;119;Encina, La;101;60;41;2023
37;Salamanca;121;Encinas de Abajo;618;319;299;2023
37;Salamanca;122;Encinas de Arriba;235;117;118;2023
37;Salamanca;123;Encinasola de los Comendadores;153;85;68;2023
37;Salamanca;124;Endrinal;203;117;86;2023
37;Salamanca;125;Escurial de la Sierra;233;129;104;2023
37;Salamanca;126;Espadaña;34;20;14;2023
37;Salamanca;127;Espeja;211;113;98;2023
37;Salamanca;128;Espino de la Orbada;240;132;108;2023
37;Salamanca;129;Florida de Liébana;251;141;110;2023
37;Salamanca;130;Forfoleda;208;114;94;2023
37;Salamanca;131;Frades de la Sierra;181;102;79;2023
37;Salamanca;132;Fregeneda, La;310;155;155;2023
37;Salamanca;133;Fresnedoso;102;57;45;2023
37;Salamanca;134;Fresno Alhándiga;191;102;89;2023
37;Salamanca;135;Fuente de San Esteban, La;1284;654;630;2023
37;Salamanca;136;Fuenteguinaldo;662;322;340;2023
37;Salamanca;137;Fuenteliante;89;43;46;2023
37;Salamanca;138;Fuenterroble de Salvatierra;253;133;120;2023
37;Salamanca;139;Fuentes de Béjar;233;123;110;2023
37;Salamanca;140;Fuentes de Oñoro;1043;560;483;2023
37;Salamanca;141;Gajates;146;73;73;2023
37;Salamanca;142;Galindo y Perahuy;665;379;286;2023
37;Salamanca;143;Galinduste;394;190;204;2023
37;Salamanca;144;Galisancho;333;180;153;2023
37;Salamanca;145;Gallegos de Argañán;269;135;134;2023
37;Salamanca;146;Gallegos de Solmirón;109;62;47;2023
37;Salamanca;147;Garcibuey;200;114;86;2023
37;Salamanca;148;Garcihernández;418;217;201;2023
37;Salamanca;149;Garcirrey;57;33;24;2023
37;Salamanca;150;Gejuelo del Barro;31;18;13;2023
37;Salamanca;151;Golpejas;148;79;69;2023
37;Salamanca;152;Gomecello;409;217;192;2023
37;Salamanca;154;Guadramiro;133;82;51;2023
37;Salamanca;155;Guijo de Ávila;77;42;35;2023
37;Salamanca;156;Guijuelo;5484;2776;2708;2023
37;Salamanca;157;Herguijuela de Ciudad Rodrigo;70;42;28;2023
37;Salamanca;158;Herguijuela de la Sierra;230;127;103;2023
37;Salamanca;159;Herguijuela del Campo;66;33;33;2023
37;Salamanca;160;Hinojosa de Duero;600;303;297;2023
37;Salamanca;161;Horcajo de Montemayor;110;57;53;2023
37;Salamanca;162;Horcajo Medianero;212;114;98;2023
37;Salamanca;163;Hoya, La;31;19;12;2023
37;Salamanca;164;Huerta;278;155;123;2023
37;Salamanca;165;Iruelos;26;11;15;2023
37;Salamanca;166;Ituero de Azaba;205;107;98;2023
37;Salamanca;167;Juzbado;189;97;92;2023
37;Salamanca;168;Lagunilla;436;239;197;2023
37;Salamanca;169;Larrodrigo;183;102;81;2023
37;Salamanca;170;Ledesma;1539;755;784;2023
37;Salamanca;171;Ledrada;447;231;216;2023
37;Salamanca;172;Linares de Riofrío;923;508;415;2023
37;Salamanca;173;Lumbrales;1517;776;741;2023
37;Salamanca;175;Machacón;444;226;218;2023
37;Salamanca;174;Macotera;1003;522;481;2023
37;Salamanca;176;Madroñal;140;79;61;2023
37;Salamanca;177;Maíllo, El;290;167;123;2023
37;Salamanca;178;Malpartida;90;47;43;2023
37;Salamanca;179;Mancera de Abajo;203;105;98;2023
37;Salamanca;180;Manzano, El;60;31;29;2023
37;Salamanca;181;Martiago;264;146;118;2023
37;Salamanca;183;Martín de Yeltes;397;200;197;2023
37;Salamanca;182;Martinamor;79;51;28;2023
37;Salamanca;184;Masueco;262;138;124;2023
37;Salamanca;186;Mata de Ledesma, La;104;58;46;2023
37;Salamanca;187;Matilla de los Caños del Río;628;306;322;2023
37;Salamanca;188;Maya, La;159;90;69;2023
37;Salamanca;189;Membribe de la Sierra;102;60;42;2023
37;Salamanca;190;Mieza;179;90;89;2023
37;Salamanca;191;Milano, El;93;59;34;2023
37;Salamanca;192;Miranda de Azán;455;250;205;2023
37;Salamanca;193;Miranda del Castañar;392;214;178;2023
37;Salamanca;194;Mogarraz;253;130;123;2023
37;Salamanca;195;Molinillo;47;26;21;2023
37;Salamanca;196;Monforte de la Sierra;59;29;30;2023
37;Salamanca;197;Monleón;89;54;35;2023
37;Salamanca;198;Monleras;241;120;121;2023
37;Salamanca;199;Monsagro;133;77;56;2023
37;Salamanca;200;Montejo;211;117;94;2023
37;Salamanca;201;Montemayor del Río;266;142;124;2023
37;Salamanca;202;Monterrubio de Armuña;1315;677;638;2023
37;Salamanca;203;Monterrubio de la Sierra;152;87;65;2023
37;Salamanca;204;Morasverdes;245;128;117;2023
37;Salamanca;205;Morille;227;120;107;2023
37;Salamanca;206;Moríñigo;87;47;40;2023
37;Salamanca;207;Moriscos;552;298;254;2023
37;Salamanca;208;Moronta;74;45;29;2023
37;Salamanca;209;Mozárbez;514;272;242;2023
37;Salamanca;211;Narros de Matalayegua;208;116;92;2023
37;Salamanca;213;Nava de Béjar;76;44;32;2023
37;Salamanca;214;Nava de Francia;122;64;58;2023
37;Salamanca;215;Nava de Sotrobal;165;96;69;2023
37;Salamanca;212;Navacarros;132;72;60;2023
37;Salamanca;216;Navales;305;167;138;2023
37;Salamanca;217;Navalmoral de Béjar;60;29;31;2023
37;Salamanca;218;Navamorales;43;28;15;2023
37;Salamanca;219;Navarredonda de la Rinconada;156;80;76;2023
37;Salamanca;221;Navasfrías;370;200;170;2023
37;Salamanca;222;Negrilla de Palencia;80;47;33;2023
37;Salamanca;223;Olmedo de Camaces;100;56;44;2023
37;Salamanca;224;Orbada, La;181;94;87;2023
37;Salamanca;225;Pajares de la Laguna;109;58;51;2023
37;Salamanca;226;Palacios del Arzobispo;151;82;69;2023
37;Salamanca;228;Palaciosrubios;305;163;142;2023
37;Salamanca;229;Palencia de Negrilla;145;90;55;2023
37;Salamanca;230;Parada de Arriba;259;135;124;2023
37;Salamanca;231;Parada de Rubiales;249;136;113;2023
37;Salamanca;232;Paradinas de San Juan;394;234;160;2023
37;Salamanca;233;Pastores;54;31;23;2023
37;Salamanca;234;Payo, El;325;162;163;2023
37;Salamanca;235;Pedraza de Alba;222;115;107;2023
37;Salamanca;236;Pedrosillo de Alba;124;73;51;2023
37;Salamanca;237;Pedrosillo de los Aires;321;190;131;2023
37;Salamanca;238;Pedrosillo el Ralo;129;67;62;2023
37;Salamanca;239;Pedroso de la Armuña, El;209;110;99;2023
37;Salamanca;240;Pelabravo;1323;719;604;2023
37;Salamanca;241;Pelarrodríguez;162;97;65;2023
37;Salamanca;242;Pelayos;74;44;30;2023
37;Salamanca;243;Peña, La;72;40;32;2023
37;Salamanca;244;Peñacaballera;155;74;81;2023
37;Salamanca;245;Peñaparda;319;163;156;2023
37;Salamanca;246;Peñaranda de Bracamonte;6079;2985;3094;2023
37;Salamanca;247;Peñarandilla;184;103;81;2023
37;Salamanca;248;Peralejos de Abajo;168;92;76;2023
37;Salamanca;249;Peralejos de Arriba;35;23;12;2023
37;Salamanca;250;Pereña de la Ribera;312;171;141;2023
37;Salamanca;251;Peromingo;122;60;62;2023
37;Salamanca;252;Pinedas;106;63;43;2023
37;Salamanca;253;Pino de Tormes, El;155;87;68;2023
37;Salamanca;254;Pitiegua;179;101;78;2023
37;Salamanca;255;Pizarral;60;37;23;2023
37;Salamanca;256;Poveda de las Cintas;197;113;84;2023
37;Salamanca;257;Pozos de Hinojo;54;29;25;2023
37;Salamanca;258;Puebla de Azaba;145;82;63;2023
37;Salamanca;259;Puebla de San Medel;33;18;15;2023
37;Salamanca;260;Puebla de Yeltes;142;76;66;2023
37;Salamanca;261;Puente del Congosto;223;130;93;2023
37;Salamanca;262;Puertas;67;40;27;2023
37;Salamanca;263;Puerto de Béjar;360;174;186;2023
37;Salamanca;264;Puerto Seguro;68;31;37;2023
37;Salamanca;265;Rágama;204;100;104;2023
37;Salamanca;266;Redonda, La;64;37;27;2023
37;Salamanca;267;Retortillo;174;91;83;2023
37;Salamanca;268;Rinconada de la Sierra, La;108;64;44;2023
37;Salamanca;269;Robleda;462;256;206;2023
37;Salamanca;270;Robliza de Cojos;190;103;87;2023
37;Salamanca;271;Rollán;341;192;149;2023
37;Salamanca;272;Saelices el Chico;173;98;75;2023
37;Salamanca;273;Sagrada, La;84;46;38;2023
37;Salamanca;303;Sahugo, El;177;98;79;2023
37;Salamanca;274;Salamanca;143954;65035;78919;2023
37;Salamanca;275;Saldeana;105;63;42;2023
37;Salamanca;276;Salmoral;114;68;46;2023
37;Salamanca;277;Salvatierra de Tormes;78;39;39;2023
37;Salamanca;278;San Cristóbal de la Cuesta;1114;581;533;2023
37;Salamanca;284;San Esteban de la Sierra;371;211;160;2023
37;Salamanca;285;San Felices de los Gallegos;354;190;164;2023
37;Salamanca;286;San Martín del Castañar;240;131;109;2023
37;Salamanca;287;San Miguel de Valero;316;167;149;2023
37;Salamanca;036;San Miguel del Robledo;48;26;22;2023
37;Salamanca;288;San Morales;354;190;164;2023
37;Salamanca;289;San Muñoz;211;103;108;2023
37;Salamanca;291;San Pedro de Rozados;277;156;121;2023
37;Salamanca;290;San Pedro del Valle;149;86;63;2023
37;Salamanca;292;San Pelayo de Guareña;92;53;39;2023
37;Salamanca;280;Sanchón de la Ribera;70;35;35;2023
37;Salamanca;281;Sanchón de la Sagrada;36;21;15;2023
37;Salamanca;282;Sanchotello;222;113;109;2023
37;Salamanca;279;Sancti-Spíritus;738;399;339;2023
37;Salamanca;283;Sando;118;69;49;2023
37;Salamanca;293;Santa María de Sando;98;50;48;2023
37;Salamanca;294;Santa Marta de Tormes;14683;7130;7553;2023
37;Salamanca;296;Santiago de la Puebla;290;151;139;2023
37;Salamanca;297;Santibáñez de Béjar;452;228;224;2023
37;Salamanca;298;Santibáñez de la Sierra;157;90;67;2023
37;Salamanca;299;Santiz;246;135;111;2023
37;Salamanca;300;Santos, Los;592;298;294;2023
37;Salamanca;301;Sardón de los Frailes;98;54;44;2023
37;Salamanca;302;Saucelle;254;129;125;2023
37;Salamanca;304;Sepulcro-Hilario;164;90;74;2023
37;Salamanca;305;Sequeros;215;100;115;2023
37;Salamanca;306;Serradilla del Arroyo;248;135;113;2023
37;Salamanca;307;Serradilla del Llano;145;81;64;2023
37;Salamanca;309;Sierpe, La;41;20;21;2023
37;Salamanca;310;Sieteiglesias de Tormes;175;83;92;2023
37;Salamanca;311;Sobradillo;182;93;89;2023
37;Salamanca;312;Sorihuela;256;134;122;2023
37;Salamanca;313;Sotoserrano;525;277;248;2023
37;Salamanca;314;Tabera de Abajo;102;56;46;2023
37;Salamanca;315;Tala, La;78;42;36;2023
37;Salamanca;316;Tamames;792;398;394;2023
37;Salamanca;317;Tarazona de Guareña;272;150;122;2023
37;Salamanca;318;Tardáguila;192;120;72;2023
37;Salamanca;319;Tejado, El;91;52;39;2023
37;Salamanca;320;Tejeda y Segoyuela;94;52;42;2023
37;Salamanca;321;Tenebrón;133;73;60;2023
37;Salamanca;322;Terradillos;3104;1544;1560;2023
37;Salamanca;323;Topas;512;267;245;2023
37;Salamanca;324;Tordillos;324;174;150;2023
37;Salamanca;325;Tornadizo, El;87;51;36;2023
37;Salamanca;327;Torresmenudas;185;102;83;2023
37;Salamanca;328;Trabanca;175;85;90;2023
37;Salamanca;329;Tremedal de Tormes;37;20;17;2023
37;Salamanca;330;Valdecarros;314;160;154;2023
37;Salamanca;331;Valdefuentes de Sangusín;187;104;83;2023
37;Salamanca;332;Valdehijaderos;83;45;38;2023
37;Salamanca;333;Valdelacasa;198;114;84;2023
37;Salamanca;334;Valdelageve;70;39;31;2023
37;Salamanca;335;Valdelosa;417;213;204;2023
37;Salamanca;336;Valdemierque;58;37;21;2023
37;Salamanca;337;Valderrodrigo;133;70;63;2023
37;Salamanca;338;Valdunciel;101;53;48;2023
37;Salamanca;339;Valero;301;172;129;2023
37;Salamanca;343;Vallejera de Riofrío;67;38;29;2023
37;Salamanca;340;Valsalabroso;119;66;53;2023
37;Salamanca;341;Valverde de Valdelacasa;54;27;27;2023
37;Salamanca;342;Valverdón;267;137;130;2023
37;Salamanca;344;Vecinos;226;112;114;2023
37;Salamanca;345;Vega de Tirados;159;81;78;2023
37;Salamanca;346;Veguillas, Las;274;136;138;2023
37;Salamanca;347;Vellés, La;517;278;239;2023
37;Salamanca;348;Ventosa del Río Almar;104;57;47;2023
37;Salamanca;349;Vídola, La;112;56;56;2023
37;Salamanca;351;Villaflores;260;130;130;2023
37;Salamanca;352;Villagonzalo de Tormes;226;140;86;2023
37;Salamanca;353;Villalba de los Llanos;113;65;48;2023
37;Salamanca;354;Villamayor;7539;3754;3785;2023
37;Salamanca;355;Villanueva del Conde;179;93;86;2023
37;Salamanca;356;Villar de Argañán;98;55;43;2023
37;Salamanca;357;Villar de Ciervo;266;144;122;2023
37;Salamanca;358;Villar de Gallimazo;195;126;69;2023
37;Salamanca;359;Villar de la Yegua;159;87;72;2023
37;Salamanca;360;Villar de Peralonso;209;107;102;2023
37;Salamanca;361;Villar de Samaniego;79;45;34;2023
37;Salamanca;362;Villares de la Reina;6576;3229;3347;2023
37;Salamanca;363;Villares de Yeltes;101;48;53;2023
37;Salamanca;364;Villarino de los Aires;775;407;368;2023
37;Salamanca;365;Villarmayor;165;93;72;2023
37;Salamanca;366;Villarmuerto;39;27;12;2023
37;Salamanca;367;Villasbuenas;168;93;75;2023
37;Salamanca;368;Villasdardo;23;8;15;2023
37;Salamanca;369;Villaseco de los Gamitos;130;73;57;2023
37;Salamanca;370;Villaseco de los Reyes;296;173;123;2023
37;Salamanca;371;Villasrubias;245;131;114;2023
37;Salamanca;372;Villaverde de Guareña;140;75;65;2023
37;Salamanca;373;Villavieja de Yeltes;696;370;326;2023
37;Salamanca;374;Villoria;1267;647;620;2023
37;Salamanca;375;Villoruela;738;372;366;2023
37;Salamanca;350;Vilvestre;394;199;195;2023
37;Salamanca;376;Vitigudino;2363;1135;1228;2023
37;Salamanca;377;Yecla de Yeltes;221;114;107;2023
37;Salamanca;378;Zamarra;75;43;32;2023
37;Salamanca;379;Zamayón;191;116;75;2023
37;Salamanca;380;Zarapicos;60;36;24;2023
37;Salamanca;381;Zarza de Pumareda, La;138;84;54;2023
37;Salamanca;382;Zorita de la Frontera;152;74;78;2023
38;Santa Cruz de Tenerife;001;Adeje;50167;25085;25082;2023
38;Santa Cruz de Tenerife;002;Agulo;1113;555;558;2023
38;Santa Cruz de Tenerife;003;Alajeró;2056;1084;972;2023
38;Santa Cruz de Tenerife;004;Arafo;5712;2878;2834;2023
38;Santa Cruz de Tenerife;005;Arico;9020;4640;4380;2023
38;Santa Cruz de Tenerife;006;Arona;85249;42981;42268;2023
38;Santa Cruz de Tenerife;007;Barlovento;1944;983;961;2023
38;Santa Cruz de Tenerife;008;Breña Alta;7305;3560;3745;2023
38;Santa Cruz de Tenerife;009;Breña Baja;5963;3023;2940;2023
38;Santa Cruz de Tenerife;010;Buenavista del Norte;4710;2344;2366;2023
38;Santa Cruz de Tenerife;011;Candelaria;28694;13816;14878;2023
38;Santa Cruz de Tenerife;012;Fasnia;2984;1567;1417;2023
38;Santa Cruz de Tenerife;013;Frontera;4465;2236;2229;2023
38;Santa Cruz de Tenerife;014;Fuencaliente de la Palma;1841;927;914;2023
38;Santa Cruz de Tenerife;015;Garachico;4936;2463;2473;2023
38;Santa Cruz de Tenerife;016;Garafía;1916;993;923;2023
38;Santa Cruz de Tenerife;017;Granadilla de Abona;54942;27299;27643;2023
38;Santa Cruz de Tenerife;018;Guancha, La;5562;2723;2839;2023
38;Santa Cruz de Tenerife;019;Guía de Isora;22301;11091;11210;2023
38;Santa Cruz de Tenerife;020;Güímar;21536;10610;10926;2023
38;Santa Cruz de Tenerife;021;Hermigua;1838;961;877;2023
38;Santa Cruz de Tenerife;022;Icod de los Vinos;23971;11734;12237;2023
38;Santa Cruz de Tenerife;024;Llanos de Aridane, Los;20189;9780;10409;2023
38;Santa Cruz de Tenerife;025;Matanza de Acentejo, La;9092;4545;4547;2023
38;Santa Cruz de Tenerife;026;Orotava, La;42454;20744;21710;2023
38;Santa Cruz de Tenerife;027;Paso, El;7967;3971;3996;2023
38;Santa Cruz de Tenerife;901;Pinar de El Hierro, El;2016;1051;965;2023
38;Santa Cruz de Tenerife;028;Puerto de la Cruz;30849;15066;15783;2023
38;Santa Cruz de Tenerife;029;Puntagorda;2320;1176;1144;2023
38;Santa Cruz de Tenerife;030;Puntallana;2605;1297;1308;2023
38;Santa Cruz de Tenerife;031;Realejos, Los;37207;18230;18977;2023
38;Santa Cruz de Tenerife;032;Rosario, El;17866;9064;8802;2023
38;Santa Cruz de Tenerife;033;San Andrés y Sauces;4219;2106;2113;2023
38;Santa Cruz de Tenerife;023;San Cristóbal de La Laguna;159034;76428;82606;2023
38;Santa Cruz de Tenerife;034;San Juan de la Rambla;4908;2454;2454;2023
38;Santa Cruz de Tenerife;035;San Miguel de Abona;22606;11347;11259;2023
38;Santa Cruz de Tenerife;036;San Sebastián de la Gomera;9501;4732;4769;2023
38;Santa Cruz de Tenerife;037;Santa Cruz de la Palma;15441;7379;8062;2023
38;Santa Cruz de Tenerife;038;Santa Cruz de Tenerife;209395;99515;109880;2023
38;Santa Cruz de Tenerife;039;Santa Úrsula;15285;7547;7738;2023
38;Santa Cruz de Tenerife;040;Santiago del Teide;11972;5934;6038;2023
38;Santa Cruz de Tenerife;041;Sauzal, El;9145;4553;4592;2023
38;Santa Cruz de Tenerife;042;Silos, Los;4679;2340;2339;2023
38;Santa Cruz de Tenerife;043;Tacoronte;24652;12279;12373;2023
38;Santa Cruz de Tenerife;044;Tanque, El;2784;1343;1441;2023
38;Santa Cruz de Tenerife;045;Tazacorte;4575;2353;2222;2023
38;Santa Cruz de Tenerife;046;Tegueste;11344;5583;5761;2023
38;Santa Cruz de Tenerife;047;Tijarafe;2640;1334;1306;2023
38;Santa Cruz de Tenerife;049;Valle Gran Rey;4719;2397;2322;2023
38;Santa Cruz de Tenerife;050;Vallehermoso;2935;1522;1413;2023
38;Santa Cruz de Tenerife;048;Valverde;5165;2579;2586;2023
38;Santa Cruz de Tenerife;051;Victoria de Acentejo, La;9228;4566;4662;2023
38;Santa Cruz de Tenerife;052;Vilaflor de Chasna;1823;921;902;2023
38;Santa Cruz de Tenerife;053;Villa de Mazo;4950;2515;2435;2023
40;Segovia;001;Abades;859;421;438;2023
40;Segovia;002;Adrada de Pirón;38;22;16;2023
40;Segovia;003;Adrados;122;71;51;2023
40;Segovia;004;Aguilafuente;562;287;275;2023
40;Segovia;005;Alconada de Maderuelo;24;15;9;2023
40;Segovia;012;Aldea Real;281;148;133;2023
40;Segovia;006;Aldealcorvo;18;11;7;2023
40;Segovia;007;Aldealengua de Pedraza;83;50;33;2023
40;Segovia;008;Aldealengua de Santa María;66;34;32;2023
40;Segovia;009;Aldeanueva de la Serrezuela;42;29;13;2023
40;Segovia;010;Aldeanueva del Codonal;110;59;51;2023
40;Segovia;013;Aldeasoña;64;36;28;2023
40;Segovia;014;Aldehorno;55;32;23;2023
40;Segovia;015;Aldehuela del Codonal;23;12;11;2023
40;Segovia;016;Aldeonte;55;32;23;2023
40;Segovia;017;Anaya;120;61;59;2023
40;Segovia;018;Añe;69;41;28;2023
40;Segovia;019;Arahuetes;25;18;7;2023
40;Segovia;020;Arcones;191;99;92;2023
40;Segovia;021;Arevalillo de Cega;18;12;6;2023
40;Segovia;022;Armuña;238;135;103;2023
40;Segovia;024;Ayllón;1124;585;539;2023
40;Segovia;025;Barbolla;143;85;58;2023
40;Segovia;026;Basardilla;148;73;75;2023
40;Segovia;028;Bercial;107;56;51;2023
40;Segovia;029;Bercimuel;34;20;14;2023
40;Segovia;030;Bernardos;475;264;211;2023
40;Segovia;031;Bernuy de Porreros;1059;547;512;2023
40;Segovia;032;Boceguillas;699;354;345;2023
40;Segovia;033;Brieva;91;53;38;2023
40;Segovia;034;Caballar;74;44;30;2023
40;Segovia;035;Cabañas de Polendos;203;106;97;2023
40;Segovia;036;Cabezuela;626;328;298;2023
40;Segovia;037;Calabazas de Fuentidueña;25;16;9;2023
40;Segovia;039;Campo de San Pedro;255;145;110;2023
40;Segovia;040;Cantalejo;3546;1774;1772;2023
40;Segovia;041;Cantimpalos;1364;727;637;2023
40;Segovia;161;Carabias;57;41;16;2023
40;Segovia;043;Carbonero el Mayor;2492;1277;1215;2023
40;Segovia;044;Carrascal del Río;137;74;63;2023
40;Segovia;045;Casla;155;83;72;2023
40;Segovia;046;Castillejo de Mesleón;111;63;48;2023
40;Segovia;047;Castro de Fuentidueña;46;29;17;2023
40;Segovia;048;Castrojimeno;31;16;15;2023
40;Segovia;049;Castroserna de Abajo;36;21;15;2023
40;Segovia;051;Castroserracín;35;18;17;2023
40;Segovia;052;Cedillo de la Torre;85;45;40;2023
40;Segovia;053;Cerezo de Abajo;126;69;57;2023
40;Segovia;054;Cerezo de Arriba;134;72;62;2023
40;Segovia;065;Chañe;699;356;343;2023
40;Segovia;055;Cilleruelo de San Mamés;33;22;11;2023
40;Segovia;056;Cobos de Fuentidueña;36;16;20;2023
40;Segovia;057;Coca;1741;871;870;2023
40;Segovia;058;Codorniz;317;162;155;2023
40;Segovia;059;Collado Hermoso;128;69;59;2023
40;Segovia;060;Condado de Castilnovo;85;47;38;2023
40;Segovia;061;Corral de Ayllón;75;42;33;2023
40;Segovia;902;Cozuelos de Fuentidueña;114;62;52;2023
40;Segovia;062;Cubillo;72;46;26;2023
40;Segovia;063;Cuéllar;9608;4827;4781;2023
40;Segovia;905;Cuevas de Provanco;127;74;53;2023
40;Segovia;068;Domingo García;32;18;14;2023
40;Segovia;069;Donhierro;86;47;39;2023
40;Segovia;070;Duruelo;160;98;62;2023
40;Segovia;071;Encinas;37;19;18;2023
40;Segovia;072;Encinillas;340;188;152;2023
40;Segovia;073;Escalona del Prado;475;253;222;2023
40;Segovia;074;Escarabajosa de Cabezas;281;149;132;2023
40;Segovia;075;Escobar de Polendos;176;97;79;2023
40;Segovia;076;Espinar, El;9814;4934;4880;2023
40;Segovia;077;Espirdo;1543;796;747;2023
40;Segovia;078;Fresneda de Cuéllar;174;103;71;2023
40;Segovia;079;Fresno de Cantespino;303;164;139;2023
40;Segovia;080;Fresno de la Fuente;77;45;32;2023
40;Segovia;081;Frumales;124;68;56;2023
40;Segovia;082;Fuente de Santa Cruz;109;58;51;2023
40;Segovia;083;Fuente el Olmo de Fuentidueña;278;93;185;2023
40;Segovia;084;Fuente el Olmo de Íscar;51;31;20;2023
40;Segovia;086;Fuentepelayo;775;401;374;2023
40;Segovia;087;Fuentepiñel;72;43;29;2023
40;Segovia;088;Fuenterrebollo;316;169;147;2023
40;Segovia;089;Fuentesaúco de Fuentidueña;244;131;113;2023
40;Segovia;091;Fuentesoto;96;57;39;2023
40;Segovia;092;Fuentidueña;144;82;62;2023
40;Segovia;093;Gallegos;95;51;44;2023
40;Segovia;094;Garcillán;519;280;239;2023
40;Segovia;095;Gomezserracín;636;326;310;2023
40;Segovia;097;Grajera;256;144;112;2023
40;Segovia;099;Honrubia de la Cuesta;52;31;21;2023
40;Segovia;100;Hontalbilla;302;167;135;2023
40;Segovia;101;Hontanares de Eresma;1601;830;771;2023
40;Segovia;103;Huertos, Los;171;91;80;2023
40;Segovia;104;Ituero y Lama;437;223;214;2023
40;Segovia;105;Juarros de Riomoros;45;27;18;2023
40;Segovia;106;Juarros de Voltoya;186;94;92;2023
40;Segovia;107;Labajos;110;61;49;2023
40;Segovia;108;Laguna de Contreras;110;67;43;2023
40;Segovia;109;Languilla;83;48;35;2023
40;Segovia;110;Lastras de Cuéllar;318;169;149;2023
40;Segovia;111;Lastras del Pozo;65;34;31;2023
40;Segovia;112;Lastrilla, La;4559;2304;2255;2023
40;Segovia;113;Losa, La;537;292;245;2023
40;Segovia;115;Maderuelo;109;63;46;2023
40;Segovia;903;Marazoleja;97;65;32;2023
40;Segovia;118;Marazuela;52;31;21;2023
40;Segovia;119;Martín Miguel;248;147;101;2023
40;Segovia;120;Martín Muñoz de la Dehesa;317;164;153;2023
40;Segovia;121;Martín Muñoz de las Posadas;259;147;112;2023
40;Segovia;122;Marugán;757;415;342;2023
40;Segovia;124;Mata de Cuéllar;266;142;124;2023
40;Segovia;123;Matabuena;203;118;85;2023
40;Segovia;125;Matilla, La;73;44;29;2023
40;Segovia;126;Melque de Cercos;69;40;29;2023
40;Segovia;127;Membibre de la Hoz;46;24;22;2023
40;Segovia;128;Migueláñez;131;73;58;2023
40;Segovia;129;Montejo de Arévalo;163;92;71;2023
40;Segovia;130;Montejo de la Vega de la Serrezuela;128;78;50;2023
40;Segovia;131;Monterrubio;61;33;28;2023
40;Segovia;132;Moral de Hornuez;42;25;17;2023
40;Segovia;134;Mozoncillo;880;488;392;2023
40;Segovia;135;Muñopedro;306;158;148;2023
40;Segovia;136;Muñoveros;142;69;73;2023
40;Segovia;138;Nava de la Asunción;2753;1415;1338;2023
40;Segovia;139;Navafría;286;154;132;2023
40;Segovia;140;Navalilla;96;51;45;2023
40;Segovia;141;Navalmanzano;1040;553;487;2023
40;Segovia;142;Navares de Ayuso;46;23;23;2023
40;Segovia;143;Navares de Enmedio;91;50;41;2023
40;Segovia;144;Navares de las Cuevas;20;13;7;2023
40;Segovia;145;Navas de Oro;1272;650;622;2023
40;Segovia;904;Navas de Riofrío;413;197;216;2023
40;Segovia;146;Navas de San Antonio;371;206;165;2023
40;Segovia;148;Nieva;249;123;126;2023
40;Segovia;149;Olombrada;489;270;219;2023
40;Segovia;150;Orejana;62;36;26;2023
40;Segovia;151;Ortigosa de Pestaño;49;25;24;2023
40;Segovia;901;Ortigosa del Monte;576;293;283;2023
40;Segovia;152;Otero de Herreros;959;491;468;2023
40;Segovia;154;Pajarejos;26;14;12;2023
40;Segovia;155;Palazuelos de Eresma;5830;3018;2812;2023
40;Segovia;156;Pedraza;358;203;155;2023
40;Segovia;157;Pelayos del Arroyo;45;25;20;2023
40;Segovia;158;Perosillo;18;12;6;2023
40;Segovia;159;Pinarejos;178;102;76;2023
40;Segovia;160;Pinarnegrillo;101;58;43;2023
40;Segovia;162;Prádena;487;256;231;2023
40;Segovia;163;Puebla de Pedraza;51;28;23;2023
40;Segovia;164;Rapariegos;197;107;90;2023
40;Segovia;181;Real Sitio de San Ildefonso;5183;2524;2659;2023
40;Segovia;165;Rebollo;75;38;37;2023
40;Segovia;166;Remondo;307;151;156;2023
40;Segovia;168;Riaguas de San Bartolomé;29;20;9;2023
40;Segovia;170;Riaza;2150;1138;1012;2023
40;Segovia;171;Ribota;47;34;13;2023
40;Segovia;172;Riofrío de Riaza;39;25;14;2023
40;Segovia;173;Roda de Eresma;250;131;119;2023
40;Segovia;174;Sacramenia;352;173;179;2023
40;Segovia;176;Samboal;464;246;218;2023
40;Segovia;177;San Cristóbal de Cuéllar;152;85;67;2023
40;Segovia;178;San Cristóbal de la Vega;83;45;38;2023
40;Segovia;906;San Cristóbal de Segovia;3152;1588;1564;2023
40;Segovia;182;San Martín y Mudrián;232;114;118;2023
40;Segovia;183;San Miguel de Bernuy;136;65;71;2023
40;Segovia;184;San Pedro de Gaíllos;306;157;149;2023
40;Segovia;179;Sanchonuño;1012;503;509;2023
40;Segovia;180;Sangarcía;289;158;131;2023
40;Segovia;185;Santa María la Real de Nieva;891;501;390;2023
40;Segovia;186;Santa Marta del Cerro;56;29;27;2023
40;Segovia;188;Santiuste de Pedraza;84;55;29;2023
40;Segovia;189;Santiuste de San Juan Bautista;534;290;244;2023
40;Segovia;190;Santo Domingo de Pirón;48;26;22;2023
40;Segovia;191;Santo Tomé del Puerto;248;140;108;2023
40;Segovia;192;Sauquillo de Cabezas;141;81;60;2023
40;Segovia;193;Sebúlcor;254;134;120;2023
40;Segovia;194;Segovia;51011;23791;27220;2023
40;Segovia;195;Sepúlveda;990;497;493;2023
40;Segovia;196;Sequera de Fresno;44;29;15;2023
40;Segovia;198;Sotillo;30;16;14;2023
40;Segovia;199;Sotosalbos;135;76;59;2023
40;Segovia;200;Tabanera la Luenga;54;27;27;2023
40;Segovia;201;Tolocirio;42;19;23;2023
40;Segovia;206;Torre Val de San Pedro;190;99;91;2023
40;Segovia;202;Torreadrada;52;28;24;2023
40;Segovia;203;Torrecaballeros;1454;748;706;2023
40;Segovia;204;Torrecilla del Pinar;180;97;83;2023
40;Segovia;205;Torreiglesias;256;129;127;2023
40;Segovia;207;Trescasas;1103;570;533;2023
40;Segovia;208;Turégano;1004;519;485;2023
40;Segovia;210;Urueñas;100;69;31;2023
40;Segovia;211;Valdeprados;61;34;27;2023
40;Segovia;212;Valdevacas de Montejo;29;16;13;2023
40;Segovia;213;Valdevacas y Guijar;85;49;36;2023
40;Segovia;218;Valle de Tabladillo;76;45;31;2023
40;Segovia;219;Vallelado;702;368;334;2023
40;Segovia;220;Valleruela de Pedraza;80;38;42;2023
40;Segovia;221;Valleruela de Sepúlveda;54;25;29;2023
40;Segovia;214;Valseca;228;124;104;2023
40;Segovia;215;Valtiendas;78;49;29;2023
40;Segovia;216;Valverde del Majano;1152;574;578;2023
40;Segovia;222;Veganzones;204;106;98;2023
40;Segovia;223;Vegas de Matute;329;192;137;2023
40;Segovia;224;Ventosilla y Tejadilla;15;10;5;2023
40;Segovia;225;Villacastín;1530;777;753;2023
40;Segovia;228;Villaverde de Íscar;585;305;280;2023
40;Segovia;229;Villaverde de Montejo;24;16;8;2023
40;Segovia;230;Villeguillo;123;68;55;2023
40;Segovia;231;Yanguas de Eresma;123;67;56;2023
40;Segovia;233;Zarzuela del Monte;494;253;241;2023
40;Segovia;234;Zarzuela del Pinar;410;216;194;2023
41;Sevilla;001;Aguadulce;2046;1017;1029;2023
41;Sevilla;002;Alanís;1675;836;839;2023
41;Sevilla;003;Albaida del Aljarafe;3254;1600;1654;2023
41;Sevilla;004;Alcalá de Guadaíra;76547;37948;38599;2023
41;Sevilla;005;Alcalá del Río;12288;6242;6046;2023
41;Sevilla;006;Alcolea del Río;3307;1648;1659;2023
41;Sevilla;007;Algaba, La;16618;8201;8417;2023
41;Sevilla;008;Algámitas;1251;651;600;2023
41;Sevilla;009;Almadén de la Plata;1324;689;635;2023
41;Sevilla;010;Almensilla;6537;3252;3285;2023
41;Sevilla;011;Arahal;19491;9666;9825;2023
41;Sevilla;012;Aznalcázar;4820;2450;2370;2023
41;Sevilla;013;Aznalcóllar;6057;3077;2980;2023
41;Sevilla;014;Badolatosa;3089;1596;1493;2023
41;Sevilla;015;Benacazón;7324;3693;3631;2023
41;Sevilla;016;Bollullos de la Mitación;11160;5540;5620;2023
41;Sevilla;017;Bormujos;22780;11260;11520;2023
41;Sevilla;018;Brenes;12804;6359;6445;2023
41;Sevilla;019;Burguillos;7098;3582;3516;2023
41;Sevilla;020;Cabezas de San Juan, Las;16400;8173;8227;2023
41;Sevilla;021;Camas;28157;13791;14366;2023
41;Sevilla;022;Campana, La;5137;2571;2566;2023
41;Sevilla;023;Cantillana;10782;5423;5359;2023
41;Sevilla;901;Cañada Rosal;3391;1678;1713;2023
41;Sevilla;024;Carmona;29551;14909;14642;2023
41;Sevilla;025;Carrión de los Céspedes;2597;1258;1339;2023
41;Sevilla;026;Casariche;5305;2716;2589;2023
41;Sevilla;027;Castilblanco de los Arroyos;5107;2582;2525;2023
41;Sevilla;028;Castilleja de Guzmán;2874;1474;1400;2023
41;Sevilla;029;Castilleja de la Cuesta;17167;8313;8854;2023
41;Sevilla;030;Castilleja del Campo;622;313;309;2023
41;Sevilla;031;Castillo de las Guardas, El;1500;796;704;2023
41;Sevilla;032;Cazalla de la Sierra;4660;2294;2366;2023
41;Sevilla;033;Constantina;5742;2846;2896;2023
41;Sevilla;034;Coria del Río;30887;15308;15579;2023
41;Sevilla;035;Coripe;1215;584;631;2023
41;Sevilla;036;Coronil, El;4690;2352;2338;2023
41;Sevilla;037;Corrales, Los;3996;2030;1966;2023
41;Sevilla;903;Cuervo de Sevilla, El;8635;4346;4289;2023
41;Sevilla;038;Dos Hermanas;138981;68066;70915;2023
41;Sevilla;039;Écija;39530;19445;20085;2023
41;Sevilla;040;Espartinas;16505;8290;8215;2023
41;Sevilla;041;Estepa;12373;6110;6263;2023
41;Sevilla;042;Fuentes de Andalucía;7217;3585;3632;2023
41;Sevilla;043;Garrobo, El;825;420;405;2023
41;Sevilla;044;Gelves;10388;5153;5235;2023
41;Sevilla;045;Gerena;7833;3889;3944;2023
41;Sevilla;046;Gilena;3686;1871;1815;2023
41;Sevilla;047;Gines;13481;6600;6881;2023
41;Sevilla;048;Guadalcanal;2545;1278;1267;2023
41;Sevilla;049;Guillena;13682;6919;6763;2023
41;Sevilla;050;Herrera;6544;3259;3285;2023
41;Sevilla;051;Huévar del Aljarafe;3289;1687;1602;2023
41;Sevilla;902;Isla Mayor;5741;2854;2887;2023
41;Sevilla;052;Lantejuela;3851;1963;1888;2023
41;Sevilla;053;Lebrija;27727;13845;13882;2023
41;Sevilla;054;Lora de Estepa;888;464;424;2023
41;Sevilla;055;Lora del Río;18316;9034;9282;2023
41;Sevilla;056;Luisiana, La;4608;2313;2295;2023
41;Sevilla;057;Madroño, El;297;149;148;2023
41;Sevilla;058;Mairena del Alcor;24125;12044;12081;2023
41;Sevilla;059;Mairena del Aljarafe;47541;23002;24539;2023
41;Sevilla;060;Marchena;19271;9539;9732;2023
41;Sevilla;061;Marinaleda;2577;1304;1273;2023
41;Sevilla;062;Martín de la Jara;2642;1368;1274;2023
41;Sevilla;063;Molares, Los;3559;1808;1751;2023
41;Sevilla;064;Montellano;7003;3510;3493;2023
41;Sevilla;065;Morón de la Frontera;27229;13382;13847;2023
41;Sevilla;066;Navas de la Concepción, Las;1523;751;772;2023
41;Sevilla;067;Olivares;9427;4727;4700;2023
41;Sevilla;068;Osuna;17418;8665;8753;2023
41;Sevilla;069;Palacios y Villafranca, Los;38698;19277;19421;2023
41;Sevilla;904;Palmar de Troya, El;2325;1159;1166;2023
41;Sevilla;070;Palomares del Río;9161;4582;4579;2023
41;Sevilla;071;Paradas;6798;3371;3427;2023
41;Sevilla;072;Pedrera;5104;2535;2569;2023
41;Sevilla;073;Pedroso, El;2054;1017;1037;2023
41;Sevilla;074;Peñaflor;3646;1834;1812;2023
41;Sevilla;075;Pilas;14052;7039;7013;2023
41;Sevilla;076;Pruna;2542;1288;1254;2023
41;Sevilla;077;Puebla de Cazalla, La;10884;5418;5466;2023
41;Sevilla;078;Puebla de los Infantes, La;2966;1452;1514;2023
41;Sevilla;079;Puebla del Río, La;11862;5833;6029;2023
41;Sevilla;080;Real de la Jara, El;1523;766;757;2023
41;Sevilla;081;Rinconada, La;40162;19965;20197;2023
41;Sevilla;082;Roda de Andalucía, La;4222;2090;2132;2023
41;Sevilla;083;Ronquillo, El;1441;732;709;2023
41;Sevilla;084;Rubio, El;3305;1655;1650;2023
41;Sevilla;085;Salteras;5627;2727;2900;2023
41;Sevilla;086;San Juan de Aznalfarache;22472;10863;11609;2023
41;Sevilla;088;San Nicolás del Puerto;608;317;291;2023
41;Sevilla;087;Sanlúcar la Mayor;14172;6972;7200;2023
41;Sevilla;089;Santiponce;8539;4224;4315;2023
41;Sevilla;090;Saucejo, El;4246;2116;2130;2023
41;Sevilla;091;Sevilla;684025;323988;360037;2023
41;Sevilla;092;Tocina;9420;4677;4743;2023
41;Sevilla;093;Tomares;25374;12499;12875;2023
41;Sevilla;094;Umbrete;9376;4674;4702;2023
41;Sevilla;095;Utrera;51718;25487;26231;2023
41;Sevilla;096;Valencina de la Concepción;8029;3923;4106;2023
41;Sevilla;097;Villamanrique de la Condesa;4640;2277;2363;2023
41;Sevilla;100;Villanueva de San Juan;994;499;495;2023
41;Sevilla;098;Villanueva del Ariscal;6814;3302;3512;2023
41;Sevilla;099;Villanueva del Río y Minas;4939;2494;2445;2023
41;Sevilla;101;Villaverde del Río;7700;3910;3790;2023
41;Sevilla;102;Viso del Alcor, El;19265;9567;9698;2023
42;Soria;001;Abejar;376;189;187;2023
42;Soria;003;Adradas;61;35;26;2023
42;Soria;004;Ágreda;3056;1564;1492;2023
42;Soria;006;Alconaba;198;131;67;2023
42;Soria;007;Alcubilla de Avellaneda;114;63;51;2023
42;Soria;008;Alcubilla de las Peñas;58;37;21;2023
42;Soria;009;Aldealafuente;79;47;32;2023
42;Soria;010;Aldealices;21;15;6;2023
42;Soria;011;Aldealpozo;20;8;12;2023
42;Soria;012;Aldealseñor;25;16;9;2023
42;Soria;013;Aldehuela de Periáñez;34;19;15;2023
42;Soria;014;Aldehuelas, Las;61;36;25;2023
42;Soria;015;Alentisque;26;16;10;2023
42;Soria;016;Aliud;21;14;7;2023
42;Soria;017;Almajano;178;94;84;2023
42;Soria;018;Almaluez;125;75;50;2023
42;Soria;019;Almarza;620;346;274;2023
42;Soria;020;Almazán;5426;2782;2644;2023
42;Soria;021;Almazul;61;42;19;2023
42;Soria;022;Almenar de Soria;225;141;84;2023
42;Soria;023;Alpanseque;53;33;20;2023
42;Soria;024;Arancón;82;53;29;2023
42;Soria;025;Arcos de Jalón;1525;780;745;2023
42;Soria;026;Arenillas;49;29;20;2023
42;Soria;027;Arévalo de la Sierra;69;44;25;2023
42;Soria;028;Ausejo de la Sierra;109;57;52;2023
42;Soria;029;Baraona;130;76;54;2023
42;Soria;030;Barca;107;67;40;2023
42;Soria;031;Barcones;26;15;11;2023
42;Soria;032;Bayubas de Abajo;150;80;70;2023
42;Soria;033;Bayubas de Arriba;62;35;27;2023
42;Soria;034;Beratón;46;23;23;2023
42;Soria;035;Berlanga de Duero;852;444;408;2023
42;Soria;036;Blacos;41;21;20;2023
42;Soria;037;Bliecos;27;17;10;2023
42;Soria;038;Borjabad;30;18;12;2023
42;Soria;039;Borobia;231;133;98;2023
42;Soria;041;Buberos;28;14;14;2023
42;Soria;042;Buitrago;75;41;34;2023
42;Soria;043;Burgo de Osma-Ciudad de Osma;5166;2574;2592;2023
42;Soria;044;Cabrejas del Campo;51;30;21;2023
42;Soria;045;Cabrejas del Pinar;301;171;130;2023
42;Soria;046;Calatañazor;45;26;19;2023
42;Soria;048;Caltojar;52;35;17;2023
42;Soria;049;Candilichera;102;63;39;2023
42;Soria;050;Cañamaque;27;19;8;2023
42;Soria;051;Carabantes;20;12;8;2023
42;Soria;052;Caracena;15;10;5;2023
42;Soria;053;Carrascosa de Abajo;17;11;6;2023
42;Soria;054;Carrascosa de la Sierra;20;15;5;2023
42;Soria;055;Casarejos;146;77;69;2023
42;Soria;056;Castilfrío de la Sierra;38;23;15;2023
42;Soria;058;Castillejo de Robledo;101;59;42;2023
42;Soria;057;Castilruiz;156;87;69;2023
42;Soria;059;Centenera de Andaluz;24;12;12;2023
42;Soria;060;Cerbón;29;21;8;2023
42;Soria;061;Cidones;311;186;125;2023
42;Soria;062;Cigudosa;15;11;4;2023
42;Soria;063;Cihuela;40;26;14;2023
42;Soria;064;Ciria;71;38;33;2023
42;Soria;065;Cirujales del Río;20;15;5;2023
42;Soria;068;Coscurita;66;42;24;2023
42;Soria;069;Covaleda;1582;826;756;2023
42;Soria;070;Cubilla;24;16;8;2023
42;Soria;071;Cubo de la Solana;170;101;69;2023
42;Soria;073;Cueva de Ágreda;71;44;27;2023
42;Soria;075;Dévanos;77;44;33;2023
42;Soria;076;Deza;181;102;79;2023
42;Soria;078;Duruelo de la Sierra;1050;541;509;2023
42;Soria;079;Escobosa de Almazán;19;12;7;2023
42;Soria;080;Espeja de San Marcelino;147;89;58;2023
42;Soria;081;Espejón;136;71;65;2023
42;Soria;082;Estepa de San Juan;13;8;5;2023
42;Soria;083;Frechilla de Almazán;20;11;9;2023
42;Soria;084;Fresno de Caracena;22;13;9;2023
42;Soria;085;Fuentearmegil;153;90;63;2023
42;Soria;086;Fuentecambrón;32;19;13;2023
42;Soria;087;Fuentecantos;68;34;34;2023
42;Soria;088;Fuentelmonge;64;36;28;2023
42;Soria;089;Fuentelsaz de Soria;62;32;30;2023
42;Soria;090;Fuentepinilla;80;47;33;2023
42;Soria;092;Fuentes de Magaña;53;31;22;2023
42;Soria;093;Fuentestrún;47;30;17;2023
42;Soria;094;Garray;767;406;361;2023
42;Soria;095;Golmayo;3014;1572;1442;2023
42;Soria;096;Gómara;299;170;129;2023
42;Soria;097;Gormaz;28;19;9;2023
42;Soria;098;Herrera de Soria;11;8;3;2023
42;Soria;100;Hinojosa del Campo;26;18;8;2023
42;Soria;103;Langa de Duero;699;377;322;2023
42;Soria;105;Liceras;49;27;22;2023
42;Soria;106;Losilla, La;13;9;4;2023
42;Soria;107;Magaña;67;42;25;2023
42;Soria;108;Maján;9;6;3;2023
42;Soria;110;Matalebreras;75;50;25;2023
42;Soria;111;Matamala de Almazán;260;145;115;2023
42;Soria;113;Medinaceli;679;350;329;2023
42;Soria;115;Miño de Medinaceli;87;52;35;2023
42;Soria;116;Miño de San Esteban;39;26;13;2023
42;Soria;117;Molinos de Duero;161;92;69;2023
42;Soria;118;Momblona;18;15;3;2023
42;Soria;119;Monteagudo de las Vicarías;173;87;86;2023
42;Soria;120;Montejo de Tiermes;148;93;55;2023
42;Soria;121;Montenegro de Cameros;52;35;17;2023
42;Soria;123;Morón de Almazán;198;105;93;2023
42;Soria;124;Muriel de la Fuente;55;37;18;2023
42;Soria;125;Muriel Viejo;75;48;27;2023
42;Soria;127;Nafría de Ucero;38;20;18;2023
42;Soria;128;Narros;68;42;26;2023
42;Soria;129;Navaleno;741;397;344;2023
42;Soria;130;Nepas;52;36;16;2023
42;Soria;131;Nolay;50;29;21;2023
42;Soria;132;Noviercas;165;91;74;2023
42;Soria;134;Ólvega;3782;1980;1802;2023
42;Soria;135;Oncala;62;40;22;2023
42;Soria;139;Pinilla del Campo;18;10;8;2023
42;Soria;140;Portillo de Soria;13;10;3;2023
42;Soria;141;Póveda de Soria, La;107;65;42;2023
42;Soria;142;Pozalmuro;48;24;24;2023
42;Soria;144;Quintana Redonda;508;291;217;2023
42;Soria;145;Quintanas de Gormaz;130;76;54;2023
42;Soria;148;Quiñonería;9;5;4;2023
42;Soria;149;Rábanos, Los;447;247;200;2023
42;Soria;151;Rebollar;36;19;17;2023
42;Soria;152;Recuerda;63;39;24;2023
42;Soria;153;Rello;20;12;8;2023
42;Soria;154;Renieblas;113;75;38;2023
42;Soria;155;Retortillo de Soria;143;81;62;2023
42;Soria;156;Reznos;25;15;10;2023
42;Soria;157;Riba de Escalote, La;10;7;3;2023
42;Soria;158;Rioseco de Soria;130;78;52;2023
42;Soria;159;Rollamienta;45;30;15;2023
42;Soria;160;Royo, El;259;142;117;2023
42;Soria;161;Salduero;140;78;62;2023
42;Soria;162;San Esteban de Gormaz;2950;1564;1386;2023
42;Soria;163;San Felices;60;37;23;2023
42;Soria;164;San Leonardo de Yagüe;1986;1014;972;2023
42;Soria;165;San Pedro Manrique;614;348;266;2023
42;Soria;166;Santa Cruz de Yanguas;57;32;25;2023
42;Soria;167;Santa María de Huerta;246;138;108;2023
42;Soria;168;Santa María de las Hoyas;102;57;45;2023
42;Soria;171;Serón de Nágima;116;64;52;2023
42;Soria;172;Soliedra;32;18;14;2023
42;Soria;173;Soria;40096;18901;21195;2023
42;Soria;174;Sotillo del Rincón;185;105;80;2023
42;Soria;175;Suellacabras;31;15;16;2023
42;Soria;176;Tajahuerce;23;12;11;2023
42;Soria;177;Tajueco;56;34;22;2023
42;Soria;178;Talveila;102;66;36;2023
42;Soria;181;Tardelcuende;424;226;198;2023
42;Soria;182;Taroda;43;23;20;2023
42;Soria;183;Tejado;96;59;37;2023
42;Soria;184;Torlengua;48;31;17;2023
42;Soria;185;Torreblacos;26;13;13;2023
42;Soria;187;Torrubia de Soria;56;39;17;2023
42;Soria;188;Trévago;53;26;27;2023
42;Soria;189;Ucero;85;48;37;2023
42;Soria;190;Vadillo;82;44;38;2023
42;Soria;191;Valdeavellano de Tera;209;114;95;2023
42;Soria;192;Valdegeña;37;27;10;2023
42;Soria;193;Valdelagua del Cerro;13;8;5;2023
42;Soria;194;Valdemaluque;141;69;72;2023
42;Soria;195;Valdenebro;92;52;40;2023
42;Soria;196;Valdeprado;8;3;5;2023
42;Soria;197;Valderrodilla;63;35;28;2023
42;Soria;198;Valtajeros;19;13;6;2023
42;Soria;200;Velamazán;67;47;20;2023
42;Soria;201;Velilla de la Sierra;28;18;10;2023
42;Soria;202;Velilla de los Ajos;16;10;6;2023
42;Soria;204;Viana de Duero;50;36;14;2023
42;Soria;205;Villaciervos;77;47;30;2023
42;Soria;206;Villanueva de Gormaz;8;5;3;2023
42;Soria;207;Villar del Ala;52;26;26;2023
42;Soria;208;Villar del Campo;24;14;10;2023
42;Soria;209;Villar del Río;161;97;64;2023
42;Soria;211;Villares de Soria, Los;82;47;35;2023
42;Soria;212;Villasayas;65;44;21;2023
42;Soria;213;Villaseca de Arciel;23;15;8;2023
42;Soria;215;Vinuesa;853;443;410;2023
42;Soria;216;Vizmanos;31;20;11;2023
42;Soria;217;Vozmediano;36;24;12;2023
42;Soria;218;Yanguas;113;72;41;2023
42;Soria;219;Yelo;40;24;16;2023
43;Tarragona;001;Aiguamúrcia;974;506;468;2023
43;Tarragona;002;Albinyana;2666;1362;1304;2023
43;Tarragona;003;Albiol, L';535;288;247;2023
43;Tarragona;004;Alcanar;9827;4965;4862;2023
43;Tarragona;005;Alcover;5278;2614;2664;2023
43;Tarragona;904;Aldea, L';4445;2402;2043;2023
43;Tarragona;006;Aldover;867;444;423;2023
43;Tarragona;007;Aleixar, L';940;486;454;2023
43;Tarragona;008;Alfara de Carles;361;191;170;2023
43;Tarragona;009;Alforja;1965;992;973;2023
43;Tarragona;010;Alió;508;250;258;2023
43;Tarragona;011;Almoster;1310;658;652;2023
43;Tarragona;012;Altafulla;5693;2753;2940;2023
43;Tarragona;013;Ametlla de Mar, L';7325;3714;3611;2023
43;Tarragona;906;Ampolla, L';3603;1829;1774;2023
43;Tarragona;014;Amposta;22270;11294;10976;2023
43;Tarragona;016;Arboç, L';5713;2902;2811;2023
43;Tarragona;015;Arbolí;129;79;50;2023
43;Tarragona;017;Argentera, L';133;75;58;2023
43;Tarragona;018;Arnes;455;218;237;2023
43;Tarragona;019;Ascó;1638;850;788;2023
43;Tarragona;020;Banyeres del Penedès;3356;1690;1666;2023
43;Tarragona;021;Barberà de la Conca;486;265;221;2023
43;Tarragona;022;Batea;1869;929;940;2023
43;Tarragona;023;Bellmunt del Priorat;284;147;137;2023
43;Tarragona;024;Bellvei;2368;1223;1145;2023
43;Tarragona;025;Benifallet;733;357;376;2023
43;Tarragona;026;Benissanet;1159;631;528;2023
43;Tarragona;027;Bisbal de Falset, La;207;118;89;2023
43;Tarragona;028;Bisbal del Penedès, La;4148;2168;1980;2023
43;Tarragona;029;Blancafort;393;202;191;2023
43;Tarragona;030;Bonastre;745;403;342;2023
43;Tarragona;031;Borges del Camp, Les;2194;1127;1067;2023
43;Tarragona;032;Bot;559;284;275;2023
43;Tarragona;033;Botarell;1156;588;568;2023
43;Tarragona;034;Bràfim;693;348;345;2023
43;Tarragona;035;Cabacés;304;168;136;2023
43;Tarragona;036;Cabra del Camp;1282;669;613;2023
43;Tarragona;037;Calafell;30631;15345;15286;2023
43;Tarragona;903;Camarles;3332;1709;1623;2023
43;Tarragona;038;Cambrils;36496;17829;18667;2023
43;Tarragona;907;Canonja, La;5922;2890;3032;2023
43;Tarragona;039;Capafonts;110;63;47;2023
43;Tarragona;040;Capçanes;424;213;211;2023
43;Tarragona;041;Caseres;241;119;122;2023
43;Tarragona;042;Castellvell del Camp;3018;1518;1500;2023
43;Tarragona;043;Catllar, El;5115;2671;2444;2023
43;Tarragona;045;Colldejou;161;93;68;2023
43;Tarragona;046;Conesa;120;60;60;2023
43;Tarragona;047;Constantí;6788;3490;3298;2023
43;Tarragona;048;Corbera d'Ebre;1011;536;475;2023
43;Tarragona;049;Cornudella de Montsant;993;529;464;2023
43;Tarragona;050;Creixell;4084;2054;2030;2023
43;Tarragona;051;Cunit;15278;7525;7753;2023
43;Tarragona;901;Deltebre;11818;5945;5873;2023
43;Tarragona;053;Duesaigües;225;122;103;2023
43;Tarragona;054;Espluga de Francolí, L';3733;1841;1892;2023
43;Tarragona;055;Falset;2809;1429;1380;2023
43;Tarragona;056;Fatarella, La;874;434;440;2023
43;Tarragona;057;Febró, La;38;23;15;2023
43;Tarragona;058;Figuera, La;119;68;51;2023
43;Tarragona;059;Figuerola del Camp;337;166;171;2023
43;Tarragona;060;Flix;3343;1684;1659;2023
43;Tarragona;061;Forès;47;29;18;2023
43;Tarragona;062;Freginals;411;222;189;2023
43;Tarragona;063;Galera, La;715;369;346;2023
43;Tarragona;064;Gandesa;3140;1592;1548;2023
43;Tarragona;065;Garcia;547;277;270;2023
43;Tarragona;066;Garidells, Els;198;98;100;2023
43;Tarragona;067;Ginestar;794;420;374;2023
43;Tarragona;068;Godall;614;306;308;2023
43;Tarragona;069;Gratallops;237;134;103;2023
43;Tarragona;070;Guiamets, Els;267;136;131;2023
43;Tarragona;071;Horta de Sant Joan;1169;595;574;2023
43;Tarragona;072;Lloar, El;105;56;49;2023
43;Tarragona;073;Llorac;97;51;46;2023
43;Tarragona;074;Llorenç del Penedès;2391;1171;1220;2023
43;Tarragona;076;Marçà;589;318;271;2023
43;Tarragona;075;Margalef;106;67;39;2023
43;Tarragona;077;Mas de Barberans;544;274;270;2023
43;Tarragona;078;Masdenverge;1137;591;546;2023
43;Tarragona;079;Masllorenç;576;319;257;2023
43;Tarragona;080;Masó, La;296;155;141;2023
43;Tarragona;081;Maspujols;856;443;413;2023
43;Tarragona;082;Masroig, El;466;252;214;2023
43;Tarragona;083;Milà, El;181;87;94;2023
43;Tarragona;084;Miravet;690;365;325;2023
43;Tarragona;085;Molar, El;314;156;158;2023
43;Tarragona;086;Montblanc;7456;3797;3659;2023
43;Tarragona;088;Montbrió del Camp;3086;1594;1492;2023
43;Tarragona;089;Montferri;435;235;200;2023
43;Tarragona;090;Montmell, El;1887;1008;879;2023
43;Tarragona;091;Mont-ral;183;102;81;2023
43;Tarragona;092;Mont-roig del Camp;13592;6962;6630;2023
43;Tarragona;093;Móra d'Ebre;5649;2852;2797;2023
43;Tarragona;094;Móra la Nova;3244;1626;1618;2023
43;Tarragona;095;Morell, El;3893;2012;1881;2023
43;Tarragona;096;Morera de Montsant, La;153;87;66;2023
43;Tarragona;097;Nou de Gaià, La;635;313;322;2023
43;Tarragona;098;Nulles;544;286;258;2023
43;Tarragona;100;Pallaresos, Els;4963;2492;2471;2023
43;Tarragona;099;Palma d'Ebre, La;341;165;176;2023
43;Tarragona;101;Passanant i Belltall;180;106;74;2023
43;Tarragona;102;Paüls;555;282;273;2023
43;Tarragona;103;Perafort;1292;667;625;2023
43;Tarragona;104;Perelló, El;2915;1505;1410;2023
43;Tarragona;105;Piles, Les;229;128;101;2023
43;Tarragona;106;Pinell de Brai, El;1006;508;498;2023
43;Tarragona;107;Pira;509;266;243;2023
43;Tarragona;108;Pla de Santa Maria, El;2395;1227;1168;2023
43;Tarragona;109;Pobla de Mafumet, La;4076;2052;2024;2023
43;Tarragona;110;Pobla de Massaluca, La;341;192;149;2023
43;Tarragona;111;Pobla de Montornès, La;3221;1659;1562;2023
43;Tarragona;112;Poboleda;330;166;164;2023
43;Tarragona;113;Pont d'Armentera, El;490;243;247;2023
43;Tarragona;141;Pontils;128;72;56;2023
43;Tarragona;114;Porrera;435;223;212;2023
43;Tarragona;115;Pradell de la Teixeta;171;87;84;2023
43;Tarragona;116;Prades;656;350;306;2023
43;Tarragona;117;Prat de Comte;188;99;89;2023
43;Tarragona;118;Pratdip;723;372;351;2023
43;Tarragona;119;Puigpelat;1215;631;584;2023
43;Tarragona;120;Querol;584;326;258;2023
43;Tarragona;136;Ràpita, La;15046;7330;7716;2023
43;Tarragona;121;Rasquera;804;396;408;2023
43;Tarragona;122;Renau;158;83;75;2023
43;Tarragona;123;Reus;108479;52592;55887;2023
43;Tarragona;124;Riba, La;572;318;254;2023
43;Tarragona;125;Riba-roja d'Ebre;1150;617;533;2023
43;Tarragona;126;Riera de Gaià, La;1778;891;887;2023
43;Tarragona;127;Riudecanyes;1349;704;645;2023
43;Tarragona;128;Riudecols;1211;619;592;2023
43;Tarragona;129;Riudoms;6810;3457;3353;2023
43;Tarragona;130;Rocafort de Queralt;243;133;110;2023
43;Tarragona;131;Roda de Berà;7829;3962;3867;2023
43;Tarragona;132;Rodonyà;526;284;242;2023
43;Tarragona;133;Roquetes;8302;4276;4026;2023
43;Tarragona;134;Rourell, El;385;196;189;2023
43;Tarragona;135;Salomó;542;283;259;2023
43;Tarragona;905;Salou;30224;15390;14834;2023
43;Tarragona;137;Sant Jaume dels Domenys;2785;1422;1363;2023
43;Tarragona;902;Sant Jaume d'Enveja;3661;1844;1817;2023
43;Tarragona;138;Santa Bàrbara;3758;1915;1843;2023
43;Tarragona;139;Santa Coloma de Queralt;2805;1415;1390;2023
43;Tarragona;140;Santa Oliva;3657;1865;1792;2023
43;Tarragona;142;Sarral;1606;808;798;2023
43;Tarragona;143;Savallà del Comtat;53;28;25;2023
43;Tarragona;144;Secuita, La;1800;904;896;2023
43;Tarragona;145;Selva del Camp, La;5736;2847;2889;2023
43;Tarragona;146;Senan;44;28;16;2023
43;Tarragona;044;Sénia, La;5623;2816;2807;2023
43;Tarragona;147;Solivella;629;338;291;2023
43;Tarragona;148;Tarragona;138262;67247;71015;2023
43;Tarragona;149;Tivenys;915;468;447;2023
43;Tarragona;150;Tivissa;1635;831;804;2023
43;Tarragona;151;Torre de Fontaubella, La;120;65;55;2023
43;Tarragona;152;Torre de l'Espanyol, La;619;319;300;2023
43;Tarragona;153;Torredembarra;17670;8629;9041;2023
43;Tarragona;154;Torroja del Priorat;139;76;63;2023
43;Tarragona;155;Tortosa;34639;17329;17310;2023
43;Tarragona;156;Ulldecona;6417;3381;3036;2023
43;Tarragona;157;Ulldemolins;418;230;188;2023
43;Tarragona;158;Vallclara;95;59;36;2023
43;Tarragona;159;Vallfogona de Riucorb;93;54;39;2023
43;Tarragona;160;Vallmoll;1942;979;963;2023
43;Tarragona;161;Valls;25014;12646;12368;2023
43;Tarragona;162;Vandellòs i l'Hospitalet de l'Infant;6984;3458;3526;2023
43;Tarragona;163;Vendrell, El;39601;19586;20015;2023
43;Tarragona;164;Vespella de Gaià;494;262;232;2023
43;Tarragona;165;Vilabella;723;369;354;2023
43;Tarragona;175;Vilalba dels Arcs;619;311;308;2023
43;Tarragona;166;Vilallonga del Camp;2423;1222;1201;2023
43;Tarragona;168;Vilanova de Prades;113;60;53;2023
43;Tarragona;167;Vilanova d'Escornalbou;594;306;288;2023
43;Tarragona;169;Vilaplana;552;294;258;2023
43;Tarragona;170;Vila-rodona;1362;720;642;2023
43;Tarragona;171;Vila-seca;23176;11642;11534;2023
43;Tarragona;172;Vilaverd;477;253;224;2023
43;Tarragona;173;Vilella Alta, La;128;71;57;2023
43;Tarragona;174;Vilella Baixa, La;197;108;89;2023
43;Tarragona;176;Vimbodí i Poblet;900;480;420;2023
43;Tarragona;177;Vinebre;415;219;196;2023
43;Tarragona;178;Vinyols i els Arcs;2323;1206;1117;2023
43;Tarragona;052;Xerta;1164;574;590;2023
44;Teruel;001;Ababuj;70;43;27;2023
44;Teruel;002;Abejuela;55;35;20;2023
44;Teruel;003;Aguatón;15;7;8;2023
44;Teruel;004;Aguaviva;565;269;296;2023
44;Teruel;005;Aguilar del Alfambra;83;43;40;2023
44;Teruel;006;Alacón;212;110;102;2023
44;Teruel;007;Alba;187;110;77;2023
44;Teruel;008;Albalate del Arzobispo;1955;1016;939;2023
44;Teruel;009;Albarracín;1015;515;500;2023
44;Teruel;010;Albentosa;302;160;142;2023
44;Teruel;011;Alcaine;48;31;17;2023
44;Teruel;012;Alcalá de la Selva;382;207;175;2023
44;Teruel;013;Alcañiz;16151;8061;8090;2023
44;Teruel;014;Alcorisa;3243;1654;1589;2023
44;Teruel;016;Alfambra;482;259;223;2023
44;Teruel;017;Aliaga;343;200;143;2023
44;Teruel;021;Allepuz;121;61;60;2023
44;Teruel;022;Alloza;540;275;265;2023
44;Teruel;023;Allueva;27;17;10;2023
44;Teruel;018;Almohaja;17;12;5;2023
44;Teruel;019;Alobras;71;45;26;2023
44;Teruel;020;Alpeñés;25;15;10;2023
44;Teruel;024;Anadón;33;21;12;2023
44;Teruel;025;Andorra;7214;3581;3633;2023
44;Teruel;026;Arcos de las Salinas;116;71;45;2023
44;Teruel;027;Arens de Lledó;205;99;106;2023
44;Teruel;028;Argente;193;98;95;2023
44;Teruel;029;Ariño;649;332;317;2023
44;Teruel;031;Azaila;98;57;41;2023
44;Teruel;032;Bádenas;21;12;9;2023
44;Teruel;033;Báguena;270;151;119;2023
44;Teruel;034;Bañón;151;87;64;2023
44;Teruel;035;Barrachina;120;66;54;2023
44;Teruel;036;Bea;28;18;10;2023
44;Teruel;037;Beceite;569;286;283;2023
44;Teruel;039;Bello;217;109;108;2023
44;Teruel;038;Belmonte de San José;127;63;64;2023
44;Teruel;040;Berge;226;116;110;2023
44;Teruel;041;Bezas;64;39;25;2023
44;Teruel;042;Blancas;135;78;57;2023
44;Teruel;043;Blesa;78;55;23;2023
44;Teruel;044;Bordón;112;64;48;2023
44;Teruel;045;Bronchales;454;255;199;2023
44;Teruel;046;Bueña;54;27;27;2023
44;Teruel;047;Burbáguena;376;208;168;2023
44;Teruel;048;Cabra de Mora;71;42;29;2023
44;Teruel;049;Calaceite;979;485;494;2023
44;Teruel;050;Calamocha;4505;2262;2243;2023
44;Teruel;051;Calanda;3759;1882;1877;2023
44;Teruel;052;Calomarde;73;43;30;2023
44;Teruel;053;Camañas;132;72;60;2023
44;Teruel;054;Camarena de la Sierra;134;74;60;2023
44;Teruel;055;Camarillas;119;64;55;2023
44;Teruel;056;Caminreal;617;331;286;2023
44;Teruel;059;Cantavieja;726;378;348;2023
44;Teruel;060;Cañada de Benatanduz;34;22;12;2023
44;Teruel;061;Cañada de Verich, La;88;53;35;2023
44;Teruel;062;Cañada Vellida;40;27;13;2023
44;Teruel;063;Cañizar del Olivar;103;58;45;2023
44;Teruel;064;Cascante del Río;70;41;29;2023
44;Teruel;065;Castejón de Tornos;68;38;30;2023
44;Teruel;066;Castel de Cabra;89;49;40;2023
44;Teruel;070;Castellar, El;55;37;18;2023
44;Teruel;071;Castellote;678;345;333;2023
44;Teruel;067;Castelnou;108;55;53;2023
44;Teruel;068;Castelserás;795;421;374;2023
44;Teruel;074;Cedrillas;653;332;321;2023
44;Teruel;075;Celadas;345;198;147;2023
44;Teruel;076;Cella;2644;1355;1289;2023
44;Teruel;077;Cerollera, La;75;49;26;2023
44;Teruel;080;Codoñera, La;320;169;151;2023
44;Teruel;082;Corbalán;113;59;54;2023
44;Teruel;084;Cortes de Aragón;61;28;33;2023
44;Teruel;085;Cosa;61;38;23;2023
44;Teruel;086;Cretas;556;283;273;2023
44;Teruel;087;Crivillén;90;51;39;2023
44;Teruel;088;Cuba, La;49;25;24;2023
44;Teruel;089;Cubla;71;46;25;2023
44;Teruel;090;Cucalón;78;51;27;2023
44;Teruel;092;Cuervo, El;98;47;51;2023
44;Teruel;093;Cuevas de Almudén;119;66;53;2023
44;Teruel;094;Cuevas Labradas;135;70;65;2023
44;Teruel;096;Ejulve;176;90;86;2023
44;Teruel;097;Escorihuela;141;71;70;2023
44;Teruel;099;Escucha;766;415;351;2023
44;Teruel;100;Estercuel;196;111;85;2023
44;Teruel;101;Ferreruela de Huerva;71;39;32;2023
44;Teruel;102;Fonfría;32;19;13;2023
44;Teruel;103;Formiche Alto;159;89;70;2023
44;Teruel;105;Fórnoles;84;45;39;2023
44;Teruel;106;Fortanete;222;124;98;2023
44;Teruel;107;Foz-Calanda;279;144;135;2023
44;Teruel;108;Fresneda, La;463;250;213;2023
44;Teruel;109;Frías de Albarracín;111;69;42;2023
44;Teruel;110;Fuenferrada;37;25;12;2023
44;Teruel;111;Fuentes Calientes;81;47;34;2023
44;Teruel;112;Fuentes Claras;435;233;202;2023
44;Teruel;113;Fuentes de Rubielos;169;94;75;2023
44;Teruel;114;Fuentespalda;288;148;140;2023
44;Teruel;115;Galve;144;74;70;2023
44;Teruel;116;Gargallo;91;48;43;2023
44;Teruel;117;Gea de Albarracín;452;248;204;2023
44;Teruel;118;Ginebrosa, La;192;109;83;2023
44;Teruel;119;Griegos;140;84;56;2023
44;Teruel;120;Guadalaviar;242;128;114;2023
44;Teruel;121;Gúdar;70;41;29;2023
44;Teruel;122;Híjar;1797;926;871;2023
44;Teruel;123;Hinojosa de Jarque;104;59;45;2023
44;Teruel;124;Hoz de la Vieja, La;87;44;43;2023
44;Teruel;125;Huesa del Común;64;39;25;2023
44;Teruel;126;Iglesuela del Cid, La;382;197;185;2023
44;Teruel;127;Jabaloyas;74;44;30;2023
44;Teruel;128;Jarque de la Val;64;31;33;2023
44;Teruel;129;Jatiel;46;27;19;2023
44;Teruel;130;Jorcas;43;22;21;2023
44;Teruel;131;Josa;37;25;12;2023
44;Teruel;132;Lagueruela;72;43;29;2023
44;Teruel;133;Lanzuela;28;19;9;2023
44;Teruel;135;Libros;101;62;39;2023
44;Teruel;136;Lidón;51;29;22;2023
44;Teruel;137;Linares de Mora;232;131;101;2023
44;Teruel;141;Lledó;171;89;82;2023
44;Teruel;138;Loscos;116;73;43;2023
44;Teruel;142;Maicas;32;20;12;2023
44;Teruel;143;Manzanera;540;298;242;2023
44;Teruel;144;Martín del Río;370;175;195;2023
44;Teruel;145;Mas de las Matas;1237;635;602;2023
44;Teruel;146;Mata de los Olmos, La;281;151;130;2023
44;Teruel;147;Mazaleón;487;258;229;2023
44;Teruel;148;Mezquita de Jarque;82;42;40;2023
44;Teruel;149;Mirambel;105;60;45;2023
44;Teruel;150;Miravete de la Sierra;28;20;8;2023
44;Teruel;151;Molinos;225;119;106;2023
44;Teruel;152;Monforte de Moyuela;83;55;28;2023
44;Teruel;153;Monreal del Campo;2486;1222;1264;2023
44;Teruel;154;Monroyo;315;172;143;2023
44;Teruel;155;Montalbán;1180;596;584;2023
44;Teruel;156;Monteagudo del Castillo;43;25;18;2023
44;Teruel;157;Monterde de Albarracín;56;32;24;2023
44;Teruel;158;Mora de Rubielos;1568;783;785;2023
44;Teruel;159;Moscardón;56;30;26;2023
44;Teruel;160;Mosqueruela;538;294;244;2023
44;Teruel;161;Muniesa;571;304;267;2023
44;Teruel;163;Noguera de Albarracín;131;74;57;2023
44;Teruel;164;Nogueras;32;21;11;2023
44;Teruel;165;Nogueruelas;192;113;79;2023
44;Teruel;167;Obón;35;21;14;2023
44;Teruel;168;Odón;207;102;105;2023
44;Teruel;169;Ojos Negros;330;185;145;2023
44;Teruel;171;Olba;279;145;134;2023
44;Teruel;172;Oliete;349;189;160;2023
44;Teruel;173;Olmos, Los;119;69;50;2023
44;Teruel;174;Orihuela del Tremedal;453;255;198;2023
44;Teruel;175;Orrios;122;67;55;2023
44;Teruel;176;Palomar de Arroyos;167;98;69;2023
44;Teruel;177;Pancrudo;114;67;47;2023
44;Teruel;178;Parras de Castellote, Las;61;35;26;2023
44;Teruel;179;Peñarroya de Tastavins;443;234;209;2023
44;Teruel;180;Peracense;75;36;39;2023
44;Teruel;181;Peralejos;86;46;40;2023
44;Teruel;182;Perales del Alfambra;264;132;132;2023
44;Teruel;183;Pitarque;65;32;33;2023
44;Teruel;184;Plou;49;29;20;2023
44;Teruel;185;Pobo, El;102;65;37;2023
44;Teruel;187;Portellada, La;242;124;118;2023
44;Teruel;189;Pozondón;54;34;20;2023
44;Teruel;190;Pozuel del Campo;66;36;30;2023
44;Teruel;191;Puebla de Híjar, La;917;478;439;2023
44;Teruel;192;Puebla de Valverde, La;470;252;218;2023
44;Teruel;193;Puertomingalvo;137;73;64;2023
44;Teruel;194;Ráfales;150;87;63;2023
44;Teruel;195;Rillo;97;58;39;2023
44;Teruel;196;Riodeva;132;62;70;2023
44;Teruel;197;Ródenas;62;34;28;2023
44;Teruel;198;Royuela;231;119;112;2023
44;Teruel;199;Rubiales;42;22;20;2023
44;Teruel;200;Rubielos de la Cérida;30;18;12;2023
44;Teruel;201;Rubielos de Mora;627;316;311;2023
44;Teruel;203;Salcedillo;10;6;4;2023
44;Teruel;204;Saldón;21;15;6;2023
44;Teruel;205;Samper de Calanda;725;380;345;2023
44;Teruel;206;San Agustín;134;83;51;2023
44;Teruel;207;San Martín del Río;135;69;66;2023
44;Teruel;208;Santa Cruz de Nogueras;23;15;8;2023
44;Teruel;209;Santa Eulalia;1017;520;497;2023
44;Teruel;210;Sarrión;1197;607;590;2023
44;Teruel;211;Segura de los Baños;42;27;15;2023
44;Teruel;212;Seno;41;18;23;2023
44;Teruel;213;Singra;80;47;33;2023
44;Teruel;215;Terriente;206;120;86;2023
44;Teruel;216;Teruel;36267;17214;19053;2023
44;Teruel;217;Toril y Masegoso;33;26;7;2023
44;Teruel;218;Tormón;33;20;13;2023
44;Teruel;219;Tornos;191;102;89;2023
44;Teruel;220;Torralba de los Sisones;148;80;68;2023
44;Teruel;223;Torre de Arcas;82;37;45;2023
44;Teruel;224;Torre de las Arcas;24;13;11;2023
44;Teruel;225;Torre del Compte;118;62;56;2023
44;Teruel;227;Torre los Negros;76;41;35;2023
44;Teruel;221;Torrecilla de Alcañiz;440;233;207;2023
44;Teruel;222;Torrecilla del Rebollar;125;79;46;2023
44;Teruel;226;Torrelacárcel;135;79;56;2023
44;Teruel;228;Torremocha de Jiloca;110;56;54;2023
44;Teruel;229;Torres de Albarracín;191;102;89;2023
44;Teruel;230;Torrevelilla;169;87;82;2023
44;Teruel;231;Torrijas;36;17;19;2023
44;Teruel;232;Torrijo del Campo;502;260;242;2023
44;Teruel;234;Tramacastiel;62;35;27;2023
44;Teruel;235;Tramacastilla;109;52;57;2023
44;Teruel;236;Tronchón;61;33;28;2023
44;Teruel;237;Urrea de Gaén;447;228;219;2023
44;Teruel;238;Utrillas;3088;1579;1509;2023
44;Teruel;239;Valacloche;26;14;12;2023
44;Teruel;240;Valbona;192;110;82;2023
44;Teruel;241;Valdealgorfa;589;287;302;2023
44;Teruel;243;Valdecuenca;31;17;14;2023
44;Teruel;244;Valdelinares;80;49;31;2023
44;Teruel;245;Valdeltormo;313;151;162;2023
44;Teruel;246;Valderrobres;2517;1276;1241;2023
44;Teruel;247;Valjunquera;331;168;163;2023
44;Teruel;249;Vallecillo, El;37;22;15;2023
44;Teruel;250;Veguillas de la Sierra;20;12;8;2023
44;Teruel;251;Villafranca del Campo;302;162;140;2023
44;Teruel;252;Villahermosa del Campo;93;58;35;2023
44;Teruel;256;Villanueva del Rebollar de la Sierra;44;25;19;2023
44;Teruel;257;Villar del Cobo;163;99;64;2023
44;Teruel;258;Villar del Salz;59;35;24;2023
44;Teruel;260;Villarluengo;181;102;79;2023
44;Teruel;261;Villarquemado;865;455;410;2023
44;Teruel;262;Villarroya de los Pinares;168;88;80;2023
44;Teruel;263;Villastar;543;278;265;2023
44;Teruel;264;Villel;326;183;143;2023
44;Teruel;265;Vinaceite;200;108;92;2023
44;Teruel;266;Visiedo;130;62;68;2023
44;Teruel;267;Vivel del Río Martín;67;35;32;2023
44;Teruel;268;Zoma, La;27;14;13;2023
45;Toledo;001;Ajofrín;2340;1180;1160;2023
45;Toledo;002;Alameda de la Sagra;4149;2181;1968;2023
45;Toledo;003;Albarreal de Tajo;735;375;360;2023
45;Toledo;004;Alcabón;762;384;378;2023
45;Toledo;005;Alcañizo;283;133;150;2023
45;Toledo;006;Alcaudete de la Jara;1640;824;816;2023
45;Toledo;007;Alcolea de Tajo;839;424;415;2023
45;Toledo;008;Aldea en Cabo;204;106;98;2023
45;Toledo;009;Aldeanueva de Barbarroya;452;233;219;2023
45;Toledo;010;Aldeanueva de San Bartolomé;414;211;203;2023
45;Toledo;011;Almendral de la Cañada;333;174;159;2023
45;Toledo;012;Almonacid de Toledo;926;467;459;2023
45;Toledo;013;Almorox;2396;1261;1135;2023
45;Toledo;014;Añover de Tajo;5215;2628;2587;2023
45;Toledo;015;Arcicóllar;1075;538;537;2023
45;Toledo;016;Argés;6961;3477;3484;2023
45;Toledo;017;Azután;292;142;150;2023
45;Toledo;018;Barcience;1039;554;485;2023
45;Toledo;019;Bargas;10978;5489;5489;2023
45;Toledo;020;Belvís de la Jara;1492;772;720;2023
45;Toledo;021;Borox;4114;2188;1926;2023
45;Toledo;022;Buenaventura;377;187;190;2023
45;Toledo;023;Burguillos de Toledo;3647;1903;1744;2023
45;Toledo;024;Burujón;1300;662;638;2023
45;Toledo;025;Cabañas de la Sagra;2107;1091;1016;2023
45;Toledo;026;Cabañas de Yepes;295;155;140;2023
45;Toledo;027;Cabezamesada;356;196;160;2023
45;Toledo;028;Calera y Chozas;4754;2399;2355;2023
45;Toledo;029;Caleruela;202;102;100;2023
45;Toledo;030;Calzada de Oropesa;498;274;224;2023
45;Toledo;031;Camarena;4439;2305;2134;2023
45;Toledo;032;Camarenilla;629;318;311;2023
45;Toledo;033;Campillo de la Jara, El;330;176;154;2023
45;Toledo;034;Camuñas;1765;923;842;2023
45;Toledo;035;Cardiel de los Montes;398;209;189;2023
45;Toledo;036;Carmena;848;434;414;2023
45;Toledo;037;Carpio de Tajo, El;1862;932;930;2023
45;Toledo;038;Carranque;5274;2736;2538;2023
45;Toledo;039;Carriches;270;133;137;2023
45;Toledo;040;Casar de Escalona, El;2011;1067;944;2023
45;Toledo;041;Casarrubios del Monte;6671;3470;3201;2023
45;Toledo;042;Casasbuenas;178;95;83;2023
45;Toledo;043;Castillo de Bayuela;905;456;449;2023
45;Toledo;045;Cazalegas;1973;1029;944;2023
45;Toledo;046;Cebolla;3191;1588;1603;2023
45;Toledo;047;Cedillo del Condado;4204;2179;2025;2023
45;Toledo;048;Cerralbos, Los;421;227;194;2023
45;Toledo;049;Cervera de los Montes;500;258;242;2023
45;Toledo;056;Chozas de Canales;4751;2462;2289;2023
45;Toledo;057;Chueca;254;126;128;2023
45;Toledo;050;Ciruelos;642;342;300;2023
45;Toledo;051;Cobeja;2556;1344;1212;2023
45;Toledo;052;Cobisa;4452;2238;2214;2023
45;Toledo;053;Consuegra;9805;4958;4847;2023
45;Toledo;054;Corral de Almaguer;5219;2739;2480;2023
45;Toledo;055;Cuerva;1264;657;607;2023
45;Toledo;058;Domingo Pérez;387;190;197;2023
45;Toledo;059;Dosbarrios;2223;1147;1076;2023
45;Toledo;060;Erustes;225;120;105;2023
45;Toledo;061;Escalona;3669;1882;1787;2023
45;Toledo;062;Escalonilla;1469;717;752;2023
45;Toledo;063;Espinoso del Rey;422;248;174;2023
45;Toledo;064;Esquivias;5778;2947;2831;2023
45;Toledo;065;Estrella, La;298;161;137;2023
45;Toledo;066;Fuensalida;12329;6241;6088;2023
45;Toledo;067;Gálvez;3002;1517;1485;2023
45;Toledo;068;Garciotum;215;107;108;2023
45;Toledo;069;Gerindote;2617;1321;1296;2023
45;Toledo;070;Guadamur;1802;908;894;2023
45;Toledo;071;Guardia, La;2136;1082;1054;2023
45;Toledo;072;Herencias, Las;794;419;375;2023
45;Toledo;073;Herreruela de Oropesa;317;172;145;2023
45;Toledo;074;Hinojosa de San Vicente;381;209;172;2023
45;Toledo;075;Hontanar;145;88;57;2023
45;Toledo;076;Hormigos;949;522;427;2023
45;Toledo;077;Huecas;849;436;413;2023
45;Toledo;078;Huerta de Valdecarábanos;1760;892;868;2023
45;Toledo;079;Iglesuela del Tiétar, La;444;236;208;2023
45;Toledo;080;Illán de Vacas;3;3;0;2023
45;Toledo;081;Illescas;31327;15749;15578;2023
45;Toledo;082;Lagartera;1306;644;662;2023
45;Toledo;083;Layos;873;441;432;2023
45;Toledo;084;Lillo;2518;1311;1207;2023
45;Toledo;085;Lominchar;2639;1400;1239;2023
45;Toledo;086;Lucillos;597;313;284;2023
45;Toledo;087;Madridejos;10169;5089;5080;2023
45;Toledo;088;Magán;4038;2048;1990;2023
45;Toledo;089;Malpica de Tajo;1649;847;802;2023
45;Toledo;090;Manzaneque;394;200;194;2023
45;Toledo;091;Maqueda;496;246;250;2023
45;Toledo;092;Marjaliza;256;131;125;2023
45;Toledo;093;Marrupe;157;78;79;2023
45;Toledo;094;Mascaraque;430;215;215;2023
45;Toledo;095;Mata, La;881;432;449;2023
45;Toledo;096;Mazarambroz;1259;657;602;2023
45;Toledo;097;Mejorada;1374;701;673;2023
45;Toledo;098;Menasalbas;2482;1289;1193;2023
45;Toledo;099;Méntrida;6019;3057;2962;2023
45;Toledo;100;Mesegar de Tajo;205;111;94;2023
45;Toledo;101;Miguel Esteban;4779;2404;2375;2023
45;Toledo;102;Mocejón;5069;2539;2530;2023
45;Toledo;103;Mohedas de la Jara;394;210;184;2023
45;Toledo;104;Montearagón;573;307;266;2023
45;Toledo;105;Montesclaros;381;201;180;2023
45;Toledo;106;Mora;9782;4914;4868;2023
45;Toledo;107;Nambroca;5151;2616;2535;2023
45;Toledo;108;Nava de Ricomalillo, La;496;261;235;2023
45;Toledo;109;Navahermosa;3618;1894;1724;2023
45;Toledo;110;Navalcán;1861;961;900;2023
45;Toledo;111;Navalmoralejo;50;26;24;2023
45;Toledo;112;Navalmorales, Los;2134;1098;1036;2023
45;Toledo;113;Navalucillos, Los;1956;994;962;2023
45;Toledo;114;Navamorcuende;608;299;309;2023
45;Toledo;115;Noblejas;3911;1964;1947;2023
45;Toledo;116;Noez;942;486;456;2023
45;Toledo;117;Nombela;907;491;416;2023
45;Toledo;118;Novés;3388;1728;1660;2023
45;Toledo;119;Numancia de la Sagra;5455;2838;2617;2023
45;Toledo;120;Nuño Gómez;159;89;70;2023
45;Toledo;121;Ocaña;13868;6935;6933;2023
45;Toledo;122;Olías del Rey;8705;4401;4304;2023
45;Toledo;123;Ontígola;4916;2582;2334;2023
45;Toledo;124;Orgaz;2600;1310;1290;2023
45;Toledo;125;Oropesa;2600;1245;1355;2023
45;Toledo;126;Otero;419;224;195;2023
45;Toledo;127;Palomeque;1143;624;519;2023
45;Toledo;128;Pantoja;3551;1785;1766;2023
45;Toledo;129;Paredes de Escalona;126;70;56;2023
45;Toledo;130;Parrillas;352;185;167;2023
45;Toledo;131;Pelahustán;337;195;142;2023
45;Toledo;132;Pepino;3163;1622;1541;2023
45;Toledo;133;Polán;3884;1949;1935;2023
45;Toledo;134;Portillo de Toledo;2308;1168;1140;2023
45;Toledo;135;Puebla de Almoradiel, La;4952;2525;2427;2023
45;Toledo;136;Puebla de Montalbán, La;7885;3985;3900;2023
45;Toledo;137;Pueblanueva, La;2158;1114;1044;2023
45;Toledo;138;Puente del Arzobispo, El;1171;589;582;2023
45;Toledo;139;Puerto de San Vicente;162;89;73;2023
45;Toledo;140;Pulgar;1528;788;740;2023
45;Toledo;141;Quero;1012;517;495;2023
45;Toledo;142;Quintanar de la Orden;11119;5507;5612;2023
45;Toledo;143;Quismondo;1721;849;872;2023
45;Toledo;144;Real de San Vicente, El;975;519;456;2023
45;Toledo;145;Recas;4876;2700;2176;2023
45;Toledo;146;Retamoso de la Jara;109;56;53;2023
45;Toledo;147;Rielves;806;404;402;2023
45;Toledo;148;Robledo del Mazo;247;136;111;2023
45;Toledo;149;Romeral, El;568;279;289;2023
45;Toledo;150;San Bartolomé de las Abiertas;619;333;286;2023
45;Toledo;151;San Martín de Montalbán;724;375;349;2023
45;Toledo;152;San Martín de Pusa;590;318;272;2023
45;Toledo;153;San Pablo de los Montes;1679;844;835;2023
45;Toledo;154;San Román de los Montes;2071;1060;1011;2023
45;Toledo;155;Santa Ana de Pusa;346;205;141;2023
45;Toledo;156;Santa Cruz de la Zarza;4098;2086;2012;2023
45;Toledo;157;Santa Cruz del Retamar;3901;2016;1885;2023
45;Toledo;158;Santa Olalla;3436;1732;1704;2023
45;Toledo;901;Santo Domingo-Caudilla;1165;608;557;2023
45;Toledo;159;Sartajada;109;66;43;2023
45;Toledo;160;Segurilla;1384;704;680;2023
45;Toledo;161;Seseña;29271;15046;14225;2023
45;Toledo;162;Sevilleja de la Jara;643;355;288;2023
45;Toledo;163;Sonseca;11205;5704;5501;2023
45;Toledo;164;Sotillo de las Palomas;173;88;85;2023
45;Toledo;165;Talavera de la Reina;84137;40349;43788;2023
45;Toledo;166;Tembleque;1955;989;966;2023
45;Toledo;167;Toboso, El;1667;833;834;2023
45;Toledo;168;Toledo;86070;40930;45140;2023
45;Toledo;169;Torralba de Oropesa;192;105;87;2023
45;Toledo;171;Torre de Esteban Hambrán, La;1846;929;917;2023
45;Toledo;170;Torrecilla de la Jara;211;117;94;2023
45;Toledo;172;Torrico;701;356;345;2023
45;Toledo;173;Torrijos;13885;6817;7068;2023
45;Toledo;174;Totanés;350;178;172;2023
45;Toledo;175;Turleque;702;352;350;2023
45;Toledo;176;Ugena;5723;2951;2772;2023
45;Toledo;177;Urda;2491;1255;1236;2023
45;Toledo;179;Valdeverdeja;559;283;276;2023
45;Toledo;180;Valmojado;4672;2346;2326;2023
45;Toledo;181;Velada;2889;1482;1407;2023
45;Toledo;182;Ventas con Peña Aguilera, Las;1139;574;565;2023
45;Toledo;183;Ventas de Retamosa, Las;4088;2148;1940;2023
45;Toledo;184;Ventas de San Julián, Las;229;107;122;2023
45;Toledo;186;Villa de Don Fadrique, La;3569;1774;1795;2023
45;Toledo;185;Villacañas;9511;4742;4769;2023
45;Toledo;187;Villafranca de los Caballeros;4846;2449;2397;2023
45;Toledo;188;Villaluenga de la Sagra;4162;2105;2057;2023
45;Toledo;189;Villamiel de Toledo;1056;537;519;2023
45;Toledo;190;Villaminaya;498;255;243;2023
45;Toledo;191;Villamuelas;613;320;293;2023
45;Toledo;192;Villanueva de Alcardete;2985;1534;1451;2023
45;Toledo;193;Villanueva de Bogas;695;356;339;2023
45;Toledo;194;Villarejo de Montalbán;69;35;34;2023
45;Toledo;195;Villarrubia de Santiago;2535;1288;1247;2023
45;Toledo;196;Villaseca de la Sagra;1851;923;928;2023
45;Toledo;197;Villasequilla;2604;1334;1270;2023
45;Toledo;198;Villatobas;2753;1410;1343;2023
45;Toledo;199;Viso de San Juan, El;5970;3185;2785;2023
45;Toledo;200;Yébenes, Los;5717;2908;2809;2023
45;Toledo;201;Yeles;6176;3269;2907;2023
45;Toledo;202;Yepes;5397;2738;2659;2023
45;Toledo;203;Yuncler;4842;2486;2356;2023
45;Toledo;204;Yunclillos;820;430;390;2023
45;Toledo;205;Yuncos;11762;5986;5776;2023
46;Valencia/València;001;Ademuz;1004;538;466;2023
46;Valencia/València;002;Ador;1699;890;809;2023
46;Valencia/València;004;Agullent;2400;1193;1207;2023
46;Valencia/València;042;Aielo de Malferit;4601;2323;2278;2023
46;Valencia/València;043;Aielo de Rugat;163;88;75;2023
46;Valencia/València;005;Alaquàs;29825;14492;15333;2023
46;Valencia/València;006;Albaida;6102;3013;3089;2023
46;Valencia/València;007;Albal;17024;8501;8523;2023
46;Valencia/València;008;Albalat de la Ribera;3411;1719;1692;2023
46;Valencia/València;009;Albalat dels Sorells;4158;2042;2116;2023
46;Valencia/València;010;Albalat dels Tarongers;1428;749;679;2023
46;Valencia/València;011;Alberic;10815;5387;5428;2023
46;Valencia/València;012;Alborache;1389;727;662;2023
46;Valencia/València;013;Alboraia/Alboraya;25792;12547;13245;2023
46;Valencia/València;014;Albuixech;4343;2102;2241;2023
46;Valencia/València;016;Alcàntera de Xúquer;1414;708;706;2023
46;Valencia/València;015;Alcàsser;10575;5277;5298;2023
46;Valencia/València;018;Alcublas;635;334;301;2023
46;Valencia/València;020;Alcúdia de Crespins, l';5361;2631;2730;2023
46;Valencia/València;019;Alcúdia, l';12197;5999;6198;2023
46;Valencia/València;021;Aldaia;33376;16712;16664;2023
46;Valencia/València;022;Alfafar;21879;10679;11200;2023
46;Valencia/València;024;Alfara de la Baronia;611;304;307;2023
46;Valencia/València;025;Alfara del Patriarca;3455;1602;1853;2023
46;Valencia/València;026;Alfarp;1618;828;790;2023
46;Valencia/València;027;Alfarrasí;1183;581;602;2023
46;Valencia/València;023;Alfauir;477;245;232;2023
46;Valencia/València;028;Algar de Palancia;527;281;246;2023
46;Valencia/València;029;Algemesí;27438;13614;13824;2023
46;Valencia/València;030;Algímia d'Alfara;1109;547;562;2023
46;Valencia/València;031;Alginet;14442;7294;7148;2023
46;Valencia/València;032;Almàssera;7504;3668;3836;2023
46;Valencia/València;033;Almiserà;279;137;142;2023
46;Valencia/València;034;Almoines;2519;1266;1253;2023
46;Valencia/València;035;Almussafes;8996;4476;4520;2023
46;Valencia/València;036;Alpuente;667;366;301;2023
46;Valencia/València;037;Alqueria de la Comtessa, l';1523;742;781;2023
46;Valencia/València;017;Alzira;46421;22657;23764;2023
46;Valencia/València;038;Andilla;311;208;103;2023
46;Valencia/València;039;Anna;2593;1298;1295;2023
46;Valencia/València;040;Antella;1114;542;572;2023
46;Valencia/València;041;Aras de los Olmos;381;213;168;2023
46;Valencia/València;003;Atzeneta d'Albaida;1161;583;578;2023
46;Valencia/València;044;Ayora;5223;2573;2650;2023
46;Valencia/València;046;Barx;1476;767;709;2023
46;Valencia/València;045;Barxeta;1595;818;777;2023
46;Valencia/València;047;Bèlgida;632;315;317;2023
46;Valencia/València;048;Bellreguard;4811;2402;2409;2023
46;Valencia/València;049;Bellús;306;156;150;2023
46;Valencia/València;050;Benagéber;168;100;68;2023
46;Valencia/València;051;Benaguasil;11877;6043;5834;2023
46;Valencia/València;052;Benavites;674;327;347;2023
46;Valencia/València;053;Beneixida;655;313;342;2023
46;Valencia/València;054;Benetússer;15879;7742;8137;2023
46;Valencia/València;055;Beniarjó;1872;942;930;2023
46;Valencia/València;056;Beniatjar;217;118;99;2023
46;Valencia/València;057;Benicolet;599;291;308;2023
46;Valencia/València;904;Benicull de Xúquer;1134;573;561;2023
46;Valencia/València;060;Benifaió;11984;5895;6089;2023
46;Valencia/València;059;Benifairó de la Valldigna;1554;767;787;2023
46;Valencia/València;058;Benifairó de les Valls;2320;1127;1193;2023
46;Valencia/València;061;Beniflá;484;236;248;2023
46;Valencia/València;062;Benigànim;5716;2907;2809;2023
46;Valencia/València;063;Benimodo;2279;1154;1125;2023
46;Valencia/València;064;Benimuslem;665;358;307;2023
46;Valencia/València;065;Beniparrell;2074;1050;1024;2023
46;Valencia/València;066;Benirredrà;1571;742;829;2023
46;Valencia/València;067;Benissanó;2385;1176;1209;2023
46;Valencia/València;068;Benissoda;460;248;212;2023
46;Valencia/València;069;Benissuera;185;93;92;2023
46;Valencia/València;070;Bétera;26759;13321;13438;2023
46;Valencia/València;071;Bicorp;549;266;283;2023
46;Valencia/València;072;Bocairent;4115;2070;2045;2023
46;Valencia/València;073;Bolbaite;1334;657;677;2023
46;Valencia/València;074;Bonrepòs i Mirambell;3907;1912;1995;2023
46;Valencia/València;075;Bufali;156;82;74;2023
46;Valencia/València;076;Bugarra;783;398;385;2023
46;Valencia/València;077;Buñol;9579;4765;4814;2023
46;Valencia/València;078;Burjassot;39702;19055;20647;2023
46;Valencia/València;079;Calles;431;249;182;2023
46;Valencia/València;080;Camporrobles;1189;611;578;2023
46;Valencia/València;081;Canals;13162;6548;6614;2023
46;Valencia/València;082;Canet d'En Berenguer;7265;3653;3612;2023
46;Valencia/València;083;Carcaixent;20777;10335;10442;2023
46;Valencia/València;084;Càrcer;1826;879;947;2023
46;Valencia/València;085;Carlet;16141;8089;8052;2023
46;Valencia/València;086;Carrícola;102;51;51;2023
46;Valencia/València;087;Casas Altas;146;72;74;2023
46;Valencia/València;088;Casas Bajas;173;88;85;2023
46;Valencia/València;089;Casinos;3091;1556;1535;2023
46;Valencia/València;257;Castelló;6891;3387;3504;2023
46;Valencia/València;090;Castelló de Rugat;2322;1181;1141;2023
46;Valencia/València;091;Castellonet de la Conquesta;149;80;69;2023
46;Valencia/València;092;Castielfabib;297;159;138;2023
46;Valencia/València;093;Catadau;2939;1478;1461;2023
46;Valencia/València;094;Catarroja;29316;14487;14829;2023
46;Valencia/València;095;Caudete de las Fuentes;693;362;331;2023
46;Valencia/València;096;Cerdà;360;186;174;2023
46;Valencia/València;107;Chella;2445;1221;1224;2023
46;Valencia/València;106;Chelva;1645;850;795;2023
46;Valencia/València;108;Chera;483;255;228;2023
46;Valencia/València;109;Cheste;8962;4622;4340;2023
46;Valencia/València;111;Chiva;16750;8570;8180;2023
46;Valencia/València;112;Chulilla;687;368;319;2023
46;Valencia/València;097;Cofrentes;1130;566;564;2023
46;Valencia/València;098;Corbera;3118;1537;1581;2023
46;Valencia/València;099;Cortes de Pallás;753;409;344;2023
46;Valencia/València;100;Cotes;314;161;153;2023
46;Valencia/València;105;Cullera;23753;11958;11795;2023
46;Valencia/València;113;Daimús;3348;1681;1667;2023
46;Valencia/València;114;Domeño;684;337;347;2023
46;Valencia/València;115;Dos Aguas;340;195;145;2023
46;Valencia/València;116;Eliana, l';19054;9344;9710;2023
46;Valencia/València;117;Emperador;717;371;346;2023
46;Valencia/València;118;Enguera;4781;2392;2389;2023
46;Valencia/València;119;Énova, l';914;471;443;2023
46;Valencia/València;120;Estivella;1598;774;824;2023
46;Valencia/València;121;Estubeny;114;56;58;2023
46;Valencia/València;122;Faura;3619;1809;1810;2023
46;Valencia/València;123;Favara;2664;1365;1299;2023
46;Valencia/València;126;Foios;7641;3733;3908;2023
46;Valencia/València;128;Font de la Figuera, la;2031;1034;997;2023
46;Valencia/València;127;Font d'en Carròs, la;3858;1934;1924;2023
46;Valencia/València;124;Fontanars dels Alforins;951;492;459;2023
46;Valencia/València;125;Fortaleny;1004;496;508;2023
46;Valencia/València;129;Fuenterrobles;688;373;315;2023
46;Valencia/València;131;Gandia;78108;38281;39827;2023
46;Valencia/València;902;Gátova;410;208;202;2023
46;Valencia/València;130;Gavarda;1058;504;554;2023
46;Valencia/València;132;Genovés, el;2778;1413;1365;2023
46;Valencia/València;133;Gestalgar;569;295;274;2023
46;Valencia/València;134;Gilet;3818;1937;1881;2023
46;Valencia/València;135;Godella;13414;6463;6951;2023
46;Valencia/València;136;Godelleta;4148;2137;2011;2023
46;Valencia/València;137;Granja de la Costera, la;288;145;143;2023
46;Valencia/València;138;Guadasséquies;480;236;244;2023
46;Valencia/València;139;Guadassuar;5961;2885;3076;2023
46;Valencia/València;140;Guardamar de la Safor;605;304;301;2023
46;Valencia/València;141;Higueruelas;522;276;246;2023
46;Valencia/València;142;Jalance;810;420;390;2023
46;Valencia/València;144;Jarafuel;765;403;362;2023
46;Valencia/València;154;Llanera de Ranes;1054;540;514;2023
46;Valencia/València;155;Llaurí;1208;610;598;2023
46;Valencia/València;147;Llíria;24518;12344;12174;2023
46;Valencia/València;152;Llocnou de la Corona;124;59;65;2023
46;Valencia/València;153;Llocnou de Sant Jeroni;567;284;283;2023
46;Valencia/València;151;Llocnou d'En Fenollet;908;466;442;2023
46;Valencia/València;156;Llombai;2687;1332;1355;2023
46;Valencia/València;157;Llosa de Ranes, la;3681;1872;1809;2023
46;Valencia/València;150;Llutxent;2324;1181;1143;2023
46;Valencia/València;148;Loriguilla;2171;1124;1047;2023
46;Valencia/València;149;Losa del Obispo;520;261;259;2023
46;Valencia/València;158;Macastre;1437;752;685;2023
46;Valencia/València;159;Manises;31573;15630;15943;2023
46;Valencia/València;160;Manuel;2500;1244;1256;2023
46;Valencia/València;161;Marines;1955;1007;948;2023
46;Valencia/València;162;Massalavés;1739;885;854;2023
46;Valencia/València;163;Massalfassar;2609;1300;1309;2023
46;Valencia/València;164;Massamagrell;16766;8264;8502;2023
46;Valencia/València;165;Massanassa;10146;4958;5188;2023
46;Valencia/València;166;Meliana;10918;5354;5564;2023
46;Valencia/València;167;Millares;330;165;165;2023
46;Valencia/València;168;Miramar;2978;1493;1485;2023
46;Valencia/València;169;Mislata;45644;22137;23507;2023
46;Valencia/València;170;Moixent/Mogente;4383;2195;2188;2023
46;Valencia/València;171;Moncada;22067;10710;11357;2023
46;Valencia/València;173;Montaverner;1617;800;817;2023
46;Valencia/València;174;Montesa;1132;575;557;2023
46;Valencia/València;175;Montitxelvo/Montichelvo;558;274;284;2023
46;Valencia/València;176;Montroi/Montroy;3295;1746;1549;2023
46;Valencia/València;172;Montserrat;9312;4815;4497;2023
46;Valencia/València;177;Museros;6741;3432;3309;2023
46;Valencia/València;178;Nàquera/Náquera;8102;4182;3920;2023
46;Valencia/València;179;Navarrés;3061;1529;1532;2023
46;Valencia/València;180;Novetlè/Novelé;856;420;436;2023
46;Valencia/València;181;Oliva;25558;12553;13005;2023
46;Valencia/València;183;Olleria, l';8421;4237;4184;2023
46;Valencia/València;182;Olocau;2303;1219;1084;2023
46;Valencia/València;184;Ontinyent;36194;17842;18352;2023
46;Valencia/València;185;Otos;436;221;215;2023
46;Valencia/València;186;Paiporta;27184;13312;13872;2023
46;Valencia/València;187;Palma de Gandía;1735;916;819;2023
46;Valencia/València;188;Palmera;1043;522;521;2023
46;Valencia/València;189;Palomar, el;574;292;282;2023
46;Valencia/València;190;Paterna;73488;36161;37327;2023
46;Valencia/València;191;Pedralba;3048;1600;1448;2023
46;Valencia/València;192;Petrés;1096;545;551;2023
46;Valencia/València;193;Picanya;11760;5825;5935;2023
46;Valencia/València;194;Picassent;22236;11164;11072;2023
46;Valencia/València;195;Piles;3031;1496;1535;2023
46;Valencia/València;196;Pinet;155;78;77;2023
46;Valencia/València;199;Pobla de Farnals, la;8699;4371;4328;2023
46;Valencia/València;202;Pobla de Vallbona, la;26435;13258;13177;2023
46;Valencia/València;200;Pobla del Duc, la;2438;1174;1264;2023
46;Valencia/València;203;Pobla Llarga, la;4529;2273;2256;2023
46;Valencia/València;197;Polinyà de Xúquer;2550;1309;1241;2023
46;Valencia/València;198;Potries;1080;555;525;2023
46;Valencia/València;205;Puçol;20731;10212;10519;2023
46;Valencia/València;201;Puebla de San Miguel;53;35;18;2023
46;Valencia/València;204;Puig de Santa Maria, el;8992;4375;4617;2023
46;Valencia/València;101;Quart de les Valls;1050;499;551;2023
46;Valencia/València;102;Quart de Poblet;25590;12425;13165;2023
46;Valencia/València;103;Quartell;1672;786;886;2023
46;Valencia/València;104;Quatretonda;2190;1096;1094;2023
46;Valencia/València;206;Quesa;661;338;323;2023
46;Valencia/València;207;Rafelbunyol;9467;4617;4850;2023
46;Valencia/València;208;Rafelcofer;1372;670;702;2023
46;Valencia/València;209;Rafelguaraf;2351;1158;1193;2023
46;Valencia/València;210;Ráfol de Salem;467;242;225;2023
46;Valencia/València;212;Real;2410;1248;1162;2023
46;Valencia/València;211;Real de Gandia, el;2649;1341;1308;2023
46;Valencia/València;213;Requena;20387;10230;10157;2023
46;Valencia/València;214;Riba-roja de Túria;23555;11887;11668;2023
46;Valencia/València;215;Riola;1780;886;894;2023
46;Valencia/València;216;Rocafort;7570;3695;3875;2023
46;Valencia/València;217;Rotglà i Corberà;1165;580;585;2023
46;Valencia/València;218;Ròtova;1292;655;637;2023
46;Valencia/València;219;Rugat;166;91;75;2023
46;Valencia/València;220;Sagunt/Sagunto;70128;34175;35953;2023
46;Valencia/València;221;Salem;401;203;198;2023
46;Valencia/València;903;San Antonio de Benagéber;10200;5042;5158;2023
46;Valencia/València;222;Sant Joanet;544;272;272;2023
46;Valencia/València;223;Sedaví;10637;5225;5412;2023
46;Valencia/València;224;Segart;166;88;78;2023
46;Valencia/València;225;Sellent;381;194;187;2023
46;Valencia/València;226;Sempere;31;16;15;2023
46;Valencia/València;227;Senyera;1122;547;575;2023
46;Valencia/València;228;Serra;3608;1826;1782;2023
46;Valencia/València;229;Siete Aguas;1229;636;593;2023
46;Valencia/València;230;Silla;19683;9747;9936;2023
46;Valencia/València;231;Simat de la Valldigna;3251;1613;1638;2023
46;Valencia/València;232;Sinarcas;1113;586;527;2023
46;Valencia/València;233;Sollana;4959;2431;2528;2023
46;Valencia/València;234;Sot de Chera;423;225;198;2023
46;Valencia/València;235;Sueca;28086;13904;14182;2023
46;Valencia/València;236;Sumacàrcer;1062;515;547;2023
46;Valencia/València;237;Tavernes Blanques;9456;4599;4857;2023
46;Valencia/València;238;Tavernes de la Valldigna;17443;8637;8806;2023
46;Valencia/València;239;Teresa de Cofrentes;611;317;294;2023
46;Valencia/València;240;Terrateig;291;150;141;2023
46;Valencia/València;241;Titaguas;505;260;245;2023
46;Valencia/València;242;Torrebaja;404;219;185;2023
46;Valencia/València;243;Torrella;143;78;65;2023
46;Valencia/València;244;Torrent;87295;42763;44532;2023
46;Valencia/València;245;Torres Torres;745;406;339;2023
46;Valencia/València;246;Tous;1352;675;677;2023
46;Valencia/València;247;Tuéjar;1201;643;558;2023
46;Valencia/València;248;Turís;7259;3785;3474;2023
46;Valencia/València;249;Utiel;11632;5799;5833;2023
46;Valencia/València;250;València;807693;383065;424628;2023
46;Valencia/València;251;Vallada;3063;1555;1508;2023
46;Valencia/València;252;Vallanca;144;75;69;2023
46;Valencia/València;253;Vallés;151;85;66;2023
46;Valencia/València;254;Venta del Moro;1164;626;538;2023
46;Valencia/València;255;Vilallonga/Villalonga;4667;2304;2363;2023
46;Valencia/València;256;Vilamarxant;10772;5562;5210;2023
46;Valencia/València;258;Villar del Arzobispo;3700;1878;1822;2023
46;Valencia/València;259;Villargordo del Cabriel;577;291;286;2023
46;Valencia/València;260;Vinalesa;3495;1690;1805;2023
46;Valencia/València;145;Xàtiva;30072;14717;15355;2023
46;Valencia/València;143;Xeraco;5923;2974;2949;2023
46;Valencia/València;146;Xeresa;2263;1136;1127;2023
46;Valencia/València;110;Xirivella;30749;15155;15594;2023
46;Valencia/València;261;Yátova;2205;1148;1057;2023
46;Valencia/València;262;Yesa, La;235;127;108;2023
46;Valencia/València;263;Zarra;364;198;166;2023
47;Valladolid;001;Adalia;51;30;21;2023
47;Valladolid;002;Aguasal;19;12;7;2023
47;Valladolid;003;Aguilar de Campos;266;159;107;2023
47;Valladolid;004;Alaejos;1380;731;649;2023
47;Valladolid;005;Alcazarén;645;344;301;2023
47;Valladolid;006;Aldea de San Miguel;215;119;96;2023
47;Valladolid;007;Aldeamayor de San Martín;6035;3107;2928;2023
47;Valladolid;008;Almenara de Adaja;23;13;10;2023
47;Valladolid;009;Amusquillo;103;63;40;2023
47;Valladolid;010;Arroyo de la Encomienda;21946;10972;10974;2023
47;Valladolid;011;Ataquines;554;303;251;2023
47;Valladolid;012;Bahabón;81;38;43;2023
47;Valladolid;013;Barcial de la Loma;99;55;44;2023
47;Valladolid;014;Barruelo del Valle;51;28;23;2023
47;Valladolid;015;Becilla de Valderaduey;211;120;91;2023
47;Valladolid;016;Benafarces;69;38;31;2023
47;Valladolid;017;Bercero;177;100;77;2023
47;Valladolid;018;Berceruelo;37;22;15;2023
47;Valladolid;019;Berrueces;98;55;43;2023
47;Valladolid;020;Bobadilla del Campo;282;160;122;2023
47;Valladolid;021;Bocigas;76;41;35;2023
47;Valladolid;022;Bocos de Duero;80;43;37;2023
47;Valladolid;023;Boecillo;4297;2164;2133;2023
47;Valladolid;024;Bolaños de Campos;245;139;106;2023
47;Valladolid;025;Brahojos de Medina;102;55;47;2023
47;Valladolid;026;Bustillo de Chaves;72;42;30;2023
47;Valladolid;027;Cabezón de Pisuerga;3823;1948;1875;2023
47;Valladolid;028;Cabezón de Valderaduey;36;19;17;2023
47;Valladolid;029;Cabreros del Monte;56;30;26;2023
47;Valladolid;030;Campaspero;1035;579;456;2023
47;Valladolid;031;Campillo, El;202;117;85;2023
47;Valladolid;032;Camporredondo;153;90;63;2023
47;Valladolid;033;Canalejas de Peñafiel;233;124;109;2023
47;Valladolid;034;Canillas de Esgueva;70;42;28;2023
47;Valladolid;035;Carpio;945;511;434;2023
47;Valladolid;036;Casasola de Arión;221;131;90;2023
47;Valladolid;037;Castrejón de Trabancos;181;93;88;2023
47;Valladolid;038;Castrillo de Duero;130;72;58;2023
47;Valladolid;039;Castrillo-Tejeriego;157;88;69;2023
47;Valladolid;040;Castrobol;52;25;27;2023
47;Valladolid;041;Castrodeza;146;93;53;2023
47;Valladolid;042;Castromembibre;51;35;16;2023
47;Valladolid;043;Castromonte;331;177;154;2023
47;Valladolid;044;Castronuevo de Esgueva;387;212;175;2023
47;Valladolid;045;Castronuño;790;390;400;2023
47;Valladolid;046;Castroponce;133;71;62;2023
47;Valladolid;047;Castroverde de Cerrato;195;124;71;2023
47;Valladolid;048;Ceinos de Campos;183;110;73;2023
47;Valladolid;049;Cervillego de la Cruz;95;55;40;2023
47;Valladolid;050;Cigales;5360;2747;2613;2023
47;Valladolid;051;Ciguñuela;356;188;168;2023
47;Valladolid;052;Cistérniga;9182;4615;4567;2023
47;Valladolid;053;Cogeces de Íscar;143;72;71;2023
47;Valladolid;054;Cogeces del Monte;641;349;292;2023
47;Valladolid;055;Corcos;218;122;96;2023
47;Valladolid;056;Corrales de Duero;103;59;44;2023
47;Valladolid;057;Cubillas de Santa Marta;389;222;167;2023
47;Valladolid;058;Cuenca de Campos;198;103;95;2023
47;Valladolid;059;Curiel de Duero;121;76;45;2023
47;Valladolid;060;Encinas de Esgueva;213;118;95;2023
47;Valladolid;061;Esguevillas de Esgueva;266;148;118;2023
47;Valladolid;062;Fombellida;180;104;76;2023
47;Valladolid;063;Fompedraza;106;58;48;2023
47;Valladolid;064;Fontihoyuelo;36;22;14;2023
47;Valladolid;065;Fresno el Viejo;854;455;399;2023
47;Valladolid;066;Fuensaldaña;2076;1067;1009;2023
47;Valladolid;067;Fuente el Sol;149;79;70;2023
47;Valladolid;068;Fuente-Olmedo;37;17;20;2023
47;Valladolid;069;Gallegos de Hornija;108;54;54;2023
47;Valladolid;070;Gatón de Campos;33;20;13;2023
47;Valladolid;071;Geria;486;234;252;2023
47;Valladolid;073;Herrín de Campos;113;63;50;2023
47;Valladolid;074;Hornillos de Eresma;190;111;79;2023
47;Valladolid;075;Íscar;6326;3192;3134;2023
47;Valladolid;076;Laguna de Duero;22672;11232;11440;2023
47;Valladolid;077;Langayo;253;159;94;2023
47;Valladolid;079;Llano de Olmedo;45;21;24;2023
47;Valladolid;078;Lomoviejo;165;89;76;2023
47;Valladolid;080;Manzanillo;53;29;24;2023
47;Valladolid;081;Marzales;45;21;24;2023
47;Valladolid;082;Matapozuelos;1008;510;498;2023
47;Valladolid;083;Matilla de los Caños;103;56;47;2023
47;Valladolid;084;Mayorga;1418;701;717;2023
47;Valladolid;086;Medina de Rioseco;4483;2202;2281;2023
47;Valladolid;085;Medina del Campo;20090;9817;10273;2023
47;Valladolid;087;Megeces;422;224;198;2023
47;Valladolid;088;Melgar de Abajo;113;59;54;2023
47;Valladolid;089;Melgar de Arriba;168;96;72;2023
47;Valladolid;090;Mojados;3331;1722;1609;2023
47;Valladolid;091;Monasterio de Vega;81;45;36;2023
47;Valladolid;092;Montealegre de Campos;101;61;40;2023
47;Valladolid;093;Montemayor de Pililla;848;454;394;2023
47;Valladolid;094;Moral de la Reina;139;75;64;2023
47;Valladolid;095;Moraleja de las Panaderas;40;23;17;2023
47;Valladolid;096;Morales de Campos;131;74;57;2023
47;Valladolid;097;Mota del Marqués;330;181;149;2023
47;Valladolid;098;Mucientes;667;340;327;2023
47;Valladolid;099;Mudarra, La;163;85;78;2023
47;Valladolid;100;Muriel;116;59;57;2023
47;Valladolid;101;Nava del Rey;1925;978;947;2023
47;Valladolid;102;Nueva Villa de las Torres;282;162;120;2023
47;Valladolid;103;Olivares de Duero;321;181;140;2023
47;Valladolid;104;Olmedo;3563;1780;1783;2023
47;Valladolid;105;Olmos de Esgueva;193;107;86;2023
47;Valladolid;106;Olmos de Peñafiel;41;23;18;2023
47;Valladolid;109;Palazuelo de Vedija;160;84;76;2023
47;Valladolid;110;Parrilla, La;490;245;245;2023
47;Valladolid;111;Pedraja de Portillo, La;1175;603;572;2023
47;Valladolid;112;Pedrajas de San Esteban;3382;1720;1662;2023
47;Valladolid;113;Pedrosa del Rey;150;84;66;2023
47;Valladolid;114;Peñafiel;5172;2638;2534;2023
47;Valladolid;115;Peñaflor de Hornija;337;182;155;2023
47;Valladolid;116;Pesquera de Duero;424;226;198;2023
47;Valladolid;117;Piña de Esgueva;313;163;150;2023
47;Valladolid;118;Piñel de Abajo;157;90;67;2023
47;Valladolid;119;Piñel de Arriba;89;48;41;2023
47;Valladolid;121;Pollos;590;335;255;2023
47;Valladolid;122;Portillo;2371;1218;1153;2023
47;Valladolid;123;Pozal de Gallinas;530;281;249;2023
47;Valladolid;124;Pozaldez;494;266;228;2023
47;Valladolid;125;Pozuelo de la Orden;54;32;22;2023
47;Valladolid;126;Puras;43;23;20;2023
47;Valladolid;127;Quintanilla de Arriba;160;90;70;2023
47;Valladolid;129;Quintanilla de Onésimo;1004;531;473;2023
47;Valladolid;130;Quintanilla de Trigueros;99;51;48;2023
47;Valladolid;128;Quintanilla del Molar;49;24;25;2023
47;Valladolid;131;Rábano;171;87;84;2023
47;Valladolid;132;Ramiro;48;27;21;2023
47;Valladolid;133;Renedo de Esgueva;3936;1993;1943;2023
47;Valladolid;134;Roales de Campos;165;92;73;2023
47;Valladolid;135;Robladillo;90;52;38;2023
47;Valladolid;137;Roturas;26;16;10;2023
47;Valladolid;138;Rubí de Bracamonte;221;126;95;2023
47;Valladolid;139;Rueda;1118;574;544;2023
47;Valladolid;140;Saelices de Mayorga;112;71;41;2023
47;Valladolid;141;Salvador de Zapardiel;106;60;46;2023
47;Valladolid;142;San Cebrián de Mazote;114;66;48;2023
47;Valladolid;143;San Llorente;100;59;41;2023
47;Valladolid;144;San Martín de Valvení;89;46;43;2023
47;Valladolid;145;San Miguel del Arroyo;650;348;302;2023
47;Valladolid;146;San Miguel del Pino;353;181;172;2023
47;Valladolid;147;San Pablo de la Moraleja;108;64;44;2023
47;Valladolid;148;San Pedro de Latarce;437;240;197;2023
47;Valladolid;149;San Pelayo;51;26;25;2023
47;Valladolid;150;San Román de Hornija;289;138;151;2023
47;Valladolid;151;San Salvador;23;14;9;2023
47;Valladolid;156;San Vicente del Palacio;164;87;77;2023
47;Valladolid;152;Santa Eufemia del Arroyo;72;41;31;2023
47;Valladolid;153;Santervás de Campos;111;60;51;2023
47;Valladolid;154;Santibáñez de Valcorba;184;108;76;2023
47;Valladolid;155;Santovenia de Pisuerga;4636;2353;2283;2023
47;Valladolid;157;Sardón de Duero;608;322;286;2023
47;Valladolid;158;Seca, La;1038;544;494;2023
47;Valladolid;159;Serrada;1128;587;541;2023
47;Valladolid;160;Siete Iglesias de Trabancos;434;227;207;2023
47;Valladolid;161;Simancas;5493;2785;2708;2023
47;Valladolid;162;Tamariz de Campos;86;48;38;2023
47;Valladolid;163;Tiedra;283;144;139;2023
47;Valladolid;164;Tordehumos;388;210;178;2023
47;Valladolid;165;Tordesillas;8681;4362;4319;2023
47;Valladolid;169;Torre de Esgueva;62;33;29;2023
47;Valladolid;170;Torre de Peñafiel;53;32;21;2023
47;Valladolid;166;Torrecilla de la Abadesa;253;118;135;2023
47;Valladolid;167;Torrecilla de la Orden;229;115;114;2023
47;Valladolid;168;Torrecilla de la Torre;24;16;8;2023
47;Valladolid;171;Torrelobatón;386;202;184;2023
47;Valladolid;172;Torrescárcela;164;88;76;2023
47;Valladolid;173;Traspinedo;1242;648;594;2023
47;Valladolid;174;Trigueros del Valle;322;172;150;2023
47;Valladolid;175;Tudela de Duero;8780;4452;4328;2023
47;Valladolid;176;Unión de Campos, La;207;102;105;2023
47;Valladolid;177;Urones de Castroponce;95;59;36;2023
47;Valladolid;178;Urueña;197;107;90;2023
47;Valladolid;179;Valbuena de Duero;402;229;173;2023
47;Valladolid;180;Valdearcos de la Vega;71;43;28;2023
47;Valladolid;181;Valdenebro de los Valles;191;108;83;2023
47;Valladolid;182;Valdestillas;1583;821;762;2023
47;Valladolid;183;Valdunquillo;126;62;64;2023
47;Valladolid;186;Valladolid;297459;139241;158218;2023
47;Valladolid;184;Valoria la Buena;704;384;320;2023
47;Valladolid;185;Valverde de Campos;103;58;45;2023
47;Valladolid;187;Vega de Ruiponce;80;47;33;2023
47;Valladolid;188;Vega de Valdetronco;91;51;40;2023
47;Valladolid;189;Velascálvaro;163;85;78;2023
47;Valladolid;190;Velilla;112;56;56;2023
47;Valladolid;191;Velliza;126;82;44;2023
47;Valladolid;192;Ventosa de la Cuesta;108;58;50;2023
47;Valladolid;193;Viana de Cega;2255;1170;1085;2023
47;Valladolid;195;Villabáñez;504;271;233;2023
47;Valladolid;196;Villabaruz de Campos;27;13;14;2023
47;Valladolid;197;Villabrágima;1034;549;485;2023
47;Valladolid;198;Villacarralón;64;42;22;2023
47;Valladolid;199;Villacid de Campos;79;46;33;2023
47;Valladolid;200;Villaco;74;49;25;2023
47;Valladolid;203;Villafrades de Campos;63;29;34;2023
47;Valladolid;204;Villafranca de Duero;231;130;101;2023
47;Valladolid;205;Villafrechós;453;245;208;2023
47;Valladolid;206;Villafuerte;87;51;36;2023
47;Valladolid;207;Villagarcía de Campos;283;166;117;2023
47;Valladolid;208;Villagómez la Nueva;54;30;24;2023
47;Valladolid;209;Villalán de Campos;31;20;11;2023
47;Valladolid;210;Villalar de los Comuneros;484;232;252;2023
47;Valladolid;211;Villalba de la Loma;61;31;30;2023
47;Valladolid;212;Villalba de los Alcores;388;216;172;2023
47;Valladolid;213;Villalbarba;106;53;53;2023
47;Valladolid;214;Villalón de Campos;1526;751;775;2023
47;Valladolid;215;Villamuriel de Campos;55;28;27;2023
47;Valladolid;216;Villán de Tordesillas;125;70;55;2023
47;Valladolid;217;Villanubla;2911;1518;1393;2023
47;Valladolid;218;Villanueva de Duero;1235;653;582;2023
47;Valladolid;219;Villanueva de la Condesa;58;26;32;2023
47;Valladolid;220;Villanueva de los Caballeros;163;91;72;2023
47;Valladolid;221;Villanueva de los Infantes;104;63;41;2023
47;Valladolid;222;Villanueva de San Mancio;103;56;47;2023
47;Valladolid;223;Villardefrades;140;82;58;2023
47;Valladolid;224;Villarmentero de Esgueva;99;53;46;2023
47;Valladolid;225;Villasexmir;71;42;29;2023
47;Valladolid;226;Villavaquerín;152;85;67;2023
47;Valladolid;227;Villavellid;55;31;24;2023
47;Valladolid;228;Villaverde de Medina;546;289;257;2023
47;Valladolid;229;Villavicencio de los Caballeros;234;122;112;2023
47;Valladolid;194;Viloria;353;186;167;2023
47;Valladolid;230;Wamba;303;163;140;2023
47;Valladolid;231;Zaratán;6342;3213;3129;2023
47;Valladolid;232;Zarza, La;116;67;49;2023
49;Zamora;002;Abezames;64;35;29;2023
49;Zamora;003;Alcañices;1048;551;497;2023
49;Zamora;004;Alcubilla de Nogales;107;59;48;2023
49;Zamora;005;Alfaraz de Sayago;123;72;51;2023
49;Zamora;006;Algodre;142;75;67;2023
49;Zamora;007;Almaraz de Duero;393;207;186;2023
49;Zamora;008;Almeida de Sayago;410;225;185;2023
49;Zamora;009;Andavías;430;218;212;2023
49;Zamora;010;Arcenillas;448;227;221;2023
49;Zamora;011;Arcos de la Polvorosa;214;120;94;2023
49;Zamora;012;Argañín;74;38;36;2023
49;Zamora;013;Argujillo;214;111;103;2023
49;Zamora;014;Arquillinos;116;62;54;2023
49;Zamora;015;Arrabalde;213;111;102;2023
49;Zamora;016;Aspariegos;228;99;129;2023
49;Zamora;017;Asturianos;263;134;129;2023
49;Zamora;018;Ayoó de Vidriales;278;143;135;2023
49;Zamora;019;Barcial del Barco;243;125;118;2023
49;Zamora;020;Belver de los Montes;253;142;111;2023
49;Zamora;021;Benavente;17261;8323;8938;2023
49;Zamora;022;Benegiles;276;150;126;2023
49;Zamora;023;Bermillo de Sayago;998;530;468;2023
49;Zamora;024;Bóveda de Toro, La;664;338;326;2023
49;Zamora;025;Bretó;178;105;73;2023
49;Zamora;026;Bretocino;209;109;100;2023
49;Zamora;027;Brime de Sog;121;57;64;2023
49;Zamora;028;Brime de Urz;103;62;41;2023
49;Zamora;029;Burganes de Valverde;617;324;293;2023
49;Zamora;030;Bustillo del Oro;84;48;36;2023
49;Zamora;031;Cabañas de Sayago;139;75;64;2023
49;Zamora;032;Calzadilla de Tera;292;147;145;2023
49;Zamora;033;Camarzana de Tera;736;373;363;2023
49;Zamora;034;Cañizal;423;225;198;2023
49;Zamora;035;Cañizo;204;115;89;2023
49;Zamora;036;Carbajales de Alba;487;250;237;2023
49;Zamora;037;Carbellino;185;103;82;2023
49;Zamora;038;Casaseca de Campeán;97;56;41;2023
49;Zamora;039;Casaseca de las Chanas;361;193;168;2023
49;Zamora;040;Castrillo de la Guareña;121;65;56;2023
49;Zamora;041;Castrogonzalo;431;235;196;2023
49;Zamora;042;Castronuevo;206;107;99;2023
49;Zamora;043;Castroverde de Campos;259;141;118;2023
49;Zamora;044;Cazurra;71;38;33;2023
49;Zamora;046;Cerecinos de Campos;244;134;110;2023
49;Zamora;047;Cerecinos del Carrizal;108;65;43;2023
49;Zamora;048;Cernadilla;113;58;55;2023
49;Zamora;050;Cobreros;536;297;239;2023
49;Zamora;052;Coomonte;175;95;80;2023
49;Zamora;053;Coreses;1036;535;501;2023
49;Zamora;054;Corrales del Vino;928;457;471;2023
49;Zamora;055;Cotanes del Monte;82;44;38;2023
49;Zamora;056;Cubillos;303;151;152;2023
49;Zamora;057;Cubo de Benavente;119;64;55;2023
49;Zamora;058;Cubo de Tierra del Vino, El;315;172;143;2023
49;Zamora;059;Cuelgamures;79;47;32;2023
49;Zamora;061;Entrala;138;77;61;2023
49;Zamora;062;Espadañedo;111;63;48;2023
49;Zamora;063;Faramontanos de Tábara;334;176;158;2023
49;Zamora;064;Fariza;494;258;236;2023
49;Zamora;065;Fermoselle;1142;582;560;2023
49;Zamora;066;Ferreras de Abajo;464;223;241;2023
49;Zamora;067;Ferreras de Arriba;356;197;159;2023
49;Zamora;068;Ferreruela;431;241;190;2023
49;Zamora;069;Figueruela de Arriba;326;161;165;2023
49;Zamora;071;Fonfría;783;409;374;2023
49;Zamora;075;Fresno de la Polvorosa;116;61;55;2023
49;Zamora;076;Fresno de la Ribera;342;176;166;2023
49;Zamora;077;Fresno de Sayago;151;75;76;2023
49;Zamora;078;Friera de Valverde;130;70;60;2023
49;Zamora;079;Fuente Encalada;93;51;42;2023
49;Zamora;080;Fuentelapeña;639;339;300;2023
49;Zamora;082;Fuentes de Ropel;380;202;178;2023
49;Zamora;081;Fuentesaúco;1588;806;782;2023
49;Zamora;083;Fuentesecas;48;27;21;2023
49;Zamora;084;Fuentespreadas;290;156;134;2023
49;Zamora;085;Galende;996;504;492;2023
49;Zamora;086;Gallegos del Pan;112;64;48;2023
49;Zamora;087;Gallegos del Río;473;271;202;2023
49;Zamora;088;Gamones;96;53;43;2023
49;Zamora;090;Gema;195;101;94;2023
49;Zamora;091;Granja de Moreruela;246;129;117;2023
49;Zamora;092;Granucillo;112;62;50;2023
49;Zamora;093;Guarrate;315;162;153;2023
49;Zamora;094;Hermisende;233;124;109;2023
49;Zamora;095;Hiniesta, La;306;164;142;2023
49;Zamora;096;Jambrina;146;79;67;2023
49;Zamora;097;Justel;81;55;26;2023
49;Zamora;098;Losacino;195;108;87;2023
49;Zamora;099;Losacio;96;54;42;2023
49;Zamora;100;Lubián;306;159;147;2023
49;Zamora;101;Luelmo;147;81;66;2023
49;Zamora;102;Maderal, El;175;94;81;2023
49;Zamora;103;Madridanos;456;240;216;2023
49;Zamora;104;Mahide;320;181;139;2023
49;Zamora;105;Maire de Castroponce;140;76;64;2023
49;Zamora;107;Malva;108;50;58;2023
49;Zamora;108;Manganeses de la Lampreana;450;236;214;2023
49;Zamora;109;Manganeses de la Polvorosa;628;305;323;2023
49;Zamora;110;Manzanal de Arriba;356;192;164;2023
49;Zamora;112;Manzanal de los Infantes;136;73;63;2023
49;Zamora;111;Manzanal del Barco;127;65;62;2023
49;Zamora;113;Matilla de Arzón;158;91;67;2023
49;Zamora;114;Matilla la Seca;35;19;16;2023
49;Zamora;115;Mayalde;163;93;70;2023
49;Zamora;116;Melgar de Tera;352;184;168;2023
49;Zamora;117;Micereces de Tera;425;217;208;2023
49;Zamora;118;Milles de la Polvorosa;198;111;87;2023
49;Zamora;119;Molacillos;240;130;110;2023
49;Zamora;120;Molezuelas de la Carballeda;47;26;21;2023
49;Zamora;121;Mombuey;396;209;187;2023
49;Zamora;122;Monfarracinos;980;506;474;2023
49;Zamora;123;Montamarta;551;300;251;2023
49;Zamora;124;Moral de Sayago;263;155;108;2023
49;Zamora;126;Moraleja de Sayago;297;153;144;2023
49;Zamora;125;Moraleja del Vino;1775;900;875;2023
49;Zamora;128;Morales de Rey;525;260;265;2023
49;Zamora;129;Morales de Toro;917;469;448;2023
49;Zamora;130;Morales de Valverde;155;80;75;2023
49;Zamora;127;Morales del Vino;3079;1593;1486;2023
49;Zamora;131;Moralina;220;116;104;2023
49;Zamora;132;Moreruela de los Infanzones;321;160;161;2023
49;Zamora;133;Moreruela de Tábara;287;155;132;2023
49;Zamora;134;Muelas de los Caballeros;202;118;84;2023
49;Zamora;135;Muelas del Pan;590;318;272;2023
49;Zamora;136;Muga de Sayago;322;158;164;2023
49;Zamora;137;Navianos de Valverde;166;95;71;2023
49;Zamora;138;Olmillos de Castro;197;107;90;2023
49;Zamora;139;Otero de Bodas;160;81;79;2023
49;Zamora;141;Pajares de la Lampreana;297;152;145;2023
49;Zamora;143;Palacios de Sanabria;239;122;117;2023
49;Zamora;142;Palacios del Pan;239;124;115;2023
49;Zamora;145;Pedralba de la Pradería;204;114;90;2023
49;Zamora;146;Pego, El;282;145;137;2023
49;Zamora;147;Peleagonzalo;300;150;150;2023
49;Zamora;148;Peleas de Abajo;269;124;145;2023
49;Zamora;149;Peñausende;373;194;179;2023
49;Zamora;150;Peque;124;55;69;2023
49;Zamora;151;Perdigón, El;669;356;313;2023
49;Zamora;152;Pereruela;506;280;226;2023
49;Zamora;153;Perilla de Castro;159;91;68;2023
49;Zamora;154;Pías;99;56;43;2023
49;Zamora;155;Piedrahita de Castro;110;60;50;2023
49;Zamora;156;Pinilla de Toro;196;102;94;2023
49;Zamora;157;Pino del Oro;178;88;90;2023
49;Zamora;158;Piñero, El;225;113;112;2023
49;Zamora;160;Pobladura de Valderaduey;37;22;15;2023
49;Zamora;159;Pobladura del Valle;277;145;132;2023
49;Zamora;162;Porto;171;96;75;2023
49;Zamora;163;Pozoantiguo;202;104;98;2023
49;Zamora;164;Pozuelo de Tábara;155;87;68;2023
49;Zamora;165;Prado;53;31;22;2023
49;Zamora;166;Puebla de Sanabria;1376;667;709;2023
49;Zamora;167;Pueblica de Valverde;181;99;82;2023
49;Zamora;170;Quintanilla de Urz;103;50;53;2023
49;Zamora;168;Quintanilla del Monte;100;55;45;2023
49;Zamora;169;Quintanilla del Olmo;45;25;20;2023
49;Zamora;171;Quiruelas de Vidriales;629;332;297;2023
49;Zamora;172;Rabanales;494;265;229;2023
49;Zamora;173;Rábano de Aliste;320;164;156;2023
49;Zamora;174;Requejo;118;67;51;2023
49;Zamora;175;Revellinos;248;132;116;2023
49;Zamora;176;Riofrío de Aliste;618;344;274;2023
49;Zamora;177;Rionegro del Puente;233;126;107;2023
49;Zamora;178;Roales;1010;530;480;2023
49;Zamora;179;Robleda-Cervantes;415;220;195;2023
49;Zamora;180;Roelos de Sayago;149;74;75;2023
49;Zamora;181;Rosinos de la Requejada;316;170;146;2023
49;Zamora;183;Salce;86;38;48;2023
49;Zamora;184;Samir de los Caños;165;92;73;2023
49;Zamora;185;San Agustín del Pozo;172;87;85;2023
49;Zamora;186;San Cebrián de Castro;240;122;118;2023
49;Zamora;187;San Cristóbal de Entreviñas;1344;703;641;2023
49;Zamora;188;San Esteban del Molar;100;57;43;2023
49;Zamora;189;San Justo;206;112;94;2023
49;Zamora;190;San Martín de Valderaduey;48;24;24;2023
49;Zamora;191;San Miguel de la Ribera;260;134;126;2023
49;Zamora;192;San Miguel del Valle;117;61;56;2023
49;Zamora;193;San Pedro de Ceque;429;229;200;2023
49;Zamora;194;San Pedro de la Nave-Almendra;322;168;154;2023
49;Zamora;208;San Vicente de la Cabeza;322;171;151;2023
49;Zamora;209;San Vitero;447;250;197;2023
49;Zamora;197;Santa Clara de Avedillo;169;82;87;2023
49;Zamora;199;Santa Colomba de las Monjas;238;118;120;2023
49;Zamora;200;Santa Cristina de la Polvorosa;1039;534;505;2023
49;Zamora;201;Santa Croya de Tera;268;135;133;2023
49;Zamora;202;Santa Eufemia del Barco;178;104;74;2023
49;Zamora;203;Santa María de la Vega;293;153;140;2023
49;Zamora;204;Santa María de Valverde;52;24;28;2023
49;Zamora;205;Santibáñez de Tera;347;178;169;2023
49;Zamora;206;Santibáñez de Vidriales;853;435;418;2023
49;Zamora;207;Santovenia;243;130;113;2023
49;Zamora;210;Sanzoles;471;246;225;2023
49;Zamora;214;Tábara;759;369;390;2023
49;Zamora;216;Tapioles;133;79;54;2023
49;Zamora;219;Toro;8349;4081;4268;2023
49;Zamora;220;Torre del Valle, La;134;73;61;2023
49;Zamora;221;Torregamones;230;119;111;2023
49;Zamora;222;Torres del Carrizal;415;216;199;2023
49;Zamora;223;Trabazos;859;459;400;2023
49;Zamora;224;Trefacio;171;96;75;2023
49;Zamora;225;Uña de Quintana;127;71;56;2023
49;Zamora;226;Vadillo de la Guareña;254;142;112;2023
49;Zamora;227;Valcabado;406;210;196;2023
49;Zamora;228;Valdefinjas;58;37;21;2023
49;Zamora;229;Valdescorriel;127;67;60;2023
49;Zamora;230;Vallesa de la Guareña;72;40;32;2023
49;Zamora;231;Vega de Tera;309;159;150;2023
49;Zamora;232;Vega de Villalobos;89;40;49;2023
49;Zamora;233;Vegalatrave;77;42;35;2023
49;Zamora;234;Venialbo;427;227;200;2023
49;Zamora;235;Vezdemarbán;428;226;202;2023
49;Zamora;236;Vidayanes;82;40;42;2023
49;Zamora;237;Videmala;145;75;70;2023
49;Zamora;238;Villabrázaro;260;141;119;2023
49;Zamora;239;Villabuena del Puente;603;309;294;2023
49;Zamora;240;Villadepera;180;101;79;2023
49;Zamora;241;Villaescusa;236;127;109;2023
49;Zamora;242;Villafáfila;449;231;218;2023
49;Zamora;243;Villaferrueña;108;54;54;2023
49;Zamora;244;Villageriz;64;35;29;2023
49;Zamora;245;Villalazán;250;125;125;2023
49;Zamora;246;Villalba de la Lampreana;215;121;94;2023
49;Zamora;247;Villalcampo;393;200;193;2023
49;Zamora;248;Villalobos;207;105;102;2023
49;Zamora;249;Villalonso;72;35;37;2023
49;Zamora;250;Villalpando;1417;685;732;2023
49;Zamora;251;Villalube;153;82;71;2023
49;Zamora;252;Villamayor de Campos;336;177;159;2023
49;Zamora;255;Villamor de los Escuderos;372;198;174;2023
49;Zamora;256;Villanázar;265;144;121;2023
49;Zamora;257;Villanueva de Azoague;368;192;176;2023
49;Zamora;258;Villanueva de Campeán;128;68;60;2023
49;Zamora;259;Villanueva de las Peras;86;42;44;2023
49;Zamora;260;Villanueva del Campo;778;383;395;2023
49;Zamora;263;Villar de Fallaves;48;27;21;2023
49;Zamora;264;Villar del Buey;518;272;246;2023
49;Zamora;261;Villaralbo;1798;908;890;2023
49;Zamora;262;Villardeciervos;388;194;194;2023
49;Zamora;265;Villardiegua de la Ribera;115;58;57;2023
49;Zamora;266;Villárdiga;67;39;28;2023
49;Zamora;267;Villardondiego;138;82;56;2023
49;Zamora;268;Villarrín de Campos;397;210;187;2023
49;Zamora;269;Villaseco del Pan;215;101;114;2023
49;Zamora;270;Villavendimio;156;98;58;2023
49;Zamora;272;Villaveza de Valverde;68;35;33;2023
49;Zamora;271;Villaveza del Agua;172;92;80;2023
49;Zamora;273;Viñas;158;86;72;2023
49;Zamora;275;Zamora;59259;27397;31862;2023
50;Zaragoza;001;Abanto;86;55;31;2023
50;Zaragoza;002;Acered;139;81;58;2023
50;Zaragoza;003;Agón;134;76;58;2023
50;Zaragoza;004;Aguarón;580;314;266;2023
50;Zaragoza;005;Aguilón;268;148;120;2023
50;Zaragoza;006;Ainzón;1055;554;501;2023
50;Zaragoza;007;Aladrén;64;41;23;2023
50;Zaragoza;008;Alagón;7257;3634;3623;2023
50;Zaragoza;009;Alarba;94;52;42;2023
50;Zaragoza;010;Alberite de San Juan;82;46;36;2023
50;Zaragoza;011;Albeta;141;70;71;2023
50;Zaragoza;012;Alborge;105;58;47;2023
50;Zaragoza;013;Alcalá de Ebro;240;113;127;2023
50;Zaragoza;014;Alcalá de Moncayo;151;85;66;2023
50;Zaragoza;015;Alconchel de Ariza;76;45;31;2023
50;Zaragoza;016;Aldehuela de Liestos;51;36;15;2023
50;Zaragoza;017;Alfajarín;2439;1238;1201;2023
50;Zaragoza;018;Alfamén;1472;763;709;2023
50;Zaragoza;019;Alforque;65;38;27;2023
50;Zaragoza;020;Alhama de Aragón;925;486;439;2023
50;Zaragoza;021;Almochuel;20;11;9;2023
50;Zaragoza;022;Almolda, La;548;270;278;2023
50;Zaragoza;023;Almonacid de la Cuba;227;115;112;2023
50;Zaragoza;024;Almonacid de la Sierra;775;445;330;2023
50;Zaragoza;025;Almunia de Doña Godina, La;7914;4113;3801;2023
50;Zaragoza;026;Alpartir;570;298;272;2023
50;Zaragoza;027;Ambel;248;124;124;2023
50;Zaragoza;028;Anento;111;81;30;2023
50;Zaragoza;029;Aniñón;676;347;329;2023
50;Zaragoza;030;Añón de Moncayo;214;122;92;2023
50;Zaragoza;031;Aranda de Moncayo;129;85;44;2023
50;Zaragoza;032;Arándiga;266;148;118;2023
50;Zaragoza;033;Ardisa;76;47;29;2023
50;Zaragoza;034;Ariza;1059;537;522;2023
50;Zaragoza;035;Artieda;80;45;35;2023
50;Zaragoza;036;Asín;101;55;46;2023
50;Zaragoza;037;Atea;137;81;56;2023
50;Zaragoza;038;Ateca;1697;884;813;2023
50;Zaragoza;039;Azuara;527;292;235;2023
50;Zaragoza;040;Badules;75;41;34;2023
50;Zaragoza;041;Bagüés;18;8;10;2023
50;Zaragoza;042;Balconchán;17;5;12;2023
50;Zaragoza;043;Bárboles;289;162;127;2023
50;Zaragoza;044;Bardallur;232;116;116;2023
50;Zaragoza;045;Belchite;1530;773;757;2023
50;Zaragoza;046;Belmonte de Gracián;178;99;79;2023
50;Zaragoza;047;Berdejo;37;26;11;2023
50;Zaragoza;048;Berrueco;33;20;13;2023
50;Zaragoza;901;Biel;167;103;64;2023
50;Zaragoza;050;Bijuesca;95;64;31;2023
50;Zaragoza;051;Biota;855;428;427;2023
50;Zaragoza;052;Bisimbre;84;44;40;2023
50;Zaragoza;053;Boquiñeni;780;390;390;2023
50;Zaragoza;054;Bordalba;49;30;19;2023
50;Zaragoza;055;Borja;5076;2579;2497;2023
50;Zaragoza;056;Botorrita;574;310;264;2023
50;Zaragoza;057;Brea de Aragón;1522;771;751;2023
50;Zaragoza;058;Bubierca;59;29;30;2023
50;Zaragoza;059;Bujaraloz;967;497;470;2023
50;Zaragoza;060;Bulbuente;242;131;111;2023
50;Zaragoza;061;Bureta;212;112;100;2023
50;Zaragoza;062;Burgo de Ebro, El;2660;1342;1318;2023
50;Zaragoza;063;Buste, El;64;36;28;2023
50;Zaragoza;064;Cabañas de Ebro;487;255;232;2023
50;Zaragoza;065;Cabolafuente;46;27;19;2023
50;Zaragoza;066;Cadrete;4486;2350;2136;2023
50;Zaragoza;067;Calatayud;19677;9659;10018;2023
50;Zaragoza;068;Calatorao;2889;1500;1389;2023
50;Zaragoza;069;Calcena;75;44;31;2023
50;Zaragoza;070;Calmarza;58;33;25;2023
50;Zaragoza;071;Campillo de Aragón;119;70;49;2023
50;Zaragoza;072;Carenas;186;100;86;2023
50;Zaragoza;073;Cariñena;3397;1716;1681;2023
50;Zaragoza;074;Caspe;10336;5479;4857;2023
50;Zaragoza;075;Castejón de Alarba;89;58;31;2023
50;Zaragoza;076;Castejón de las Armas;86;44;42;2023
50;Zaragoza;077;Castejón de Valdejasa;202;102;100;2023
50;Zaragoza;078;Castiliscar;217;113;104;2023
50;Zaragoza;079;Cervera de la Cañada;272;154;118;2023
50;Zaragoza;080;Cerveruela;37;25;12;2023
50;Zaragoza;081;Cetina;564;288;276;2023
50;Zaragoza;092;Chiprana;531;275;256;2023
50;Zaragoza;093;Chodes;94;50;44;2023
50;Zaragoza;082;Cimballa;87;43;44;2023
50;Zaragoza;083;Cinco Olivas;104;52;52;2023
50;Zaragoza;084;Clarés de Ribota;74;42;32;2023
50;Zaragoza;085;Codo;213;117;96;2023
50;Zaragoza;086;Codos;228;149;79;2023
50;Zaragoza;087;Contamina;38;22;16;2023
50;Zaragoza;088;Cosuenda;335;171;164;2023
50;Zaragoza;089;Cuarte de Huerva;14701;7460;7241;2023
50;Zaragoza;090;Cubel;148;69;79;2023
50;Zaragoza;091;Cuerlas, Las;41;22;19;2023
50;Zaragoza;094;Daroca;1957;963;994;2023
50;Zaragoza;095;Ejea de los Caballeros;17135;8797;8338;2023
50;Zaragoza;096;Embid de Ariza;31;18;13;2023
50;Zaragoza;098;Encinacorba;183;97;86;2023
50;Zaragoza;099;Épila;4494;2320;2174;2023
50;Zaragoza;100;Erla;363;184;179;2023
50;Zaragoza;101;Escatrón;1174;595;579;2023
50;Zaragoza;102;Fabara;1065;585;480;2023
50;Zaragoza;104;Farlete;408;201;207;2023
50;Zaragoza;105;Fayón;422;241;181;2023
50;Zaragoza;106;Fayos, Los;128;70;58;2023
50;Zaragoza;107;Figueruelas;1250;618;632;2023
50;Zaragoza;108;Fombuena;57;32;25;2023
50;Zaragoza;109;Frago, El;126;79;47;2023
50;Zaragoza;110;Frasno, El;363;203;160;2023
50;Zaragoza;111;Fréscano;200;110;90;2023
50;Zaragoza;113;Fuendejalón;756;406;350;2023
50;Zaragoza;114;Fuendetodos;150;87;63;2023
50;Zaragoza;115;Fuentes de Ebro;4626;2403;2223;2023
50;Zaragoza;116;Fuentes de Jiloca;219;121;98;2023
50;Zaragoza;117;Gallocanta;123;68;55;2023
50;Zaragoza;118;Gallur;2576;1298;1278;2023
50;Zaragoza;119;Gelsa;996;524;472;2023
50;Zaragoza;120;Godojos;61;34;27;2023
50;Zaragoza;121;Gotor;307;163;144;2023
50;Zaragoza;122;Grisel;93;52;41;2023
50;Zaragoza;123;Grisén;646;331;315;2023
50;Zaragoza;124;Herrera de los Navarros;502;278;224;2023
50;Zaragoza;125;Ibdes;378;196;182;2023
50;Zaragoza;126;Illueca;2711;1381;1330;2023
50;Zaragoza;128;Isuerre;33;16;17;2023
50;Zaragoza;129;Jaraba;281;157;124;2023
50;Zaragoza;130;Jarque de Moncayo;399;209;190;2023
50;Zaragoza;131;Jaulín;291;155;136;2023
50;Zaragoza;132;Joyosa, La;1152;587;565;2023
50;Zaragoza;133;Lagata;111;62;49;2023
50;Zaragoza;134;Langa del Castillo;115;61;54;2023
50;Zaragoza;135;Layana;96;54;42;2023
50;Zaragoza;136;Lécera;616;318;298;2023
50;Zaragoza;138;Lechón;46;27;19;2023
50;Zaragoza;137;Leciñena;1103;563;540;2023
50;Zaragoza;139;Letux;337;183;154;2023
50;Zaragoza;140;Litago;196;115;81;2023
50;Zaragoza;141;Lituénigo;123;63;60;2023
50;Zaragoza;142;Lobera de Onsella;26;14;12;2023
50;Zaragoza;143;Longares;852;511;341;2023
50;Zaragoza;144;Longás;44;27;17;2023
50;Zaragoza;146;Lucena de Jalón;234;126;108;2023
50;Zaragoza;147;Luceni;990;500;490;2023
50;Zaragoza;148;Luesia;335;179;156;2023
50;Zaragoza;149;Luesma;39;22;17;2023
50;Zaragoza;150;Lumpiaque;848;446;402;2023
50;Zaragoza;151;Luna;680;361;319;2023
50;Zaragoza;152;Maella;2100;1149;951;2023
50;Zaragoza;153;Magallón;1110;574;536;2023
50;Zaragoza;154;Mainar;176;94;82;2023
50;Zaragoza;155;Malanquilla;79;53;26;2023
50;Zaragoza;156;Maleján;268;147;121;2023
50;Zaragoza;160;Mallén;2939;1520;1419;2023
50;Zaragoza;157;Malón;431;216;215;2023
50;Zaragoza;159;Maluenda;902;456;446;2023
50;Zaragoza;161;Manchones;99;54;45;2023
50;Zaragoza;162;Mara;163;77;86;2023
50;Zaragoza;163;María de Huerva;6335;3194;3141;2023
50;Zaragoza;902;Marracos;87;45;42;2023
50;Zaragoza;164;Mediana de Aragón;441;220;221;2023
50;Zaragoza;165;Mequinenza;2272;1144;1128;2023
50;Zaragoza;166;Mesones de Isuela;260;138;122;2023
50;Zaragoza;167;Mezalocha;224;120;104;2023
50;Zaragoza;168;Mianos;26;14;12;2023
50;Zaragoza;169;Miedes de Aragón;425;222;203;2023
50;Zaragoza;170;Monegrillo;384;211;173;2023
50;Zaragoza;171;Moneva;124;72;52;2023
50;Zaragoza;172;Monreal de Ariza;175;107;68;2023
50;Zaragoza;173;Monterde;160;105;55;2023
50;Zaragoza;174;Montón;87;56;31;2023
50;Zaragoza;175;Morata de Jalón;1058;528;530;2023
50;Zaragoza;176;Morata de Jiloca;251;143;108;2023
50;Zaragoza;177;Morés;304;162;142;2023
50;Zaragoza;178;Moros;285;146;139;2023
50;Zaragoza;179;Moyuela;241;138;103;2023
50;Zaragoza;180;Mozota;129;68;61;2023
50;Zaragoza;181;Muel;1450;756;694;2023
50;Zaragoza;182;Muela, La;6416;3333;3083;2023
50;Zaragoza;183;Munébrega;369;195;174;2023
50;Zaragoza;184;Murero;106;58;48;2023
50;Zaragoza;185;Murillo de Gállego;203;119;84;2023
50;Zaragoza;186;Navardún;38;23;15;2023
50;Zaragoza;187;Nigüella;60;35;25;2023
50;Zaragoza;188;Nombrevilla;37;21;16;2023
50;Zaragoza;189;Nonaspe;1025;559;466;2023
50;Zaragoza;190;Novallas;846;448;398;2023
50;Zaragoza;191;Novillas;509;256;253;2023
50;Zaragoza;192;Nuévalos;317;172;145;2023
50;Zaragoza;193;Nuez de Ebro;912;454;458;2023
50;Zaragoza;194;Olvés;102;56;46;2023
50;Zaragoza;195;Orcajo;59;37;22;2023
50;Zaragoza;196;Orera;103;57;46;2023
50;Zaragoza;197;Orés;91;55;36;2023
50;Zaragoza;198;Oseja;47;32;15;2023
50;Zaragoza;199;Osera de Ebro;400;203;197;2023
50;Zaragoza;200;Paniza;594;324;270;2023
50;Zaragoza;201;Paracuellos de Jiloca;584;309;275;2023
50;Zaragoza;202;Paracuellos de la Ribera;115;64;51;2023
50;Zaragoza;203;Pastriz;1316;644;672;2023
50;Zaragoza;204;Pedrola;3667;1899;1768;2023
50;Zaragoza;205;Pedrosas, Las;99;49;50;2023
50;Zaragoza;206;Perdiguera;552;300;252;2023
50;Zaragoza;207;Piedratajada;89;51;38;2023
50;Zaragoza;208;Pina de Ebro;2456;1253;1203;2023
50;Zaragoza;209;Pinseque;4342;2224;2118;2023
50;Zaragoza;210;Pintanos, Los;40;27;13;2023
50;Zaragoza;211;Plasencia de Jalón;353;194;159;2023
50;Zaragoza;212;Pleitas;34;13;21;2023
50;Zaragoza;213;Plenas;105;58;47;2023
50;Zaragoza;214;Pomer;26;19;7;2023
50;Zaragoza;215;Pozuel de Ariza;23;12;11;2023
50;Zaragoza;216;Pozuelo de Aragón;257;138;119;2023
50;Zaragoza;217;Pradilla de Ebro;558;308;250;2023
50;Zaragoza;218;Puebla de Albortón;131;75;56;2023
50;Zaragoza;219;Puebla de Alfindén, La;6414;3274;3140;2023
50;Zaragoza;220;Puendeluna;44;28;16;2023
50;Zaragoza;221;Purujosa;30;19;11;2023
50;Zaragoza;222;Quinto;1869;953;916;2023
50;Zaragoza;223;Remolinos;1010;508;502;2023
50;Zaragoza;224;Retascón;71;38;33;2023
50;Zaragoza;225;Ricla;2987;1619;1368;2023
50;Zaragoza;227;Romanos;149;79;70;2023
50;Zaragoza;228;Rueda de Jalón;323;171;152;2023
50;Zaragoza;229;Ruesca;70;29;41;2023
50;Zaragoza;241;Sabiñán;673;355;318;2023
50;Zaragoza;230;Sádaba;1263;637;626;2023
50;Zaragoza;231;Salillas de Jalón;351;175;176;2023
50;Zaragoza;232;Salvatierra de Esca;204;101;103;2023
50;Zaragoza;233;Samper del Salz;92;49;43;2023
50;Zaragoza;234;San Martín de la Virgen de Moncayo;271;155;116;2023
50;Zaragoza;235;San Mateo de Gállego;3441;1752;1689;2023
50;Zaragoza;236;Santa Cruz de Grío;97;65;32;2023
50;Zaragoza;237;Santa Cruz de Moncayo;126;68;58;2023
50;Zaragoza;238;Santa Eulalia de Gállego;94;53;41;2023
50;Zaragoza;239;Santed;67;42;25;2023
50;Zaragoza;240;Sástago;1088;545;543;2023
50;Zaragoza;242;Sediles;108;62;46;2023
50;Zaragoza;243;Sestrica;341;196;145;2023
50;Zaragoza;244;Sierra de Luna;271;138;133;2023
50;Zaragoza;245;Sigüés;70;39;31;2023
50;Zaragoza;246;Sisamón;44;28;16;2023
50;Zaragoza;247;Sobradiel;1116;533;583;2023
50;Zaragoza;248;Sos del Rey Católico;583;310;273;2023
50;Zaragoza;249;Tabuenca;315;193;122;2023
50;Zaragoza;250;Talamantes;84;41;43;2023
50;Zaragoza;251;Tarazona;10720;5319;5401;2023
50;Zaragoza;252;Tauste;6828;3426;3402;2023
50;Zaragoza;253;Terrer;550;301;249;2023
50;Zaragoza;254;Tierga;174;99;75;2023
50;Zaragoza;255;Tobed;201;108;93;2023
50;Zaragoza;256;Torralba de los Frailes;72;39;33;2023
50;Zaragoza;257;Torralba de Ribota;176;95;81;2023
50;Zaragoza;258;Torralbilla;43;27;16;2023
50;Zaragoza;259;Torrehermosa;73;36;37;2023
50;Zaragoza;260;Torrelapaja;32;21;11;2023
50;Zaragoza;261;Torrellas;237;126;111;2023
50;Zaragoza;262;Torres de Berrellén;1498;783;715;2023
50;Zaragoza;263;Torrijo de la Cañada;201;118;83;2023
50;Zaragoza;264;Tosos;163;96;67;2023
50;Zaragoza;265;Trasmoz;83;46;37;2023
50;Zaragoza;266;Trasobares;123;73;50;2023
50;Zaragoza;267;Uncastillo;625;299;326;2023
50;Zaragoza;268;Undués de Lerda;52;29;23;2023
50;Zaragoza;269;Urrea de Jalón;438;247;191;2023
50;Zaragoza;270;Urriés;49;23;26;2023
50;Zaragoza;271;Used;269;146;123;2023
50;Zaragoza;272;Utebo;18955;9378;9577;2023
50;Zaragoza;274;Val de San Martín;62;38;24;2023
50;Zaragoza;273;Valdehorna;32;19;13;2023
50;Zaragoza;275;Valmadrid;126;76;50;2023
50;Zaragoza;276;Valpalmas;136;67;69;2023
50;Zaragoza;277;Valtorres;72;36;36;2023
50;Zaragoza;278;Velilla de Ebro;202;106;96;2023
50;Zaragoza;279;Velilla de Jiloca;67;31;36;2023
50;Zaragoza;280;Vera de Moncayo;315;171;144;2023
50;Zaragoza;281;Vierlas;85;47;38;2023
50;Zaragoza;283;Villadoz;82;45;37;2023
50;Zaragoza;284;Villafeliche;146;87;59;2023
50;Zaragoza;285;Villafranca de Ebro;840;432;408;2023
50;Zaragoza;286;Villalba de Perejil;91;41;50;2023
50;Zaragoza;287;Villalengua;289;159;130;2023
50;Zaragoza;903;Villamayor de Gállego;2866;1455;1411;2023
50;Zaragoza;288;Villanueva de Gállego;4806;2401;2405;2023
50;Zaragoza;290;Villanueva de Huerva;385;203;182;2023
50;Zaragoza;289;Villanueva de Jiloca;69;34;35;2023
50;Zaragoza;291;Villar de los Navarros;148;82;66;2023
50;Zaragoza;292;Villarreal de Huerva;278;157;121;2023
50;Zaragoza;293;Villarroya de la Sierra;430;230;200;2023
50;Zaragoza;294;Villarroya del Campo;71;39;32;2023
50;Zaragoza;282;Vilueña, La;63;34;29;2023
50;Zaragoza;295;Vistabella;51;30;21;2023
50;Zaragoza;296;Zaida, La;439;224;215;2023
50;Zaragoza;297;Zaragoza;682513;326270;356243;2023
50;Zaragoza;298;Zuera;8677;4455;4222;2023
02;Albacete;001;Abengibre;782;386;396;2015
02;Albacete;002;Alatoz;610;340;270;2015
02;Albacete;003;Albacete;172121;84233;87888;2015
02;Albacete;004;Albatana;744;380;364;2015
02;Albacete;005;Alborea;754;394;360;2015
02;Albacete;006;Alcadozo;699;372;327;2015
02;Albacete;007;Alcalá del Júcar;1250;667;583;2015
02;Albacete;008;Alcaraz;1529;774;755;2015
02;Albacete;009;Almansa;24837;12359;12478;2015
02;Albacete;010;Alpera;2326;1196;1130;2015
02;Albacete;011;Ayna;717;385;332;2015
02;Albacete;012;Balazote;2378;1228;1150;2015
02;Albacete;014;Ballestero, El;442;226;216;2015
02;Albacete;013;Balsa de Ves;172;102;70;2015
02;Albacete;015;Barrax;1915;979;936;2015
02;Albacete;016;Bienservida;664;346;318;2015
02;Albacete;017;Bogarra;947;489;458;2015
02;Albacete;018;Bonete;1127;580;547;2015
02;Albacete;019;Bonillo, El;2915;1472;1443;2015
02;Albacete;020;Carcelén;546;294;252;2015
02;Albacete;021;Casas de Juan Núñez;1382;723;659;2015
02;Albacete;022;Casas de Lázaro;403;228;175;2015
02;Albacete;023;Casas de Ves;666;343;323;2015
02;Albacete;024;Casas-Ibáñez;4658;2407;2251;2015
02;Albacete;025;Caudete;10163;5167;4996;2015
02;Albacete;026;Cenizate;1174;602;572;2015
02;Albacete;029;Chinchilla de Monte-Aragón;4169;2165;2004;2015
02;Albacete;027;Corral-Rubio;358;198;160;2015
02;Albacete;028;Cotillas;141;75;66;2015
02;Albacete;030;Elche de la Sierra;3761;1891;1870;2015
02;Albacete;031;Férez;705;355;350;2015
02;Albacete;032;Fuensanta;327;180;147;2015
02;Albacete;033;Fuente-Álamo;2591;1366;1225;2015
02;Albacete;034;Fuentealbilla;1901;962;939;2015
02;Albacete;035;Gineta, La;2532;1294;1238;2015
02;Albacete;036;Golosalvo;114;62;52;2015
02;Albacete;037;Hellín;30592;15227;15365;2015
02;Albacete;038;Herrera, La;347;180;167;2015
02;Albacete;039;Higueruela;1249;649;600;2015
02;Albacete;040;Hoya-Gonzalo;706;369;337;2015
02;Albacete;041;Jorquera;400;213;187;2015
02;Albacete;042;Letur;987;480;507;2015
02;Albacete;043;Lezuza;1483;759;724;2015
02;Albacete;044;Liétor;1321;686;635;2015
02;Albacete;045;Madrigueras;4724;2424;2300;2015
02;Albacete;046;Mahora;1422;722;700;2015
02;Albacete;047;Masegoso;121;65;56;2015
02;Albacete;048;Minaya;1564;801;763;2015
02;Albacete;049;Molinicos;917;466;451;2015
02;Albacete;050;Montalvos;108;56;52;2015
02;Albacete;051;Montealegre del Castillo;2122;1075;1047;2015
02;Albacete;052;Motilleja;555;290;265;2015
02;Albacete;053;Munera;3643;1845;1798;2015
02;Albacete;054;Navas de Jorquera;524;267;257;2015
02;Albacete;055;Nerpio;1362;737;625;2015
02;Albacete;056;Ontur;2141;1064;1077;2015
02;Albacete;057;Ossa de Montiel;2510;1251;1259;2015
02;Albacete;058;Paterna del Madera;378;205;173;2015
02;Albacete;060;Peñas de San Pedro;1431;829;602;2015
02;Albacete;059;Peñascosa;355;187;168;2015
02;Albacete;061;Pétrola;737;382;355;2015
02;Albacete;062;Povedilla;471;250;221;2015
02;Albacete;901;Pozo Cañada;2811;1409;1402;2015
02;Albacete;063;Pozohondo;1717;896;821;2015
02;Albacete;064;Pozo-Lorente;415;210;205;2015
02;Albacete;065;Pozuelo;542;284;258;2015
02;Albacete;066;Recueja, La;275;141;134;2015
02;Albacete;067;Riópar;1448;738;710;2015
02;Albacete;068;Robledo;405;210;195;2015
02;Albacete;069;Roda, La;15868;8011;7857;2015
02;Albacete;070;Salobre;554;290;264;2015
02;Albacete;071;San Pedro;1316;668;648;2015
02;Albacete;072;Socovos;1832;942;890;2015
02;Albacete;073;Tarazona de la Mancha;6543;3317;3226;2015
02;Albacete;074;Tobarra;7973;4051;3922;2015
02;Albacete;075;Valdeganga;1991;1011;980;2015
02;Albacete;076;Vianos;376;192;184;2015
02;Albacete;077;Villa de Ves;59;33;26;2015
02;Albacete;078;Villalgordo del Júcar;1147;596;551;2015
02;Albacete;079;Villamalea;4106;2067;2039;2015
02;Albacete;080;Villapalacios;628;327;301;2015
02;Albacete;081;Villarrobledo;25989;12894;13095;2015
02;Albacete;082;Villatoya;115;68;47;2015
02;Albacete;083;Villavaliente;238;138;100;2015
02;Albacete;084;Villaverde de Guadalimar;373;200;173;2015
02;Albacete;085;Viveros;300;151;149;2015
02;Albacete;086;Yeste;2869;1471;1398;2015
03;Alicante/Alacant;001;Adsubia;632;324;308;2015
03;Alicante/Alacant;002;Agost;4707;2378;2329;2015
03;Alicante/Alacant;003;Agres;574;307;267;2015
03;Alicante/Alacant;004;Aigües;937;501;436;2015
03;Alicante/Alacant;005;Albatera;11780;5993;5787;2015
03;Alicante/Alacant;006;Alcalalí;1311;661;650;2015
03;Alicante/Alacant;007;Alcocer de Planes;216;111;105;2015
03;Alicante/Alacant;008;Alcoleja;184;96;88;2015
03;Alicante/Alacant;009;Alcoy/Alcoi;59567;29007;30560;2015
03;Alicante/Alacant;010;Alfafara;406;198;208;2015
03;Alicante/Alacant;011;Alfàs del Pi, l';21700;10781;10919;2015
03;Alicante/Alacant;012;Algorfa;3693;1852;1841;2015
03;Alicante/Alacant;013;Algueña;1413;706;707;2015
03;Alicante/Alacant;014;Alicante/Alacant;328648;159401;169247;2015
03;Alicante/Alacant;015;Almoradí;19955;10098;9857;2015
03;Alicante/Alacant;016;Almudaina;114;61;53;2015
03;Alicante/Alacant;017;Alqueria d'Asnar, l';522;244;278;2015
03;Alicante/Alacant;018;Altea;22385;11008;11377;2015
03;Alicante/Alacant;019;Aspe;20406;10299;10107;2015
03;Alicante/Alacant;020;Balones;133;69;64;2015
03;Alicante/Alacant;021;Banyeres de Mariola;7155;3569;3586;2015
03;Alicante/Alacant;022;Benasau;155;76;79;2015
03;Alicante/Alacant;023;Beneixama;1746;864;882;2015
03;Alicante/Alacant;024;Benejúzar;5398;2697;2701;2015
03;Alicante/Alacant;025;Benferri;1899;992;907;2015
03;Alicante/Alacant;026;Beniarbeig;1926;958;968;2015
03;Alicante/Alacant;027;Beniardá;227;116;111;2015
03;Alicante/Alacant;028;Beniarrés;1208;608;600;2015
03;Alicante/Alacant;030;Benidoleig;1196;585;611;2015
03;Alicante/Alacant;031;Benidorm;69045;34395;34650;2015
03;Alicante/Alacant;032;Benifallim;114;63;51;2015
03;Alicante/Alacant;033;Benifato;156;79;77;2015
03;Alicante/Alacant;029;Benigembla;490;248;242;2015
03;Alicante/Alacant;034;Benijófar;3655;1798;1857;2015
03;Alicante/Alacant;035;Benilloba;786;399;387;2015
03;Alicante/Alacant;036;Benillup;101;47;54;2015
03;Alicante/Alacant;037;Benimantell;501;238;263;2015
03;Alicante/Alacant;038;Benimarfull;433;217;216;2015
03;Alicante/Alacant;039;Benimassot;111;61;50;2015
03;Alicante/Alacant;040;Benimeli;416;202;214;2015
03;Alicante/Alacant;041;Benissa;11598;5735;5863;2015
03;Alicante/Alacant;042;Benitachell/Poble Nou de Benitatxell, el;4690;2317;2373;2015
03;Alicante/Alacant;043;Biar;3657;1796;1861;2015
03;Alicante/Alacant;044;Bigastro;6714;3424;3290;2015
03;Alicante/Alacant;045;Bolulla;426;217;209;2015
03;Alicante/Alacant;046;Busot;3075;1559;1516;2015
03;Alicante/Alacant;049;Callosa de Segura;18200;9158;9042;2015
03;Alicante/Alacant;048;Callosa d'en Sarrià;7133;3602;3531;2015
03;Alicante/Alacant;047;Calp;21540;10917;10623;2015
03;Alicante/Alacant;050;Campello, el;27356;13390;13966;2015
03;Alicante/Alacant;051;Campo de Mirra/Camp de Mirra, el;445;232;213;2015
03;Alicante/Alacant;052;Cañada;1229;607;622;2015
03;Alicante/Alacant;053;Castalla;9994;5056;4938;2015
03;Alicante/Alacant;054;Castell de Castells;431;214;217;2015
03;Alicante/Alacant;075;Castell de Guadalest, el;224;114;110;2015
03;Alicante/Alacant;055;Catral;8690;4405;4285;2015
03;Alicante/Alacant;056;Cocentaina;11406;5752;5654;2015
03;Alicante/Alacant;057;Confrides;208;118;90;2015
03;Alicante/Alacant;058;Cox;7229;3701;3528;2015
03;Alicante/Alacant;059;Crevillent;28465;14419;14046;2015
03;Alicante/Alacant;061;Daya Nueva;1732;879;853;2015
03;Alicante/Alacant;062;Daya Vieja;668;345;323;2015
03;Alicante/Alacant;063;Dénia;41553;20290;21263;2015
03;Alicante/Alacant;064;Dolores;7246;3624;3622;2015
03;Alicante/Alacant;065;Elche/Elx;227312;112783;114529;2015
03;Alicante/Alacant;066;Elda;53248;25978;27270;2015
03;Alicante/Alacant;067;Facheca;103;56;47;2015
03;Alicante/Alacant;068;Famorca;52;26;26;2015
03;Alicante/Alacant;069;Finestrat;6239;3208;3031;2015
03;Alicante/Alacant;077;Fondó de les Neus, el/Hondón de las Nieves;2583;1305;1278;2015
03;Alicante/Alacant;070;Formentera del Segura;4206;2144;2062;2015
03;Alicante/Alacant;072;Gaianes;457;237;220;2015
03;Alicante/Alacant;071;Gata de Gorgos;5885;2974;2911;2015
03;Alicante/Alacant;073;Gorga;275;151;124;2015
03;Alicante/Alacant;074;Granja de Rocamora;2425;1257;1168;2015
03;Alicante/Alacant;076;Guardamar del Segura;15589;7704;7885;2015
03;Alicante/Alacant;078;Hondón de los Frailes;1160;604;556;2015
03;Alicante/Alacant;079;Ibi;23321;11669;11652;2015
03;Alicante/Alacant;080;Jacarilla;1930;973;957;2015
03;Alicante/Alacant;082;Jávea/Xàbia;27681;13704;13977;2015
03;Alicante/Alacant;083;Jijona/Xixona;7205;3508;3697;2015
03;Alicante/Alacant;085;Llíber;1099;541;558;2015
03;Alicante/Alacant;084;Lorcha/Orxa, l';650;323;327;2015
03;Alicante/Alacant;086;Millena;224;115;109;2015
03;Alicante/Alacant;088;Monforte del Cid;7603;3967;3636;2015
03;Alicante/Alacant;089;Monóvar/Monòver;12381;6170;6211;2015
03;Alicante/Alacant;903;Montesinos, Los;4921;2497;2424;2015
03;Alicante/Alacant;091;Murla;516;241;275;2015
03;Alicante/Alacant;092;Muro de Alcoy;9167;4541;4626;2015
03;Alicante/Alacant;090;Mutxamel;24256;12072;12184;2015
03;Alicante/Alacant;093;Novelda;26146;12968;13178;2015
03;Alicante/Alacant;094;Nucia, la;20039;10154;9885;2015
03;Alicante/Alacant;095;Ondara;6617;3319;3298;2015
03;Alicante/Alacant;096;Onil;7548;3769;3779;2015
03;Alicante/Alacant;097;Orba;2210;1097;1113;2015
03;Alicante/Alacant;099;Orihuela;82675;41273;41402;2015
03;Alicante/Alacant;098;Orxeta;850;436;414;2015
03;Alicante/Alacant;100;Parcent;997;497;500;2015
03;Alicante/Alacant;101;Pedreguer;7337;3636;3701;2015
03;Alicante/Alacant;102;Pego;10331;5195;5136;2015
03;Alicante/Alacant;103;Penàguila;353;193;160;2015
03;Alicante/Alacant;104;Petrer;34586;17243;17343;2015
03;Alicante/Alacant;902;Pilar de la Horadada;21629;11148;10481;2015
03;Alicante/Alacant;105;Pinós, el/Pinoso;7695;3881;3814;2015
03;Alicante/Alacant;106;Planes;753;396;357;2015
03;Alicante/Alacant;901;Poblets, els;3303;1602;1701;2015
03;Alicante/Alacant;107;Polop;4369;2252;2117;2015
03;Alicante/Alacant;060;Quatretondeta;111;60;51;2015
03;Alicante/Alacant;109;Rafal;4167;2094;2073;2015
03;Alicante/Alacant;110;Ràfol d'Almúnia, el;635;318;317;2015
03;Alicante/Alacant;111;Redován;7706;4006;3700;2015
03;Alicante/Alacant;112;Relleu;1279;631;648;2015
03;Alicante/Alacant;113;Rojales;18127;9188;8939;2015
03;Alicante/Alacant;114;Romana, la;2431;1253;1178;2015
03;Alicante/Alacant;115;Sagra;410;211;199;2015
03;Alicante/Alacant;116;Salinas;1597;812;785;2015
03;Alicante/Alacant;118;San Fulgencio;9021;4527;4494;2015
03;Alicante/Alacant;904;San Isidro;1874;961;913;2015
03;Alicante/Alacant;120;San Miguel de Salinas;6773;3379;3394;2015
03;Alicante/Alacant;122;San Vicente del Raspeig/Sant Vicent del Raspeig;56302;27906;28396;2015
03;Alicante/Alacant;117;Sanet y Negrals;674;329;345;2015
03;Alicante/Alacant;119;Sant Joan d'Alacant;22825;11058;11767;2015
03;Alicante/Alacant;121;Santa Pola;31657;15975;15682;2015
03;Alicante/Alacant;123;Sax;9696;4881;4815;2015
03;Alicante/Alacant;124;Sella;588;317;271;2015
03;Alicante/Alacant;125;Senija;610;320;290;2015
03;Alicante/Alacant;127;Tàrbena;661;346;315;2015
03;Alicante/Alacant;128;Teulada;11460;5679;5781;2015
03;Alicante/Alacant;129;Tibi;1656;866;790;2015
03;Alicante/Alacant;130;Tollos;52;28;24;2015
03;Alicante/Alacant;131;Tormos;312;161;151;2015
03;Alicante/Alacant;132;Torremanzanas/Torre de les Maçanes, la;746;391;355;2015
03;Alicante/Alacant;133;Torrevieja;88447;44526;43921;2015
03;Alicante/Alacant;134;Vall d'Alcalà, la;169;87;82;2015
03;Alicante/Alacant;136;Vall de Gallinera;609;331;278;2015
03;Alicante/Alacant;137;Vall de Laguar, la;826;419;407;2015
03;Alicante/Alacant;135;Vall d'Ebo, la;249;131;118;2015
03;Alicante/Alacant;138;Verger, el;4627;2293;2334;2015
03;Alicante/Alacant;139;Villajoyosa/Vila Joiosa, la;33878;16962;16916;2015
03;Alicante/Alacant;140;Villena;34361;17151;17210;2015
03;Alicante/Alacant;081;Xaló;2675;1338;1337;2015
04;Almería;001;Abla;1342;689;653;2015
04;Almería;002;Abrucena;1279;656;623;2015
04;Almería;003;Adra;24670;12453;12217;2015
04;Almería;004;Albánchez;805;404;401;2015
04;Almería;005;Alboloduy;653;314;339;2015
04;Almería;006;Albox;11429;5828;5601;2015
04;Almería;007;Alcolea;812;423;389;2015
04;Almería;008;Alcóntar;570;314;256;2015
04;Almería;009;Alcudia de Monteagud;168;83;85;2015
04;Almería;010;Alhabia;700;359;341;2015
04;Almería;011;Alhama de Almería;3763;1897;1866;2015
04;Almería;012;Alicún;220;113;107;2015
04;Almería;013;Almería;194203;94475;99728;2015
04;Almería;014;Almócita;173;85;88;2015
04;Almería;015;Alsodux;138;75;63;2015
04;Almería;016;Antas;3195;1597;1598;2015
04;Almería;017;Arboleas;4670;2321;2349;2015
04;Almería;018;Armuña de Almanzora;332;165;167;2015
04;Almería;019;Bacares;278;142;136;2015
04;Almería;020;Bayárcal;336;185;151;2015
04;Almería;021;Bayarque;216;109;107;2015
04;Almería;022;Bédar;990;484;506;2015
04;Almería;023;Beires;119;55;64;2015
04;Almería;024;Benahadux;4183;2071;2112;2015
04;Almería;026;Benitagla;78;42;36;2015
04;Almería;027;Benizalón;283;146;137;2015
04;Almería;028;Bentarique;258;145;113;2015
04;Almería;029;Berja;15174;7653;7521;2015
04;Almería;030;Canjáyar;1342;698;644;2015
04;Almería;031;Cantoria;3580;1805;1775;2015
04;Almería;032;Carboneras;7838;4034;3804;2015
04;Almería;033;Castro de Filabres;147;71;76;2015
04;Almería;036;Chercos;275;145;130;2015
04;Almería;037;Chirivel;1604;812;792;2015
04;Almería;034;Cóbdar;183;103;80;2015
04;Almería;035;Cuevas del Almanzora;13292;6882;6410;2015
04;Almería;038;Dalías;3979;1968;2011;2015
04;Almería;902;Ejido, El;85961;45335;40626;2015
04;Almería;041;Enix;437;246;191;2015
04;Almería;043;Felix;688;385;303;2015
04;Almería;044;Fines;2143;1118;1025;2015
04;Almería;045;Fiñana;2134;1078;1056;2015
04;Almería;046;Fondón;1020;532;488;2015
04;Almería;047;Gádor;3027;1577;1450;2015
04;Almería;048;Gallardos, Los;2973;1521;1452;2015
04;Almería;049;Garrucha;8577;4412;4165;2015
04;Almería;050;Gérgal;1093;568;525;2015
04;Almería;051;Huécija;515;247;268;2015
04;Almería;052;Huércal de Almería;16823;8596;8227;2015
04;Almería;053;Huércal-Overa;18530;9204;9326;2015
04;Almería;054;Illar;380;199;181;2015
04;Almería;055;Instinción;458;225;233;2015
04;Almería;056;Laroya;178;100;78;2015
04;Almería;057;Láujar de Andarax;1574;785;789;2015
04;Almería;058;Líjar;431;222;209;2015
04;Almería;059;Lubrín;1568;762;806;2015
04;Almería;060;Lucainena de las Torres;606;315;291;2015
04;Almería;061;Lúcar;772;382;390;2015
04;Almería;062;Macael;5676;2904;2772;2015
04;Almería;063;María;1285;661;624;2015
04;Almería;064;Mojácar;6825;3387;3438;2015
04;Almería;903;Mojonera, La;8963;4938;4025;2015
04;Almería;065;Nacimiento;501;251;250;2015
04;Almería;066;Níjar;28056;15163;12893;2015
04;Almería;067;Ohanes;669;329;340;2015
04;Almería;068;Olula de Castro;190;102;88;2015
04;Almería;069;Olula del Río;6259;3223;3036;2015
04;Almería;070;Oria;2428;1262;1166;2015
04;Almería;071;Padules;464;237;227;2015
04;Almería;072;Partaloa;673;321;352;2015
04;Almería;073;Paterna del Río;376;215;161;2015
04;Almería;074;Pechina;3860;1968;1892;2015
04;Almería;075;Pulpí;8762;4524;4238;2015
04;Almería;076;Purchena;1686;865;821;2015
04;Almería;077;Rágol;338;177;161;2015
04;Almería;078;Rioja;1374;686;688;2015
04;Almería;079;Roquetas de Mar;90623;46592;44031;2015
04;Almería;080;Santa Cruz de Marchena;254;128;126;2015
04;Almería;081;Santa Fe de Mondújar;448;228;220;2015
04;Almería;082;Senés;330;173;157;2015
04;Almería;083;Serón;2167;1100;1067;2015
04;Almería;084;Sierro;392;207;185;2015
04;Almería;085;Somontín;492;244;248;2015
04;Almería;086;Sorbas;2608;1373;1235;2015
04;Almería;087;Suflí;252;132;120;2015
04;Almería;088;Tabernas;3668;1910;1758;2015
04;Almería;089;Taberno;1000;495;505;2015
04;Almería;090;Tahal;396;203;193;2015
04;Almería;091;Terque;417;207;210;2015
04;Almería;092;Tíjola;3701;1826;1875;2015
04;Almería;901;Tres Villas, Las;615;321;294;2015
04;Almería;093;Turre;3346;1696;1650;2015
04;Almería;094;Turrillas;242;137;105;2015
04;Almería;095;Uleila del Campo;897;456;441;2015
04;Almería;096;Urrácal;336;170;166;2015
04;Almería;097;Velefique;268;145;123;2015
04;Almería;098;Vélez-Blanco;2035;1057;978;2015
04;Almería;099;Vélez-Rubio;6767;3304;3463;2015
04;Almería;100;Vera;15108;7669;7439;2015
04;Almería;101;Viator;5698;2947;2751;2015
04;Almería;102;Vícar;24571;13011;11560;2015
04;Almería;103;Zurgena;3030;1504;1526;2015
01;Araba/Álava;001;Alegría-Dulantzi;2882;1491;1391;2015
01;Araba/Álava;002;Amurrio;10263;5099;5164;2015
01;Araba/Álava;049;Añana;157;87;70;2015
01;Araba/Álava;003;Aramaio;1518;797;721;2015
01;Araba/Álava;006;Armiñón;244;123;121;2015
01;Araba/Álava;037;Arraia-Maeztu;712;404;308;2015
01;Araba/Álava;008;Arratzua-Ubarrundia;997;542;455;2015
01;Araba/Álava;004;Artziniega;1829;908;921;2015
01;Araba/Álava;009;Asparrena;1647;834;813;2015
01;Araba/Álava;010;Ayala/Aiara;2927;1477;1450;2015
01;Araba/Álava;011;Baños de Ebro/Mañueta;311;169;142;2015
01;Araba/Álava;013;Barrundia;905;500;405;2015
01;Araba/Álava;014;Berantevilla;467;237;230;2015
01;Araba/Álava;016;Bernedo;526;312;214;2015
01;Araba/Álava;017;Campezo/Kanpezu;1069;565;504;2015
01;Araba/Álava;021;Elburgo/Burgelu;608;318;290;2015
01;Araba/Álava;022;Elciego;1051;521;530;2015
01;Araba/Álava;023;Elvillar/Bilar;353;175;178;2015
01;Araba/Álava;046;Erriberagoitia/Ribera Alta;773;442;331;2015
01;Araba/Álava;056;Harana/Valle de Arana;242;140;102;2015
01;Araba/Álava;901;Iruña Oka/Iruña de Oca;3172;1648;1524;2015
01;Araba/Álava;027;Iruraiz-Gauna;509;281;228;2015
01;Araba/Álava;019;Kripan;182;98;84;2015
01;Araba/Álava;020;Kuartango;362;209;153;2015
01;Araba/Álava;028;Labastida/Bastida;1471;759;712;2015
01;Araba/Álava;030;Lagrán;163;87;76;2015
01;Araba/Álava;031;Laguardia;1520;782;738;2015
01;Araba/Álava;032;Lanciego/Lantziego;679;350;329;2015
01;Araba/Álava;902;Lantarón;893;506;387;2015
01;Araba/Álava;033;Lapuebla de Labarca;860;449;411;2015
01;Araba/Álava;036;Laudio/Llodio;18300;9046;9254;2015
01;Araba/Álava;058;Legutio;1716;913;803;2015
01;Araba/Álava;034;Leza;216;107;109;2015
01;Araba/Álava;039;Moreda de Álava/Moreda Araba;233;117;116;2015
01;Araba/Álava;041;Navaridas;231;142;89;2015
01;Araba/Álava;042;Okondo;1156;604;552;2015
01;Araba/Álava;043;Oyón-Oion;3320;1684;1636;2015
01;Araba/Álava;044;Peñacerrada-Urizaharra;270;164;106;2015
01;Araba/Álava;047;Ribera Baja/Erribera Beitia;1359;739;620;2015
01;Araba/Álava;051;Salvatierra/Agurain;4986;2483;2503;2015
01;Araba/Álava;052;Samaniego;294;150;144;2015
01;Araba/Álava;053;San Millán/Donemiliaga;722;403;319;2015
01;Araba/Álava;054;Urkabustaiz;1300;688;612;2015
01;Araba/Álava;055;Valdegovía/Gaubea;1013;559;454;2015
01;Araba/Álava;057;Villabuena de Álava/Eskuernaga;306;160;146;2015
01;Araba/Álava;059;Vitoria-Gasteiz;243918;119369;124549;2015
01;Araba/Álava;060;Yécora/Iekora;266;141;125;2015
01;Araba/Álava;061;Zalduondo;196;108;88;2015
01;Araba/Álava;062;Zambrana;406;219;187;2015
01;Araba/Álava;018;Zigoitia;1765;953;812;2015
01;Araba/Álava;063;Zuia;2383;1235;1148;2015
33;Asturias;001;Allande;1826;915;911;2015
33;Asturias;002;Aller;11555;5693;5862;2015
33;Asturias;003;Amieva;727;388;339;2015
33;Asturias;004;Avilés;80880;38314;42566;2015
33;Asturias;005;Belmonte de Miranda;1641;846;795;2015
33;Asturias;006;Bimenes;1768;840;928;2015
33;Asturias;007;Boal;1669;834;835;2015
33;Asturias;008;Cabrales;2094;1064;1030;2015
33;Asturias;009;Cabranes;1056;543;513;2015
33;Asturias;010;Candamo;2055;1014;1041;2015
33;Asturias;012;Cangas de Onís;6498;3168;3330;2015
33;Asturias;011;Cangas del Narcea;13451;6677;6774;2015
33;Asturias;013;Caravia;501;254;247;2015
33;Asturias;014;Carreño;10704;5163;5541;2015
33;Asturias;015;Caso;1663;940;723;2015
33;Asturias;016;Castrillón;22735;11018;11717;2015
33;Asturias;017;Castropol;3638;1749;1889;2015
33;Asturias;018;Coaña;3419;1668;1751;2015
33;Asturias;019;Colunga;3518;1717;1801;2015
33;Asturias;020;Corvera de Asturias;16088;7934;8154;2015
33;Asturias;021;Cudillero;5210;2596;2614;2015
33;Asturias;022;Degaña;1082;560;522;2015
33;Asturias;023;Franco, El;3859;1895;1964;2015
33;Asturias;024;Gijón;274290;129372;144918;2015
33;Asturias;025;Gozón;10588;5164;5424;2015
33;Asturias;026;Grado;10309;4967;5342;2015
33;Asturias;027;Grandas de Salime;927;474;453;2015
33;Asturias;028;Ibias;1473;816;657;2015
33;Asturias;029;Illano;389;197;192;2015
33;Asturias;030;Illas;1030;524;506;2015
33;Asturias;031;Langreo;41738;19807;21931;2015
33;Asturias;032;Laviana;13582;6526;7056;2015
33;Asturias;033;Lena;11654;5634;6020;2015
33;Asturias;035;Llanera;13904;6908;6996;2015
33;Asturias;036;Llanes;13694;6664;7030;2015
33;Asturias;037;Mieres;40338;19138;21200;2015
33;Asturias;038;Morcín;2746;1367;1379;2015
33;Asturias;039;Muros de Nalón;1883;893;990;2015
33;Asturias;040;Nava;5411;2660;2751;2015
33;Asturias;041;Navia;8644;4189;4455;2015
33;Asturias;042;Noreña;5333;2559;2774;2015
33;Asturias;043;Onís;763;402;361;2015
33;Asturias;044;Oviedo;221870;103063;118807;2015
33;Asturias;045;Parres;5490;2680;2810;2015
33;Asturias;046;Peñamellera Alta;559;280;279;2015
33;Asturias;047;Peñamellera Baja;1291;633;658;2015
33;Asturias;048;Pesoz;172;89;83;2015
33;Asturias;049;Piloña;7412;3663;3749;2015
33;Asturias;050;Ponga;655;385;270;2015
33;Asturias;051;Pravia;8667;4196;4471;2015
33;Asturias;052;Proaza;786;450;336;2015
33;Asturias;053;Quirós;1250;701;549;2015
33;Asturias;054;Regueras, Las;1934;988;946;2015
33;Asturias;055;Ribadedeva;1836;890;946;2015
33;Asturias;056;Ribadesella;5904;2821;3083;2015
33;Asturias;057;Ribera de Arriba;1890;963;927;2015
33;Asturias;058;Riosa;2061;1038;1023;2015
33;Asturias;059;Salas;5371;2659;2712;2015
33;Asturias;061;San Martín de Oscos;422;209;213;2015
33;Asturias;060;San Martín del Rey Aurelio;17182;8245;8937;2015
33;Asturias;063;San Tirso de Abres;473;233;240;2015
33;Asturias;062;Santa Eulalia de Oscos;471;248;223;2015
33;Asturias;064;Santo Adriano;263;131;132;2015
33;Asturias;065;Sariego;1276;615;661;2015
33;Asturias;066;Siero;52191;25452;26739;2015
33;Asturias;067;Sobrescobio;855;458;397;2015
33;Asturias;068;Somiedo;1231;719;512;2015
33;Asturias;069;Soto del Barco;3978;1957;2021;2015
33;Asturias;070;Tapia de Casariego;3906;1900;2006;2015
33;Asturias;071;Taramundi;698;333;365;2015
33;Asturias;072;Teverga;1768;929;839;2015
33;Asturias;073;Tineo;10128;5073;5055;2015
33;Asturias;034;Valdés;12421;6035;6386;2015
33;Asturias;074;Vegadeo;3960;1901;2059;2015
33;Asturias;075;Villanueva de Oscos;310;155;155;2015
33;Asturias;076;Villaviciosa;14690;7229;7461;2015
33;Asturias;077;Villayón;1366;711;655;2015
33;Asturias;078;Yernes y Tameza;159;92;67;2015
05;Ávila;001;Adanero;231;127;104;2015
05;Ávila;002;Adrada, La;2640;1383;1257;2015
05;Ávila;005;Albornos;205;108;97;2015
05;Ávila;007;Aldeanueva de Santa Cruz;123;67;56;2015
05;Ávila;008;Aldeaseca;262;128;134;2015
05;Ávila;010;Aldehuela, La;173;91;82;2015
05;Ávila;012;Amavida;147;73;74;2015
05;Ávila;013;Arenal, El;1011;506;505;2015
05;Ávila;014;Arenas de San Pedro;6671;3239;3432;2015
05;Ávila;015;Arevalillo;92;46;46;2015
05;Ávila;016;Arévalo;8172;3981;4191;2015
05;Ávila;017;Aveinte;84;46;38;2015
05;Ávila;018;Avellaneda;29;17;12;2015
05;Ávila;019;Ávila;58358;27902;30456;2015
05;Ávila;021;Barco de Ávila, El;2576;1248;1328;2015
05;Ávila;022;Barraco, El;1968;1019;949;2015
05;Ávila;023;Barromán;196;106;90;2015
05;Ávila;024;Becedas;236;127;109;2015
05;Ávila;025;Becedillas;103;58;45;2015
05;Ávila;026;Bercial de Zapardiel;221;118;103;2015
05;Ávila;027;Berlanas, Las;330;168;162;2015
05;Ávila;029;Bernuy-Zapardiel;131;75;56;2015
05;Ávila;030;Berrocalejo de Aragona;51;27;24;2015
05;Ávila;033;Blascomillán;197;101;96;2015
05;Ávila;034;Blasconuño de Matacabras;15;9;6;2015
05;Ávila;035;Blascosancho;117;57;60;2015
05;Ávila;036;Bohodón, El;129;68;61;2015
05;Ávila;037;Bohoyo;304;168;136;2015
05;Ávila;038;Bonilla de la Sierra;129;76;53;2015
05;Ávila;039;Brabos;49;30;19;2015
05;Ávila;040;Bularros;69;43;26;2015
05;Ávila;041;Burgohondo;1228;647;581;2015
05;Ávila;042;Cabezas de Alambre;168;83;85;2015
05;Ávila;043;Cabezas del Pozo;88;50;38;2015
05;Ávila;044;Cabezas del Villar;261;151;110;2015
05;Ávila;045;Cabizuela;98;51;47;2015
05;Ávila;046;Canales;56;30;26;2015
05;Ávila;047;Candeleda;5104;2597;2507;2015
05;Ávila;048;Cantiveros;126;69;57;2015
05;Ávila;049;Cardeñosa;454;243;211;2015
05;Ávila;051;Carrera, La;201;106;95;2015
05;Ávila;052;Casas del Puerto;100;52;48;2015
05;Ávila;053;Casasola;78;41;37;2015
05;Ávila;054;Casavieja;1507;770;737;2015
05;Ávila;055;Casillas;704;375;329;2015
05;Ávila;056;Castellanos de Zapardiel;97;52;45;2015
05;Ávila;057;Cebreros;3232;1649;1583;2015
05;Ávila;058;Cepeda la Mora;85;45;40;2015
05;Ávila;067;Chamartín;92;52;40;2015
05;Ávila;059;Cillán;110;65;45;2015
05;Ávila;060;Cisla;118;60;58;2015
05;Ávila;061;Colilla, La;331;169;162;2015
05;Ávila;062;Collado de Contreras;192;101;91;2015
05;Ávila;063;Collado del Mirón;35;21;14;2015
05;Ávila;064;Constanzana;116;68;48;2015
05;Ávila;065;Crespos;526;282;244;2015
05;Ávila;066;Cuevas del Valle;516;278;238;2015
05;Ávila;903;Diego del Carpio;161;90;71;2015
05;Ávila;069;Donjimeno;82;50;32;2015
05;Ávila;070;Donvidas;37;20;17;2015
05;Ávila;072;Espinosa de los Caballeros;102;55;47;2015
05;Ávila;073;Flores de Ávila;320;175;145;2015
05;Ávila;074;Fontiveros;770;404;366;2015
05;Ávila;075;Fresnedilla;131;54;77;2015
05;Ávila;076;Fresno, El;601;308;293;2015
05;Ávila;077;Fuente el Saúz;182;98;84;2015
05;Ávila;078;Fuentes de Año;126;69;57;2015
05;Ávila;079;Gallegos de Altamiros;72;45;27;2015
05;Ávila;080;Gallegos de Sobrinos;56;25;31;2015
05;Ávila;081;Garganta del Villar;40;29;11;2015
05;Ávila;082;Gavilanes;619;329;290;2015
05;Ávila;083;Gemuño;169;87;82;2015
05;Ávila;085;Gil García;43;21;22;2015
05;Ávila;084;Gilbuena;73;43;30;2015
05;Ávila;086;Gimialcón;85;52;33;2015
05;Ávila;087;Gotarrendura;164;58;106;2015
05;Ávila;088;Grandes y San Martín;30;14;16;2015
05;Ávila;089;Guisando;534;269;265;2015
05;Ávila;090;Gutierre-Muñoz;90;45;45;2015
05;Ávila;092;Hernansancho;184;99;85;2015
05;Ávila;093;Herradón de Pinares;549;314;235;2015
05;Ávila;094;Herreros de Suso;145;78;67;2015
05;Ávila;095;Higuera de las Dueñas;302;164;138;2015
05;Ávila;096;Hija de Dios, La;82;47;35;2015
05;Ávila;097;Horcajada, La;525;266;259;2015
05;Ávila;099;Horcajo de las Torres;556;311;245;2015
05;Ávila;100;Hornillo, El;317;169;148;2015
05;Ávila;102;Hoyo de Pinares, El;2308;1205;1103;2015
05;Ávila;101;Hoyocasero;369;206;163;2015
05;Ávila;103;Hoyorredondo;77;43;34;2015
05;Ávila;106;Hoyos de Miguel Muñoz;35;18;17;2015
05;Ávila;104;Hoyos del Collado;33;20;13;2015
05;Ávila;105;Hoyos del Espino;364;195;169;2015
05;Ávila;107;Hurtumpascual;62;38;24;2015
05;Ávila;108;Junciana;53;28;25;2015
05;Ávila;109;Langa;520;269;251;2015
05;Ávila;110;Lanzahíta;905;470;435;2015
05;Ávila;113;Llanos de Tormes, Los;82;39;43;2015
05;Ávila;112;Losar del Barco, El;109;54;55;2015
05;Ávila;114;Madrigal de las Altas Torres;1524;777;747;2015
05;Ávila;115;Maello;647;334;313;2015
05;Ávila;116;Malpartida de Corneja;123;62;61;2015
05;Ávila;117;Mamblas;220;122;98;2015
05;Ávila;118;Mancera de Arriba;88;50;38;2015
05;Ávila;119;Manjabálago y Ortigosa de Rioalmar;34;21;13;2015
05;Ávila;120;Marlín;37;24;13;2015
05;Ávila;121;Martiherrero;307;159;148;2015
05;Ávila;122;Martínez;139;75;64;2015
05;Ávila;123;Mediana de Voltoya;106;53;53;2015
05;Ávila;124;Medinilla;112;53;59;2015
05;Ávila;125;Mengamuñoz;63;31;32;2015
05;Ávila;126;Mesegar de Corneja;75;41;34;2015
05;Ávila;127;Mijares;767;418;349;2015
05;Ávila;128;Mingorría;407;211;196;2015
05;Ávila;129;Mirón, El;134;82;52;2015
05;Ávila;130;Mironcillo;101;54;47;2015
05;Ávila;131;Mirueña de los Infanzones;98;54;44;2015
05;Ávila;132;Mombeltrán;1171;609;562;2015
05;Ávila;133;Monsalupe;72;35;37;2015
05;Ávila;134;Moraleja de Matacabras;47;27;20;2015
05;Ávila;135;Muñana;435;229;206;2015
05;Ávila;136;Muñico;111;56;55;2015
05;Ávila;138;Muñogalindo;374;187;187;2015
05;Ávila;139;Muñogrande;63;38;25;2015
05;Ávila;140;Muñomer del Peco;131;68;63;2015
05;Ávila;141;Muñopepe;112;67;45;2015
05;Ávila;142;Muñosancho;104;50;54;2015
05;Ávila;143;Muñotello;64;36;28;2015
05;Ávila;144;Narrillos del Álamo;85;44;41;2015
05;Ávila;145;Narrillos del Rebollar;56;30;26;2015
05;Ávila;149;Narros de Saldueña;110;61;49;2015
05;Ávila;147;Narros del Castillo;180;98;82;2015
05;Ávila;148;Narros del Puerto;27;12;15;2015
05;Ávila;152;Nava de Arévalo;801;422;379;2015
05;Ávila;153;Nava del Barco;108;57;51;2015
05;Ávila;151;Navacepedilla de Corneja;109;57;52;2015
05;Ávila;154;Navadijos;38;28;10;2015
05;Ávila;155;Navaescurial;60;37;23;2015
05;Ávila;156;Navahondilla;335;191;144;2015
05;Ávila;157;Navalacruz;259;133;126;2015
05;Ávila;158;Navalmoral;353;187;166;2015
05;Ávila;159;Navalonguilla;264;135;129;2015
05;Ávila;160;Navalosa;333;185;148;2015
05;Ávila;161;Navalperal de Pinares;867;446;421;2015
05;Ávila;162;Navalperal de Tormes;98;51;47;2015
05;Ávila;163;Navaluenga;2017;1002;1015;2015
05;Ávila;164;Navaquesera;26;11;15;2015
05;Ávila;165;Navarredonda de Gredos;473;239;234;2015
05;Ávila;166;Navarredondilla;217;115;102;2015
05;Ávila;167;Navarrevisca;307;167;140;2015
05;Ávila;168;Navas del Marqués, Las;5420;2746;2674;2015
05;Ávila;169;Navatalgordo;239;127;112;2015
05;Ávila;170;Navatejares;54;26;28;2015
05;Ávila;171;Neila de San Miguel;73;37;36;2015
05;Ávila;172;Niharra;172;94;78;2015
05;Ávila;173;Ojos-Albos;67;39;28;2015
05;Ávila;174;Orbita;80;40;40;2015
05;Ávila;175;Oso, El;176;100;76;2015
05;Ávila;176;Padiernos;292;151;141;2015
05;Ávila;177;Pajares de Adaja;191;95;96;2015
05;Ávila;178;Palacios de Goda;418;218;200;2015
05;Ávila;179;Papatrigo;253;127;126;2015
05;Ávila;180;Parral, El;79;44;35;2015
05;Ávila;181;Pascualcobo;39;26;13;2015
05;Ávila;182;Pedro Bernardo;921;484;437;2015
05;Ávila;183;Pedro-Rodríguez;158;82;76;2015
05;Ávila;184;Peguerinos;312;183;129;2015
05;Ávila;185;Peñalba de Ávila;114;62;52;2015
05;Ávila;186;Piedrahíta;1884;897;987;2015
05;Ávila;187;Piedralaves;2208;1119;1089;2015
05;Ávila;188;Poveda;50;31;19;2015
05;Ávila;189;Poyales del Hoyo;557;306;251;2015
05;Ávila;190;Pozanco;53;31;22;2015
05;Ávila;191;Pradosegar;139;74;65;2015
05;Ávila;192;Puerto Castilla;116;73;43;2015
05;Ávila;193;Rasueros;201;117;84;2015
05;Ávila;194;Riocabado;150;84;66;2015
05;Ávila;195;Riofrío;233;136;97;2015
05;Ávila;196;Rivilla de Barajas;67;31;36;2015
05;Ávila;197;Salobral;110;59;51;2015
05;Ávila;198;Salvadiós;80;40;40;2015
05;Ávila;199;San Bartolomé de Béjar;42;22;20;2015
05;Ávila;200;San Bartolomé de Corneja;54;29;25;2015
05;Ávila;201;San Bartolomé de Pinares;597;317;280;2015
05;Ávila;206;San Esteban de los Patos;34;19;15;2015
05;Ávila;208;San Esteban de Zapardiel;41;25;16;2015
05;Ávila;207;San Esteban del Valle;800;426;374;2015
05;Ávila;209;San García de Ingelmos;82;48;34;2015
05;Ávila;901;San Juan de Gredos;291;160;131;2015
05;Ávila;210;San Juan de la Encinilla;90;46;44;2015
05;Ávila;211;San Juan de la Nava;518;268;250;2015
05;Ávila;212;San Juan del Molinillo;227;131;96;2015
05;Ávila;213;San Juan del Olmo;112;68;44;2015
05;Ávila;214;San Lorenzo de Tormes;42;23;19;2015
05;Ávila;215;San Martín de la Vega del Alberche;181;111;70;2015
05;Ávila;216;San Martín del Pimpollar;185;107;78;2015
05;Ávila;217;San Miguel de Corneja;62;33;29;2015
05;Ávila;218;San Miguel de Serrezuela;137;74;63;2015
05;Ávila;219;San Pascual;43;28;15;2015
05;Ávila;220;San Pedro del Arroyo;455;240;215;2015
05;Ávila;231;San Vicente de Arévalo;190;106;84;2015
05;Ávila;204;Sanchidrián;768;391;377;2015
05;Ávila;205;Sanchorreja;91;45;46;2015
05;Ávila;222;Santa Cruz de Pinares;157;87;70;2015
05;Ávila;221;Santa Cruz del Valle;385;198;187;2015
05;Ávila;226;Santa María de los Caballeros;79;46;33;2015
05;Ávila;224;Santa María del Arroyo;114;59;55;2015
05;Ávila;225;Santa María del Berrocal;391;205;186;2015
05;Ávila;902;Santa María del Cubillo;337;193;144;2015
05;Ávila;227;Santa María del Tiétar;526;274;252;2015
05;Ávila;228;Santiago del Collado;183;115;68;2015
05;Ávila;904;Santiago del Tormes;146;82;64;2015
05;Ávila;229;Santo Domingo de las Posadas;78;41;37;2015
05;Ávila;230;Santo Tomé de Zabarcos;71;39;32;2015
05;Ávila;232;Serrada, La;110;58;52;2015
05;Ávila;233;Serranillos;262;142;120;2015
05;Ávila;234;Sigeres;53;27;26;2015
05;Ávila;235;Sinlabajos;127;66;61;2015
05;Ávila;236;Solana de Ávila;138;76;62;2015
05;Ávila;237;Solana de Rioalmar;185;104;81;2015
05;Ávila;238;Solosancho;905;482;423;2015
05;Ávila;239;Sotalbo;218;114;104;2015
05;Ávila;240;Sotillo de la Adrada;4652;2308;2344;2015
05;Ávila;241;Tiemblo, El;4231;2164;2067;2015
05;Ávila;242;Tiñosillos;790;403;387;2015
05;Ávila;243;Tolbaños;95;52;43;2015
05;Ávila;244;Tormellas;55;31;24;2015
05;Ávila;245;Tornadizos de Ávila;432;217;215;2015
05;Ávila;247;Torre, La;273;149;124;2015
05;Ávila;246;Tórtoles;64;34;30;2015
05;Ávila;249;Umbrías;117;60;57;2015
05;Ávila;251;Vadillo de la Sierra;70;42;28;2015
05;Ávila;252;Valdecasa;77;45;32;2015
05;Ávila;253;Vega de Santa María;94;47;47;2015
05;Ávila;254;Velayos;234;116;118;2015
05;Ávila;256;Villaflor;126;64;62;2015
05;Ávila;257;Villafranca de la Sierra;134;76;58;2015
05;Ávila;905;Villanueva de Ávila;239;121;118;2015
05;Ávila;258;Villanueva de Gómez;142;81;61;2015
05;Ávila;259;Villanueva del Aceral;139;69;70;2015
05;Ávila;260;Villanueva del Campillo;100;60;40;2015
05;Ávila;261;Villar de Corneja;41;24;17;2015
05;Ávila;262;Villarejo del Valle;380;200;180;2015
05;Ávila;263;Villatoro;184;104;80;2015
05;Ávila;264;Viñegra de Moraña;49;26;23;2015
05;Ávila;265;Vita;84;48;36;2015
05;Ávila;266;Zapardiel de la Cañada;104;54;50;2015
05;Ávila;267;Zapardiel de la Ribera;111;58;53;2015
06;Badajoz;001;Acedera;816;419;397;2015
06;Badajoz;002;Aceuchal;5471;2715;2756;2015
06;Badajoz;003;Ahillones;960;480;480;2015
06;Badajoz;004;Alange;1914;965;949;2015
06;Badajoz;005;Albuera, La;2046;1053;993;2015
06;Badajoz;006;Alburquerque;5486;2781;2705;2015
06;Badajoz;007;Alconchel;1790;894;896;2015
06;Badajoz;008;Alconera;747;367;380;2015
06;Badajoz;009;Aljucén;240;137;103;2015
06;Badajoz;010;Almendral;1296;632;664;2015
06;Badajoz;011;Almendralejo;34265;17095;17170;2015
06;Badajoz;012;Arroyo de San Serván;4175;2115;2060;2015
06;Badajoz;013;Atalaya;302;154;148;2015
06;Badajoz;014;Azuaga;8031;3978;4053;2015
06;Badajoz;015;Badajoz;149892;72774;77118;2015
06;Badajoz;016;Barcarrota;3634;1862;1772;2015
06;Badajoz;017;Baterno;318;172;146;2015
06;Badajoz;018;Benquerencia de la Serena;888;435;453;2015
06;Badajoz;019;Berlanga;2434;1211;1223;2015
06;Badajoz;020;Bienvenida;2218;1149;1069;2015
06;Badajoz;021;Bodonal de la Sierra;1081;558;523;2015
06;Badajoz;022;Burguillos del Cerro;3179;1574;1605;2015
06;Badajoz;023;Cabeza del Buey;5138;2531;2607;2015
06;Badajoz;024;Cabeza la Vaca;1391;713;678;2015
06;Badajoz;025;Calamonte;6330;3125;3205;2015
06;Badajoz;026;Calera de León;1014;513;501;2015
06;Badajoz;027;Calzadilla de los Barros;845;425;420;2015
06;Badajoz;028;Campanario;5150;2532;2618;2015
06;Badajoz;029;Campillo de Llerena;1414;712;702;2015
06;Badajoz;030;Capilla;191;98;93;2015
06;Badajoz;031;Carmonita;561;278;283;2015
06;Badajoz;032;Carrascalejo, El;71;36;35;2015
06;Badajoz;033;Casas de Don Pedro;1560;795;765;2015
06;Badajoz;034;Casas de Reina;199;94;105;2015
06;Badajoz;035;Castilblanco;1085;554;531;2015
06;Badajoz;036;Castuera;6163;3052;3111;2015
06;Badajoz;042;Cheles;1221;587;634;2015
06;Badajoz;037;Codosera, La;2197;1162;1035;2015
06;Badajoz;038;Cordobilla de Lácara;960;492;468;2015
06;Badajoz;039;Coronada, La;2195;1078;1117;2015
06;Badajoz;040;Corte de Peleas;1312;651;661;2015
06;Badajoz;041;Cristina;556;288;268;2015
06;Badajoz;043;Don Álvaro;781;402;379;2015
06;Badajoz;044;Don Benito;36971;18268;18703;2015
06;Badajoz;045;Entrín Bajo;562;289;273;2015
06;Badajoz;046;Esparragalejo;1489;722;767;2015
06;Badajoz;047;Esparragosa de la Serena;1060;544;516;2015
06;Badajoz;048;Esparragosa de Lares;972;477;495;2015
06;Badajoz;049;Feria;1209;592;617;2015
06;Badajoz;050;Fregenal de la Sierra;4968;2441;2527;2015
06;Badajoz;051;Fuenlabrada de los Montes;1921;942;979;2015
06;Badajoz;052;Fuente de Cantos;4941;2432;2509;2015
06;Badajoz;053;Fuente del Arco;709;360;349;2015
06;Badajoz;054;Fuente del Maestre;6856;3387;3469;2015
06;Badajoz;055;Fuentes de León;2415;1189;1226;2015
06;Badajoz;056;Garbayuela;543;285;258;2015
06;Badajoz;057;Garlitos;630;328;302;2015
06;Badajoz;058;Garrovilla, La;2453;1239;1214;2015
06;Badajoz;059;Granja de Torrehermosa;2160;1073;1087;2015
06;Badajoz;903;Guadiana del Caudillo;2527;1256;1271;2015
06;Badajoz;060;Guareña;7151;3604;3547;2015
06;Badajoz;061;Haba, La;1286;651;635;2015
06;Badajoz;062;Helechosa de los Montes;716;397;319;2015
06;Badajoz;063;Herrera del Duque;3686;1871;1815;2015
06;Badajoz;064;Higuera de la Serena;969;513;456;2015
06;Badajoz;065;Higuera de Llerena;352;179;173;2015
06;Badajoz;066;Higuera de Vargas;2020;1010;1010;2015
06;Badajoz;067;Higuera la Real;2359;1197;1162;2015
06;Badajoz;068;Hinojosa del Valle;514;256;258;2015
06;Badajoz;069;Hornachos;3749;1875;1874;2015
06;Badajoz;070;Jerez de los Caballeros;9615;4781;4834;2015
06;Badajoz;071;Lapa, La;287;144;143;2015
06;Badajoz;073;Llera;888;459;429;2015
06;Badajoz;074;Llerena;5929;2965;2964;2015
06;Badajoz;072;Lobón;2837;1466;1371;2015
06;Badajoz;075;Magacela;552;293;259;2015
06;Badajoz;076;Maguilla;1007;502;505;2015
06;Badajoz;077;Malcocinado;395;217;178;2015
06;Badajoz;078;Malpartida de la Serena;599;304;295;2015
06;Badajoz;079;Manchita;760;393;367;2015
06;Badajoz;080;Medellín;2306;1157;1149;2015
06;Badajoz;081;Medina de las Torres;1280;661;619;2015
06;Badajoz;082;Mengabril;472;249;223;2015
06;Badajoz;083;Mérida;58971;28796;30175;2015
06;Badajoz;084;Mirandilla;1349;683;666;2015
06;Badajoz;085;Monesterio;4306;2194;2112;2015
06;Badajoz;086;Montemolín;1455;704;751;2015
06;Badajoz;087;Monterrubio de la Serena;2490;1214;1276;2015
06;Badajoz;088;Montijo;15789;7848;7941;2015
06;Badajoz;089;Morera, La;736;370;366;2015
06;Badajoz;090;Nava de Santiago, La;1005;503;502;2015
06;Badajoz;091;Navalvillar de Pela;4671;2364;2307;2015
06;Badajoz;092;Nogales;700;349;351;2015
06;Badajoz;093;Oliva de la Frontera;5403;2718;2685;2015
06;Badajoz;094;Oliva de Mérida;1798;925;873;2015
06;Badajoz;095;Olivenza;12090;6040;6050;2015
06;Badajoz;096;Orellana de la Sierra;245;134;111;2015
06;Badajoz;097;Orellana la Vieja;2836;1473;1363;2015
06;Badajoz;098;Palomas;697;345;352;2015
06;Badajoz;099;Parra, La;1383;711;672;2015
06;Badajoz;100;Peñalsordo;1042;502;540;2015
06;Badajoz;101;Peraleda del Zaucejo;565;290;275;2015
06;Badajoz;102;Puebla de Alcocer;1240;606;634;2015
06;Badajoz;103;Puebla de la Calzada;5970;2974;2996;2015
06;Badajoz;104;Puebla de la Reina;789;400;389;2015
06;Badajoz;107;Puebla de Obando;1894;954;940;2015
06;Badajoz;108;Puebla de Sancho Pérez;2793;1405;1388;2015
06;Badajoz;105;Puebla del Maestre;759;391;368;2015
06;Badajoz;106;Puebla del Prior;515;262;253;2015
06;Badajoz;902;Pueblonuevo del Guadiana;2046;1041;1005;2015
06;Badajoz;109;Quintana de la Serena;4818;2433;2385;2015
06;Badajoz;110;Reina;169;81;88;2015
06;Badajoz;111;Rena;655;337;318;2015
06;Badajoz;112;Retamal de Llerena;475;249;226;2015
06;Badajoz;113;Ribera del Fresno;3440;1711;1729;2015
06;Badajoz;114;Risco;158;81;77;2015
06;Badajoz;115;Roca de la Sierra, La;1515;741;774;2015
06;Badajoz;116;Salvaleón;1893;937;956;2015
06;Badajoz;117;Salvatierra de los Barros;1712;842;870;2015
06;Badajoz;119;San Pedro de Mérida;877;447;430;2015
06;Badajoz;123;San Vicente de Alcántara;5689;2863;2826;2015
06;Badajoz;118;Sancti-Spíritus;227;125;102;2015
06;Badajoz;120;Santa Amalia;4149;2089;2060;2015
06;Badajoz;121;Santa Marta;4301;2163;2138;2015
06;Badajoz;122;Santos de Maimona, Los;8254;4194;4060;2015
06;Badajoz;124;Segura de León;2012;998;1014;2015
06;Badajoz;125;Siruela;2017;1007;1010;2015
06;Badajoz;126;Solana de los Barros;2692;1342;1350;2015
06;Badajoz;127;Talarrubias;3576;1794;1782;2015
06;Badajoz;128;Talavera la Real;5484;2749;2735;2015
06;Badajoz;129;Táliga;721;365;356;2015
06;Badajoz;130;Tamurejo;225;117;108;2015
06;Badajoz;131;Torre de Miguel Sesmero;1261;634;627;2015
06;Badajoz;132;Torremayor;1049;499;550;2015
06;Badajoz;133;Torremejía;2259;1171;1088;2015
06;Badajoz;134;Trasierra;654;352;302;2015
06;Badajoz;135;Trujillanos;1442;759;683;2015
06;Badajoz;136;Usagre;1851;922;929;2015
06;Badajoz;137;Valdecaballeros;1135;585;550;2015
06;Badajoz;901;Valdelacalzada;2784;1428;1356;2015
06;Badajoz;138;Valdetorres;1246;616;630;2015
06;Badajoz;139;Valencia de las Torres;645;353;292;2015
06;Badajoz;140;Valencia del Mombuey;766;387;379;2015
06;Badajoz;141;Valencia del Ventoso;2084;1029;1055;2015
06;Badajoz;146;Valle de la Serena;1302;663;639;2015
06;Badajoz;147;Valle de Matamoros;391;200;191;2015
06;Badajoz;148;Valle de Santa Ana;1175;580;595;2015
06;Badajoz;142;Valverde de Burguillos;296;153;143;2015
06;Badajoz;143;Valverde de Leganés;4184;2110;2074;2015
06;Badajoz;144;Valverde de Llerena;645;321;324;2015
06;Badajoz;145;Valverde de Mérida;1086;551;535;2015
06;Badajoz;149;Villafranca de los Barros;13289;6540;6749;2015
06;Badajoz;150;Villagarcía de la Torre;945;497;448;2015
06;Badajoz;151;Villagonzalo;1295;628;667;2015
06;Badajoz;152;Villalba de los Barros;1574;798;776;2015
06;Badajoz;153;Villanueva de la Serena;26021;12738;13283;2015
06;Badajoz;154;Villanueva del Fresno;3489;1738;1751;2015
06;Badajoz;156;Villar de Rena;1413;733;680;2015
06;Badajoz;155;Villar del Rey;2273;1204;1069;2015
06;Badajoz;157;Villarta de los Montes;516;259;257;2015
06;Badajoz;158;Zafra;16857;8161;8696;2015
06;Badajoz;159;Zahínos;2844;1406;1438;2015
06;Badajoz;160;Zalamea de la Serena;3786;1904;1882;2015
06;Badajoz;162;Zarza, La;3586;1809;1777;2015
06;Badajoz;161;Zarza-Capilla;359;181;178;2015
07;Balears, Illes;002;Alaior;8997;4490;4507;2015
07;Balears, Illes;001;Alaró;5275;2592;2683;2015
07;Balears, Illes;003;Alcúdia;19763;10045;9718;2015
07;Balears, Illes;004;Algaida;5410;2765;2645;2015
07;Balears, Illes;005;Andratx;11093;5532;5561;2015
07;Balears, Illes;901;Ariany;871;460;411;2015
07;Balears, Illes;006;Artà;7381;3693;3688;2015
07;Balears, Illes;007;Banyalbufar;548;306;242;2015
07;Balears, Illes;008;Binissalem;7850;3878;3972;2015
07;Balears, Illes;009;Búger;1022;531;491;2015
07;Balears, Illes;010;Bunyola;6706;3300;3406;2015
07;Balears, Illes;011;Calvià;50328;25153;25175;2015
07;Balears, Illes;012;Campanet;2524;1245;1279;2015
07;Balears, Illes;013;Campos;9892;4943;4949;2015
07;Balears, Illes;014;Capdepera;11420;5781;5639;2015
07;Balears, Illes;064;Castell, Es;7635;3898;3737;2015
07;Balears, Illes;015;Ciutadella de Menorca;29098;14488;14610;2015
07;Balears, Illes;016;Consell;3862;1952;1910;2015
07;Balears, Illes;017;Costitx;1205;591;614;2015
07;Balears, Illes;018;Deià;713;347;366;2015
07;Balears, Illes;026;Eivissa;49975;25264;24711;2015
07;Balears, Illes;019;Escorca;236;137;99;2015
07;Balears, Illes;020;Esporles;4922;2437;2485;2015
07;Balears, Illes;021;Estellencs;336;181;155;2015
07;Balears, Illes;022;Felanitx;17412;8760;8652;2015
07;Balears, Illes;023;Ferreries;4571;2290;2281;2015
07;Balears, Illes;024;Formentera;11878;6226;5652;2015
07;Balears, Illes;025;Fornalutx;703;350;353;2015
07;Balears, Illes;027;Inca;30651;15414;15237;2015
07;Balears, Illes;028;Lloret de Vistalegre;1233;626;607;2015
07;Balears, Illes;029;Lloseta;5639;2847;2792;2015
07;Balears, Illes;030;Llubí;2176;1081;1095;2015
07;Balears, Illes;031;Llucmajor;34618;17458;17160;2015
07;Balears, Illes;033;Manacor;40170;19979;20191;2015
07;Balears, Illes;034;Mancor de la Vall;1321;672;649;2015
07;Balears, Illes;032;Maó-Mahón;28006;13710;14296;2015
07;Balears, Illes;035;Maria de la Salut;2113;1071;1042;2015
07;Balears, Illes;036;Marratxí;35726;17932;17794;2015
07;Balears, Illes;037;Mercadal, Es;5091;2583;2508;2015
07;Balears, Illes;902;Migjorn Gran, Es;1429;708;721;2015
07;Balears, Illes;038;Montuïri;2850;1430;1420;2015
07;Balears, Illes;039;Muro;6723;3367;3356;2015
07;Balears, Illes;040;Palma de Mallorca;400578;195144;205434;2015
07;Balears, Illes;041;Petra;2816;1395;1421;2015
07;Balears, Illes;044;Pobla, Sa;12694;6473;6221;2015
07;Balears, Illes;042;Pollença;16115;8016;8099;2015
07;Balears, Illes;043;Porreres;5267;2703;2564;2015
07;Balears, Illes;045;Puigpunyent;2018;1027;991;2015
07;Balears, Illes;059;Salines, Ses;5018;2538;2480;2015
07;Balears, Illes;046;Sant Antoni de Portmany;23631;12330;11301;2015
07;Balears, Illes;049;Sant Joan;2035;998;1037;2015
07;Balears, Illes;050;Sant Joan de Labritja;5872;3014;2858;2015
07;Balears, Illes;048;Sant Josep de sa Talaia;25674;13381;12293;2015
07;Balears, Illes;051;Sant Llorenç des Cardassar;8146;4027;4119;2015
07;Balears, Illes;052;Sant Lluís;7521;3781;3740;2015
07;Balears, Illes;053;Santa Eugènia;1638;829;809;2015
07;Balears, Illes;054;Santa Eulària des Riu;35812;18214;17598;2015
07;Balears, Illes;055;Santa Margalida;11672;5934;5738;2015
07;Balears, Illes;056;Santa María del Camí;6685;3321;3364;2015
07;Balears, Illes;057;Santanyí;11316;5682;5634;2015
07;Balears, Illes;058;Selva;3890;1957;1933;2015
07;Balears, Illes;047;Sencelles;3082;1555;1527;2015
07;Balears, Illes;060;Sineu;3612;1799;1813;2015
07;Balears, Illes;061;Sóller;13648;6864;6784;2015
07;Balears, Illes;062;Son Servera;11449;5710;5739;2015
07;Balears, Illes;063;Valldemossa;2005;1019;986;2015
07;Balears, Illes;065;Vilafranca de Bonany;2913;1454;1459;2015
08;Barcelona;001;Abrera;12071;6118;5953;2015
08;Barcelona;002;Aguilar de Segarra;246;131;115;2015
08;Barcelona;014;Aiguafreda;2465;1175;1290;2015
08;Barcelona;003;Alella;9660;4726;4934;2015
08;Barcelona;004;Alpens;290;156;134;2015
08;Barcelona;005;Ametlla del Vallès, L';8303;4178;4125;2015
08;Barcelona;006;Arenys de Mar;15289;7491;7798;2015
08;Barcelona;007;Arenys de Munt;8736;4408;4328;2015
08;Barcelona;008;Argençola;223;118;105;2015
08;Barcelona;009;Argentona;11978;5899;6079;2015
08;Barcelona;010;Artés;5665;2861;2804;2015
08;Barcelona;011;Avià;2225;1102;1123;2015
08;Barcelona;012;Avinyó;2248;1112;1136;2015
08;Barcelona;013;Avinyonet del Penedès;1652;863;789;2015
08;Barcelona;015;Badalona;215654;106424;109230;2015
08;Barcelona;904;Badia del Vallès;13502;6571;6931;2015
08;Barcelona;016;Bagà;2188;1080;1108;2015
08;Barcelona;017;Balenyà;3711;1863;1848;2015
08;Barcelona;018;Balsareny;3324;1636;1688;2015
08;Barcelona;252;Barberà del Vallès;32545;16091;16454;2015
08;Barcelona;019;Barcelona;1604555;759520;845035;2015
08;Barcelona;020;Begues;6670;3317;3353;2015
08;Barcelona;021;Bellprat;74;46;28;2015
08;Barcelona;022;Berga;16238;7952;8286;2015
08;Barcelona;023;Bigues i Riells;8858;4524;4334;2015
08;Barcelona;024;Borredà;503;280;223;2015
08;Barcelona;025;Bruc, El;2032;1097;935;2015
08;Barcelona;026;Brull, El;254;138;116;2015
08;Barcelona;027;Cabanyes, Les;967;501;466;2015
08;Barcelona;028;Cabrera d'Anoia;1348;715;633;2015
08;Barcelona;029;Cabrera de Mar;4522;2277;2245;2015
08;Barcelona;030;Cabrils;7250;3590;3660;2015
08;Barcelona;031;Calaf;3426;1749;1677;2015
08;Barcelona;034;Calders;968;496;472;2015
08;Barcelona;033;Caldes de Montbui;17098;8521;8577;2015
08;Barcelona;032;Caldes d'Estrac;2717;1316;1401;2015
08;Barcelona;035;Calella;18226;8886;9340;2015
08;Barcelona;037;Calldetenes;2427;1240;1187;2015
08;Barcelona;038;Callús;2024;994;1030;2015
08;Barcelona;036;Calonge de Segarra;197;99;98;2015
08;Barcelona;039;Campins;491;249;242;2015
08;Barcelona;040;Canet de Mar;14177;6884;7293;2015
08;Barcelona;041;Canovelles;15906;8205;7701;2015
08;Barcelona;042;Cànoves i Samalús;2897;1473;1424;2015
08;Barcelona;043;Canyelles;4375;2235;2140;2015
08;Barcelona;044;Capellades;5268;2592;2676;2015
08;Barcelona;045;Capolat;92;44;48;2015
08;Barcelona;046;Cardedeu;17938;8799;9139;2015
08;Barcelona;047;Cardona;4898;2404;2494;2015
08;Barcelona;048;Carme;792;411;381;2015
08;Barcelona;049;Casserres;1541;764;777;2015
08;Barcelona;057;Castell de l'Areny;73;41;32;2015
08;Barcelona;052;Castellar de n'Hug;159;86;73;2015
08;Barcelona;050;Castellar del Riu;175;96;79;2015
08;Barcelona;051;Castellar del Vallès;23442;11561;11881;2015
08;Barcelona;053;Castellbell i el Vilar;3566;1820;1746;2015
08;Barcelona;054;Castellbisbal;12364;6272;6092;2015
08;Barcelona;055;Castellcir;694;345;349;2015
08;Barcelona;056;Castelldefels;63891;31500;32391;2015
08;Barcelona;058;Castellet i la Gornal;2212;1115;1097;2015
08;Barcelona;060;Castellfollit de Riubregós;167;96;71;2015
08;Barcelona;059;Castellfollit del Boix;434;220;214;2015
08;Barcelona;061;Castellgalí;1996;1044;952;2015
08;Barcelona;062;Castellnou de Bages;1266;638;628;2015
08;Barcelona;063;Castellolí;574;280;294;2015
08;Barcelona;064;Castellterçol;2368;1192;1176;2015
08;Barcelona;065;Castellví de la Marca;1540;769;771;2015
08;Barcelona;066;Castellví de Rosanes;1771;868;903;2015
08;Barcelona;067;Centelles;7372;3601;3771;2015
08;Barcelona;268;Cercs;1209;602;607;2015
08;Barcelona;266;Cerdanyola del Vallès;57413;28124;29289;2015
08;Barcelona;068;Cervelló;8851;4426;4425;2015
08;Barcelona;069;Collbató;4389;2263;2126;2015
08;Barcelona;070;Collsuspina;343;181;162;2015
08;Barcelona;071;Copons;307;157;150;2015
08;Barcelona;072;Corbera de Llobregat;14240;7127;7113;2015
08;Barcelona;073;Cornellà de Llobregat;86376;42093;44283;2015
08;Barcelona;074;Cubelles;14420;7325;7095;2015
08;Barcelona;075;Dosrius;5215;2644;2571;2015
08;Barcelona;076;Esparreguera;21701;10975;10726;2015
08;Barcelona;077;Esplugues de Llobregat;45626;21965;23661;2015
08;Barcelona;078;Espunyola, L';252;129;123;2015
08;Barcelona;254;Esquirol, L';2150;1077;1073;2015
08;Barcelona;079;Estany, L';398;199;199;2015
08;Barcelona;134;Figaró-Montmany;1094;549;545;2015
08;Barcelona;080;Fígols;43;23;20;2015
08;Barcelona;082;Fogars de la Selva;1470;755;715;2015
08;Barcelona;081;Fogars de Montclús;477;248;229;2015
08;Barcelona;083;Folgueroles;2285;1156;1129;2015
08;Barcelona;084;Fonollosa;1393;726;667;2015
08;Barcelona;085;Font-rubí;1348;692;656;2015
08;Barcelona;086;Franqueses del Vallès, Les;19446;9894;9552;2015
08;Barcelona;090;Gaià;168;91;77;2015
08;Barcelona;087;Gallifa;197;103;94;2015
08;Barcelona;088;Garriga, La;15740;7646;8094;2015
08;Barcelona;089;Gavà;46405;22851;23554;2015
08;Barcelona;091;Gelida;7253;3629;3624;2015
08;Barcelona;092;Gironella;4925;2422;2503;2015
08;Barcelona;093;Gisclareny;27;16;11;2015
08;Barcelona;094;Granada, La;2085;1070;1015;2015
08;Barcelona;095;Granera;80;53;27;2015
08;Barcelona;096;Granollers;60101;29712;30389;2015
08;Barcelona;097;Gualba;1414;722;692;2015
08;Barcelona;099;Guardiola de Berguedà;930;493;437;2015
08;Barcelona;100;Gurb;2545;1318;1227;2015
08;Barcelona;101;Hospitalet de Llobregat, L';252171;122224;129947;2015
08;Barcelona;162;Hostalets de Pierola, Els;2887;1491;1396;2015
08;Barcelona;102;Igualada;38751;18950;19801;2015
08;Barcelona;103;Jorba;838;422;416;2015
08;Barcelona;104;Llacuna, La;883;476;407;2015
08;Barcelona;105;Llagosta, La;13252;6531;6721;2015
08;Barcelona;107;Lliçà d'Amunt;14742;7498;7244;2015
08;Barcelona;108;Lliçà de Vall;6383;3254;3129;2015
08;Barcelona;106;Llinars del Vallès;9570;4742;4828;2015
08;Barcelona;109;Lluçà;280;139;141;2015
08;Barcelona;110;Malgrat de Mar;18371;9183;9188;2015
08;Barcelona;111;Malla;262;132;130;2015
08;Barcelona;112;Manlleu;20228;10096;10132;2015
08;Barcelona;113;Manresa;74655;36397;38258;2015
08;Barcelona;242;Marganell;280;132;148;2015
08;Barcelona;114;Martorell;27694;14149;13545;2015
08;Barcelona;115;Martorelles;4756;2370;2386;2015
08;Barcelona;116;Masies de Roda, Les;715;354;361;2015
08;Barcelona;117;Masies de Voltregà, Les;3165;1554;1611;2015
08;Barcelona;118;Masnou, El;22923;11062;11861;2015
08;Barcelona;119;Masquefa;8335;4214;4121;2015
08;Barcelona;120;Matadepera;8900;4461;4439;2015
08;Barcelona;121;Mataró;124867;62045;62822;2015
08;Barcelona;122;Mediona;2273;1147;1126;2015
08;Barcelona;138;Moià;5865;2942;2923;2015
08;Barcelona;123;Molins de Rei;25155;12255;12900;2015
08;Barcelona;124;Mollet del Vallès;51650;25648;26002;2015
08;Barcelona;128;Monistrol de Calders;697;361;336;2015
08;Barcelona;127;Monistrol de Montserrat;2901;1473;1428;2015
08;Barcelona;125;Montcada i Reixac;34377;16941;17436;2015
08;Barcelona;130;Montclar;120;60;60;2015
08;Barcelona;131;Montesquiu;943;480;463;2015
08;Barcelona;126;Montgat;11501;5721;5780;2015
08;Barcelona;132;Montmajor;476;238;238;2015
08;Barcelona;133;Montmaneu;156;83;73;2015
08;Barcelona;135;Montmeló;8835;4331;4504;2015
08;Barcelona;136;Montornès del Vallès;16172;8210;7962;2015
08;Barcelona;137;Montseny;319;166;153;2015
08;Barcelona;129;Muntanyola;606;313;293;2015
08;Barcelona;139;Mura;203;109;94;2015
08;Barcelona;140;Navarcles;6012;2936;3076;2015
08;Barcelona;141;Navàs;6103;3049;3054;2015
08;Barcelona;142;Nou de Berguedà, La;153;74;79;2015
08;Barcelona;143;Òdena;3623;1848;1775;2015
08;Barcelona;145;Olèrdola;3518;1823;1695;2015
08;Barcelona;146;Olesa de Bonesvalls;1715;881;834;2015
08;Barcelona;147;Olesa de Montserrat;23536;11791;11745;2015
08;Barcelona;148;Olivella;3569;1895;1674;2015
08;Barcelona;149;Olost;1182;596;586;2015
08;Barcelona;144;Olvan;856;423;433;2015
08;Barcelona;150;Orís;308;154;154;2015
08;Barcelona;151;Oristà;559;275;284;2015
08;Barcelona;152;Orpí;139;76;63;2015
08;Barcelona;153;Òrrius;688;356;332;2015
08;Barcelona;154;Pacs del Penedès;893;451;442;2015
08;Barcelona;155;Palafolls;9132;4550;4582;2015
08;Barcelona;156;Palau-solità i Plegamans;14457;7087;7370;2015
08;Barcelona;157;Pallejà;11298;5634;5664;2015
08;Barcelona;905;Palma de Cervelló, La;2966;1492;1474;2015
08;Barcelona;158;Papiol, El;4071;2033;2038;2015
08;Barcelona;159;Parets del Vallès;18901;9495;9406;2015
08;Barcelona;160;Perafita;419;212;207;2015
08;Barcelona;161;Piera;14991;7621;7370;2015
08;Barcelona;163;Pineda de Mar;25968;12986;12982;2015
08;Barcelona;164;Pla del Penedès, El;1230;614;616;2015
08;Barcelona;165;Pobla de Claramunt, La;2150;1089;1061;2015
08;Barcelona;166;Pobla de Lillet, La;1139;561;578;2015
08;Barcelona;167;Polinyà;8226;4180;4046;2015
08;Barcelona;182;Pont de Vilomara i Rocafort, El;3715;1901;1814;2015
08;Barcelona;168;Pontons;483;273;210;2015
08;Barcelona;169;Prat de Llobregat, El;63014;30931;32083;2015
08;Barcelona;171;Prats de Lluçanès;2580;1294;1286;2015
08;Barcelona;170;Prats de Rei, Els;536;280;256;2015
08;Barcelona;230;Premià de Dalt;10392;5231;5161;2015
08;Barcelona;172;Premià de Mar;27944;13667;14277;2015
08;Barcelona;174;Puigdàlber;539;266;273;2015
08;Barcelona;175;Puig-reig;4167;2022;2145;2015
08;Barcelona;176;Pujalt;198;109;89;2015
08;Barcelona;177;Quar, La;52;28;24;2015
08;Barcelona;178;Rajadell;524;268;256;2015
08;Barcelona;179;Rellinars;748;388;360;2015
08;Barcelona;180;Ripollet;37445;18544;18901;2015
08;Barcelona;181;Roca del Vallès, La;10504;5278;5226;2015
08;Barcelona;183;Roda de Ter;6122;3006;3116;2015
08;Barcelona;184;Rubí;74536;36985;37551;2015
08;Barcelona;185;Rubió;229;125;104;2015
08;Barcelona;901;Rupit i Pruit;281;145;136;2015
08;Barcelona;187;Sabadell;207814;101118;106696;2015
08;Barcelona;188;Sagàs;157;85;72;2015
08;Barcelona;190;Saldes;288;162;126;2015
08;Barcelona;191;Sallent;6669;3215;3454;2015
08;Barcelona;194;Sant Adrià de Besòs;35814;17638;18176;2015
08;Barcelona;195;Sant Agustí de Lluçanès;90;45;45;2015
08;Barcelona;196;Sant Andreu de la Barca;27340;13717;13623;2015
08;Barcelona;197;Sant Andreu de Llavaneres;10493;5166;5327;2015
08;Barcelona;198;Sant Antoni de Vilamajor;5789;2896;2893;2015
08;Barcelona;199;Sant Bartomeu del Grau;863;447;416;2015
08;Barcelona;200;Sant Boi de Llobregat;82195;40327;41868;2015
08;Barcelona;201;Sant Boi de Lluçanès;544;264;280;2015
08;Barcelona;203;Sant Cebrià de Vallalta;3326;1734;1592;2015
08;Barcelona;202;Sant Celoni;17317;8582;8735;2015
08;Barcelona;204;Sant Climent de Llobregat;4013;2011;2002;2015
08;Barcelona;205;Sant Cugat del Vallès;87830;42743;45087;2015
08;Barcelona;206;Sant Cugat Sesgarrigues;978;482;496;2015
08;Barcelona;207;Sant Esteve de Palautordera;2568;1272;1296;2015
08;Barcelona;208;Sant Esteve Sesrovires;7613;3805;3808;2015
08;Barcelona;210;Sant Feliu de Codines;5908;2977;2931;2015
08;Barcelona;211;Sant Feliu de Llobregat;43800;21259;22541;2015
08;Barcelona;212;Sant Feliu Sasserra;628;330;298;2015
08;Barcelona;209;Sant Fost de Campsentelles;8603;4298;4305;2015
08;Barcelona;213;Sant Fruitós de Bages;8351;4165;4186;2015
08;Barcelona;215;Sant Hipòlit de Voltregà;3429;1697;1732;2015
08;Barcelona;193;Sant Iscle de Vallalta;1308;672;636;2015
08;Barcelona;216;Sant Jaume de Frontanyà;26;16;10;2015
08;Barcelona;218;Sant Joan de Vilatorrada;10768;5383;5385;2015
08;Barcelona;217;Sant Joan Despí;33264;16264;17000;2015
08;Barcelona;903;Sant Julià de Cerdanyola;242;134;108;2015
08;Barcelona;220;Sant Julià de Vilatorta;3104;1518;1586;2015
08;Barcelona;221;Sant Just Desvern;16631;7918;8713;2015
08;Barcelona;222;Sant Llorenç d'Hortons;2557;1284;1273;2015
08;Barcelona;223;Sant Llorenç Savall;2380;1208;1172;2015
08;Barcelona;225;Sant Martí d'Albars;110;54;56;2015
08;Barcelona;224;Sant Martí de Centelles;1103;562;541;2015
08;Barcelona;226;Sant Martí de Tous;1186;599;587;2015
08;Barcelona;227;Sant Martí Sarroca;3092;1509;1583;2015
08;Barcelona;228;Sant Martí Sesgueioles;378;189;189;2015
08;Barcelona;229;Sant Mateu de Bages;620;314;306;2015
08;Barcelona;231;Sant Pere de Ribes;29666;14906;14760;2015
08;Barcelona;232;Sant Pere de Riudebitlles;2374;1191;1183;2015
08;Barcelona;233;Sant Pere de Torelló;2433;1255;1178;2015
08;Barcelona;234;Sant Pere de Vilamajor;4281;2134;2147;2015
08;Barcelona;189;Sant Pere Sallavinera;167;93;74;2015
08;Barcelona;235;Sant Pol de Mar;5012;2486;2526;2015
08;Barcelona;236;Sant Quintí de Mediona;2116;1074;1042;2015
08;Barcelona;237;Sant Quirze de Besora;2132;1050;1082;2015
08;Barcelona;238;Sant Quirze del Vallès;19602;9619;9983;2015
08;Barcelona;239;Sant Quirze Safaja;622;332;290;2015
08;Barcelona;240;Sant Sadurní d'Anoia;12689;6234;6455;2015
08;Barcelona;241;Sant Sadurní d'Osormort;86;50;36;2015
08;Barcelona;098;Sant Salvador de Guardiola;3126;1583;1543;2015
08;Barcelona;262;Sant Vicenç de Castellet;9246;4584;4662;2015
08;Barcelona;264;Sant Vicenç de Montalt;6049;3053;2996;2015
08;Barcelona;265;Sant Vicenç de Torelló;2001;988;1013;2015
08;Barcelona;263;Sant Vicenç dels Horts;27983;13952;14031;2015
08;Barcelona;243;Santa Cecília de Voltregà;179;94;85;2015
08;Barcelona;244;Santa Coloma de Cervelló;8022;3945;4077;2015
08;Barcelona;245;Santa Coloma de Gramenet;116950;58265;58685;2015
08;Barcelona;246;Santa Eugènia de Berga;2204;1131;1073;2015
08;Barcelona;247;Santa Eulàlia de Riuprimer;1284;645;639;2015
08;Barcelona;248;Santa Eulàlia de Ronçana;7080;3560;3520;2015
08;Barcelona;249;Santa Fe del Penedès;378;190;188;2015
08;Barcelona;250;Santa Margarida de Montbui;9648;4822;4826;2015
08;Barcelona;251;Santa Margarida i els Monjos;7332;3732;3600;2015
08;Barcelona;253;Santa Maria de Besora;158;79;79;2015
08;Barcelona;256;Santa Maria de Martorelles;853;425;428;2015
08;Barcelona;255;Santa Maria de Merlès;185;91;94;2015
08;Barcelona;257;Santa Maria de Miralles;130;68;62;2015
08;Barcelona;259;Santa Maria de Palautordera;9103;4584;4519;2015
08;Barcelona;258;Santa Maria d'Oló;1063;548;515;2015
08;Barcelona;260;Santa Perpètua de Mogoda;25466;12899;12567;2015
08;Barcelona;261;Santa Susanna;3275;1662;1613;2015
08;Barcelona;192;Santpedor;7459;3721;3738;2015
08;Barcelona;267;Sentmenat;8652;4387;4265;2015
08;Barcelona;269;Seva;3434;1750;1684;2015
08;Barcelona;270;Sitges;28269;14082;14187;2015
08;Barcelona;271;Sobremunt;82;35;47;2015
08;Barcelona;272;Sora;184;104;80;2015
08;Barcelona;273;Subirats;2988;1543;1445;2015
08;Barcelona;274;Súria;5927;2858;3069;2015
08;Barcelona;276;Tagamanent;319;170;149;2015
08;Barcelona;277;Talamanca;189;108;81;2015
08;Barcelona;278;Taradell;6262;3126;3136;2015
08;Barcelona;275;Tavèrnoles;319;165;154;2015
08;Barcelona;280;Tavertet;124;70;54;2015
08;Barcelona;281;Teià;6238;3078;3160;2015
08;Barcelona;279;Terrassa;215214;106067;109147;2015
08;Barcelona;282;Tiana;8411;4035;4376;2015
08;Barcelona;283;Tona;8021;3961;4060;2015
08;Barcelona;284;Tordera;16433;8325;8108;2015
08;Barcelona;285;Torelló;13881;6816;7065;2015
08;Barcelona;286;Torre de Claramunt, La;3767;1925;1842;2015
08;Barcelona;287;Torrelavit;1401;741;660;2015
08;Barcelona;288;Torrelles de Foix;2246;1184;1062;2015
08;Barcelona;289;Torrelles de Llobregat;5883;2902;2981;2015
08;Barcelona;290;Ullastrell;2043;1023;1020;2015
08;Barcelona;291;Vacarisses;6143;3175;2968;2015
08;Barcelona;292;Vallbona d'Anoia;1417;732;685;2015
08;Barcelona;293;Vallcebre;255;146;109;2015
08;Barcelona;294;Vallgorguina;2749;1409;1340;2015
08;Barcelona;295;Vallirana;14633;7307;7326;2015
08;Barcelona;296;Vallromanes;2543;1295;1248;2015
08;Barcelona;297;Veciana;175;97;78;2015
08;Barcelona;298;Vic;42498;21146;21352;2015
08;Barcelona;299;Vilada;427;227;200;2015
08;Barcelona;301;Viladecans;65549;32541;33008;2015
08;Barcelona;300;Viladecavalls;7365;3685;3680;2015
08;Barcelona;305;Vilafranca del Penedès;39224;19282;19942;2015
08;Barcelona;306;Vilalba Sasserra;709;352;357;2015
08;Barcelona;303;Vilanova de Sau;312;157;155;2015
08;Barcelona;302;Vilanova del Camí;12452;6250;6202;2015
08;Barcelona;902;Vilanova del Vallès;5241;2661;2580;2015
08;Barcelona;307;Vilanova i la Geltrú;65684;31821;33863;2015
08;Barcelona;214;Vilassar de Dalt;8964;4406;4558;2015
08;Barcelona;219;Vilassar de Mar;20447;9860;10587;2015
08;Barcelona;304;Vilobí del Penedès;1085;564;521;2015
08;Barcelona;308;Viver i Serrateix;168;90;78;2015
48;Bizkaia;001;Abadiño;7516;3745;3771;2015
48;Bizkaia;002;Abanto y Ciérvana-Abanto Zierbena;9635;4754;4881;2015
48;Bizkaia;911;Ajangiz;459;236;223;2015
48;Bizkaia;912;Alonsotegi;2856;1402;1454;2015
48;Bizkaia;003;Amorebieta-Etxano;18736;9215;9521;2015
48;Bizkaia;004;Amoroto;410;212;198;2015
48;Bizkaia;005;Arakaldo;157;78;79;2015
48;Bizkaia;006;Arantzazu;382;188;194;2015
48;Bizkaia;093;Areatza;1195;575;620;2015
48;Bizkaia;009;Arrankudiaga;973;478;495;2015
48;Bizkaia;914;Arratzu;406;200;206;2015
48;Bizkaia;010;Arrieta;572;294;278;2015
48;Bizkaia;011;Arrigorriaga;12339;6008;6331;2015
48;Bizkaia;023;Artea;768;385;383;2015
48;Bizkaia;008;Artzentales;730;387;343;2015
48;Bizkaia;091;Atxondo;1378;693;685;2015
48;Bizkaia;070;Aulesti;658;330;328;2015
48;Bizkaia;012;Bakio;2589;1319;1270;2015
48;Bizkaia;090;Balmaseda;7800;3814;3986;2015
48;Bizkaia;013;Barakaldo;100228;48446;51782;2015
48;Bizkaia;014;Barrika;1539;758;781;2015
48;Bizkaia;015;Basauri;41304;20073;21231;2015
48;Bizkaia;092;Bedia;1022;485;537;2015
48;Bizkaia;016;Berango;6961;3399;3562;2015
48;Bizkaia;017;Bermeo;16947;8383;8564;2015
48;Bizkaia;018;Berriatua;1220;659;561;2015
48;Bizkaia;019;Berriz;4778;2386;2392;2015
48;Bizkaia;020;Bilbao;345141;162564;182577;2015
48;Bizkaia;021;Busturia;1687;839;848;2015
48;Bizkaia;901;Derio;6022;2936;3086;2015
48;Bizkaia;026;Dima;1424;728;696;2015
48;Bizkaia;027;Durango;28899;14130;14769;2015
48;Bizkaia;028;Ea;844;428;416;2015
48;Bizkaia;031;Elantxobe;384;188;196;2015
48;Bizkaia;032;Elorrio;7271;3620;3651;2015
48;Bizkaia;902;Erandio;24234;11873;12361;2015
48;Bizkaia;033;Ereño;252;132;120;2015
48;Bizkaia;034;Ermua;16048;8048;8000;2015
48;Bizkaia;079;Errigoiti;507;280;227;2015
48;Bizkaia;029;Etxebarri;10881;5440;5441;2015
48;Bizkaia;030;Etxebarria;787;399;388;2015
48;Bizkaia;906;Forua;947;475;472;2015
48;Bizkaia;035;Fruiz;547;278;269;2015
48;Bizkaia;036;Galdakao;29344;14461;14883;2015
48;Bizkaia;037;Galdames;813;424;389;2015
48;Bizkaia;038;Gamiz-Fika;1344;669;675;2015
48;Bizkaia;039;Garai;313;156;157;2015
48;Bizkaia;040;Gatika;1653;836;817;2015
48;Bizkaia;041;Gautegiz Arteaga;858;428;430;2015
48;Bizkaia;046;Gernika-Lumo;16763;8079;8684;2015
48;Bizkaia;044;Getxo;78846;37043;41803;2015
48;Bizkaia;047;Gizaburuaga;213;110;103;2015
48;Bizkaia;042;Gordexola;1710;869;841;2015
48;Bizkaia;043;Gorliz;5670;2827;2843;2015
48;Bizkaia;045;Güeñes;6578;3216;3362;2015
48;Bizkaia;048;Ibarrangelu;640;323;317;2015
48;Bizkaia;094;Igorre;4241;2062;2179;2015
48;Bizkaia;049;Ispaster;702;373;329;2015
48;Bizkaia;910;Iurreta;3753;1858;1895;2015
48;Bizkaia;050;Izurtza;254;142;112;2015
48;Bizkaia;022;Karrantza Harana/Valle de Carranza;2749;1422;1327;2015
48;Bizkaia;907;Kortezubi;467;230;237;2015
48;Bizkaia;051;Lanestosa;271;138;133;2015
48;Bizkaia;052;Larrabetzu;2046;990;1056;2015
48;Bizkaia;053;Laukiz;1145;571;574;2015
48;Bizkaia;054;Leioa;30715;14973;15742;2015
48;Bizkaia;057;Lekeitio;7229;3564;3665;2015
48;Bizkaia;055;Lemoa;3505;1773;1732;2015
48;Bizkaia;056;Lemoiz;1215;641;574;2015
48;Bizkaia;081;Lezama;2406;1189;1217;2015
48;Bizkaia;903;Loiu;2392;1175;1217;2015
48;Bizkaia;058;Mallabia;1215;611;604;2015
48;Bizkaia;059;Mañaria;527;270;257;2015
48;Bizkaia;060;Markina-Xemein;4969;2547;2422;2015
48;Bizkaia;061;Maruri-Jatabe;955;485;470;2015
48;Bizkaia;062;Mendata;381;199;182;2015
48;Bizkaia;063;Mendexa;463;239;224;2015
48;Bizkaia;064;Meñaka;734;377;357;2015
48;Bizkaia;066;Morga;420;219;201;2015
48;Bizkaia;068;Mundaka;1892;912;980;2015
48;Bizkaia;069;Mungia;17131;8348;8783;2015
48;Bizkaia;007;Munitibar-Arbatzegi Gerrikaitz;461;247;214;2015
48;Bizkaia;908;Murueta;310;163;147;2015
48;Bizkaia;071;Muskiz;7601;3767;3834;2015
48;Bizkaia;067;Muxika;1450;739;711;2015
48;Bizkaia;909;Nabarniz;237;121;116;2015
48;Bizkaia;073;Ondarroa;8527;4304;4223;2015
48;Bizkaia;075;Orozko;2611;1287;1324;2015
48;Bizkaia;083;Ortuella;8415;4116;4299;2015
48;Bizkaia;072;Otxandio;1272;647;625;2015
48;Bizkaia;077;Plentzia;4338;2117;2221;2015
48;Bizkaia;078;Portugalete;46718;22337;24381;2015
48;Bizkaia;082;Santurtzi;46284;22415;23869;2015
48;Bizkaia;084;Sestao;28052;13598;14454;2015
48;Bizkaia;904;Sondika;4535;2186;2349;2015
48;Bizkaia;085;Sopela;13211;6486;6725;2015
48;Bizkaia;086;Sopuerta;2599;1311;1288;2015
48;Bizkaia;076;Sukarrieta;373;190;183;2015
48;Bizkaia;087;Trucios-Turtzioz;513;278;235;2015
48;Bizkaia;088;Ubide;179;90;89;2015
48;Bizkaia;065;Ugao-Miraballes;4122;2065;2057;2015
48;Bizkaia;089;Urduliz;4070;2022;2048;2015
48;Bizkaia;074;Urduña/Orduña;4186;2132;2054;2015
48;Bizkaia;080;Valle de Trápaga-Trapagaran;12093;5916;6177;2015
48;Bizkaia;095;Zaldibar;3063;1534;1529;2015
48;Bizkaia;096;Zalla;8477;4164;4313;2015
48;Bizkaia;905;Zamudio;3244;1586;1658;2015
48;Bizkaia;097;Zaratamo;1613;800;813;2015
48;Bizkaia;024;Zeanuri;1258;642;616;2015
48;Bizkaia;025;Zeberio;1081;537;544;2015
48;Bizkaia;913;Zierbena;1493;793;700;2015
48;Bizkaia;915;Ziortza-Bolibar;434;233;201;2015
09;Burgos;001;Abajas;29;18;11;2015
09;Burgos;003;Adrada de Haza;221;117;104;2015
09;Burgos;006;Aguas Cándidas;58;35;23;2015
09;Burgos;007;Aguilar de Bureba;68;39;29;2015
09;Burgos;009;Albillos;221;118;103;2015
09;Burgos;010;Alcocero de Mola;33;24;9;2015
09;Burgos;011;Alfoz de Bricia;74;47;27;2015
09;Burgos;907;Alfoz de Quintanadueñas;2019;1089;930;2015
09;Burgos;012;Alfoz de Santa Gadea;105;61;44;2015
09;Burgos;013;Altable;51;28;23;2015
09;Burgos;014;Altos, Los;190;112;78;2015
09;Burgos;016;Ameyugo;103;59;44;2015
09;Burgos;017;Anguix;134;75;59;2015
09;Burgos;018;Aranda de Duero;32880;16055;16825;2015
09;Burgos;019;Arandilla;172;103;69;2015
09;Burgos;020;Arauzo de Miel;350;184;166;2015
09;Burgos;021;Arauzo de Salce;60;35;25;2015
09;Burgos;022;Arauzo de Torre;78;43;35;2015
09;Burgos;023;Arcos;1566;837;729;2015
09;Burgos;024;Arenillas de Riopisuerga;179;102;77;2015
09;Burgos;025;Arija;146;76;70;2015
09;Burgos;026;Arlanzón;429;258;171;2015
09;Burgos;027;Arraya de Oca;45;27;18;2015
09;Burgos;029;Atapuerca;187;106;81;2015
09;Burgos;030;Ausines, Los;126;78;48;2015
09;Burgos;032;Avellanosa de Muñó;115;61;54;2015
09;Burgos;033;Bahabón de Esgueva;89;55;34;2015
09;Burgos;034;Balbases, Los;323;173;150;2015
09;Burgos;035;Baños de Valdearados;361;213;148;2015
09;Burgos;036;Bañuelos de Bureba;37;22;15;2015
09;Burgos;037;Barbadillo de Herreros;116;69;47;2015
09;Burgos;038;Barbadillo del Mercado;129;71;58;2015
09;Burgos;039;Barbadillo del Pez;77;45;32;2015
09;Burgos;041;Barrio de Muñó;32;17;15;2015
09;Burgos;043;Barrios de Bureba, Los;199;122;77;2015
09;Burgos;044;Barrios de Colina;52;26;26;2015
09;Burgos;045;Basconcillos del Tozo;291;168;123;2015
09;Burgos;046;Bascuñana;35;22;13;2015
09;Burgos;047;Belbimbre;69;36;33;2015
09;Burgos;048;Belorado;1969;1020;949;2015
09;Burgos;050;Berberana;74;37;37;2015
09;Burgos;051;Berlangas de Roa;185;96;89;2015
09;Burgos;052;Berzosa de Bureba;32;23;9;2015
09;Burgos;054;Bozoó;105;61;44;2015
09;Burgos;055;Brazacorta;73;40;33;2015
09;Burgos;056;Briviesca;7129;3606;3523;2015
09;Burgos;057;Bugedo;175;112;63;2015
09;Burgos;058;Buniel;516;285;231;2015
09;Burgos;059;Burgos;177100;84478;92622;2015
09;Burgos;060;Busto de Bureba;164;89;75;2015
09;Burgos;061;Cabañes de Esgueva;180;96;84;2015
09;Burgos;062;Cabezón de la Sierra;66;27;39;2015
09;Burgos;064;Caleruega;470;232;238;2015
09;Burgos;065;Campillo de Aranda;178;103;75;2015
09;Burgos;066;Campolara;74;52;22;2015
09;Burgos;067;Canicosa de la Sierra;514;274;240;2015
09;Burgos;068;Cantabrana;31;18;13;2015
09;Burgos;070;Carazo;34;24;10;2015
09;Burgos;071;Carcedo de Bureba;50;28;22;2015
09;Burgos;072;Carcedo de Burgos;388;216;172;2015
09;Burgos;073;Cardeñadijo;1295;716;579;2015
09;Burgos;074;Cardeñajimeno;1019;534;485;2015
09;Burgos;075;Cardeñuela Riopico;127;73;54;2015
09;Burgos;076;Carrias;23;20;3;2015
09;Burgos;077;Cascajares de Bureba;36;17;19;2015
09;Burgos;078;Cascajares de la Sierra;39;20;19;2015
09;Burgos;079;Castellanos de Castro;48;30;18;2015
09;Burgos;083;Castil de Peones;37;20;17;2015
09;Burgos;082;Castildelgado;43;25;18;2015
09;Burgos;084;Castrillo de la Reina;209;132;77;2015
09;Burgos;085;Castrillo de la Vega;636;340;296;2015
09;Burgos;088;Castrillo de Riopisuerga;61;39;22;2015
09;Burgos;086;Castrillo del Val;839;504;335;2015
09;Burgos;090;Castrillo Matajudíos;58;32;26;2015
09;Burgos;091;Castrojeriz;845;437;408;2015
09;Burgos;063;Cavia;247;146;101;2015
09;Burgos;093;Cayuela;180;98;82;2015
09;Burgos;094;Cebrecos;47;30;17;2015
09;Burgos;095;Celada del Camino;97;51;46;2015
09;Burgos;098;Cerezo de Río Tirón;598;322;276;2015
09;Burgos;100;Cerratón de Juarros;55;37;18;2015
09;Burgos;101;Ciadoncha;81;47;34;2015
09;Burgos;102;Cillaperlata;37;25;12;2015
09;Burgos;103;Cilleruelo de Abajo;237;129;108;2015
09;Burgos;104;Cilleruelo de Arriba;59;31;28;2015
09;Burgos;105;Ciruelos de Cervera;111;61;50;2015
09;Burgos;108;Cogollos;451;249;202;2015
09;Burgos;109;Condado de Treviño;1362;782;580;2015
09;Burgos;110;Contreras;82;50;32;2015
09;Burgos;112;Coruña del Conde;124;78;46;2015
09;Burgos;113;Covarrubias;585;312;273;2015
09;Burgos;114;Cubillo del Campo;100;54;46;2015
09;Burgos;115;Cubo de Bureba;103;59;44;2015
09;Burgos;117;Cueva de Roa, La;99;50;49;2015
09;Burgos;119;Cuevas de San Clemente;49;17;32;2015
09;Burgos;120;Encío;46;25;21;2015
09;Burgos;122;Espinosa de Cervera;100;60;40;2015
09;Burgos;124;Espinosa de los Monteros;1788;945;843;2015
09;Burgos;123;Espinosa del Camino;44;26;18;2015
09;Burgos;125;Estépar;664;396;268;2015
09;Burgos;127;Fontioso;54;30;24;2015
09;Burgos;128;Frandovínez;99;57;42;2015
09;Burgos;129;Fresneda de la Sierra Tirón;123;85;38;2015
09;Burgos;130;Fresneña;87;48;39;2015
09;Burgos;131;Fresnillo de las Dueñas;636;336;300;2015
09;Burgos;132;Fresno de Río Tirón;195;109;86;2015
09;Burgos;133;Fresno de Rodilla;49;28;21;2015
09;Burgos;134;Frías;265;143;122;2015
09;Burgos;135;Fuentebureba;54;27;27;2015
09;Burgos;136;Fuentecén;222;124;98;2015
09;Burgos;137;Fuentelcésped;213;104;109;2015
09;Burgos;138;Fuentelisendo;96;55;41;2015
09;Burgos;139;Fuentemolinos;97;62;35;2015
09;Burgos;140;Fuentenebro;139;84;55;2015
09;Burgos;141;Fuentespina;769;404;365;2015
09;Burgos;143;Galbarros;29;20;9;2015
09;Burgos;144;Gallega, La;54;32;22;2015
09;Burgos;148;Grijalba;104;53;51;2015
09;Burgos;149;Grisaleña;39;28;11;2015
09;Burgos;151;Gumiel de Izán;577;332;245;2015
09;Burgos;152;Gumiel de Mercado;344;190;154;2015
09;Burgos;154;Hacinas;166;93;73;2015
09;Burgos;155;Haza;26;15;11;2015
09;Burgos;159;Hontanas;67;42;25;2015
09;Burgos;160;Hontangas;106;65;41;2015
09;Burgos;162;Hontoria de la Cantera;157;86;71;2015
09;Burgos;164;Hontoria de Valdearados;201;124;77;2015
09;Burgos;163;Hontoria del Pinar;707;388;319;2015
09;Burgos;166;Hormazas, Las;106;62;44;2015
09;Burgos;167;Hornillos del Camino;56;32;24;2015
09;Burgos;168;Horra, La;366;190;176;2015
09;Burgos;169;Hortigüela;103;63;40;2015
09;Burgos;170;Hoyales de Roa;211;109;102;2015
09;Burgos;172;Huérmeces;131;63;68;2015
09;Burgos;173;Huerta de Arriba;128;73;55;2015
09;Burgos;174;Huerta de Rey;1007;542;465;2015
09;Burgos;175;Humada;130;83;47;2015
09;Burgos;176;Hurones;73;45;28;2015
09;Burgos;177;Ibeas de Juarros;1400;778;622;2015
09;Burgos;178;Ibrillos;55;31;24;2015
09;Burgos;179;Iglesiarrubia;44;25;19;2015
09;Burgos;180;Iglesias;140;78;62;2015
09;Burgos;181;Isar;331;169;162;2015
09;Burgos;182;Itero del Castillo;84;46;38;2015
09;Burgos;183;Jaramillo de la Fuente;52;30;22;2015
09;Burgos;184;Jaramillo Quemado;5;3;2;2015
09;Burgos;189;Junta de Traslaloma;136;72;64;2015
09;Burgos;190;Junta de Villalba de Losa;89;49;40;2015
09;Burgos;191;Jurisdicción de Lara;47;25;22;2015
09;Burgos;192;Jurisdicción de San Zadornil;51;27;24;2015
09;Burgos;194;Lerma;2703;1345;1358;2015
09;Burgos;195;Llano de Bureba;63;38;25;2015
09;Burgos;196;Madrigal del Monte;169;103;66;2015
09;Burgos;197;Madrigalejo del Monte;181;114;67;2015
09;Burgos;198;Mahamud;123;70;53;2015
09;Burgos;199;Mambrilla de Castrejón;100;53;47;2015
09;Burgos;200;Mambrillas de Lara;48;27;21;2015
09;Burgos;201;Mamolar;31;22;9;2015
09;Burgos;202;Manciles;19;12;7;2015
09;Burgos;206;Mazuela;63;34;29;2015
09;Burgos;208;Mecerreyes;259;134;125;2015
09;Burgos;209;Medina de Pomar;5983;3040;2943;2015
09;Burgos;211;Melgar de Fernamental;1744;952;792;2015
09;Burgos;213;Merindad de Cuesta-Urria;366;195;171;2015
09;Burgos;214;Merindad de Montija;803;474;329;2015
09;Burgos;906;Merindad de Río Ubierna;1456;800;656;2015
09;Burgos;215;Merindad de Sotoscueva;436;244;192;2015
09;Burgos;216;Merindad de Valdeporres;440;229;211;2015
09;Burgos;217;Merindad de Valdivielso;400;230;170;2015
09;Burgos;218;Milagros;460;249;211;2015
09;Burgos;219;Miranda de Ebro;36173;17798;18375;2015
09;Burgos;220;Miraveche;79;52;27;2015
09;Burgos;221;Modúbar de la Emparedada;597;335;262;2015
09;Burgos;223;Monasterio de la Sierra;48;32;16;2015
09;Burgos;224;Monasterio de Rodilla;181;98;83;2015
09;Burgos;225;Moncalvillo;86;51;35;2015
09;Burgos;226;Monterrubio de la Demanda;64;36;28;2015
09;Burgos;227;Montorio;162;86;76;2015
09;Burgos;228;Moradillo de Roa;192;100;92;2015
09;Burgos;229;Nava de Roa;221;113;108;2015
09;Burgos;230;Navas de Bureba;35;15;20;2015
09;Burgos;231;Nebreda;70;49;21;2015
09;Burgos;232;Neila;173;100;73;2015
09;Burgos;235;Olmedillo de Roa;199;116;83;2015
09;Burgos;236;Olmillos de Muñó;38;22;16;2015
09;Burgos;238;Oña;1088;568;520;2015
09;Burgos;239;Oquillas;59;35;24;2015
09;Burgos;241;Orbaneja Riopico;243;128;115;2015
09;Burgos;242;Padilla de Abajo;89;52;37;2015
09;Burgos;243;Padilla de Arriba;78;49;29;2015
09;Burgos;244;Padrones de Bureba;52;25;27;2015
09;Burgos;246;Palacios de la Sierra;744;372;372;2015
09;Burgos;247;Palacios de Riopisuerga;28;14;14;2015
09;Burgos;248;Palazuelos de la Sierra;79;45;34;2015
09;Burgos;249;Palazuelos de Muñó;54;29;25;2015
09;Burgos;250;Pampliega;332;176;156;2015
09;Burgos;251;Pancorbo;453;251;202;2015
09;Burgos;253;Pardilla;126;72;54;2015
09;Burgos;255;Partido de la Sierra en Tobalina;84;50;34;2015
09;Burgos;256;Pedrosa de Duero;455;251;204;2015
09;Burgos;259;Pedrosa de Río Úrbel;249;151;98;2015
09;Burgos;257;Pedrosa del Páramo;103;60;43;2015
09;Burgos;258;Pedrosa del Príncipe;175;92;83;2015
09;Burgos;261;Peñaranda de Duero;552;286;266;2015
09;Burgos;262;Peral de Arlanza;163;87;76;2015
09;Burgos;265;Piérnigas;40;25;15;2015
09;Burgos;266;Pineda de la Sierra;101;62;39;2015
09;Burgos;267;Pineda Trasmonte;126;79;47;2015
09;Burgos;268;Pinilla de los Barruecos;111;65;46;2015
09;Burgos;269;Pinilla de los Moros;42;26;16;2015
09;Burgos;270;Pinilla Trasmonte;176;100;76;2015
09;Burgos;272;Poza de la Sal;337;175;162;2015
09;Burgos;273;Prádanos de Bureba;58;35;23;2015
09;Burgos;274;Pradoluengo;1282;638;644;2015
09;Burgos;275;Presencio;195;114;81;2015
09;Burgos;276;Puebla de Arganzón, La;519;283;236;2015
09;Burgos;277;Puentedura;129;86;43;2015
09;Burgos;279;Quemada;259;152;107;2015
09;Burgos;281;Quintana del Pidio;164;81;83;2015
09;Burgos;280;Quintanabureba;30;18;12;2015
09;Burgos;283;Quintanaélez;52;27;25;2015
09;Burgos;287;Quintanaortuño;281;153;128;2015
09;Burgos;288;Quintanapalla;110;63;47;2015
09;Burgos;289;Quintanar de la Sierra;1845;973;872;2015
09;Burgos;292;Quintanavides;96;57;39;2015
09;Burgos;294;Quintanilla de la Mata;130;79;51;2015
09;Burgos;901;Quintanilla del Agua y Tordueles;419;216;203;2015
09;Burgos;295;Quintanilla del Coco;61;29;32;2015
09;Burgos;298;Quintanilla San García;88;48;40;2015
09;Burgos;301;Quintanilla Vivar;766;408;358;2015
09;Burgos;297;Quintanillas, Las;391;222;169;2015
09;Burgos;302;Rabanera del Pinar;121;72;49;2015
09;Burgos;303;Rábanos;96;56;40;2015
09;Burgos;304;Rabé de las Calzadas;228;119;109;2015
09;Burgos;306;Rebolledo de la Torre;122;64;58;2015
09;Burgos;307;Redecilla del Camino;136;81;55;2015
09;Burgos;308;Redecilla del Campo;71;42;29;2015
09;Burgos;309;Regumiel de la Sierra;367;187;180;2015
09;Burgos;310;Reinoso;11;8;3;2015
09;Burgos;311;Retuerta;65;40;25;2015
09;Burgos;314;Revilla del Campo;96;64;32;2015
09;Burgos;316;Revilla Vallejera;115;76;39;2015
09;Burgos;312;Revilla y Ahedo, La;114;63;51;2015
09;Burgos;315;Revillarruz;512;266;246;2015
09;Burgos;317;Rezmondo;15;6;9;2015
09;Burgos;318;Riocavado de la Sierra;59;36;23;2015
09;Burgos;321;Roa;2373;1221;1152;2015
09;Burgos;323;Rojas;72;47;25;2015
09;Burgos;325;Royuela de Río Franco;212;126;86;2015
09;Burgos;326;Rubena;176;103;73;2015
09;Burgos;327;Rublacedo de Abajo;37;21;16;2015
09;Burgos;328;Rucandio;77;38;39;2015
09;Burgos;329;Salas de Bureba;133;81;52;2015
09;Burgos;330;Salas de los Infantes;2091;1074;1017;2015
09;Burgos;332;Saldaña de Burgos;203;111;92;2015
09;Burgos;334;Salinillas de Bureba;48;37;11;2015
09;Burgos;335;San Adrián de Juarros;93;55;38;2015
09;Burgos;337;San Juan del Monte;139;81;58;2015
09;Burgos;338;San Mamés de Burgos;286;161;125;2015
09;Burgos;339;San Martín de Rubiales;142;80;62;2015
09;Burgos;340;San Millán de Lara;78;54;24;2015
09;Burgos;360;San Vicente del Valle;29;19;10;2015
09;Burgos;343;Santa Cecilia;105;63;42;2015
09;Burgos;345;Santa Cruz de la Salceda;152;88;64;2015
09;Burgos;346;Santa Cruz del Valle Urbión;103;63;40;2015
09;Burgos;347;Santa Gadea del Cid;155;84;71;2015
09;Burgos;348;Santa Inés;155;78;77;2015
09;Burgos;350;Santa María del Campo;595;324;271;2015
09;Burgos;351;Santa María del Invierno;63;44;19;2015
09;Burgos;352;Santa María del Mercadillo;114;68;46;2015
09;Burgos;353;Santa María Rivarredonda;94;58;36;2015
09;Burgos;354;Santa Olalla de Bureba;33;24;9;2015
09;Burgos;355;Santibáñez de Esgueva;99;54;45;2015
09;Burgos;356;Santibáñez del Val;50;30;20;2015
09;Burgos;358;Santo Domingo de Silos;287;175;112;2015
09;Burgos;361;Sargentes de la Lora;129;73;56;2015
09;Burgos;362;Sarracín;246;140;106;2015
09;Burgos;363;Sasamón;1073;602;471;2015
09;Burgos;365;Sequera de Haza, La;34;22;12;2015
09;Burgos;366;Solarana;93;48;45;2015
09;Burgos;368;Sordillos;24;15;9;2015
09;Burgos;369;Sotillo de la Ribera;520;274;246;2015
09;Burgos;372;Sotragero;286;154;132;2015
09;Burgos;373;Sotresgudo;482;276;206;2015
09;Burgos;374;Susinos del Páramo;103;67;36;2015
09;Burgos;375;Tamarón;38;20;18;2015
09;Burgos;377;Tardajos;803;417;386;2015
09;Burgos;378;Tejada;28;20;8;2015
09;Burgos;380;Terradillos de Esgueva;86;39;47;2015
09;Burgos;381;Tinieblas de la Sierra;37;21;16;2015
09;Burgos;382;Tobar;27;16;11;2015
09;Burgos;384;Tordómar;343;190;153;2015
09;Burgos;386;Torrecilla del Monte;69;38;31;2015
09;Burgos;387;Torregalindo;136;84;52;2015
09;Burgos;388;Torrelara;37;20;17;2015
09;Burgos;389;Torrepadre;78;45;33;2015
09;Burgos;390;Torresandino;691;373;318;2015
09;Burgos;391;Tórtoles de Esgueva;498;260;238;2015
09;Burgos;392;Tosantos;56;32;24;2015
09;Burgos;394;Trespaderne;877;462;415;2015
09;Burgos;395;Tubilla del Agua;154;96;58;2015
09;Burgos;396;Tubilla del Lago;150;83;67;2015
09;Burgos;398;Úrbel del Castillo;79;53;26;2015
09;Burgos;400;Vadocondes;382;210;172;2015
09;Burgos;403;Valdeande;100;66;34;2015
09;Burgos;405;Valdezate;140;74;66;2015
09;Burgos;406;Valdorros;332;186;146;2015
09;Burgos;408;Vallarta de Bureba;45;28;17;2015
09;Burgos;904;Valle de las Navas;533;309;224;2015
09;Burgos;908;Valle de Losa;538;319;219;2015
09;Burgos;409;Valle de Manzanedo;132;71;61;2015
09;Burgos;410;Valle de Mena;3826;1955;1871;2015
09;Burgos;411;Valle de Oca;159;99;60;2015
09;Burgos;902;Valle de Santibáñez;505;281;224;2015
09;Burgos;905;Valle de Sedano;472;273;199;2015
09;Burgos;412;Valle de Tobalina;1026;559;467;2015
09;Burgos;413;Valle de Valdebezana;506;270;236;2015
09;Burgos;414;Valle de Valdelaguna;213;122;91;2015
09;Burgos;415;Valle de Valdelucio;309;163;146;2015
09;Burgos;416;Valle de Zamanzas;68;35;33;2015
09;Burgos;417;Vallejera;42;25;17;2015
09;Burgos;418;Valles de Palenzuela;89;45;44;2015
09;Burgos;419;Valluércanes;77;51;26;2015
09;Burgos;407;Valmala;28;15;13;2015
09;Burgos;422;Vid de Bureba, La;20;9;11;2015
09;Burgos;421;Vid y Barrios, La;274;155;119;2015
09;Burgos;423;Vileña;29;18;11;2015
09;Burgos;427;Villadiego;1593;870;723;2015
09;Burgos;428;Villaescusa de Roa;113;63;50;2015
09;Burgos;429;Villaescusa la Sombría;69;49;20;2015
09;Burgos;430;Villaespasa;26;15;11;2015
09;Burgos;431;Villafranca Montes de Oca;129;78;51;2015
09;Burgos;432;Villafruela;209;118;91;2015
09;Burgos;433;Villagalijo;66;43;23;2015
09;Burgos;434;Villagonzalo Pedernales;1774;930;844;2015
09;Burgos;437;Villahoz;320;174;146;2015
09;Burgos;438;Villalba de Duero;683;358;325;2015
09;Burgos;439;Villalbilla de Burgos;1279;675;604;2015
09;Burgos;440;Villalbilla de Gumiel;93;56;37;2015
09;Burgos;441;Villaldemiro;68;39;29;2015
09;Burgos;442;Villalmanzo;450;243;207;2015
09;Burgos;443;Villamayor de los Montes;202;101;101;2015
09;Burgos;444;Villamayor de Treviño;76;37;39;2015
09;Burgos;445;Villambistia;46;32;14;2015
09;Burgos;446;Villamedianilla;12;7;5;2015
09;Burgos;447;Villamiel de la Sierra;40;24;16;2015
09;Burgos;448;Villangómez;239;147;92;2015
09;Burgos;449;Villanueva de Argaño;106;65;41;2015
09;Burgos;450;Villanueva de Carazo;32;21;11;2015
09;Burgos;451;Villanueva de Gumiel;284;143;141;2015
09;Burgos;454;Villanueva de Teba;48;30;18;2015
09;Burgos;455;Villaquirán de la Puebla;47;27;20;2015
09;Burgos;456;Villaquirán de los Infantes;146;77;69;2015
09;Burgos;903;Villarcayo de Merindad de Castilla la Vieja;4372;2259;2113;2015
09;Burgos;458;Villariezo;612;340;272;2015
09;Burgos;460;Villasandino;192;115;77;2015
09;Burgos;463;Villasur de Herreros;265;151;114;2015
09;Burgos;464;Villatuelda;43;24;19;2015
09;Burgos;466;Villaverde del Monte;134;76;58;2015
09;Burgos;467;Villaverde-Mogina;86;57;29;2015
09;Burgos;471;Villayerno Morquillas;207;110;97;2015
09;Burgos;472;Villazopeque;57;36;21;2015
09;Burgos;473;Villegas;90;51;39;2015
09;Burgos;476;Villoruebo;85;53;32;2015
09;Burgos;424;Viloria de Rioja;39;23;16;2015
09;Burgos;425;Vilviestre del Pinar;616;337;279;2015
09;Burgos;478;Vizcaínos;49;31;18;2015
09;Burgos;480;Zael;115;59;56;2015
09;Burgos;482;Zarzosa de Río Pisuerga;31;19;12;2015
09;Burgos;483;Zazuar;242;128;114;2015
09;Burgos;485;Zuñeda;57;35;22;2015
10;Cáceres;001;Abadía;336;188;148;2015
10;Cáceres;002;Abertura;429;214;215;2015
10;Cáceres;003;Acebo;569;290;279;2015
10;Cáceres;004;Acehúche;822;402;420;2015
10;Cáceres;005;Aceituna;623;323;300;2015
10;Cáceres;006;Ahigal;1421;742;679;2015
10;Cáceres;903;Alagón del Río;923;468;455;2015
10;Cáceres;007;Albalá;730;366;364;2015
10;Cáceres;008;Alcántara;1571;782;789;2015
10;Cáceres;009;Alcollarín;256;123;133;2015
10;Cáceres;010;Alcuéscar;2759;1425;1334;2015
10;Cáceres;012;Aldea del Cano;667;316;351;2015
10;Cáceres;013;Aldea del Obispo, La;331;174;157;2015
10;Cáceres;011;Aldeacentenera;646;331;315;2015
10;Cáceres;014;Aldeanueva de la Vera;2155;1051;1104;2015
10;Cáceres;015;Aldeanueva del Camino;791;383;408;2015
10;Cáceres;016;Aldehuela de Jerte;367;200;167;2015
10;Cáceres;017;Alía;936;466;470;2015
10;Cáceres;018;Aliseda;1957;983;974;2015
10;Cáceres;019;Almaraz;1669;855;814;2015
10;Cáceres;020;Almoharín;1933;948;985;2015
10;Cáceres;021;Arroyo de la Luz;6042;2996;3046;2015
10;Cáceres;023;Arroyomolinos;787;420;367;2015
10;Cáceres;022;Arroyomolinos de la Vera;471;238;233;2015
10;Cáceres;024;Baños de Montemayor;774;372;402;2015
10;Cáceres;025;Barrado;434;224;210;2015
10;Cáceres;026;Belvís de Monroy;650;337;313;2015
10;Cáceres;027;Benquerencia;80;44;36;2015
10;Cáceres;028;Berrocalejo;125;66;59;2015
10;Cáceres;029;Berzocana;461;236;225;2015
10;Cáceres;030;Bohonal de Ibor;499;253;246;2015
10;Cáceres;031;Botija;189;101;88;2015
10;Cáceres;032;Brozas;1953;977;976;2015
10;Cáceres;033;Cabañas del Castillo;470;253;217;2015
10;Cáceres;034;Cabezabellosa;381;198;183;2015
10;Cáceres;035;Cabezuela del Valle;2267;1170;1097;2015
10;Cáceres;036;Cabrero;356;196;160;2015
10;Cáceres;037;Cáceres;95617;45947;49670;2015
10;Cáceres;038;Cachorrilla;93;49;44;2015
10;Cáceres;039;Cadalso;468;233;235;2015
10;Cáceres;040;Calzadilla;501;256;245;2015
10;Cáceres;041;Caminomorisco;1268;667;601;2015
10;Cáceres;042;Campillo de Deleitosa;52;22;30;2015
10;Cáceres;043;Campo Lugar;916;459;457;2015
10;Cáceres;044;Cañamero;1709;898;811;2015
10;Cáceres;045;Cañaveral;1081;530;551;2015
10;Cáceres;046;Carbajo;217;109;108;2015
10;Cáceres;047;Carcaboso;1136;572;564;2015
10;Cáceres;048;Carrascalejo;257;126;131;2015
10;Cáceres;049;Casar de Cáceres;4664;2313;2351;2015
10;Cáceres;050;Casar de Palomero;1245;631;614;2015
10;Cáceres;051;Casares de las Hurdes;449;233;216;2015
10;Cáceres;052;Casas de Don Antonio;204;101;103;2015
10;Cáceres;053;Casas de Don Gómez;301;160;141;2015
10;Cáceres;056;Casas de Millán;653;331;322;2015
10;Cáceres;057;Casas de Miravete;157;101;56;2015
10;Cáceres;054;Casas del Castañar;604;295;309;2015
10;Cáceres;055;Casas del Monte;828;416;412;2015
10;Cáceres;058;Casatejada;1428;737;691;2015
10;Cáceres;059;Casillas de Coria;416;200;216;2015
10;Cáceres;060;Castañar de Ibor;1112;571;541;2015
10;Cáceres;061;Ceclavín;1943;988;955;2015
10;Cáceres;062;Cedillo;490;254;236;2015
10;Cáceres;063;Cerezo;186;89;97;2015
10;Cáceres;064;Cilleros;1757;889;868;2015
10;Cáceres;065;Collado de la Vera;181;100;81;2015
10;Cáceres;066;Conquista de la Sierra;191;110;81;2015
10;Cáceres;067;Coria;12930;6353;6577;2015
10;Cáceres;068;Cuacos de Yuste;865;444;421;2015
10;Cáceres;069;Cumbre, La;914;460;454;2015
10;Cáceres;070;Deleitosa;775;392;383;2015
10;Cáceres;071;Descargamaría;147;83;64;2015
10;Cáceres;072;Eljas;941;478;463;2015
10;Cáceres;073;Escurial;755;399;356;2015
10;Cáceres;075;Fresnedoso de Ibor;293;156;137;2015
10;Cáceres;076;Galisteo;992;485;507;2015
10;Cáceres;077;Garciaz;804;422;382;2015
10;Cáceres;079;Garganta la Olla;1010;528;482;2015
10;Cáceres;078;Garganta, La;446;238;208;2015
10;Cáceres;080;Gargantilla;409;208;201;2015
10;Cáceres;081;Gargüera;126;70;56;2015
10;Cáceres;082;Garrovillas de Alconétar;2205;1071;1134;2015
10;Cáceres;083;Garvín;92;52;40;2015
10;Cáceres;084;Gata;1593;820;773;2015
10;Cáceres;085;Gordo, El;394;199;195;2015
10;Cáceres;086;Granja, La;357;193;164;2015
10;Cáceres;087;Guadalupe;2013;988;1025;2015
10;Cáceres;088;Guijo de Coria;216;114;102;2015
10;Cáceres;089;Guijo de Galisteo;1576;794;782;2015
10;Cáceres;090;Guijo de Granadilla;581;308;273;2015
10;Cáceres;091;Guijo de Santa Bárbara;431;229;202;2015
10;Cáceres;092;Herguijuela;336;171;165;2015
10;Cáceres;093;Hernán-Pérez;485;243;242;2015
10;Cáceres;094;Herrera de Alcántara;270;137;133;2015
10;Cáceres;095;Herreruela;375;189;186;2015
10;Cáceres;096;Hervás;4194;2074;2120;2015
10;Cáceres;097;Higuera;114;68;46;2015
10;Cáceres;098;Hinojal;417;210;207;2015
10;Cáceres;099;Holguera;692;344;348;2015
10;Cáceres;100;Hoyos;934;461;473;2015
10;Cáceres;101;Huélaga;220;111;109;2015
10;Cáceres;102;Ibahernando;554;269;285;2015
10;Cáceres;103;Jaraicejo;510;248;262;2015
10;Cáceres;104;Jaraíz de la Vera;6481;3242;3239;2015
10;Cáceres;105;Jarandilla de la Vera;2955;1471;1484;2015
10;Cáceres;106;Jarilla;146;75;71;2015
10;Cáceres;107;Jerte;1282;650;632;2015
10;Cáceres;108;Ladrillar;222;117;105;2015
10;Cáceres;109;Logrosán;2068;1047;1021;2015
10;Cáceres;110;Losar de la Vera;2833;1456;1377;2015
10;Cáceres;111;Madrigal de la Vera;1705;891;814;2015
10;Cáceres;112;Madrigalejo;1855;930;925;2015
10;Cáceres;113;Madroñera;2695;1345;1350;2015
10;Cáceres;114;Majadas;1343;670;673;2015
10;Cáceres;115;Malpartida de Cáceres;4337;2168;2169;2015
10;Cáceres;116;Malpartida de Plasencia;4714;2365;2349;2015
10;Cáceres;117;Marchagaz;220;118;102;2015
10;Cáceres;118;Mata de Alcántara;320;166;154;2015
10;Cáceres;119;Membrío;695;340;355;2015
10;Cáceres;120;Mesas de Ibor;187;101;86;2015
10;Cáceres;121;Miajadas;9944;4944;5000;2015
10;Cáceres;122;Millanes;257;135;122;2015
10;Cáceres;123;Mirabel;687;343;344;2015
10;Cáceres;124;Mohedas de Granadilla;849;429;420;2015
10;Cáceres;125;Monroy;1037;516;521;2015
10;Cáceres;126;Montánchez;1828;913;915;2015
10;Cáceres;127;Montehermoso;5844;2984;2860;2015
10;Cáceres;128;Moraleja;6963;3480;3483;2015
10;Cáceres;129;Morcillo;407;193;214;2015
10;Cáceres;130;Navaconcejo;2030;1032;998;2015
10;Cáceres;131;Navalmoral de la Mata;17156;8284;8872;2015
10;Cáceres;132;Navalvillar de Ibor;447;224;223;2015
10;Cáceres;133;Navas del Madroño;1372;679;693;2015
10;Cáceres;134;Navezuelas;664;341;323;2015
10;Cáceres;135;Nuñomoral;1392;739;653;2015
10;Cáceres;136;Oliva de Plasencia;336;188;148;2015
10;Cáceres;137;Palomero;378;202;176;2015
10;Cáceres;138;Pasarón de la Vera;655;314;341;2015
10;Cáceres;139;Pedroso de Acim;104;54;50;2015
10;Cáceres;140;Peraleda de la Mata;1403;711;692;2015
10;Cáceres;141;Peraleda de San Román;306;153;153;2015
10;Cáceres;142;Perales del Puerto;970;496;474;2015
10;Cáceres;143;Pescueza;165;77;88;2015
10;Cáceres;144;Pesga, La;1130;594;536;2015
10;Cáceres;145;Piedras Albas;156;74;82;2015
10;Cáceres;146;Pinofranqueado;1762;938;824;2015
10;Cáceres;147;Piornal;1555;789;766;2015
10;Cáceres;148;Plasencia;40755;19786;20969;2015
10;Cáceres;149;Plasenzuela;501;248;253;2015
10;Cáceres;150;Portaje;397;203;194;2015
10;Cáceres;151;Portezuelo;246;130;116;2015
10;Cáceres;152;Pozuelo de Zarzón;483;243;240;2015
10;Cáceres;153;Puerto de Santa Cruz;363;183;180;2015
10;Cáceres;154;Rebollar;219;107;112;2015
10;Cáceres;155;Riolobos;1310;680;630;2015
10;Cáceres;156;Robledillo de Gata;99;53;46;2015
10;Cáceres;157;Robledillo de la Vera;301;157;144;2015
10;Cáceres;158;Robledillo de Trujillo;372;197;175;2015
10;Cáceres;159;Robledollano;327;182;145;2015
10;Cáceres;160;Romangordo;263;125;138;2015
10;Cáceres;901;Rosalejo;1495;787;708;2015
10;Cáceres;161;Ruanes;75;41;34;2015
10;Cáceres;162;Salorino;630;328;302;2015
10;Cáceres;163;Salvatierra de Santiago;239;120;119;2015
10;Cáceres;164;San Martín de Trevejo;851;425;426;2015
10;Cáceres;165;Santa Ana;276;149;127;2015
10;Cáceres;166;Santa Cruz de la Sierra;329;163;166;2015
10;Cáceres;167;Santa Cruz de Paniagua;326;177;149;2015
10;Cáceres;168;Santa Marta de Magasca;295;148;147;2015
10;Cáceres;169;Santiago de Alcántara;583;283;300;2015
10;Cáceres;170;Santiago del Campo;279;139;140;2015
10;Cáceres;171;Santibáñez el Alto;349;178;171;2015
10;Cáceres;172;Santibáñez el Bajo;738;387;351;2015
10;Cáceres;173;Saucedilla;877;466;411;2015
10;Cáceres;174;Segura de Toro;189;86;103;2015
10;Cáceres;175;Serradilla;1637;832;805;2015
10;Cáceres;176;Serrejón;443;225;218;2015
10;Cáceres;177;Sierra de Fuentes;2040;1034;1006;2015
10;Cáceres;178;Talaván;887;449;438;2015
10;Cáceres;179;Talaveruela de la Vera;345;183;162;2015
10;Cáceres;180;Talayuela;8240;4435;3805;2015
10;Cáceres;181;Tejeda de Tiétar;837;455;382;2015
10;Cáceres;904;Tiétar;940;493;447;2015
10;Cáceres;182;Toril;170;111;59;2015
10;Cáceres;183;Tornavacas;1144;595;549;2015
10;Cáceres;184;Torno, El;956;501;455;2015
10;Cáceres;187;Torre de Don Miguel;503;268;235;2015
10;Cáceres;188;Torre de Santa María;582;293;289;2015
10;Cáceres;185;Torrecilla de los Ángeles;653;337;316;2015
10;Cáceres;186;Torrecillas de la Tiesa;1134;563;571;2015
10;Cáceres;190;Torrejón el Rubio;628;315;313;2015
10;Cáceres;189;Torrejoncillo;3184;1571;1613;2015
10;Cáceres;191;Torremenga;629;341;288;2015
10;Cáceres;192;Torremocha;915;449;466;2015
10;Cáceres;193;Torreorgaz;1695;819;876;2015
10;Cáceres;194;Torrequemada;601;285;316;2015
10;Cáceres;195;Trujillo;9510;4620;4890;2015
10;Cáceres;196;Valdastillas;334;170;164;2015
10;Cáceres;197;Valdecañas de Tajo;137;76;61;2015
10;Cáceres;198;Valdefuentes;1293;637;656;2015
10;Cáceres;199;Valdehúncar;187;99;88;2015
10;Cáceres;200;Valdelacasa de Tajo;455;227;228;2015
10;Cáceres;201;Valdemorales;198;99;99;2015
10;Cáceres;202;Valdeobispo;701;340;361;2015
10;Cáceres;203;Valencia de Alcántara;5699;2811;2888;2015
10;Cáceres;204;Valverde de la Vera;529;266;263;2015
10;Cáceres;205;Valverde del Fresno;2422;1227;1195;2015
10;Cáceres;902;Vegaviana;863;446;417;2015
10;Cáceres;206;Viandar de la Vera;255;132;123;2015
10;Cáceres;207;Villa del Campo;515;250;265;2015
10;Cáceres;208;Villa del Rey;130;66;64;2015
10;Cáceres;209;Villamesías;289;141;148;2015
10;Cáceres;210;Villamiel;518;262;256;2015
10;Cáceres;211;Villanueva de la Sierra;460;228;232;2015
10;Cáceres;212;Villanueva de la Vera;2122;1079;1043;2015
10;Cáceres;214;Villar de Plasencia;223;116;107;2015
10;Cáceres;213;Villar del Pedroso;636;331;305;2015
10;Cáceres;215;Villasbuenas de Gata;388;200;188;2015
10;Cáceres;216;Zarza de Granadilla;1843;950;893;2015
10;Cáceres;217;Zarza de Montánchez;594;295;299;2015
10;Cáceres;218;Zarza la Mayor;1359;673;686;2015
10;Cáceres;219;Zorita;1502;751;751;2015
11;Cádiz;001;Alcalá de los Gazules;5326;2734;2592;2015
11;Cádiz;002;Alcalá del Valle;5224;2620;2604;2015
11;Cádiz;003;Algar;1448;750;698;2015
11;Cádiz;004;Algeciras;118920;58776;60144;2015
11;Cádiz;005;Algodonales;5649;2876;2773;2015
11;Cádiz;006;Arcos de la Frontera;31193;15624;15569;2015
11;Cádiz;007;Barbate;22808;11435;11373;2015
11;Cádiz;008;Barrios, Los;23167;11614;11553;2015
11;Cádiz;901;Benalup-Casas Viejas;7000;3560;3440;2015
11;Cádiz;009;Benaocaz;720;383;337;2015
11;Cádiz;010;Bornos;7934;3956;3978;2015
11;Cádiz;011;Bosque, El;2067;1046;1021;2015
11;Cádiz;012;Cádiz;120468;57001;63467;2015
11;Cádiz;013;Castellar de la Frontera;3045;1527;1518;2015
11;Cádiz;015;Chiclana de la Frontera;82777;41691;41086;2015
11;Cádiz;016;Chipiona;19062;9578;9484;2015
11;Cádiz;014;Conil de la Frontera;22136;11183;10953;2015
11;Cádiz;017;Espera;3915;1970;1945;2015
11;Cádiz;018;Gastor, El;1809;942;867;2015
11;Cádiz;019;Grazalema;2165;1085;1080;2015
11;Cádiz;020;Jerez de la Frontera;212876;104237;108639;2015
11;Cádiz;021;Jimena de la Frontera;9772;5016;4756;2015
11;Cádiz;022;Línea de la Concepción, La;63352;31073;32279;2015
11;Cádiz;023;Medina-Sidonia;11749;5990;5759;2015
11;Cádiz;024;Olvera;8289;4089;4200;2015
11;Cádiz;025;Paterna de Rivera;5585;2880;2705;2015
11;Cádiz;026;Prado del Rey;5819;2908;2911;2015
11;Cádiz;027;Puerto de Santa María, El;88335;43424;44911;2015
11;Cádiz;028;Puerto Real;41509;20911;20598;2015
11;Cádiz;029;Puerto Serrano;7145;3613;3532;2015
11;Cádiz;030;Rota;29123;14545;14578;2015
11;Cádiz;031;San Fernando;96131;47132;48999;2015
11;Cádiz;902;San José del Valle;4427;2261;2166;2015
11;Cádiz;033;San Roque;29373;14652;14721;2015
11;Cádiz;032;Sanlúcar de Barrameda;67433;33621;33812;2015
11;Cádiz;034;Setenil de las Bodegas;2845;1457;1388;2015
11;Cádiz;035;Tarifa;18011;9127;8884;2015
11;Cádiz;036;Torre Alháquime;779;399;380;2015
11;Cádiz;037;Trebujena;7072;3542;3530;2015
11;Cádiz;038;Ubrique;16836;8294;8542;2015
11;Cádiz;039;Vejer de la Frontera;12812;6412;6400;2015
11;Cádiz;040;Villaluenga del Rosario;471;248;223;2015
11;Cádiz;041;Villamartín;12271;6177;6094;2015
11;Cádiz;042;Zahara;1436;735;701;2015
39;Cantabria;001;Alfoz de Lloredo;2485;1269;1216;2015
39;Cantabria;002;Ampuero;4184;2141;2043;2015
39;Cantabria;003;Anievas;326;165;161;2015
39;Cantabria;004;Arenas de Iguña;1752;904;848;2015
39;Cantabria;005;Argoños;1744;908;836;2015
39;Cantabria;006;Arnuero;2125;1073;1052;2015
39;Cantabria;007;Arredondo;498;285;213;2015
39;Cantabria;008;Astillero, El;18297;8954;9343;2015
39;Cantabria;009;Bárcena de Cicero;4127;2151;1976;2015
39;Cantabria;010;Bárcena de Pie de Concha;728;359;369;2015
39;Cantabria;011;Bareyo;2011;1012;999;2015
39;Cantabria;012;Cabezón de la Sal;8353;4047;4306;2015
39;Cantabria;013;Cabezón de Liébana;622;363;259;2015
39;Cantabria;014;Cabuérniga;998;541;457;2015
39;Cantabria;015;Camaleño;1008;542;466;2015
39;Cantabria;016;Camargo;30766;15125;15641;2015
39;Cantabria;027;Campoo de Enmedio;3780;1938;1842;2015
39;Cantabria;017;Campoo de Yuso;685;373;312;2015
39;Cantabria;018;Cartes;5670;2860;2810;2015
39;Cantabria;019;Castañeda;2681;1365;1316;2015
39;Cantabria;020;Castro-Urdiales;31833;15896;15937;2015
39;Cantabria;021;Cieza;560;284;276;2015
39;Cantabria;022;Cillorigo de Liébana;1318;707;611;2015
39;Cantabria;023;Colindres;8271;4089;4182;2015
39;Cantabria;024;Comillas;2267;1070;1197;2015
39;Cantabria;025;Corrales de Buelna, Los;11077;5432;5645;2015
39;Cantabria;026;Corvera de Toranzo;2080;1058;1022;2015
39;Cantabria;028;Entrambasaguas;4931;2513;2418;2015
39;Cantabria;029;Escalante;758;393;365;2015
39;Cantabria;030;Guriezo;2354;1211;1143;2015
39;Cantabria;031;Hazas de Cesto;1520;767;753;2015
39;Cantabria;032;Hermandad de Campoo de Suso;1679;913;766;2015
39;Cantabria;033;Herrerías;657;373;284;2015
39;Cantabria;034;Lamasón;302;192;110;2015
39;Cantabria;035;Laredo;11643;5553;6090;2015
39;Cantabria;036;Liendo;1223;630;593;2015
39;Cantabria;037;Liérganes;2386;1186;1200;2015
39;Cantabria;038;Limpias;1815;905;910;2015
39;Cantabria;039;Luena;634;345;289;2015
39;Cantabria;040;Marina de Cudeyo;5203;2613;2590;2015
39;Cantabria;041;Mazcuerras;2127;1090;1037;2015
39;Cantabria;042;Medio Cudeyo;7530;3671;3859;2015
39;Cantabria;043;Meruelo;1922;980;942;2015
39;Cantabria;044;Miengo;4675;2367;2308;2015
39;Cantabria;045;Miera;410;214;196;2015
39;Cantabria;046;Molledo;1595;790;805;2015
39;Cantabria;047;Noja;2587;1293;1294;2015
39;Cantabria;048;Penagos;2017;1022;995;2015
39;Cantabria;049;Peñarrubia;351;191;160;2015
39;Cantabria;050;Pesaguero;312;180;132;2015
39;Cantabria;051;Pesquera;73;42;31;2015
39;Cantabria;052;Piélagos;24360;12135;12225;2015
39;Cantabria;053;Polaciones;241;154;87;2015
39;Cantabria;054;Polanco;5705;2867;2838;2015
39;Cantabria;055;Potes;1413;697;716;2015
39;Cantabria;056;Puente Viesgo;2886;1471;1415;2015
39;Cantabria;057;Ramales de la Victoria;2820;1434;1386;2015
39;Cantabria;058;Rasines;990;525;465;2015
39;Cantabria;059;Reinosa;9605;4516;5089;2015
39;Cantabria;060;Reocín;8382;4124;4258;2015
39;Cantabria;061;Ribamontán al Mar;4419;2241;2178;2015
39;Cantabria;062;Ribamontán al Monte;2267;1174;1093;2015
39;Cantabria;063;Rionansa;1051;588;463;2015
39;Cantabria;064;Riotuerto;1638;797;841;2015
39;Cantabria;065;Rozas de Valdearroyo, Las;282;159;123;2015
39;Cantabria;066;Ruente;1037;559;478;2015
39;Cantabria;067;Ruesga;903;484;419;2015
39;Cantabria;068;Ruiloba;768;399;369;2015
39;Cantabria;069;San Felices de Buelna;2408;1192;1216;2015
39;Cantabria;070;San Miguel de Aguayo;164;83;81;2015
39;Cantabria;071;San Pedro del Romeral;461;256;205;2015
39;Cantabria;072;San Roque de Riomiera;394;233;161;2015
39;Cantabria;080;San Vicente de la Barquera;4247;2117;2130;2015
39;Cantabria;073;Santa Cruz de Bezana;12560;6188;6372;2015
39;Cantabria;074;Santa María de Cayón;9090;4598;4492;2015
39;Cantabria;075;Santander;173957;80318;93639;2015
39;Cantabria;076;Santillana del Mar;4203;2036;2167;2015
39;Cantabria;077;Santiurde de Reinosa;279;162;117;2015
39;Cantabria;078;Santiurde de Toranzo;1619;824;795;2015
39;Cantabria;079;Santoña;11088;5428;5660;2015
39;Cantabria;081;Saro;511;268;243;2015
39;Cantabria;082;Selaya;1922;959;963;2015
39;Cantabria;083;Soba;1260;684;576;2015
39;Cantabria;084;Solórzano;1010;535;475;2015
39;Cantabria;085;Suances;8612;4286;4326;2015
39;Cantabria;086;Tojos, Los;404;238;166;2015
39;Cantabria;087;Torrelavega;53496;25405;28091;2015
39;Cantabria;088;Tresviso;71;48;23;2015
39;Cantabria;089;Tudanca;154;110;44;2015
39;Cantabria;090;Udías;895;450;445;2015
39;Cantabria;095;Val de San Vicente;2797;1448;1349;2015
39;Cantabria;091;Valdáliga;2309;1205;1104;2015
39;Cantabria;092;Valdeolea;1020;530;490;2015
39;Cantabria;093;Valdeprado del Río;331;189;142;2015
39;Cantabria;094;Valderredible;1001;556;445;2015
39;Cantabria;101;Valle de Villaverde;336;167;169;2015
39;Cantabria;096;Vega de Liébana;793;422;371;2015
39;Cantabria;097;Vega de Pas;814;417;397;2015
39;Cantabria;098;Villacarriedo;1669;875;794;2015
39;Cantabria;099;Villaescusa;3826;1907;1919;2015
39;Cantabria;100;Villafufre;1032;540;492;2015
39;Cantabria;102;Voto;2729;1445;1284;2015
12;Castellón/Castelló;002;Aín;131;71;60;2015
12;Castellón/Castelló;003;Albocàsser;1334;662;672;2015
12;Castellón/Castelló;004;Alcalà de Xivert;7255;3687;3568;2015
12;Castellón/Castelló;005;Alcora, l';10591;5372;5219;2015
12;Castellón/Castelló;006;Alcudia de Veo;209;113;96;2015
12;Castellón/Castelló;007;Alfondeguilla;901;456;445;2015
12;Castellón/Castelló;008;Algimia de Almonacid;281;161;120;2015
12;Castellón/Castelló;009;Almazora/Almassora;25488;12785;12703;2015
12;Castellón/Castelló;010;Almedíjar;275;142;133;2015
12;Castellón/Castelló;011;Almenara;6031;2994;3037;2015
12;Castellón/Castelló;901;Alquerías del Niño Perdido;4503;2231;2272;2015
12;Castellón/Castelló;012;Altura;3647;1879;1768;2015
12;Castellón/Castelló;013;Arañuel;171;91;80;2015
12;Castellón/Castelló;014;Ares del Maestrat;208;116;92;2015
12;Castellón/Castelló;015;Argelita;103;57;46;2015
12;Castellón/Castelló;016;Artana;1992;1021;971;2015
12;Castellón/Castelló;001;Atzeneta del Maestrat;1307;671;636;2015
12;Castellón/Castelló;017;Ayódar;175;93;82;2015
12;Castellón/Castelló;018;Azuébar;325;170;155;2015
12;Castellón/Castelló;020;Barracas;181;99;82;2015
12;Castellón/Castelló;022;Bejís;399;228;171;2015
12;Castellón/Castelló;024;Benafer;170;88;82;2015
12;Castellón/Castelló;025;Benafigos;156;89;67;2015
12;Castellón/Castelló;026;Benasal;1150;584;566;2015
12;Castellón/Castelló;027;Benicarló;26403;13161;13242;2015
12;Castellón/Castelló;028;Benicasim/Benicàssim;18098;9083;9015;2015
12;Castellón/Castelló;029;Benlloch;1119;562;557;2015
12;Castellón/Castelló;021;Betxí;5763;2842;2921;2015
12;Castellón/Castelló;032;Borriana/Burriana;34708;17244;17464;2015
12;Castellón/Castelló;031;Borriol;5176;2615;2561;2015
12;Castellón/Castelló;033;Cabanes;2939;1474;1465;2015
12;Castellón/Castelló;034;Càlig;2049;1049;1000;2015
12;Castellón/Castelló;036;Canet lo Roig;746;364;382;2015
12;Castellón/Castelló;037;Castell de Cabres;16;10;6;2015
12;Castellón/Castelló;038;Castellfort;206;104;102;2015
12;Castellón/Castelló;039;Castellnovo;1003;505;498;2015
12;Castellón/Castelló;040;Castellón de la Plana/Castelló de la Plana;171669;83406;88263;2015
12;Castellón/Castelló;041;Castillo de Villamalefa;112;72;40;2015
12;Castellón/Castelló;042;Catí;779;395;384;2015
12;Castellón/Castelló;043;Caudiel;700;359;341;2015
12;Castellón/Castelló;044;Cervera del Maestre;653;312;341;2015
12;Castellón/Castelló;053;Chilches/Xilxes;2752;1440;1312;2015
12;Castellón/Castelló;055;Chodos/Xodos;124;70;54;2015
12;Castellón/Castelló;056;Chóvar;327;172;155;2015
12;Castellón/Castelló;045;Cinctorres;424;207;217;2015
12;Castellón/Castelló;046;Cirat;233;130;103;2015
12;Castellón/Castelló;048;Cortes de Arenoso;308;165;143;2015
12;Castellón/Castelló;049;Costur;550;287;263;2015
12;Castellón/Castelló;050;Coves de Vinromà, les;1870;933;937;2015
12;Castellón/Castelló;051;Culla;535;271;264;2015
12;Castellón/Castelló;057;Eslida;833;415;418;2015
12;Castellón/Castelló;058;Espadilla;86;48;38;2015
12;Castellón/Castelló;059;Fanzara;314;158;156;2015
12;Castellón/Castelló;060;Figueroles;539;276;263;2015
12;Castellón/Castelló;061;Forcall;476;231;245;2015
12;Castellón/Castelló;063;Fuente la Reina;51;29;22;2015
12;Castellón/Castelló;064;Fuentes de Ayódar;130;68;62;2015
12;Castellón/Castelló;065;Gaibiel;205;109;96;2015
12;Castellón/Castelló;067;Geldo;651;335;316;2015
12;Castellón/Castelló;068;Herbés;49;26;23;2015
12;Castellón/Castelló;069;Higueras;91;49;42;2015
12;Castellón/Castelló;070;Jana, la;714;358;356;2015
12;Castellón/Castelló;071;Jérica;1599;820;779;2015
12;Castellón/Castelló;074;Llosa, la;988;488;500;2015
12;Castellón/Castelló;072;Lucena del Cid;1385;701;684;2015
12;Castellón/Castelló;073;Ludiente;181;99;82;2015
12;Castellón/Castelló;075;Mata de Morella, la;176;89;87;2015
12;Castellón/Castelló;076;Matet;95;47;48;2015
12;Castellón/Castelló;077;Moncofa;6256;3259;2997;2015
12;Castellón/Castelló;078;Montán;393;186;207;2015
12;Castellón/Castelló;079;Montanejos;549;268;281;2015
12;Castellón/Castelló;080;Morella;2575;1274;1301;2015
12;Castellón/Castelló;081;Navajas;765;398;367;2015
12;Castellón/Castelló;082;Nules;13442;6664;6778;2015
12;Castellón/Castelló;083;Olocau del Rey;123;67;56;2015
12;Castellón/Castelló;084;Onda;24963;12566;12397;2015
12;Castellón/Castelló;085;Oropesa del Mar/Orpesa;9493;4992;4501;2015
12;Castellón/Castelló;087;Palanques;31;15;16;2015
12;Castellón/Castelló;088;Pavías;74;43;31;2015
12;Castellón/Castelló;089;Peníscola/Peñíscola;7444;3772;3672;2015
12;Castellón/Castelló;090;Pina de Montalgrao;129;65;64;2015
12;Castellón/Castelló;093;Pobla de Benifassà, la;228;121;107;2015
12;Castellón/Castelló;094;Pobla Tornesa, la;1191;626;565;2015
12;Castellón/Castelló;091;Portell de Morella;218;113;105;2015
12;Castellón/Castelló;092;Puebla de Arenoso;141;76;65;2015
12;Castellón/Castelló;095;Ribesalbes;1233;623;610;2015
12;Castellón/Castelló;096;Rossell;1020;533;487;2015
12;Castellón/Castelló;097;Sacañet;80;48;32;2015
12;Castellón/Castelló;098;Salzadella, la;762;384;378;2015
12;Castellón/Castelló;101;San Rafael del Río;502;254;248;2015
12;Castellón/Castelló;902;Sant Joan de Moró;3051;1593;1458;2015
12;Castellón/Castelló;099;Sant Jordi/San Jorge;1020;520;500;2015
12;Castellón/Castelló;100;Sant Mateu;1995;986;1009;2015
12;Castellón/Castelló;102;Santa Magdalena de Pulpis;810;438;372;2015
12;Castellón/Castelló;104;Segorbe;9073;4486;4587;2015
12;Castellón/Castelló;103;Serratella, la;101;54;47;2015
12;Castellón/Castelló;105;Sierra Engarcerán;1018;540;478;2015
12;Castellón/Castelló;106;Soneja;1476;722;754;2015
12;Castellón/Castelló;107;Sot de Ferrer;428;219;209;2015
12;Castellón/Castelló;108;Sueras/Suera;564;289;275;2015
12;Castellón/Castelló;109;Tales;836;419;417;2015
12;Castellón/Castelló;110;Teresa;277;143;134;2015
12;Castellón/Castelló;111;Tírig;489;251;238;2015
12;Castellón/Castelló;112;Todolella;140;80;60;2015
12;Castellón/Castelló;113;Toga;106;53;53;2015
12;Castellón/Castelló;114;Torás;231;117;114;2015
12;Castellón/Castelló;115;Toro, El;251;139;112;2015
12;Castellón/Castelló;116;Torralba del Pinar;71;34;37;2015
12;Castellón/Castelló;119;Torre d'En Besora, la;163;94;69;2015
12;Castellón/Castelló;120;Torre d'en Doménec, la;217;109;108;2015
12;Castellón/Castelló;117;Torreblanca;5413;2744;2669;2015
12;Castellón/Castelló;118;Torrechiva;81;48;33;2015
12;Castellón/Castelló;121;Traiguera;1534;775;759;2015
12;Castellón/Castelló;122;Useras/Useres, les;1014;532;482;2015
12;Castellón/Castelló;124;Vall d'Alba;2844;1478;1366;2015
12;Castellón/Castelló;125;Vall de Almonacid;262;140;122;2015
12;Castellón/Castelló;126;Vall d'Uixó, la;31671;15703;15968;2015
12;Castellón/Castelló;123;Vallat;52;21;31;2015
12;Castellón/Castelló;127;Vallibona;85;47;38;2015
12;Castellón/Castelló;128;Vilafamés;1867;992;875;2015
12;Castellón/Castelló;132;Vilanova d'Alcolea;603;318;285;2015
12;Castellón/Castelló;134;Vilar de Canes;175;95;80;2015
12;Castellón/Castelló;135;Vila-real;50580;25142;25438;2015
12;Castellón/Castelló;136;Vilavella, la;3253;1629;1624;2015
12;Castellón/Castelló;129;Villafranca del Cid/Vilafranca;2295;1137;1158;2015
12;Castellón/Castelló;130;Villahermosa del Río;484;260;224;2015
12;Castellón/Castelló;131;Villamalur;70;40;30;2015
12;Castellón/Castelló;133;Villanueva de Viver;61;33;28;2015
12;Castellón/Castelló;137;Villores;37;19;18;2015
12;Castellón/Castelló;138;Vinaròs;28190;13940;14250;2015
12;Castellón/Castelló;139;Vistabella del Maestrat;370;199;171;2015
12;Castellón/Castelló;140;Viver;1558;809;749;2015
12;Castellón/Castelló;052;Xert;779;384;395;2015
12;Castellón/Castelló;141;Zorita del Maestrazgo;129;65;64;2015
12;Castellón/Castelló;142;Zucaina;183;99;84;2015
51;Ceuta;001;Ceuta;84263;42757;41506;2015
13;Ciudad Real;001;Abenójar;1471;760;711;2015
13;Ciudad Real;002;Agudo;1750;891;859;2015
13;Ciudad Real;003;Alamillo;531;275;256;2015
13;Ciudad Real;004;Albaladejo;1323;681;642;2015
13;Ciudad Real;005;Alcázar de San Juan;31269;15234;16035;2015
13;Ciudad Real;006;Alcoba;637;320;317;2015
13;Ciudad Real;007;Alcolea de Calatrava;1475;746;729;2015
13;Ciudad Real;008;Alcubillas;518;264;254;2015
13;Ciudad Real;009;Aldea del Rey;1823;937;886;2015
13;Ciudad Real;010;Alhambra;1042;529;513;2015
13;Ciudad Real;011;Almadén;5794;2778;3016;2015
13;Ciudad Real;012;Almadenejos;456;233;223;2015
13;Ciudad Real;013;Almagro;9074;4472;4602;2015
13;Ciudad Real;014;Almedina;572;294;278;2015
13;Ciudad Real;015;Almodóvar del Campo;6477;3265;3212;2015
13;Ciudad Real;016;Almuradiel;843;417;426;2015
13;Ciudad Real;017;Anchuras;343;181;162;2015
13;Ciudad Real;903;Arenales de San Gregorio;672;351;321;2015
13;Ciudad Real;018;Arenas de San Juan;1067;545;522;2015
13;Ciudad Real;019;Argamasilla de Alba;7110;3589;3521;2015
13;Ciudad Real;020;Argamasilla de Calatrava;5992;3030;2962;2015
13;Ciudad Real;021;Arroba de los Montes;471;251;220;2015
13;Ciudad Real;022;Ballesteros de Calatrava;416;209;207;2015
13;Ciudad Real;023;Bolaños de Calatrava;12001;6129;5872;2015
13;Ciudad Real;024;Brazatortas;1038;537;501;2015
13;Ciudad Real;025;Cabezarados;328;171;157;2015
13;Ciudad Real;026;Cabezarrubias del Puerto;521;273;248;2015
13;Ciudad Real;027;Calzada de Calatrava;4122;2064;2058;2015
13;Ciudad Real;028;Campo de Criptana;14126;7100;7026;2015
13;Ciudad Real;029;Cañada de Calatrava;106;60;46;2015
13;Ciudad Real;030;Caracuel de Calatrava;165;96;69;2015
13;Ciudad Real;031;Carrión de Calatrava;3090;1567;1523;2015
13;Ciudad Real;032;Carrizosa;1331;670;661;2015
13;Ciudad Real;033;Castellar de Santiago;2055;1027;1028;2015
13;Ciudad Real;038;Chillón;1937;951;986;2015
13;Ciudad Real;034;Ciudad Real;74427;35200;39227;2015
13;Ciudad Real;035;Corral de Calatrava;1135;564;571;2015
13;Ciudad Real;036;Cortijos, Los;961;497;464;2015
13;Ciudad Real;037;Cózar;1092;536;556;2015
13;Ciudad Real;039;Daimiel;18577;9273;9304;2015
13;Ciudad Real;040;Fernán Caballero;1069;537;532;2015
13;Ciudad Real;041;Fontanarejo;281;153;128;2015
13;Ciudad Real;042;Fuencaliente;1082;563;519;2015
13;Ciudad Real;043;Fuenllana;261;132;129;2015
13;Ciudad Real;044;Fuente el Fresno;3365;1747;1618;2015
13;Ciudad Real;045;Granátula de Calatrava;819;398;421;2015
13;Ciudad Real;046;Guadalmez;813;405;408;2015
13;Ciudad Real;047;Herencia;8758;4448;4310;2015
13;Ciudad Real;048;Hinojosas de Calatrava;499;256;243;2015
13;Ciudad Real;049;Horcajo de los Montes;959;479;480;2015
13;Ciudad Real;050;Labores, Las;617;311;306;2015
13;Ciudad Real;904;Llanos del Caudillo;739;375;364;2015
13;Ciudad Real;051;Luciana;398;212;186;2015
13;Ciudad Real;052;Malagón;8280;4112;4168;2015
13;Ciudad Real;053;Manzanares;18642;9258;9384;2015
13;Ciudad Real;054;Membrilla;6168;3104;3064;2015
13;Ciudad Real;055;Mestanza;724;354;370;2015
13;Ciudad Real;056;Miguelturra;15032;7587;7445;2015
13;Ciudad Real;057;Montiel;1450;758;692;2015
13;Ciudad Real;058;Moral de Calatrava;5429;2730;2699;2015
13;Ciudad Real;059;Navalpino;235;119;116;2015
13;Ciudad Real;060;Navas de Estena;265;144;121;2015
13;Ciudad Real;061;Pedro Muñoz;7714;3932;3782;2015
13;Ciudad Real;062;Picón;698;366;332;2015
13;Ciudad Real;063;Piedrabuena;4624;2349;2275;2015
13;Ciudad Real;064;Poblete;2334;1204;1130;2015
13;Ciudad Real;065;Porzuna;3742;1918;1824;2015
13;Ciudad Real;066;Pozuelo de Calatrava;3371;1728;1643;2015
13;Ciudad Real;067;Pozuelos de Calatrava, Los;430;225;205;2015
13;Ciudad Real;068;Puebla de Don Rodrigo;1220;660;560;2015
13;Ciudad Real;069;Puebla del Príncipe;756;377;379;2015
13;Ciudad Real;070;Puerto Lápice;955;479;476;2015
13;Ciudad Real;071;Puertollano;50035;24327;25708;2015
13;Ciudad Real;072;Retuerta del Bullaque;1019;565;454;2015
13;Ciudad Real;901;Robledo, El;1228;659;569;2015
13;Ciudad Real;902;Ruidera;608;306;302;2015
13;Ciudad Real;073;Saceruela;617;332;285;2015
13;Ciudad Real;074;San Carlos del Valle;1184;614;570;2015
13;Ciudad Real;075;San Lorenzo de Calatrava;231;124;107;2015
13;Ciudad Real;076;Santa Cruz de los Cáñamos;546;270;276;2015
13;Ciudad Real;077;Santa Cruz de Mudela;4330;2149;2181;2015
13;Ciudad Real;078;Socuéllamos;12721;6470;6251;2015
13;Ciudad Real;080;Solana del Pino;353;187;166;2015
13;Ciudad Real;079;Solana, La;15979;8054;7925;2015
13;Ciudad Real;081;Terrinches;782;400;382;2015
13;Ciudad Real;082;Tomelloso;37645;18845;18800;2015
13;Ciudad Real;083;Torralba de Calatrava;3107;1538;1569;2015
13;Ciudad Real;084;Torre de Juan Abad;1108;544;564;2015
13;Ciudad Real;085;Torrenueva;2911;1460;1451;2015
13;Ciudad Real;086;Valdemanco del Esteras;210;108;102;2015
13;Ciudad Real;087;Valdepeñas;30514;14947;15567;2015
13;Ciudad Real;088;Valenzuela de Calatrava;706;327;379;2015
13;Ciudad Real;089;Villahermosa;2014;964;1050;2015
13;Ciudad Real;090;Villamanrique;1286;642;644;2015
13;Ciudad Real;091;Villamayor de Calatrava;673;329;344;2015
13;Ciudad Real;092;Villanueva de la Fuente;2288;1174;1114;2015
13;Ciudad Real;093;Villanueva de los Infantes;5373;2657;2716;2015
13;Ciudad Real;094;Villanueva de San Carlos;308;163;145;2015
13;Ciudad Real;095;Villar del Pozo;99;53;46;2015
13;Ciudad Real;096;Villarrubia de los Ojos;10494;5257;5237;2015
13;Ciudad Real;097;Villarta de San Juan;2953;1488;1465;2015
13;Ciudad Real;098;Viso del Marqués;2524;1231;1293;2015
14;Córdoba;001;Adamuz;4317;2214;2103;2015
14;Córdoba;002;Aguilar de la Frontera;13551;6832;6719;2015
14;Córdoba;003;Alcaracejos;1523;731;792;2015
14;Córdoba;004;Almedinilla;2455;1230;1225;2015
14;Córdoba;005;Almodóvar del Río;7961;3988;3973;2015
14;Córdoba;006;Añora;1563;768;795;2015
14;Córdoba;007;Baena;19802;10143;9659;2015
14;Córdoba;008;Belalcázar;3437;1647;1790;2015
14;Córdoba;009;Belmez;3119;1516;1603;2015
14;Córdoba;010;Benamejí;5060;2515;2545;2015
14;Córdoba;011;Blázquez, Los;703;367;336;2015
14;Córdoba;012;Bujalance;7693;3839;3854;2015
14;Córdoba;013;Cabra;20837;10196;10641;2015
14;Córdoba;014;Cañete de las Torres;3010;1540;1470;2015
14;Córdoba;015;Carcabuey;2595;1323;1272;2015
14;Córdoba;016;Cardeña;1604;810;794;2015
14;Córdoba;017;Carlota, La;13929;7023;6906;2015
14;Córdoba;018;Carpio, El;4496;2240;2256;2015
14;Córdoba;019;Castro del Río;7972;3943;4029;2015
14;Córdoba;020;Conquista;438;219;219;2015
14;Córdoba;021;Córdoba;327362;157311;170051;2015
14;Córdoba;022;Doña Mencía;4882;2372;2510;2015
14;Córdoba;023;Dos Torres;2457;1219;1238;2015
14;Córdoba;024;Encinas Reales;2343;1159;1184;2015
14;Córdoba;025;Espejo;3443;1742;1701;2015
14;Córdoba;026;Espiel;2508;1253;1255;2015
14;Córdoba;027;Fernán-Núñez;9713;4865;4848;2015
14;Córdoba;028;Fuente la Lancha;377;192;185;2015
14;Córdoba;029;Fuente Obejuna;4894;2506;2388;2015
14;Córdoba;030;Fuente Palmera;10895;5473;5422;2015
14;Córdoba;031;Fuente-Tójar;721;345;376;2015
14;Córdoba;032;Granjuela, La;482;247;235;2015
14;Córdoba;033;Guadalcázar;1566;777;789;2015
14;Córdoba;034;Guijo, El;372;195;177;2015
14;Córdoba;035;Hinojosa del Duque;7054;3442;3612;2015
14;Córdoba;036;Hornachuelos;4642;2340;2302;2015
14;Córdoba;037;Iznájar;4556;2285;2271;2015
14;Córdoba;038;Lucena;42697;21298;21399;2015
14;Córdoba;039;Luque;3127;1568;1559;2015
14;Córdoba;040;Montalbán de Córdoba;4519;2266;2253;2015
14;Córdoba;041;Montemayor;3950;1978;1972;2015
14;Córdoba;042;Montilla;23519;11639;11880;2015
14;Córdoba;043;Montoro;9640;4733;4907;2015
14;Córdoba;044;Monturque;2007;997;1010;2015
14;Córdoba;045;Moriles;3848;1923;1925;2015
14;Córdoba;046;Nueva Carteya;5470;2769;2701;2015
14;Córdoba;047;Obejo;2027;1041;986;2015
14;Córdoba;048;Palenciana;1545;778;767;2015
14;Córdoba;049;Palma del Río;21522;10742;10780;2015
14;Córdoba;050;Pedro Abad;2927;1474;1453;2015
14;Córdoba;051;Pedroche;1624;785;839;2015
14;Córdoba;052;Peñarroya-Pueblonuevo;11300;5467;5833;2015
14;Córdoba;053;Posadas;7544;3769;3775;2015
14;Córdoba;054;Pozoblanco;17380;8496;8884;2015
14;Córdoba;055;Priego de Córdoba;22936;11222;11714;2015
14;Córdoba;056;Puente Genil;30167;15022;15145;2015
14;Córdoba;057;Rambla, La;7547;3785;3762;2015
14;Córdoba;058;Rute;10269;5116;5153;2015
14;Córdoba;059;San Sebastián de los Ballesteros;816;412;404;2015
14;Córdoba;061;Santa Eufemia;859;433;426;2015
14;Córdoba;060;Santaella;6062;3061;3001;2015
14;Córdoba;062;Torrecampo;1177;581;596;2015
14;Córdoba;063;Valenzuela;1241;607;634;2015
14;Córdoba;064;Valsequillo;379;186;193;2015
14;Córdoba;065;Victoria, La;2375;1184;1191;2015
14;Córdoba;066;Villa del Río;7403;3702;3701;2015
14;Córdoba;067;Villafranca de Córdoba;4889;2507;2382;2015
14;Córdoba;068;Villaharta;703;344;359;2015
14;Córdoba;069;Villanueva de Córdoba;9141;4523;4618;2015
14;Córdoba;070;Villanueva del Duque;1553;777;776;2015
14;Córdoba;071;Villanueva del Rey;1096;550;546;2015
14;Córdoba;072;Villaralto;1238;608;630;2015
14;Córdoba;073;Villaviciosa de Córdoba;3443;1755;1688;2015
14;Córdoba;074;Viso, El;2651;1307;1344;2015
14;Córdoba;075;Zuheros;688;347;341;2015
15;Coruña, A;001;Abegondo;5586;2773;2813;2015
15;Coruña, A;002;Ames;30267;14608;15659;2015
15;Coruña, A;003;Aranga;1997;1006;991;2015
15;Coruña, A;004;Ares;5743;2839;2904;2015
15;Coruña, A;005;Arteixo;30950;15471;15479;2015
15;Coruña, A;006;Arzúa;6219;3084;3135;2015
15;Coruña, A;007;Baña, A;3698;1769;1929;2015
15;Coruña, A;008;Bergondo;6700;3249;3451;2015
15;Coruña, A;009;Betanzos;13202;6305;6897;2015
15;Coruña, A;010;Boimorto;2125;1089;1036;2015
15;Coruña, A;011;Boiro;18950;9248;9702;2015
15;Coruña, A;012;Boqueixón;4321;2136;2185;2015
15;Coruña, A;013;Brión;7564;3646;3918;2015
15;Coruña, A;014;Cabana de Bergantiños;4552;2228;2324;2015
15;Coruña, A;015;Cabanas;3299;1611;1688;2015
15;Coruña, A;016;Camariñas;5577;2707;2870;2015
15;Coruña, A;017;Cambre;24076;11821;12255;2015
15;Coruña, A;018;Capela, A;1334;663;671;2015
15;Coruña, A;019;Carballo;31283;15323;15960;2015
15;Coruña, A;901;Cariño;4167;2065;2102;2015
15;Coruña, A;020;Carnota;4284;2055;2229;2015
15;Coruña, A;021;Carral;6180;3040;3140;2015
15;Coruña, A;022;Cedeira;7062;3548;3514;2015
15;Coruña, A;023;Cee;7723;3702;4021;2015
15;Coruña, A;024;Cerceda;5076;2476;2600;2015
15;Coruña, A;025;Cerdido;1233;599;634;2015
15;Coruña, A;027;Coirós;1757;872;885;2015
15;Coruña, A;028;Corcubión;1655;814;841;2015
15;Coruña, A;029;Coristanco;6551;3151;3400;2015
15;Coruña, A;030;Coruña, A;243870;113191;130679;2015
15;Coruña, A;031;Culleredo;29593;14409;15184;2015
15;Coruña, A;032;Curtis;4015;2016;1999;2015
15;Coruña, A;033;Dodro;2882;1396;1486;2015
15;Coruña, A;034;Dumbría;3077;1470;1607;2015
15;Coruña, A;035;Fene;13385;6408;6977;2015
15;Coruña, A;036;Ferrol;69452;32627;36825;2015
15;Coruña, A;037;Fisterra;4775;2405;2370;2015
15;Coruña, A;038;Frades;2460;1225;1235;2015
15;Coruña, A;039;Irixoa;1389;694;695;2015
15;Coruña, A;041;Laracha, A;11402;5608;5794;2015
15;Coruña, A;040;Laxe;3185;1588;1597;2015
15;Coruña, A;042;Lousame;3463;1684;1779;2015
15;Coruña, A;043;Malpica de Bergantiños;5666;2762;2904;2015
15;Coruña, A;044;Mañón;1454;702;752;2015
15;Coruña, A;045;Mazaricos;4173;1998;2175;2015
15;Coruña, A;046;Melide;7538;3714;3824;2015
15;Coruña, A;047;Mesía;2734;1364;1370;2015
15;Coruña, A;048;Miño;5859;2927;2932;2015
15;Coruña, A;049;Moeche;1246;583;663;2015
15;Coruña, A;050;Monfero;2037;1036;1001;2015
15;Coruña, A;051;Mugardos;5362;2601;2761;2015
15;Coruña, A;053;Muros;8960;4331;4629;2015
15;Coruña, A;052;Muxía;5025;2440;2585;2015
15;Coruña, A;054;Narón;39565;19194;20371;2015
15;Coruña, A;055;Neda;5261;2565;2696;2015
15;Coruña, A;056;Negreira;6936;3349;3587;2015
15;Coruña, A;057;Noia;14472;6926;7546;2015
15;Coruña, A;058;Oleiros;34693;16859;17834;2015
15;Coruña, A;059;Ordes;12776;6201;6575;2015
15;Coruña, A;060;Oroso;7413;3664;3749;2015
15;Coruña, A;061;Ortigueira;6136;2952;3184;2015
15;Coruña, A;062;Outes;6691;3203;3488;2015
15;Coruña, A;902;Oza-Cesuras;5253;2654;2599;2015
15;Coruña, A;064;Paderne;2467;1202;1265;2015
15;Coruña, A;065;Padrón;8643;4168;4475;2015
15;Coruña, A;066;Pino, O;4706;2351;2355;2015
15;Coruña, A;067;Pobra do Caramiñal, A;9623;4699;4924;2015
15;Coruña, A;068;Ponteceso;5789;2894;2895;2015
15;Coruña, A;069;Pontedeume;8011;3843;4168;2015
15;Coruña, A;070;Pontes de García Rodríguez, As;10503;5166;5337;2015
15;Coruña, A;071;Porto do Son;9436;4698;4738;2015
15;Coruña, A;072;Rianxo;11386;5557;5829;2015
15;Coruña, A;073;Ribeira;27372;13504;13868;2015
15;Coruña, A;074;Rois;4710;2244;2466;2015
15;Coruña, A;075;Sada;15080;7419;7661;2015
15;Coruña, A;076;San Sadurniño;3009;1494;1515;2015
15;Coruña, A;077;Santa Comba;9635;4648;4987;2015
15;Coruña, A;078;Santiago de Compostela;95612;44388;51224;2015
15;Coruña, A;079;Santiso;1709;889;820;2015
15;Coruña, A;080;Sobrado;1911;987;924;2015
15;Coruña, A;081;Somozas, As;1191;608;583;2015
15;Coruña, A;082;Teo;18505;9096;9409;2015
15;Coruña, A;083;Toques;1213;632;581;2015
15;Coruña, A;084;Tordoia;3591;1684;1907;2015
15;Coruña, A;085;Touro;3778;1883;1895;2015
15;Coruña, A;086;Trazo;3263;1605;1658;2015
15;Coruña, A;088;Val do Dubra;4033;1942;2091;2015
15;Coruña, A;087;Valdoviño;6753;3304;3449;2015
15;Coruña, A;089;Vedra;5059;2478;2581;2015
15;Coruña, A;091;Vilarmaior;1233;633;600;2015
15;Coruña, A;090;Vilasantar;1280;669;611;2015
15;Coruña, A;092;Vimianzo;7520;3626;3894;2015
15;Coruña, A;093;Zas;4846;2337;2509;2015
16;Cuenca;001;Abia de la Obispalía;77;49;28;2015
16;Cuenca;002;Acebrón, El;241;121;120;2015
16;Cuenca;003;Alarcón;148;66;82;2015
16;Cuenca;004;Albaladejo del Cuende;292;150;142;2015
16;Cuenca;005;Albalate de las Nogueras;272;146;126;2015
16;Cuenca;006;Albendea;134;64;70;2015
16;Cuenca;007;Alberca de Záncara, La;1723;881;842;2015
16;Cuenca;008;Alcalá de la Vega;105;57;48;2015
16;Cuenca;009;Alcantud;72;39;33;2015
16;Cuenca;010;Alcázar del Rey;172;82;90;2015
16;Cuenca;011;Alcohujate;32;18;14;2015
16;Cuenca;012;Alconchel de la Estrella;111;63;48;2015
16;Cuenca;013;Algarra;32;21;11;2015
16;Cuenca;014;Aliaguilla;698;364;334;2015
16;Cuenca;015;Almarcha, La;415;230;185;2015
16;Cuenca;016;Almendros;272;152;120;2015
16;Cuenca;017;Almodóvar del Pinar;447;245;202;2015
16;Cuenca;018;Almonacid del Marquesado;458;238;220;2015
16;Cuenca;019;Altarejos;229;119;110;2015
16;Cuenca;020;Arandilla del Arroyo;16;9;7;2015
16;Cuenca;905;Arcas;1605;812;793;2015
16;Cuenca;022;Arcos de la Sierra;88;51;37;2015
16;Cuenca;024;Arguisuelas;146;80;66;2015
16;Cuenca;025;Arrancacepas;26;13;13;2015
16;Cuenca;026;Atalaya del Cañavate;116;54;62;2015
16;Cuenca;027;Barajas de Melo;935;498;437;2015
16;Cuenca;029;Barchín del Hoyo;90;52;38;2015
16;Cuenca;030;Bascuñana de San Pedro;20;12;8;2015
16;Cuenca;031;Beamud;49;23;26;2015
16;Cuenca;032;Belinchón;356;185;171;2015
16;Cuenca;033;Belmonte;2019;996;1023;2015
16;Cuenca;034;Belmontejo;196;107;89;2015
16;Cuenca;035;Beteta;293;140;153;2015
16;Cuenca;036;Boniches;151;70;81;2015
16;Cuenca;038;Buciegas;46;27;19;2015
16;Cuenca;039;Buenache de Alarcón;499;262;237;2015
16;Cuenca;040;Buenache de la Sierra;106;62;44;2015
16;Cuenca;041;Buendía;425;224;201;2015
16;Cuenca;042;Campillo de Altobuey;1481;725;756;2015
16;Cuenca;043;Campillos-Paravientos;117;62;55;2015
16;Cuenca;044;Campillos-Sierra;36;16;20;2015
16;Cuenca;901;Campos del Paraíso;845;431;414;2015
16;Cuenca;045;Canalejas del Arroyo;289;157;132;2015
16;Cuenca;046;Cañada del Hoyo;280;143;137;2015
16;Cuenca;047;Cañada Juncosa;272;153;119;2015
16;Cuenca;048;Cañamares;500;267;233;2015
16;Cuenca;049;Cañavate, El;165;87;78;2015
16;Cuenca;050;Cañaveras;325;159;166;2015
16;Cuenca;051;Cañaveruelas;151;77;74;2015
16;Cuenca;052;Cañete;802;413;389;2015
16;Cuenca;053;Cañizares;505;270;235;2015
16;Cuenca;055;Carboneras de Guadazaón;810;415;395;2015
16;Cuenca;056;Cardenete;533;283;250;2015
16;Cuenca;057;Carrascosa;89;57;32;2015
16;Cuenca;058;Carrascosa de Haro;122;63;59;2015
16;Cuenca;060;Casas de Benítez;918;449;469;2015
16;Cuenca;061;Casas de Fernando Alonso;1311;704;607;2015
16;Cuenca;062;Casas de Garcimolina;28;17;11;2015
16;Cuenca;063;Casas de Guijarro;116;63;53;2015
16;Cuenca;064;Casas de Haro;873;462;411;2015
16;Cuenca;065;Casas de los Pinos;464;225;239;2015
16;Cuenca;066;Casasimarro;3144;1624;1520;2015
16;Cuenca;067;Castejón;158;85;73;2015
16;Cuenca;068;Castillejo de Iniesta;189;107;82;2015
16;Cuenca;070;Castillejo-Sierra;33;18;15;2015
16;Cuenca;072;Castillo de Garcimuñoz;157;90;67;2015
16;Cuenca;071;Castillo-Albaráñez;21;10;11;2015
16;Cuenca;073;Cervera del Llano;231;120;111;2015
16;Cuenca;023;Chillarón de Cuenca;567;309;258;2015
16;Cuenca;081;Chumillas;54;29;25;2015
16;Cuenca;074;Cierva, La;44;26;18;2015
16;Cuenca;078;Cuenca;55428;26506;28922;2015
16;Cuenca;079;Cueva del Hierro;35;24;11;2015
16;Cuenca;082;Enguídanos;345;182;163;2015
16;Cuenca;083;Fresneda de Altarejos;54;28;26;2015
16;Cuenca;084;Fresneda de la Sierra;54;29;25;2015
16;Cuenca;085;Frontera, La;170;89;81;2015
16;Cuenca;086;Fuente de Pedro Naharro;1248;642;606;2015
16;Cuenca;087;Fuentelespino de Haro;280;145;135;2015
16;Cuenca;088;Fuentelespino de Moya;125;69;56;2015
16;Cuenca;904;Fuentenava de Jábaga;568;306;262;2015
16;Cuenca;089;Fuentes;465;249;216;2015
16;Cuenca;091;Fuertescusa;75;40;35;2015
16;Cuenca;092;Gabaldón;188;109;79;2015
16;Cuenca;093;Garaballa;72;38;34;2015
16;Cuenca;094;Gascueña;176;94;82;2015
16;Cuenca;095;Graja de Campalbo;101;51;50;2015
16;Cuenca;096;Graja de Iniesta;370;192;178;2015
16;Cuenca;097;Henarejos;169;85;84;2015
16;Cuenca;098;Herrumblar, El;717;371;346;2015
16;Cuenca;099;Hinojosa, La;214;107;107;2015
16;Cuenca;100;Hinojosos, Los;884;429;455;2015
16;Cuenca;101;Hito, El;173;94;79;2015
16;Cuenca;102;Honrubia;1650;821;829;2015
16;Cuenca;103;Hontanaya;319;172;147;2015
16;Cuenca;104;Hontecillas;58;31;27;2015
16;Cuenca;106;Horcajo de Santiago;3689;1896;1793;2015
16;Cuenca;107;Huélamo;106;64;42;2015
16;Cuenca;108;Huelves;53;26;27;2015
16;Cuenca;109;Huérguina;56;29;27;2015
16;Cuenca;110;Huerta de la Obispalía;133;78;55;2015
16;Cuenca;111;Huerta del Marquesado;210;123;87;2015
16;Cuenca;112;Huete;1862;954;908;2015
16;Cuenca;113;Iniesta;4382;2151;2231;2015
16;Cuenca;115;Laguna del Marquesado;48;27;21;2015
16;Cuenca;116;Lagunaseca;94;52;42;2015
16;Cuenca;117;Landete;1310;678;632;2015
16;Cuenca;118;Ledaña;1662;816;846;2015
16;Cuenca;119;Leganiel;189;97;92;2015
16;Cuenca;121;Majadas, Las;284;146;138;2015
16;Cuenca;122;Mariana;320;164;156;2015
16;Cuenca;123;Masegosa;79;44;35;2015
16;Cuenca;124;Mesas, Las;2388;1217;1171;2015
16;Cuenca;125;Minglanilla;2367;1233;1134;2015
16;Cuenca;126;Mira;987;493;494;2015
16;Cuenca;128;Monreal del Llano;73;39;34;2015
16;Cuenca;129;Montalbanejo;118;64;54;2015
16;Cuenca;130;Montalbo;687;371;316;2015
16;Cuenca;131;Monteagudo de las Salinas;144;84;60;2015
16;Cuenca;132;Mota de Altarejos;31;22;9;2015
16;Cuenca;133;Mota del Cuervo;6172;3065;3107;2015
16;Cuenca;134;Motilla del Palancar;5896;2958;2938;2015
16;Cuenca;135;Moya;171;98;73;2015
16;Cuenca;137;Narboneta;56;30;26;2015
16;Cuenca;139;Olivares de Júcar;345;179;166;2015
16;Cuenca;140;Olmeda de la Cuesta;28;15;13;2015
16;Cuenca;141;Olmeda del Rey;135;65;70;2015
16;Cuenca;142;Olmedilla de Alarcón;158;91;67;2015
16;Cuenca;143;Olmedilla de Eliz;19;13;6;2015
16;Cuenca;145;Osa de la Vega;544;284;260;2015
16;Cuenca;146;Pajarón;84;41;43;2015
16;Cuenca;147;Pajaroncillo;76;48;28;2015
16;Cuenca;148;Palomares del Campo;680;337;343;2015
16;Cuenca;149;Palomera;186;100;86;2015
16;Cuenca;150;Paracuellos;102;52;50;2015
16;Cuenca;151;Paredes;65;35;30;2015
16;Cuenca;152;Parra de las Vegas, La;44;26;18;2015
16;Cuenca;153;Pedernoso, El;1189;606;583;2015
16;Cuenca;154;Pedroñeras, Las;6816;3519;3297;2015
16;Cuenca;155;Peral, El;693;381;312;2015
16;Cuenca;156;Peraleja, La;109;58;51;2015
16;Cuenca;157;Pesquera, La;248;133;115;2015
16;Cuenca;158;Picazo, El;710;361;349;2015
16;Cuenca;159;Pinarejo;238;118;120;2015
16;Cuenca;160;Pineda de Gigüela;69;36;33;2015
16;Cuenca;161;Piqueras del Castillo;57;31;26;2015
16;Cuenca;162;Portalrubio de Guadamejud;30;15;15;2015
16;Cuenca;163;Portilla;74;39;35;2015
16;Cuenca;165;Poyatos;67;36;31;2015
16;Cuenca;166;Pozoamargo;311;163;148;2015
16;Cuenca;908;Pozorrubielos de la Mancha;211;104;107;2015
16;Cuenca;167;Pozorrubio de Santiago;345;163;182;2015
16;Cuenca;169;Pozuelo, El;62;35;27;2015
16;Cuenca;170;Priego;1014;516;498;2015
16;Cuenca;171;Provencio, El;2526;1249;1277;2015
16;Cuenca;172;Puebla de Almenara;416;212;204;2015
16;Cuenca;174;Puebla del Salvador;211;118;93;2015
16;Cuenca;175;Quintanar del Rey;7576;3909;3667;2015
16;Cuenca;176;Rada de Haro;53;27;26;2015
16;Cuenca;177;Reíllo;89;47;42;2015
16;Cuenca;181;Rozalén del Monte;75;35;40;2015
16;Cuenca;185;Saceda-Trasierra;51;32;19;2015
16;Cuenca;186;Saelices;553;284;269;2015
16;Cuenca;187;Salinas del Manzano;94;53;41;2015
16;Cuenca;188;Salmeroncillos;115;65;50;2015
16;Cuenca;189;Salvacañete;316;165;151;2015
16;Cuenca;190;San Clemente;6754;3427;3327;2015
16;Cuenca;191;San Lorenzo de la Parrilla;1153;571;582;2015
16;Cuenca;192;San Martín de Boniches;48;25;23;2015
16;Cuenca;193;San Pedro Palmiches;70;40;30;2015
16;Cuenca;194;Santa Cruz de Moya;259;138;121;2015
16;Cuenca;196;Santa María de los Llanos;721;374;347;2015
16;Cuenca;195;Santa María del Campo Rus;626;311;315;2015
16;Cuenca;197;Santa María del Val;68;38;30;2015
16;Cuenca;198;Sisante;1758;884;874;2015
16;Cuenca;199;Solera de Gabaldón;29;13;16;2015
16;Cuenca;909;Sotorribas;802;409;393;2015
16;Cuenca;202;Talayuelas;944;498;446;2015
16;Cuenca;203;Tarancón;14922;7447;7475;2015
16;Cuenca;204;Tébar;303;159;144;2015
16;Cuenca;205;Tejadillos;129;62;67;2015
16;Cuenca;206;Tinajas;221;111;110;2015
16;Cuenca;209;Torralba;127;75;52;2015
16;Cuenca;211;Torrejoncillo del Rey;433;222;211;2015
16;Cuenca;212;Torrubia del Campo;285;140;145;2015
16;Cuenca;213;Torrubia del Castillo;40;25;15;2015
16;Cuenca;215;Tragacete;288;159;129;2015
16;Cuenca;216;Tresjuncos;343;185;158;2015
16;Cuenca;217;Tribaldos;95;48;47;2015
16;Cuenca;218;Uclés;234;124;110;2015
16;Cuenca;219;Uña;103;51;52;2015
16;Cuenca;906;Valdecolmenas, Los;84;50;34;2015
16;Cuenca;224;Valdemeca;91;48;43;2015
16;Cuenca;225;Valdemorillo de la Sierra;83;48;35;2015
16;Cuenca;227;Valdemoro-Sierra;119;68;51;2015
16;Cuenca;228;Valdeolivas;208;126;82;2015
16;Cuenca;902;Valdetórtola;154;82;72;2015
16;Cuenca;903;Valeras, Las;1632;858;774;2015
16;Cuenca;231;Valhermoso de la Fuente;55;28;27;2015
16;Cuenca;173;Valle de Altomira, El;246;135;111;2015
16;Cuenca;234;Valsalobre;32;19;13;2015
16;Cuenca;236;Valverde de Júcar;1172;590;582;2015
16;Cuenca;237;Valverdejo;101;54;47;2015
16;Cuenca;238;Vara de Rey;561;294;267;2015
16;Cuenca;239;Vega del Codorno;153;92;61;2015
16;Cuenca;240;Vellisca;112;61;51;2015
16;Cuenca;242;Villaconejos de Trabaque;372;190;182;2015
16;Cuenca;243;Villaescusa de Haro;529;264;265;2015
16;Cuenca;244;Villagarcía del Llano;762;388;374;2015
16;Cuenca;245;Villalba de la Sierra;509;250;259;2015
16;Cuenca;246;Villalba del Rey;566;312;254;2015
16;Cuenca;247;Villalgordo del Marquesado;99;54;45;2015
16;Cuenca;248;Villalpardo;970;476;494;2015
16;Cuenca;249;Villamayor de Santiago;2617;1342;1275;2015
16;Cuenca;250;Villanueva de Guadamejud;80;48;32;2015
16;Cuenca;251;Villanueva de la Jara;2304;1161;1143;2015
16;Cuenca;253;Villar de Cañas;447;238;209;2015
16;Cuenca;254;Villar de Domingo García;218;114;104;2015
16;Cuenca;255;Villar de la Encina;164;85;79;2015
16;Cuenca;263;Villar de Olalla;1236;673;563;2015
16;Cuenca;258;Villar del Humo;235;133;102;2015
16;Cuenca;259;Villar del Infantado;42;26;16;2015
16;Cuenca;910;Villar y Velasco;104;57;47;2015
16;Cuenca;264;Villarejo de Fuentes;488;246;242;2015
16;Cuenca;265;Villarejo de la Peñuela;21;7;14;2015
16;Cuenca;266;Villarejo-Periesteban;324;165;159;2015
16;Cuenca;269;Villares del Saz;517;257;260;2015
16;Cuenca;270;Villarrubio;211;115;96;2015
16;Cuenca;271;Villarta;917;468;449;2015
16;Cuenca;272;Villas de la Ventosa;280;152;128;2015
16;Cuenca;273;Villaverde y Pasaconsol;352;185;167;2015
16;Cuenca;274;Víllora;141;75;66;2015
16;Cuenca;275;Vindel;12;7;5;2015
16;Cuenca;276;Yémeda;23;17;6;2015
16;Cuenca;277;Zafra de Záncara;137;73;64;2015
16;Cuenca;278;Zafrilla;75;38;37;2015
16;Cuenca;279;Zarza de Tajo;296;153;143;2015
16;Cuenca;280;Zarzuela;204;109;95;2015
20;Gipuzkoa;001;Abaltzisketa;329;182;147;2015
20;Gipuzkoa;002;Aduna;470;255;215;2015
20;Gipuzkoa;016;Aia;2051;1094;957;2015
20;Gipuzkoa;003;Aizarnazabal;775;391;384;2015
20;Gipuzkoa;004;Albiztur;320;167;153;2015
20;Gipuzkoa;005;Alegia;1741;889;852;2015
20;Gipuzkoa;006;Alkiza;362;187;175;2015
20;Gipuzkoa;906;Altzaga;176;87;89;2015
20;Gipuzkoa;007;Altzo;405;208;197;2015
20;Gipuzkoa;008;Amezketa;942;510;432;2015
20;Gipuzkoa;009;Andoain;14668;7263;7405;2015
20;Gipuzkoa;010;Anoeta;1959;1015;944;2015
20;Gipuzkoa;011;Antzuola;2193;1106;1087;2015
20;Gipuzkoa;012;Arama;210;107;103;2015
20;Gipuzkoa;013;Aretxabaleta;6974;3531;3443;2015
20;Gipuzkoa;055;Arrasate/Mondragón;22055;10934;11121;2015
20;Gipuzkoa;014;Asteasu;1525;806;719;2015
20;Gipuzkoa;903;Astigarraga;5688;2916;2772;2015
20;Gipuzkoa;015;Ataun;1674;874;800;2015
20;Gipuzkoa;017;Azkoitia;11566;5800;5766;2015
20;Gipuzkoa;018;Azpeitia;14675;7385;7290;2015
20;Gipuzkoa;904;Baliarrain;147;81;66;2015
20;Gipuzkoa;019;Beasain;13980;7067;6913;2015
20;Gipuzkoa;020;Beizama;165;102;63;2015
20;Gipuzkoa;021;Belauntza;248;131;117;2015
20;Gipuzkoa;022;Berastegi;1061;552;509;2015
20;Gipuzkoa;074;Bergara;14780;7354;7426;2015
20;Gipuzkoa;023;Berrobi;583;304;279;2015
20;Gipuzkoa;024;Bidania-Goiatz;526;281;245;2015
20;Gipuzkoa;029;Deba;5463;2744;2719;2015
20;Gipuzkoa;069;Donostia/San Sebastián;186095;87532;98563;2015
20;Gipuzkoa;030;Eibar;27414;13300;14114;2015
20;Gipuzkoa;031;Elduain;244;127;117;2015
20;Gipuzkoa;033;Elgeta;1116;561;555;2015
20;Gipuzkoa;032;Elgoibar;11589;5766;5823;2015
20;Gipuzkoa;067;Errenteria;39276;19123;20153;2015
20;Gipuzkoa;066;Errezil;593;305;288;2015
20;Gipuzkoa;034;Eskoriatza;4085;2069;2016;2015
20;Gipuzkoa;035;Ezkio-Itsaso;619;319;300;2015
20;Gipuzkoa;038;Gabiria;491;260;231;2015
20;Gipuzkoa;037;Gaintza;122;72;50;2015
20;Gipuzkoa;907;Gaztelu;164;94;70;2015
20;Gipuzkoa;039;Getaria;2783;1413;1370;2015
20;Gipuzkoa;040;Hernani;19600;9582;10018;2015
20;Gipuzkoa;041;Hernialde;331;168;163;2015
20;Gipuzkoa;036;Hondarribia;16945;8421;8524;2015
20;Gipuzkoa;042;Ibarra;4278;2154;2124;2015
20;Gipuzkoa;043;Idiazabal;2308;1158;1150;2015
20;Gipuzkoa;044;Ikaztegieta;486;252;234;2015
20;Gipuzkoa;045;Irun;61481;30089;31392;2015
20;Gipuzkoa;046;Irura;1690;887;803;2015
20;Gipuzkoa;047;Itsasondo;675;336;339;2015
20;Gipuzkoa;048;Larraul;249;138;111;2015
20;Gipuzkoa;902;Lasarte-Oria;18093;8835;9258;2015
20;Gipuzkoa;049;Lazkao;5456;2761;2695;2015
20;Gipuzkoa;050;Leaburu;368;196;172;2015
20;Gipuzkoa;051;Legazpi;8521;4335;4186;2015
20;Gipuzkoa;052;Legorreta;1441;722;719;2015
20;Gipuzkoa;068;Leintz-Gatzaga;241;128;113;2015
20;Gipuzkoa;053;Lezo;5990;2976;3014;2015
20;Gipuzkoa;054;Lizartza;624;335;289;2015
20;Gipuzkoa;901;Mendaro;2026;1026;1000;2015
20;Gipuzkoa;057;Mutiloa;266;143;123;2015
20;Gipuzkoa;056;Mutriku;5313;2680;2633;2015
20;Gipuzkoa;063;Oiartzun;10148;5040;5108;2015
20;Gipuzkoa;058;Olaberria;932;475;457;2015
20;Gipuzkoa;059;Oñati;11276;5595;5681;2015
20;Gipuzkoa;076;Ordizia;9846;4928;4918;2015
20;Gipuzkoa;905;Orendain;193;101;92;2015
20;Gipuzkoa;060;Orexa;126;66;60;2015
20;Gipuzkoa;061;Orio;5805;2929;2876;2015
20;Gipuzkoa;062;Ormaiztegi;1304;662;642;2015
20;Gipuzkoa;064;Pasaia;16012;7701;8311;2015
20;Gipuzkoa;070;Segura;1476;749;727;2015
20;Gipuzkoa;065;Soraluze-Placencia de las Armas;3947;1991;1956;2015
20;Gipuzkoa;071;Tolosa;19113;9194;9919;2015
20;Gipuzkoa;072;Urnieta;6239;3123;3116;2015
20;Gipuzkoa;077;Urretxu;6908;3450;3458;2015
20;Gipuzkoa;073;Usurbil;6183;3126;3057;2015
20;Gipuzkoa;075;Villabona;5862;2942;2920;2015
20;Gipuzkoa;078;Zaldibia;1577;829;748;2015
20;Gipuzkoa;079;Zarautz;22988;11209;11779;2015
20;Gipuzkoa;025;Zegama;1517;777;740;2015
20;Gipuzkoa;026;Zerain;255;118;137;2015
20;Gipuzkoa;027;Zestoa;3714;1956;1758;2015
20;Gipuzkoa;028;Zizurkil;3010;1515;1495;2015
20;Gipuzkoa;081;Zumaia;9798;4866;4932;2015
20;Gipuzkoa;080;Zumarraga;9921;4871;5050;2015
17;Girona;001;Agullana;828;418;410;2015
17;Girona;002;Aiguaviva;775;391;384;2015
17;Girona;003;Albanyà;149;85;64;2015
17;Girona;004;Albons;745;382;363;2015
17;Girona;006;Alp;1595;835;760;2015
17;Girona;007;Amer;2250;1095;1155;2015
17;Girona;008;Anglès;5540;2748;2792;2015
17;Girona;009;Arbúcies;6297;3259;3038;2015
17;Girona;010;Argelaguer;412;221;191;2015
17;Girona;011;Armentera, L';907;451;456;2015
17;Girona;012;Avinyonet de Puigventós;1565;795;770;2015
17;Girona;015;Banyoles;19299;9652;9647;2015
17;Girona;016;Bàscara;943;479;464;2015
17;Girona;013;Begur;3985;2019;1966;2015
17;Girona;018;Bellcaire d'Empordà;652;316;336;2015
17;Girona;019;Besalú;2437;1154;1283;2015
17;Girona;020;Bescanó;4807;2411;2396;2015
17;Girona;021;Beuda;193;100;93;2015
17;Girona;022;Bisbal d'Empordà, La;10759;5370;5389;2015
17;Girona;234;Biure;242;129;113;2015
17;Girona;023;Blanes;39132;19561;19571;2015
17;Girona;029;Boadella i les Escaules;261;134;127;2015
17;Girona;024;Bolvir;380;195;185;2015
17;Girona;025;Bordils;1710;844;866;2015
17;Girona;026;Borrassà;711;368;343;2015
17;Girona;027;Breda;3728;1862;1866;2015
17;Girona;028;Brunyola;394;199;195;2015
17;Girona;031;Cabanelles;237;130;107;2015
17;Girona;030;Cabanes;931;499;432;2015
17;Girona;032;Cadaqués;2840;1371;1469;2015
17;Girona;033;Caldes de Malavella;7166;3559;3607;2015
17;Girona;034;Calonge;10520;5272;5248;2015
17;Girona;035;Camós;683;346;337;2015
17;Girona;036;Campdevànol;3352;1653;1699;2015
17;Girona;037;Campelles;127;64;63;2015
17;Girona;038;Campllong;499;247;252;2015
17;Girona;039;Camprodon;2299;1126;1173;2015
17;Girona;040;Canet d'Adri;671;340;331;2015
17;Girona;041;Cantallops;328;166;162;2015
17;Girona;042;Capmany;590;307;283;2015
17;Girona;044;Cassà de la Selva;10030;5132;4898;2015
17;Girona;046;Castellfollit de la Roca;992;498;494;2015
17;Girona;047;Castelló d'Empúries;10870;5502;5368;2015
17;Girona;048;Castell-Platja d'Aro;10589;5251;5338;2015
17;Girona;189;Cellera de Ter, La;2071;1028;1043;2015
17;Girona;049;Celrà;5155;2591;2564;2015
17;Girona;050;Cervià de Ter;926;468;458;2015
17;Girona;051;Cistella;303;146;157;2015
17;Girona;054;Colera;533;270;263;2015
17;Girona;055;Colomers;189;91;98;2015
17;Girona;057;Corçà;1244;628;616;2015
17;Girona;056;Cornellà del Terri;2236;1147;1089;2015
17;Girona;058;Crespià;256;133;123;2015
17;Girona;901;Cruïlles, Monells i Sant Sadurní de l'Heura;1304;664;640;2015
17;Girona;060;Darnius;554;282;272;2015
17;Girona;061;Das;222;122;100;2015
17;Girona;062;Escala, L';10276;5210;5066;2015
17;Girona;063;Espinelves;196;95;101;2015
17;Girona;064;Espolla;415;205;210;2015
17;Girona;065;Esponellà;444;221;223;2015
17;Girona;005;Far d'Empordà, El;552;279;273;2015
17;Girona;066;Figueres;45346;22471;22875;2015
17;Girona;067;Flaçà;1060;506;554;2015
17;Girona;068;Foixà;306;157;149;2015
17;Girona;069;Fontanals de Cerdanya;450;237;213;2015
17;Girona;070;Fontanilles;144;86;58;2015
17;Girona;071;Fontcoberta;1448;709;739;2015
17;Girona;902;Forallac;1705;832;873;2015
17;Girona;073;Fornells de la Selva;2528;1244;1284;2015
17;Girona;074;Fortià;723;347;376;2015
17;Girona;075;Garrigàs;423;220;203;2015
17;Girona;076;Garrigoles;160;88;72;2015
17;Girona;077;Garriguella;842;419;423;2015
17;Girona;078;Ger;430;230;200;2015
17;Girona;079;Girona;97586;46761;50825;2015
17;Girona;080;Gombrèn;185;92;93;2015
17;Girona;081;Gualta;368;203;165;2015
17;Girona;082;Guils de Cerdanya;523;275;248;2015
17;Girona;083;Hostalric;4005;2017;1988;2015
17;Girona;084;Isòvol;281;156;125;2015
17;Girona;085;Jafre;387;208;179;2015
17;Girona;086;Jonquera, La;3220;1615;1605;2015
17;Girona;087;Juià;338;177;161;2015
17;Girona;088;Lladó;767;380;387;2015
17;Girona;089;Llagostera;8224;4214;4010;2015
17;Girona;090;Llambilles;733;374;359;2015
17;Girona;091;Llanars;512;267;245;2015
17;Girona;092;Llançà;4985;2466;2519;2015
17;Girona;093;Llers;1209;605;604;2015
17;Girona;094;Llívia;1456;787;669;2015
17;Girona;095;Lloret de Mar;37618;19338;18280;2015
17;Girona;096;Llosses, Les;226;129;97;2015
17;Girona;102;Maçanet de Cabrenys;755;379;376;2015
17;Girona;103;Maçanet de la Selva;6887;3527;3360;2015
17;Girona;097;Madremanya;276;138;138;2015
17;Girona;098;Maià de Montcal;446;229;217;2015
17;Girona;100;Masarac;294;154;140;2015
17;Girona;101;Massanes;722;381;341;2015
17;Girona;099;Meranges;100;58;42;2015
17;Girona;105;Mieres;330;169;161;2015
17;Girona;106;Mollet de Peralada;180;95;85;2015
17;Girona;107;Molló;330;160;170;2015
17;Girona;109;Montagut i Oix;949;498;451;2015
17;Girona;110;Mont-ras;1710;859;851;2015
17;Girona;111;Navata;1323;652;671;2015
17;Girona;112;Ogassa;232;136;96;2015
17;Girona;114;Olot;33944;16845;17099;2015
17;Girona;115;Ordis;389;208;181;2015
17;Girona;116;Osor;421;217;204;2015
17;Girona;117;Palafrugell;22733;11313;11420;2015
17;Girona;118;Palamós;17911;8751;9160;2015
17;Girona;119;Palau de Santa Eulàlia;88;54;34;2015
17;Girona;121;Palau-sator;298;157;141;2015
17;Girona;120;Palau-saverdera;1485;742;743;2015
17;Girona;123;Palol de Revardit;466;240;226;2015
17;Girona;124;Pals;2501;1265;1236;2015
17;Girona;125;Pardines;155;87;68;2015
17;Girona;126;Parlavà;398;208;190;2015
17;Girona;128;Pau;557;276;281;2015
17;Girona;129;Pedret i Marzà;193;106;87;2015
17;Girona;130;Pera, La;441;210;231;2015
17;Girona;132;Peralada;1841;920;921;2015
17;Girona;133;Planes d'Hostoles, Les;1674;848;826;2015
17;Girona;134;Planoles;298;161;137;2015
17;Girona;135;Pont de Molins;512;251;261;2015
17;Girona;136;Pontós;231;131;100;2015
17;Girona;137;Porqueres;4521;2253;2268;2015
17;Girona;140;Port de la Selva, El;1002;533;469;2015
17;Girona;138;Portbou;1167;579;588;2015
17;Girona;139;Preses, Les;1764;873;891;2015
17;Girona;141;Puigcerdà;8825;4412;4413;2015
17;Girona;142;Quart;3448;1734;1714;2015
17;Girona;043;Queralbs;173;100;73;2015
17;Girona;143;Rabós;182;90;92;2015
17;Girona;144;Regencós;285;148;137;2015
17;Girona;145;Ribes de Freser;1818;896;922;2015
17;Girona;146;Riells i Viabrea;3945;2042;1903;2015
17;Girona;147;Ripoll;10632;5217;5415;2015
17;Girona;148;Riudarenes;2120;1091;1029;2015
17;Girona;149;Riudaura;461;225;236;2015
17;Girona;150;Riudellots de la Selva;2022;1030;992;2015
17;Girona;151;Riumors;245;122;123;2015
17;Girona;152;Roses;19575;9806;9769;2015
17;Girona;153;Rupià;248;125;123;2015
17;Girona;154;Sales de Llierca;139;68;71;2015
17;Girona;155;Salt;29342;15461;13881;2015
17;Girona;157;Sant Andreu Salou;149;79;70;2015
17;Girona;183;Sant Aniol de Finestres;373;196;177;2015
17;Girona;158;Sant Climent Sescebes;601;346;255;2015
17;Girona;159;Sant Feliu de Buixalleu;787;411;376;2015
17;Girona;160;Sant Feliu de Guíxols;21586;10668;10918;2015
17;Girona;161;Sant Feliu de Pallerols;1332;654;678;2015
17;Girona;162;Sant Ferriol;239;135;104;2015
17;Girona;163;Sant Gregori;3498;1762;1736;2015
17;Girona;164;Sant Hilari Sacalm;5608;2843;2765;2015
17;Girona;165;Sant Jaume de Llierca;841;412;429;2015
17;Girona;167;Sant Joan de les Abadesses;3383;1676;1707;2015
17;Girona;168;Sant Joan de Mollet;497;240;257;2015
17;Girona;185;Sant Joan les Fonts;2937;1451;1486;2015
17;Girona;166;Sant Jordi Desvalls;720;349;371;2015
17;Girona;169;Sant Julià de Ramis;3415;1724;1691;2015
17;Girona;903;Sant Julià del Llor i Bonmatí;1272;654;618;2015
17;Girona;171;Sant Llorenç de la Muga;255;129;126;2015
17;Girona;172;Sant Martí de Llémena;605;319;286;2015
17;Girona;173;Sant Martí Vell;248;131;117;2015
17;Girona;174;Sant Miquel de Campmajor;219;115;104;2015
17;Girona;175;Sant Miquel de Fluvià;756;395;361;2015
17;Girona;176;Sant Mori;176;96;80;2015
17;Girona;177;Sant Pau de Segúries;682;336;346;2015
17;Girona;178;Sant Pere Pescador;2143;1159;984;2015
17;Girona;180;Santa Coloma de Farners;12681;6447;6234;2015
17;Girona;181;Santa Cristina d'Aro;5089;2570;2519;2015
17;Girona;182;Santa Llogaia d'Àlguema;339;178;161;2015
17;Girona;184;Santa Pau;1562;796;766;2015
17;Girona;186;Sarrià de Ter;4973;2474;2499;2015
17;Girona;187;Saus, Camallera i Llampaies;830;413;417;2015
17;Girona;188;Selva de Mar, La;184;103;81;2015
17;Girona;190;Serinyà;1130;585;545;2015
17;Girona;191;Serra de Daró;209;114;95;2015
17;Girona;192;Setcases;180;100;80;2015
17;Girona;193;Sils;5797;2932;2865;2015
17;Girona;052;Siurana;152;73;79;2015
17;Girona;194;Susqueda;92;55;37;2015
17;Girona;195;Tallada d'Empordà, La;458;237;221;2015
17;Girona;196;Terrades;294;145;149;2015
17;Girona;197;Torrent;169;91;78;2015
17;Girona;198;Torroella de Fluvià;732;387;345;2015
17;Girona;199;Torroella de Montgrí;11388;5778;5610;2015
17;Girona;200;Tortellà;775;377;398;2015
17;Girona;201;Toses;155;92;63;2015
17;Girona;202;Tossa de Mar;5623;2857;2766;2015
17;Girona;204;Ullà;1068;593;475;2015
17;Girona;205;Ullastret;295;144;151;2015
17;Girona;203;Ultramort;200;111;89;2015
17;Girona;206;Urús;176;83;93;2015
17;Girona;014;Vajol, La;88;50;38;2015
17;Girona;208;Vall de Bianya, La;1297;661;636;2015
17;Girona;207;Vall d'en Bas, La;2966;1480;1486;2015
17;Girona;170;Vallfogona de Ripollès;205;111;94;2015
17;Girona;209;Vall-llobrega;915;458;457;2015
17;Girona;210;Ventalló;830;429;401;2015
17;Girona;211;Verges;1197;578;619;2015
17;Girona;212;Vidrà;173;89;84;2015
17;Girona;213;Vidreres;7741;4006;3735;2015
17;Girona;214;Vilabertran;902;460;442;2015
17;Girona;215;Vilablareix;2559;1256;1303;2015
17;Girona;217;Viladamat;441;229;212;2015
17;Girona;216;Viladasens;221;114;107;2015
17;Girona;218;Vilademuls;834;436;398;2015
17;Girona;220;Viladrau;1035;527;508;2015
17;Girona;221;Vilafant;5543;2720;2823;2015
17;Girona;223;Vilajuïga;1169;577;592;2015
17;Girona;224;Vilallonga de Ter;398;205;193;2015
17;Girona;225;Vilamacolum;294;150;144;2015
17;Girona;226;Vilamalla;1133;581;552;2015
17;Girona;227;Vilamaniscle;179;97;82;2015
17;Girona;228;Vilanant;399;198;201;2015
17;Girona;230;Vila-sacra;670;319;351;2015
17;Girona;222;Vilaür;159;80;79;2015
17;Girona;233;Vilobí d'Onyar;3166;1647;1519;2015
17;Girona;232;Vilopriu;199;107;92;2015
18;Granada;001;Agrón;310;157;153;2015
18;Granada;002;Alamedilla;637;331;306;2015
18;Granada;003;Albolote;18464;9210;9254;2015
18;Granada;004;Albondón;782;437;345;2015
18;Granada;005;Albuñán;420;218;202;2015
18;Granada;006;Albuñol;6948;3677;3271;2015
18;Granada;007;Albuñuelas;893;451;442;2015
18;Granada;010;Aldeire;631;334;297;2015
18;Granada;011;Alfacar;5445;2763;2682;2015
18;Granada;012;Algarinejo;2813;1445;1368;2015
18;Granada;013;Alhama de Granada;6126;3289;2837;2015
18;Granada;014;Alhendín;8503;4333;4170;2015
18;Granada;015;Alicún de Ortega;523;273;250;2015
18;Granada;016;Almegíjar;376;207;169;2015
18;Granada;017;Almuñécar;27391;13558;13833;2015
18;Granada;904;Alpujarra de la Sierra;1041;559;482;2015
18;Granada;018;Alquife;718;358;360;2015
18;Granada;020;Arenas del Rey;1865;963;902;2015
18;Granada;021;Armilla;23623;11828;11795;2015
18;Granada;022;Atarfe;17792;8852;8940;2015
18;Granada;023;Baza;20668;10280;10388;2015
18;Granada;024;Beas de Granada;1012;549;463;2015
18;Granada;025;Beas de Guadix;363;184;179;2015
18;Granada;027;Benalúa;3298;1644;1654;2015
18;Granada;028;Benalúa de las Villas;1148;602;546;2015
18;Granada;029;Benamaurel;2378;1210;1168;2015
18;Granada;030;Bérchules;739;394;345;2015
18;Granada;032;Bubión;309;159;150;2015
18;Granada;033;Busquístar;289;155;134;2015
18;Granada;034;Cacín;589;298;291;2015
18;Granada;035;Cádiar;1554;808;746;2015
18;Granada;036;Cájar;4909;2383;2526;2015
18;Granada;114;Calahorra, La;719;359;360;2015
18;Granada;037;Calicasas;606;295;311;2015
18;Granada;038;Campotéjar;1301;676;625;2015
18;Granada;039;Caniles;4351;2206;2145;2015
18;Granada;040;Cáñar;405;209;196;2015
18;Granada;042;Capileira;508;249;259;2015
18;Granada;043;Carataunas;210;113;97;2015
18;Granada;044;Cástaras;250;153;97;2015
18;Granada;045;Castilléjar;1400;735;665;2015
18;Granada;046;Castril;2276;1159;1117;2015
18;Granada;047;Cenes de la Vega;7942;4007;3935;2015
18;Granada;059;Chauchina;5428;2696;2732;2015
18;Granada;061;Chimeneas;1360;719;641;2015
18;Granada;062;Churriana de la Vega;13907;6919;6988;2015
18;Granada;048;Cijuela;3221;1640;1581;2015
18;Granada;049;Cogollos de Guadix;718;390;328;2015
18;Granada;050;Cogollos de la Vega;2099;1045;1054;2015
18;Granada;051;Colomera;1416;746;670;2015
18;Granada;053;Cortes de Baza;2058;1039;1019;2015
18;Granada;054;Cortes y Graena;1043;538;505;2015
18;Granada;912;Cuevas del Campo;1882;942;940;2015
18;Granada;056;Cúllar;4351;2183;2168;2015
18;Granada;057;Cúllar Vega;7128;3608;3520;2015
18;Granada;063;Darro;1545;772;773;2015
18;Granada;064;Dehesas de Guadix;454;229;225;2015
18;Granada;065;Dehesas Viejas;783;399;384;2015
18;Granada;066;Deifontes;2624;1321;1303;2015
18;Granada;067;Diezma;780;395;385;2015
18;Granada;068;Dílar;1838;920;918;2015
18;Granada;069;Dólar;621;323;298;2015
18;Granada;070;Dúdar;348;188;160;2015
18;Granada;071;Dúrcal;7123;3527;3596;2015
18;Granada;072;Escúzar;791;399;392;2015
18;Granada;074;Ferreira;314;159;155;2015
18;Granada;076;Fonelas;1054;548;506;2015
18;Granada;078;Freila;950;482;468;2015
18;Granada;079;Fuente Vaqueros;4457;2228;2229;2015
18;Granada;905;Gabias, Las;19603;10017;9586;2015
18;Granada;082;Galera;1150;569;581;2015
18;Granada;083;Gobernador;298;140;158;2015
18;Granada;084;Gójar;5410;2771;2639;2015
18;Granada;085;Gor;777;396;381;2015
18;Granada;086;Gorafe;420;216;204;2015
18;Granada;087;Granada;235800;109370;126430;2015
18;Granada;088;Guadahortuna;1989;1015;974;2015
18;Granada;089;Guadix;18928;9354;9574;2015
18;Granada;906;Guajares, Los;1087;572;515;2015
18;Granada;093;Gualchos;4849;2477;2372;2015
18;Granada;094;Güejar Sierra;2953;1553;1400;2015
18;Granada;095;Güevéjar;2540;1341;1199;2015
18;Granada;096;Huélago;430;221;209;2015
18;Granada;097;Huéneja;1168;618;550;2015
18;Granada;098;Huéscar;7677;3790;3887;2015
18;Granada;099;Huétor de Santillán;1872;960;912;2015
18;Granada;100;Huétor Tájar;10147;5103;5044;2015
18;Granada;101;Huétor Vega;11849;5950;5899;2015
18;Granada;102;Illora;10423;5203;5220;2015
18;Granada;103;Itrabo;1018;511;507;2015
18;Granada;105;Iznalloz;6016;3086;2930;2015
18;Granada;107;Jayena;1178;595;583;2015
18;Granada;108;Jerez del Marquesado;1021;525;496;2015
18;Granada;109;Jete;908;466;442;2015
18;Granada;111;Jun;3620;1842;1778;2015
18;Granada;112;Juviles;153;72;81;2015
18;Granada;115;Láchar;3263;1666;1597;2015
18;Granada;116;Lanjarón;3715;1838;1877;2015
18;Granada;117;Lanteira;546;286;260;2015
18;Granada;119;Lecrín;2138;1083;1055;2015
18;Granada;120;Lentegí;346;183;163;2015
18;Granada;121;Lobras;166;84;82;2015
18;Granada;122;Loja;20893;10475;10418;2015
18;Granada;123;Lugros;320;176;144;2015
18;Granada;124;Lújar;517;274;243;2015
18;Granada;126;Malahá, La;1834;918;916;2015
18;Granada;127;Maracena;21816;10743;11073;2015
18;Granada;128;Marchal;427;198;229;2015
18;Granada;132;Moclín;3976;1971;2005;2015
18;Granada;133;Molvízar;2895;1473;1422;2015
18;Granada;134;Monachil;7538;3900;3638;2015
18;Granada;135;Montefrío;5720;2872;2848;2015
18;Granada;136;Montejícar;2230;1139;1091;2015
18;Granada;137;Montillana;1330;703;627;2015
18;Granada;138;Moraleda de Zafayona;3200;1629;1571;2015
18;Granada;909;Morelábor;693;373;320;2015
18;Granada;140;Motril;60777;29914;30863;2015
18;Granada;141;Murtas;524;301;223;2015
18;Granada;903;Nevada;1123;574;549;2015
18;Granada;143;Nigüelas;1214;616;598;2015
18;Granada;144;Nívar;922;476;446;2015
18;Granada;145;Ogíjares;13719;6775;6944;2015
18;Granada;146;Orce;1226;633;593;2015
18;Granada;147;Órgiva;5483;2752;2731;2015
18;Granada;148;Otívar;1093;549;544;2015
18;Granada;150;Padul;8407;4236;4171;2015
18;Granada;151;Pampaneira;315;157;158;2015
18;Granada;152;Pedro Martínez;1150;564;586;2015
18;Granada;153;Peligros;11154;5544;5610;2015
18;Granada;154;Peza, La;1250;645;605;2015
18;Granada;910;Pinar, El;996;516;480;2015
18;Granada;157;Pinos Genil;1438;745;693;2015
18;Granada;158;Pinos Puente;10605;5315;5290;2015
18;Granada;159;Píñar;1209;670;539;2015
18;Granada;161;Polícar;235;122;113;2015
18;Granada;162;Polopos;1680;885;795;2015
18;Granada;163;Pórtugos;409;213;196;2015
18;Granada;164;Puebla de Don Fadrique;2329;1211;1118;2015
18;Granada;165;Pulianas;5366;2666;2700;2015
18;Granada;167;Purullena;2399;1202;1197;2015
18;Granada;168;Quéntar;974;495;479;2015
18;Granada;170;Rubite;392;221;171;2015
18;Granada;171;Salar;2712;1366;1346;2015
18;Granada;173;Salobreña;12429;6171;6258;2015
18;Granada;174;Santa Cruz del Comercio;549;288;261;2015
18;Granada;175;Santa Fe;15067;7428;7639;2015
18;Granada;176;Soportújar;296;167;129;2015
18;Granada;177;Sorvilán;552;281;271;2015
18;Granada;901;Taha, La;643;334;309;2015
18;Granada;178;Torre-Cardela;847;437;410;2015
18;Granada;179;Torvizcón;708;372;336;2015
18;Granada;180;Trevélez;786;411;375;2015
18;Granada;181;Turón;265;159;106;2015
18;Granada;182;Ugíjar;2560;1259;1301;2015
18;Granada;914;Valderrubio;2111;1040;1071;2015
18;Granada;907;Valle del Zalabí;2229;1134;1095;2015
18;Granada;902;Valle, El;1013;496;517;2015
18;Granada;183;Válor;654;337;317;2015
18;Granada;911;Vegas del Genil;10423;5327;5096;2015
18;Granada;184;Vélez de Benaudalla;2903;1461;1442;2015
18;Granada;185;Ventas de Huelma;661;352;309;2015
18;Granada;149;Villa de Otura;6783;3442;3341;2015
18;Granada;908;Villamena;1016;510;506;2015
18;Granada;187;Villanueva de las Torres;661;350;311;2015
18;Granada;188;Villanueva Mesía;2013;1008;1005;2015
18;Granada;189;Víznar;971;499;472;2015
18;Granada;192;Zafarraya;2040;1087;953;2015
18;Granada;913;Zagra;899;460;439;2015
18;Granada;193;Zubia, La;18675;9160;9515;2015
18;Granada;194;Zújar;2777;1432;1345;2015
19;Guadalajara;001;Abánades;63;37;26;2015
19;Guadalajara;002;Ablanque;74;41;33;2015
19;Guadalajara;003;Adobes;43;23;20;2015
19;Guadalajara;004;Alaminos;73;34;39;2015
19;Guadalajara;005;Alarilla;90;59;31;2015
19;Guadalajara;006;Albalate de Zorita;997;550;447;2015
19;Guadalajara;007;Albares;589;314;275;2015
19;Guadalajara;008;Albendiego;43;28;15;2015
19;Guadalajara;009;Alcocer;360;188;172;2015
19;Guadalajara;010;Alcolea de las Peñas;13;8;5;2015
19;Guadalajara;011;Alcolea del Pinar;343;190;153;2015
19;Guadalajara;013;Alcoroches;141;83;58;2015
19;Guadalajara;015;Aldeanueva de Guadalajara;79;43;36;2015
19;Guadalajara;016;Algar de Mesa;67;44;23;2015
19;Guadalajara;017;Algora;77;50;27;2015
19;Guadalajara;018;Alhóndiga;184;104;80;2015
19;Guadalajara;019;Alique;18;7;11;2015
19;Guadalajara;020;Almadrones;59;37;22;2015
19;Guadalajara;021;Almoguera;1401;733;668;2015
19;Guadalajara;022;Almonacid de Zorita;760;362;398;2015
19;Guadalajara;023;Alocén;168;91;77;2015
19;Guadalajara;024;Alovera;12247;6272;5975;2015
19;Guadalajara;027;Alustante;172;101;71;2015
19;Guadalajara;031;Angón;15;12;3;2015
19;Guadalajara;032;Anguita;205;107;98;2015
19;Guadalajara;033;Anquela del Ducado;69;41;28;2015
19;Guadalajara;034;Anquela del Pedregal;19;14;5;2015
19;Guadalajara;036;Aranzueque;436;221;215;2015
19;Guadalajara;037;Arbancón;157;91;66;2015
19;Guadalajara;038;Arbeteta;29;19;10;2015
19;Guadalajara;039;Argecilla;70;48;22;2015
19;Guadalajara;040;Armallones;54;33;21;2015
19;Guadalajara;041;Armuña de Tajuña;240;124;116;2015
19;Guadalajara;042;Arroyo de las Fraguas;28;16;12;2015
19;Guadalajara;043;Atanzón;81;50;31;2015
19;Guadalajara;044;Atienza;458;253;205;2015
19;Guadalajara;045;Auñón;163;87;76;2015
19;Guadalajara;046;Azuqueca de Henares;34896;17780;17116;2015
19;Guadalajara;047;Baides;73;36;37;2015
19;Guadalajara;048;Baños de Tajo;17;13;4;2015
19;Guadalajara;049;Bañuelos;17;15;2;2015
19;Guadalajara;050;Barriopedro;19;11;8;2015
19;Guadalajara;051;Berninches;65;38;27;2015
19;Guadalajara;052;Bodera, La;31;19;12;2015
19;Guadalajara;053;Brihuega;2538;1327;1211;2015
19;Guadalajara;054;Budia;231;129;102;2015
19;Guadalajara;055;Bujalaro;67;36;31;2015
19;Guadalajara;057;Bustares;80;50;30;2015
19;Guadalajara;058;Cabanillas del Campo;9707;4907;4800;2015
19;Guadalajara;059;Campillo de Dueñas;85;47;38;2015
19;Guadalajara;060;Campillo de Ranas;186;116;70;2015
19;Guadalajara;061;Campisábalos;66;45;21;2015
19;Guadalajara;064;Canredondo;88;49;39;2015
19;Guadalajara;065;Cantalojas;166;104;62;2015
19;Guadalajara;066;Cañizar;71;37;34;2015
19;Guadalajara;067;Cardoso de la Sierra, El;66;44;22;2015
19;Guadalajara;070;Casa de Uceda;111;60;51;2015
19;Guadalajara;071;Casar, El;11606;5949;5657;2015
19;Guadalajara;073;Casas de San Galindo;24;15;9;2015
19;Guadalajara;074;Caspueñas;97;56;41;2015
19;Guadalajara;075;Castejón de Henares;69;42;27;2015
19;Guadalajara;076;Castellar de la Muela;41;18;23;2015
19;Guadalajara;078;Castilforte;57;36;21;2015
19;Guadalajara;079;Castilnuevo;8;5;3;2015
19;Guadalajara;080;Cendejas de Enmedio;86;44;42;2015
19;Guadalajara;081;Cendejas de la Torre;30;18;12;2015
19;Guadalajara;082;Centenera;106;57;49;2015
19;Guadalajara;103;Checa;289;175;114;2015
19;Guadalajara;104;Chequilla;21;11;10;2015
19;Guadalajara;106;Chillarón del Rey;111;64;47;2015
19;Guadalajara;105;Chiloeches;3291;1715;1576;2015
19;Guadalajara;086;Cifuentes;1920;989;931;2015
19;Guadalajara;087;Cincovillas;22;12;10;2015
19;Guadalajara;088;Ciruelas;101;57;44;2015
19;Guadalajara;089;Ciruelos del Pinar;28;16;12;2015
19;Guadalajara;090;Cobeta;121;57;64;2015
19;Guadalajara;091;Cogollor;29;17;12;2015
19;Guadalajara;092;Cogolludo;600;344;256;2015
19;Guadalajara;095;Condemios de Abajo;20;11;9;2015
19;Guadalajara;096;Condemios de Arriba;128;69;59;2015
19;Guadalajara;097;Congostrina;21;14;7;2015
19;Guadalajara;098;Copernal;28;18;10;2015
19;Guadalajara;099;Corduente;365;203;162;2015
19;Guadalajara;102;Cubillo de Uceda, El;145;76;69;2015
19;Guadalajara;107;Driebes;375;195;180;2015
19;Guadalajara;108;Durón;129;64;65;2015
19;Guadalajara;109;Embid;44;25;19;2015
19;Guadalajara;110;Escamilla;71;35;36;2015
19;Guadalajara;111;Escariche;187;108;79;2015
19;Guadalajara;112;Escopete;62;30;32;2015
19;Guadalajara;113;Espinosa de Henares;696;360;336;2015
19;Guadalajara;114;Esplegares;40;26;14;2015
19;Guadalajara;115;Establés;29;19;10;2015
19;Guadalajara;116;Estriégana;21;13;8;2015
19;Guadalajara;117;Fontanar;2338;1228;1110;2015
19;Guadalajara;118;Fuembellida;13;8;5;2015
19;Guadalajara;119;Fuencemillán;99;57;42;2015
19;Guadalajara;120;Fuentelahiguera de Albatages;136;77;59;2015
19;Guadalajara;121;Fuentelencina;332;188;144;2015
19;Guadalajara;122;Fuentelsaz;104;56;48;2015
19;Guadalajara;123;Fuentelviejo;70;33;37;2015
19;Guadalajara;124;Fuentenovilla;543;297;246;2015
19;Guadalajara;125;Gajanejos;50;31;19;2015
19;Guadalajara;126;Galápagos;2368;1264;1104;2015
19;Guadalajara;127;Galve de Sorbe;109;61;48;2015
19;Guadalajara;129;Gascueña de Bornova;39;23;16;2015
19;Guadalajara;130;Guadalajara;83391;40278;43113;2015
19;Guadalajara;132;Henche;100;56;44;2015
19;Guadalajara;133;Heras de Ayuso;252;151;101;2015
19;Guadalajara;134;Herrería;26;17;9;2015
19;Guadalajara;135;Hiendelaencina;133;73;60;2015
19;Guadalajara;136;Hijes;25;16;9;2015
19;Guadalajara;138;Hita;358;196;162;2015
19;Guadalajara;139;Hombrados;38;21;17;2015
19;Guadalajara;142;Hontoba;314;178;136;2015
19;Guadalajara;143;Horche;2544;1306;1238;2015
19;Guadalajara;145;Hortezuela de Océn;52;31;21;2015
19;Guadalajara;146;Huerce, La;39;22;17;2015
19;Guadalajara;147;Huérmeces del Cerro;43;28;15;2015
19;Guadalajara;148;Huertahernando;60;39;21;2015
19;Guadalajara;150;Hueva;140;84;56;2015
19;Guadalajara;151;Humanes;1485;725;760;2015
19;Guadalajara;152;Illana;775;439;336;2015
19;Guadalajara;153;Iniéstola;24;15;9;2015
19;Guadalajara;154;Inviernas, Las;66;44;22;2015
19;Guadalajara;155;Irueste;65;42;23;2015
19;Guadalajara;156;Jadraque;1504;772;732;2015
19;Guadalajara;157;Jirueque;68;41;27;2015
19;Guadalajara;159;Ledanca;102;53;49;2015
19;Guadalajara;160;Loranca de Tajuña;1275;699;576;2015
19;Guadalajara;161;Lupiana;256;135;121;2015
19;Guadalajara;162;Luzaga;65;35;30;2015
19;Guadalajara;163;Luzón;72;37;35;2015
19;Guadalajara;165;Majaelrayo;52;27;25;2015
19;Guadalajara;166;Málaga del Fresno;194;111;83;2015
19;Guadalajara;167;Malaguilla;154;84;70;2015
19;Guadalajara;168;Mandayona;339;174;165;2015
19;Guadalajara;169;Mantiel;49;31;18;2015
19;Guadalajara;170;Maranchón;247;136;111;2015
19;Guadalajara;171;Marchamalo;6750;3418;3332;2015
19;Guadalajara;172;Masegoso de Tajuña;59;33;26;2015
19;Guadalajara;173;Matarrubia;46;33;13;2015
19;Guadalajara;174;Matillas;149;71;78;2015
19;Guadalajara;175;Mazarete;46;22;24;2015
19;Guadalajara;176;Mazuecos;307;156;151;2015
19;Guadalajara;177;Medranda;84;43;41;2015
19;Guadalajara;178;Megina;47;31;16;2015
19;Guadalajara;179;Membrillera;96;49;47;2015
19;Guadalajara;181;Miedes de Atienza;67;37;30;2015
19;Guadalajara;182;Mierla, La;41;28;13;2015
19;Guadalajara;184;Millana;126;72;54;2015
19;Guadalajara;183;Milmarcos;98;56;42;2015
19;Guadalajara;185;Miñosa, La;34;24;10;2015
19;Guadalajara;186;Mirabueno;93;55;38;2015
19;Guadalajara;187;Miralrío;64;38;26;2015
19;Guadalajara;188;Mochales;52;29;23;2015
19;Guadalajara;189;Mohernando;180;96;84;2015
19;Guadalajara;190;Molina de Aragón;3468;1732;1736;2015
19;Guadalajara;191;Monasterio;13;4;9;2015
19;Guadalajara;192;Mondéjar;2579;1325;1254;2015
19;Guadalajara;193;Montarrón;28;15;13;2015
19;Guadalajara;194;Moratilla de los Meleros;111;61;50;2015
19;Guadalajara;195;Morenilla;45;26;19;2015
19;Guadalajara;196;Muduex;116;61;55;2015
19;Guadalajara;197;Navas de Jadraque, Las;27;19;8;2015
19;Guadalajara;198;Negredo;21;12;9;2015
19;Guadalajara;199;Ocentejo;20;14;6;2015
19;Guadalajara;200;Olivar, El;89;54;35;2015
19;Guadalajara;201;Olmeda de Cobeta;73;40;33;2015
19;Guadalajara;202;Olmeda de Jadraque, La;16;9;7;2015
19;Guadalajara;203;Ordial, El;31;17;14;2015
19;Guadalajara;204;Orea;203;123;80;2015
19;Guadalajara;208;Pálmaces de Jadraque;47;25;22;2015
19;Guadalajara;209;Pardos;43;26;17;2015
19;Guadalajara;210;Paredes de Sigüenza;22;12;10;2015
19;Guadalajara;211;Pareja;468;267;201;2015
19;Guadalajara;212;Pastrana;978;506;472;2015
19;Guadalajara;213;Pedregal, El;83;52;31;2015
19;Guadalajara;214;Peñalén;82;48;34;2015
19;Guadalajara;215;Peñalver;187;116;71;2015
19;Guadalajara;216;Peralejos de las Truchas;153;84;69;2015
19;Guadalajara;217;Peralveche;70;45;25;2015
19;Guadalajara;218;Pinilla de Jadraque;55;30;25;2015
19;Guadalajara;219;Pinilla de Molina;17;12;5;2015
19;Guadalajara;220;Pioz;3544;1893;1651;2015
19;Guadalajara;221;Piqueras;56;37;19;2015
19;Guadalajara;222;Pobo de Dueñas, El;134;69;65;2015
19;Guadalajara;223;Poveda de la Sierra;131;67;64;2015
19;Guadalajara;224;Pozo de Almoguera;109;61;48;2015
19;Guadalajara;225;Pozo de Guadalajara;1249;666;583;2015
19;Guadalajara;226;Prádena de Atienza;51;35;16;2015
19;Guadalajara;227;Prados Redondos;74;47;27;2015
19;Guadalajara;228;Puebla de Beleña;46;24;22;2015
19;Guadalajara;229;Puebla de Valles;74;40;34;2015
19;Guadalajara;230;Quer;747;399;348;2015
19;Guadalajara;231;Rebollosa de Jadraque;14;10;4;2015
19;Guadalajara;232;Recuenco, El;74;44;30;2015
19;Guadalajara;233;Renera;111;62;49;2015
19;Guadalajara;234;Retiendas;53;27;26;2015
19;Guadalajara;235;Riba de Saelices;111;62;49;2015
19;Guadalajara;237;Rillo de Gallo;56;32;24;2015
19;Guadalajara;238;Riofrío del Llano;46;27;19;2015
19;Guadalajara;239;Robledillo de Mohernando;109;56;53;2015
19;Guadalajara;240;Robledo de Corpes;55;30;25;2015
19;Guadalajara;241;Romanillos de Atienza;54;33;21;2015
19;Guadalajara;242;Romanones;117;61;56;2015
19;Guadalajara;243;Rueda de la Sierra;50;32;18;2015
19;Guadalajara;244;Sacecorbo;93;52;41;2015
19;Guadalajara;245;Sacedón;1605;841;764;2015
19;Guadalajara;246;Saelices de la Sal;54;31;23;2015
19;Guadalajara;247;Salmerón;177;97;80;2015
19;Guadalajara;248;San Andrés del Congosto;91;51;40;2015
19;Guadalajara;249;San Andrés del Rey;34;15;19;2015
19;Guadalajara;250;Santiuste;19;12;7;2015
19;Guadalajara;251;Saúca;58;32;26;2015
19;Guadalajara;252;Sayatón;89;51;38;2015
19;Guadalajara;254;Selas;63;27;36;2015
19;Guadalajara;901;Semillas;41;25;16;2015
19;Guadalajara;255;Setiles;84;49;35;2015
19;Guadalajara;256;Sienes;55;33;22;2015
19;Guadalajara;257;Sigüenza;4648;2307;2341;2015
19;Guadalajara;258;Solanillos del Extremo;104;60;44;2015
19;Guadalajara;259;Somolinos;33;16;17;2015
19;Guadalajara;260;Sotillo, El;48;26;22;2015
19;Guadalajara;261;Sotodosos;41;17;24;2015
19;Guadalajara;262;Tamajón;148;75;73;2015
19;Guadalajara;263;Taragudo;51;23;28;2015
19;Guadalajara;264;Taravilla;41;26;15;2015
19;Guadalajara;265;Tartanedo;150;87;63;2015
19;Guadalajara;266;Tendilla;339;186;153;2015
19;Guadalajara;267;Terzaga;20;13;7;2015
19;Guadalajara;268;Tierzo;38;24;14;2015
19;Guadalajara;269;Toba, La;105;57;48;2015
19;Guadalajara;271;Tordellego;56;31;25;2015
19;Guadalajara;270;Tordelrábano;21;12;9;2015
19;Guadalajara;272;Tordesilos;108;64;44;2015
19;Guadalajara;274;Torija;1453;763;690;2015
19;Guadalajara;279;Torre del Burgo;228;120;108;2015
19;Guadalajara;277;Torrecuadrada de Molina;23;13;10;2015
19;Guadalajara;278;Torrecuadradilla;31;18;13;2015
19;Guadalajara;280;Torrejón del Rey;5064;2624;2440;2015
19;Guadalajara;281;Torremocha de Jadraque;27;18;9;2015
19;Guadalajara;282;Torremocha del Campo;200;114;86;2015
19;Guadalajara;283;Torremocha del Pinar;40;15;25;2015
19;Guadalajara;284;Torremochuela;11;6;5;2015
19;Guadalajara;285;Torrubia;25;15;10;2015
19;Guadalajara;286;Tórtola de Henares;990;536;454;2015
19;Guadalajara;287;Tortuera;207;108;99;2015
19;Guadalajara;288;Tortuero;20;12;8;2015
19;Guadalajara;289;Traíd;29;18;11;2015
19;Guadalajara;290;Trijueque;1256;659;597;2015
19;Guadalajara;291;Trillo;1436;754;682;2015
19;Guadalajara;293;Uceda;2602;1358;1244;2015
19;Guadalajara;294;Ujados;28;16;12;2015
19;Guadalajara;296;Utande;35;25;10;2015
19;Guadalajara;297;Valdarachas;36;18;18;2015
19;Guadalajara;298;Valdearenas;94;60;34;2015
19;Guadalajara;299;Valdeavellano;102;55;47;2015
19;Guadalajara;300;Valdeaveruelo;1048;533;515;2015
19;Guadalajara;301;Valdeconcha;41;24;17;2015
19;Guadalajara;302;Valdegrudas;66;42;24;2015
19;Guadalajara;303;Valdelcubo;58;36;22;2015
19;Guadalajara;304;Valdenuño Fernández;270;156;114;2015
19;Guadalajara;305;Valdepeñas de la Sierra;192;114;78;2015
19;Guadalajara;306;Valderrebollo;31;15;16;2015
19;Guadalajara;307;Valdesotos;25;14;11;2015
19;Guadalajara;308;Valfermoso de Tajuña;65;41;24;2015
19;Guadalajara;309;Valhermoso;44;27;17;2015
19;Guadalajara;310;Valtablado del Río;12;9;3;2015
19;Guadalajara;311;Valverde de los Arroyos;90;48;42;2015
19;Guadalajara;314;Viana de Jadraque;54;37;17;2015
19;Guadalajara;317;Villanueva de Alcorón;193;100;93;2015
19;Guadalajara;318;Villanueva de Argecilla;31;21;10;2015
19;Guadalajara;319;Villanueva de la Torre;6443;3253;3190;2015
19;Guadalajara;321;Villares de Jadraque;54;35;19;2015
19;Guadalajara;322;Villaseca de Henares;33;17;16;2015
19;Guadalajara;323;Villaseca de Uceda;48;25;23;2015
19;Guadalajara;324;Villel de Mesa;207;111;96;2015
19;Guadalajara;325;Viñuelas;151;83;68;2015
19;Guadalajara;326;Yebes;2741;1440;1301;2015
19;Guadalajara;327;Yebra;539;283;256;2015
19;Guadalajara;329;Yélamos de Abajo;64;34;30;2015
19;Guadalajara;330;Yélamos de Arriba;94;55;39;2015
19;Guadalajara;331;Yunquera de Henares;3755;1932;1823;2015
19;Guadalajara;332;Yunta, La;100;57;43;2015
19;Guadalajara;333;Zaorejas;139;88;51;2015
19;Guadalajara;334;Zarzuela de Jadraque;35;22;13;2015
19;Guadalajara;335;Zorita de los Canes;72;35;37;2015
21;Huelva;001;Alájar;813;413;400;2015
21;Huelva;002;Aljaraque;20357;10150;10207;2015
21;Huelva;003;Almendro, El;829;436;393;2015
21;Huelva;004;Almonaster la Real;1861;978;883;2015
21;Huelva;005;Almonte;23254;11648;11606;2015
21;Huelva;006;Alosno;4038;1966;2072;2015
21;Huelva;007;Aracena;7972;3935;4037;2015
21;Huelva;008;Aroche;3183;1599;1584;2015
21;Huelva;009;Arroyomolinos de León;1018;525;493;2015
21;Huelva;010;Ayamonte;20357;10173;10184;2015
21;Huelva;011;Beas;4304;2181;2123;2015
21;Huelva;012;Berrocal;345;165;180;2015
21;Huelva;013;Bollullos Par del Condado;14324;7142;7182;2015
21;Huelva;014;Bonares;6090;3032;3058;2015
21;Huelva;015;Cabezas Rubias;744;387;357;2015
21;Huelva;016;Cala;1252;633;619;2015
21;Huelva;017;Calañas;4238;2166;2072;2015
21;Huelva;018;Campillo, El;2122;1051;1071;2015
21;Huelva;019;Campofrío;643;320;323;2015
21;Huelva;020;Cañaveral de León;409;199;210;2015
21;Huelva;021;Cartaya;19164;9853;9311;2015
21;Huelva;022;Castaño del Robledo;211;122;89;2015
21;Huelva;023;Cerro de Andévalo, El;2495;1253;1242;2015
21;Huelva;030;Chucena;2122;1076;1046;2015
21;Huelva;024;Corteconcepción;552;275;277;2015
21;Huelva;025;Cortegana;4931;2514;2417;2015
21;Huelva;026;Cortelazor;283;143;140;2015
21;Huelva;027;Cumbres de Enmedio;54;33;21;2015
21;Huelva;028;Cumbres de San Bartolomé;421;210;211;2015
21;Huelva;029;Cumbres Mayores;1848;924;924;2015
21;Huelva;031;Encinasola;1326;684;642;2015
21;Huelva;032;Escacena del Campo;2095;1030;1065;2015
21;Huelva;033;Fuenteheridos;641;332;309;2015
21;Huelva;034;Galaroza;1486;733;753;2015
21;Huelva;035;Gibraleón;12508;6202;6306;2015
21;Huelva;036;Granada de Río-Tinto, La;202;102;100;2015
21;Huelva;037;Granado, El;540;291;249;2015
21;Huelva;038;Higuera de la Sierra;1327;681;646;2015
21;Huelva;039;Hinojales;273;132;141;2015
21;Huelva;040;Hinojos;3862;1942;1920;2015
21;Huelva;041;Huelva;146318;70283;76035;2015
21;Huelva;042;Isla Cristina;21193;10515;10678;2015
21;Huelva;043;Jabugo;2267;1146;1121;2015
21;Huelva;044;Lepe;27675;14051;13624;2015
21;Huelva;045;Linares de la Sierra;272;140;132;2015
21;Huelva;046;Lucena del Puerto;3046;1599;1447;2015
21;Huelva;047;Manzanilla;2108;1065;1043;2015
21;Huelva;048;Marines, Los;273;136;137;2015
21;Huelva;049;Minas de Riotinto;4063;1967;2096;2015
21;Huelva;050;Moguer;21383;10636;10747;2015
21;Huelva;051;Nava, La;289;145;144;2015
21;Huelva;052;Nerva;5514;2656;2858;2015
21;Huelva;053;Niebla;3999;2015;1984;2015
21;Huelva;054;Palma del Condado, La;10662;5327;5335;2015
21;Huelva;055;Palos de la Frontera;10365;5178;5187;2015
21;Huelva;056;Paterna del Campo;3554;1802;1752;2015
21;Huelva;057;Paymogo;1238;623;615;2015
21;Huelva;058;Puebla de Guzmán;3143;1619;1524;2015
21;Huelva;059;Puerto Moral;288;142;146;2015
21;Huelva;060;Punta Umbría;14996;7619;7377;2015
21;Huelva;061;Rociana del Condado;7643;3844;3799;2015
21;Huelva;062;Rosal de la Frontera;1750;881;869;2015
21;Huelva;063;San Bartolomé de la Torre;3608;1813;1795;2015
21;Huelva;064;San Juan del Puerto;8832;4448;4384;2015
21;Huelva;066;San Silvestre de Guzmán;634;347;287;2015
21;Huelva;065;Sanlúcar de Guadiana;443;224;219;2015
21;Huelva;067;Santa Ana la Real;523;240;283;2015
21;Huelva;068;Santa Bárbara de Casa;1113;552;561;2015
21;Huelva;069;Santa Olalla del Cala;2010;1033;977;2015
21;Huelva;070;Trigueros;7746;3830;3916;2015
21;Huelva;071;Valdelarco;225;109;116;2015
21;Huelva;072;Valverde del Camino;12766;6275;6491;2015
21;Huelva;073;Villablanca;2880;1440;1440;2015
21;Huelva;074;Villalba del Alcor;3320;1637;1683;2015
21;Huelva;075;Villanueva de las Cruces;379;184;195;2015
21;Huelva;076;Villanueva de los Castillejos;2747;1380;1367;2015
21;Huelva;077;Villarrasa;2162;1097;1065;2015
21;Huelva;078;Zalamea la Real;3210;1618;1592;2015
21;Huelva;079;Zufre;886;452;434;2015
22;Huesca;001;Abiego;253;136;117;2015
22;Huesca;002;Abizanda;142;73;69;2015
22;Huesca;003;Adahuesca;173;87;86;2015
22;Huesca;004;Agüero;145;85;60;2015
22;Huesca;907;Aínsa-Sobrarbe;2220;1141;1079;2015
22;Huesca;006;Aisa;358;194;164;2015
22;Huesca;007;Albalate de Cinca;1151;609;542;2015
22;Huesca;008;Albalatillo;205;114;91;2015
22;Huesca;009;Albelda;750;391;359;2015
22;Huesca;011;Albero Alto;124;75;49;2015
22;Huesca;012;Albero Bajo;138;74;64;2015
22;Huesca;013;Alberuela de Tubo;314;165;149;2015
22;Huesca;014;Alcalá de Gurrea;273;142;131;2015
22;Huesca;015;Alcalá del Obispo;342;187;155;2015
22;Huesca;016;Alcampell;697;356;341;2015
22;Huesca;017;Alcolea de Cinca;1125;591;534;2015
22;Huesca;018;Alcubierre;399;217;182;2015
22;Huesca;019;Alerre;209;109;100;2015
22;Huesca;020;Alfántega;128;63;65;2015
22;Huesca;021;Almudévar;2501;1288;1213;2015
22;Huesca;022;Almunia de San Juan;679;350;329;2015
22;Huesca;023;Almuniente;522;261;261;2015
22;Huesca;024;Alquézar;297;163;134;2015
22;Huesca;025;Altorricón;1469;785;684;2015
22;Huesca;027;Angüés;391;213;178;2015
22;Huesca;028;Ansó;426;219;207;2015
22;Huesca;029;Antillón;159;85;74;2015
22;Huesca;032;Aragüés del Puerto;119;63;56;2015
22;Huesca;035;Arén;328;173;155;2015
22;Huesca;036;Argavieso;105;61;44;2015
22;Huesca;037;Arguis;126;72;54;2015
22;Huesca;039;Ayerbe;1116;557;559;2015
22;Huesca;040;Azanuy-Alins;173;87;86;2015
22;Huesca;041;Azara;189;95;94;2015
22;Huesca;042;Azlor;141;67;74;2015
22;Huesca;043;Baélls;106;60;46;2015
22;Huesca;044;Bailo;288;171;117;2015
22;Huesca;045;Baldellou;102;58;44;2015
22;Huesca;046;Ballobar;838;425;413;2015
22;Huesca;047;Banastás;305;162;143;2015
22;Huesca;048;Barbastro;17020;8269;8751;2015
22;Huesca;049;Barbués;87;49;38;2015
22;Huesca;050;Barbuñales;99;49;50;2015
22;Huesca;051;Bárcabo;117;68;49;2015
22;Huesca;052;Belver de Cinca;1312;735;577;2015
22;Huesca;053;Benabarre;1127;584;543;2015
22;Huesca;054;Benasque;2090;1109;981;2015
22;Huesca;246;Beranuy;92;53;39;2015
22;Huesca;055;Berbegal;378;193;185;2015
22;Huesca;057;Bielsa;488;249;239;2015
22;Huesca;058;Bierge;244;139;105;2015
22;Huesca;059;Biescas;1487;781;706;2015
22;Huesca;060;Binaced;1507;785;722;2015
22;Huesca;061;Binéfar;9439;4904;4535;2015
22;Huesca;062;Bisaurri;176;95;81;2015
22;Huesca;063;Biscarrués;202;111;91;2015
22;Huesca;064;Blecua y Torres;200;113;87;2015
22;Huesca;066;Boltaña;981;518;463;2015
22;Huesca;067;Bonansa;81;44;37;2015
22;Huesca;068;Borau;95;59;36;2015
22;Huesca;069;Broto;532;287;245;2015
22;Huesca;072;Caldearenas;210;119;91;2015
22;Huesca;074;Campo;437;239;198;2015
22;Huesca;075;Camporrélls;138;78;60;2015
22;Huesca;076;Canal de Berdún;367;197;170;2015
22;Huesca;077;Candasnos;330;171;159;2015
22;Huesca;078;Canfranc;560;313;247;2015
22;Huesca;079;Capdesaso;172;75;97;2015
22;Huesca;080;Capella;361;192;169;2015
22;Huesca;081;Casbas de Huesca;291;156;135;2015
22;Huesca;083;Castejón de Monegros;568;300;268;2015
22;Huesca;084;Castejón de Sos;740;379;361;2015
22;Huesca;082;Castejón del Puente;340;179;161;2015
22;Huesca;085;Castelflorite;120;65;55;2015
22;Huesca;086;Castiello de Jaca;251;139;112;2015
22;Huesca;087;Castigaleu;94;55;39;2015
22;Huesca;088;Castillazuelo;181;89;92;2015
22;Huesca;089;Castillonroy;343;176;167;2015
22;Huesca;094;Chalamera;111;58;53;2015
22;Huesca;095;Chía;90;57;33;2015
22;Huesca;096;Chimillas;358;182;176;2015
22;Huesca;090;Colungo;126;70;56;2015
22;Huesca;099;Esplús;619;316;303;2015
22;Huesca;102;Estada;210;114;96;2015
22;Huesca;103;Estadilla;819;392;427;2015
22;Huesca;105;Estopiñán del Castillo;147;78;69;2015
22;Huesca;106;Fago;25;16;9;2015
22;Huesca;107;Fanlo;112;69;43;2015
22;Huesca;109;Fiscal;361;192;169;2015
22;Huesca;110;Fonz;944;483;461;2015
22;Huesca;111;Foradada del Toscar;187;101;86;2015
22;Huesca;112;Fraga;14921;7614;7307;2015
22;Huesca;113;Fueva, La;622;324;298;2015
22;Huesca;114;Gistaín;138;76;62;2015
22;Huesca;115;Grado, El;433;227;206;2015
22;Huesca;116;Grañén;1859;973;886;2015
22;Huesca;117;Graus;3371;1687;1684;2015
22;Huesca;119;Gurrea de Gállego;1545;798;747;2015
22;Huesca;122;Hoz de Jaca;68;35;33;2015
22;Huesca;908;Hoz y Costean;230;131;99;2015
22;Huesca;124;Huerto;238;132;106;2015
22;Huesca;125;Huesca;52239;24983;27256;2015
22;Huesca;126;Ibieca;110;60;50;2015
22;Huesca;127;Igriés;692;365;327;2015
22;Huesca;128;Ilche;208;107;101;2015
22;Huesca;129;Isábena;276;148;128;2015
22;Huesca;130;Jaca;13088;6504;6584;2015
22;Huesca;131;Jasa;104;59;45;2015
22;Huesca;133;Labuerda;167;89;78;2015
22;Huesca;135;Laluenga;213;116;97;2015
22;Huesca;136;Lalueza;997;520;477;2015
22;Huesca;137;Lanaja;1268;678;590;2015
22;Huesca;139;Laperdiguera;96;51;45;2015
22;Huesca;141;Lascellas-Ponzano;138;83;55;2015
22;Huesca;142;Lascuarre;137;69;68;2015
22;Huesca;143;Laspaúles;281;163;118;2015
22;Huesca;144;Laspuña;290;155;135;2015
22;Huesca;149;Loarre;335;190;145;2015
22;Huesca;150;Loporzano;532;298;234;2015
22;Huesca;151;Loscorrales;106;51;55;2015
22;Huesca;905;Lupiñén-Ortilla;364;181;183;2015
22;Huesca;155;Monesma y Cajigar;87;46;41;2015
22;Huesca;156;Monflorite-Lascasas;313;165;148;2015
22;Huesca;157;Montanuy;221;124;97;2015
22;Huesca;158;Monzón;17260;8779;8481;2015
22;Huesca;160;Naval;259;135;124;2015
22;Huesca;162;Novales;183;93;90;2015
22;Huesca;163;Nueno;552;303;249;2015
22;Huesca;164;Olvena;45;23;22;2015
22;Huesca;165;Ontiñena;569;284;285;2015
22;Huesca;167;Osso de Cinca;746;391;355;2015
22;Huesca;168;Palo;24;12;12;2015
22;Huesca;170;Panticosa;762;390;372;2015
22;Huesca;172;Peñalba;695;348;347;2015
22;Huesca;173;Peñas de Riglos, Las;264;164;100;2015
22;Huesca;174;Peralta de Alcofea;602;318;284;2015
22;Huesca;175;Peralta de Calasanz;233;132;101;2015
22;Huesca;176;Peraltilla;201;104;97;2015
22;Huesca;177;Perarrúa;111;58;53;2015
22;Huesca;178;Pertusa;124;74;50;2015
22;Huesca;181;Piracés;107;59;48;2015
22;Huesca;182;Plan;303;156;147;2015
22;Huesca;184;Poleñino;217;116;101;2015
22;Huesca;186;Pozán de Vero;221;108;113;2015
22;Huesca;187;Puebla de Castro, La;383;195;188;2015
22;Huesca;188;Puente de Montañana;107;46;61;2015
22;Huesca;902;Puente la Reina de Jaca;261;134;127;2015
22;Huesca;189;Puértolas;207;120;87;2015
22;Huesca;190;Pueyo de Araguás, El;149;88;61;2015
22;Huesca;193;Pueyo de Santa Cruz;328;169;159;2015
22;Huesca;195;Quicena;286;145;141;2015
22;Huesca;197;Robres;586;294;292;2015
22;Huesca;199;Sabiñánigo;9598;4814;4784;2015
22;Huesca;200;Sahún;308;163;145;2015
22;Huesca;201;Salas Altas;313;159;154;2015
22;Huesca;202;Salas Bajas;168;80;88;2015
22;Huesca;203;Salillas;101;53;48;2015
22;Huesca;204;Sallent de Gállego;1441;720;721;2015
22;Huesca;205;San Esteban de Litera;498;258;240;2015
22;Huesca;207;San Juan de Plan;148;83;65;2015
22;Huesca;903;San Miguel del Cinca;857;424;433;2015
22;Huesca;206;Sangarrén;235;121;114;2015
22;Huesca;208;Santa Cilia;207;108;99;2015
22;Huesca;209;Santa Cruz de la Serós;186;106;80;2015
22;Huesca;906;Santa María de Dulcis;221;117;104;2015
22;Huesca;212;Santaliestra y San Quílez;104;53;51;2015
22;Huesca;213;Sariñena;4223;2179;2044;2015
22;Huesca;214;Secastilla;144;65;79;2015
22;Huesca;215;Seira;147;81;66;2015
22;Huesca;217;Sena;515;281;234;2015
22;Huesca;218;Senés de Alcubierre;49;23;26;2015
22;Huesca;220;Sesa;190;106;84;2015
22;Huesca;221;Sesué;119;64;55;2015
22;Huesca;222;Siétamo;672;368;304;2015
22;Huesca;223;Sopeira;99;54;45;2015
22;Huesca;904;Sotonera, La;990;514;476;2015
22;Huesca;225;Tamarite de Litera;3538;1809;1729;2015
22;Huesca;226;Tardienta;985;501;484;2015
22;Huesca;227;Tella-Sin;249;141;108;2015
22;Huesca;228;Tierz;742;362;380;2015
22;Huesca;229;Tolva;137;82;55;2015
22;Huesca;230;Torla-Ordesa;306;158;148;2015
22;Huesca;232;Torralba de Aragón;114;59;55;2015
22;Huesca;233;Torre la Ribera;104;55;49;2015
22;Huesca;234;Torrente de Cinca;1187;598;589;2015
22;Huesca;235;Torres de Alcanadre;107;62;45;2015
22;Huesca;236;Torres de Barbués;283;139;144;2015
22;Huesca;239;Tramaced;110;66;44;2015
22;Huesca;242;Valfarta;72;42;30;2015
22;Huesca;243;Valle de Bardají;37;22;15;2015
22;Huesca;901;Valle de Hecho;880;458;422;2015
22;Huesca;244;Valle de Lierp;54;29;25;2015
22;Huesca;245;Velilla de Cinca;442;226;216;2015
22;Huesca;909;Vencillón;411;213;198;2015
22;Huesca;247;Viacamp y Litera;42;24;18;2015
22;Huesca;248;Vicién;126;73;53;2015
22;Huesca;249;Villanova;157;80;77;2015
22;Huesca;250;Villanúa;435;238;197;2015
22;Huesca;251;Villanueva de Sigena;442;218;224;2015
22;Huesca;252;Yebra de Basa;142;83;59;2015
22;Huesca;253;Yésero;58;35;23;2015
22;Huesca;254;Zaidín;1852;951;901;2015
23;Jaén;001;Albanchez de Mágina;1186;613;573;2015
23;Jaén;002;Alcalá la Real;22036;10824;11212;2015
23;Jaén;003;Alcaudete;10779;5300;5479;2015
23;Jaén;004;Aldeaquemada;531;280;251;2015
23;Jaén;005;Andújar;38246;18832;19414;2015
23;Jaén;006;Arjona;5692;2825;2867;2015
23;Jaén;007;Arjonilla;3729;1867;1862;2015
23;Jaén;008;Arquillos;1872;929;943;2015
23;Jaén;905;Arroyo del Ojanco;2373;1203;1170;2015
23;Jaén;009;Baeza;16163;8012;8151;2015
23;Jaén;010;Bailén;18243;9087;9156;2015
23;Jaén;011;Baños de la Encina;2672;1364;1308;2015
23;Jaén;012;Beas de Segura;5439;2820;2619;2015
23;Jaén;902;Bedmar y Garcíez;2871;1421;1450;2015
23;Jaén;014;Begíjar;3133;1575;1558;2015
23;Jaén;015;Bélmez de la Moraleda;1693;836;857;2015
23;Jaén;016;Benatae;487;255;232;2015
23;Jaén;017;Cabra del Santo Cristo;1937;1021;916;2015
23;Jaén;018;Cambil;2857;1480;1377;2015
23;Jaén;019;Campillo de Arenas;1941;1016;925;2015
23;Jaén;020;Canena;1959;996;963;2015
23;Jaén;021;Carboneros;641;331;310;2015
23;Jaén;901;Cárcheles;1425;740;685;2015
23;Jaén;024;Carolina, La;15673;7738;7935;2015
23;Jaén;025;Castellar;3440;1724;1716;2015
23;Jaén;026;Castillo de Locubín;4293;2114;2179;2015
23;Jaén;027;Cazalilla;872;426;446;2015
23;Jaén;028;Cazorla;7692;3730;3962;2015
23;Jaén;029;Chiclana de Segura;1023;506;517;2015
23;Jaén;030;Chilluévar;1509;739;770;2015
23;Jaén;031;Escañuela;953;485;468;2015
23;Jaén;032;Espelúy;699;346;353;2015
23;Jaén;033;Frailes;1651;824;827;2015
23;Jaén;034;Fuensanta de Martos;3160;1558;1602;2015
23;Jaén;035;Fuerte del Rey;1409;723;686;2015
23;Jaén;037;Génave;618;335;283;2015
23;Jaén;038;Guardia de Jaén, La;4832;2449;2383;2015
23;Jaén;039;Guarromán;2876;1470;1406;2015
23;Jaén;041;Higuera de Calatrava;649;341;308;2015
23;Jaén;042;Hinojares;355;186;169;2015
23;Jaén;043;Hornos;657;322;335;2015
23;Jaén;044;Huelma;6089;3021;3068;2015
23;Jaén;045;Huesa;2584;1301;1283;2015
23;Jaén;046;Ibros;2973;1475;1498;2015
23;Jaén;047;Iruela, La;1999;988;1011;2015
23;Jaén;048;Iznatoraf;1016;537;479;2015
23;Jaén;049;Jabalquinto;2201;1111;1090;2015
23;Jaén;050;Jaén;115395;55553;59842;2015
23;Jaén;051;Jamilena;3404;1727;1677;2015
23;Jaén;052;Jimena;1344;652;692;2015
23;Jaén;053;Jódar;12022;5959;6063;2015
23;Jaén;040;Lahiguera;1783;877;906;2015
23;Jaén;054;Larva;487;251;236;2015
23;Jaén;055;Linares;59737;29316;30421;2015
23;Jaén;056;Lopera;3779;1892;1887;2015
23;Jaén;057;Lupión;910;450;460;2015
23;Jaén;058;Mancha Real;11212;5590;5622;2015
23;Jaén;059;Marmolejo;7089;3534;3555;2015
23;Jaén;060;Martos;24398;12099;12299;2015
23;Jaén;061;Mengíbar;9935;4956;4979;2015
23;Jaén;062;Montizón;1815;938;877;2015
23;Jaén;063;Navas de San Juan;4712;2359;2353;2015
23;Jaén;064;Noalejo;2000;1008;992;2015
23;Jaén;065;Orcera;1919;967;952;2015
23;Jaén;066;Peal de Becerro;5410;2696;2714;2015
23;Jaén;067;Pegalajar;3032;1522;1510;2015
23;Jaén;069;Porcuna;6567;3311;3256;2015
23;Jaén;070;Pozo Alcón;4892;2492;2400;2015
23;Jaén;071;Puente de Génave;2221;1123;1098;2015
23;Jaén;072;Puerta de Segura, La;2503;1250;1253;2015
23;Jaén;073;Quesada;5585;2821;2764;2015
23;Jaén;074;Rus;3728;1904;1824;2015
23;Jaén;075;Sabiote;4073;2026;2047;2015
23;Jaén;076;Santa Elena;986;526;460;2015
23;Jaén;077;Santiago de Calatrava;797;410;387;2015
23;Jaén;904;Santiago-Pontones;3338;1717;1621;2015
23;Jaén;079;Santisteban del Puerto;4666;2401;2265;2015
23;Jaén;080;Santo Tomé;2303;1167;1136;2015
23;Jaén;081;Segura de la Sierra;1916;939;977;2015
23;Jaén;082;Siles;2345;1199;1146;2015
23;Jaén;084;Sorihuela del Guadalimar;1248;661;587;2015
23;Jaén;085;Torreblascopedro;2742;1374;1368;2015
23;Jaén;086;Torredelcampo;14605;7347;7258;2015
23;Jaén;087;Torredonjimeno;14011;6873;7138;2015
23;Jaén;088;Torreperogil;7548;3676;3872;2015
23;Jaén;090;Torres;1516;766;750;2015
23;Jaén;091;Torres de Albánchez;877;455;422;2015
23;Jaén;092;Úbeda;34930;17124;17806;2015
23;Jaén;093;Valdepeñas de Jaén;3926;1943;1983;2015
23;Jaén;094;Vilches;4689;2357;2332;2015
23;Jaén;095;Villacarrillo;11040;5578;5462;2015
23;Jaén;096;Villanueva de la Reina;3245;1642;1603;2015
23;Jaén;097;Villanueva del Arzobispo;8484;4378;4106;2015
23;Jaén;098;Villardompardo;1029;514;515;2015
23;Jaén;099;Villares, Los;5999;3000;2999;2015
23;Jaén;101;Villarrodrigo;438;225;213;2015
23;Jaén;903;Villatorres;4412;2240;2172;2015
24;León;001;Acebedo;225;132;93;2015
24;León;002;Algadefe;284;144;140;2015
24;León;003;Alija del Infantado;715;363;352;2015
24;León;004;Almanza;596;349;247;2015
24;León;005;Antigua, La;418;239;179;2015
24;León;006;Ardón;596;314;282;2015
24;León;007;Arganza;822;417;405;2015
24;León;008;Astorga;11387;5414;5973;2015
24;León;009;Balboa;321;173;148;2015
24;León;010;Bañeza, La;10443;5045;5398;2015
24;León;011;Barjas;201;108;93;2015
24;León;012;Barrios de Luna, Los;331;185;146;2015
24;León;014;Bembibre;9568;4718;4850;2015
24;León;015;Benavides;2616;1293;1323;2015
24;León;016;Benuza;507;289;218;2015
24;León;017;Bercianos del Páramo;618;314;304;2015
24;León;018;Bercianos del Real Camino;196;101;95;2015
24;León;019;Berlanga del Bierzo;392;179;213;2015
24;León;020;Boca de Huérgano;487;283;204;2015
24;León;021;Boñar;1947;976;971;2015
24;León;022;Borrenes;368;187;181;2015
24;León;023;Brazuelo;307;167;140;2015
24;León;024;Burgo Ranero, El;767;409;358;2015
24;León;025;Burón;325;190;135;2015
24;León;026;Bustillo del Páramo;1311;675;636;2015
24;León;027;Cabañas Raras;1337;677;660;2015
24;León;028;Cabreros del Río;431;235;196;2015
24;León;029;Cabrillanes;828;426;402;2015
24;León;030;Cacabelos;5318;2654;2664;2015
24;León;031;Calzada del Coto;253;142;111;2015
24;León;032;Campazas;139;67;72;2015
24;León;033;Campo de Villavidel;212;116;96;2015
24;León;034;Camponaraya;4086;2039;2047;2015
24;León;036;Candín;297;151;146;2015
24;León;037;Cármenes;396;214;182;2015
24;León;038;Carracedelo;3575;1777;1798;2015
24;León;039;Carrizo;2357;1186;1171;2015
24;León;040;Carrocera;514;268;246;2015
24;León;041;Carucedo;583;294;289;2015
24;León;042;Castilfalé;71;41;30;2015
24;León;043;Castrillo de Cabrera;134;72;62;2015
24;León;044;Castrillo de la Valduerna;183;82;101;2015
24;León;046;Castrocalbón;1051;554;497;2015
24;León;047;Castrocontrigo;839;447;392;2015
24;León;049;Castropodame;1728;888;840;2015
24;León;050;Castrotierra de Valmadrigal;115;60;55;2015
24;León;051;Cea;460;241;219;2015
24;León;052;Cebanico;174;100;74;2015
24;León;053;Cebrones del Río;512;268;244;2015
24;León;065;Chozas de Abajo;2496;1299;1197;2015
24;León;054;Cimanes de la Vega;500;256;244;2015
24;León;055;Cimanes del Tejar;763;411;352;2015
24;León;056;Cistierna;3351;1672;1679;2015
24;León;057;Congosto;1591;787;804;2015
24;León;058;Corbillos de los Oteros;208;115;93;2015
24;León;059;Corullón;990;503;487;2015
24;León;060;Crémenes;589;318;271;2015
24;León;061;Cuadros;1999;1015;984;2015
24;León;062;Cubillas de los Oteros;147;80;67;2015
24;León;063;Cubillas de Rueda;466;238;228;2015
24;León;064;Cubillos del Sil;1821;965;856;2015
24;León;066;Destriana;549;265;284;2015
24;León;067;Encinedo;797;419;378;2015
24;León;068;Ercina, La;490;251;239;2015
24;León;069;Escobar de Campos;46;29;17;2015
24;León;070;Fabero;4818;2360;2458;2015
24;León;071;Folgoso de la Ribera;1153;566;587;2015
24;León;073;Fresno de la Vega;560;277;283;2015
24;León;074;Fuentes de Carbajal;103;56;47;2015
24;León;076;Garrafe de Torío;1457;792;665;2015
24;León;077;Gordaliza del Pino;272;136;136;2015
24;León;078;Gordoncillo;473;237;236;2015
24;León;079;Gradefes;997;528;469;2015
24;León;080;Grajal de Campos;242;123;119;2015
24;León;081;Gusendos de los Oteros;148;83;65;2015
24;León;082;Hospital de Órbigo;995;491;504;2015
24;León;083;Igüeña;1262;672;590;2015
24;León;084;Izagre;184;98;86;2015
24;León;086;Joarilla de las Matas;318;166;152;2015
24;León;087;Laguna Dalga;703;377;326;2015
24;León;088;Laguna de Negrillos;1098;567;531;2015
24;León;089;León;127817;58100;69717;2015
24;León;092;Llamas de la Ribera;885;465;420;2015
24;León;090;Lucillo;413;219;194;2015
24;León;091;Luyego;717;367;350;2015
24;León;093;Magaz de Cepeda;396;197;199;2015
24;León;094;Mansilla de las Mulas;1805;919;886;2015
24;León;095;Mansilla Mayor;344;183;161;2015
24;León;096;Maraña;138;82;56;2015
24;León;097;Matadeón de los Oteros;254;134;120;2015
24;León;098;Matallana de Torío;1345;706;639;2015
24;León;099;Matanza;197;110;87;2015
24;León;100;Molinaseca;892;487;405;2015
24;León;101;Murias de Paredes;426;210;216;2015
24;León;102;Noceda del Bierzo;727;362;365;2015
24;León;103;Oencia;310;176;134;2015
24;León;104;Omañas, Las;291;157;134;2015
24;León;105;Onzonilla;1758;907;851;2015
24;León;106;Oseja de Sajambre;279;168;111;2015
24;León;107;Pajares de los Oteros;308;192;116;2015
24;León;108;Palacios de la Valduerna;425;208;217;2015
24;León;109;Palacios del Sil;1090;595;495;2015
24;León;110;Páramo del Sil;1403;713;690;2015
24;León;112;Peranzanes;327;187;140;2015
24;León;113;Pobladura de Pelayo García;396;202;194;2015
24;León;114;Pola de Gordón, La;3522;1749;1773;2015
24;León;115;Ponferrada;66884;31935;34949;2015
24;León;116;Posada de Valdeón;477;279;198;2015
24;León;117;Pozuelo del Páramo;478;244;234;2015
24;León;118;Prado de la Guzpeña;140;79;61;2015
24;León;119;Priaranza del Bierzo;802;405;397;2015
24;León;120;Prioro;376;215;161;2015
24;León;121;Puebla de Lillo;715;398;317;2015
24;León;122;Puente de Domingo Flórez;1574;814;760;2015
24;León;123;Quintana del Castillo;810;440;370;2015
24;León;124;Quintana del Marco;407;221;186;2015
24;León;125;Quintana y Congosto;372;185;187;2015
24;León;127;Regueras de Arriba;326;177;149;2015
24;León;129;Reyero;125;64;61;2015
24;León;130;Riaño;490;284;206;2015
24;León;131;Riego de la Vega;835;435;400;2015
24;León;132;Riello;676;378;298;2015
24;León;133;Rioseco de Tapia;372;201;171;2015
24;León;134;Robla, La;4302;2178;2124;2015
24;León;136;Roperuelos del Páramo;592;300;292;2015
24;León;137;Sabero;1246;615;631;2015
24;León;139;Sahagún;2709;1341;1368;2015
24;León;141;San Adrián del Valle;112;58;54;2015
24;León;142;San Andrés del Rabanedo;31745;15270;16475;2015
24;León;144;San Cristóbal de la Polantera;800;392;408;2015
24;León;145;San Emiliano;694;374;320;2015
24;León;146;San Esteban de Nogales;281;149;132;2015
24;León;148;San Justo de la Vega;1949;1002;947;2015
24;León;149;San Millán de los Caballeros;190;99;91;2015
24;León;150;San Pedro Bercianos;263;137;126;2015
24;León;143;Sancedo;569;283;286;2015
24;León;151;Santa Colomba de Curueño;547;288;259;2015
24;León;152;Santa Colomba de Somoza;567;298;269;2015
24;León;153;Santa Cristina de Valmadrigal;271;140;131;2015
24;León;154;Santa Elena de Jamuz;1135;587;548;2015
24;León;155;Santa María de la Isla;522;271;251;2015
24;León;158;Santa María de Ordás;340;174;166;2015
24;León;156;Santa María del Monte de Cea;256;133;123;2015
24;León;157;Santa María del Páramo;3128;1536;1592;2015
24;León;159;Santa Marina del Rey;2029;1007;1022;2015
24;León;160;Santas Martas;809;422;387;2015
24;León;161;Santiago Millas;330;183;147;2015
24;León;162;Santovenia de la Valdoncina;2006;1035;971;2015
24;León;163;Sariegos;4826;2435;2391;2015
24;León;164;Sena de Luna;402;201;201;2015
24;León;165;Sobrado;363;179;184;2015
24;León;166;Soto de la Vega;1641;847;794;2015
24;León;167;Soto y Amío;853;435;418;2015
24;León;168;Toral de los Guzmanes;533;280;253;2015
24;León;206;Toral de los Vados;2024;993;1031;2015
24;León;169;Toreno;3380;1691;1689;2015
24;León;170;Torre del Bierzo;2265;1153;1112;2015
24;León;171;Trabadelo;394;219;175;2015
24;León;172;Truchas;454;232;222;2015
24;León;173;Turcia;1057;540;517;2015
24;León;174;Urdiales del Páramo;515;271;244;2015
24;León;185;Val de San Lorenzo;542;271;271;2015
24;León;175;Valdefresno;2149;1111;1038;2015
24;León;176;Valdefuentes del Páramo;347;184;163;2015
24;León;177;Valdelugueros;533;301;232;2015
24;León;178;Valdemora;79;36;43;2015
24;León;179;Valdepiélago;338;187;151;2015
24;León;180;Valdepolo;1274;665;609;2015
24;León;181;Valderas;1819;921;898;2015
24;León;182;Valderrey;461;217;244;2015
24;León;183;Valderrueda;923;471;452;2015
24;León;184;Valdesamario;215;119;96;2015
24;León;187;Valdevimbre;997;521;476;2015
24;León;188;Valencia de Don Juan;5181;2539;2642;2015
24;León;191;Vallecillo;124;68;56;2015
24;León;189;Valverde de la Virgen;7435;3858;3577;2015
24;León;190;Valverde-Enrique;175;94;81;2015
24;León;193;Vecilla, La;408;213;195;2015
24;León;196;Vega de Espinareda;2281;1144;1137;2015
24;León;197;Vega de Infanzones;905;456;449;2015
24;León;198;Vega de Valcarce;669;341;328;2015
24;León;194;Vegacervera;314;169;145;2015
24;León;199;Vegaquemada;465;244;221;2015
24;León;201;Vegas del Condado;1163;655;508;2015
24;León;202;Villablino;9509;4672;4837;2015
24;León;203;Villabraz;113;62;51;2015
24;León;205;Villadangos del Páramo;1103;571;532;2015
24;León;207;Villademor de la Vega;349;186;163;2015
24;León;209;Villafranca del Bierzo;3160;1521;1639;2015
24;León;210;Villagatón;617;325;292;2015
24;León;211;Villamandos;310;172;138;2015
24;León;901;Villamanín;1029;534;495;2015
24;León;212;Villamañán;1194;575;619;2015
24;León;213;Villamartín de Don Sancho;164;86;78;2015
24;León;214;Villamejil;746;392;354;2015
24;León;215;Villamol;173;87;86;2015
24;León;216;Villamontán de la Valduerna;804;418;386;2015
24;León;217;Villamoratiel de las Matas;155;87;68;2015
24;León;218;Villanueva de las Manzanas;507;264;243;2015
24;León;219;Villaobispo de Otero;604;325;279;2015
24;León;902;Villaornate y Castro;377;187;190;2015
24;León;221;Villaquejida;912;458;454;2015
24;León;222;Villaquilambre;18615;9263;9352;2015
24;León;223;Villarejo de Órbigo;3112;1536;1576;2015
24;León;224;Villares de Órbigo;685;360;325;2015
24;León;225;Villasabariego;1175;622;553;2015
24;León;226;Villaselán;210;120;90;2015
24;León;227;Villaturiel;1947;1019;928;2015
24;León;228;Villazala;749;399;350;2015
24;León;229;Villazanzo de Valderaduey;475;269;206;2015
24;León;230;Zotes del Páramo;454;257;197;2015
25;Lleida;001;Abella de la Conca;170;93;77;2015
25;Lleida;002;Àger;613;325;288;2015
25;Lleida;003;Agramunt;5491;2775;2716;2015
25;Lleida;038;Aitona;2456;1249;1207;2015
25;Lleida;004;Alamús, Els;778;404;374;2015
25;Lleida;005;Alàs i Cerc;356;182;174;2015
25;Lleida;006;Albagés, L';419;222;197;2015
25;Lleida;007;Albatàrrec;2214;1156;1058;2015
25;Lleida;008;Albesa;1624;874;750;2015
25;Lleida;009;Albi, L';819;426;393;2015
25;Lleida;010;Alcanó;246;123;123;2015
25;Lleida;011;Alcarràs;9372;4863;4509;2015
25;Lleida;012;Alcoletge;3285;1716;1569;2015
25;Lleida;013;Alfarràs;2976;1558;1418;2015
25;Lleida;014;Alfés;326;164;162;2015
25;Lleida;015;Algerri;422;229;193;2015
25;Lleida;016;Alguaire;3002;1571;1431;2015
25;Lleida;017;Alins;288;153;135;2015
25;Lleida;019;Almacelles;6766;3534;3232;2015
25;Lleida;020;Almatret;326;172;154;2015
25;Lleida;021;Almenar;3525;1879;1646;2015
25;Lleida;022;Alòs de Balaguer;123;69;54;2015
25;Lleida;023;Alpicat;6275;3146;3129;2015
25;Lleida;024;Alt Àneu;407;232;175;2015
25;Lleida;027;Anglesola;1378;688;690;2015
25;Lleida;029;Arbeca;2278;1156;1122;2015
25;Lleida;031;Arres;67;42;25;2015
25;Lleida;032;Arsèguel;79;46;33;2015
25;Lleida;033;Artesa de Lleida;1517;793;724;2015
25;Lleida;034;Artesa de Segre;3614;1840;1774;2015
25;Lleida;036;Aspa;218;110;108;2015
25;Lleida;037;Avellanes i Santa Linya, Les;473;269;204;2015
25;Lleida;039;Baix Pallars;350;187;163;2015
25;Lleida;040;Balaguer;16479;8323;8156;2015
25;Lleida;041;Barbens;900;477;423;2015
25;Lleida;042;Baronia de Rialb, La;245;128;117;2015
25;Lleida;044;Bassella;234;117;117;2015
25;Lleida;045;Bausen;58;32;26;2015
25;Lleida;046;Belianes;555;274;281;2015
25;Lleida;170;Bellaguarda;308;161;147;2015
25;Lleida;047;Bellcaire d'Urgell;1296;659;637;2015
25;Lleida;048;Bell-lloc d'Urgell;2329;1156;1173;2015
25;Lleida;049;Bellmunt d'Urgell;188;93;95;2015
25;Lleida;050;Bellpuig;4989;2590;2399;2015
25;Lleida;051;Bellver de Cerdanya;2028;1051;977;2015
25;Lleida;052;Bellvís;2270;1141;1129;2015
25;Lleida;053;Benavent de Segrià;1506;780;726;2015
25;Lleida;055;Biosca;199;104;95;2015
25;Lleida;057;Bòrdes, Es;237;136;101;2015
25;Lleida;058;Borges Blanques, Les;6019;3051;2968;2015
25;Lleida;059;Bossòst;1137;555;582;2015
25;Lleida;056;Bovera;275;152;123;2015
25;Lleida;060;Cabanabona;82;38;44;2015
25;Lleida;061;Cabó;94;48;46;2015
25;Lleida;062;Camarasa;903;461;442;2015
25;Lleida;063;Canejan;100;56;44;2015
25;Lleida;904;Castell de Mur;188;101;87;2015
25;Lleida;064;Castellar de la Ribera;150;76;74;2015
25;Lleida;067;Castelldans;981;534;447;2015
25;Lleida;068;Castellnou de Seana;736;391;345;2015
25;Lleida;069;Castelló de Farfanya;547;294;253;2015
25;Lleida;070;Castellserà;1044;530;514;2015
25;Lleida;071;Cava;60;35;25;2015
25;Lleida;072;Cervera;8956;4483;4473;2015
25;Lleida;073;Cervià de les Garrigues;695;364;331;2015
25;Lleida;074;Ciutadilla;217;117;100;2015
25;Lleida;075;Clariana de Cardener;140;71;69;2015
25;Lleida;076;Cogul, El;181;97;84;2015
25;Lleida;077;Coll de Nargó;575;293;282;2015
25;Lleida;163;Coma i la Pedra, La;270;165;105;2015
25;Lleida;161;Conca de Dalt;446;233;213;2015
25;Lleida;078;Corbins;1394;744;650;2015
25;Lleida;079;Cubells;378;200;178;2015
25;Lleida;081;Espluga Calba, L';387;192;195;2015
25;Lleida;082;Espot;362;196;166;2015
25;Lleida;088;Estamariu;124;71;53;2015
25;Lleida;085;Estaràs;176;95;81;2015
25;Lleida;086;Esterri d'Àneu;804;386;418;2015
25;Lleida;087;Esterri de Cardós;73;35;38;2015
25;Lleida;089;Farrera;118;69;49;2015
25;Lleida;908;Fígols i Alinyà;261;147;114;2015
25;Lleida;092;Floresta, La;160;89;71;2015
25;Lleida;093;Fondarella;831;413;418;2015
25;Lleida;094;Foradada;174;99;75;2015
25;Lleida;096;Fuliola, La;1291;653;638;2015
25;Lleida;097;Fulleda;94;47;47;2015
25;Lleida;098;Gavet de la Conca;287;142;145;2015
25;Lleida;912;Gimenells i el Pla de la Font;1151;589;562;2015
25;Lleida;099;Golmés;1770;882;888;2015
25;Lleida;100;Gósol;226;131;95;2015
25;Lleida;101;Granadella, La;712;369;343;2015
25;Lleida;102;Granja d'Escarp, La;1001;528;473;2015
25;Lleida;103;Granyanella;146;81;65;2015
25;Lleida;105;Granyena de les Garrigues;161;96;65;2015
25;Lleida;104;Granyena de Segarra;139;70;69;2015
25;Lleida;109;Guimerà;277;152;125;2015
25;Lleida;903;Guingueta d'Àneu, La;315;169;146;2015
25;Lleida;110;Guissona;6862;3637;3225;2015
25;Lleida;111;Guixers;142;89;53;2015
25;Lleida;115;Isona i Conca Dellà;1064;558;506;2015
25;Lleida;112;Ivars de Noguera;346;177;169;2015
25;Lleida;113;Ivars d'Urgell;1591;831;760;2015
25;Lleida;114;Ivorra;106;55;51;2015
25;Lleida;910;Josa i Tuixén;129;74;55;2015
25;Lleida;118;Juncosa;421;230;191;2015
25;Lleida;119;Juneda;3384;1757;1627;2015
25;Lleida;121;Les;953;476;477;2015
25;Lleida;122;Linyola;2652;1339;1313;2015
25;Lleida;123;Lladorre;229;111;118;2015
25;Lleida;124;Lladurs;193;103;90;2015
25;Lleida;125;Llardecans;491;253;238;2015
25;Lleida;126;Llavorsí;354;179;175;2015
25;Lleida;120;Lleida;138542;68412;70130;2015
25;Lleida;127;Lles de Cerdanya;257;148;109;2015
25;Lleida;128;Llimiana;158;91;67;2015
25;Lleida;129;Llobera;202;109;93;2015
25;Lleida;133;Maials;941;500;441;2015
25;Lleida;130;Maldà;228;117;111;2015
25;Lleida;131;Massalcoreig;564;301;263;2015
25;Lleida;132;Massoteres;189;105;84;2015
25;Lleida;134;Menàrguens;849;471;378;2015
25;Lleida;135;Miralcamp;1390;695;695;2015
25;Lleida;137;Mollerussa;14900;7612;7288;2015
25;Lleida;136;Molsosa, La;113;56;57;2015
25;Lleida;139;Montellà i Martinet;586;320;266;2015
25;Lleida;140;Montferrer i Castellbò;1010;546;464;2015
25;Lleida;138;Montgai;663;347;316;2015
25;Lleida;142;Montoliu de Lleida;514;260;254;2015
25;Lleida;141;Montoliu de Segarra;194;107;87;2015
25;Lleida;143;Montornès de Segarra;101;50;51;2015
25;Lleida;145;Nalec;95;49;46;2015
25;Lleida;025;Naut Aran;1760;890;870;2015
25;Lleida;146;Navès;281;136;145;2015
25;Lleida;148;Odèn;253;145;108;2015
25;Lleida;149;Oliana;1842;923;919;2015
25;Lleida;150;Oliola;233;128;105;2015
25;Lleida;151;Olius;910;475;435;2015
25;Lleida;152;Oluges, Les;161;85;76;2015
25;Lleida;153;Omellons, Els;226;118;108;2015
25;Lleida;154;Omells de na Gaia, Els;136;73;63;2015
25;Lleida;155;Organyà;845;418;427;2015
25;Lleida;156;Os de Balaguer;995;501;494;2015
25;Lleida;157;Ossó de Sió;213;109;104;2015
25;Lleida;158;Palau d'Anglesola, El;2136;1051;1085;2015
25;Lleida;164;Penelles;482;277;205;2015
25;Lleida;165;Peramola;343;175;168;2015
25;Lleida;166;Pinell de Solsonès;207;119;88;2015
25;Lleida;167;Pinós;305;167;138;2015
25;Lleida;911;Plans de Sió, Els;528;281;247;2015
25;Lleida;168;Poal, El;668;348;320;2015
25;Lleida;169;Pobla de Cérvoles, La;222;124;98;2015
25;Lleida;171;Pobla de Segur, La;3016;1499;1517;2015
25;Lleida;030;Pont de Bar, El;159;88;71;2015
25;Lleida;173;Pont de Suert, El;2314;1167;1147;2015
25;Lleida;172;Ponts;2632;1305;1327;2015
25;Lleida;174;Portella, La;731;398;333;2015
25;Lleida;175;Prats i Sansor;251;131;120;2015
25;Lleida;176;Preixana;407;204;203;2015
25;Lleida;177;Preixens;458;234;224;2015
25;Lleida;179;Prullans;206;105;101;2015
25;Lleida;180;Puiggròs;295;153;142;2015
25;Lleida;181;Puigverd d'Agramunt;244;140;104;2015
25;Lleida;182;Puigverd de Lleida;1405;725;680;2015
25;Lleida;183;Rialp;655;340;315;2015
25;Lleida;905;Ribera d'Ondara;429;225;204;2015
25;Lleida;185;Ribera d'Urgellet;978;514;464;2015
25;Lleida;186;Riner;267;131;136;2015
25;Lleida;913;Riu de Cerdanya;104;60;44;2015
25;Lleida;189;Rosselló;3043;1538;1505;2015
25;Lleida;190;Salàs de Pallars;359;193;166;2015
25;Lleida;191;Sanaüja;427;219;208;2015
25;Lleida;196;Sant Esteve de la Sarga;144;89;55;2015
25;Lleida;192;Sant Guim de Freixenet;1078;557;521;2015
25;Lleida;197;Sant Guim de la Plana;174;94;80;2015
25;Lleida;193;Sant Llorenç de Morunys;977;478;499;2015
25;Lleida;902;Sant Martí de Riucorb;689;368;321;2015
25;Lleida;194;Sant Ramon;506;273;233;2015
25;Lleida;201;Sarroca de Bellera;125;79;46;2015
25;Lleida;200;Sarroca de Lleida;387;213;174;2015
25;Lleida;202;Senterada;133;80;53;2015
25;Lleida;035;Sentiu de Sió, La;459;234;225;2015
25;Lleida;204;Seròs;1886;1025;861;2015
25;Lleida;203;Seu d'Urgell, La;12249;5896;6353;2015
25;Lleida;205;Sidamon;732;379;353;2015
25;Lleida;206;Soleràs, El;342;176;166;2015
25;Lleida;207;Solsona;9004;4505;4499;2015
25;Lleida;208;Soriguera;385;206;179;2015
25;Lleida;209;Sort;2199;1089;1110;2015
25;Lleida;210;Soses;1728;899;829;2015
25;Lleida;211;Sudanell;847;473;374;2015
25;Lleida;212;Sunyer;325;180;145;2015
25;Lleida;215;Talarn;582;363;219;2015
25;Lleida;216;Talavera;262;146;116;2015
25;Lleida;217;Tàrrega;16444;8152;8292;2015
25;Lleida;218;Tarrés;103;57;46;2015
25;Lleida;219;Tarroja de Segarra;178;91;87;2015
25;Lleida;220;Térmens;1531;767;764;2015
25;Lleida;221;Tírvia;153;76;77;2015
25;Lleida;222;Tiurana;72;35;37;2015
25;Lleida;223;Torà;1232;613;619;2015
25;Lleida;224;Torms, Els;147;82;65;2015
25;Lleida;225;Tornabous;885;467;418;2015
25;Lleida;227;Torre de Cabdella, La;762;390;372;2015
25;Lleida;226;Torrebesses;286;151;135;2015
25;Lleida;228;Torrefarrera;4611;2333;2278;2015
25;Lleida;907;Torrefeta i Florejacs;604;319;285;2015
25;Lleida;230;Torregrossa;2255;1143;1112;2015
25;Lleida;231;Torrelameu;706;400;306;2015
25;Lleida;232;Torres de Segre;2271;1172;1099;2015
25;Lleida;233;Torre-serona;379;190;189;2015
25;Lleida;234;Tremp;6175;3062;3113;2015
25;Lleida;043;Vall de Boí, La;1004;532;472;2015
25;Lleida;901;Vall de Cardós;368;196;172;2015
25;Lleida;238;Vallbona de les Monges;256;136;120;2015
25;Lleida;240;Vallfogona de Balaguer;1880;925;955;2015
25;Lleida;906;Valls d'Aguilar, Les;302;164;138;2015
25;Lleida;239;Valls de Valira, Les;845;428;417;2015
25;Lleida;909;Vansa i Fórnols, La;210;111;99;2015
25;Lleida;242;Verdú;947;452;495;2015
25;Lleida;243;Vielha e Mijaran;5450;2767;2683;2015
25;Lleida;244;Vilagrassa;522;270;252;2015
25;Lleida;245;Vilaller;566;303;263;2015
25;Lleida;247;Vilamòs;164;92;72;2015
25;Lleida;248;Vilanova de Bellpuig;1175;604;571;2015
25;Lleida;254;Vilanova de la Barca;1099;546;553;2015
25;Lleida;249;Vilanova de l'Aguda;218;108;110;2015
25;Lleida;250;Vilanova de Meià;424;233;191;2015
25;Lleida;251;Vilanova de Segrià;940;497;443;2015
25;Lleida;252;Vila-sana;718;359;359;2015
25;Lleida;253;Vilosell, El;187;91;96;2015
25;Lleida;255;Vinaixa;526;268;258;2015
27;Lugo;001;Abadín;2612;1280;1332;2015
27;Lugo;002;Alfoz;1846;894;952;2015
27;Lugo;003;Antas de Ulla;2109;1041;1068;2015
27;Lugo;004;Baleira;1380;729;651;2015
27;Lugo;901;Baralla;2724;1408;1316;2015
27;Lugo;005;Barreiros;3021;1442;1579;2015
27;Lugo;006;Becerreá;2987;1494;1493;2015
27;Lugo;007;Begonte;3160;1580;1580;2015
27;Lugo;008;Bóveda;1545;777;768;2015
27;Lugo;902;Burela;9580;4752;4828;2015
27;Lugo;009;Carballedo;2351;1177;1174;2015
27;Lugo;010;Castro de Rei;5153;2521;2632;2015
27;Lugo;011;Castroverde;2802;1444;1358;2015
27;Lugo;012;Cervantes;1487;845;642;2015
27;Lugo;013;Cervo;4336;2134;2202;2015
27;Lugo;016;Chantada;8493;4120;4373;2015
27;Lugo;014;Corgo, O;3646;1853;1793;2015
27;Lugo;015;Cospeito;4827;2344;2483;2015
27;Lugo;017;Folgoso do Courel;1089;569;520;2015
27;Lugo;018;Fonsagrada, A;3838;2000;1838;2015
27;Lugo;019;Foz;9891;4818;5073;2015
27;Lugo;020;Friol;3942;1981;1961;2015
27;Lugo;022;Guitiriz;5520;2755;2765;2015
27;Lugo;023;Guntín;2881;1470;1411;2015
27;Lugo;024;Incio, O;1777;885;892;2015
27;Lugo;026;Láncara;2764;1398;1366;2015
27;Lugo;027;Lourenzá;2301;1109;1192;2015
27;Lugo;028;Lugo;98134;45630;52504;2015
27;Lugo;029;Meira;1749;885;864;2015
27;Lugo;030;Mondoñedo;3876;1813;2063;2015
27;Lugo;031;Monforte de Lemos;19061;9021;10040;2015
27;Lugo;032;Monterroso;3778;1880;1898;2015
27;Lugo;033;Muras;684;350;334;2015
27;Lugo;034;Navia de Suarna;1211;678;533;2015
27;Lugo;035;Negueira de Muñiz;214;112;102;2015
27;Lugo;037;Nogais, As;1191;629;562;2015
27;Lugo;038;Ourol;1055;522;533;2015
27;Lugo;039;Outeiro de Rei;5068;2600;2468;2015
27;Lugo;040;Palas de Rei;3588;1783;1805;2015
27;Lugo;041;Pantón;2674;1278;1396;2015
27;Lugo;042;Paradela;1934;962;972;2015
27;Lugo;043;Páramo, O;1474;741;733;2015
27;Lugo;044;Pastoriza, A;3274;1636;1638;2015
27;Lugo;045;Pedrafita do Cebreiro;1119;599;520;2015
27;Lugo;047;Pobra do Brollón, A;1794;887;907;2015
27;Lugo;046;Pol;1732;844;888;2015
27;Lugo;048;Pontenova, A;2470;1196;1274;2015
27;Lugo;049;Portomarín;1557;797;760;2015
27;Lugo;050;Quiroga;3424;1650;1774;2015
27;Lugo;056;Rábade;1549;780;769;2015
27;Lugo;051;Ribadeo;9929;4751;5178;2015
27;Lugo;052;Ribas de Sil;1001;512;489;2015
27;Lugo;053;Ribeira de Piquín;580;291;289;2015
27;Lugo;054;Riotorto;1364;672;692;2015
27;Lugo;055;Samos;1425;756;669;2015
27;Lugo;057;Sarria;13393;6555;6838;2015
27;Lugo;058;Saviñao, O;4056;2041;2015;2015
27;Lugo;059;Sober;2400;1180;1220;2015
27;Lugo;060;Taboada;3032;1454;1578;2015
27;Lugo;061;Trabada;1178;567;611;2015
27;Lugo;062;Triacastela;699;351;348;2015
27;Lugo;063;Valadouro, O;2048;995;1053;2015
27;Lugo;064;Vicedo, O;1820;898;922;2015
27;Lugo;065;Vilalba;14645;7131;7514;2015
27;Lugo;066;Viveiro;15735;7696;8039;2015
27;Lugo;021;Xermade;1985;966;1019;2015
27;Lugo;025;Xove;3424;1696;1728;2015
28;Madrid;001;Acebeda, La;65;36;29;2015
28;Madrid;002;Ajalvir;4343;2276;2067;2015
28;Madrid;003;Alameda del Valle;217;126;91;2015
28;Madrid;004;Álamo, El;8965;4451;4514;2015
28;Madrid;005;Alcalá de Henares;198750;97913;100837;2015
28;Madrid;006;Alcobendas;113055;54547;58508;2015
28;Madrid;007;Alcorcón;167136;81069;86067;2015
28;Madrid;008;Aldea del Fresno;2535;1352;1183;2015
28;Madrid;009;Algete;20148;9946;10202;2015
28;Madrid;010;Alpedrete;14248;7048;7200;2015
28;Madrid;011;Ambite;618;315;303;2015
28;Madrid;012;Anchuelo;1200;625;575;2015
28;Madrid;013;Aranjuez;58168;28340;29828;2015
28;Madrid;014;Arganda del Rey;54533;27575;26958;2015
28;Madrid;015;Arroyomolinos;26846;13525;13321;2015
28;Madrid;016;Atazar, El;96;52;44;2015
28;Madrid;017;Batres;1568;798;770;2015
28;Madrid;018;Becerril de la Sierra;5396;2668;2728;2015
28;Madrid;019;Belmonte de Tajo;1625;848;777;2015
28;Madrid;021;Berrueco, El;618;319;299;2015
28;Madrid;020;Berzosa del Lozoya;202;118;84;2015
28;Madrid;022;Boadilla del Monte;48775;23859;24916;2015
28;Madrid;023;Boalo, El;7157;3658;3499;2015
28;Madrid;024;Braojos;203;115;88;2015
28;Madrid;025;Brea de Tajo;560;326;234;2015
28;Madrid;026;Brunete;10398;5138;5260;2015
28;Madrid;027;Buitrago del Lozoya;1865;908;957;2015
28;Madrid;028;Bustarviejo;2367;1199;1168;2015
28;Madrid;029;Cabanillas de la Sierra;733;387;346;2015
28;Madrid;030;Cabrera, La;2574;1270;1304;2015
28;Madrid;031;Cadalso de los Vidrios;2767;1435;1332;2015
28;Madrid;032;Camarma de Esteruelas;7134;3629;3505;2015
28;Madrid;033;Campo Real;5854;2994;2860;2015
28;Madrid;034;Canencia;464;248;216;2015
28;Madrid;035;Carabaña;2017;1002;1015;2015
28;Madrid;036;Casarrubuelos;3548;1806;1742;2015
28;Madrid;037;Cenicientos;2035;1003;1032;2015
28;Madrid;038;Cercedilla;6781;3332;3449;2015
28;Madrid;039;Cervera de Buitrago;164;97;67;2015
28;Madrid;051;Chapinería;2158;1111;1047;2015
28;Madrid;052;Chinchón;5436;2768;2668;2015
28;Madrid;040;Ciempozuelos;23696;11953;11743;2015
28;Madrid;041;Cobeña;6983;3450;3533;2015
28;Madrid;046;Collado Mediano;6599;3301;3298;2015
28;Madrid;047;Collado Villalba;62056;30325;31731;2015
28;Madrid;043;Colmenar de Oreja;8071;4097;3974;2015
28;Madrid;042;Colmenar del Arroyo;1611;829;782;2015
28;Madrid;045;Colmenar Viejo;47601;23546;24055;2015
28;Madrid;044;Colmenarejo;8934;4420;4514;2015
28;Madrid;048;Corpa;669;348;321;2015
28;Madrid;049;Coslada;86919;42947;43972;2015
28;Madrid;050;Cubas de la Sagra;5875;2904;2971;2015
28;Madrid;053;Daganzo de Arriba;9919;4970;4949;2015
28;Madrid;054;Escorial, El;15342;7577;7765;2015
28;Madrid;055;Estremera;1350;703;647;2015
28;Madrid;056;Fresnedillas de la Oliva;1554;803;751;2015
28;Madrid;057;Fresno de Torote;2041;1080;961;2015
28;Madrid;058;Fuenlabrada;195180;96951;98229;2015
28;Madrid;059;Fuente el Saz de Jarama;6440;3273;3167;2015
28;Madrid;060;Fuentidueña de Tajo;1954;971;983;2015
28;Madrid;061;Galapagar;32294;15953;16341;2015
28;Madrid;062;Garganta de los Montes;367;193;174;2015
28;Madrid;063;Gargantilla del Lozoya y Pinilla de Buitrago;351;186;165;2015
28;Madrid;064;Gascones;176;104;72;2015
28;Madrid;065;Getafe;174921;85919;89002;2015
28;Madrid;066;Griñón;9918;4936;4982;2015
28;Madrid;067;Guadalix de la Sierra;6039;3034;3005;2015
28;Madrid;068;Guadarrama;15538;7688;7850;2015
28;Madrid;069;Hiruela, La;54;37;17;2015
28;Madrid;070;Horcajo de la Sierra-Aoslos;159;90;69;2015
28;Madrid;071;Horcajuelo de la Sierra;88;44;44;2015
28;Madrid;072;Hoyo de Manzanares;7880;3979;3901;2015
28;Madrid;073;Humanes de Madrid;19413;9809;9604;2015
28;Madrid;074;Leganés;186907;91179;95728;2015
28;Madrid;075;Loeches;8212;4123;4089;2015
28;Madrid;076;Lozoya;594;311;283;2015
28;Madrid;901;Lozoyuela-Navas-Sieteiglesias;1203;623;580;2015
28;Madrid;078;Madarcos;45;28;17;2015
28;Madrid;079;Madrid;3141991;1460597;1681394;2015
28;Madrid;080;Majadahonda;70800;33702;37098;2015
28;Madrid;082;Manzanares el Real;8309;4214;4095;2015
28;Madrid;083;Meco;13269;6674;6595;2015
28;Madrid;084;Mejorada del Campo;22902;11454;11448;2015
28;Madrid;085;Miraflores de la Sierra;5807;2990;2817;2015
28;Madrid;086;Molar, El;8036;4063;3973;2015
28;Madrid;087;Molinos, Los;4349;2160;2189;2015
28;Madrid;088;Montejo de la Sierra;374;191;183;2015
28;Madrid;089;Moraleja de Enmedio;5046;2524;2522;2015
28;Madrid;090;Moralzarzal;12213;6128;6085;2015
28;Madrid;091;Morata de Tajuña;7453;3707;3746;2015
28;Madrid;092;Móstoles;206263;101155;105108;2015
28;Madrid;093;Navacerrada;2855;1423;1432;2015
28;Madrid;094;Navalafuente;1201;620;581;2015
28;Madrid;095;Navalagamella;2462;1272;1190;2015
28;Madrid;096;Navalcarnero;26672;13307;13365;2015
28;Madrid;097;Navarredonda y San Mamés;136;84;52;2015
28;Madrid;099;Navas del Rey;2628;1394;1234;2015
28;Madrid;100;Nuevo Baztán;6098;3100;2998;2015
28;Madrid;101;Olmeda de las Fuentes;338;176;162;2015
28;Madrid;102;Orusco de Tajuña;1260;632;628;2015
28;Madrid;104;Paracuellos de Jarama;22293;11353;10940;2015
28;Madrid;106;Parla;125056;62686;62370;2015
28;Madrid;107;Patones;524;259;265;2015
28;Madrid;108;Pedrezuela;5271;2652;2619;2015
28;Madrid;109;Pelayos de la Presa;2455;1229;1226;2015
28;Madrid;110;Perales de Tajuña;2871;1441;1430;2015
28;Madrid;111;Pezuela de las Torres;783;407;376;2015
28;Madrid;112;Pinilla del Valle;200;113;87;2015
28;Madrid;113;Pinto;48660;24224;24436;2015
28;Madrid;114;Piñuécar-Gandullas;175;97;78;2015
28;Madrid;115;Pozuelo de Alarcón;84558;40498;44060;2015
28;Madrid;116;Pozuelo del Rey;1071;562;509;2015
28;Madrid;117;Prádena del Rincón;122;74;48;2015
28;Madrid;118;Puebla de la Sierra;73;48;25;2015
28;Madrid;902;Puentes Viejas;644;361;283;2015
28;Madrid;119;Quijorna;3196;1620;1576;2015
28;Madrid;120;Rascafría;1739;948;791;2015
28;Madrid;121;Redueña;259;137;122;2015
28;Madrid;122;Ribatejada;707;344;363;2015
28;Madrid;123;Rivas-Vaciamadrid;81473;40686;40787;2015
28;Madrid;124;Robledillo de la Jara;100;51;49;2015
28;Madrid;125;Robledo de Chavela;3955;2075;1880;2015
28;Madrid;126;Robregordo;48;28;20;2015
28;Madrid;127;Rozas de Madrid, Las;93520;45322;48198;2015
28;Madrid;128;Rozas de Puerto Real;523;304;219;2015
28;Madrid;129;San Agustín del Guadalix;12982;6393;6589;2015
28;Madrid;130;San Fernando de Henares;40188;19758;20430;2015
28;Madrid;131;San Lorenzo de El Escorial;18191;8691;9500;2015
28;Madrid;132;San Martín de la Vega;18835;9710;9125;2015
28;Madrid;133;San Martín de Valdeiglesias;8463;4233;4230;2015
28;Madrid;134;San Sebastián de los Reyes;84944;41593;43351;2015
28;Madrid;135;Santa María de la Alameda;1199;632;567;2015
28;Madrid;136;Santorcaz;849;438;411;2015
28;Madrid;137;Santos de la Humosa, Los;2389;1216;1173;2015
28;Madrid;138;Serna del Monte, La;86;44;42;2015
28;Madrid;140;Serranillos del Valle;3994;1970;2024;2015
28;Madrid;141;Sevilla la Nueva;8902;4406;4496;2015
28;Madrid;143;Somosierra;73;41;32;2015
28;Madrid;144;Soto del Real;8456;4147;4309;2015
28;Madrid;145;Talamanca de Jarama;3371;1700;1671;2015
28;Madrid;146;Tielmes;2585;1328;1257;2015
28;Madrid;147;Titulcia;1234;637;597;2015
28;Madrid;148;Torrejón de Ardoz;126934;62982;63952;2015
28;Madrid;149;Torrejón de la Calzada;7901;3923;3978;2015
28;Madrid;150;Torrejón de Velasco;4224;2125;2099;2015
28;Madrid;151;Torrelaguna;4788;2458;2330;2015
28;Madrid;152;Torrelodones;23117;11154;11963;2015
28;Madrid;153;Torremocha de Jarama;948;464;484;2015
28;Madrid;154;Torres de la Alameda;7877;4028;3849;2015
28;Madrid;903;Tres Cantos;43309;20957;22352;2015
28;Madrid;155;Valdaracete;639;323;316;2015
28;Madrid;156;Valdeavero;1451;754;697;2015
28;Madrid;157;Valdelaguna;837;424;413;2015
28;Madrid;158;Valdemanco;922;495;427;2015
28;Madrid;159;Valdemaqueda;786;387;399;2015
28;Madrid;160;Valdemorillo;12173;6241;5932;2015
28;Madrid;161;Valdemoro;72854;36268;36586;2015
28;Madrid;162;Valdeolmos-Alalpardo;3785;1932;1853;2015
28;Madrid;163;Valdepiélagos;566;294;272;2015
28;Madrid;164;Valdetorres de Jarama;4234;2138;2096;2015
28;Madrid;165;Valdilecha;2838;1469;1369;2015
28;Madrid;166;Valverde de Alcalá;441;235;206;2015
28;Madrid;167;Velilla de San Antonio;12382;6271;6111;2015
28;Madrid;168;Vellón, El;1803;932;871;2015
28;Madrid;169;Venturada;1991;1058;933;2015
28;Madrid;171;Villa del Prado;6414;3283;3131;2015
28;Madrid;170;Villaconejos;3405;1723;1682;2015
28;Madrid;172;Villalbilla;12351;6259;6092;2015
28;Madrid;173;Villamanrique de Tajo;720;370;350;2015
28;Madrid;174;Villamanta;2525;1276;1249;2015
28;Madrid;175;Villamantilla;1292;636;656;2015
28;Madrid;176;Villanueva de la Cañada;19250;9373;9877;2015
28;Madrid;178;Villanueva de Perales;1441;737;704;2015
28;Madrid;177;Villanueva del Pardillo;16797;8260;8537;2015
28;Madrid;179;Villar del Olmo;2058;1063;995;2015
28;Madrid;180;Villarejo de Salvanés;7288;3668;3620;2015
28;Madrid;181;Villaviciosa de Odón;27075;13163;13912;2015
28;Madrid;182;Villavieja del Lozoya;280;150;130;2015
28;Madrid;183;Zarzalejo;1546;810;736;2015
29;Málaga;001;Alameda;5403;2731;2672;2015
29;Málaga;002;Alcaucín;2375;1193;1182;2015
29;Málaga;003;Alfarnate;1159;590;569;2015
29;Málaga;004;Alfarnatejo;463;237;226;2015
29;Málaga;005;Algarrobo;6013;3035;2978;2015
29;Málaga;006;Algatocín;834;432;402;2015
29;Málaga;007;Alhaurín de la Torre;38523;19162;19361;2015
29;Málaga;008;Alhaurín el Grande;24338;12167;12171;2015
29;Málaga;009;Almáchar;1867;962;905;2015
29;Málaga;010;Almargen;2081;1070;1011;2015
29;Málaga;011;Almogía;3826;1968;1858;2015
29;Málaga;012;Álora;13003;6540;6463;2015
29;Málaga;013;Alozaina;2082;1051;1031;2015
29;Málaga;014;Alpandeire;257;132;125;2015
29;Málaga;015;Antequera;41141;20224;20917;2015
29;Málaga;016;Árchez;436;226;210;2015
29;Málaga;017;Archidona;8490;4278;4212;2015
29;Málaga;018;Ardales;2527;1276;1251;2015
29;Málaga;019;Arenas;1219;640;579;2015
29;Málaga;020;Arriate;4157;2049;2108;2015
29;Málaga;021;Atajate;158;83;75;2015
29;Málaga;022;Benadalid;253;124;129;2015
29;Málaga;023;Benahavís;7105;3555;3550;2015
29;Málaga;024;Benalauría;470;255;215;2015
29;Málaga;025;Benalmádena;66598;32976;33622;2015
29;Málaga;026;Benamargosa;1568;808;760;2015
29;Málaga;027;Benamocarra;3047;1541;1506;2015
29;Málaga;028;Benaoján;1513;787;726;2015
29;Málaga;029;Benarrabá;521;258;263;2015
29;Málaga;030;Borge, El;963;499;464;2015
29;Málaga;031;Burgo, El;1929;973;956;2015
29;Málaga;032;Campillos;8524;4265;4259;2015
29;Málaga;033;Canillas de Aceituno;1737;911;826;2015
29;Málaga;034;Canillas de Albaida;842;426;416;2015
29;Málaga;035;Cañete la Real;1738;885;853;2015
29;Málaga;036;Carratraca;775;395;380;2015
29;Málaga;037;Cartajima;247;129;118;2015
29;Málaga;038;Cártama;24592;12497;12095;2015
29;Málaga;039;Casabermeja;3418;1815;1603;2015
29;Málaga;040;Casarabonela;2599;1363;1236;2015
29;Málaga;041;Casares;5954;3069;2885;2015
29;Málaga;042;Coín;21561;10868;10693;2015
29;Málaga;043;Colmenar;3444;1765;1679;2015
29;Málaga;044;Comares;1385;751;634;2015
29;Málaga;045;Cómpeta;3503;1759;1744;2015
29;Málaga;046;Cortes de la Frontera;3304;1694;1610;2015
29;Málaga;047;Cuevas Bajas;1431;699;732;2015
29;Málaga;049;Cuevas de San Marcos;3884;1951;1933;2015
29;Málaga;048;Cuevas del Becerro;1643;816;827;2015
29;Málaga;050;Cútar;605;308;297;2015
29;Málaga;051;Estepona;67080;33234;33846;2015
29;Málaga;052;Faraján;265;130;135;2015
29;Málaga;053;Frigiliana;3065;1557;1508;2015
29;Málaga;054;Fuengirola;77525;37983;39542;2015
29;Málaga;055;Fuente de Piedra;2613;1345;1268;2015
29;Málaga;056;Gaucín;1670;884;786;2015
29;Málaga;057;Genalguacil;456;233;223;2015
29;Málaga;058;Guaro;2060;1044;1016;2015
29;Málaga;059;Humilladero;3364;1697;1667;2015
29;Málaga;060;Igualeja;816;415;401;2015
29;Málaga;061;Istán;1388;696;692;2015
29;Málaga;062;Iznate;899;461;438;2015
29;Málaga;063;Jimera de Líbar;415;216;199;2015
29;Málaga;064;Jubrique;638;319;319;2015
29;Málaga;065;Júzcar;238;138;100;2015
29;Málaga;066;Macharaviaya;477;257;220;2015
29;Málaga;067;Málaga;569130;273817;295313;2015
29;Málaga;068;Manilva;14587;7524;7063;2015
29;Málaga;069;Marbella;139537;67535;72002;2015
29;Málaga;070;Mijas;79483;39913;39570;2015
29;Málaga;071;Moclinejo;1255;653;602;2015
29;Málaga;072;Mollina;4901;2461;2440;2015
29;Málaga;073;Monda;2382;1208;1174;2015
29;Málaga;074;Montejaque;984;485;499;2015
29;Málaga;075;Nerja;21185;10446;10739;2015
29;Málaga;076;Ojén;3353;1712;1641;2015
29;Málaga;077;Parauta;249;116;133;2015
29;Málaga;079;Periana;3231;1690;1541;2015
29;Málaga;080;Pizarra;9148;4626;4522;2015
29;Málaga;081;Pujerra;294;155;139;2015
29;Málaga;082;Rincón de la Victoria;43135;21192;21943;2015
29;Málaga;083;Riogordo;2936;1539;1397;2015
29;Málaga;084;Ronda;35676;17421;18255;2015
29;Málaga;085;Salares;207;105;102;2015
29;Málaga;086;Sayalonga;1505;770;735;2015
29;Málaga;087;Sedella;692;389;303;2015
29;Málaga;088;Sierra de Yeguas;3398;1713;1685;2015
29;Málaga;089;Teba;3973;2002;1971;2015
29;Málaga;090;Tolox;2186;1108;1078;2015
29;Málaga;901;Torremolinos;67492;33717;33775;2015
29;Málaga;091;Torrox;15117;7684;7433;2015
29;Málaga;092;Totalán;710;373;337;2015
29;Málaga;093;Valle de Abdalajís;2615;1323;1292;2015
29;Málaga;094;Vélez-Málaga;78166;38769;39397;2015
29;Málaga;095;Villanueva de Algaidas;4337;2219;2118;2015
29;Málaga;902;Villanueva de la Concepción;3341;1631;1710;2015
29;Málaga;098;Villanueva de Tapia;1544;779;765;2015
29;Málaga;096;Villanueva del Rosario;3508;1715;1793;2015
29;Málaga;097;Villanueva del Trabuco;5246;2615;2631;2015
29;Málaga;099;Viñuela;2013;1046;967;2015
29;Málaga;100;Yunquera;2983;1519;1464;2015
52;Melilla;001;Melilla;85584;43593;41991;2015
30;Murcia;001;Abanilla;6347;3209;3138;2015
30;Murcia;002;Abarán;13179;6630;6549;2015
30;Murcia;003;Águilas;34772;17376;17396;2015
30;Murcia;004;Albudeite;1374;689;685;2015
30;Murcia;005;Alcantarilla;41021;20239;20782;2015
30;Murcia;902;Alcázares, Los;15605;7930;7675;2015
30;Murcia;006;Aledo;984;491;493;2015
30;Murcia;007;Alguazas;9544;4956;4588;2015
30;Murcia;008;Alhama de Murcia;21351;10822;10529;2015
30;Murcia;009;Archena;18559;9630;8929;2015
30;Murcia;010;Beniel;11096;5670;5426;2015
30;Murcia;011;Blanca;6521;3320;3201;2015
30;Murcia;012;Bullas;11753;5922;5831;2015
30;Murcia;013;Calasparra;10423;5279;5144;2015
30;Murcia;014;Campos del Río;2083;996;1087;2015
30;Murcia;015;Caravaca de la Cruz;25851;12937;12914;2015
30;Murcia;016;Cartagena;216301;108358;107943;2015
30;Murcia;017;Cehegín;15794;7954;7840;2015
30;Murcia;018;Ceutí;11227;5655;5572;2015
30;Murcia;019;Cieza;35115;17658;17457;2015
30;Murcia;020;Fortuna;9814;5244;4570;2015
30;Murcia;021;Fuente Álamo de Murcia;16284;8498;7786;2015
30;Murcia;022;Jumilla;25484;13181;12303;2015
30;Murcia;023;Librilla;5016;2571;2445;2015
30;Murcia;024;Lorca;91714;46986;44728;2015
30;Murcia;025;Lorquí;7020;3555;3465;2015
30;Murcia;026;Mazarrón;32150;16627;15523;2015
30;Murcia;027;Molina de Segura;69331;34617;34714;2015
30;Murcia;028;Moratalla;8189;4165;4024;2015
30;Murcia;029;Mula;16805;8599;8206;2015
30;Murcia;030;Murcia;439889;215177;224712;2015
30;Murcia;031;Ojós;504;270;234;2015
30;Murcia;032;Pliego;3973;2050;1923;2015
30;Murcia;033;Puerto Lumbreras;14694;7357;7337;2015
30;Murcia;034;Ricote;1369;718;651;2015
30;Murcia;035;San Javier;31915;16167;15748;2015
30;Murcia;036;San Pedro del Pinatar;24339;12293;12046;2015
30;Murcia;901;Santomera;16012;8157;7855;2015
30;Murcia;037;Torre-Pacheco;34469;17975;16494;2015
30;Murcia;038;Torres de Cotillas, Las;21399;10854;10545;2015
30;Murcia;039;Totana;30916;15924;14992;2015
30;Murcia;040;Ulea;906;471;435;2015
30;Murcia;041;Unión, La;19572;9916;9656;2015
30;Murcia;042;Villanueva del Río Segura;2524;1270;1254;2015
30;Murcia;043;Yecla;34100;17071;17029;2015
31;Navarra;001;Abáigar;97;49;48;2015
31;Navarra;002;Abárzuza/Abartzuza;556;276;280;2015
31;Navarra;003;Abaurregaina/Abaurrea Alta;127;79;48;2015
31;Navarra;004;Abaurrepea/Abaurrea Baja;35;22;13;2015
31;Navarra;005;Aberin;376;204;172;2015
31;Navarra;006;Ablitas;2520;1288;1232;2015
31;Navarra;007;Adiós;170;91;79;2015
31;Navarra;008;Aguilar de Codés;83;44;39;2015
31;Navarra;009;Aibar/Oibar;832;449;383;2015
31;Navarra;011;Allín/Allin;848;455;393;2015
31;Navarra;012;Allo;1012;511;501;2015
31;Navarra;010;Altsasu/Alsasua;7490;3785;3705;2015
31;Navarra;013;Améscoa Baja;774;410;364;2015
31;Navarra;014;Ancín/Antzin;376;210;166;2015
31;Navarra;015;Andosilla;2753;1402;1351;2015
31;Navarra;016;Ansoáin/Antsoain;10830;5364;5466;2015
31;Navarra;017;Anue;464;256;208;2015
31;Navarra;018;Añorbe;539;295;244;2015
31;Navarra;019;Aoiz/Agoitz;2601;1301;1300;2015
31;Navarra;020;Araitz;522;294;228;2015
31;Navarra;025;Arakil;955;494;461;2015
31;Navarra;021;Aranarache/Aranaratxe;73;42;31;2015
31;Navarra;023;Aranguren;9398;4729;4669;2015
31;Navarra;024;Arano;108;60;48;2015
31;Navarra;022;Arantza;638;343;295;2015
31;Navarra;026;Aras;172;94;78;2015
31;Navarra;027;Arbizu;1111;571;540;2015
31;Navarra;028;Arce/Artzi;264;140;124;2015
31;Navarra;029;Arcos, Los;1136;560;576;2015
31;Navarra;030;Arellano;164;90;74;2015
31;Navarra;031;Areso;260;136;124;2015
31;Navarra;032;Arguedas;2295;1174;1121;2015
31;Navarra;033;Aria;52;31;21;2015
31;Navarra;034;Aribe;44;23;21;2015
31;Navarra;035;Armañanzas;68;40;28;2015
31;Navarra;036;Arróniz;1068;563;505;2015
31;Navarra;037;Arruazu;108;56;52;2015
31;Navarra;038;Artajona;1680;862;818;2015
31;Navarra;039;Artazu;112;57;55;2015
31;Navarra;040;Atez/Atetz;232;132;100;2015
31;Navarra;058;Auritz/Burguete;262;131;131;2015
31;Navarra;041;Ayegui/Aiegi;2217;1166;1051;2015
31;Navarra;042;Azagra;3804;1951;1853;2015
31;Navarra;043;Azuelo;37;15;22;2015
31;Navarra;044;Bakaiku;339;178;161;2015
31;Navarra;901;Barañain;20475;9938;10537;2015
31;Navarra;045;Barásoain;665;351;314;2015
31;Navarra;046;Barbarin;67;31;36;2015
31;Navarra;047;Bargota;292;143;149;2015
31;Navarra;048;Barillas;203;108;95;2015
31;Navarra;049;Basaburua;859;488;371;2015
31;Navarra;050;Baztan;7792;3925;3867;2015
31;Navarra;137;Beintza-Labaien;231;132;99;2015
31;Navarra;051;Beire;296;154;142;2015
31;Navarra;052;Belascoáin;117;61;56;2015
31;Navarra;250;Bera;3768;1885;1883;2015
31;Navarra;053;Berbinzana;633;331;302;2015
31;Navarra;905;Beriáin;3889;1903;1986;2015
31;Navarra;902;Berrioplano/Berriobeiti;6527;3320;3207;2015
31;Navarra;903;Berriozar;9625;4896;4729;2015
31;Navarra;054;Bertizarana;590;294;296;2015
31;Navarra;055;Betelu;347;184;163;2015
31;Navarra;253;Bidaurreta;160;89;71;2015
31;Navarra;056;Biurrun-Olcoz;219;127;92;2015
31;Navarra;057;Buñuel;2271;1109;1162;2015
31;Navarra;059;Burgui/Burgi;223;127;96;2015
31;Navarra;060;Burlada/Burlata;18336;8896;9440;2015
31;Navarra;061;Busto, El;71;36;35;2015
31;Navarra;062;Cabanillas;1414;737;677;2015
31;Navarra;063;Cabredo;104;58;46;2015
31;Navarra;064;Cadreita;2082;1101;981;2015
31;Navarra;065;Caparroso;2773;1426;1347;2015
31;Navarra;066;Cárcar;1054;534;520;2015
31;Navarra;067;Carcastillo;2466;1261;1205;2015
31;Navarra;068;Cascante;3787;1868;1919;2015
31;Navarra;069;Cáseda;989;484;505;2015
31;Navarra;070;Castejón;4062;2011;2051;2015
31;Navarra;071;Castillonuevo;16;12;4;2015
31;Navarra;193;Cendea de Olza/Oltza Zendea;1822;913;909;2015
31;Navarra;072;Cintruénigo;7779;3979;3800;2015
31;Navarra;074;Cirauqui/Zirauki;483;263;220;2015
31;Navarra;075;Ciriza/Ziritza;131;60;71;2015
31;Navarra;076;Cizur;3751;1917;1834;2015
31;Navarra;077;Corella;7740;3970;3770;2015
31;Navarra;078;Cortes;3192;1616;1576;2015
31;Navarra;079;Desojo;81;45;36;2015
31;Navarra;080;Dicastillo;637;336;301;2015
31;Navarra;081;Donamaria;443;222;221;2015
31;Navarra;221;Doneztebe/Santesteban;1658;846;812;2015
31;Navarra;083;Echarri;78;40;38;2015
31;Navarra;087;Elgorriaga;219;104;115;2015
31;Navarra;089;Enériz/Eneritz;322;160;162;2015
31;Navarra;090;Eratsun;150;91;59;2015
31;Navarra;091;Ergoiena;397;215;182;2015
31;Navarra;092;Erro;792;449;343;2015
31;Navarra;094;Eslava;123;64;59;2015
31;Navarra;095;Esparza de Salazar/Espartza Zaraitzu;87;45;42;2015
31;Navarra;096;Espronceda;114;66;48;2015
31;Navarra;097;Estella-Lizarra;13702;6584;7118;2015
31;Navarra;098;Esteribar;2598;1352;1246;2015
31;Navarra;099;Etayo;72;37;35;2015
31;Navarra;082;Etxalar;801;429;372;2015
31;Navarra;084;Etxarri Aranatz;2466;1280;1186;2015
31;Navarra;085;Etxauri;586;305;281;2015
31;Navarra;100;Eulate;303;166;137;2015
31;Navarra;101;Ezcabarte;1834;957;877;2015
31;Navarra;093;Ezcároz/Ezkaroze;323;175;148;2015
31;Navarra;102;Ezkurra;154;103;51;2015
31;Navarra;103;Ezprogui;47;24;23;2015
31;Navarra;104;Falces;2390;1204;1186;2015
31;Navarra;105;Fitero;2022;1005;1017;2015
31;Navarra;106;Fontellas;961;489;472;2015
31;Navarra;107;Funes;2471;1328;1143;2015
31;Navarra;108;Fustiñana;2511;1248;1263;2015
31;Navarra;109;Galar;2074;1097;977;2015
31;Navarra;110;Gallipienzo/Galipentzu;106;60;46;2015
31;Navarra;111;Gallués/Galoze;103;64;39;2015
31;Navarra;112;Garaioa;97;53;44;2015
31;Navarra;113;Garde;157;96;61;2015
31;Navarra;114;Garínoain;490;269;221;2015
31;Navarra;115;Garralda;185;96;89;2015
31;Navarra;116;Genevilla;75;43;32;2015
31;Navarra;117;Goizueta;736;400;336;2015
31;Navarra;118;Goñi;170;106;64;2015
31;Navarra;119;Güesa/Gorza;43;25;18;2015
31;Navarra;120;Guesálaz/Gesalatz;450;267;183;2015
31;Navarra;121;Guirguillano;81;42;39;2015
31;Navarra;256;Hiriberri/Villanueva de Aezkoa;119;66;53;2015
31;Navarra;122;Huarte/Uharte;6776;3397;3379;2015
31;Navarra;124;Ibargoiti;249;145;104;2015
31;Navarra;259;Igantzi;618;324;294;2015
31;Navarra;125;Igúzquiza;332;172;160;2015
31;Navarra;126;Imotz;432;227;205;2015
31;Navarra;127;Irañeta;172;96;76;2015
31;Navarra;904;Irurtzun;2194;1133;1061;2015
31;Navarra;128;Isaba/Izaba;473;229;244;2015
31;Navarra;129;Ituren;515;265;250;2015
31;Navarra;130;Iturmendi;388;200;188;2015
31;Navarra;131;Iza/Itza;1171;632;539;2015
31;Navarra;132;Izagaondoa;177;114;63;2015
31;Navarra;133;Izalzu/Itzaltzu;51;31;20;2015
31;Navarra;134;Jaurrieta;202;115;87;2015
31;Navarra;135;Javier;103;37;66;2015
31;Navarra;136;Juslapeña;553;293;260;2015
31;Navarra;138;Lakuntza;1257;651;606;2015
31;Navarra;139;Lana;176;100;76;2015
31;Navarra;140;Lantz;151;87;64;2015
31;Navarra;141;Lapoblación;127;70;57;2015
31;Navarra;142;Larraga;2034;1086;948;2015
31;Navarra;143;Larraona;112;51;61;2015
31;Navarra;144;Larraun;985;533;452;2015
31;Navarra;145;Lazagurría;206;105;101;2015
31;Navarra;146;Leache/Leatxe;44;26;18;2015
31;Navarra;147;Legarda;110;58;52;2015
31;Navarra;148;Legaria;98;44;54;2015
31;Navarra;149;Leitza;2888;1517;1371;2015
31;Navarra;908;Lekunberri;1483;733;750;2015
31;Navarra;150;Leoz/Leotz;241;157;84;2015
31;Navarra;151;Lerga;73;43;30;2015
31;Navarra;152;Lerín;1665;852;813;2015
31;Navarra;153;Lesaka;2742;1417;1325;2015
31;Navarra;154;Lezáun;261;157;104;2015
31;Navarra;155;Liédena;303;159;144;2015
31;Navarra;156;Lizoáin-Arriasgoiti;318;191;127;2015
31;Navarra;157;Lodosa;4741;2385;2356;2015
31;Navarra;158;Lónguida/Longida;306;165;141;2015
31;Navarra;159;Lumbier;1349;724;625;2015
31;Navarra;160;Luquin;135;72;63;2015
31;Navarra;248;Luzaide/Valcarlos;377;216;161;2015
31;Navarra;161;Mañeru;432;233;199;2015
31;Navarra;162;Marañón;53;26;27;2015
31;Navarra;163;Marcilla;2800;1399;1401;2015
31;Navarra;164;Mélida;729;378;351;2015
31;Navarra;165;Mendavia;3597;1842;1755;2015
31;Navarra;166;Mendaza;311;158;153;2015
31;Navarra;167;Mendigorría;1055;548;507;2015
31;Navarra;168;Metauten;291;161;130;2015
31;Navarra;169;Milagro;3290;1719;1571;2015
31;Navarra;170;Mirafuentes;56;24;32;2015
31;Navarra;171;Miranda de Arga;847;438;409;2015
31;Navarra;172;Monreal/Elo;470;254;216;2015
31;Navarra;173;Monteagudo;1097;550;547;2015
31;Navarra;174;Morentin;129;66;63;2015
31;Navarra;175;Mues;88;47;41;2015
31;Navarra;176;Murchante;3842;1931;1911;2015
31;Navarra;177;Murieta;353;189;164;2015
31;Navarra;178;Murillo el Cuende;654;333;321;2015
31;Navarra;179;Murillo el Fruto;634;329;305;2015
31;Navarra;180;Muruzábal;266;117;149;2015
31;Navarra;181;Navascués/Nabaskoze;151;89;62;2015
31;Navarra;182;Nazar;45;26;19;2015
31;Navarra;088;Noáin (Valle de Elorz)/Noain (Elortzibar);7892;3992;3900;2015
31;Navarra;183;Obanos;904;445;459;2015
31;Navarra;185;Ochagavía/Otsagabia;560;293;267;2015
31;Navarra;184;Oco;64;32;32;2015
31;Navarra;186;Odieta;370;206;164;2015
31;Navarra;187;Oiz;141;81;60;2015
31;Navarra;188;Olaibar;316;177;139;2015
31;Navarra;189;Olazti/Olazagutía;1520;776;744;2015
31;Navarra;190;Olejua;49;28;21;2015
31;Navarra;191;Olite/Erriberri;3907;1973;1934;2015
31;Navarra;194;Ollo;409;217;192;2015
31;Navarra;192;Olóriz/Oloritz;195;113;82;2015
31;Navarra;195;Orbaizeta;202;102;100;2015
31;Navarra;196;Orbara;42;22;20;2015
31;Navarra;197;Orísoain;92;49;43;2015
31;Navarra;906;Orkoien;3770;1906;1864;2015
31;Navarra;198;Oronz/Orontze;46;25;21;2015
31;Navarra;199;Oroz-Betelu/Orotz-Betelu;153;87;66;2015
31;Navarra;211;Orreaga/Roncesvalles;32;16;16;2015
31;Navarra;200;Oteiza;928;490;438;2015
31;Navarra;201;Pamplona/Iruña;195853;93134;102719;2015
31;Navarra;202;Peralta/Azkoien;5863;2950;2913;2015
31;Navarra;203;Petilla de Aragón;34;21;13;2015
31;Navarra;204;Piedramillera;39;26;13;2015
31;Navarra;205;Pitillas;511;248;263;2015
31;Navarra;206;Puente la Reina/Gares;2818;1446;1372;2015
31;Navarra;207;Pueyo;340;183;157;2015
31;Navarra;208;Ribaforada;3692;1889;1803;2015
31;Navarra;209;Romanzado;173;90;83;2015
31;Navarra;210;Roncal/Erronkari;227;121;106;2015
31;Navarra;212;Sada;163;87;76;2015
31;Navarra;213;Saldías;116;68;48;2015
31;Navarra;214;Salinas de Oro/Jaitz;117;66;51;2015
31;Navarra;215;San Adrián;6196;3069;3127;2015
31;Navarra;217;San Martín de Unx;372;195;177;2015
31;Navarra;216;Sangüesa/Zangoza;5020;2545;2475;2015
31;Navarra;219;Sansol;100;53;47;2015
31;Navarra;220;Santacara;891;462;429;2015
31;Navarra;222;Sarriés/Sartze;63;40;23;2015
31;Navarra;223;Sartaguda;1372;717;655;2015
31;Navarra;224;Sesma;1183;607;576;2015
31;Navarra;225;Sorlada;61;35;26;2015
31;Navarra;226;Sunbilla;648;343;305;2015
31;Navarra;227;Tafalla;10809;5336;5473;2015
31;Navarra;228;Tiebas-Muruarte de Reta;617;315;302;2015
31;Navarra;229;Tirapu;51;32;19;2015
31;Navarra;230;Torralba del Río;118;63;55;2015
31;Navarra;231;Torres del Río;129;60;69;2015
31;Navarra;232;Tudela;35388;17436;17952;2015
31;Navarra;233;Tulebras;118;51;67;2015
31;Navarra;234;Ucar;182;106;76;2015
31;Navarra;123;Uharte Arakil;840;443;397;2015
31;Navarra;235;Ujué;187;104;83;2015
31;Navarra;236;Ultzama;1666;867;799;2015
31;Navarra;237;Unciti;219;128;91;2015
31;Navarra;238;Unzué/Untzue;124;71;53;2015
31;Navarra;239;Urdazubi/Urdax;402;193;209;2015
31;Navarra;240;Urdiain;681;354;327;2015
31;Navarra;241;Urraul Alto;152;90;62;2015
31;Navarra;242;Urraul Bajo;294;130;164;2015
31;Navarra;244;Urroz;186;102;84;2015
31;Navarra;243;Urroz-Villa;408;214;194;2015
31;Navarra;245;Urzainqui/Urzainki;95;54;41;2015
31;Navarra;246;Uterga;174;100;74;2015
31;Navarra;247;Uztárroz/Uztarroze;154;76;78;2015
31;Navarra;086;Valle de Egüés;19603;9880;9723;2015
31;Navarra;260;Valle de Yerri/Deierri;1497;763;734;2015
31;Navarra;249;Valtierra;2443;1205;1238;2015
31;Navarra;251;Viana;4048;2076;1972;2015
31;Navarra;252;Vidángoz/Bidankoze;94;51;43;2015
31;Navarra;254;Villafranca;2805;1414;1391;2015
31;Navarra;255;Villamayor de Monjardín;128;67;61;2015
31;Navarra;257;Villatuerta;1137;573;564;2015
31;Navarra;258;Villava/Atarrabia;10265;5031;5234;2015
31;Navarra;261;Yesa;285;159;126;2015
31;Navarra;262;Zabalza/Zabaltza;276;141;135;2015
31;Navarra;073;Ziordia;389;190;199;2015
31;Navarra;907;Zizur Mayor/Zizur Nagusia;14493;7145;7348;2015
31;Navarra;263;Zubieta;323;173;150;2015
31;Navarra;264;Zugarramurdi;227;113;114;2015
31;Navarra;265;Zúñiga;116;74;42;2015
32;Ourense;001;Allariz;6049;3001;3048;2015
32;Ourense;002;Amoeiro;2245;1104;1141;2015
32;Ourense;003;Arnoia, A;1040;508;532;2015
32;Ourense;004;Avión;1962;900;1062;2015
32;Ourense;005;Baltar;1002;533;469;2015
32;Ourense;006;Bande;1735;841;894;2015
32;Ourense;007;Baños de Molgas;1658;821;837;2015
32;Ourense;008;Barbadás;10463;5109;5354;2015
32;Ourense;009;Barco de Valdeorras, O;13785;6712;7073;2015
32;Ourense;010;Beade;451;240;211;2015
32;Ourense;011;Beariz;1016;450;566;2015
32;Ourense;012;Blancos, Os;878;485;393;2015
32;Ourense;013;Boborás;2510;1168;1342;2015
32;Ourense;014;Bola, A;1339;637;702;2015
32;Ourense;015;Bolo, O;988;501;487;2015
32;Ourense;016;Calvos de Randín;922;453;469;2015
32;Ourense;018;Carballeda de Avia;1400;679;721;2015
32;Ourense;017;Carballeda de Valdeorras;1698;871;827;2015
32;Ourense;019;Carballiño, O;13999;6574;7425;2015
32;Ourense;020;Cartelle;2852;1398;1454;2015
32;Ourense;022;Castrelo de Miño;1556;777;779;2015
32;Ourense;021;Castrelo do Val;1079;555;524;2015
32;Ourense;023;Castro Caldelas;1351;679;672;2015
32;Ourense;024;Celanova;5536;2637;2899;2015
32;Ourense;025;Cenlle;1189;566;623;2015
32;Ourense;029;Chandrexa de Queixa;528;296;232;2015
32;Ourense;026;Coles;3168;1594;1574;2015
32;Ourense;027;Cortegada;1184;577;607;2015
32;Ourense;028;Cualedro;1840;934;906;2015
32;Ourense;030;Entrimo;1251;589;662;2015
32;Ourense;031;Esgos;1220;614;606;2015
32;Ourense;033;Gomesende;829;393;436;2015
32;Ourense;034;Gudiña, A;1392;732;660;2015
32;Ourense;035;Irixo, O;1600;770;830;2015
32;Ourense;038;Larouco;526;249;277;2015
32;Ourense;039;Laza;1424;740;684;2015
32;Ourense;040;Leiro;1630;811;819;2015
32;Ourense;041;Lobeira;813;389;424;2015
32;Ourense;042;Lobios;1988;1006;982;2015
32;Ourense;043;Maceda;2957;1438;1519;2015
32;Ourense;044;Manzaneda;975;482;493;2015
32;Ourense;045;Maside;2879;1391;1488;2015
32;Ourense;046;Melón;1293;614;679;2015
32;Ourense;047;Merca, A;2021;979;1042;2015
32;Ourense;048;Mezquita, A;1109;570;539;2015
32;Ourense;049;Montederramo;807;410;397;2015
32;Ourense;050;Monterrei;2758;1402;1356;2015
32;Ourense;051;Muíños;1622;816;806;2015
32;Ourense;052;Nogueira de Ramuín;2124;1072;1052;2015
32;Ourense;053;Oímbra;2020;1112;908;2015
32;Ourense;054;Ourense;106231;48592;57639;2015
32;Ourense;055;Paderne de Allariz;1486;715;771;2015
32;Ourense;056;Padrenda;1912;916;996;2015
32;Ourense;057;Parada de Sil;605;323;282;2015
32;Ourense;058;Pereiro de Aguiar, O;6319;3236;3083;2015
32;Ourense;059;Peroxa, A;2038;1005;1033;2015
32;Ourense;060;Petín;953;463;490;2015
32;Ourense;061;Piñor;1232;620;612;2015
32;Ourense;063;Pobra de Trives, A;2245;1116;1129;2015
32;Ourense;064;Pontedeva;600;295;305;2015
32;Ourense;062;Porqueira;901;440;461;2015
32;Ourense;065;Punxín;760;369;391;2015
32;Ourense;066;Quintela de Leirado;629;277;352;2015
32;Ourense;067;Rairiz de Veiga;1430;733;697;2015
32;Ourense;068;Ramirás;1607;739;868;2015
32;Ourense;069;Ribadavia;5112;2474;2638;2015
32;Ourense;071;Riós;1683;851;832;2015
32;Ourense;072;Rúa, A;4595;2269;2326;2015
32;Ourense;073;Rubiá;1473;727;746;2015
32;Ourense;074;San Amaro;1170;566;604;2015
32;Ourense;075;San Cibrao das Viñas;5036;2556;2480;2015
32;Ourense;076;San Cristovo de Cea;2346;1164;1182;2015
32;Ourense;070;San Xoán de Río;600;292;308;2015
32;Ourense;077;Sandiás;1307;595;712;2015
32;Ourense;078;Sarreaus;1283;649;634;2015
32;Ourense;079;Taboadela;1514;774;740;2015
32;Ourense;080;Teixeira, A;378;189;189;2015
32;Ourense;081;Toén;2426;1249;1177;2015
32;Ourense;082;Trasmiras;1410;704;706;2015
32;Ourense;083;Veiga, A;946;478;468;2015
32;Ourense;084;Verea;1042;492;550;2015
32;Ourense;085;Verín;14107;6815;7292;2015
32;Ourense;086;Viana do Bolo;3037;1509;1528;2015
32;Ourense;087;Vilamarín;2026;1024;1002;2015
32;Ourense;088;Vilamartín de Valdeorras;1798;923;875;2015
32;Ourense;089;Vilar de Barrio;1455;743;712;2015
32;Ourense;090;Vilar de Santos;894;435;459;2015
32;Ourense;091;Vilardevós;2170;1124;1046;2015
32;Ourense;092;Vilariño de Conso;615;348;267;2015
32;Ourense;032;Xinzo de Limia;10043;4911;5132;2015
32;Ourense;036;Xunqueira de Ambía;1498;758;740;2015
32;Ourense;037;Xunqueira de Espadanedo;818;406;412;2015
34;Palencia;001;Abarca de Campos;43;26;17;2015
34;Palencia;003;Abia de las Torres;184;101;83;2015
34;Palencia;004;Aguilar de Campoo;7033;3421;3612;2015
34;Palencia;005;Alar del Rey;987;484;503;2015
34;Palencia;006;Alba de Cerrato;84;46;38;2015
34;Palencia;009;Amayuelas de Arriba;40;26;14;2015
34;Palencia;010;Ampudia;640;333;307;2015
34;Palencia;011;Amusco;440;238;202;2015
34;Palencia;012;Antigüedad;391;209;182;2015
34;Palencia;015;Arconada;44;28;16;2015
34;Palencia;017;Astudillo;1002;505;497;2015
34;Palencia;018;Autilla del Pino;232;127;105;2015
34;Palencia;019;Autillo de Campos;146;74;72;2015
34;Palencia;020;Ayuela;58;34;24;2015
34;Palencia;022;Baltanás;1273;671;602;2015
34;Palencia;024;Baquerín de Campos;37;25;12;2015
34;Palencia;025;Bárcena de Campos;63;30;33;2015
34;Palencia;027;Barruelo de Santullán;1275;631;644;2015
34;Palencia;028;Báscones de Ojeda;154;82;72;2015
34;Palencia;029;Becerril de Campos;812;419;393;2015
34;Palencia;031;Belmonte de Campos;33;18;15;2015
34;Palencia;032;Berzosilla;47;25;22;2015
34;Palencia;033;Boada de Campos;18;12;6;2015
34;Palencia;035;Boadilla de Rioseco;126;73;53;2015
34;Palencia;034;Boadilla del Camino;127;71;56;2015
34;Palencia;036;Brañosera;247;144;103;2015
34;Palencia;037;Buenavista de Valdavia;320;178;142;2015
34;Palencia;038;Bustillo de la Vega;316;171;145;2015
34;Palencia;039;Bustillo del Páramo de Carrión;64;38;26;2015
34;Palencia;041;Calahorra de Boedo;94;51;43;2015
34;Palencia;042;Calzada de los Molinos;347;189;158;2015
34;Palencia;045;Capillas;79;40;39;2015
34;Palencia;046;Cardeñosa de Volpejera;49;28;21;2015
34;Palencia;047;Carrión de los Condes;2177;1048;1129;2015
34;Palencia;048;Castil de Vela;71;37;34;2015
34;Palencia;049;Castrejón de la Peña;398;217;181;2015
34;Palencia;050;Castrillo de Don Juan;234;128;106;2015
34;Palencia;051;Castrillo de Onielo;114;62;52;2015
34;Palencia;052;Castrillo de Villavega;196;107;89;2015
34;Palencia;053;Castromocho;234;125;109;2015
34;Palencia;055;Cervatos de la Cueza;300;170;130;2015
34;Palencia;056;Cervera de Pisuerga;2442;1223;1219;2015
34;Palencia;057;Cevico de la Torre;511;251;260;2015
34;Palencia;058;Cevico Navero;196;105;91;2015
34;Palencia;059;Cisneros;474;240;234;2015
34;Palencia;060;Cobos de Cerrato;146;80;66;2015
34;Palencia;061;Collazos de Boedo;115;62;53;2015
34;Palencia;062;Congosto de Valdavia;184;111;73;2015
34;Palencia;063;Cordovilla la Real;106;63;43;2015
34;Palencia;066;Cubillas de Cerrato;61;32;29;2015
34;Palencia;067;Dehesa de Montejo;136;77;59;2015
34;Palencia;068;Dehesa de Romanos;34;20;14;2015
34;Palencia;069;Dueñas;2741;1399;1342;2015
34;Palencia;070;Espinosa de Cerrato;177;88;89;2015
34;Palencia;071;Espinosa de Villagonzalo;201;103;98;2015
34;Palencia;072;Frechilla;176;88;88;2015
34;Palencia;073;Fresno del Río;205;99;106;2015
34;Palencia;074;Frómista;822;416;406;2015
34;Palencia;076;Fuentes de Nava;682;349;333;2015
34;Palencia;077;Fuentes de Valdepero;419;218;201;2015
34;Palencia;079;Grijota;2114;1098;1016;2015
34;Palencia;080;Guardo;6547;3249;3298;2015
34;Palencia;081;Guaza de Campos;61;34;27;2015
34;Palencia;082;Hérmedes de Cerrato;87;47;40;2015
34;Palencia;083;Herrera de Pisuerga;2132;1039;1093;2015
34;Palencia;084;Herrera de Valdecañas;147;79;68;2015
34;Palencia;086;Hontoria de Cerrato;109;58;51;2015
34;Palencia;087;Hornillos de Cerrato;137;72;65;2015
34;Palencia;088;Husillos;290;159;131;2015
34;Palencia;089;Itero de la Vega;179;97;82;2015
34;Palencia;091;Lagartos;137;78;59;2015
34;Palencia;092;Lantadilla;331;177;154;2015
34;Palencia;094;Ledigos;64;37;27;2015
34;Palencia;903;Loma de Ucieza;232;135;97;2015
34;Palencia;096;Lomas;56;37;19;2015
34;Palencia;098;Magaz de Pisuerga;975;514;461;2015
34;Palencia;099;Manquillos;77;41;36;2015
34;Palencia;100;Mantinos;156;87;69;2015
34;Palencia;101;Marcilla de Campos;40;19;21;2015
34;Palencia;102;Mazariegos;221;128;93;2015
34;Palencia;103;Mazuecos de Valdeginate;98;56;42;2015
34;Palencia;104;Melgar de Yuso;263;152;111;2015
34;Palencia;106;Meneses de Campos;121;62;59;2015
34;Palencia;107;Micieces de Ojeda;83;47;36;2015
34;Palencia;108;Monzón de Campos;623;322;301;2015
34;Palencia;109;Moratinos;60;36;24;2015
34;Palencia;110;Mudá;94;49;45;2015
34;Palencia;112;Nogal de las Huertas;44;26;18;2015
34;Palencia;113;Olea de Boedo;36;13;23;2015
34;Palencia;114;Olmos de Ojeda;213;130;83;2015
34;Palencia;116;Osornillo;63;32;31;2015
34;Palencia;901;Osorno la Mayor;1298;683;615;2015
34;Palencia;120;Palencia;79595;37516;42079;2015
34;Palencia;121;Palenzuela;208;112;96;2015
34;Palencia;122;Páramo de Boedo;111;59;52;2015
34;Palencia;123;Paredes de Nava;1981;1008;973;2015
34;Palencia;124;Payo de Ojeda;63;37;26;2015
34;Palencia;125;Pedraza de Campos;96;49;47;2015
34;Palencia;126;Pedrosa de la Vega;347;189;158;2015
34;Palencia;127;Perales;111;58;53;2015
34;Palencia;904;Pernía, La;349;205;144;2015
34;Palencia;129;Pino del Río;192;118;74;2015
34;Palencia;130;Piña de Campos;229;120;109;2015
34;Palencia;131;Población de Arroyo;62;34;28;2015
34;Palencia;132;Población de Campos;135;77;58;2015
34;Palencia;133;Población de Cerrato;112;62;50;2015
34;Palencia;134;Polentinos;55;30;25;2015
34;Palencia;135;Pomar de Valdivia;462;259;203;2015
34;Palencia;136;Poza de la Vega;225;124;101;2015
34;Palencia;137;Pozo de Urama;30;19;11;2015
34;Palencia;139;Prádanos de Ojeda;197;108;89;2015
34;Palencia;140;Puebla de Valdavia, La;109;56;53;2015
34;Palencia;141;Quintana del Puente;277;157;120;2015
34;Palencia;143;Quintanilla de Onsoña;192;112;80;2015
34;Palencia;146;Reinoso de Cerrato;54;36;18;2015
34;Palencia;147;Renedo de la Vega;203;110;93;2015
34;Palencia;149;Requena de Campos;20;10;10;2015
34;Palencia;151;Respenda de la Peña;181;106;75;2015
34;Palencia;152;Revenga de Campos;162;85;77;2015
34;Palencia;154;Revilla de Collazos;86;46;40;2015
34;Palencia;155;Ribas de Campos;166;85;81;2015
34;Palencia;156;Riberos de la Cueza;59;39;20;2015
34;Palencia;157;Saldaña;3121;1564;1557;2015
34;Palencia;158;Salinas de Pisuerga;358;183;175;2015
34;Palencia;159;San Cebrián de Campos;446;246;200;2015
34;Palencia;160;San Cebrián de Mudá;160;87;73;2015
34;Palencia;161;San Cristóbal de Boedo;23;14;9;2015
34;Palencia;163;San Mamés de Campos;53;27;26;2015
34;Palencia;165;San Román de la Cuba;71;40;31;2015
34;Palencia;167;Santa Cecilia del Alcor;129;76;53;2015
34;Palencia;168;Santa Cruz de Boedo;59;33;26;2015
34;Palencia;169;Santervás de la Vega;479;266;213;2015
34;Palencia;170;Santibáñez de Ecla;65;33;32;2015
34;Palencia;171;Santibáñez de la Peña;1101;542;559;2015
34;Palencia;174;Santoyo;224;121;103;2015
34;Palencia;175;Serna, La;96;61;35;2015
34;Palencia;177;Soto de Cerrato;195;114;81;2015
34;Palencia;176;Sotobañado y Priorato;159;93;66;2015
34;Palencia;178;Tabanera de Cerrato;126;73;53;2015
34;Palencia;179;Tabanera de Valdavia;31;16;15;2015
34;Palencia;180;Támara de Campos;79;41;38;2015
34;Palencia;181;Tariego de Cerrato;526;281;245;2015
34;Palencia;182;Torquemada;1025;555;470;2015
34;Palencia;184;Torremormojón;55;31;24;2015
34;Palencia;185;Triollo;60;34;26;2015
34;Palencia;186;Valbuena de Pisuerga;52;30;22;2015
34;Palencia;189;Valdeolmillos;69;37;32;2015
34;Palencia;190;Valderrábano;57;29;28;2015
34;Palencia;192;Valde-Ucieza;108;64;44;2015
34;Palencia;196;Valle de Cerrato;96;58;38;2015
34;Palencia;902;Valle del Retortillo;185;106;79;2015
34;Palencia;199;Velilla del Río Carrión;1406;723;683;2015
34;Palencia;023;Venta de Baños;6432;3229;3203;2015
34;Palencia;201;Vertavillo;208;111;97;2015
34;Palencia;093;Vid de Ojeda, La;106;64;42;2015
34;Palencia;202;Villabasta de Valdavia;31;16;15;2015
34;Palencia;204;Villacidaler;48;29;19;2015
34;Palencia;205;Villaconancio;63;37;26;2015
34;Palencia;206;Villada;1036;520;516;2015
34;Palencia;208;Villaeles de Valdavia;60;34;26;2015
34;Palencia;210;Villahán;104;52;52;2015
34;Palencia;211;Villaherreros;208;102;106;2015
34;Palencia;213;Villalaco;65;33;32;2015
34;Palencia;214;Villalba de Guardo;204;110;94;2015
34;Palencia;215;Villalcázar de Sirga;158;83;75;2015
34;Palencia;216;Villalcón;71;40;31;2015
34;Palencia;217;Villalobón;1573;795;778;2015
34;Palencia;218;Villaluenga de la Vega;565;327;238;2015
34;Palencia;220;Villamartín de Campos;181;102;79;2015
34;Palencia;221;Villamediana;185;102;83;2015
34;Palencia;222;Villameriel;127;72;55;2015
34;Palencia;223;Villamoronta;262;150;112;2015
34;Palencia;224;Villamuera de la Cueza;51;31;20;2015
34;Palencia;225;Villamuriel de Cerrato;6370;3288;3082;2015
34;Palencia;227;Villanueva del Rebollar;78;38;40;2015
34;Palencia;228;Villanuño de Valdavia;94;53;41;2015
34;Palencia;229;Villaprovedo;69;46;23;2015
34;Palencia;230;Villarmentero de Campos;21;11;10;2015
34;Palencia;231;Villarrabé;218;116;102;2015
34;Palencia;232;Villarramiel;860;458;402;2015
34;Palencia;233;Villasarracino;142;81;61;2015
34;Palencia;234;Villasila de Valdavia;77;53;24;2015
34;Palencia;236;Villaturde;167;88;79;2015
34;Palencia;237;Villaumbrales;686;350;336;2015
34;Palencia;238;Villaviudas;395;187;208;2015
34;Palencia;240;Villerías de Campos;94;54;40;2015
34;Palencia;241;Villodre;16;11;5;2015
34;Palencia;242;Villodrigo;122;68;54;2015
34;Palencia;243;Villoldo;364;199;165;2015
34;Palencia;245;Villota del Páramo;326;189;137;2015
34;Palencia;246;Villovieco;70;40;30;2015
35;Palmas, Las;001;Agaete;5618;2813;2805;2015
35;Palmas, Las;002;Agüimes;30294;15351;14943;2015
35;Palmas, Las;020;Aldea de San Nicolás, La;7969;4036;3933;2015
35;Palmas, Las;003;Antigua;11024;5875;5149;2015
35;Palmas, Las;004;Arrecife;56940;28539;28401;2015
35;Palmas, Las;005;Artenara;1177;641;536;2015
35;Palmas, Las;006;Arucas;37054;18448;18606;2015
35;Palmas, Las;007;Betancuria;713;364;349;2015
35;Palmas, Las;008;Firgas;7486;3782;3704;2015
35;Palmas, Las;009;Gáldar;24235;12165;12070;2015
35;Palmas, Las;010;Haría;4755;2446;2309;2015
35;Palmas, Las;011;Ingenio;30258;15365;14893;2015
35;Palmas, Las;012;Mogán;22277;11557;10720;2015
35;Palmas, Las;013;Moya;7845;3988;3857;2015
35;Palmas, Las;014;Oliva, La;25199;13367;11832;2015
35;Palmas, Las;015;Pájara;19271;10061;9210;2015
35;Palmas, Las;016;Palmas de Gran Canaria, Las;379766;184254;195512;2015
35;Palmas, Las;017;Puerto del Rosario;37363;19082;18281;2015
35;Palmas, Las;018;San Bartolomé;18402;9288;9114;2015
35;Palmas, Las;019;San Bartolomé de Tirajana;54932;28653;26279;2015
35;Palmas, Las;021;Santa Brígida;18582;9214;9368;2015
35;Palmas, Las;022;Santa Lucía de Tirajana;69069;34529;34540;2015
35;Palmas, Las;023;Santa María de Guía de Gran Canaria;13890;6926;6964;2015
35;Palmas, Las;024;Teguise;21454;10883;10571;2015
35;Palmas, Las;025;Tejeda;2001;1064;937;2015
35;Palmas, Las;026;Telde;102078;50487;51591;2015
35;Palmas, Las;027;Teror;12499;6435;6064;2015
35;Palmas, Las;028;Tías;20019;10241;9778;2015
35;Palmas, Las;029;Tinajo;5824;3014;2810;2015
35;Palmas, Las;030;Tuineje;13797;7071;6726;2015
35;Palmas, Las;032;Valleseco;3856;2030;1826;2015
35;Palmas, Las;031;Valsequillo de Gran Canaria;9276;4682;4594;2015
35;Palmas, Las;033;Vega de San Mateo;7668;3910;3758;2015
35;Palmas, Las;034;Yaiza;15815;8288;7527;2015
36;Pontevedra;020;Agolada;2585;1278;1307;2015
36;Pontevedra;001;Arbo;2846;1440;1406;2015
36;Pontevedra;003;Baiona;12072;5982;6090;2015
36;Pontevedra;002;Barro;3726;1844;1882;2015
36;Pontevedra;004;Bueu;12251;6031;6220;2015
36;Pontevedra;005;Caldas de Reis;9834;4742;5092;2015
36;Pontevedra;006;Cambados;13895;6744;7151;2015
36;Pontevedra;007;Campo Lameiro;1931;922;1009;2015
36;Pontevedra;008;Cangas;26520;13081;13439;2015
36;Pontevedra;009;Cañiza, A;5230;2551;2679;2015
36;Pontevedra;010;Catoira;3368;1651;1717;2015
36;Pontevedra;011;Cerdedo;1828;854;974;2015
36;Pontevedra;012;Cotobade;4332;2099;2233;2015
36;Pontevedra;013;Covelo;2617;1293;1324;2015
36;Pontevedra;014;Crecente;2252;1077;1175;2015
36;Pontevedra;015;Cuntis;4878;2311;2567;2015
36;Pontevedra;016;Dozón;1174;610;564;2015
36;Pontevedra;017;Estrada, A;21025;10072;10953;2015
36;Pontevedra;018;Forcarei;3683;1728;1955;2015
36;Pontevedra;019;Fornelos de Montes;1794;850;944;2015
36;Pontevedra;021;Gondomar;14056;6954;7102;2015
36;Pontevedra;022;Grove, O;10801;5306;5495;2015
36;Pontevedra;023;Guarda, A;10193;4969;5224;2015
36;Pontevedra;901;Illa de Arousa, A;4956;2459;2497;2015
36;Pontevedra;024;Lalín;20005;9707;10298;2015
36;Pontevedra;025;Lama, A;2670;1296;1374;2015
36;Pontevedra;026;Marín;25084;12588;12496;2015
36;Pontevedra;027;Meaño;5382;2611;2771;2015
36;Pontevedra;028;Meis;5006;2399;2607;2015
36;Pontevedra;029;Moaña;19492;9527;9965;2015
36;Pontevedra;030;Mondariz;4665;2273;2392;2015
36;Pontevedra;031;Mondariz-Balneario;652;329;323;2015
36;Pontevedra;032;Moraña;4358;2111;2247;2015
36;Pontevedra;033;Mos;15305;7549;7756;2015
36;Pontevedra;034;Neves, As;4066;1971;2095;2015
36;Pontevedra;035;Nigrán;17619;8660;8959;2015
36;Pontevedra;036;Oia;3008;1511;1497;2015
36;Pontevedra;037;Pazos de Borbén;3067;1494;1573;2015
36;Pontevedra;041;Poio;16842;8326;8516;2015
36;Pontevedra;043;Ponte Caldelas;5540;2691;2849;2015
36;Pontevedra;042;Ponteareas;22990;11214;11776;2015
36;Pontevedra;044;Pontecesures;3062;1532;1530;2015
36;Pontevedra;038;Pontevedra;82539;39074;43465;2015
36;Pontevedra;039;Porriño, O;18898;9296;9602;2015
36;Pontevedra;040;Portas;3061;1467;1594;2015
36;Pontevedra;045;Redondela;29697;14516;15181;2015
36;Pontevedra;046;Ribadumia;5087;2457;2630;2015
36;Pontevedra;047;Rodeiro;2700;1371;1329;2015
36;Pontevedra;048;Rosal, O;6406;3154;3252;2015
36;Pontevedra;049;Salceda de Caselas;8873;4433;4440;2015
36;Pontevedra;050;Salvaterra de Miño;9619;4796;4823;2015
36;Pontevedra;051;Sanxenxo;17391;8613;8778;2015
36;Pontevedra;052;Silleda;8772;4254;4518;2015
36;Pontevedra;053;Soutomaior;7317;3640;3677;2015
36;Pontevedra;054;Tomiño;13662;6856;6806;2015
36;Pontevedra;055;Tui;17013;8169;8844;2015
36;Pontevedra;056;Valga;6062;2965;3097;2015
36;Pontevedra;057;Vigo;294098;139688;154410;2015
36;Pontevedra;059;Vila de Cruces;5556;2711;2845;2015
36;Pontevedra;058;Vilaboa;6059;2934;3125;2015
36;Pontevedra;060;Vilagarcía de Arousa;37482;17978;19504;2015
36;Pontevedra;061;Vilanova de Arousa;10422;5105;5317;2015
26;Rioja, La;001;Ábalos;252;150;102;2015
26;Rioja, La;002;Agoncillo;1123;634;489;2015
26;Rioja, La;003;Aguilar del Río Alhama;509;252;257;2015
26;Rioja, La;004;Ajamil de Cameros;71;47;24;2015
26;Rioja, La;005;Albelda de Iregua;3284;1686;1598;2015
26;Rioja, La;006;Alberite;2456;1237;1219;2015
26;Rioja, La;007;Alcanadre;710;377;333;2015
26;Rioja, La;008;Aldeanueva de Ebro;2779;1444;1335;2015
26;Rioja, La;009;Alesanco;505;268;237;2015
26;Rioja, La;010;Alesón;124;74;50;2015
26;Rioja, La;011;Alfaro;9568;4828;4740;2015
26;Rioja, La;012;Almarza de Cameros;22;14;8;2015
26;Rioja, La;013;Anguciana;453;247;206;2015
26;Rioja, La;014;Anguiano;537;303;234;2015
26;Rioja, La;015;Arenzana de Abajo;232;121;111;2015
26;Rioja, La;016;Arenzana de Arriba;33;21;12;2015
26;Rioja, La;017;Arnedillo;468;234;234;2015
26;Rioja, La;018;Arnedo;14597;7222;7375;2015
26;Rioja, La;019;Arrúbal;481;257;224;2015
26;Rioja, La;020;Ausejo;796;424;372;2015
26;Rioja, La;021;Autol;4427;2215;2212;2015
26;Rioja, La;022;Azofra;205;108;97;2015
26;Rioja, La;023;Badarán;534;266;268;2015
26;Rioja, La;024;Bañares;284;144;140;2015
26;Rioja, La;026;Baños de Río Tobía;1621;810;811;2015
26;Rioja, La;025;Baños de Rioja;92;54;38;2015
26;Rioja, La;027;Berceo;172;111;61;2015
26;Rioja, La;028;Bergasa;152;84;68;2015
26;Rioja, La;029;Bergasillas Bajera;39;20;19;2015
26;Rioja, La;030;Bezares;15;8;7;2015
26;Rioja, La;031;Bobadilla;120;63;57;2015
26;Rioja, La;032;Brieva de Cameros;53;34;19;2015
26;Rioja, La;033;Briñas;210;101;109;2015
26;Rioja, La;034;Briones;835;446;389;2015
26;Rioja, La;035;Cabezón de Cameros;16;12;4;2015
26;Rioja, La;036;Calahorra;23955;11763;12192;2015
26;Rioja, La;037;Camprovín;154;87;67;2015
26;Rioja, La;038;Canales de la Sierra;97;62;35;2015
26;Rioja, La;039;Canillas de Río Tuerto;38;18;20;2015
26;Rioja, La;040;Cañas;92;47;45;2015
26;Rioja, La;041;Cárdenas;162;85;77;2015
26;Rioja, La;042;Casalarreina;1190;611;579;2015
26;Rioja, La;043;Castañares de Rioja;439;218;221;2015
26;Rioja, La;044;Castroviejo;68;40;28;2015
26;Rioja, La;045;Cellorigo;12;5;7;2015
26;Rioja, La;046;Cenicero;2028;1019;1009;2015
26;Rioja, La;047;Cervera del Río Alhama;2427;1230;1197;2015
26;Rioja, La;048;Cidamón;27;15;12;2015
26;Rioja, La;049;Cihuri;226;116;110;2015
26;Rioja, La;050;Cirueña;130;84;46;2015
26;Rioja, La;051;Clavijo;307;176;131;2015
26;Rioja, La;052;Cordovín;167;82;85;2015
26;Rioja, La;053;Corera;253;135;118;2015
26;Rioja, La;054;Cornago;355;202;153;2015
26;Rioja, La;055;Corporales;47;25;22;2015
26;Rioja, La;056;Cuzcurrita de Río Tirón;507;277;230;2015
26;Rioja, La;057;Daroca de Rioja;54;35;19;2015
26;Rioja, La;058;Enciso;166;103;63;2015
26;Rioja, La;059;Entrena;1489;766;723;2015
26;Rioja, La;060;Estollo;91;59;32;2015
26;Rioja, La;061;Ezcaray;2050;1071;979;2015
26;Rioja, La;062;Foncea;99;52;47;2015
26;Rioja, La;063;Fonzaleche;146;97;49;2015
26;Rioja, La;064;Fuenmayor;3146;1591;1555;2015
26;Rioja, La;065;Galbárruli;46;31;15;2015
26;Rioja, La;066;Galilea;363;185;178;2015
26;Rioja, La;067;Gallinero de Cameros;25;17;8;2015
26;Rioja, La;068;Gimileo;127;70;57;2015
26;Rioja, La;069;Grañón;279;155;124;2015
26;Rioja, La;070;Grávalos;208;108;100;2015
26;Rioja, La;071;Haro;11414;5652;5762;2015
26;Rioja, La;072;Herce;340;178;162;2015
26;Rioja, La;073;Herramélluri;109;60;49;2015
26;Rioja, La;074;Hervías;118;57;61;2015
26;Rioja, La;075;Hormilla;455;245;210;2015
26;Rioja, La;076;Hormilleja;150;74;76;2015
26;Rioja, La;077;Hornillos de Cameros;31;16;15;2015
26;Rioja, La;078;Hornos de Moncalvillo;91;56;35;2015
26;Rioja, La;079;Huércanos;852;457;395;2015
26;Rioja, La;080;Igea;612;339;273;2015
26;Rioja, La;081;Jalón de Cameros;18;10;8;2015
26;Rioja, La;082;Laguna de Cameros;128;74;54;2015
26;Rioja, La;083;Lagunilla del Jubera;327;182;145;2015
26;Rioja, La;084;Lardero;9448;4788;4660;2015
26;Rioja, La;086;Ledesma de la Cogolla;18;13;5;2015
26;Rioja, La;087;Leiva;277;142;135;2015
26;Rioja, La;088;Leza de Río Leza;38;22;16;2015
26;Rioja, La;089;Logroño;151344;72079;79265;2015
26;Rioja, La;091;Lumbreras;163;106;57;2015
26;Rioja, La;092;Manjarrés;117;71;46;2015
26;Rioja, La;093;Mansilla de la Sierra;71;49;22;2015
26;Rioja, La;094;Manzanares de Rioja;83;50;33;2015
26;Rioja, La;095;Matute;109;55;54;2015
26;Rioja, La;096;Medrano;316;168;148;2015
26;Rioja, La;098;Munilla;116;58;58;2015
26;Rioja, La;099;Murillo de Río Leza;1708;870;838;2015
26;Rioja, La;100;Muro de Aguas;58;35;23;2015
26;Rioja, La;101;Muro en Cameros;48;30;18;2015
26;Rioja, La;102;Nájera;8185;4046;4139;2015
26;Rioja, La;103;Nalda;952;510;442;2015
26;Rioja, La;104;Navajún;16;12;4;2015
26;Rioja, La;105;Navarrete;2928;1475;1453;2015
26;Rioja, La;106;Nestares;97;53;44;2015
26;Rioja, La;107;Nieva de Cameros;93;60;33;2015
26;Rioja, La;109;Ochánduri;98;59;39;2015
26;Rioja, La;108;Ocón;282;176;106;2015
26;Rioja, La;110;Ojacastro;187;108;79;2015
26;Rioja, La;111;Ollauri;281;150;131;2015
26;Rioja, La;112;Ortigosa de Cameros;260;151;109;2015
26;Rioja, La;113;Pazuengos;35;25;10;2015
26;Rioja, La;114;Pedroso;81;55;26;2015
26;Rioja, La;115;Pinillos;15;8;7;2015
26;Rioja, La;117;Pradejón;3976;2045;1931;2015
26;Rioja, La;118;Pradillo;61;31;30;2015
26;Rioja, La;119;Préjano;244;139;105;2015
26;Rioja, La;120;Quel;1996;1043;953;2015
26;Rioja, La;121;Rabanera;34;25;9;2015
26;Rioja, La;122;Rasillo de Cameros, El;151;79;72;2015
26;Rioja, La;123;Redal, El;143;80;63;2015
26;Rioja, La;124;Ribafrecha;1021;538;483;2015
26;Rioja, La;125;Rincón de Soto;3729;1897;1832;2015
26;Rioja, La;126;Robres del Castillo;31;20;11;2015
26;Rioja, La;127;Rodezno;274;154;120;2015
26;Rioja, La;128;Sajazarra;125;63;62;2015
26;Rioja, La;129;San Asensio;1183;630;553;2015
26;Rioja, La;130;San Millán de la Cogolla;244;160;84;2015
26;Rioja, La;131;San Millán de Yécora;35;24;11;2015
26;Rioja, La;132;San Román de Cameros;149;82;67;2015
26;Rioja, La;139;San Torcuato;62;34;28;2015
26;Rioja, La;142;San Vicente de la Sonsierra;1007;521;486;2015
26;Rioja, La;134;Santa Coloma;106;63;43;2015
26;Rioja, La;135;Santa Engracia del Jubera;181;112;69;2015
26;Rioja, La;136;Santa Eulalia Bajera;112;59;53;2015
26;Rioja, La;138;Santo Domingo de la Calzada;6401;3240;3161;2015
26;Rioja, La;140;Santurde de Rioja;293;154;139;2015
26;Rioja, La;141;Santurdejo;126;77;49;2015
26;Rioja, La;143;Sojuela;282;172;110;2015
26;Rioja, La;144;Sorzano;239;134;105;2015
26;Rioja, La;145;Sotés;292;169;123;2015
26;Rioja, La;146;Soto en Cameros;112;61;51;2015
26;Rioja, La;147;Terroba;33;17;16;2015
26;Rioja, La;148;Tirgo;211;106;105;2015
26;Rioja, La;149;Tobía;61;36;25;2015
26;Rioja, La;150;Tormantos;137;79;58;2015
26;Rioja, La;153;Torre en Cameros;12;10;2;2015
26;Rioja, La;151;Torrecilla en Cameros;519;277;242;2015
26;Rioja, La;152;Torrecilla sobre Alesanco;36;21;15;2015
26;Rioja, La;154;Torremontalbo;14;8;6;2015
26;Rioja, La;155;Treviana;179;93;86;2015
26;Rioja, La;157;Tricio;390;190;200;2015
26;Rioja, La;158;Tudelilla;376;204;172;2015
26;Rioja, La;160;Uruñuela;958;483;475;2015
26;Rioja, La;161;Valdemadera;8;5;3;2015
26;Rioja, La;162;Valgañón;137;86;51;2015
26;Rioja, La;163;Ventosa;172;95;77;2015
26;Rioja, La;164;Ventrosa;67;41;26;2015
26;Rioja, La;165;Viguera;437;251;186;2015
26;Rioja, La;166;Villalba de Rioja;125;78;47;2015
26;Rioja, La;167;Villalobar de Rioja;63;46;17;2015
26;Rioja, La;168;Villamediana de Iregua;7643;3863;3780;2015
26;Rioja, La;169;Villanueva de Cameros;71;41;30;2015
26;Rioja, La;170;Villar de Arnedo, El;629;323;306;2015
26;Rioja, La;171;Villar de Torre;188;111;77;2015
26;Rioja, La;172;Villarejo;31;24;7;2015
26;Rioja, La;173;Villarroya;8;4;4;2015
26;Rioja, La;174;Villarta-Quintana;155;89;66;2015
26;Rioja, La;175;Villavelayo;57;37;20;2015
26;Rioja, La;176;Villaverde de Rioja;63;35;28;2015
26;Rioja, La;177;Villoslada de Cameros;354;218;136;2015
26;Rioja, La;178;Viniegra de Abajo;86;53;33;2015
26;Rioja, La;179;Viniegra de Arriba;45;28;17;2015
26;Rioja, La;180;Zarratón;268;150;118;2015
26;Rioja, La;181;Zarzosa;15;11;4;2015
26;Rioja, La;183;Zorraquín;82;37;45;2015
37;Salamanca;001;Abusejo;213;112;101;2015
37;Salamanca;002;Agallas;157;79;78;2015
37;Salamanca;003;Ahigal de los Aceiteros;136;72;64;2015
37;Salamanca;004;Ahigal de Villarino;41;23;18;2015
37;Salamanca;005;Alameda de Gardón, La;89;47;42;2015
37;Salamanca;006;Alamedilla, La;146;74;72;2015
37;Salamanca;007;Alaraz;502;259;243;2015
37;Salamanca;008;Alba de Tormes;5309;2630;2679;2015
37;Salamanca;009;Alba de Yeltes;240;125;115;2015
37;Salamanca;010;Alberca, La;1121;557;564;2015
37;Salamanca;011;Alberguería de Argañán, La;138;69;69;2015
37;Salamanca;012;Alconada;160;85;75;2015
37;Salamanca;015;Aldea del Obispo;313;167;146;2015
37;Salamanca;013;Aldeacipreste;126;69;57;2015
37;Salamanca;014;Aldeadávila de la Ribera;1264;646;618;2015
37;Salamanca;016;Aldealengua;696;354;342;2015
37;Salamanca;017;Aldeanueva de Figueroa;291;152;139;2015
37;Salamanca;018;Aldeanueva de la Sierra;108;59;49;2015
37;Salamanca;019;Aldearrodrigo;155;80;75;2015
37;Salamanca;020;Aldearrubia;489;270;219;2015
37;Salamanca;021;Aldeaseca de Alba;86;40;46;2015
37;Salamanca;022;Aldeaseca de la Frontera;295;152;143;2015
37;Salamanca;023;Aldeatejada;1724;875;849;2015
37;Salamanca;024;Aldeavieja de Tormes;107;58;49;2015
37;Salamanca;025;Aldehuela de la Bóveda;287;157;130;2015
37;Salamanca;026;Aldehuela de Yeltes;213;114;99;2015
37;Salamanca;027;Almenara de Tormes;250;143;107;2015
37;Salamanca;028;Almendra;172;96;76;2015
37;Salamanca;029;Anaya de Alba;219;127;92;2015
37;Salamanca;030;Añover de Tormes;94;51;43;2015
37;Salamanca;031;Arabayona de Mógica;396;216;180;2015
37;Salamanca;032;Arapiles;644;337;307;2015
37;Salamanca;033;Arcediano;109;59;50;2015
37;Salamanca;034;Arco, El;94;49;45;2015
37;Salamanca;035;Armenteros;281;159;122;2015
37;Salamanca;037;Atalaya, La;119;67;52;2015
37;Salamanca;038;Babilafuente;877;454;423;2015
37;Salamanca;039;Bañobárez;317;167;150;2015
37;Salamanca;040;Barbadillo;398;207;191;2015
37;Salamanca;041;Barbalos;79;42;37;2015
37;Salamanca;042;Barceo;48;28;20;2015
37;Salamanca;044;Barruecopardo;496;274;222;2015
37;Salamanca;045;Bastida, La;28;17;11;2015
37;Salamanca;046;Béjar;13724;6513;7211;2015
37;Salamanca;047;Beleña;220;104;116;2015
37;Salamanca;049;Bermellar;148;77;71;2015
37;Salamanca;050;Berrocal de Huebra;70;40;30;2015
37;Salamanca;051;Berrocal de Salvatierra;87;46;41;2015
37;Salamanca;052;Boada;298;153;145;2015
37;Salamanca;054;Bodón, El;296;153;143;2015
37;Salamanca;055;Bogajo;144;78;66;2015
37;Salamanca;056;Bouza, La;65;29;36;2015
37;Salamanca;057;Bóveda del Río Almar;242;128;114;2015
37;Salamanca;058;Brincones;60;30;30;2015
37;Salamanca;059;Buenamadre;136;74;62;2015
37;Salamanca;060;Buenavista;265;150;115;2015
37;Salamanca;061;Cabaco, El;244;124;120;2015
37;Salamanca;063;Cabeza de Béjar, La;82;48;34;2015
37;Salamanca;065;Cabeza del Caballo;349;190;159;2015
37;Salamanca;062;Cabezabellosa de la Calzada;88;49;39;2015
37;Salamanca;067;Cabrerizos;4198;2115;2083;2015
37;Salamanca;068;Cabrillas;405;205;200;2015
37;Salamanca;069;Calvarrasa de Abajo;1155;596;559;2015
37;Salamanca;070;Calvarrasa de Arriba;620;326;294;2015
37;Salamanca;071;Calzada de Béjar, La;90;49;41;2015
37;Salamanca;072;Calzada de Don Diego;185;98;87;2015
37;Salamanca;073;Calzada de Valdunciel;655;340;315;2015
37;Salamanca;074;Campillo de Azaba;173;100;73;2015
37;Salamanca;077;Campo de Peñaranda, El;278;157;121;2015
37;Salamanca;078;Candelario;930;462;468;2015
37;Salamanca;079;Canillas de Abajo;70;50;20;2015
37;Salamanca;080;Cantagallo;270;144;126;2015
37;Salamanca;081;Cantalapiedra;1027;531;496;2015
37;Salamanca;082;Cantalpino;937;508;429;2015
37;Salamanca;083;Cantaracillo;195;105;90;2015
37;Salamanca;085;Carbajosa de la Sagrada;6740;3399;3341;2015
37;Salamanca;086;Carpio de Azaba;104;61;43;2015
37;Salamanca;087;Carrascal de Barregas;1086;571;515;2015
37;Salamanca;088;Carrascal del Obispo;225;119;106;2015
37;Salamanca;089;Casafranca;72;42;30;2015
37;Salamanca;090;Casas del Conde, Las;56;31;25;2015
37;Salamanca;091;Casillas de Flores;189;95;94;2015
37;Salamanca;092;Castellanos de Moriscos;2322;1204;1118;2015
37;Salamanca;185;Castellanos de Villiquera;684;372;312;2015
37;Salamanca;096;Castillejo de Martín Viejo;238;134;104;2015
37;Salamanca;097;Castraz;37;24;13;2015
37;Salamanca;098;Cepeda;371;187;184;2015
37;Salamanca;099;Cereceda de la Sierra;79;42;37;2015
37;Salamanca;100;Cerezal de Peñahorcada;81;46;35;2015
37;Salamanca;101;Cerralbo;178;98;80;2015
37;Salamanca;102;Cerro, El;449;225;224;2015
37;Salamanca;103;Cespedosa de Tormes;534;284;250;2015
37;Salamanca;114;Chagarcía Medianero;95;49;46;2015
37;Salamanca;104;Cilleros de la Bastida;26;14;12;2015
37;Salamanca;106;Cipérez;284;144;140;2015
37;Salamanca;107;Ciudad Rodrigo;13052;6310;6742;2015
37;Salamanca;108;Coca de Alba;105;50;55;2015
37;Salamanca;109;Colmenar de Montemayor;189;105;84;2015
37;Salamanca;110;Cordovilla;132;73;59;2015
37;Salamanca;112;Cristóbal;175;99;76;2015
37;Salamanca;113;Cubo de Don Sancho, El;465;249;216;2015
37;Salamanca;115;Dios le Guarde;141;74;67;2015
37;Salamanca;116;Doñinos de Ledesma;72;35;37;2015
37;Salamanca;117;Doñinos de Salamanca;1952;1027;925;2015
37;Salamanca;118;Ejeme;137;79;58;2015
37;Salamanca;120;Encina de San Silvestre;110;58;52;2015
37;Salamanca;119;Encina, La;117;74;43;2015
37;Salamanca;121;Encinas de Abajo;666;343;323;2015
37;Salamanca;122;Encinas de Arriba;248;127;121;2015
37;Salamanca;123;Encinasola de los Comendadores;194;104;90;2015
37;Salamanca;124;Endrinal;238;129;109;2015
37;Salamanca;125;Escurial de la Sierra;254;140;114;2015
37;Salamanca;126;Espadaña;36;20;16;2015
37;Salamanca;127;Espeja;252;131;121;2015
37;Salamanca;128;Espino de la Orbada;283;153;130;2015
37;Salamanca;129;Florida de Liébana;281;153;128;2015
37;Salamanca;130;Forfoleda;187;101;86;2015
37;Salamanca;131;Frades de la Sierra;214;114;100;2015
37;Salamanca;132;Fregeneda, La;382;184;198;2015
37;Salamanca;133;Fresnedoso;108;62;46;2015
37;Salamanca;134;Fresno Alhándiga;247;135;112;2015
37;Salamanca;135;Fuente de San Esteban, La;1376;695;681;2015
37;Salamanca;136;Fuenteguinaldo;706;352;354;2015
37;Salamanca;137;Fuenteliante;110;56;54;2015
37;Salamanca;138;Fuenterroble de Salvatierra;252;130;122;2015
37;Salamanca;139;Fuentes de Béjar;254;132;122;2015
37;Salamanca;140;Fuentes de Oñoro;1070;552;518;2015
37;Salamanca;141;Gajates;166;76;90;2015
37;Salamanca;142;Galindo y Perahuy;710;408;302;2015
37;Salamanca;143;Galinduste;452;225;227;2015
37;Salamanca;144;Galisancho;395;220;175;2015
37;Salamanca;145;Gallegos de Argañán;291;152;139;2015
37;Salamanca;146;Gallegos de Solmirón;140;74;66;2015
37;Salamanca;147;Garcibuey;185;101;84;2015
37;Salamanca;148;Garcihernández;491;253;238;2015
37;Salamanca;149;Garcirrey;73;42;31;2015
37;Salamanca;150;Gejuelo del Barro;40;23;17;2015
37;Salamanca;151;Golpejas;157;81;76;2015
37;Salamanca;152;Gomecello;480;254;226;2015
37;Salamanca;154;Guadramiro;152;87;65;2015
37;Salamanca;155;Guijo de Ávila;87;52;35;2015
37;Salamanca;156;Guijuelo;5673;2827;2846;2015
37;Salamanca;157;Herguijuela de Ciudad Rodrigo;81;46;35;2015
37;Salamanca;158;Herguijuela de la Sierra;274;149;125;2015
37;Salamanca;159;Herguijuela del Campo;92;42;50;2015
37;Salamanca;160;Hinojosa de Duero;712;351;361;2015
37;Salamanca;161;Horcajo de Montemayor;159;86;73;2015
37;Salamanca;162;Horcajo Medianero;218;118;100;2015
37;Salamanca;163;Hoya, La;43;26;17;2015
37;Salamanca;164;Huerta;306;166;140;2015
37;Salamanca;165;Iruelos;39;15;24;2015
37;Salamanca;166;Ituero de Azaba;232;120;112;2015
37;Salamanca;167;Juzbado;166;88;78;2015
37;Salamanca;168;Lagunilla;507;273;234;2015
37;Salamanca;169;Larrodrigo;191;110;81;2015
37;Salamanca;170;Ledesma;1778;881;897;2015
37;Salamanca;171;Ledrada;507;256;251;2015
37;Salamanca;172;Linares de Riofrío;983;546;437;2015
37;Salamanca;173;Lumbrales;1735;875;860;2015
37;Salamanca;175;Machacón;456;240;216;2015
37;Salamanca;174;Macotera;1184;627;557;2015
37;Salamanca;176;Madroñal;159;93;66;2015
37;Salamanca;177;Maíllo, El;289;153;136;2015
37;Salamanca;178;Malpartida;100;57;43;2015
37;Salamanca;179;Mancera de Abajo;230;121;109;2015
37;Salamanca;180;Manzano, El;73;39;34;2015
37;Salamanca;181;Martiago;296;159;137;2015
37;Salamanca;183;Martín de Yeltes;447;228;219;2015
37;Salamanca;182;Martinamor;97;59;38;2015
37;Salamanca;184;Masueco;348;181;167;2015
37;Salamanca;186;Mata de Ledesma, La;109;59;50;2015
37;Salamanca;187;Matilla de los Caños del Río;633;322;311;2015
37;Salamanca;188;Maya, La;199;117;82;2015
37;Salamanca;189;Membribe de la Sierra;139;80;59;2015
37;Salamanca;190;Mieza;227;112;115;2015
37;Salamanca;191;Milano, El;111;62;49;2015
37;Salamanca;192;Miranda de Azán;423;228;195;2015
37;Salamanca;193;Miranda del Castañar;450;238;212;2015
37;Salamanca;194;Mogarraz;314;166;148;2015
37;Salamanca;195;Molinillo;57;33;24;2015
37;Salamanca;196;Monforte de la Sierra;89;48;41;2015
37;Salamanca;197;Monleón;91;53;38;2015
37;Salamanca;198;Monleras;245;116;129;2015
37;Salamanca;199;Monsagro;148;80;68;2015
37;Salamanca;200;Montejo;206;111;95;2015
37;Salamanca;201;Montemayor del Río;301;155;146;2015
37;Salamanca;202;Monterrubio de Armuña;1324;708;616;2015
37;Salamanca;203;Monterrubio de la Sierra;182;100;82;2015
37;Salamanca;204;Morasverdes;288;149;139;2015
37;Salamanca;205;Morille;252;132;120;2015
37;Salamanca;206;Moríñigo;102;55;47;2015
37;Salamanca;207;Moriscos;354;196;158;2015
37;Salamanca;208;Moronta;84;50;34;2015
37;Salamanca;209;Mozárbez;512;269;243;2015
37;Salamanca;211;Narros de Matalayegua;241;131;110;2015
37;Salamanca;213;Nava de Béjar;98;52;46;2015
37;Salamanca;214;Nava de Francia;138;73;65;2015
37;Salamanca;215;Nava de Sotrobal;170;95;75;2015
37;Salamanca;212;Navacarros;120;66;54;2015
37;Salamanca;216;Navales;341;183;158;2015
37;Salamanca;217;Navalmoral de Béjar;60;26;34;2015
37;Salamanca;218;Navamorales;73;44;29;2015
37;Salamanca;219;Navarredonda de la Rinconada;194;100;94;2015
37;Salamanca;221;Navasfrías;475;251;224;2015
37;Salamanca;222;Negrilla de Palencia;98;56;42;2015
37;Salamanca;223;Olmedo de Camaces;115;62;53;2015
37;Salamanca;224;Orbada, La;225;119;106;2015
37;Salamanca;225;Pajares de la Laguna;119;64;55;2015
37;Salamanca;226;Palacios del Arzobispo;170;86;84;2015
37;Salamanca;228;Palaciosrubios;393;210;183;2015
37;Salamanca;229;Palencia de Negrilla;172;92;80;2015
37;Salamanca;230;Parada de Arriba;265;137;128;2015
37;Salamanca;231;Parada de Rubiales;281;144;137;2015
37;Salamanca;232;Paradinas de San Juan;421;239;182;2015
37;Salamanca;233;Pastores;58;32;26;2015
37;Salamanca;234;Payo, El;404;197;207;2015
37;Salamanca;235;Pedraza de Alba;249;129;120;2015
37;Salamanca;236;Pedrosillo de Alba;152;84;68;2015
37;Salamanca;237;Pedrosillo de los Aires;385;214;171;2015
37;Salamanca;238;Pedrosillo el Ralo;143;74;69;2015
37;Salamanca;239;Pedroso de la Armuña, El;252;127;125;2015
37;Salamanca;240;Pelabravo;1126;596;530;2015
37;Salamanca;241;Pelarrodríguez;173;105;68;2015
37;Salamanca;242;Pelayos;105;63;42;2015
37;Salamanca;243;Peña, La;110;52;58;2015
37;Salamanca;244;Peñacaballera;144;69;75;2015
37;Salamanca;245;Peñaparda;375;189;186;2015
37;Salamanca;246;Peñaranda de Bracamonte;6557;3214;3343;2015
37;Salamanca;247;Peñarandilla;214;112;102;2015
37;Salamanca;248;Peralejos de Abajo;169;85;84;2015
37;Salamanca;249;Peralejos de Arriba;45;26;19;2015
37;Salamanca;250;Pereña de la Ribera;391;202;189;2015
37;Salamanca;251;Peromingo;135;64;71;2015
37;Salamanca;252;Pinedas;112;63;49;2015
37;Salamanca;253;Pino de Tormes, El;158;86;72;2015
37;Salamanca;254;Pitiegua;198;114;84;2015
37;Salamanca;255;Pizarral;56;30;26;2015
37;Salamanca;256;Poveda de las Cintas;251;142;109;2015
37;Salamanca;257;Pozos de Hinojo;53;29;24;2015
37;Salamanca;258;Puebla de Azaba;210;115;95;2015
37;Salamanca;259;Puebla de San Medel;45;26;19;2015
37;Salamanca;260;Puebla de Yeltes;153;85;68;2015
37;Salamanca;261;Puente del Congosto;240;132;108;2015
37;Salamanca;262;Puertas;84;45;39;2015
37;Salamanca;263;Puerto de Béjar;385;193;192;2015
37;Salamanca;264;Puerto Seguro;66;34;32;2015
37;Salamanca;265;Rágama;242;124;118;2015
37;Salamanca;266;Redonda, La;94;54;40;2015
37;Salamanca;267;Retortillo;227;123;104;2015
37;Salamanca;268;Rinconada de la Sierra, La;120;64;56;2015
37;Salamanca;269;Robleda;526;280;246;2015
37;Salamanca;270;Robliza de Cojos;211;108;103;2015
37;Salamanca;271;Rollán;376;203;173;2015
37;Salamanca;272;Saelices el Chico;155;79;76;2015
37;Salamanca;273;Sagrada, La;116;64;52;2015
37;Salamanca;303;Sahugo, El;188;100;88;2015
37;Salamanca;274;Salamanca;146438;66858;79580;2015
37;Salamanca;275;Saldeana;125;69;56;2015
37;Salamanca;276;Salmoral;158;99;59;2015
37;Salamanca;277;Salvatierra de Tormes;63;30;33;2015
37;Salamanca;278;San Cristóbal de la Cuesta;1017;545;472;2015
37;Salamanca;284;San Esteban de la Sierra;346;184;162;2015
37;Salamanca;285;San Felices de los Gallegos;451;229;222;2015
37;Salamanca;286;San Martín del Castañar;243;132;111;2015
37;Salamanca;287;San Miguel de Valero;355;178;177;2015
37;Salamanca;036;San Miguel del Robledo;66;34;32;2015
37;Salamanca;288;San Morales;288;159;129;2015
37;Salamanca;289;San Muñoz;277;142;135;2015
37;Salamanca;291;San Pedro de Rozados;307;166;141;2015
37;Salamanca;290;San Pedro del Valle;152;84;68;2015
37;Salamanca;292;San Pelayo de Guareña;96;50;46;2015
37;Salamanca;280;Sanchón de la Ribera;82;48;34;2015
37;Salamanca;281;Sanchón de la Sagrada;40;24;16;2015
37;Salamanca;282;Sanchotello;238;124;114;2015
37;Salamanca;279;Sancti-Spíritus;880;470;410;2015
37;Salamanca;283;Sando;136;82;54;2015
37;Salamanca;293;Santa María de Sando;124;62;62;2015
37;Salamanca;294;Santa Marta de Tormes;14970;7368;7602;2015
37;Salamanca;296;Santiago de la Puebla;366;189;177;2015
37;Salamanca;297;Santibáñez de Béjar;488;250;238;2015
37;Salamanca;298;Santibáñez de la Sierra;191;106;85;2015
37;Salamanca;299;Santiz;254;127;127;2015
37;Salamanca;300;Santos, Los;645;327;318;2015
37;Salamanca;301;Sardón de los Frailes;84;50;34;2015
37;Salamanca;302;Saucelle;324;170;154;2015
37;Salamanca;304;Sepulcro-Hilario;186;106;80;2015
37;Salamanca;305;Sequeros;239;117;122;2015
37;Salamanca;306;Serradilla del Arroyo;286;157;129;2015
37;Salamanca;307;Serradilla del Llano;171;85;86;2015
37;Salamanca;309;Sierpe, La;50;26;24;2015
37;Salamanca;310;Sieteiglesias de Tormes;214;110;104;2015
37;Salamanca;311;Sobradillo;243;119;124;2015
37;Salamanca;312;Sorihuela;270;137;133;2015
37;Salamanca;313;Sotoserrano;606;323;283;2015
37;Salamanca;314;Tabera de Abajo;115;64;51;2015
37;Salamanca;315;Tala, La;96;52;44;2015
37;Salamanca;316;Tamames;838;429;409;2015
37;Salamanca;317;Tarazona de Guareña;334;178;156;2015
37;Salamanca;318;Tardáguila;228;135;93;2015
37;Salamanca;319;Tejado, El;127;67;60;2015
37;Salamanca;320;Tejeda y Segoyuela;100;56;44;2015
37;Salamanca;321;Tenebrón;163;81;82;2015
37;Salamanca;322;Terradillos;3152;1619;1533;2015
37;Salamanca;323;Topas;552;298;254;2015
37;Salamanca;324;Tordillos;395;212;183;2015
37;Salamanca;325;Tornadizo, El;94;51;43;2015
37;Salamanca;327;Torresmenudas;195;99;96;2015
37;Salamanca;328;Trabanca;228;114;114;2015
37;Salamanca;329;Tremedal de Tormes;40;19;21;2015
37;Salamanca;330;Valdecarros;364;187;177;2015
37;Salamanca;331;Valdefuentes de Sangusín;231;129;102;2015
37;Salamanca;332;Valdehijaderos;86;46;40;2015
37;Salamanca;333;Valdelacasa;236;139;97;2015
37;Salamanca;334;Valdelageve;86;45;41;2015
37;Salamanca;335;Valdelosa;454;223;231;2015
37;Salamanca;336;Valdemierque;57;35;22;2015
37;Salamanca;337;Valderrodrigo;153;75;78;2015
37;Salamanca;338;Valdunciel;93;46;47;2015
37;Salamanca;339;Valero;309;166;143;2015
37;Salamanca;343;Vallejera de Riofrío;70;35;35;2015
37;Salamanca;340;Valsalabroso;149;87;62;2015
37;Salamanca;341;Valverde de Valdelacasa;85;50;35;2015
37;Salamanca;342;Valverdón;282;145;137;2015
37;Salamanca;344;Vecinos;273;139;134;2015
37;Salamanca;345;Vega de Tirados;181;94;87;2015
37;Salamanca;346;Veguillas, Las;288;134;154;2015
37;Salamanca;347;Vellés, La;561;306;255;2015
37;Salamanca;348;Ventosa del Río Almar;118;67;51;2015
37;Salamanca;349;Vídola, La;121;55;66;2015
37;Salamanca;351;Villaflores;293;148;145;2015
37;Salamanca;352;Villagonzalo de Tormes;216;125;91;2015
37;Salamanca;353;Villalba de los Llanos;142;80;62;2015
37;Salamanca;354;Villamayor;6962;3486;3476;2015
37;Salamanca;355;Villanueva del Conde;183;95;88;2015
37;Salamanca;356;Villar de Argañán;90;49;41;2015
37;Salamanca;357;Villar de Ciervo;298;157;141;2015
37;Salamanca;358;Villar de Gallimazo;198;122;76;2015
37;Salamanca;359;Villar de la Yegua;202;106;96;2015
37;Salamanca;360;Villar de Peralonso;259;124;135;2015
37;Salamanca;361;Villar de Samaniego;89;50;39;2015
37;Salamanca;362;Villares de la Reina;6188;3092;3096;2015
37;Salamanca;363;Villares de Yeltes;131;63;68;2015
37;Salamanca;364;Villarino de los Aires;892;461;431;2015
37;Salamanca;365;Villarmayor;200;106;94;2015
37;Salamanca;366;Villarmuerto;41;27;14;2015
37;Salamanca;367;Villasbuenas;209;114;95;2015
37;Salamanca;368;Villasdardo;17;6;11;2015
37;Salamanca;369;Villaseco de los Gamitos;152;88;64;2015
37;Salamanca;370;Villaseco de los Reyes;372;211;161;2015
37;Salamanca;371;Villasrubias;299;163;136;2015
37;Salamanca;372;Villaverde de Guareña;155;84;71;2015
37;Salamanca;373;Villavieja de Yeltes;861;447;414;2015
37;Salamanca;374;Villoria;1429;722;707;2015
37;Salamanca;375;Villoruela;836;422;414;2015
37;Salamanca;350;Vilvestre;447;218;229;2015
37;Salamanca;376;Vitigudino;2700;1326;1374;2015
37;Salamanca;377;Yecla de Yeltes;276;145;131;2015
37;Salamanca;378;Zamarra;108;60;48;2015
37;Salamanca;379;Zamayón;194;110;84;2015
37;Salamanca;380;Zarapicos;51;26;25;2015
37;Salamanca;381;Zarza de Pumareda, La;144;81;63;2015
37;Salamanca;382;Zorita de la Frontera;194;99;95;2015
38;Santa Cruz de Tenerife;001;Adeje;45405;23024;22381;2015
38;Santa Cruz de Tenerife;002;Agulo;1081;555;526;2015
38;Santa Cruz de Tenerife;003;Alajeró;2025;1072;953;2015
38;Santa Cruz de Tenerife;004;Arafo;5499;2726;2773;2015
38;Santa Cruz de Tenerife;005;Arico;7327;3825;3502;2015
38;Santa Cruz de Tenerife;006;Arona;79928;40919;39009;2015
38;Santa Cruz de Tenerife;007;Barlovento;1910;960;950;2015
38;Santa Cruz de Tenerife;008;Breña Alta;7170;3542;3628;2015
38;Santa Cruz de Tenerife;009;Breña Baja;5362;2687;2675;2015
38;Santa Cruz de Tenerife;010;Buenavista del Norte;4859;2472;2387;2015
38;Santa Cruz de Tenerife;011;Candelaria;26490;12882;13608;2015
38;Santa Cruz de Tenerife;012;Fasnia;2820;1465;1355;2015
38;Santa Cruz de Tenerife;013;Frontera;3926;1990;1936;2015
38;Santa Cruz de Tenerife;014;Fuencaliente de la Palma;1730;881;849;2015
38;Santa Cruz de Tenerife;015;Garachico;4966;2483;2483;2015
38;Santa Cruz de Tenerife;016;Garafía;1590;816;774;2015
38;Santa Cruz de Tenerife;017;Granadilla de Abona;44846;22506;22340;2015
38;Santa Cruz de Tenerife;018;Guancha, La;5433;2664;2769;2015
38;Santa Cruz de Tenerife;019;Guía de Isora;20373;10177;10196;2015
38;Santa Cruz de Tenerife;020;Güímar;18777;9285;9492;2015
38;Santa Cruz de Tenerife;021;Hermigua;1950;991;959;2015
38;Santa Cruz de Tenerife;022;Icod de los Vinos;22659;11176;11483;2015
38;Santa Cruz de Tenerife;024;Llanos de Aridane, Los;20227;9833;10394;2015
38;Santa Cruz de Tenerife;025;Matanza de Acentejo, La;8752;4387;4365;2015
38;Santa Cruz de Tenerife;026;Orotava, La;41317;20400;20917;2015
38;Santa Cruz de Tenerife;027;Paso, El;7563;3757;3806;2015
38;Santa Cruz de Tenerife;901;Pinar de El Hierro, El;1791;931;860;2015
38;Santa Cruz de Tenerife;028;Puerto de la Cruz;29412;14381;15031;2015
38;Santa Cruz de Tenerife;029;Puntagorda;2027;1031;996;2015
38;Santa Cruz de Tenerife;030;Puntallana;2372;1193;1179;2015
38;Santa Cruz de Tenerife;031;Realejos, Los;36276;17844;18432;2015
38;Santa Cruz de Tenerife;032;Rosario, El;17277;8781;8496;2015
38;Santa Cruz de Tenerife;033;San Andrés y Sauces;4265;2146;2119;2015
38;Santa Cruz de Tenerife;023;San Cristóbal de La Laguna;152843;74382;78461;2015
38;Santa Cruz de Tenerife;034;San Juan de la Rambla;4958;2475;2483;2015
38;Santa Cruz de Tenerife;035;San Miguel de Abona;17090;8619;8471;2015
38;Santa Cruz de Tenerife;036;San Sebastián de la Gomera;8591;4338;4253;2015
38;Santa Cruz de Tenerife;037;Santa Cruz de la Palma;15900;7716;8184;2015
38;Santa Cruz de Tenerife;038;Santa Cruz de Tenerife;203811;97375;106436;2015
38;Santa Cruz de Tenerife;039;Santa Úrsula;14246;7128;7118;2015
38;Santa Cruz de Tenerife;040;Santiago del Teide;10690;5311;5379;2015
38;Santa Cruz de Tenerife;041;Sauzal, El;8930;4410;4520;2015
38;Santa Cruz de Tenerife;042;Silos, Los;4805;2397;2408;2015
38;Santa Cruz de Tenerife;043;Tacoronte;23893;11908;11985;2015
38;Santa Cruz de Tenerife;044;Tanque, El;2698;1317;1381;2015
38;Santa Cruz de Tenerife;045;Tazacorte;4771;2420;2351;2015
38;Santa Cruz de Tenerife;046;Tegueste;11107;5506;5601;2015
38;Santa Cruz de Tenerife;047;Tijarafe;2596;1314;1282;2015
38;Santa Cruz de Tenerife;049;Valle Gran Rey;4223;2144;2079;2015
38;Santa Cruz de Tenerife;050;Vallehermoso;2913;1490;1423;2015
38;Santa Cruz de Tenerife;048;Valverde;4870;2483;2387;2015
38;Santa Cruz de Tenerife;051;Victoria de Acentejo, La;9026;4542;4484;2015
38;Santa Cruz de Tenerife;052;Vilaflor de Chasna;1671;856;815;2015
38;Santa Cruz de Tenerife;053;Villa de Mazo;4863;2441;2422;2015
40;Segovia;001;Abades;863;433;430;2015
40;Segovia;002;Adrada de Pirón;41;19;22;2015
40;Segovia;003;Adrados;155;83;72;2015
40;Segovia;004;Aguilafuente;639;310;329;2015
40;Segovia;005;Alconada de Maderuelo;37;23;14;2015
40;Segovia;012;Aldea Real;332;177;155;2015
40;Segovia;006;Aldealcorvo;20;13;7;2015
40;Segovia;007;Aldealengua de Pedraza;83;51;32;2015
40;Segovia;008;Aldealengua de Santa María;70;34;36;2015
40;Segovia;009;Aldeanueva de la Serrezuela;55;38;17;2015
40;Segovia;010;Aldeanueva del Codonal;134;73;61;2015
40;Segovia;013;Aldeasoña;61;36;25;2015
40;Segovia;014;Aldehorno;57;32;25;2015
40;Segovia;015;Aldehuela del Codonal;34;18;16;2015
40;Segovia;016;Aldeonte;59;27;32;2015
40;Segovia;017;Anaya;123;60;63;2015
40;Segovia;018;Añe;98;56;42;2015
40;Segovia;019;Arahuetes;41;27;14;2015
40;Segovia;020;Arcones;214;102;112;2015
40;Segovia;021;Arevalillo de Cega;30;18;12;2015
40;Segovia;022;Armuña;233;131;102;2015
40;Segovia;024;Ayllón;1268;656;612;2015
40;Segovia;025;Barbolla;200;112;88;2015
40;Segovia;026;Basardilla;137;63;74;2015
40;Segovia;028;Bercial;115;59;56;2015
40;Segovia;029;Bercimuel;32;16;16;2015
40;Segovia;030;Bernardos;547;294;253;2015
40;Segovia;031;Bernuy de Porreros;719;385;334;2015
40;Segovia;032;Boceguillas;793;407;386;2015
40;Segovia;033;Brieva;93;50;43;2015
40;Segovia;034;Caballar;96;49;47;2015
40;Segovia;035;Cabañas de Polendos;180;103;77;2015
40;Segovia;036;Cabezuela;674;344;330;2015
40;Segovia;037;Calabazas de Fuentidueña;39;22;17;2015
40;Segovia;039;Campo de San Pedro;281;156;125;2015
40;Segovia;040;Cantalejo;3693;1861;1832;2015
40;Segovia;041;Cantimpalos;1346;703;643;2015
40;Segovia;043;Carbonero el Mayor;2540;1303;1237;2015
40;Segovia;044;Carrascal del Río;150;82;68;2015
40;Segovia;045;Casla;156;87;69;2015
40;Segovia;046;Castillejo de Mesleón;143;85;58;2015
40;Segovia;047;Castro de Fuentidueña;32;20;12;2015
40;Segovia;048;Castrojimeno;38;19;19;2015
40;Segovia;049;Castroserna de Abajo;74;39;35;2015
40;Segovia;051;Castroserracín;64;34;30;2015
40;Segovia;052;Cedillo de la Torre;111;56;55;2015
40;Segovia;053;Cerezo de Abajo;148;78;70;2015
40;Segovia;054;Cerezo de Arriba;145;80;65;2015
40;Segovia;065;Chañe;887;423;464;2015
40;Segovia;055;Cilleruelo de San Mamés;39;25;14;2015
40;Segovia;056;Cobos de Fuentidueña;39;19;20;2015
40;Segovia;057;Coca;1896;952;944;2015
40;Segovia;058;Codorniz;351;179;172;2015
40;Segovia;059;Collado Hermoso;145;70;75;2015
40;Segovia;060;Condado de Castilnovo;105;60;45;2015
40;Segovia;061;Corral de Ayllón;85;50;35;2015
40;Segovia;902;Cozuelos de Fuentidueña;134;75;59;2015
40;Segovia;062;Cubillo;74;43;31;2015
40;Segovia;063;Cuéllar;9477;4773;4704;2015
40;Segovia;905;Cuevas de Provanco;140;75;65;2015
40;Segovia;068;Domingo García;28;17;11;2015
40;Segovia;069;Donhierro;102;54;48;2015
40;Segovia;070;Duruelo;181;108;73;2015
40;Segovia;071;Encinas;50;27;23;2015
40;Segovia;072;Encinillas;250;144;106;2015
40;Segovia;073;Escalona del Prado;558;295;263;2015
40;Segovia;074;Escarabajosa de Cabezas;327;176;151;2015
40;Segovia;075;Escobar de Polendos;184;97;87;2015
40;Segovia;076;Espinar, El;9486;4876;4610;2015
40;Segovia;077;Espirdo;1107;597;510;2015
40;Segovia;078;Fresneda de Cuéllar;178;101;77;2015
40;Segovia;079;Fresno de Cantespino;277;149;128;2015
40;Segovia;080;Fresno de la Fuente;94;50;44;2015
40;Segovia;081;Frumales;127;65;62;2015
40;Segovia;082;Fuente de Santa Cruz;128;67;61;2015
40;Segovia;083;Fuente el Olmo de Fuentidueña;176;65;111;2015
40;Segovia;084;Fuente el Olmo de Íscar;68;38;30;2015
40;Segovia;086;Fuentepelayo;914;479;435;2015
40;Segovia;087;Fuentepiñel;99;53;46;2015
40;Segovia;088;Fuenterrebollo;369;193;176;2015
40;Segovia;089;Fuentesaúco de Fuentidueña;249;134;115;2015
40;Segovia;091;Fuentesoto;112;60;52;2015
40;Segovia;092;Fuentidueña;144;83;61;2015
40;Segovia;093;Gallegos;94;51;43;2015
40;Segovia;094;Garcillán;453;237;216;2015
40;Segovia;095;Gomezserracín;676;348;328;2015
40;Segovia;097;Grajera;234;127;107;2015
40;Segovia;099;Honrubia de la Cuesta;65;37;28;2015
40;Segovia;100;Hontalbilla;316;167;149;2015
40;Segovia;101;Hontanares de Eresma;1301;685;616;2015
40;Segovia;103;Huertos, Los;181;107;74;2015
40;Segovia;104;Ituero y Lama;375;202;173;2015
40;Segovia;105;Juarros de Riomoros;59;35;24;2015
40;Segovia;106;Juarros de Voltoya;238;120;118;2015
40;Segovia;107;Labajos;145;80;65;2015
40;Segovia;108;Laguna de Contreras;124;69;55;2015
40;Segovia;109;Languilla;85;45;40;2015
40;Segovia;110;Lastras de Cuéllar;407;207;200;2015
40;Segovia;111;Lastras del Pozo;79;38;41;2015
40;Segovia;112;Lastrilla, La;3669;1874;1795;2015
40;Segovia;113;Losa, La;535;293;242;2015
40;Segovia;115;Maderuelo;119;63;56;2015
40;Segovia;903;Marazoleja;114;70;44;2015
40;Segovia;118;Marazuela;54;32;22;2015
40;Segovia;119;Martín Miguel;222;131;91;2015
40;Segovia;120;Martín Muñoz de la Dehesa;222;119;103;2015
40;Segovia;121;Martín Muñoz de las Posadas;337;179;158;2015
40;Segovia;122;Marugán;624;333;291;2015
40;Segovia;124;Mata de Cuéllar;280;144;136;2015
40;Segovia;123;Matabuena;193;109;84;2015
40;Segovia;125;Matilla, La;105;59;46;2015
40;Segovia;126;Melque de Cercos;91;46;45;2015
40;Segovia;127;Membibre de la Hoz;34;19;15;2015
40;Segovia;128;Migueláñez;153;83;70;2015
40;Segovia;129;Montejo de Arévalo;192;105;87;2015
40;Segovia;130;Montejo de la Vega de la Serrezuela;150;88;62;2015
40;Segovia;131;Monterrubio;62;34;28;2015
40;Segovia;132;Moral de Hornuez;71;39;32;2015
40;Segovia;134;Mozoncillo;932;499;433;2015
40;Segovia;135;Muñopedro;332;172;160;2015
40;Segovia;136;Muñoveros;159;78;81;2015
40;Segovia;138;Nava de la Asunción;2882;1447;1435;2015
40;Segovia;139;Navafría;324;173;151;2015
40;Segovia;140;Navalilla;123;64;59;2015
40;Segovia;141;Navalmanzano;1121;590;531;2015
40;Segovia;142;Navares de Ayuso;54;26;28;2015
40;Segovia;143;Navares de Enmedio;99;56;43;2015
40;Segovia;144;Navares de las Cuevas;28;18;10;2015
40;Segovia;145;Navas de Oro;1387;715;672;2015
40;Segovia;904;Navas de Riofrío;421;198;223;2015
40;Segovia;146;Navas de San Antonio;390;200;190;2015
40;Segovia;148;Nieva;300;157;143;2015
40;Segovia;149;Olombrada;605;322;283;2015
40;Segovia;150;Orejana;74;44;30;2015
40;Segovia;151;Ortigosa de Pestaño;74;38;36;2015
40;Segovia;901;Ortigosa del Monte;547;295;252;2015
40;Segovia;152;Otero de Herreros;981;502;479;2015
40;Segovia;154;Pajarejos;20;12;8;2015
40;Segovia;155;Palazuelos de Eresma;4986;2581;2405;2015
40;Segovia;156;Pedraza;416;232;184;2015
40;Segovia;157;Pelayos del Arroyo;57;34;23;2015
40;Segovia;158;Perosillo;18;13;5;2015
40;Segovia;159;Pinarejos;181;104;77;2015
40;Segovia;160;Pinarnegrillo;112;62;50;2015
40;Segovia;161;Pradales;47;26;21;2015
40;Segovia;162;Prádena;545;291;254;2015
40;Segovia;163;Puebla de Pedraza;59;34;25;2015
40;Segovia;164;Rapariegos;208;110;98;2015
40;Segovia;181;Real Sitio de San Ildefonso;5403;2666;2737;2015
40;Segovia;165;Rebollo;91;49;42;2015
40;Segovia;166;Remondo;296;148;148;2015
40;Segovia;168;Riaguas de San Bartolomé;38;22;16;2015
40;Segovia;170;Riaza;2290;1244;1046;2015
40;Segovia;171;Ribota;43;35;8;2015
40;Segovia;172;Riofrío de Riaza;53;34;19;2015
40;Segovia;173;Roda de Eresma;197;107;90;2015
40;Segovia;174;Sacramenia;429;224;205;2015
40;Segovia;176;Samboal;484;261;223;2015
40;Segovia;177;San Cristóbal de Cuéllar;159;86;73;2015
40;Segovia;178;San Cristóbal de la Vega;117;58;59;2015
40;Segovia;906;San Cristóbal de Segovia;2964;1501;1463;2015
40;Segovia;182;San Martín y Mudrián;258;129;129;2015
40;Segovia;183;San Miguel de Bernuy;154;79;75;2015
40;Segovia;184;San Pedro de Gaíllos;322;174;148;2015
40;Segovia;179;Sanchonuño;949;459;490;2015
40;Segovia;180;Sangarcía;336;184;152;2015
40;Segovia;185;Santa María la Real de Nieva;1045;554;491;2015
40;Segovia;186;Santa Marta del Cerro;42;20;22;2015
40;Segovia;188;Santiuste de Pedraza;111;67;44;2015
40;Segovia;189;Santiuste de San Juan Bautista;599;327;272;2015
40;Segovia;190;Santo Domingo de Pirón;62;38;24;2015
40;Segovia;191;Santo Tomé del Puerto;293;164;129;2015
40;Segovia;192;Sauquillo de Cabezas;186;101;85;2015
40;Segovia;193;Sebúlcor;278;145;133;2015
40;Segovia;194;Segovia;52728;25004;27724;2015
40;Segovia;195;Sepúlveda;1168;609;559;2015
40;Segovia;196;Sequera de Fresno;45;25;20;2015
40;Segovia;198;Sotillo;26;15;11;2015
40;Segovia;199;Sotosalbos;118;59;59;2015
40;Segovia;200;Tabanera la Luenga;48;22;26;2015
40;Segovia;201;Tolocirio;53;25;28;2015
40;Segovia;206;Torre Val de San Pedro;196;100;96;2015
40;Segovia;202;Torreadrada;72;32;40;2015
40;Segovia;203;Torrecaballeros;1288;642;646;2015
40;Segovia;204;Torrecilla del Pinar;219;117;102;2015
40;Segovia;205;Torreiglesias;328;170;158;2015
40;Segovia;207;Trescasas;1007;520;487;2015
40;Segovia;208;Turégano;1039;521;518;2015
40;Segovia;210;Urueñas;104;62;42;2015
40;Segovia;211;Valdeprados;80;46;34;2015
40;Segovia;212;Valdevacas de Montejo;32;15;17;2015
40;Segovia;213;Valdevacas y Guijar;107;53;54;2015
40;Segovia;218;Valle de Tabladillo;102;59;43;2015
40;Segovia;219;Vallelado;718;385;333;2015
40;Segovia;220;Valleruela de Pedraza;73;37;36;2015
40;Segovia;221;Valleruela de Sepúlveda;54;26;28;2015
40;Segovia;214;Valseca;264;147;117;2015
40;Segovia;215;Valtiendas;91;54;37;2015
40;Segovia;216;Valverde del Majano;1063;535;528;2015
40;Segovia;222;Veganzones;264;146;118;2015
40;Segovia;223;Vegas de Matute;285;166;119;2015
40;Segovia;224;Ventosilla y Tejadilla;26;17;9;2015
40;Segovia;225;Villacastín;1521;787;734;2015
40;Segovia;228;Villaverde de Íscar;623;331;292;2015
40;Segovia;229;Villaverde de Montejo;40;22;18;2015
40;Segovia;230;Villeguillo;117;71;46;2015
40;Segovia;231;Yanguas de Eresma;137;68;69;2015
40;Segovia;233;Zarzuela del Monte;548;280;268;2015
40;Segovia;234;Zarzuela del Pinar;473;247;226;2015
41;Sevilla;001;Aguadulce;2114;1043;1071;2015
41;Sevilla;002;Alanís;1820;912;908;2015
41;Sevilla;003;Albaida del Aljarafe;3110;1554;1556;2015
41;Sevilla;004;Alcalá de Guadaíra;74845;37222;37623;2015
41;Sevilla;005;Alcalá del Río;11745;5967;5778;2015
41;Sevilla;006;Alcolea del Río;3414;1712;1702;2015
41;Sevilla;007;Algaba, La;16279;8056;8223;2015
41;Sevilla;008;Algámitas;1291;675;616;2015
41;Sevilla;009;Almadén de la Plata;1480;762;718;2015
41;Sevilla;010;Almensilla;5861;2937;2924;2015
41;Sevilla;011;Arahal;19550;9683;9867;2015
41;Sevilla;012;Aznalcázar;4469;2267;2202;2015
41;Sevilla;013;Aznalcóllar;6168;3161;3007;2015
41;Sevilla;014;Badolatosa;3147;1625;1522;2015
41;Sevilla;015;Benacazón;7163;3581;3582;2015
41;Sevilla;016;Bollullos de la Mitación;10199;5139;5060;2015
41;Sevilla;017;Bormujos;21362;10603;10759;2015
41;Sevilla;018;Brenes;12697;6372;6325;2015
41;Sevilla;019;Burguillos;6420;3249;3171;2015
41;Sevilla;020;Cabezas de San Juan, Las;16514;8342;8172;2015
41;Sevilla;021;Camas;26861;13114;13747;2015
41;Sevilla;022;Campana, La;5410;2705;2705;2015
41;Sevilla;023;Cantillana;10717;5476;5241;2015
41;Sevilla;901;Cañada Rosal;3305;1634;1671;2015
41;Sevilla;024;Carmona;28656;14439;14217;2015
41;Sevilla;025;Carrión de los Céspedes;2563;1230;1333;2015
41;Sevilla;026;Casariche;5594;2853;2741;2015
41;Sevilla;027;Castilblanco de los Arroyos;4946;2492;2454;2015
41;Sevilla;028;Castilleja de Guzmán;2855;1457;1398;2015
41;Sevilla;029;Castilleja de la Cuesta;17459;8469;8990;2015
41;Sevilla;030;Castilleja del Campo;622;317;305;2015
41;Sevilla;031;Castillo de las Guardas, El;1511;764;747;2015
41;Sevilla;032;Cazalla de la Sierra;5007;2465;2542;2015
41;Sevilla;033;Constantina;6190;3072;3118;2015
41;Sevilla;034;Coria del Río;30358;15134;15224;2015
41;Sevilla;035;Coripe;1359;680;679;2015
41;Sevilla;036;Coronil, El;4946;2474;2472;2015
41;Sevilla;037;Corrales, Los;4003;2051;1952;2015
41;Sevilla;903;Cuervo de Sevilla, El;8694;4439;4255;2015
41;Sevilla;038;Dos Hermanas;131317;64762;66555;2015
41;Sevilla;039;Écija;40320;19864;20456;2015
41;Sevilla;040;Espartinas;14909;7475;7434;2015
41;Sevilla;041;Estepa;12716;6312;6404;2015
41;Sevilla;042;Fuentes de Andalucía;7190;3583;3607;2015
41;Sevilla;043;Garrobo, El;777;400;377;2015
41;Sevilla;044;Gelves;9838;4882;4956;2015
41;Sevilla;045;Gerena;7404;3746;3658;2015
41;Sevilla;046;Gilena;3861;1948;1913;2015
41;Sevilla;047;Gines;13309;6558;6751;2015
41;Sevilla;048;Guadalcanal;2744;1368;1376;2015
41;Sevilla;049;Guillena;12506;6317;6189;2015
41;Sevilla;050;Herrera;6467;3212;3255;2015
41;Sevilla;051;Huévar del Aljarafe;2791;1440;1351;2015
41;Sevilla;902;Isla Mayor;5938;2977;2961;2015
41;Sevilla;052;Lantejuela;3873;1978;1895;2015
41;Sevilla;053;Lebrija;27449;13730;13719;2015
41;Sevilla;054;Lora de Estepa;856;437;419;2015
41;Sevilla;055;Lora del Río;19328;9572;9756;2015
41;Sevilla;056;Luisiana, La;4674;2357;2317;2015
41;Sevilla;057;Madroño, El;305;151;154;2015
41;Sevilla;058;Mairena del Alcor;22749;11416;11333;2015
41;Sevilla;059;Mairena del Aljarafe;44388;21742;22646;2015
41;Sevilla;060;Marchena;19878;9945;9933;2015
41;Sevilla;061;Marinaleda;2734;1398;1336;2015
41;Sevilla;062;Martín de la Jara;2756;1423;1333;2015
41;Sevilla;063;Molares, Los;3467;1779;1688;2015
41;Sevilla;064;Montellano;7088;3549;3539;2015
41;Sevilla;065;Morón de la Frontera;28223;13945;14278;2015
41;Sevilla;066;Navas de la Concepción, Las;1639;805;834;2015
41;Sevilla;067;Olivares;9522;4795;4727;2015
41;Sevilla;068;Osuna;17801;8809;8992;2015
41;Sevilla;069;Palacios y Villafranca, Los;38157;19212;18945;2015
41;Sevilla;070;Palomares del Río;8211;4118;4093;2015
41;Sevilla;071;Paradas;7024;3509;3515;2015
41;Sevilla;072;Pedrera;5328;2632;2696;2015
41;Sevilla;073;Pedroso, El;2124;1058;1066;2015
41;Sevilla;074;Peñaflor;3721;1880;1841;2015
41;Sevilla;075;Pilas;13987;7069;6918;2015
41;Sevilla;076;Pruna;2696;1386;1310;2015
41;Sevilla;077;Puebla de Cazalla, La;11241;5599;5642;2015
41;Sevilla;078;Puebla de los Infantes, La;3100;1537;1563;2015
41;Sevilla;079;Puebla del Río, La;12114;6007;6107;2015
41;Sevilla;080;Real de la Jara, El;1581;768;813;2015
41;Sevilla;081;Rinconada, La;38180;18980;19200;2015
41;Sevilla;082;Roda de Andalucía, La;4282;2125;2157;2015
41;Sevilla;083;Ronquillo, El;1398;727;671;2015
41;Sevilla;084;Rubio, El;3524;1729;1795;2015
41;Sevilla;085;Salteras;5492;2667;2825;2015
41;Sevilla;086;San Juan de Aznalfarache;21390;10361;11029;2015
41;Sevilla;088;San Nicolás del Puerto;599;303;296;2015
41;Sevilla;087;Sanlúcar la Mayor;13451;6648;6803;2015
41;Sevilla;089;Santiponce;8453;4220;4233;2015
41;Sevilla;090;Saucejo, El;4399;2172;2227;2015
41;Sevilla;091;Sevilla;693878;329591;364287;2015
41;Sevilla;092;Tocina;9728;4809;4919;2015
41;Sevilla;093;Tomares;24743;12235;12508;2015
41;Sevilla;094;Umbrete;8606;4331;4275;2015
41;Sevilla;095;Utrera;52558;26176;26382;2015
41;Sevilla;096;Valencina de la Concepción;7948;3944;4004;2015
41;Sevilla;097;Villamanrique de la Condesa;4503;2214;2289;2015
41;Sevilla;100;Villanueva de San Juan;1232;589;643;2015
41;Sevilla;098;Villanueva del Ariscal;6395;3133;3262;2015
41;Sevilla;099;Villanueva del Río y Minas;4944;2464;2480;2015
41;Sevilla;101;Villaverde del Río;7823;3987;3836;2015
41;Sevilla;102;Viso del Alcor, El;19149;9605;9544;2015
42;Soria;001;Abejar;336;185;151;2015
42;Soria;003;Adradas;51;28;23;2015
42;Soria;004;Ágreda;3053;1549;1504;2015
42;Soria;006;Alconaba;195;125;70;2015
42;Soria;007;Alcubilla de Avellaneda;130;65;65;2015
42;Soria;008;Alcubilla de las Peñas;58;35;23;2015
42;Soria;009;Aldealafuente;93;53;40;2015
42;Soria;010;Aldealices;25;15;10;2015
42;Soria;011;Aldealpozo;20;10;10;2015
42;Soria;012;Aldealseñor;41;22;19;2015
42;Soria;013;Aldehuela de Periáñez;41;21;20;2015
42;Soria;014;Aldehuelas, Las;68;36;32;2015
42;Soria;015;Alentisque;32;18;14;2015
42;Soria;016;Aliud;17;11;6;2015
42;Soria;017;Almajano;179;92;87;2015
42;Soria;018;Almaluez;163;98;65;2015
42;Soria;019;Almarza;587;335;252;2015
42;Soria;020;Almazán;5734;2904;2830;2015
42;Soria;021;Almazul;84;49;35;2015
42;Soria;022;Almenar de Soria;240;140;100;2015
42;Soria;023;Alpanseque;70;37;33;2015
42;Soria;024;Arancón;91;58;33;2015
42;Soria;025;Arcos de Jalón;1661;892;769;2015
42;Soria;026;Arenillas;29;13;16;2015
42;Soria;027;Arévalo de la Sierra;76;48;28;2015
42;Soria;028;Ausejo de la Sierra;84;47;37;2015
42;Soria;029;Baraona;163;94;69;2015
42;Soria;030;Barca;108;65;43;2015
42;Soria;031;Barcones;25;16;9;2015
42;Soria;032;Bayubas de Abajo;157;81;76;2015
42;Soria;033;Bayubas de Arriba;52;31;21;2015
42;Soria;034;Beratón;37;20;17;2015
42;Soria;035;Berlanga de Duero;943;474;469;2015
42;Soria;036;Blacos;50;28;22;2015
42;Soria;037;Bliecos;37;22;15;2015
42;Soria;038;Borjabad;35;21;14;2015
42;Soria;039;Borobia;258;135;123;2015
42;Soria;041;Buberos;36;20;16;2015
42;Soria;042;Buitrago;60;33;27;2015
42;Soria;043;Burgo de Osma-Ciudad de Osma;5066;2532;2534;2015
42;Soria;044;Cabrejas del Campo;60;36;24;2015
42;Soria;045;Cabrejas del Pinar;376;215;161;2015
42;Soria;046;Calatañazor;55;31;24;2015
42;Soria;048;Caltojar;65;40;25;2015
42;Soria;049;Candilichera;127;74;53;2015
42;Soria;050;Cañamaque;36;26;10;2015
42;Soria;051;Carabantes;22;10;12;2015
42;Soria;052;Caracena;15;10;5;2015
42;Soria;053;Carrascosa de Abajo;28;18;10;2015
42;Soria;054;Carrascosa de la Sierra;20;14;6;2015
42;Soria;055;Casarejos;185;96;89;2015
42;Soria;056;Castilfrío de la Sierra;29;19;10;2015
42;Soria;058;Castillejo de Robledo;115;66;49;2015
42;Soria;057;Castilruiz;197;108;89;2015
42;Soria;059;Centenera de Andaluz;21;9;12;2015
42;Soria;060;Cerbón;33;22;11;2015
42;Soria;061;Cidones;333;192;141;2015
42;Soria;062;Cigudosa;28;19;9;2015
42;Soria;063;Cihuela;58;31;27;2015
42;Soria;064;Ciria;93;52;41;2015
42;Soria;065;Cirujales del Río;23;15;8;2015
42;Soria;068;Coscurita;92;54;38;2015
42;Soria;069;Covaleda;1779;908;871;2015
42;Soria;070;Cubilla;40;25;15;2015
42;Soria;071;Cubo de la Solana;193;107;86;2015
42;Soria;073;Cueva de Ágreda;77;46;31;2015
42;Soria;075;Dévanos;92;49;43;2015
42;Soria;076;Deza;242;127;115;2015
42;Soria;078;Duruelo de la Sierra;1175;606;569;2015
42;Soria;079;Escobosa de Almazán;28;19;9;2015
42;Soria;080;Espeja de San Marcelino;173;97;76;2015
42;Soria;081;Espejón;188;96;92;2015
42;Soria;082;Estepa de San Juan;7;5;2;2015
42;Soria;083;Frechilla de Almazán;24;12;12;2015
42;Soria;084;Fresno de Caracena;26;16;10;2015
42;Soria;085;Fuentearmegil;197;111;86;2015
42;Soria;086;Fuentecambrón;41;23;18;2015
42;Soria;087;Fuentecantos;53;26;27;2015
42;Soria;088;Fuentelmonge;76;43;33;2015
42;Soria;089;Fuentelsaz de Soria;59;29;30;2015
42;Soria;090;Fuentepinilla;97;60;37;2015
42;Soria;092;Fuentes de Magaña;75;42;33;2015
42;Soria;093;Fuentestrún;50;30;20;2015
42;Soria;094;Garray;702;376;326;2015
42;Soria;095;Golmayo;2484;1300;1184;2015
42;Soria;096;Gómara;335;184;151;2015
42;Soria;097;Gormaz;28;21;7;2015
42;Soria;098;Herrera de Soria;11;7;4;2015
42;Soria;100;Hinojosa del Campo;32;21;11;2015
42;Soria;103;Langa de Duero;756;408;348;2015
42;Soria;105;Liceras;57;29;28;2015
42;Soria;106;Losilla, La;16;10;6;2015
42;Soria;107;Magaña;87;51;36;2015
42;Soria;108;Maján;13;7;6;2015
42;Soria;110;Matalebreras;77;45;32;2015
42;Soria;111;Matamala de Almazán;329;178;151;2015
42;Soria;113;Medinaceli;732;363;369;2015
42;Soria;115;Miño de Medinaceli;76;48;28;2015
42;Soria;116;Miño de San Esteban;53;33;20;2015
42;Soria;117;Molinos de Duero;178;92;86;2015
42;Soria;118;Momblona;23;16;7;2015
42;Soria;119;Monteagudo de las Vicarías;218;111;107;2015
42;Soria;120;Montejo de Tiermes;174;117;57;2015
42;Soria;121;Montenegro de Cameros;70;43;27;2015
42;Soria;123;Morón de Almazán;216;113;103;2015
42;Soria;124;Muriel de la Fuente;66;37;29;2015
42;Soria;125;Muriel Viejo;98;57;41;2015
42;Soria;127;Nafría de Ucero;39;24;15;2015
42;Soria;128;Narros;42;23;19;2015
42;Soria;129;Navaleno;832;439;393;2015
42;Soria;130;Nepas;60;39;21;2015
42;Soria;131;Nolay;57;30;27;2015
42;Soria;132;Noviercas;158;84;74;2015
42;Soria;134;Ólvega;3715;1914;1801;2015
42;Soria;135;Oncala;82;46;36;2015
42;Soria;139;Pinilla del Campo;23;13;10;2015
42;Soria;140;Portillo de Soria;15;10;5;2015
42;Soria;141;Póveda de Soria, La;115;67;48;2015
42;Soria;142;Pozalmuro;68;30;38;2015
42;Soria;144;Quintana Redonda;507;286;221;2015
42;Soria;145;Quintanas de Gormaz;149;87;62;2015
42;Soria;148;Quiñonería;9;4;5;2015
42;Soria;149;Rábanos, Los;507;289;218;2015
42;Soria;151;Rebollar;39;18;21;2015
42;Soria;152;Recuerda;93;52;41;2015
42;Soria;153;Rello;17;11;6;2015
42;Soria;154;Renieblas;102;62;40;2015
42;Soria;155;Retortillo de Soria;182;106;76;2015
42;Soria;156;Reznos;33;22;11;2015
42;Soria;157;Riba de Escalote, La;16;11;5;2015
42;Soria;158;Rioseco de Soria;131;76;55;2015
42;Soria;159;Rollamienta;39;26;13;2015
42;Soria;160;Royo, El;305;163;142;2015
42;Soria;161;Salduero;155;85;70;2015
42;Soria;162;San Esteban de Gormaz;3070;1604;1466;2015
42;Soria;163;San Felices;55;34;21;2015
42;Soria;164;San Leonardo de Yagüe;2164;1100;1064;2015
42;Soria;165;San Pedro Manrique;594;330;264;2015
42;Soria;166;Santa Cruz de Yanguas;67;44;23;2015
42;Soria;167;Santa María de Huerta;319;176;143;2015
42;Soria;168;Santa María de las Hoyas;119;67;52;2015
42;Soria;171;Serón de Nágima;135;72;63;2015
42;Soria;172;Soliedra;36;20;16;2015
42;Soria;173;Soria;39168;18557;20611;2015
42;Soria;174;Sotillo del Rincón;198;103;95;2015
42;Soria;175;Suellacabras;25;15;10;2015
42;Soria;176;Tajahuerce;30;17;13;2015
42;Soria;177;Tajueco;79;45;34;2015
42;Soria;178;Talveila;133;73;60;2015
42;Soria;181;Tardelcuende;450;239;211;2015
42;Soria;182;Taroda;51;27;24;2015
42;Soria;183;Tejado;125;71;54;2015
42;Soria;184;Torlengua;71;38;33;2015
42;Soria;185;Torreblacos;26;14;12;2015
42;Soria;187;Torrubia de Soria;75;50;25;2015
42;Soria;188;Trévago;55;24;31;2015
42;Soria;189;Ucero;61;31;30;2015
42;Soria;190;Vadillo;116;66;50;2015
42;Soria;191;Valdeavellano de Tera;203;119;84;2015
42;Soria;192;Valdegeña;43;30;13;2015
42;Soria;193;Valdelagua del Cerro;14;9;5;2015
42;Soria;194;Valdemaluque;189;87;102;2015
42;Soria;195;Valdenebro;119;70;49;2015
42;Soria;196;Valdeprado;14;10;4;2015
42;Soria;197;Valderrodilla;79;43;36;2015
42;Soria;198;Valtajeros;23;13;10;2015
42;Soria;200;Velamazán;85;55;30;2015
42;Soria;201;Velilla de la Sierra;25;15;10;2015
42;Soria;202;Velilla de los Ajos;25;15;10;2015
42;Soria;204;Viana de Duero;59;43;16;2015
42;Soria;205;Villaciervos;95;61;34;2015
42;Soria;206;Villanueva de Gormaz;8;5;3;2015
42;Soria;207;Villar del Ala;51;25;26;2015
42;Soria;208;Villar del Campo;22;14;8;2015
42;Soria;209;Villar del Río;159;103;56;2015
42;Soria;211;Villares de Soria, Los;91;52;39;2015
42;Soria;212;Villasayas;78;52;26;2015
42;Soria;213;Villaseca de Arciel;38;20;18;2015
42;Soria;215;Vinuesa;938;506;432;2015
42;Soria;216;Vizmanos;27;20;7;2015
42;Soria;217;Vozmediano;37;24;13;2015
42;Soria;218;Yanguas;107;68;39;2015
42;Soria;219;Yelo;46;25;21;2015
43;Tarragona;001;Aiguamúrcia;912;486;426;2015
43;Tarragona;002;Albinyana;2320;1171;1149;2015
43;Tarragona;003;Albiol, L';448;228;220;2015
43;Tarragona;004;Alcanar;9603;4863;4740;2015
43;Tarragona;005;Alcover;5073;2535;2538;2015
43;Tarragona;904;Aldea, L';4245;2239;2006;2015
43;Tarragona;006;Aldover;918;459;459;2015
43;Tarragona;007;Aleixar, L';885;448;437;2015
43;Tarragona;008;Alfara de Carles;378;202;176;2015
43;Tarragona;009;Alforja;1883;956;927;2015
43;Tarragona;010;Alió;419;202;217;2015
43;Tarragona;011;Almoster;1410;702;708;2015
43;Tarragona;012;Altafulla;5052;2482;2570;2015
43;Tarragona;013;Ametlla de Mar, L';7183;3617;3566;2015
43;Tarragona;906;Ampolla, L';3473;1766;1707;2015
43;Tarragona;014;Amposta;20952;10564;10388;2015
43;Tarragona;016;Arboç, L';5513;2853;2660;2015
43;Tarragona;015;Arbolí;123;71;52;2015
43;Tarragona;017;Argentera, L';147;82;65;2015
43;Tarragona;018;Arnes;474;242;232;2015
43;Tarragona;019;Ascó;1682;877;805;2015
43;Tarragona;020;Banyeres del Penedès;3103;1561;1542;2015
43;Tarragona;021;Barberà de la Conca;505;267;238;2015
43;Tarragona;022;Batea;1945;966;979;2015
43;Tarragona;023;Bellmunt del Priorat;303;153;150;2015
43;Tarragona;024;Bellvei;2185;1140;1045;2015
43;Tarragona;025;Benifallet;717;356;361;2015
43;Tarragona;026;Benissanet;1251;683;568;2015
43;Tarragona;027;Bisbal de Falset, La;221;120;101;2015
43;Tarragona;028;Bisbal del Penedès, La;3474;1838;1636;2015
43;Tarragona;029;Blancafort;413;211;202;2015
43;Tarragona;030;Bonastre;641;329;312;2015
43;Tarragona;031;Borges del Camp, Les;2087;1043;1044;2015
43;Tarragona;032;Bot;618;320;298;2015
43;Tarragona;033;Botarell;1101;576;525;2015
43;Tarragona;034;Bràfim;665;334;331;2015
43;Tarragona;035;Cabacés;330;166;164;2015
43;Tarragona;036;Cabra del Camp;1109;578;531;2015
43;Tarragona;037;Calafell;24256;12191;12065;2015
43;Tarragona;903;Camarles;3476;1780;1696;2015
43;Tarragona;038;Cambrils;32915;16170;16745;2015
43;Tarragona;907;Canonja, La;5839;2891;2948;2015
43;Tarragona;039;Capafonts;111;58;53;2015
43;Tarragona;040;Capçanes;413;204;209;2015
43;Tarragona;041;Caseres;258;131;127;2015
43;Tarragona;042;Castellvell del Camp;2897;1448;1449;2015
43;Tarragona;043;Catllar, El;4215;2176;2039;2015
43;Tarragona;045;Colldejou;172;94;78;2015
43;Tarragona;046;Conesa;120;58;62;2015
43;Tarragona;047;Constantí;6416;3337;3079;2015
43;Tarragona;048;Corbera d'Ebre;1095;572;523;2015
43;Tarragona;049;Cornudella de Montsant;981;539;442;2015
43;Tarragona;050;Creixell;3492;1771;1721;2015
43;Tarragona;051;Cunit;11883;5889;5994;2015
43;Tarragona;901;Deltebre;11676;5901;5775;2015
43;Tarragona;053;Duesaigües;236;128;108;2015
43;Tarragona;054;Espluga de Francolí, L';3818;1846;1972;2015
43;Tarragona;055;Falset;2867;1435;1432;2015
43;Tarragona;056;Fatarella, La;1028;512;516;2015
43;Tarragona;057;Febró, La;39;28;11;2015
43;Tarragona;058;Figuera, La;117;66;51;2015
43;Tarragona;059;Figuerola del Camp;349;167;182;2015
43;Tarragona;060;Flix;3754;1868;1886;2015
43;Tarragona;061;Forès;51;27;24;2015
43;Tarragona;062;Freginals;399;214;185;2015
43;Tarragona;063;Galera, La;770;397;373;2015
43;Tarragona;064;Gandesa;3009;1536;1473;2015
43;Tarragona;065;Garcia;583;299;284;2015
43;Tarragona;066;Garidells, Els;188;92;96;2015
43;Tarragona;067;Ginestar;802;418;384;2015
43;Tarragona;068;Godall;632;311;321;2015
43;Tarragona;069;Gratallops;243;131;112;2015
43;Tarragona;070;Guiamets, Els;277;129;148;2015
43;Tarragona;071;Horta de Sant Joan;1217;632;585;2015
43;Tarragona;072;Lloar, El;121;66;55;2015
43;Tarragona;073;Llorac;111;61;50;2015
43;Tarragona;074;Llorenç del Penedès;2323;1152;1171;2015
43;Tarragona;076;Marçà;596;314;282;2015
43;Tarragona;075;Margalef;106;64;42;2015
43;Tarragona;077;Mas de Barberans;604;297;307;2015
43;Tarragona;078;Masdenverge;1096;565;531;2015
43;Tarragona;079;Masllorenç;501;271;230;2015
43;Tarragona;080;Masó, La;290;155;135;2015
43;Tarragona;081;Maspujols;786;403;383;2015
43;Tarragona;082;Masroig, El;511;280;231;2015
43;Tarragona;083;Milà, El;178;88;90;2015
43;Tarragona;084;Miravet;747;402;345;2015
43;Tarragona;085;Molar, El;291;156;135;2015
43;Tarragona;086;Montblanc;7283;3684;3599;2015
43;Tarragona;088;Montbrió del Camp;2693;1382;1311;2015
43;Tarragona;089;Montferri;378;207;171;2015
43;Tarragona;090;Montmell, El;1373;749;624;2015
43;Tarragona;091;Mont-ral;176;98;78;2015
43;Tarragona;092;Mont-roig del Camp;11877;6202;5675;2015
43;Tarragona;093;Móra d'Ebre;5477;2699;2778;2015
43;Tarragona;094;Móra la Nova;3185;1600;1585;2015
43;Tarragona;095;Morell, El;3524;1808;1716;2015
43;Tarragona;096;Morera de Montsant, La;147;86;61;2015
43;Tarragona;097;Nou de Gaià, La;537;264;273;2015
43;Tarragona;098;Nulles;448;233;215;2015
43;Tarragona;100;Pallaresos, Els;4547;2298;2249;2015
43;Tarragona;099;Palma d'Ebre, La;376;178;198;2015
43;Tarragona;101;Passanant i Belltall;173;100;73;2015
43;Tarragona;102;Paüls;582;285;297;2015
43;Tarragona;103;Perafort;1320;697;623;2015
43;Tarragona;104;Perelló, El;2925;1500;1425;2015
43;Tarragona;105;Piles, Les;209;112;97;2015
43;Tarragona;106;Pinell de Brai, El;1053;533;520;2015
43;Tarragona;107;Pira;494;262;232;2015
43;Tarragona;108;Pla de Santa Maria, El;2333;1212;1121;2015
43;Tarragona;109;Pobla de Mafumet, La;3675;1897;1778;2015
43;Tarragona;110;Pobla de Massaluca, La;341;182;159;2015
43;Tarragona;111;Pobla de Montornès, La;2861;1518;1343;2015
43;Tarragona;112;Poboleda;363;196;167;2015
43;Tarragona;113;Pont d'Armentera, El;545;277;268;2015
43;Tarragona;141;Pontils;121;69;52;2015
43;Tarragona;114;Porrera;448;243;205;2015
43;Tarragona;115;Pradell de la Teixeta;183;82;101;2015
43;Tarragona;116;Prades;623;319;304;2015
43;Tarragona;117;Prat de Comte;165;89;76;2015
43;Tarragona;118;Pratdip;697;368;329;2015
43;Tarragona;119;Puigpelat;1119;577;542;2015
43;Tarragona;120;Querol;563;312;251;2015
43;Tarragona;121;Rasquera;864;430;434;2015
43;Tarragona;122;Renau;151;79;72;2015
43;Tarragona;123;Reus;103194;50011;53183;2015
43;Tarragona;124;Riba, La;605;325;280;2015
43;Tarragona;125;Riba-roja d'Ebre;1172;618;554;2015
43;Tarragona;126;Riera de Gaià, La;1679;841;838;2015
43;Tarragona;127;Riudecanyes;1151;600;551;2015
43;Tarragona;128;Riudecols;1216;636;580;2015
43;Tarragona;129;Riudoms;6633;3409;3224;2015
43;Tarragona;130;Rocafort de Queralt;251;133;118;2015
43;Tarragona;131;Roda de Berà;6352;3288;3064;2015
43;Tarragona;132;Rodonyà;501;258;243;2015
43;Tarragona;133;Roquetes;8234;4246;3988;2015
43;Tarragona;134;Rourell, El;404;207;197;2015
43;Tarragona;135;Salomó;539;275;264;2015
43;Tarragona;905;Salou;26459;13863;12596;2015
43;Tarragona;136;Sant Carles de la Ràpita;14760;7259;7501;2015
43;Tarragona;137;Sant Jaume dels Domenys;2521;1299;1222;2015
43;Tarragona;902;Sant Jaume d'Enveja;3538;1801;1737;2015
43;Tarragona;138;Santa Bàrbara;3734;1904;1830;2015
43;Tarragona;139;Santa Coloma de Queralt;2850;1414;1436;2015
43;Tarragona;140;Santa Oliva;3283;1674;1609;2015
43;Tarragona;142;Sarral;1585;806;779;2015
43;Tarragona;143;Savallà del Comtat;62;31;31;2015
43;Tarragona;144;Secuita, La;1670;839;831;2015
43;Tarragona;145;Selva del Camp, La;5559;2797;2762;2015
43;Tarragona;146;Senan;47;31;16;2015
43;Tarragona;044;Sénia, La;5799;2912;2887;2015
43;Tarragona;147;Solivella;629;313;316;2015
43;Tarragona;148;Tarragona;131255;63920;67335;2015
43;Tarragona;149;Tivenys;868;443;425;2015
43;Tarragona;150;Tivissa;1751;876;875;2015
43;Tarragona;151;Torre de Fontaubella, La;129;67;62;2015
43;Tarragona;152;Torre de l'Espanyol, La;644;338;306;2015
43;Tarragona;153;Torredembarra;15371;7528;7843;2015
43;Tarragona;154;Torroja del Priorat;164;92;72;2015
43;Tarragona;155;Tortosa;33864;16964;16900;2015
43;Tarragona;156;Ulldecona;6637;3394;3243;2015
43;Tarragona;157;Ulldemolins;404;228;176;2015
43;Tarragona;158;Vallclara;109;62;47;2015
43;Tarragona;159;Vallfogona de Riucorb;95;58;37;2015
43;Tarragona;160;Vallmoll;1651;836;815;2015
43;Tarragona;161;Valls;24321;12127;12194;2015
43;Tarragona;162;Vandellòs i l'Hospitalet de l'Infant;6050;3019;3031;2015
43;Tarragona;163;Vendrell, El;36558;18229;18329;2015
43;Tarragona;164;Vespella de Gaià;425;232;193;2015
43;Tarragona;165;Vilabella;803;421;382;2015
43;Tarragona;175;Vilalba dels Arcs;669;341;328;2015
43;Tarragona;166;Vilallonga del Camp;2228;1138;1090;2015
43;Tarragona;168;Vilanova de Prades;121;61;60;2015
43;Tarragona;167;Vilanova d'Escornalbou;538;288;250;2015
43;Tarragona;169;Vilaplana;624;316;308;2015
43;Tarragona;170;Vila-rodona;1276;647;629;2015
43;Tarragona;171;Vila-seca;22332;11314;11018;2015
43;Tarragona;172;Vilaverd;469;246;223;2015
43;Tarragona;173;Vilella Alta, La;135;70;65;2015
43;Tarragona;174;Vilella Baixa, La;197;109;88;2015
43;Tarragona;176;Vimbodí i Poblet;966;542;424;2015
43;Tarragona;177;Vinebre;435;219;216;2015
43;Tarragona;178;Vinyols i els Arcs;1931;993;938;2015
43;Tarragona;052;Xerta;1209;589;620;2015
44;Teruel;001;Ababuj;73;45;28;2015
44;Teruel;002;Abejuela;54;34;20;2015
44;Teruel;003;Aguatón;19;7;12;2015
44;Teruel;004;Aguaviva;586;289;297;2015
44;Teruel;005;Aguilar del Alfambra;66;41;25;2015
44;Teruel;006;Alacón;293;151;142;2015
44;Teruel;007;Alba;210;114;96;2015
44;Teruel;008;Albalate del Arzobispo;2001;1017;984;2015
44;Teruel;009;Albarracín;1049;545;504;2015
44;Teruel;010;Albentosa;270;138;132;2015
44;Teruel;011;Alcaine;74;46;28;2015
44;Teruel;012;Alcalá de la Selva;399;220;179;2015
44;Teruel;013;Alcañiz;16230;8105;8125;2015
44;Teruel;014;Alcorisa;3374;1714;1660;2015
44;Teruel;016;Alfambra;571;295;276;2015
44;Teruel;017;Aliaga;365;202;163;2015
44;Teruel;021;Allepuz;118;56;62;2015
44;Teruel;022;Alloza;604;305;299;2015
44;Teruel;023;Allueva;27;14;13;2015
44;Teruel;018;Almohaja;20;15;5;2015
44;Teruel;019;Alobras;70;41;29;2015
44;Teruel;020;Alpeñés;21;12;9;2015
44;Teruel;024;Anadón;25;15;10;2015
44;Teruel;025;Andorra;8065;4101;3964;2015
44;Teruel;026;Arcos de las Salinas;105;56;49;2015
44;Teruel;027;Arens de Lledó;206;100;106;2015
44;Teruel;028;Argente;214;101;113;2015
44;Teruel;029;Ariño;763;386;377;2015
44;Teruel;031;Azaila;116;58;58;2015
44;Teruel;032;Bádenas;19;11;8;2015
44;Teruel;033;Báguena;327;179;148;2015
44;Teruel;034;Bañón;150;83;67;2015
44;Teruel;035;Barrachina;133;73;60;2015
44;Teruel;036;Bea;26;17;9;2015
44;Teruel;037;Beceite;566;299;267;2015
44;Teruel;039;Bello;238;113;125;2015
44;Teruel;038;Belmonte de San José;117;57;60;2015
44;Teruel;040;Berge;246;125;121;2015
44;Teruel;041;Bezas;67;37;30;2015
44;Teruel;042;Blancas;149;84;65;2015
44;Teruel;043;Blesa;109;65;44;2015
44;Teruel;044;Bordón;117;66;51;2015
44;Teruel;045;Bronchales;423;247;176;2015
44;Teruel;046;Bueña;55;27;28;2015
44;Teruel;047;Burbáguena;254;126;128;2015
44;Teruel;048;Cabra de Mora;73;43;30;2015
44;Teruel;049;Calaceite;1052;535;517;2015
44;Teruel;050;Calamocha;4417;2180;2237;2015
44;Teruel;051;Calanda;3893;1911;1982;2015
44;Teruel;052;Calomarde;87;50;37;2015
44;Teruel;053;Camañas;125;67;58;2015
44;Teruel;054;Camarena de la Sierra;123;74;49;2015
44;Teruel;055;Camarillas;99;60;39;2015
44;Teruel;056;Caminreal;659;342;317;2015
44;Teruel;059;Cantavieja;741;393;348;2015
44;Teruel;060;Cañada de Benatanduz;41;27;14;2015
44;Teruel;061;Cañada de Verich, La;102;61;41;2015
44;Teruel;062;Cañada Vellida;36;26;10;2015
44;Teruel;063;Cañizar del Olivar;103;56;47;2015
44;Teruel;064;Cascante del Río;80;49;31;2015
44;Teruel;065;Castejón de Tornos;60;38;22;2015
44;Teruel;066;Castel de Cabra;122;65;57;2015
44;Teruel;070;Castellar, El;58;37;21;2015
44;Teruel;071;Castellote;728;380;348;2015
44;Teruel;067;Castelnou;142;71;71;2015
44;Teruel;068;Castelserás;840;443;397;2015
44;Teruel;074;Cedrillas;619;315;304;2015
44;Teruel;075;Celadas;398;222;176;2015
44;Teruel;076;Cella;2776;1462;1314;2015
44;Teruel;077;Cerollera, La;106;68;38;2015
44;Teruel;080;Codoñera, La;365;189;176;2015
44;Teruel;082;Corbalán;110;60;50;2015
44;Teruel;084;Cortes de Aragón;58;27;31;2015
44;Teruel;085;Cosa;57;32;25;2015
44;Teruel;086;Cretas;573;289;284;2015
44;Teruel;087;Crivillén;74;37;37;2015
44;Teruel;088;Cuba, La;37;19;18;2015
44;Teruel;089;Cubla;54;37;17;2015
44;Teruel;090;Cucalón;104;62;42;2015
44;Teruel;092;Cuervo, El;87;47;40;2015
44;Teruel;093;Cuevas de Almudén;140;83;57;2015
44;Teruel;094;Cuevas Labradas;123;68;55;2015
44;Teruel;096;Ejulve;200;102;98;2015
44;Teruel;097;Escorihuela;158;79;79;2015
44;Teruel;099;Escucha;953;523;430;2015
44;Teruel;100;Estercuel;229;131;98;2015
44;Teruel;101;Ferreruela de Huerva;69;37;32;2015
44;Teruel;102;Fonfría;31;18;13;2015
44;Teruel;103;Formiche Alto;180;98;82;2015
44;Teruel;105;Fórnoles;86;43;43;2015
44;Teruel;106;Fortanete;203;118;85;2015
44;Teruel;107;Foz-Calanda;269;143;126;2015
44;Teruel;108;Fresneda, La;474;265;209;2015
44;Teruel;109;Frías de Albarracín;131;72;59;2015
44;Teruel;110;Fuenferrada;57;32;25;2015
44;Teruel;111;Fuentes Calientes;93;51;42;2015
44;Teruel;112;Fuentes Claras;528;294;234;2015
44;Teruel;113;Fuentes de Rubielos;121;66;55;2015
44;Teruel;114;Fuentespalda;285;143;142;2015
44;Teruel;115;Galve;167;86;81;2015
44;Teruel;116;Gargallo;103;54;49;2015
44;Teruel;117;Gea de Albarracín;387;203;184;2015
44;Teruel;118;Ginebrosa, La;203;114;89;2015
44;Teruel;119;Griegos;157;94;63;2015
44;Teruel;120;Guadalaviar;247;143;104;2015
44;Teruel;121;Gúdar;77;43;34;2015
44;Teruel;122;Híjar;1761;888;873;2015
44;Teruel;123;Hinojosa de Jarque;136;77;59;2015
44;Teruel;124;Hoz de la Vieja, La;82;44;38;2015
44;Teruel;125;Huesa del Común;73;43;30;2015
44;Teruel;126;Iglesuela del Cid, La;432;224;208;2015
44;Teruel;127;Jabaloyas;77;42;35;2015
44;Teruel;128;Jarque de la Val;78;41;37;2015
44;Teruel;129;Jatiel;48;27;21;2015
44;Teruel;130;Jorcas;41;23;18;2015
44;Teruel;131;Josa;36;21;15;2015
44;Teruel;132;Lagueruela;81;42;39;2015
44;Teruel;133;Lanzuela;29;21;8;2015
44;Teruel;135;Libros;124;76;48;2015
44;Teruel;136;Lidón;52;27;25;2015
44;Teruel;137;Linares de Mora;287;166;121;2015
44;Teruel;141;Lledó;169;90;79;2015
44;Teruel;138;Loscos;151;89;62;2015
44;Teruel;142;Maicas;36;20;16;2015
44;Teruel;143;Manzanera;510;269;241;2015
44;Teruel;144;Martín del Río;441;225;216;2015
44;Teruel;145;Mas de las Matas;1318;681;637;2015
44;Teruel;146;Mata de los Olmos, La;261;128;133;2015
44;Teruel;147;Mazaleón;534;288;246;2015
44;Teruel;148;Mezquita de Jarque;115;67;48;2015
44;Teruel;149;Mirambel;119;65;54;2015
44;Teruel;150;Miravete de la Sierra;29;20;9;2015
44;Teruel;151;Molinos;258;138;120;2015
44;Teruel;152;Monforte de Moyuela;66;47;19;2015
44;Teruel;153;Monreal del Campo;2611;1305;1306;2015
44;Teruel;154;Monroyo;360;217;143;2015
44;Teruel;155;Montalbán;1327;674;653;2015
44;Teruel;156;Monteagudo del Castillo;52;29;23;2015
44;Teruel;157;Monterde de Albarracín;69;39;30;2015
44;Teruel;158;Mora de Rubielos;1585;808;777;2015
44;Teruel;159;Moscardón;58;31;27;2015
44;Teruel;160;Mosqueruela;593;322;271;2015
44;Teruel;161;Muniesa;635;337;298;2015
44;Teruel;163;Noguera de Albarracín;151;80;71;2015
44;Teruel;164;Nogueras;29;20;9;2015
44;Teruel;165;Nogueruelas;207;113;94;2015
44;Teruel;167;Obón;48;27;21;2015
44;Teruel;168;Odón;226;118;108;2015
44;Teruel;169;Ojos Negros;413;223;190;2015
44;Teruel;171;Olba;240;137;103;2015
44;Teruel;172;Oliete;412;218;194;2015
44;Teruel;173;Olmos, Los;127;69;58;2015
44;Teruel;174;Orihuela del Tremedal;535;285;250;2015
44;Teruel;175;Orrios;137;69;68;2015
44;Teruel;176;Palomar de Arroyos;182;106;76;2015
44;Teruel;177;Pancrudo;112;68;44;2015
44;Teruel;178;Parras de Castellote, Las;59;34;25;2015
44;Teruel;179;Peñarroya de Tastavins;477;260;217;2015
44;Teruel;180;Peracense;72;41;31;2015
44;Teruel;181;Peralejos;86;45;41;2015
44;Teruel;182;Perales del Alfambra;238;127;111;2015
44;Teruel;183;Pitarque;90;45;45;2015
44;Teruel;184;Plou;52;30;22;2015
44;Teruel;185;Pobo, El;142;88;54;2015
44;Teruel;187;Portellada, La;240;121;119;2015
44;Teruel;189;Pozondón;62;33;29;2015
44;Teruel;190;Pozuel del Campo;74;39;35;2015
44;Teruel;191;Puebla de Híjar, La;947;472;475;2015
44;Teruel;192;Puebla de Valverde, La;500;269;231;2015
44;Teruel;193;Puertomingalvo;119;69;50;2015
44;Teruel;194;Ráfales;133;71;62;2015
44;Teruel;195;Rillo;97;54;43;2015
44;Teruel;196;Riodeva;163;79;84;2015
44;Teruel;197;Ródenas;66;38;28;2015
44;Teruel;198;Royuela;221;123;98;2015
44;Teruel;199;Rubiales;53;30;23;2015
44;Teruel;200;Rubielos de la Cérida;41;22;19;2015
44;Teruel;201;Rubielos de Mora;661;343;318;2015
44;Teruel;203;Salcedillo;13;10;3;2015
44;Teruel;204;Saldón;27;17;10;2015
44;Teruel;205;Samper de Calanda;854;422;432;2015
44;Teruel;206;San Agustín;141;89;52;2015
44;Teruel;207;San Martín del Río;174;89;85;2015
44;Teruel;208;Santa Cruz de Nogueras;39;20;19;2015
44;Teruel;209;Santa Eulalia;1081;542;539;2015
44;Teruel;210;Sarrión;1167;624;543;2015
44;Teruel;211;Segura de los Baños;40;25;15;2015
44;Teruel;212;Seno;43;21;22;2015
44;Teruel;213;Singra;80;45;35;2015
44;Teruel;215;Terriente;178;104;74;2015
44;Teruel;216;Teruel;35590;17054;18536;2015
44;Teruel;217;Toril y Masegoso;30;25;5;2015
44;Teruel;218;Tormón;34;20;14;2015
44;Teruel;219;Tornos;235;123;112;2015
44;Teruel;220;Torralba de los Sisones;157;86;71;2015
44;Teruel;223;Torre de Arcas;81;38;43;2015
44;Teruel;224;Torre de las Arcas;29;14;15;2015
44;Teruel;225;Torre del Compte;137;69;68;2015
44;Teruel;227;Torre los Negros;90;49;41;2015
44;Teruel;221;Torrecilla de Alcañiz;407;215;192;2015
44;Teruel;222;Torrecilla del Rebollar;144;88;56;2015
44;Teruel;226;Torrelacárcel;184;96;88;2015
44;Teruel;228;Torremocha de Jiloca;110;63;47;2015
44;Teruel;229;Torres de Albarracín;181;98;83;2015
44;Teruel;230;Torrevelilla;200;96;104;2015
44;Teruel;231;Torrijas;45;21;24;2015
44;Teruel;232;Torrijo del Campo;489;254;235;2015
44;Teruel;234;Tramacastiel;75;43;32;2015
44;Teruel;235;Tramacastilla;107;50;57;2015
44;Teruel;236;Tronchón;68;38;30;2015
44;Teruel;237;Urrea de Gaén;488;243;245;2015
44;Teruel;238;Utrillas;3110;1609;1501;2015
44;Teruel;239;Valacloche;27;16;11;2015
44;Teruel;240;Valbona;193;105;88;2015
44;Teruel;241;Valdealgorfa;664;332;332;2015
44;Teruel;243;Valdecuenca;40;26;14;2015
44;Teruel;244;Valdelinares;85;52;33;2015
44;Teruel;245;Valdeltormo;312;154;158;2015
44;Teruel;246;Valderrobres;2342;1192;1150;2015
44;Teruel;247;Valjunquera;358;184;174;2015
44;Teruel;249;Vallecillo, El;60;34;26;2015
44;Teruel;250;Veguillas de la Sierra;22;14;8;2015
44;Teruel;251;Villafranca del Campo;299;156;143;2015
44;Teruel;252;Villahermosa del Campo;103;67;36;2015
44;Teruel;256;Villanueva del Rebollar de la Sierra;51;29;22;2015
44;Teruel;257;Villar del Cobo;189;105;84;2015
44;Teruel;258;Villar del Salz;74;44;30;2015
44;Teruel;260;Villarluengo;189;114;75;2015
44;Teruel;261;Villarquemado;869;452;417;2015
44;Teruel;262;Villarroya de los Pinares;163;85;78;2015
44;Teruel;263;Villastar;526;267;259;2015
44;Teruel;264;Villel;342;199;143;2015
44;Teruel;265;Vinaceite;262;138;124;2015
44;Teruel;266;Visiedo;133;61;72;2015
44;Teruel;267;Vivel del Río Martín;83;46;37;2015
44;Teruel;268;Zoma, La;18;7;11;2015
45;Toledo;001;Ajofrín;2314;1165;1149;2015
45;Toledo;002;Alameda de la Sagra;3478;1817;1661;2015
45;Toledo;003;Albarreal de Tajo;713;372;341;2015
45;Toledo;004;Alcabón;720;386;334;2015
45;Toledo;005;Alcañizo;292;148;144;2015
45;Toledo;006;Alcaudete de la Jara;1897;956;941;2015
45;Toledo;007;Alcolea de Tajo;830;419;411;2015
45;Toledo;008;Aldea en Cabo;184;95;89;2015
45;Toledo;009;Aldeanueva de Barbarroya;612;305;307;2015
45;Toledo;010;Aldeanueva de San Bartolomé;475;243;232;2015
45;Toledo;011;Almendral de la Cañada;339;180;159;2015
45;Toledo;012;Almonacid de Toledo;865;427;438;2015
45;Toledo;013;Almorox;2248;1186;1062;2015
45;Toledo;014;Añover de Tajo;5191;2662;2529;2015
45;Toledo;015;Arcicóllar;833;409;424;2015
45;Toledo;016;Argés;6000;3018;2982;2015
45;Toledo;017;Azután;291;145;146;2015
45;Toledo;018;Barcience;747;397;350;2015
45;Toledo;019;Bargas;10008;4983;5025;2015
45;Toledo;020;Belvís de la Jara;1663;825;838;2015
45;Toledo;021;Borox;3605;1879;1726;2015
45;Toledo;022;Buenaventura;445;234;211;2015
45;Toledo;023;Burguillos de Toledo;3028;1532;1496;2015
45;Toledo;024;Burujón;1399;732;667;2015
45;Toledo;025;Cabañas de la Sagra;1760;926;834;2015
45;Toledo;026;Cabañas de Yepes;272;142;130;2015
45;Toledo;027;Cabezamesada;433;234;199;2015
45;Toledo;028;Calera y Chozas;4691;2384;2307;2015
45;Toledo;029;Caleruela;234;124;110;2015
45;Toledo;030;Calzada de Oropesa;564;302;262;2015
45;Toledo;031;Camarena;3776;1972;1804;2015
45;Toledo;032;Camarenilla;553;283;270;2015
45;Toledo;033;Campillo de la Jara, El;405;208;197;2015
45;Toledo;034;Camuñas;1824;937;887;2015
45;Toledo;035;Cardiel de los Montes;372;199;173;2015
45;Toledo;036;Carmena;785;403;382;2015
45;Toledo;037;Carpio de Tajo, El;2038;1013;1025;2015
45;Toledo;038;Carranque;4545;2357;2188;2015
45;Toledo;039;Carriches;294;153;141;2015
45;Toledo;040;Casar de Escalona, El;1986;1059;927;2015
45;Toledo;041;Casarrubios del Monte;5319;2806;2513;2015
45;Toledo;042;Casasbuenas;208;104;104;2015
45;Toledo;043;Castillo de Bayuela;978;502;476;2015
45;Toledo;045;Cazalegas;1730;883;847;2015
45;Toledo;046;Cebolla;3527;1789;1738;2015
45;Toledo;047;Cedillo del Condado;3604;1896;1708;2015
45;Toledo;048;Cerralbos, Los;434;232;202;2015
45;Toledo;049;Cervera de los Montes;521;267;254;2015
45;Toledo;056;Chozas de Canales;3763;1968;1795;2015
45;Toledo;057;Chueca;269;146;123;2015
45;Toledo;050;Ciruelos;564;304;260;2015
45;Toledo;051;Cobeja;2196;1139;1057;2015
45;Toledo;052;Cobisa;4154;2079;2075;2015
45;Toledo;053;Consuegra;10437;5258;5179;2015
45;Toledo;054;Corral de Almaguer;5677;2886;2791;2015
45;Toledo;055;Cuerva;1400;725;675;2015
45;Toledo;058;Domingo Pérez;461;231;230;2015
45;Toledo;059;Dosbarrios;2255;1149;1106;2015
45;Toledo;060;Erustes;225;120;105;2015
45;Toledo;061;Escalona;3306;1697;1609;2015
45;Toledo;062;Escalonilla;1470;725;745;2015
45;Toledo;063;Espinoso del Rey;507;280;227;2015
45;Toledo;064;Esquivias;5389;2725;2664;2015
45;Toledo;065;Estrella, La;260;133;127;2015
45;Toledo;066;Fuensalida;11068;5638;5430;2015
45;Toledo;067;Gálvez;3187;1608;1579;2015
45;Toledo;068;Garciotum;197;100;97;2015
45;Toledo;069;Gerindote;2427;1261;1166;2015
45;Toledo;070;Guadamur;1864;933;931;2015
45;Toledo;071;Guardia, La;2329;1170;1159;2015
45;Toledo;072;Herencias, Las;823;440;383;2015
45;Toledo;073;Herreruela de Oropesa;357;177;180;2015
45;Toledo;074;Hinojosa de San Vicente;413;227;186;2015
45;Toledo;075;Hontanar;156;93;63;2015
45;Toledo;076;Hormigos;741;409;332;2015
45;Toledo;077;Huecas;661;345;316;2015
45;Toledo;078;Huerta de Valdecarábanos;1798;888;910;2015
45;Toledo;079;Iglesuela, La;430;230;200;2015
45;Toledo;080;Illán de Vacas;6;4;2;2015
45;Toledo;081;Illescas;25964;13205;12759;2015
45;Toledo;082;Lagartera;1503;757;746;2015
45;Toledo;083;Layos;644;328;316;2015
45;Toledo;084;Lillo;2813;1454;1359;2015
45;Toledo;085;Lominchar;2342;1226;1116;2015
45;Toledo;086;Lucillos;613;318;295;2015
45;Toledo;087;Madridejos;10876;5473;5403;2015
45;Toledo;088;Magán;3202;1659;1543;2015
45;Toledo;089;Malpica de Tajo;1861;950;911;2015
45;Toledo;090;Manzaneque;391;191;200;2015
45;Toledo;091;Maqueda;476;242;234;2015
45;Toledo;092;Marjaliza;278;138;140;2015
45;Toledo;093;Marrupe;170;90;80;2015
45;Toledo;094;Mascaraque;479;244;235;2015
45;Toledo;095;Mata, La;917;459;458;2015
45;Toledo;096;Mazarambroz;1287;665;622;2015
45;Toledo;097;Mejorada;1294;667;627;2015
45;Toledo;098;Menasalbas;2814;1472;1342;2015
45;Toledo;099;Méntrida;4984;2576;2408;2015
45;Toledo;100;Mesegar de Tajo;228;116;112;2015
45;Toledo;101;Miguel Esteban;5080;2534;2546;2015
45;Toledo;102;Mocejón;4874;2466;2408;2015
45;Toledo;103;Mohedas de la Jara;453;248;205;2015
45;Toledo;104;Montearagón;554;288;266;2015
45;Toledo;105;Montesclaros;440;236;204;2015
45;Toledo;106;Mora;10077;5080;4997;2015
45;Toledo;107;Nambroca;4442;2271;2171;2015
45;Toledo;108;Nava de Ricomalillo, La;597;303;294;2015
45;Toledo;109;Navahermosa;3878;2009;1869;2015
45;Toledo;110;Navalcán;2166;1160;1006;2015
45;Toledo;111;Navalmoralejo;70;35;35;2015
45;Toledo;112;Navalmorales, Los;2757;1448;1309;2015
45;Toledo;113;Navalucillos, Los;2357;1216;1141;2015
45;Toledo;114;Navamorcuende;668;342;326;2015
45;Toledo;115;Noblejas;3534;1808;1726;2015
45;Toledo;116;Noez;926;473;453;2015
45;Toledo;117;Nombela;946;487;459;2015
45;Toledo;118;Novés;2727;1408;1319;2015
45;Toledo;119;Numancia de la Sagra;4763;2501;2262;2015
45;Toledo;120;Nuño Gómez;154;80;74;2015
45;Toledo;121;Ocaña;10795;5506;5289;2015
45;Toledo;122;Olías del Rey;7229;3682;3547;2015
45;Toledo;123;Ontígola;4232;2257;1975;2015
45;Toledo;124;Orgaz;2738;1367;1371;2015
45;Toledo;125;Oropesa;2771;1361;1410;2015
45;Toledo;126;Otero;371;189;182;2015
45;Toledo;127;Palomeque;902;488;414;2015
45;Toledo;128;Pantoja;3409;1719;1690;2015
45;Toledo;129;Paredes de Escalona;142;69;73;2015
45;Toledo;130;Parrillas;375;194;181;2015
45;Toledo;131;Pelahustán;349;191;158;2015
45;Toledo;132;Pepino;2714;1421;1293;2015
45;Toledo;133;Polán;3851;1932;1919;2015
45;Toledo;134;Portillo de Toledo;2187;1086;1101;2015
45;Toledo;135;Puebla de Almoradiel, La;5546;2812;2734;2015
45;Toledo;136;Puebla de Montalbán, La;8063;4088;3975;2015
45;Toledo;137;Pueblanueva, La;2304;1158;1146;2015
45;Toledo;138;Puente del Arzobispo, El;1337;651;686;2015
45;Toledo;139;Puerto de San Vicente;192;96;96;2015
45;Toledo;140;Pulgar;1603;831;772;2015
45;Toledo;141;Quero;1084;553;531;2015
45;Toledo;142;Quintanar de la Orden;11604;5826;5778;2015
45;Toledo;143;Quismondo;1568;795;773;2015
45;Toledo;144;Real de San Vicente, El;1031;547;484;2015
45;Toledo;145;Recas;4311;2387;1924;2015
45;Toledo;146;Retamoso de la Jara;106;53;53;2015
45;Toledo;147;Rielves;760;385;375;2015
45;Toledo;148;Robledo del Mazo;327;186;141;2015
45;Toledo;149;Romeral, El;706;351;355;2015
45;Toledo;150;San Bartolomé de las Abiertas;524;278;246;2015
45;Toledo;151;San Martín de Montalbán;800;401;399;2015
45;Toledo;152;San Martín de Pusa;741;390;351;2015
45;Toledo;153;San Pablo de los Montes;1910;960;950;2015
45;Toledo;154;San Román de los Montes;1855;990;865;2015
45;Toledo;155;Santa Ana de Pusa;449;250;199;2015
45;Toledo;156;Santa Cruz de la Zarza;4426;2234;2192;2015
45;Toledo;157;Santa Cruz del Retamar;2901;1504;1397;2015
45;Toledo;158;Santa Olalla;3277;1664;1613;2015
45;Toledo;901;Santo Domingo-Caudilla;1021;540;481;2015
45;Toledo;159;Sartajada;102;59;43;2015
45;Toledo;160;Segurilla;1318;676;642;2015
45;Toledo;161;Seseña;21558;11237;10321;2015
45;Toledo;162;Sevilleja de la Jara;751;403;348;2015
45;Toledo;163;Sonseca;11289;5709;5580;2015
45;Toledo;164;Sotillo de las Palomas;213;118;95;2015
45;Toledo;165;Talavera de la Reina;85150;41166;43984;2015
45;Toledo;166;Tembleque;2149;1095;1054;2015
45;Toledo;167;Toboso, El;1964;992;972;2015
45;Toledo;168;Toledo;83226;39859;43367;2015
45;Toledo;169;Torralba de Oropesa;227;119;108;2015
45;Toledo;171;Torre de Esteban Hambrán, La;1770;914;856;2015
45;Toledo;170;Torrecilla de la Jara;262;136;126;2015
45;Toledo;172;Torrico;827;420;407;2015
45;Toledo;173;Torrijos;13273;6554;6719;2015
45;Toledo;174;Totanés;386;199;187;2015
45;Toledo;175;Turleque;818;417;401;2015
45;Toledo;176;Ugena;5282;2727;2555;2015
45;Toledo;177;Urda;2830;1413;1417;2015
45;Toledo;179;Valdeverdeja;647;311;336;2015
45;Toledo;180;Valmojado;4079;2077;2002;2015
45;Toledo;181;Velada;2893;1501;1392;2015
45;Toledo;182;Ventas con Peña Aguilera, Las;1206;622;584;2015
45;Toledo;183;Ventas de Retamosa, Las;3382;1777;1605;2015
45;Toledo;184;Ventas de San Julián, Las;238;112;126;2015
45;Toledo;186;Villa de Don Fadrique, La;3918;1937;1981;2015
45;Toledo;185;Villacañas;10070;5004;5066;2015
45;Toledo;187;Villafranca de los Caballeros;5196;2586;2610;2015
45;Toledo;188;Villaluenga de la Sagra;3857;1914;1943;2015
45;Toledo;189;Villamiel de Toledo;872;464;408;2015
45;Toledo;190;Villaminaya;559;283;276;2015
45;Toledo;191;Villamuelas;671;346;325;2015
45;Toledo;192;Villanueva de Alcardete;3503;1822;1681;2015
45;Toledo;193;Villanueva de Bogas;774;397;377;2015
45;Toledo;194;Villarejo de Montalbán;81;44;37;2015
45;Toledo;195;Villarrubia de Santiago;2665;1349;1316;2015
45;Toledo;196;Villaseca de la Sagra;1808;914;894;2015
45;Toledo;197;Villasequilla;2545;1311;1234;2015
45;Toledo;198;Villatobas;2515;1291;1224;2015
45;Toledo;199;Viso de San Juan, El;4263;2283;1980;2015
45;Toledo;200;Yébenes, Los;6132;3138;2994;2015
45;Toledo;201;Yeles;5038;2698;2340;2015
45;Toledo;202;Yepes;5055;2585;2470;2015
45;Toledo;203;Yuncler;3594;1824;1770;2015
45;Toledo;204;Yunclillos;878;466;412;2015
45;Toledo;205;Yuncos;10607;5491;5116;2015
46;Valencia/València;001;Ademuz;1149;609;540;2015
46;Valencia/València;002;Ador;1374;714;660;2015
46;Valencia/València;004;Agullent;2402;1184;1218;2015
46;Valencia/València;042;Aielo de Malferit;4705;2349;2356;2015
46;Valencia/València;043;Aielo de Rugat;173;91;82;2015
46;Valencia/València;005;Alaquàs;29838;14654;15184;2015
46;Valencia/València;006;Albaida;5987;2957;3030;2015
46;Valencia/València;007;Albal;16029;8006;8023;2015
46;Valencia/València;008;Albalat de la Ribera;3467;1761;1706;2015
46;Valencia/València;009;Albalat dels Sorells;3896;1878;2018;2015
46;Valencia/València;010;Albalat dels Tarongers;1178;628;550;2015
46;Valencia/València;011;Alberic;10498;5269;5229;2015
46;Valencia/València;012;Alborache;1136;597;539;2015
46;Valencia/València;013;Alboraya;23819;11684;12135;2015
46;Valencia/València;014;Albuixech;3928;1943;1985;2015
46;Valencia/València;016;Alcàntera de Xúquer;1341;665;676;2015
46;Valencia/València;015;Alcàsser;9612;4876;4736;2015
46;Valencia/València;018;Alcublas;727;368;359;2015
46;Valencia/València;020;Alcúdia de Crespins, l';5282;2645;2637;2015
46;Valencia/València;019;Alcúdia, l';11691;5744;5947;2015
46;Valencia/València;021;Aldaia;31120;15554;15566;2015
46;Valencia/València;022;Alfafar;21125;10405;10720;2015
46;Valencia/València;024;Alfara de la Baronia;526;273;253;2015
46;Valencia/València;025;Alfara del Patriarca;3228;1590;1638;2015
46;Valencia/València;026;Alfarp;1532;791;741;2015
46;Valencia/València;027;Alfarrasí;1247;615;632;2015
46;Valencia/València;023;Alfauir;458;231;227;2015
46;Valencia/València;028;Algar de Palancia;503;253;250;2015
46;Valencia/València;029;Algemesí;27633;13714;13919;2015
46;Valencia/València;030;Algimia de Alfara;1048;517;531;2015
46;Valencia/València;031;Alginet;13144;6701;6443;2015
46;Valencia/València;032;Almàssera;7269;3548;3721;2015
46;Valencia/València;033;Almiserà;272;137;135;2015
46;Valencia/València;034;Almoines;2302;1158;1144;2015
46;Valencia/València;035;Almussafes;8759;4403;4356;2015
46;Valencia/València;036;Alpuente;679;379;300;2015
46;Valencia/València;037;Alqueria de la Comtessa, l';1504;742;762;2015
46;Valencia/València;017;Alzira;44554;21684;22870;2015
46;Valencia/València;038;Andilla;362;228;134;2015
46;Valencia/València;039;Anna;2712;1365;1347;2015
46;Valencia/València;040;Antella;1301;644;657;2015
46;Valencia/València;041;Aras de los Olmos;382;217;165;2015
46;Valencia/València;003;Atzeneta d'Albaida;1160;597;563;2015
46;Valencia/València;044;Ayora;5303;2667;2636;2015
46;Valencia/València;046;Barx;1264;658;606;2015
46;Valencia/València;045;Barxeta;1615;822;793;2015
46;Valencia/València;047;Bèlgida;683;335;348;2015
46;Valencia/València;048;Bellreguard;4623;2315;2308;2015
46;Valencia/València;049;Bellús;326;164;162;2015
46;Valencia/València;050;Benagéber;217;122;95;2015
46;Valencia/València;051;Benaguasil;10936;5574;5362;2015
46;Valencia/València;052;Benavites;626;296;330;2015
46;Valencia/València;053;Beneixida;690;327;363;2015
46;Valencia/València;054;Benetússer;14436;7061;7375;2015
46;Valencia/València;055;Beniarjó;1754;872;882;2015
46;Valencia/València;056;Beniatjar;240;119;121;2015
46;Valencia/València;057;Benicolet;612;312;300;2015
46;Valencia/València;904;Benicull de Xúquer;993;511;482;2015
46;Valencia/València;060;Benifaió;11913;5927;5986;2015
46;Valencia/València;059;Benifairó de la Valldigna;1622;802;820;2015
46;Valencia/València;058;Benifairó de les Valls;2239;1122;1117;2015
46;Valencia/València;061;Beniflá;453;228;225;2015
46;Valencia/València;062;Benigànim;6120;3102;3018;2015
46;Valencia/València;063;Benimodo;2229;1150;1079;2015
46;Valencia/València;064;Benimuslem;658;335;323;2015
46;Valencia/València;065;Beniparrell;1922;986;936;2015
46;Valencia/València;066;Benirredrà;1592;769;823;2015
46;Valencia/València;067;Benisanó;2233;1121;1112;2015
46;Valencia/València;068;Benissoda;431;237;194;2015
46;Valencia/València;069;Benisuera;191;98;93;2015
46;Valencia/València;070;Bétera;22349;11231;11118;2015
46;Valencia/València;071;Bicorp;533;271;262;2015
46;Valencia/València;072;Bocairent;4357;2190;2167;2015
46;Valencia/València;073;Bolbaite;1389;695;694;2015
46;Valencia/València;074;Bonrepòs i Mirambell;3566;1755;1811;2015
46;Valencia/València;075;Bufali;167;92;75;2015
46;Valencia/València;076;Bugarra;739;371;368;2015
46;Valencia/València;077;Buñol;9726;4876;4850;2015
46;Valencia/València;078;Burjassot;37546;18165;19381;2015
46;Valencia/València;079;Calles;391;223;168;2015
46;Valencia/València;080;Camporrobles;1322;672;650;2015
46;Valencia/València;081;Canals;13628;6835;6793;2015
46;Valencia/València;082;Canet d'En Berenguer;6426;3281;3145;2015
46;Valencia/València;083;Carcaixent;20479;10129;10350;2015
46;Valencia/València;084;Càrcer;1965;947;1018;2015
46;Valencia/València;085;Carlet;15397;7676;7721;2015
46;Valencia/València;086;Carrícola;98;51;47;2015
46;Valencia/València;087;Casas Altas;146;77;69;2015
46;Valencia/València;088;Casas Bajas;188;97;91;2015
46;Valencia/València;089;Casinos;2785;1429;1356;2015
46;Valencia/València;090;Castelló de Rugat;2287;1164;1123;2015
46;Valencia/València;091;Castellonet de la Conquesta;133;73;60;2015
46;Valencia/València;092;Castielfabib;275;139;136;2015
46;Valencia/València;093;Catadau;2761;1382;1379;2015
46;Valencia/València;094;Catarroja;27688;13727;13961;2015
46;Valencia/València;095;Caudete de las Fuentes;724;384;340;2015
46;Valencia/València;096;Cerdà;361;185;176;2015
46;Valencia/València;107;Chella;2604;1277;1327;2015
46;Valencia/València;106;Chelva;1446;751;695;2015
46;Valencia/València;108;Chera;527;283;244;2015
46;Valencia/València;109;Cheste;8459;4317;4142;2015
46;Valencia/València;111;Chiva;15004;7747;7257;2015
46;Valencia/València;112;Chulilla;676;353;323;2015
46;Valencia/València;097;Cofrentes;1097;560;537;2015
46;Valencia/València;098;Corbera;3233;1613;1620;2015
46;Valencia/València;099;Cortes de Pallás;993;532;461;2015
46;Valencia/València;100;Cotes;357;178;179;2015
46;Valencia/València;105;Cullera;22236;11070;11166;2015
46;Valencia/València;113;Daimús;3054;1529;1525;2015
46;Valencia/València;114;Domeño;718;365;353;2015
46;Valencia/València;115;Dos Aguas;443;251;192;2015
46;Valencia/València;116;Eliana, l';17436;8559;8877;2015
46;Valencia/València;117;Emperador;687;359;328;2015
46;Valencia/València;118;Enguera;5083;2535;2548;2015
46;Valencia/València;119;Ènova, l';941;483;458;2015
46;Valencia/València;120;Estivella;1380;685;695;2015
46;Valencia/València;121;Estubeny;119;59;60;2015
46;Valencia/València;122;Faura;3477;1759;1718;2015
46;Valencia/València;123;Favara;2461;1237;1224;2015
46;Valencia/València;126;Foios;7199;3528;3671;2015
46;Valencia/València;128;Font de la Figuera, la;2139;1074;1065;2015
46;Valencia/València;127;Font d'En Carròs, la;3761;1871;1890;2015
46;Valencia/València;124;Fontanars dels Alforins;1003;517;486;2015
46;Valencia/València;125;Fortaleny;1039;518;521;2015
46;Valencia/València;129;Fuenterrobles;698;379;319;2015
46;Valencia/València;131;Gandia;75514;37513;38001;2015
46;Valencia/València;902;Gátova;364;172;192;2015
46;Valencia/València;130;Gavarda;1113;530;583;2015
46;Valencia/València;132;Genovés;2821;1429;1392;2015
46;Valencia/València;133;Gestalgar;663;342;321;2015
46;Valencia/València;134;Gilet;3314;1703;1611;2015
46;Valencia/València;135;Godella;13071;6317;6754;2015
46;Valencia/València;136;Godelleta;3380;1730;1650;2015
46;Valencia/València;137;Granja de la Costera, la;331;172;159;2015
46;Valencia/València;138;Guadasséquies;466;250;216;2015
46;Valencia/València;139;Guadassuar;5927;2900;3027;2015
46;Valencia/València;140;Guardamar de la Safor;489;263;226;2015
46;Valencia/València;141;Higueruelas;516;270;246;2015
46;Valencia/València;142;Jalance;914;477;437;2015
46;Valencia/València;144;Jarafuel;808;409;399;2015
46;Valencia/València;154;Llanera de Ranes;1058;532;526;2015
46;Valencia/València;155;Llaurí;1233;616;617;2015
46;Valencia/València;147;Llíria;22745;11526;11219;2015
46;Valencia/València;152;Llocnou de la Corona;144;77;67;2015
46;Valencia/València;153;Llocnou de Sant Jeroni;527;262;265;2015
46;Valencia/València;151;Llocnou d'En Fenollet;919;481;438;2015
46;Valencia/València;156;Llombai;2765;1391;1374;2015
46;Valencia/València;157;Llosa de Ranes, la;3575;1841;1734;2015
46;Valencia/València;150;Llutxent;2422;1245;1177;2015
46;Valencia/València;148;Loriguilla;1953;1024;929;2015
46;Valencia/València;149;Losa del Obispo;502;266;236;2015
46;Valencia/València;158;Macastre;1249;645;604;2015
46;Valencia/València;159;Manises;30807;15204;15603;2015
46;Valencia/València;160;Manuel;2507;1223;1284;2015
46;Valencia/València;161;Marines;1859;963;896;2015
46;Valencia/València;162;Massalavés;1597;835;762;2015
46;Valencia/València;163;Massalfassar;2473;1232;1241;2015
46;Valencia/València;164;Massamagrell;15523;7687;7836;2015
46;Valencia/València;165;Massanassa;9264;4594;4670;2015
46;Valencia/València;166;Meliana;10588;5230;5358;2015
46;Valencia/València;167;Millares;387;192;195;2015
46;Valencia/València;168;Miramar;2620;1383;1237;2015
46;Valencia/València;169;Mislata;43320;21093;22227;2015
46;Valencia/València;170;Mogente/Moixent;4527;2281;2246;2015
46;Valencia/València;171;Moncada;21842;10777;11065;2015
46;Valencia/València;173;Montaverner;1691;850;841;2015
46;Valencia/València;174;Montesa;1257;635;622;2015
46;Valencia/València;175;Montitxelvo/Montichelvo;665;332;333;2015
46;Valencia/València;176;Montroi/Montroy;2891;1528;1363;2015
46;Valencia/València;172;Montserrat;7231;3750;3481;2015
46;Valencia/València;177;Museros;6189;3132;3057;2015
46;Valencia/València;178;Náquera;6204;3240;2964;2015
46;Valencia/València;179;Navarrés;3104;1578;1526;2015
46;Valencia/València;180;Novelé/Novetlè;856;422;434;2015
46;Valencia/València;181;Oliva;26190;12982;13208;2015
46;Valencia/València;183;Olleria, l';8369;4245;4124;2015
46;Valencia/València;182;Olocau;1670;895;775;2015
46;Valencia/València;184;Ontinyent;35621;17639;17982;2015
46;Valencia/València;185;Otos;455;233;222;2015
46;Valencia/València;186;Paiporta;24810;12371;12439;2015
46;Valencia/València;187;Palma de Gandía;1652;845;807;2015
46;Valencia/València;188;Palmera;992;529;463;2015
46;Valencia/València;189;Palomar, el;588;293;295;2015
46;Valencia/València;190;Paterna;67340;33479;33861;2015
46;Valencia/València;191;Pedralba;2859;1506;1353;2015
46;Valencia/València;192;Petrés;977;479;498;2015
46;Valencia/València;193;Picanya;11270;5536;5734;2015
46;Valencia/València;194;Picassent;20427;10324;10103;2015
46;Valencia/València;195;Piles;2740;1373;1367;2015
46;Valencia/València;196;Pinet;170;83;87;2015
46;Valencia/València;199;Pobla de Farnals, la;7776;3912;3864;2015
46;Valencia/València;202;Pobla de Vallbona, la;22994;11626;11368;2015
46;Valencia/València;200;Pobla del Duc, la;2556;1237;1319;2015
46;Valencia/València;203;Pobla Llarga, la;4536;2278;2258;2015
46;Valencia/València;197;Polinyà de Xúquer;2526;1288;1238;2015
46;Valencia/València;198;Potries;1020;502;518;2015
46;Valencia/València;205;Puçol;19357;9569;9788;2015
46;Valencia/València;201;Puebla de San Miguel;72;42;30;2015
46;Valencia/València;204;Puig de Santa Maria, el;8844;4271;4573;2015
46;Valencia/València;101;Quart de les Valls;1056;506;550;2015
46;Valencia/València;102;Quart de Poblet;24864;12217;12647;2015
46;Valencia/València;103;Quartell;1557;760;797;2015
46;Valencia/València;104;Quatretonda;2378;1201;1177;2015
46;Valencia/València;206;Quesa;690;355;335;2015
46;Valencia/València;207;Rafelbunyol;8883;4400;4483;2015
46;Valencia/València;208;Rafelcofer;1410;674;736;2015
46;Valencia/València;209;Rafelguaraf;2422;1203;1219;2015
46;Valencia/València;210;Ráfol de Salem;423;203;220;2015
46;Valencia/València;212;Real;2291;1193;1098;2015
46;Valencia/València;211;Real de Gandía;2286;1115;1171;2015
46;Valencia/València;213;Requena;20621;10316;10305;2015
46;Valencia/València;214;Riba-roja de Túria;21391;10866;10525;2015
46;Valencia/València;215;Riola;1838;932;906;2015
46;Valencia/València;216;Rocafort;6829;3359;3470;2015
46;Valencia/València;217;Rotglà i Corberà;1144;567;577;2015
46;Valencia/València;218;Rótova;1285;667;618;2015
46;Valencia/València;219;Rugat;179;91;88;2015
46;Valencia/València;220;Sagunto/Sagunt;64944;31919;33025;2015
46;Valencia/València;221;Salem;432;215;217;2015
46;Valencia/València;903;San Antonio de Benagéber;7981;3937;4044;2015
46;Valencia/València;222;Sant Joanet;476;238;238;2015
46;Valencia/València;223;Sedaví;10180;4941;5239;2015
46;Valencia/València;224;Segart;170;86;84;2015
46;Valencia/València;225;Sellent;401;209;192;2015
46;Valencia/València;226;Sempere;52;24;28;2015
46;Valencia/València;227;Senyera;1175;573;602;2015
46;Valencia/València;228;Serra;3142;1639;1503;2015
46;Valencia/València;229;Siete Aguas;1282;698;584;2015
46;Valencia/València;230;Silla;18570;9237;9333;2015
46;Valencia/València;231;Simat de la Valldigna;3362;1715;1647;2015
46;Valencia/València;232;Sinarcas;1168;595;573;2015
46;Valencia/València;233;Sollana;4941;2429;2512;2015
46;Valencia/València;234;Sot de Chera;424;213;211;2015
46;Valencia/València;235;Sueca;28252;13994;14258;2015
46;Valencia/València;236;Sumacàrcer;1168;577;591;2015
46;Valencia/València;237;Tavernes Blanques;9244;4516;4728;2015
46;Valencia/València;238;Tavernes de la Valldigna;17734;8939;8795;2015
46;Valencia/València;239;Teresa de Cofrentes;675;345;330;2015
46;Valencia/València;240;Terrateig;300;159;141;2015
46;Valencia/València;241;Titaguas;473;244;229;2015
46;Valencia/València;242;Torrebaja;435;222;213;2015
46;Valencia/València;243;Torrella;156;88;68;2015
46;Valencia/València;244;Torrent;80107;39608;40499;2015
46;Valencia/València;245;Torres Torres;642;350;292;2015
46;Valencia/València;246;Tous;1265;635;630;2015
46;Valencia/València;247;Tuéjar;1158;619;539;2015
46;Valencia/València;248;Turís;6528;3421;3107;2015
46;Valencia/València;249;Utiel;11915;5986;5929;2015
46;Valencia/València;250;Valencia;786189;375291;410898;2015
46;Valencia/València;251;Vallada;3121;1581;1540;2015
46;Valencia/València;252;Vallanca;149;81;68;2015
46;Valencia/València;253;Vallés;145;76;69;2015
46;Valencia/València;254;Venta del Moro;1376;729;647;2015
46;Valencia/València;255;Vilallonga/Villalonga;4352;2173;2179;2015
46;Valencia/València;256;Vilamarxant;9208;4761;4447;2015
46;Valencia/València;257;Villanueva de Castellón;7270;3593;3677;2015
46;Valencia/València;258;Villar del Arzobispo;3597;1811;1786;2015
46;Valencia/València;259;Villargordo del Cabriel;650;345;305;2015
46;Valencia/València;260;Vinalesa;3284;1609;1675;2015
46;Valencia/València;145;Xàtiva;29095;14202;14893;2015
46;Valencia/València;143;Xeraco;5881;3004;2877;2015
46;Valencia/València;146;Xeresa;2239;1143;1096;2015
46;Valencia/València;110;Xirivella;28963;14301;14662;2015
46;Valencia/València;261;Yátova;2117;1094;1023;2015
46;Valencia/València;262;Yesa, La;252;136;116;2015
46;Valencia/València;263;Zarra;463;252;211;2015
47;Valladolid;001;Adalia;59;36;23;2015
47;Valladolid;002;Aguasal;26;19;7;2015
47;Valladolid;003;Aguilar de Campos;284;159;125;2015
47;Valladolid;004;Alaejos;1418;753;665;2015
47;Valladolid;005;Alcazarén;693;373;320;2015
47;Valladolid;006;Aldea de San Miguel;227;117;110;2015
47;Valladolid;007;Aldeamayor de San Martín;4968;2554;2414;2015
47;Valladolid;008;Almenara de Adaja;31;13;18;2015
47;Valladolid;009;Amusquillo;109;69;40;2015
47;Valladolid;010;Arroyo de la Encomienda;18491;9342;9149;2015
47;Valladolid;011;Ataquines;596;324;272;2015
47;Valladolid;012;Bahabón;131;63;68;2015
47;Valladolid;013;Barcial de la Loma;110;58;52;2015
47;Valladolid;014;Barruelo del Valle;67;40;27;2015
47;Valladolid;015;Becilla de Valderaduey;265;151;114;2015
47;Valladolid;016;Benafarces;80;43;37;2015
47;Valladolid;017;Bercero;218;117;101;2015
47;Valladolid;018;Berceruelo;37;21;16;2015
47;Valladolid;019;Berrueces;99;52;47;2015
47;Valladolid;020;Bobadilla del Campo;311;174;137;2015
47;Valladolid;021;Bocigas;86;45;41;2015
47;Valladolid;022;Bocos de Duero;57;26;31;2015
47;Valladolid;023;Boecillo;4016;2057;1959;2015
47;Valladolid;024;Bolaños de Campos;347;185;162;2015
47;Valladolid;025;Brahojos de Medina;129;68;61;2015
47;Valladolid;026;Bustillo de Chaves;91;49;42;2015
47;Valladolid;027;Cabezón de Pisuerga;3605;1844;1761;2015
47;Valladolid;028;Cabezón de Valderaduey;35;18;17;2015
47;Valladolid;029;Cabreros del Monte;67;38;29;2015
47;Valladolid;030;Campaspero;1141;620;521;2015
47;Valladolid;031;Campillo, El;223;127;96;2015
47;Valladolid;032;Camporredondo;166;96;70;2015
47;Valladolid;033;Canalejas de Peñafiel;264;143;121;2015
47;Valladolid;034;Canillas de Esgueva;82;46;36;2015
47;Valladolid;035;Carpio;1057;567;490;2015
47;Valladolid;036;Casasola de Arión;275;155;120;2015
47;Valladolid;037;Castrejón de Trabancos;194;96;98;2015
47;Valladolid;038;Castrillo de Duero;133;74;59;2015
47;Valladolid;039;Castrillo-Tejeriego;197;108;89;2015
47;Valladolid;040;Castrobol;66;34;32;2015
47;Valladolid;041;Castrodeza;176;108;68;2015
47;Valladolid;042;Castromembibre;65;38;27;2015
47;Valladolid;043;Castromonte;321;182;139;2015
47;Valladolid;044;Castronuevo de Esgueva;393;216;177;2015
47;Valladolid;045;Castronuño;889;443;446;2015
47;Valladolid;046;Castroponce;144;82;62;2015
47;Valladolid;047;Castroverde de Cerrato;233;143;90;2015
47;Valladolid;048;Ceinos de Campos;247;136;111;2015
47;Valladolid;049;Cervillego de la Cruz;95;52;43;2015
47;Valladolid;050;Cigales;5071;2588;2483;2015
47;Valladolid;051;Ciguñuela;390;206;184;2015
47;Valladolid;052;Cistérniga;8789;4480;4309;2015
47;Valladolid;053;Cogeces de Íscar;142;74;68;2015
47;Valladolid;054;Cogeces del Monte;727;394;333;2015
47;Valladolid;055;Corcos;216;115;101;2015
47;Valladolid;056;Corrales de Duero;85;49;36;2015
47;Valladolid;057;Cubillas de Santa Marta;296;168;128;2015
47;Valladolid;058;Cuenca de Campos;243;128;115;2015
47;Valladolid;059;Curiel de Duero;111;73;38;2015
47;Valladolid;060;Encinas de Esgueva;279;158;121;2015
47;Valladolid;061;Esguevillas de Esgueva;283;152;131;2015
47;Valladolid;062;Fombellida;185;108;77;2015
47;Valladolid;063;Fompedraza;118;64;54;2015
47;Valladolid;064;Fontihoyuelo;33;20;13;2015
47;Valladolid;065;Fresno el Viejo;946;497;449;2015
47;Valladolid;066;Fuensaldaña;1518;780;738;2015
47;Valladolid;067;Fuente el Sol;181;98;83;2015
47;Valladolid;068;Fuente-Olmedo;42;19;23;2015
47;Valladolid;069;Gallegos de Hornija;137;69;68;2015
47;Valladolid;070;Gatón de Campos;44;23;21;2015
47;Valladolid;071;Geria;519;255;264;2015
47;Valladolid;073;Herrín de Campos;129;62;67;2015
47;Valladolid;074;Hornillos de Eresma;169;92;77;2015
47;Valladolid;075;Íscar;6536;3311;3225;2015
47;Valladolid;076;Laguna de Duero;22601;11294;11307;2015
47;Valladolid;077;Langayo;268;170;98;2015
47;Valladolid;079;Llano de Olmedo;67;38;29;2015
47;Valladolid;078;Lomoviejo;185;96;89;2015
47;Valladolid;080;Manzanillo;49;28;21;2015
47;Valladolid;081;Marzales;52;24;28;2015
47;Valladolid;082;Matapozuelos;1016;516;500;2015
47;Valladolid;083;Matilla de los Caños;94;52;42;2015
47;Valladolid;084;Mayorga;1689;825;864;2015
47;Valladolid;086;Medina de Rioseco;4821;2375;2446;2015
47;Valladolid;085;Medina del Campo;21110;10223;10887;2015
47;Valladolid;087;Megeces;447;234;213;2015
47;Valladolid;088;Melgar de Abajo;115;64;51;2015
47;Valladolid;089;Melgar de Arriba;181;100;81;2015
47;Valladolid;090;Mojados;3135;1632;1503;2015
47;Valladolid;091;Monasterio de Vega;90;48;42;2015
47;Valladolid;092;Montealegre de Campos;127;73;54;2015
47;Valladolid;093;Montemayor de Pililla;918;489;429;2015
47;Valladolid;094;Moral de la Reina;191;107;84;2015
47;Valladolid;095;Moraleja de las Panaderas;40;27;13;2015
47;Valladolid;096;Morales de Campos;155;83;72;2015
47;Valladolid;097;Mota del Marqués;392;200;192;2015
47;Valladolid;098;Mucientes;699;352;347;2015
47;Valladolid;099;Mudarra, La;166;86;80;2015
47;Valladolid;100;Muriel;146;77;69;2015
47;Valladolid;101;Nava del Rey;2125;1093;1032;2015
47;Valladolid;102;Nueva Villa de las Torres;316;180;136;2015
47;Valladolid;103;Olivares de Duero;317;174;143;2015
47;Valladolid;104;Olmedo;3744;1836;1908;2015
47;Valladolid;105;Olmos de Esgueva;226;119;107;2015
47;Valladolid;106;Olmos de Peñafiel;65;36;29;2015
47;Valladolid;109;Palazuelo de Vedija;206;109;97;2015
47;Valladolid;110;Parrilla, La;502;251;251;2015
47;Valladolid;111;Pedraja de Portillo, La;1143;588;555;2015
47;Valladolid;112;Pedrajas de San Esteban;3432;1767;1665;2015
47;Valladolid;113;Pedrosa del Rey;198;106;92;2015
47;Valladolid;114;Peñafiel;5419;2709;2710;2015
47;Valladolid;115;Peñaflor de Hornija;319;179;140;2015
47;Valladolid;116;Pesquera de Duero;474;263;211;2015
47;Valladolid;117;Piña de Esgueva;330;169;161;2015
47;Valladolid;118;Piñel de Abajo;183;98;85;2015
47;Valladolid;119;Piñel de Arriba;99;50;49;2015
47;Valladolid;121;Pollos;623;329;294;2015
47;Valladolid;122;Portillo;2441;1270;1171;2015
47;Valladolid;123;Pozal de Gallinas;561;306;255;2015
47;Valladolid;124;Pozaldez;499;272;227;2015
47;Valladolid;125;Pozuelo de la Orden;63;38;25;2015
47;Valladolid;126;Puras;55;28;27;2015
47;Valladolid;127;Quintanilla de Arriba;149;83;66;2015
47;Valladolid;129;Quintanilla de Onésimo;1078;562;516;2015
47;Valladolid;130;Quintanilla de Trigueros;115;59;56;2015
47;Valladolid;128;Quintanilla del Molar;63;28;35;2015
47;Valladolid;131;Rábano;195;107;88;2015
47;Valladolid;132;Ramiro;46;27;19;2015
47;Valladolid;133;Renedo de Esgueva;3620;1853;1767;2015
47;Valladolid;134;Roales de Campos;174;99;75;2015
47;Valladolid;135;Robladillo;99;59;40;2015
47;Valladolid;137;Roturas;32;19;13;2015
47;Valladolid;138;Rubí de Bracamonte;236;130;106;2015
47;Valladolid;139;Rueda;1312;678;634;2015
47;Valladolid;140;Saelices de Mayorga;123;73;50;2015
47;Valladolid;141;Salvador de Zapardiel;139;81;58;2015
47;Valladolid;142;San Cebrián de Mazote;177;102;75;2015
47;Valladolid;143;San Llorente;135;76;59;2015
47;Valladolid;144;San Martín de Valvení;88;48;40;2015
47;Valladolid;145;San Miguel del Arroyo;704;377;327;2015
47;Valladolid;146;San Miguel del Pino;316;173;143;2015
47;Valladolid;147;San Pablo de la Moraleja;127;66;61;2015
47;Valladolid;148;San Pedro de Latarce;522;288;234;2015
47;Valladolid;149;San Pelayo;44;20;24;2015
47;Valladolid;150;San Román de Hornija;346;164;182;2015
47;Valladolid;151;San Salvador;32;17;15;2015
47;Valladolid;156;San Vicente del Palacio;178;97;81;2015
47;Valladolid;152;Santa Eufemia del Arroyo;108;60;48;2015
47;Valladolid;153;Santervás de Campos;122;68;54;2015
47;Valladolid;154;Santibáñez de Valcorba;173;99;74;2015
47;Valladolid;155;Santovenia de Pisuerga;4203;2155;2048;2015
47;Valladolid;157;Sardón de Duero;634;328;306;2015
47;Valladolid;158;Seca, La;1107;564;543;2015
47;Valladolid;159;Serrada;1173;628;545;2015
47;Valladolid;160;Siete Iglesias de Trabancos;488;260;228;2015
47;Valladolid;161;Simancas;5265;2661;2604;2015
47;Valladolid;162;Tamariz de Campos;63;34;29;2015
47;Valladolid;163;Tiedra;319;161;158;2015
47;Valladolid;164;Tordehumos;443;220;223;2015
47;Valladolid;165;Tordesillas;8936;4523;4413;2015
47;Valladolid;169;Torre de Esgueva;73;35;38;2015
47;Valladolid;170;Torre de Peñafiel;42;25;17;2015
47;Valladolid;166;Torrecilla de la Abadesa;296;144;152;2015
47;Valladolid;167;Torrecilla de la Orden;262;132;130;2015
47;Valladolid;168;Torrecilla de la Torre;32;20;12;2015
47;Valladolid;171;Torrelobatón;456;237;219;2015
47;Valladolid;172;Torrescárcela;167;90;77;2015
47;Valladolid;173;Traspinedo;1076;584;492;2015
47;Valladolid;174;Trigueros del Valle;315;171;144;2015
47;Valladolid;175;Tudela de Duero;8683;4451;4232;2015
47;Valladolid;176;Unión de Campos, La;272;134;138;2015
47;Valladolid;177;Urones de Castroponce;116;66;50;2015
47;Valladolid;178;Urueña;191;105;86;2015
47;Valladolid;179;Valbuena de Duero;475;248;227;2015
47;Valladolid;180;Valdearcos de la Vega;91;47;44;2015
47;Valladolid;181;Valdenebro de los Valles;208;103;105;2015
47;Valladolid;182;Valdestillas;1732;896;836;2015
47;Valladolid;183;Valdunquillo;158;77;81;2015
47;Valladolid;186;Valladolid;303905;143197;160708;2015
47;Valladolid;184;Valoria la Buena;680;359;321;2015
47;Valladolid;185;Valverde de Campos;106;64;42;2015
47;Valladolid;187;Vega de Ruiponce;106;64;42;2015
47;Valladolid;188;Vega de Valdetronco;120;67;53;2015
47;Valladolid;189;Velascálvaro;171;94;77;2015
47;Valladolid;190;Velilla;111;55;56;2015
47;Valladolid;191;Velliza;122;76;46;2015
47;Valladolid;192;Ventosa de la Cuesta;113;63;50;2015
47;Valladolid;193;Viana de Cega;2015;1053;962;2015
47;Valladolid;195;Villabáñez;549;312;237;2015
47;Valladolid;196;Villabaruz de Campos;38;17;21;2015
47;Valladolid;197;Villabrágima;1061;557;504;2015
47;Valladolid;198;Villacarralón;78;47;31;2015
47;Valladolid;199;Villacid de Campos;86;51;35;2015
47;Valladolid;200;Villaco;83;53;30;2015
47;Valladolid;203;Villafrades de Campos;72;37;35;2015
47;Valladolid;204;Villafranca de Duero;307;159;148;2015
47;Valladolid;205;Villafrechós;491;262;229;2015
47;Valladolid;206;Villafuerte;105;60;45;2015
47;Valladolid;207;Villagarcía de Campos;334;193;141;2015
47;Valladolid;208;Villagómez la Nueva;71;37;34;2015
47;Valladolid;209;Villalán de Campos;46;29;17;2015
47;Valladolid;210;Villalar de los Comuneros;437;214;223;2015
47;Valladolid;211;Villalba de la Loma;62;31;31;2015
47;Valladolid;212;Villalba de los Alcores;420;227;193;2015
47;Valladolid;213;Villalbarba;130;68;62;2015
47;Valladolid;214;Villalón de Campos;1716;842;874;2015
47;Valladolid;215;Villamuriel de Campos;58;28;30;2015
47;Valladolid;216;Villán de Tordesillas;122;70;52;2015
47;Valladolid;217;Villanubla;2565;1345;1220;2015
47;Valladolid;218;Villanueva de Duero;1193;618;575;2015
47;Valladolid;219;Villanueva de la Condesa;69;34;35;2015
47;Valladolid;220;Villanueva de los Caballeros;188;96;92;2015
47;Valladolid;221;Villanueva de los Infantes;113;69;44;2015
47;Valladolid;222;Villanueva de San Mancio;86;46;40;2015
47;Valladolid;223;Villardefrades;183;102;81;2015
47;Valladolid;224;Villarmentero de Esgueva;104;56;48;2015
47;Valladolid;225;Villasexmir;82;48;34;2015
47;Valladolid;226;Villavaquerín;181;104;77;2015
47;Valladolid;227;Villavellid;68;40;28;2015
47;Valladolid;228;Villaverde de Medina;527;290;237;2015
47;Valladolid;229;Villavicencio de los Caballeros;243;119;124;2015
47;Valladolid;194;Viloria;363;186;177;2015
47;Valladolid;230;Wamba;343;180;163;2015
47;Valladolid;231;Zaratán;6124;3164;2960;2015
47;Valladolid;232;Zarza, La;115;64;51;2015
49;Zamora;002;Abezames;66;34;32;2015
49;Zamora;003;Alcañices;1108;555;553;2015
49;Zamora;004;Alcubilla de Nogales;135;74;61;2015
49;Zamora;005;Alfaraz de Sayago;149;85;64;2015
49;Zamora;006;Algodre;167;94;73;2015
49;Zamora;007;Almaraz de Duero;398;195;203;2015
49;Zamora;008;Almeida de Sayago;500;272;228;2015
49;Zamora;009;Andavías;448;230;218;2015
49;Zamora;010;Arcenillas;415;210;205;2015
49;Zamora;011;Arcos de la Polvorosa;242;127;115;2015
49;Zamora;012;Argañín;82;40;42;2015
49;Zamora;013;Argujillo;283;142;141;2015
49;Zamora;014;Arquillinos;114;58;56;2015
49;Zamora;015;Arrabalde;252;123;129;2015
49;Zamora;016;Aspariegos;286;132;154;2015
49;Zamora;017;Asturianos;275;138;137;2015
49;Zamora;018;Ayoó de Vidriales;363;186;177;2015
49;Zamora;019;Barcial del Barco;276;152;124;2015
49;Zamora;020;Belver de los Montes;315;170;145;2015
49;Zamora;021;Benavente;18550;8977;9573;2015
49;Zamora;022;Benegiles;332;176;156;2015
49;Zamora;023;Bermillo de Sayago;1104;581;523;2015
49;Zamora;024;Bóveda de Toro, La;781;394;387;2015
49;Zamora;025;Bretó;184;108;76;2015
49;Zamora;026;Bretocino;248;133;115;2015
49;Zamora;027;Brime de Sog;155;74;81;2015
49;Zamora;028;Brime de Urz;129;76;53;2015
49;Zamora;029;Burganes de Valverde;695;364;331;2015
49;Zamora;030;Bustillo del Oro;86;44;42;2015
49;Zamora;031;Cabañas de Sayago;153;82;71;2015
49;Zamora;032;Calzadilla de Tera;350;165;185;2015
49;Zamora;033;Camarzana de Tera;889;443;446;2015
49;Zamora;034;Cañizal;485;252;233;2015
49;Zamora;035;Cañizo;249;132;117;2015
49;Zamora;036;Carbajales de Alba;586;297;289;2015
49;Zamora;037;Carbellino;206;109;97;2015
49;Zamora;038;Casaseca de Campeán;105;58;47;2015
49;Zamora;039;Casaseca de las Chanas;378;206;172;2015
49;Zamora;040;Castrillo de la Guareña;129;68;61;2015
49;Zamora;041;Castrogonzalo;491;261;230;2015
49;Zamora;042;Castronuevo;247;120;127;2015
49;Zamora;043;Castroverde de Campos;349;178;171;2015
49;Zamora;044;Cazurra;89;48;41;2015
49;Zamora;046;Cerecinos de Campos;308;169;139;2015
49;Zamora;047;Cerecinos del Carrizal;121;68;53;2015
49;Zamora;048;Cernadilla;138;68;70;2015
49;Zamora;050;Cobreros;591;320;271;2015
49;Zamora;052;Coomonte;203;105;98;2015
49;Zamora;053;Coreses;1080;560;520;2015
49;Zamora;054;Corrales del Vino;1052;519;533;2015
49;Zamora;055;Cotanes del Monte;117;65;52;2015
49;Zamora;056;Cubillos;322;164;158;2015
49;Zamora;057;Cubo de Benavente;116;64;52;2015
49;Zamora;058;Cubo de Tierra del Vino, El;355;193;162;2015
49;Zamora;059;Cuelgamures;93;59;34;2015
49;Zamora;061;Entrala;165;87;78;2015
49;Zamora;062;Espadañedo;129;63;66;2015
49;Zamora;063;Faramontanos de Tábara;365;189;176;2015
49;Zamora;064;Fariza;570;295;275;2015
49;Zamora;065;Fermoselle;1335;689;646;2015
49;Zamora;066;Ferreras de Abajo;565;289;276;2015
49;Zamora;067;Ferreras de Arriba;414;220;194;2015
49;Zamora;068;Ferreruela;518;284;234;2015
49;Zamora;069;Figueruela de Arriba;405;194;211;2015
49;Zamora;071;Fonfría;837;428;409;2015
49;Zamora;075;Fresno de la Polvorosa;153;80;73;2015
49;Zamora;076;Fresno de la Ribera;381;205;176;2015
49;Zamora;077;Fresno de Sayago;204;109;95;2015
49;Zamora;078;Friera de Valverde;185;97;88;2015
49;Zamora;079;Fuente Encalada;119;67;52;2015
49;Zamora;080;Fuentelapeña;778;414;364;2015
49;Zamora;082;Fuentes de Ropel;416;211;205;2015
49;Zamora;081;Fuentesaúco;1644;814;830;2015
49;Zamora;083;Fuentesecas;64;30;34;2015
49;Zamora;084;Fuentespreadas;322;174;148;2015
49;Zamora;085;Galende;1190;607;583;2015
49;Zamora;086;Gallegos del Pan;129;75;54;2015
49;Zamora;087;Gallegos del Río;550;299;251;2015
49;Zamora;088;Gamones;101;56;45;2015
49;Zamora;090;Gema;217;111;106;2015
49;Zamora;091;Granja de Moreruela;290;154;136;2015
49;Zamora;092;Granucillo;144;71;73;2015
49;Zamora;093;Guarrate;351;180;171;2015
49;Zamora;094;Hermisende;273;145;128;2015
49;Zamora;095;Hiniesta, La;333;171;162;2015
49;Zamora;096;Jambrina;179;93;86;2015
49;Zamora;097;Justel;99;60;39;2015
49;Zamora;098;Losacino;241;133;108;2015
49;Zamora;099;Losacio;144;71;73;2015
49;Zamora;100;Lubián;345;183;162;2015
49;Zamora;101;Luelmo;171;88;83;2015
49;Zamora;102;Maderal, El;214;110;104;2015
49;Zamora;103;Madridanos;478;246;232;2015
49;Zamora;104;Mahide;381;208;173;2015
49;Zamora;105;Maire de Castroponce;164;89;75;2015
49;Zamora;107;Malva;140;67;73;2015
49;Zamora;108;Manganeses de la Lampreana;519;262;257;2015
49;Zamora;109;Manganeses de la Polvorosa;719;355;364;2015
49;Zamora;110;Manzanal de Arriba;398;213;185;2015
49;Zamora;112;Manzanal de los Infantes;142;81;61;2015
49;Zamora;111;Manzanal del Barco;142;74;68;2015
49;Zamora;113;Matilla de Arzón;184;109;75;2015
49;Zamora;114;Matilla la Seca;46;23;23;2015
49;Zamora;115;Mayalde;207;111;96;2015
49;Zamora;116;Melgar de Tera;430;220;210;2015
49;Zamora;117;Micereces de Tera;490;246;244;2015
49;Zamora;118;Milles de la Polvorosa;230;123;107;2015
49;Zamora;119;Molacillos;269;144;125;2015
49;Zamora;120;Molezuelas de la Carballeda;86;48;38;2015
49;Zamora;121;Mombuey;427;230;197;2015
49;Zamora;122;Monfarracinos;992;504;488;2015
49;Zamora;123;Montamarta;604;314;290;2015
49;Zamora;124;Moral de Sayago;278;157;121;2015
49;Zamora;126;Moraleja de Sayago;266;142;124;2015
49;Zamora;125;Moraleja del Vino;1660;856;804;2015
49;Zamora;128;Morales de Rey;618;312;306;2015
49;Zamora;129;Morales de Toro;996;523;473;2015
49;Zamora;130;Morales de Valverde;198;103;95;2015
49;Zamora;127;Morales del Vino;2955;1541;1414;2015
49;Zamora;131;Moralina;302;156;146;2015
49;Zamora;132;Moreruela de los Infanzones;372;189;183;2015
49;Zamora;133;Moreruela de Tábara;342;169;173;2015
49;Zamora;134;Muelas de los Caballeros;205;114;91;2015
49;Zamora;135;Muelas del Pan;705;353;352;2015
49;Zamora;136;Muga de Sayago;374;177;197;2015
49;Zamora;137;Navianos de Valverde;205;114;91;2015
49;Zamora;138;Olmillos de Castro;250;134;116;2015
49;Zamora;139;Otero de Bodas;182;97;85;2015
49;Zamora;141;Pajares de la Lampreana;383;186;197;2015
49;Zamora;143;Palacios de Sanabria;261;129;132;2015
49;Zamora;142;Palacios del Pan;262;133;129;2015
49;Zamora;145;Pedralba de la Pradería;306;162;144;2015
49;Zamora;146;Pego, El;327;167;160;2015
49;Zamora;147;Peleagonzalo;271;137;134;2015
49;Zamora;148;Peleas de Abajo;235;123;112;2015
49;Zamora;149;Peñausende;437;220;217;2015
49;Zamora;150;Peque;154;69;85;2015
49;Zamora;151;Perdigón, El;740;394;346;2015
49;Zamora;152;Pereruela;591;318;273;2015
49;Zamora;153;Perilla de Castro;182;92;90;2015
49;Zamora;154;Pías;143;78;65;2015
49;Zamora;155;Piedrahita de Castro;93;50;43;2015
49;Zamora;156;Pinilla de Toro;252;135;117;2015
49;Zamora;157;Pino del Oro;231;125;106;2015
49;Zamora;158;Piñero, El;240;127;113;2015
49;Zamora;160;Pobladura de Valderaduey;41;22;19;2015
49;Zamora;159;Pobladura del Valle;313;165;148;2015
49;Zamora;162;Porto;194;109;85;2015
49;Zamora;163;Pozoantiguo;262;133;129;2015
49;Zamora;164;Pozuelo de Tábara;172;89;83;2015
49;Zamora;165;Prado;60;34;26;2015
49;Zamora;166;Puebla de Sanabria;1484;711;773;2015
49;Zamora;167;Pueblica de Valverde;226;123;103;2015
49;Zamora;170;Quintanilla de Urz;109;55;54;2015
49;Zamora;168;Quintanilla del Monte;100;48;52;2015
49;Zamora;169;Quintanilla del Olmo;32;16;16;2015
49;Zamora;171;Quiruelas de Vidriales;710;356;354;2015
49;Zamora;172;Rabanales;576;296;280;2015
49;Zamora;173;Rábano de Aliste;414;205;209;2015
49;Zamora;174;Requejo;156;77;79;2015
49;Zamora;175;Revellinos;279;151;128;2015
49;Zamora;176;Riofrío de Aliste;747;401;346;2015
49;Zamora;177;Rionegro del Puente;306;158;148;2015
49;Zamora;178;Roales;848;457;391;2015
49;Zamora;179;Robleda-Cervantes;464;245;219;2015
49;Zamora;180;Roelos de Sayago;178;84;94;2015
49;Zamora;181;Rosinos de la Requejada;398;213;185;2015
49;Zamora;183;Salce;104;47;57;2015
49;Zamora;184;Samir de los Caños;191;103;88;2015
49;Zamora;185;San Agustín del Pozo;193;101;92;2015
49;Zamora;186;San Cebrián de Castro;272;128;144;2015
49;Zamora;187;San Cristóbal de Entreviñas;1481;777;704;2015
49;Zamora;188;San Esteban del Molar;125;71;54;2015
49;Zamora;189;San Justo;247;135;112;2015
49;Zamora;190;San Martín de Valderaduey;65;33;32;2015
49;Zamora;191;San Miguel de la Ribera;304;153;151;2015
49;Zamora;192;San Miguel del Valle;156;74;82;2015
49;Zamora;193;San Pedro de Ceque;513;265;248;2015
49;Zamora;194;San Pedro de la Nave-Almendra;379;193;186;2015
49;Zamora;208;San Vicente de la Cabeza;427;225;202;2015
49;Zamora;209;San Vitero;563;313;250;2015
49;Zamora;197;Santa Clara de Avedillo;180;93;87;2015
49;Zamora;199;Santa Colomba de las Monjas;281;140;141;2015
49;Zamora;200;Santa Cristina de la Polvorosa;1105;561;544;2015
49;Zamora;201;Santa Croya de Tera;326;166;160;2015
49;Zamora;202;Santa Eufemia del Barco;197;111;86;2015
49;Zamora;203;Santa María de la Vega;352;181;171;2015
49;Zamora;204;Santa María de Valverde;65;26;39;2015
49;Zamora;205;Santibáñez de Tera;411;209;202;2015
49;Zamora;206;Santibáñez de Vidriales;1044;529;515;2015
49;Zamora;207;Santovenia;281;139;142;2015
49;Zamora;210;Sanzoles;556;280;276;2015
49;Zamora;214;Tábara;832;430;402;2015
49;Zamora;216;Tapioles;166;97;69;2015
49;Zamora;219;Toro;9214;4493;4721;2015
49;Zamora;220;Torre del Valle, La;155;82;73;2015
49;Zamora;221;Torregamones;304;158;146;2015
49;Zamora;222;Torres del Carrizal;431;218;213;2015
49;Zamora;223;Trabazos;1002;534;468;2015
49;Zamora;224;Trefacio;192;96;96;2015
49;Zamora;225;Uña de Quintana;157;80;77;2015
49;Zamora;226;Vadillo de la Guareña;285;152;133;2015
49;Zamora;227;Valcabado;361;183;178;2015
49;Zamora;228;Valdefinjas;57;35;22;2015
49;Zamora;229;Valdescorriel;148;74;74;2015
49;Zamora;230;Vallesa de la Guareña;106;58;48;2015
49;Zamora;231;Vega de Tera;385;188;197;2015
49;Zamora;232;Vega de Villalobos;112;55;57;2015
49;Zamora;233;Vegalatrave;93;52;41;2015
49;Zamora;234;Venialbo;480;262;218;2015
49;Zamora;235;Vezdemarbán;441;227;214;2015
49;Zamora;236;Vidayanes;92;48;44;2015
49;Zamora;237;Videmala;180;95;85;2015
49;Zamora;238;Villabrázaro;238;128;110;2015
49;Zamora;239;Villabuena del Puente;786;405;381;2015
49;Zamora;240;Villadepera;242;130;112;2015
49;Zamora;241;Villaescusa;276;149;127;2015
49;Zamora;242;Villafáfila;506;260;246;2015
49;Zamora;243;Villaferrueña;117;60;57;2015
49;Zamora;244;Villageriz;50;30;20;2015
49;Zamora;245;Villalazán;287;140;147;2015
49;Zamora;246;Villalba de la Lampreana;257;142;115;2015
49;Zamora;247;Villalcampo;476;236;240;2015
49;Zamora;248;Villalobos;261;130;131;2015
49;Zamora;249;Villalonso;101;54;47;2015
49;Zamora;250;Villalpando;1523;754;769;2015
49;Zamora;251;Villalube;174;92;82;2015
49;Zamora;252;Villamayor de Campos;337;171;166;2015
49;Zamora;255;Villamor de los Escuderos;422;224;198;2015
49;Zamora;256;Villanázar;299;152;147;2015
49;Zamora;257;Villanueva de Azoague;329;170;159;2015
49;Zamora;258;Villanueva de Campeán;122;66;56;2015
49;Zamora;259;Villanueva de las Peras;96;54;42;2015
49;Zamora;260;Villanueva del Campo;914;453;461;2015
49;Zamora;263;Villar de Fallaves;51;28;23;2015
49;Zamora;264;Villar del Buey;653;339;314;2015
49;Zamora;261;Villaralbo;1893;958;935;2015
49;Zamora;262;Villardeciervos;464;223;241;2015
49;Zamora;265;Villardiegua de la Ribera;134;67;67;2015
49;Zamora;266;Villárdiga;87;46;41;2015
49;Zamora;267;Villardondiego;99;57;42;2015
49;Zamora;268;Villarrín de Campos;450;243;207;2015
49;Zamora;269;Villaseco del Pan;256;124;132;2015
49;Zamora;270;Villavendimio;163;98;65;2015
49;Zamora;272;Villaveza de Valverde;89;45;44;2015
49;Zamora;271;Villaveza del Agua;218;115;103;2015
49;Zamora;273;Viñas;211;107;104;2015
49;Zamora;275;Zamora;63831;29908;33923;2015
50;Zaragoza;001;Abanto;113;62;51;2015
50;Zaragoza;002;Acered;217;128;89;2015
50;Zaragoza;003;Agón;155;85;70;2015
50;Zaragoza;004;Aguarón;724;379;345;2015
50;Zaragoza;005;Aguilón;254;137;117;2015
50;Zaragoza;006;Ainzón;1143;583;560;2015
50;Zaragoza;007;Aladrén;52;34;18;2015
50;Zaragoza;008;Alagón;7014;3497;3517;2015
50;Zaragoza;009;Alarba;152;90;62;2015
50;Zaragoza;010;Alberite de San Juan;84;51;33;2015
50;Zaragoza;011;Albeta;145;70;75;2015
50;Zaragoza;012;Alborge;121;62;59;2015
50;Zaragoza;013;Alcalá de Ebro;279;132;147;2015
50;Zaragoza;014;Alcalá de Moncayo;186;107;79;2015
50;Zaragoza;015;Alconchel de Ariza;80;46;34;2015
50;Zaragoza;016;Aldehuela de Liestos;57;39;18;2015
50;Zaragoza;017;Alfajarín;2266;1166;1100;2015
50;Zaragoza;018;Alfamén;1466;780;686;2015
50;Zaragoza;019;Alforque;64;35;29;2015
50;Zaragoza;020;Alhama de Aragón;1077;555;522;2015
50;Zaragoza;021;Almochuel;34;17;17;2015
50;Zaragoza;022;Almolda, La;593;298;295;2015
50;Zaragoza;023;Almonacid de la Cuba;255;132;123;2015
50;Zaragoza;024;Almonacid de la Sierra;731;405;326;2015
50;Zaragoza;025;Almunia de Doña Godina, La;7680;3915;3765;2015
50;Zaragoza;026;Alpartir;564;288;276;2015
50;Zaragoza;027;Ambel;256;124;132;2015
50;Zaragoza;028;Anento;105;68;37;2015
50;Zaragoza;029;Aniñón;761;417;344;2015
50;Zaragoza;030;Añón de Moncayo;206;121;85;2015
50;Zaragoza;031;Aranda de Moncayo;187;117;70;2015
50;Zaragoza;032;Arándiga;340;175;165;2015
50;Zaragoza;033;Ardisa;74;48;26;2015
50;Zaragoza;034;Ariza;1196;615;581;2015
50;Zaragoza;035;Artieda;81;48;33;2015
50;Zaragoza;036;Asín;104;51;53;2015
50;Zaragoza;037;Atea;112;64;48;2015
50;Zaragoza;038;Ateca;1968;1015;953;2015
50;Zaragoza;039;Azuara;606;330;276;2015
50;Zaragoza;040;Badules;95;55;40;2015
50;Zaragoza;041;Bagüés;13;8;5;2015
50;Zaragoza;042;Balconchán;13;6;7;2015
50;Zaragoza;043;Bárboles;340;187;153;2015
50;Zaragoza;044;Bardallur;282;139;143;2015
50;Zaragoza;045;Belchite;1562;793;769;2015
50;Zaragoza;046;Belmonte de Gracián;211;117;94;2015
50;Zaragoza;047;Berdejo;53;33;20;2015
50;Zaragoza;048;Berrueco;37;19;18;2015
50;Zaragoza;901;Biel;148;86;62;2015
50;Zaragoza;050;Bijuesca;100;64;36;2015
50;Zaragoza;051;Biota;1002;500;502;2015
50;Zaragoza;052;Bisimbre;97;51;46;2015
50;Zaragoza;053;Boquiñeni;871;445;426;2015
50;Zaragoza;054;Bordalba;62;41;21;2015
50;Zaragoza;055;Borja;4930;2462;2468;2015
50;Zaragoza;056;Botorrita;484;267;217;2015
50;Zaragoza;057;Brea de Aragón;1719;869;850;2015
50;Zaragoza;058;Bubierca;76;37;39;2015
50;Zaragoza;059;Bujaraloz;1008;528;480;2015
50;Zaragoza;060;Bulbuente;236;126;110;2015
50;Zaragoza;061;Bureta;253;137;116;2015
50;Zaragoza;062;Burgo de Ebro, El;2348;1196;1152;2015
50;Zaragoza;063;Buste, El;66;36;30;2015
50;Zaragoza;064;Cabañas de Ebro;527;283;244;2015
50;Zaragoza;065;Cabolafuente;38;21;17;2015
50;Zaragoza;066;Cadrete;3602;1892;1710;2015
50;Zaragoza;067;Calatayud;19724;9730;9994;2015
50;Zaragoza;068;Calatorao;2864;1502;1362;2015
50;Zaragoza;069;Calcena;79;50;29;2015
50;Zaragoza;070;Calmarza;77;44;33;2015
50;Zaragoza;071;Campillo de Aragón;141;77;64;2015
50;Zaragoza;072;Carenas;172;90;82;2015
50;Zaragoza;073;Cariñena;3389;1728;1661;2015
50;Zaragoza;074;Caspe;9867;5098;4769;2015
50;Zaragoza;075;Castejón de Alarba;95;58;37;2015
50;Zaragoza;076;Castejón de las Armas;101;53;48;2015
50;Zaragoza;077;Castejón de Valdejasa;228;117;111;2015
50;Zaragoza;078;Castiliscar;280;142;138;2015
50;Zaragoza;079;Cervera de la Cañada;311;169;142;2015
50;Zaragoza;080;Cerveruela;33;21;12;2015
50;Zaragoza;081;Cetina;645;328;317;2015
50;Zaragoza;092;Chiprana;498;271;227;2015
50;Zaragoza;093;Chodes;132;72;60;2015
50;Zaragoza;082;Cimballa;113;57;56;2015
50;Zaragoza;083;Cinco Olivas;113;56;57;2015
50;Zaragoza;084;Clarés de Ribota;80;45;35;2015
50;Zaragoza;085;Codo;194;95;99;2015
50;Zaragoza;086;Codos;185;113;72;2015
50;Zaragoza;087;Contamina;36;21;15;2015
50;Zaragoza;088;Cosuenda;396;209;187;2015
50;Zaragoza;089;Cuarte de Huerva;12141;6262;5879;2015
50;Zaragoza;090;Cubel;189;93;96;2015
50;Zaragoza;091;Cuerlas, Las;50;27;23;2015
50;Zaragoza;094;Daroca;2113;1040;1073;2015
50;Zaragoza;095;Ejea de los Caballeros;16754;8588;8166;2015
50;Zaragoza;096;Embid de Ariza;47;22;25;2015
50;Zaragoza;098;Encinacorba;222;112;110;2015
50;Zaragoza;099;Épila;4545;2379;2166;2015
50;Zaragoza;100;Erla;371;186;185;2015
50;Zaragoza;101;Escatrón;1084;531;553;2015
50;Zaragoza;102;Fabara;1227;666;561;2015
50;Zaragoza;104;Farlete;414;206;208;2015
50;Zaragoza;105;Fayón;355;185;170;2015
50;Zaragoza;106;Fayos, Los;151;78;73;2015
50;Zaragoza;107;Figueruelas;1229;621;608;2015
50;Zaragoza;108;Fombuena;51;31;20;2015
50;Zaragoza;109;Frago, El;104;65;39;2015
50;Zaragoza;110;Frasno, El;415;225;190;2015
50;Zaragoza;111;Fréscano;205;109;96;2015
50;Zaragoza;113;Fuendejalón;833;448;385;2015
50;Zaragoza;114;Fuendetodos;144;76;68;2015
50;Zaragoza;115;Fuentes de Ebro;4594;2385;2209;2015
50;Zaragoza;116;Fuentes de Jiloca;219;120;99;2015
50;Zaragoza;117;Gallocanta;160;90;70;2015
50;Zaragoza;118;Gallur;2695;1354;1341;2015
50;Zaragoza;119;Gelsa;1087;567;520;2015
50;Zaragoza;120;Godojos;35;20;15;2015
50;Zaragoza;121;Gotor;334;177;157;2015
50;Zaragoza;122;Grisel;74;45;29;2015
50;Zaragoza;123;Grisén;656;332;324;2015
50;Zaragoza;124;Herrera de los Navarros;550;290;260;2015
50;Zaragoza;125;Ibdes;455;240;215;2015
50;Zaragoza;126;Illueca;3139;1554;1585;2015
50;Zaragoza;128;Isuerre;35;22;13;2015
50;Zaragoza;129;Jaraba;324;164;160;2015
50;Zaragoza;130;Jarque;473;259;214;2015
50;Zaragoza;131;Jaulín;260;140;120;2015
50;Zaragoza;132;Joyosa, La;1042;534;508;2015
50;Zaragoza;133;Lagata;124;69;55;2015
50;Zaragoza;134;Langa del Castillo;137;69;68;2015
50;Zaragoza;135;Layana;114;62;52;2015
50;Zaragoza;136;Lécera;729;396;333;2015
50;Zaragoza;138;Lechón;56;33;23;2015
50;Zaragoza;137;Leciñena;1220;619;601;2015
50;Zaragoza;139;Letux;359;202;157;2015
50;Zaragoza;140;Litago;174;97;77;2015
50;Zaragoza;141;Lituénigo;123;65;58;2015
50;Zaragoza;142;Lobera de Onsella;42;26;16;2015
50;Zaragoza;143;Longares;847;499;348;2015
50;Zaragoza;144;Longás;36;25;11;2015
50;Zaragoza;146;Lucena de Jalón;242;132;110;2015
50;Zaragoza;147;Luceni;1006;518;488;2015
50;Zaragoza;148;Luesia;334;186;148;2015
50;Zaragoza;149;Luesma;43;26;17;2015
50;Zaragoza;150;Lumpiaque;886;456;430;2015
50;Zaragoza;151;Luna;756;400;356;2015
50;Zaragoza;152;Maella;1953;1042;911;2015
50;Zaragoza;153;Magallón;1174;603;571;2015
50;Zaragoza;154;Mainar;152;81;71;2015
50;Zaragoza;155;Malanquilla;113;71;42;2015
50;Zaragoza;156;Maleján;267;137;130;2015
50;Zaragoza;160;Mallén;3292;1732;1560;2015
50;Zaragoza;157;Malón;359;183;176;2015
50;Zaragoza;159;Maluenda;1034;509;525;2015
50;Zaragoza;161;Manchones;130;75;55;2015
50;Zaragoza;162;Mara;182;93;89;2015
50;Zaragoza;163;María de Huerva;5425;2792;2633;2015
50;Zaragoza;902;Marracos;94;52;42;2015
50;Zaragoza;164;Mediana de Aragón;457;219;238;2015
50;Zaragoza;165;Mequinenza;2311;1180;1131;2015
50;Zaragoza;166;Mesones de Isuela;291;141;150;2015
50;Zaragoza;167;Mezalocha;235;135;100;2015
50;Zaragoza;168;Mianos;31;19;12;2015
50;Zaragoza;169;Miedes de Aragón;479;264;215;2015
50;Zaragoza;170;Monegrillo;431;241;190;2015
50;Zaragoza;171;Moneva;112;66;46;2015
50;Zaragoza;172;Monreal de Ariza;222;126;96;2015
50;Zaragoza;173;Monterde;278;157;121;2015
50;Zaragoza;174;Montón;105;63;42;2015
50;Zaragoza;175;Morata de Jalón;1204;592;612;2015
50;Zaragoza;176;Morata de Jiloca;256;148;108;2015
50;Zaragoza;177;Morés;362;195;167;2015
50;Zaragoza;178;Moros;397;208;189;2015
50;Zaragoza;179;Moyuela;280;153;127;2015
50;Zaragoza;180;Mozota;121;60;61;2015
50;Zaragoza;181;Muel;1335;684;651;2015
50;Zaragoza;182;Muela, La;4980;2578;2402;2015
50;Zaragoza;183;Munébrega;405;222;183;2015
50;Zaragoza;184;Murero;131;76;55;2015
50;Zaragoza;185;Murillo de Gállego;166;103;63;2015
50;Zaragoza;186;Navardún;41;25;16;2015
50;Zaragoza;187;Nigüella;78;47;31;2015
50;Zaragoza;188;Nombrevilla;34;19;15;2015
50;Zaragoza;189;Nonaspe;1008;538;470;2015
50;Zaragoza;190;Novallas;913;495;418;2015
50;Zaragoza;191;Novillas;578;283;295;2015
50;Zaragoza;192;Nuévalos;327;181;146;2015
50;Zaragoza;193;Nuez de Ebro;826;420;406;2015
50;Zaragoza;194;Olvés;117;67;50;2015
50;Zaragoza;195;Orcajo;56;38;18;2015
50;Zaragoza;196;Orera;127;65;62;2015
50;Zaragoza;197;Orés;112;66;46;2015
50;Zaragoza;198;Oseja;61;36;25;2015
50;Zaragoza;199;Osera de Ebro;407;205;202;2015
50;Zaragoza;200;Paniza;691;367;324;2015
50;Zaragoza;201;Paracuellos de Jiloca;590;305;285;2015
50;Zaragoza;202;Paracuellos de la Ribera;168;87;81;2015
50;Zaragoza;203;Pastriz;1280;616;664;2015
50;Zaragoza;204;Pedrola;3560;1850;1710;2015
50;Zaragoza;205;Pedrosas, Las;107;52;55;2015
50;Zaragoza;206;Perdiguera;597;314;283;2015
50;Zaragoza;207;Piedratajada;114;60;54;2015
50;Zaragoza;208;Pina de Ebro;2535;1304;1231;2015
50;Zaragoza;209;Pinseque;3606;1891;1715;2015
50;Zaragoza;210;Pintanos, Los;44;26;18;2015
50;Zaragoza;211;Plasencia de Jalón;342;187;155;2015
50;Zaragoza;212;Pleitas;45;21;24;2015
50;Zaragoza;213;Plenas;111;62;49;2015
50;Zaragoza;214;Pomer;32;21;11;2015
50;Zaragoza;215;Pozuel de Ariza;24;15;9;2015
50;Zaragoza;216;Pozuelo de Aragón;288;154;134;2015
50;Zaragoza;217;Pradilla de Ebro;560;300;260;2015
50;Zaragoza;218;Puebla de Albortón;124;77;47;2015
50;Zaragoza;219;Puebla de Alfindén, La;5948;3062;2886;2015
50;Zaragoza;220;Puendeluna;51;27;24;2015
50;Zaragoza;221;Purujosa;37;25;12;2015
50;Zaragoza;222;Quinto;2020;1031;989;2015
50;Zaragoza;223;Remolinos;1143;595;548;2015
50;Zaragoza;224;Retascón;79;48;31;2015
50;Zaragoza;225;Ricla;3122;1635;1487;2015
50;Zaragoza;227;Romanos;111;62;49;2015
50;Zaragoza;228;Rueda de Jalón;332;180;152;2015
50;Zaragoza;229;Ruesca;73;37;36;2015
50;Zaragoza;241;Sabiñán;743;397;346;2015
50;Zaragoza;230;Sádaba;1404;718;686;2015
50;Zaragoza;231;Salillas de Jalón;324;164;160;2015
50;Zaragoza;232;Salvatierra de Esca;215;107;108;2015
50;Zaragoza;233;Samper del Salz;123;72;51;2015
50;Zaragoza;234;San Martín de la Virgen de Moncayo;279;158;121;2015
50;Zaragoza;235;San Mateo de Gállego;3051;1574;1477;2015
50;Zaragoza;236;Santa Cruz de Grío;135;74;61;2015
50;Zaragoza;237;Santa Cruz de Moncayo;136;72;64;2015
50;Zaragoza;238;Santa Eulalia de Gállego;110;57;53;2015
50;Zaragoza;239;Santed;66;42;24;2015
50;Zaragoza;240;Sástago;1217;620;597;2015
50;Zaragoza;242;Sediles;105;63;42;2015
50;Zaragoza;243;Sestrica;402;229;173;2015
50;Zaragoza;244;Sierra de Luna;267;143;124;2015
50;Zaragoza;245;Sigüés;103;56;47;2015
50;Zaragoza;246;Sisamón;36;24;12;2015
50;Zaragoza;247;Sobradiel;1077;527;550;2015
50;Zaragoza;248;Sos del Rey Católico;614;314;300;2015
50;Zaragoza;249;Tabuenca;352;201;151;2015
50;Zaragoza;250;Talamantes;58;26;32;2015
50;Zaragoza;251;Tarazona;10759;5331;5428;2015
50;Zaragoza;252;Tauste;6941;3445;3496;2015
50;Zaragoza;253;Terrer;520;281;239;2015
50;Zaragoza;254;Tierga;200;110;90;2015
50;Zaragoza;255;Tobed;243;129;114;2015
50;Zaragoza;256;Torralba de los Frailes;86;46;40;2015
50;Zaragoza;257;Torralba de Ribota;186;106;80;2015
50;Zaragoza;258;Torralbilla;63;36;27;2015
50;Zaragoza;259;Torrehermosa;69;38;31;2015
50;Zaragoza;260;Torrelapaja;35;21;14;2015
50;Zaragoza;261;Torrellas;269;142;127;2015
50;Zaragoza;262;Torres de Berrellén;1491;777;714;2015
50;Zaragoza;263;Torrijo de la Cañada;245;141;104;2015
50;Zaragoza;264;Tosos;205;113;92;2015
50;Zaragoza;265;Trasmoz;79;42;37;2015
50;Zaragoza;266;Trasobares;128;79;49;2015
50;Zaragoza;267;Uncastillo;684;328;356;2015
50;Zaragoza;268;Undués de Lerda;61;38;23;2015
50;Zaragoza;269;Urrea de Jalón;398;212;186;2015
50;Zaragoza;270;Urriés;37;21;16;2015
50;Zaragoza;271;Used;288;159;129;2015
50;Zaragoza;272;Utebo;18430;9211;9219;2015
50;Zaragoza;274;Val de San Martín;70;41;29;2015
50;Zaragoza;273;Valdehorna;30;15;15;2015
50;Zaragoza;275;Valmadrid;128;82;46;2015
50;Zaragoza;276;Valpalmas;142;67;75;2015
50;Zaragoza;277;Valtorres;66;32;34;2015
50;Zaragoza;278;Velilla de Ebro;250;137;113;2015
50;Zaragoza;279;Velilla de Jiloca;120;61;59;2015
50;Zaragoza;280;Vera de Moncayo;388;199;189;2015
50;Zaragoza;281;Vierlas;96;51;45;2015
50;Zaragoza;283;Villadoz;90;56;34;2015
50;Zaragoza;284;Villafeliche;195;102;93;2015
50;Zaragoza;285;Villafranca de Ebro;836;414;422;2015
50;Zaragoza;286;Villalba de Perejil;98;49;49;2015
50;Zaragoza;287;Villalengua;348;184;164;2015
50;Zaragoza;903;Villamayor de Gállego;2793;1411;1382;2015
50;Zaragoza;288;Villanueva de Gállego;4614;2330;2284;2015
50;Zaragoza;290;Villanueva de Huerva;491;257;234;2015
50;Zaragoza;289;Villanueva de Jiloca;57;28;29;2015
50;Zaragoza;291;Villar de los Navarros;113;62;51;2015
50;Zaragoza;292;Villarreal de Huerva;247;129;118;2015
50;Zaragoza;293;Villarroya de la Sierra;503;269;234;2015
50;Zaragoza;294;Villarroya del Campo;80;45;35;2015
50;Zaragoza;282;Vilueña, La;111;57;54;2015
50;Zaragoza;295;Vistabella;45;29;16;2015
50;Zaragoza;296;Zaida, La;473;233;240;2015
50;Zaragoza;297;Zaragoza;664953;319795;345158;2015
50;Zaragoza;298;Zuera;7820;4028;3792;2015
01;Araba/Álava;001;Alegría-Dulantzi;2971;1531;1440;2024
01;Araba/Álava;002;Amurrio;10330;5149;5181;2024
01;Araba/Álava;003;Aramaio;1381;709;672;2024
01;Araba/Álava;004;Artziniega;1856;913;943;2024
01;Araba/Álava;006;Armiñón;247;127;120;2024
01;Araba/Álava;008;Arratzua-Ubarrundia;1047;552;495;2024
01;Araba/Álava;009;Asparrena;1611;813;798;2024
01;Araba/Álava;010;Ayala/Aiara;2942;1491;1451;2024
01;Araba/Álava;011;Baños de Ebro/Mañueta;291;168;123;2024
01;Araba/Álava;013;Barrundia;879;490;389;2024
01;Araba/Álava;014;Berantevilla;459;238;221;2024
01;Araba/Álava;016;Bernedo;546;318;228;2024
01;Araba/Álava;017;Campezo/Kanpezu;1085;574;511;2024
01;Araba/Álava;018;Zigoitia;1844;990;854;2024
01;Araba/Álava;019;Kripan;178;90;88;2024
01;Araba/Álava;020;Kuartango;408;229;179;2024
01;Araba/Álava;021;Elburgo/Burgelu;642;334;308;2024
01;Araba/Álava;022;Elciego;955;478;477;2024
01;Araba/Álava;023;Elvillar/Bilar;319;152;167;2024
01;Araba/Álava;027;Iruraiz-Gauna;553;298;255;2024
01;Araba/Álava;028;Labastida/Bastida;1565;800;765;2024
01;Araba/Álava;030;Lagrán;170;96;74;2024
01;Araba/Álava;031;Laguardia;1478;790;688;2024
01;Araba/Álava;032;Lanciego/Lantziego;685;354;331;2024
01;Araba/Álava;033;Lapuebla de Labarca;859;436;423;2024
01;Araba/Álava;034;Leza;210;107;103;2024
01;Araba/Álava;036;Laudio/Llodio;17982;8712;9270;2024
01;Araba/Álava;037;Arraia-Maeztu;822;451;371;2024
01;Araba/Álava;039;Moreda de Álava/Moreda Araba;215;114;101;2024
01;Araba/Álava;041;Navaridas;191;106;85;2024
01;Araba/Álava;042;Okondo;1194;630;564;2024
01;Araba/Álava;043;Oyón-Oion;3413;1724;1689;2024
01;Araba/Álava;044;Peñacerrada-Urizaharra;302;181;121;2024
01;Araba/Álava;046;Erriberagoitia/Ribera Alta;845;504;341;2024
01;Araba/Álava;047;Ribera Baja/Erriberabeitia;1439;767;672;2024
01;Araba/Álava;049;Añana;142;86;56;2024
01;Araba/Álava;051;Agurain/Salvatierra;5155;2601;2554;2024
01;Araba/Álava;052;Samaniego;290;144;146;2024
01;Araba/Álava;053;San Millán/Donemiliaga;720;388;332;2024
01;Araba/Álava;054;Urkabustaiz;1462;761;701;2024
01;Araba/Álava;055;Valdegovía/Gaubea;1072;577;495;2024
01;Araba/Álava;056;Harana/Valle de Arana;214;117;97;2024
01;Araba/Álava;057;Villabuena de Álava/Eskuernaga;290;154;136;2024
01;Araba/Álava;058;Legutio;2086;1078;1008;2024
01;Araba/Álava;059;Vitoria-Gasteiz;257968;125412;132556;2024
01;Araba/Álava;060;Yécora/Iekora;265;143;122;2024
01;Araba/Álava;061;Zalduondo;194;105;89;2024
01;Araba/Álava;062;Zambrana;442;242;200;2024
01;Araba/Álava;063;Zuia;2372;1237;1135;2024
01;Araba/Álava;901;Iruña Oka/Iruña de Oca;3625;1923;1702;2024
01;Araba/Álava;902;Lantarón;926;531;395;2024
02;Albacete;001;Abengibre;759;374;385;2024
02;Albacete;002;Alatoz;497;267;230;2024
02;Albacete;003;Albacete;174137;85115;89022;2024
02;Albacete;004;Albatana;663;342;321;2024
02;Albacete;005;Alborea;676;363;313;2024
02;Albacete;006;Alcadozo;641;351;290;2024
02;Albacete;007;Alcalá del Júcar;1117;585;532;2024
02;Albacete;008;Alcaraz;1304;676;628;2024
02;Albacete;009;Almansa;24281;12041;12240;2024
02;Albacete;010;Alpera;2260;1192;1068;2024
02;Albacete;011;Ayna;608;337;271;2024
02;Albacete;012;Balazote;2379;1210;1169;2024
02;Albacete;013;Balsa de Ves;124;70;54;2024
02;Albacete;014;Ballestero, El;413;213;200;2024
02;Albacete;015;Barrax;1864;968;896;2024
02;Albacete;016;Bienservida;552;300;252;2024
02;Albacete;017;Bogarra;748;401;347;2024
02;Albacete;018;Bonete;970;506;464;2024
02;Albacete;019;Bonillo, El;2624;1342;1282;2024
02;Albacete;020;Carcelén;487;257;230;2024
02;Albacete;021;Casas de Juan Núñez;1361;730;631;2024
02;Albacete;022;Casas de Lázaro;311;180;131;2024
02;Albacete;023;Casas de Ves;548;290;258;2024
02;Albacete;024;Casas-Ibáñez;4591;2328;2263;2024
02;Albacete;025;Caudete;10249;5246;5003;2024
02;Albacete;026;Cenizate;1160;587;573;2024
02;Albacete;027;Corral-Rubio;302;161;141;2024
02;Albacete;028;Cotillas;126;72;54;2024
02;Albacete;029;Chinchilla de Monte-Aragón;4626;2395;2231;2024
02;Albacete;030;Elche de la Sierra;3596;1762;1834;2024
02;Albacete;031;Férez;605;298;307;2024
02;Albacete;032;Fuensanta;287;154;133;2024
02;Albacete;033;Fuente-Álamo;2417;1273;1144;2024
02;Albacete;034;Fuentealbilla;1799;941;858;2024
02;Albacete;035;Gineta, La;2635;1357;1278;2024
02;Albacete;036;Golosalvo;85;44;41;2024
02;Albacete;037;Hellín;30812;15493;15319;2024
02;Albacete;038;Herrera, La;303;161;142;2024
02;Albacete;039;Higueruela;1142;600;542;2024
02;Albacete;040;Hoya-Gonzalo;593;319;274;2024
02;Albacete;041;Jorquera;358;194;164;2024
02;Albacete;042;Letur;922;466;456;2024
02;Albacete;043;Lezuza;1305;688;617;2024
02;Albacete;044;Liétor;1063;552;511;2024
02;Albacete;045;Madrigueras;4658;2365;2293;2024
02;Albacete;046;Mahora;1465;762;703;2024
02;Albacete;047;Masegoso;116;68;48;2024
02;Albacete;048;Minaya;1387;694;693;2024
02;Albacete;049;Molinicos;785;403;382;2024
02;Albacete;050;Montalvos;81;48;33;2024
02;Albacete;051;Montealegre del Castillo;2038;1059;979;2024
02;Albacete;052;Motilleja;668;364;304;2024
02;Albacete;053;Munera;3395;1756;1639;2024
02;Albacete;054;Navas de Jorquera;533;282;251;2024
02;Albacete;055;Nerpio;1150;652;498;2024
02;Albacete;056;Ontur;1890;942;948;2024
02;Albacete;057;Ossa de Montiel;2216;1127;1089;2024
02;Albacete;058;Paterna del Madera;339;190;149;2024
02;Albacete;059;Peñascosa;328;187;141;2024
02;Albacete;060;Peñas de San Pedro;1466;867;599;2024
02;Albacete;061;Pétrola;665;354;311;2024
02;Albacete;062;Povedilla;392;210;182;2024
02;Albacete;063;Pozohondo;1553;818;735;2024
02;Albacete;064;Pozo-Lorente;386;201;185;2024
02;Albacete;065;Pozuelo;467;256;211;2024
02;Albacete;066;Recueja, La;221;121;100;2024
02;Albacete;067;Riópar;1353;686;667;2024
02;Albacete;068;Robledo;393;219;174;2024
02;Albacete;069;Roda, La;15610;7852;7758;2024
02;Albacete;070;Salobre;442;237;205;2024
02;Albacete;071;San Pedro;1185;607;578;2024
02;Albacete;072;Socovos;1662;871;791;2024
02;Albacete;073;Tarazona de la Mancha;6117;3144;2973;2024
02;Albacete;074;Tobarra;7947;4128;3819;2024
02;Albacete;075;Valdeganga;1961;1008;953;2024
02;Albacete;076;Vianos;320;165;155;2024
02;Albacete;077;Villa de Ves;55;32;23;2024
02;Albacete;078;Villalgordo del Júcar;1128;592;536;2024
02;Albacete;079;Villamalea;3973;2041;1932;2024
02;Albacete;080;Villapalacios;562;295;267;2024
02;Albacete;081;Villarrobledo;25262;12489;12773;2024
02;Albacete;082;Villatoya;113;67;46;2024
02;Albacete;083;Villavaliente;201;122;79;2024
02;Albacete;084;Villaverde de Guadalimar;310;167;143;2024
02;Albacete;085;Viveros;305;159;146;2024
02;Albacete;086;Yeste;2509;1310;1199;2024
02;Albacete;901;Pozo Cañada;2692;1371;1321;2024
03;Alicante/Alacant;001;Atzúbia, l';594;314;280;2024
03;Alicante/Alacant;002;Agost;5107;2586;2521;2024
03;Alicante/Alacant;003;Agres;610;327;283;2024
03;Alicante/Alacant;004;Aigües;1189;598;591;2024
03;Alicante/Alacant;005;Albatera;13296;6785;6511;2024
03;Alicante/Alacant;006;Alcalalí;1406;690;716;2024
03;Alicante/Alacant;007;Alcosser;259;129;130;2024
03;Alicante/Alacant;008;Alcoleja;186;100;86;2024
03;Alicante/Alacant;009;Alcoi/Alcoy;60372;29529;30843;2024
03;Alicante/Alacant;010;Alfafara;413;194;219;2024
03;Alicante/Alacant;011;Alfàs del Pi, l';20160;9890;10270;2024
03;Alicante/Alacant;012;Algorfa;3684;1848;1836;2024
03;Alicante/Alacant;013;Algueña;1342;684;658;2024
03;Alicante/Alacant;014;Alacant/Alicante;358720;173006;185714;2024
03;Alicante/Alacant;015;Almoradí;22464;11331;11133;2024
03;Alicante/Alacant;016;Almudaina;118;57;61;2024
03;Alicante/Alacant;017;Alqueria d'Asnar, l';519;254;265;2024
03;Alicante/Alacant;018;Altea;23963;11693;12270;2024
03;Alicante/Alacant;019;Aspe;21969;11046;10923;2024
03;Alicante/Alacant;020;Balones;131;66;65;2024
03;Alicante/Alacant;021;Banyeres de Mariola;7307;3724;3583;2024
03;Alicante/Alacant;022;Benasau;171;81;90;2024
03;Alicante/Alacant;023;Beneixama;1679;831;848;2024
03;Alicante/Alacant;024;Benejúzar;5697;2842;2855;2024
03;Alicante/Alacant;025;Benferri;2053;1049;1004;2024
03;Alicante/Alacant;026;Beniarbeig;2384;1195;1189;2024
03;Alicante/Alacant;027;Beniardà;235;119;116;2024
03;Alicante/Alacant;028;Beniarrés;1096;564;532;2024
03;Alicante/Alacant;029;Benigembla;559;276;283;2024
03;Alicante/Alacant;030;Benidoleig;1219;611;608;2024
03;Alicante/Alacant;031;Benidorm;74663;37089;37574;2024
03;Alicante/Alacant;032;Benifallim;116;64;52;2024
03;Alicante/Alacant;033;Benifato;144;81;63;2024
03;Alicante/Alacant;034;Benijófar;3471;1698;1773;2024
03;Alicante/Alacant;035;Benilloba;747;397;350;2024
03;Alicante/Alacant;036;Benillup;109;58;51;2024
03;Alicante/Alacant;037;Benimantell;548;276;272;2024
03;Alicante/Alacant;038;Benimarfull;447;237;210;2024
03;Alicante/Alacant;039;Benimassot;96;52;44;2024
03;Alicante/Alacant;040;Benimeli;453;202;251;2024
03;Alicante/Alacant;041;Benissa;12317;6072;6245;2024
03;Alicante/Alacant;042;Poble Nou de Benitatxell, el/Benitachell;4851;2408;2443;2024
03;Alicante/Alacant;043;Biar;3634;1777;1857;2024
03;Alicante/Alacant;044;Bigastro;7431;3743;3688;2024
03;Alicante/Alacant;045;Bolulla;486;250;236;2024
03;Alicante/Alacant;046;Busot;3629;1807;1822;2024
03;Alicante/Alacant;047;Calp;26821;13239;13582;2024
03;Alicante/Alacant;048;Callosa d'en Sarrià;7959;4140;3819;2024
03;Alicante/Alacant;049;Callosa de Segura;19658;10055;9603;2024
03;Alicante/Alacant;050;Campello, el;30600;14849;15751;2024
03;Alicante/Alacant;051;Camp de Mirra, el/Campo de Mirra;445;231;214;2024
03;Alicante/Alacant;052;Cañada;1225;611;614;2024
03;Alicante/Alacant;053;Castalla;11622;5887;5735;2024
03;Alicante/Alacant;054;Castell de Castells;444;228;216;2024
03;Alicante/Alacant;055;Catral;9423;4706;4717;2024
03;Alicante/Alacant;056;Cocentaina;11411;5755;5656;2024
03;Alicante/Alacant;057;Confrides;296;159;137;2024
03;Alicante/Alacant;058;Cox;7622;3838;3784;2024
03;Alicante/Alacant;059;Crevillent;30585;15491;15094;2024
03;Alicante/Alacant;060;Quatretondeta;134;74;60;2024
03;Alicante/Alacant;061;Daya Nueva;1832;886;946;2024
03;Alicante/Alacant;062;Daya Vieja;657;330;327;2024
03;Alicante/Alacant;063;Dénia;46942;22822;24120;2024
03;Alicante/Alacant;064;Dolores;8102;4075;4027;2024
03;Alicante/Alacant;065;Elx/Elche;243128;120333;122795;2024
03;Alicante/Alacant;066;Elda;53818;26301;27517;2024
03;Alicante/Alacant;067;Fageca;100;52;48;2024
03;Alicante/Alacant;068;Famorca;44;24;20;2024
03;Alicante/Alacant;069;Finestrat;9352;4768;4584;2024
03;Alicante/Alacant;070;Formentera del Segura;4749;2408;2341;2024
03;Alicante/Alacant;071;Gata de Gorgos;6659;3415;3244;2024
03;Alicante/Alacant;072;Gaianes;553;278;275;2024
03;Alicante/Alacant;073;Gorga;284;149;135;2024
03;Alicante/Alacant;074;Granja de Rocamora;2739;1416;1323;2024
03;Alicante/Alacant;075;Castell de Guadalest, el;282;134;148;2024
03;Alicante/Alacant;076;Guardamar del Segura;18111;8824;9287;2024
03;Alicante/Alacant;077;Fondó de les Neus, el/Hondón de las Nieves;2696;1394;1302;2024
03;Alicante/Alacant;078;Hondón de los Frailes;1310;680;630;2024
03;Alicante/Alacant;079;Ibi;24210;12053;12157;2024
03;Alicante/Alacant;080;Jacarilla;2122;1079;1043;2024
03;Alicante/Alacant;081;Xaló;3042;1516;1526;2024
03;Alicante/Alacant;082;Xàbia/Jávea;30131;15065;15066;2024
03;Alicante/Alacant;083;Xixona/Jijona;7307;3570;3737;2024
03;Alicante/Alacant;084;Orxa, l'/Lorcha;581;294;287;2024
03;Alicante/Alacant;085;Llíber;905;449;456;2024
03;Alicante/Alacant;086;Millena;249;136;113;2024
03;Alicante/Alacant;088;Monforte del Cid;8967;4637;4330;2024
03;Alicante/Alacant;089;Monòver/Monóvar;12764;6364;6400;2024
03;Alicante/Alacant;090;Mutxamel;27761;13895;13866;2024
03;Alicante/Alacant;091;Murla;585;278;307;2024
03;Alicante/Alacant;092;Muro de Alcoy;9345;4717;4628;2024
03;Alicante/Alacant;093;Novelda;26213;13018;13195;2024
03;Alicante/Alacant;094;Nucia, la;18783;9522;9261;2024
03;Alicante/Alacant;095;Ondara;7522;3764;3758;2024
03;Alicante/Alacant;096;Onil;7959;4017;3942;2024
03;Alicante/Alacant;097;Orba;2387;1141;1246;2024
03;Alicante/Alacant;098;Orxeta;879;447;432;2024
03;Alicante/Alacant;099;Orihuela;83720;41427;42293;2024
03;Alicante/Alacant;100;Parcent;1021;496;525;2024
03;Alicante/Alacant;101;Pedreguer;8687;4325;4362;2024
03;Alicante/Alacant;102;Pego;10632;5300;5332;2024
03;Alicante/Alacant;103;Penàguila;293;146;147;2024
03;Alicante/Alacant;104;Petrer;34076;16803;17273;2024
03;Alicante/Alacant;105;Pinós, el/Pinoso;8407;4257;4150;2024
03;Alicante/Alacant;106;Planes;696;372;324;2024
03;Alicante/Alacant;107;Polop;5650;2832;2818;2024
03;Alicante/Alacant;109;Rafal;4900;2435;2465;2024
03;Alicante/Alacant;110;Ràfol d'Almúnia, el;703;360;343;2024
03;Alicante/Alacant;111;Redován;8285;4289;3996;2024
03;Alicante/Alacant;112;Relleu;1288;665;623;2024
03;Alicante/Alacant;113;Rojales;17162;8693;8469;2024
03;Alicante/Alacant;114;Romana, la;2672;1396;1276;2024
03;Alicante/Alacant;115;Sagra;441;217;224;2024
03;Alicante/Alacant;116;Salinas;1775;919;856;2024
03;Alicante/Alacant;117;Sanet y Negrals;722;364;358;2024
03;Alicante/Alacant;118;San Fulgencio;9433;4707;4726;2024
03;Alicante/Alacant;119;Sant Joan d'Alacant;25918;12524;13394;2024
03;Alicante/Alacant;120;San Miguel de Salinas;6976;3494;3482;2024
03;Alicante/Alacant;121;Santa Pola;38556;19193;19363;2024
03;Alicante/Alacant;122;Sant Vicent del Raspeig/San Vicente del Raspeig;60269;29791;30478;2024
03;Alicante/Alacant;123;Sax;10172;5069;5103;2024
03;Alicante/Alacant;124;Sella;604;318;286;2024
03;Alicante/Alacant;125;Senija;696;357;339;2024
03;Alicante/Alacant;127;Tàrbena;634;336;298;2024
03;Alicante/Alacant;128;Teulada;12834;6422;6412;2024
03;Alicante/Alacant;129;Tibi;1803;945;858;2024
03;Alicante/Alacant;130;Tollos;38;26;12;2024
03;Alicante/Alacant;131;Tormos;328;158;170;2024
03;Alicante/Alacant;132;Torre de les Maçanes, la/Torremanzanas;744;393;351;2024
03;Alicante/Alacant;133;Torrevieja;94803;46076;48727;2024
03;Alicante/Alacant;134;Vall d'Alcalà, la;175;90;85;2024
03;Alicante/Alacant;135;Vall d'Ebo, la;230;121;109;2024
03;Alicante/Alacant;136;Vall de Gallinera, la;584;296;288;2024
03;Alicante/Alacant;137;Vall de Laguar, la;903;455;448;2024
03;Alicante/Alacant;138;Verger, el;5272;2599;2673;2024
03;Alicante/Alacant;139;Vila Joiosa, la/Villajoyosa;36891;18204;18687;2024
03;Alicante/Alacant;140;Villena;34385;17238;17147;2024
03;Alicante/Alacant;901;Poblets, els;2684;1279;1405;2024
03;Alicante/Alacant;902;Pilar de la Horadada;23844;12199;11645;2024
03;Alicante/Alacant;903;Montesinos, Los;5682;2873;2809;2024
03;Alicante/Alacant;904;San Isidro;2312;1186;1126;2024
04;Almería;001;Abla;1272;656;616;2024
04;Almería;002;Abrucena;1235;650;585;2024
04;Almería;003;Adra;25515;13049;12466;2024
04;Almería;004;Albanchez;682;367;315;2024
04;Almería;005;Alboloduy;585;284;301;2024
04;Almería;006;Albox;12408;6336;6072;2024
04;Almería;007;Alcolea;829;432;397;2024
04;Almería;008;Alcóntar;557;308;249;2024
04;Almería;009;Alcudia de Monteagud;128;66;62;2024
04;Almería;010;Alhabia;725;395;330;2024
04;Almería;011;Alhama de Almería;3878;1980;1898;2024
04;Almería;012;Alicún;215;106;109;2024
04;Almería;013;Almería;202675;98600;104075;2024
04;Almería;014;Almócita;210;108;102;2024
04;Almería;015;Alsodux;138;78;60;2024
04;Almería;016;Antas;3450;1818;1632;2024
04;Almería;017;Arboleas;4319;2172;2147;2024
04;Almería;018;Armuña de Almanzora;331;166;165;2024
04;Almería;019;Bacares;239;127;112;2024
04;Almería;020;Bayárcal;296;156;140;2024
04;Almería;021;Bayarque;224;106;118;2024
04;Almería;022;Bédar;976;489;487;2024
04;Almería;023;Beires;148;83;65;2024
04;Almería;024;Benahadux;4808;2381;2427;2024
04;Almería;026;Benitagla;60;34;26;2024
04;Almería;027;Benizalón;252;146;106;2024
04;Almería;028;Bentarique;227;123;104;2024
04;Almería;029;Berja;12939;6661;6278;2024
04;Almería;030;Canjáyar;1134;593;541;2024
04;Almería;031;Cantoria;3569;1798;1771;2024
04;Almería;032;Carboneras;8441;4314;4127;2024
04;Almería;033;Castro de Filabres;101;54;47;2024
04;Almería;034;Cóbdar;190;106;84;2024
04;Almería;035;Cuevas del Almanzora;15246;7928;7318;2024
04;Almería;036;Chercos;303;157;146;2024
04;Almería;037;Chirivel;1567;815;752;2024
04;Almería;038;Dalías;4169;2076;2093;2024
04;Almería;041;Enix;598;325;273;2024
04;Almería;043;Felix;770;449;321;2024
04;Almería;044;Fines;2286;1215;1071;2024
04;Almería;045;Fiñana;1984;1008;976;2024
04;Almería;046;Fondón;1133;587;546;2024
04;Almería;047;Gádor;3067;1616;1451;2024
04;Almería;048;Gallardos, Los;3071;1532;1539;2024
04;Almería;049;Garrucha;10603;5528;5075;2024
04;Almería;050;Gérgal;1191;654;537;2024
04;Almería;051;Huécija;537;261;276;2024
04;Almería;052;Huércal de Almería;18584;9387;9197;2024
04;Almería;053;Huércal-Overa;20609;10260;10349;2024
04;Almería;054;Íllar;460;237;223;2024
04;Almería;055;Instinción;498;255;243;2024
04;Almería;056;Laroya;209;116;93;2024
04;Almería;057;Láujar de Andarax;1658;840;818;2024
04;Almería;058;Líjar;393;210;183;2024
04;Almería;059;Lubrín;1428;717;711;2024
04;Almería;060;Lucainena de las Torres;714;369;345;2024
04;Almería;061;Lúcar;825;412;413;2024
04;Almería;062;Macael;5428;2763;2665;2024
04;Almería;063;María;1195;616;579;2024
04;Almería;064;Mojácar;7517;3689;3828;2024
04;Almería;065;Nacimiento;501;261;240;2024
04;Almería;066;Níjar;33076;18800;14276;2024
04;Almería;067;Ohanes;547;283;264;2024
04;Almería;068;Olula de Castro;181;101;80;2024
04;Almería;069;Olula del Río;6429;3290;3139;2024
04;Almería;070;Oria;2199;1148;1051;2024
04;Almería;071;Padules;440;238;202;2024
04;Almería;072;Partaloa;875;438;437;2024
04;Almería;073;Paterna del Río;396;219;177;2024
04;Almería;074;Pechina;4463;2308;2155;2024
04;Almería;075;Pulpí;11906;6183;5723;2024
04;Almería;076;Purchena;1533;779;754;2024
04;Almería;077;Rágol;298;155;143;2024
04;Almería;078;Rioja;1589;819;770;2024
04;Almería;079;Roquetas de Mar;109204;56839;52365;2024
04;Almería;080;Santa Cruz de Marchena;245;132;113;2024
04;Almería;081;Santa Fe de Mondújar;494;250;244;2024
04;Almería;082;Senés;278;155;123;2024
04;Almería;083;Serón;2133;1105;1028;2024
04;Almería;084;Sierro;376;207;169;2024
04;Almería;085;Somontín;524;275;249;2024
04;Almería;086;Sorbas;2525;1299;1226;2024
04;Almería;087;Suflí;231;120;111;2024
04;Almería;088;Tabernas;4097;2127;1970;2024
04;Almería;089;Taberno;962;476;486;2024
04;Almería;090;Tahal;375;194;181;2024
04;Almería;091;Terque;384;205;179;2024
04;Almería;092;Tíjola;3549;1783;1766;2024
04;Almería;093;Turre;4209;2166;2043;2024
04;Almería;094;Turrillas;268;152;116;2024
04;Almería;095;Uleila del Campo;816;409;407;2024
04;Almería;096;Urrácal;350;183;167;2024
04;Almería;097;Velefique;246;140;106;2024
04;Almería;098;Vélez-Blanco;1933;995;938;2024
04;Almería;099;Vélez-Rubio;6613;3224;3389;2024
04;Almería;100;Vera;19488;9925;9563;2024
04;Almería;101;Viator;6271;3192;3079;2024
04;Almería;102;Vícar;28835;15574;13261;2024
04;Almería;103;Zurgena;2990;1537;1453;2024
04;Almería;901;Tres Villas, Las;574;318;256;2024
04;Almería;902;Ejido, El;90135;47231;42904;2024
04;Almería;903;Mojonera, La;8677;4747;3930;2024
04;Almería;904;Balanegra;3016;1586;1430;2024
05;Ávila;001;Adanero;208;120;88;2024
05;Ávila;002;Adrada, La;2796;1428;1368;2024
05;Ávila;005;Albornos;175;92;83;2024
05;Ávila;007;Aldeanueva de Santa Cruz;102;55;47;2024
05;Ávila;008;Aldeaseca;203;103;100;2024
05;Ávila;010;Aldehuela, La;143;73;70;2024
05;Ávila;012;Amavida;133;72;61;2024
05;Ávila;013;Arenal, El;978;476;502;2024
05;Ávila;014;Arenas de San Pedro;6438;3130;3308;2024
05;Ávila;015;Arevalillo;58;27;31;2024
05;Ávila;016;Arévalo;7830;3815;4015;2024
05;Ávila;017;Aveinte;73;42;31;2024
05;Ávila;018;Avellaneda;23;15;8;2024
05;Ávila;019;Ávila;58111;27616;30495;2024
05;Ávila;021;Barco de Ávila, El;2297;1108;1189;2024
05;Ávila;022;Barraco, El;2027;1015;1012;2024
05;Ávila;023;Barromán;175;95;80;2024
05;Ávila;024;Becedas;151;83;68;2024
05;Ávila;025;Becedillas;69;37;32;2024
05;Ávila;026;Bercial de Zapardiel;173;90;83;2024
05;Ávila;027;Berlanas, Las;323;170;153;2024
05;Ávila;029;Bernuy-Zapardiel;84;49;35;2024
05;Ávila;030;Berrocalejo de Aragona;56;31;25;2024
05;Ávila;033;Blascomillán;170;85;85;2024
05;Ávila;034;Blasconuño de Matacabras;14;9;5;2024
05;Ávila;035;Blascosancho;100;51;49;2024
05;Ávila;036;Bohodón, El;110;56;54;2024
05;Ávila;037;Bohoyo;214;126;88;2024
05;Ávila;038;Bonilla de la Sierra;163;94;69;2024
05;Ávila;039;Brabos;35;23;12;2024
05;Ávila;040;Bularros;55;38;17;2024
05;Ávila;041;Burgohondo;1249;668;581;2024
05;Ávila;042;Cabezas de Alambre;153;70;83;2024
05;Ávila;043;Cabezas del Pozo;82;41;41;2024
05;Ávila;044;Cabezas del Villar;224;128;96;2024
05;Ávila;045;Cabizuela;88;46;42;2024
05;Ávila;046;Canales;35;19;16;2024
05;Ávila;047;Candeleda;5031;2516;2515;2024
05;Ávila;048;Cantiveros;99;60;39;2024
05;Ávila;049;Cardeñosa;419;225;194;2024
05;Ávila;051;Carrera, La;160;86;74;2024
05;Ávila;052;Casas del Puerto;83;42;41;2024
05;Ávila;053;Casasola;63;37;26;2024
05;Ávila;054;Casavieja;1394;718;676;2024
05;Ávila;055;Casillas;669;368;301;2024
05;Ávila;056;Castellanos de Zapardiel;113;61;52;2024
05;Ávila;057;Cebreros;3239;1679;1560;2024
05;Ávila;058;Cepeda la Mora;66;38;28;2024
05;Ávila;059;Cillán;79;47;32;2024
05;Ávila;060;Cisla;102;55;47;2024
05;Ávila;061;Colilla, La;375;191;184;2024
05;Ávila;062;Collado de Contreras;145;76;69;2024
05;Ávila;063;Collado del Mirón;20;11;9;2024
05;Ávila;064;Constanzana;99;59;40;2024
05;Ávila;065;Crespos;482;257;225;2024
05;Ávila;066;Cuevas del Valle;517;285;232;2024
05;Ávila;067;Chamartín;62;35;27;2024
05;Ávila;069;Donjimeno;72;40;32;2024
05;Ávila;070;Donvidas;36;22;14;2024
05;Ávila;072;Espinosa de los Caballeros;97;51;46;2024
05;Ávila;073;Flores de Ávila;270;142;128;2024
05;Ávila;074;Fontiveros;725;377;348;2024
05;Ávila;075;Fresnedilla;97;50;47;2024
05;Ávila;076;Fresno, El;591;308;283;2024
05;Ávila;077;Fuente el Saúz;151;85;66;2024
05;Ávila;078;Fuentes de Año;88;51;37;2024
05;Ávila;079;Gallegos de Altamiros;60;38;22;2024
05;Ávila;080;Gallegos de Sobrinos;45;23;22;2024
05;Ávila;081;Garganta del Villar;39;25;14;2024
05;Ávila;082;Gavilanes;529;288;241;2024
05;Ávila;083;Gemuño;142;76;66;2024
05;Ávila;084;Gilbuena;47;32;15;2024
05;Ávila;085;Gil García;48;25;23;2024
05;Ávila;086;Gimialcón;66;43;23;2024
05;Ávila;087;Gotarrendura;167;61;106;2024
05;Ávila;088;Grandes y San Martín;32;15;17;2024
05;Ávila;089;Guisando;474;245;229;2024
05;Ávila;090;Gutierre-Muñoz;64;32;32;2024
05;Ávila;092;Hernansancho;142;80;62;2024
05;Ávila;093;Herradón de Pinares;495;267;228;2024
05;Ávila;094;Herreros de Suso;140;80;60;2024
05;Ávila;095;Higuera de las Dueñas;270;155;115;2024
05;Ávila;096;Hija de Dios, La;75;47;28;2024
05;Ávila;097;Horcajada, La;457;229;228;2024
05;Ávila;099;Horcajo de las Torres;441;248;193;2024
05;Ávila;100;Hornillo, El;280;151;129;2024
05;Ávila;101;Hoyocasero;311;176;135;2024
05;Ávila;102;Hoyo de Pinares, El;2183;1132;1051;2024
05;Ávila;103;Hoyorredondo;59;32;27;2024
05;Ávila;104;Hoyos del Collado;30;17;13;2024
05;Ávila;105;Hoyos del Espino;344;179;165;2024
05;Ávila;106;Hoyos de Miguel Muñoz;27;14;13;2024
05;Ávila;107;Hurtumpascual;42;26;16;2024
05;Ávila;108;Junciana;40;22;18;2024
05;Ávila;109;Langa;450;231;219;2024
05;Ávila;110;Lanzahíta;788;404;384;2024
05;Ávila;112;Losar del Barco, El;103;59;44;2024
05;Ávila;113;Llanos de Tormes, Los;63;28;35;2024
05;Ávila;114;Madrigal de las Altas Torres;1299;667;632;2024
05;Ávila;115;Maello;700;379;321;2024
05;Ávila;116;Malpartida de Corneja;91;46;45;2024
05;Ávila;117;Mamblas;196;111;85;2024
05;Ávila;118;Mancera de Arriba;70;37;33;2024
05;Ávila;119;Manjabálago y Ortigosa de Rioalmar;26;13;13;2024
05;Ávila;120;Marlín;31;21;10;2024
05;Ávila;121;Martiherrero;361;189;172;2024
05;Ávila;122;Martínez;108;55;53;2024
05;Ávila;123;Mediana de Voltoya;117;61;56;2024
05;Ávila;124;Medinilla;77;41;36;2024
05;Ávila;125;Mengamuñoz;54;28;26;2024
05;Ávila;126;Mesegar de Corneja;66;36;30;2024
05;Ávila;127;Mijares;731;398;333;2024
05;Ávila;128;Mingorría;410;216;194;2024
05;Ávila;129;Mirón, El;98;61;37;2024
05;Ávila;130;Mironcillo;112;59;53;2024
05;Ávila;131;Mirueña de los Infanzones;95;51;44;2024
05;Ávila;132;Mombeltrán;916;479;437;2024
05;Ávila;133;Monsalupe;59;32;27;2024
05;Ávila;134;Moraleja de Matacabras;53;29;24;2024
05;Ávila;135;Muñana;502;269;233;2024
05;Ávila;136;Muñico;80;47;33;2024
05;Ávila;138;Muñogalindo;300;151;149;2024
05;Ávila;139;Muñogrande;74;38;36;2024
05;Ávila;140;Muñomer del Peco;111;62;49;2024
05;Ávila;141;Muñopepe;104;54;50;2024
05;Ávila;142;Muñosancho;88;46;42;2024
05;Ávila;143;Muñotello;49;27;22;2024
05;Ávila;144;Narrillos del Álamo;59;33;26;2024
05;Ávila;145;Narrillos del Rebollar;34;21;13;2024
05;Ávila;147;Narros del Castillo;152;85;67;2024
05;Ávila;148;Narros del Puerto;28;15;13;2024
05;Ávila;149;Narros de Saldueña;106;54;52;2024
05;Ávila;151;Navacepedilla de Corneja;100;55;45;2024
05;Ávila;152;Nava de Arévalo;663;337;326;2024
05;Ávila;153;Nava del Barco;83;46;37;2024
05;Ávila;154;Navadijos;29;19;10;2024
05;Ávila;155;Navaescurial;53;32;21;2024
05;Ávila;156;Navahondilla;353;206;147;2024
05;Ávila;157;Navalacruz;204;121;83;2024
05;Ávila;158;Navalmoral;412;220;192;2024
05;Ávila;159;Navalonguilla;185;90;95;2024
05;Ávila;160;Navalosa;324;188;136;2024
05;Ávila;161;Navalperal de Pinares;826;440;386;2024
05;Ávila;162;Navalperal de Tormes;77;46;31;2024
05;Ávila;163;Navaluenga;2172;1083;1089;2024
05;Ávila;164;Navaquesera;43;23;20;2024
05;Ávila;165;Navarredonda de Gredos;446;234;212;2024
05;Ávila;166;Navarredondilla;158;90;68;2024
05;Ávila;167;Navarrevisca;299;168;131;2024
05;Ávila;168;Navas del Marqués, Las;5590;2860;2730;2024
05;Ávila;169;Navatalgordo;237;137;100;2024
05;Ávila;170;Navatejares;50;23;27;2024
05;Ávila;171;Neila de San Miguel;62;34;28;2024
05;Ávila;172;Niharra;183;109;74;2024
05;Ávila;173;Ojos-Albos;96;50;46;2024
05;Ávila;174;Orbita;69;37;32;2024
05;Ávila;175;Oso, El;129;78;51;2024
05;Ávila;176;Padiernos;275;150;125;2024
05;Ávila;177;Pajares de Adaja;127;69;58;2024
05;Ávila;178;Palacios de Goda;397;215;182;2024
05;Ávila;179;Papatrigo;219;106;113;2024
05;Ávila;180;Parral, El;62;39;23;2024
05;Ávila;181;Pascualcobo;39;27;12;2024
05;Ávila;182;Pedro Bernardo;758;398;360;2024
05;Ávila;183;Pedro-Rodríguez;134;68;66;2024
05;Ávila;184;Peguerinos;294;162;132;2024
05;Ávila;185;Peñalba de Ávila;105;56;49;2024
05;Ávila;186;Piedrahíta;1637;797;840;2024
05;Ávila;187;Piedralaves;2150;1077;1073;2024
05;Ávila;188;Poveda;33;18;15;2024
05;Ávila;189;Poyales del Hoyo;487;270;217;2024
05;Ávila;190;Pozanco;60;37;23;2024
05;Ávila;191;Pradosegar;117;64;53;2024
05;Ávila;192;Puerto Castilla;98;62;36;2024
05;Ávila;193;Rasueros;160;91;69;2024
05;Ávila;194;Riocabado;125;76;49;2024
05;Ávila;195;Riofrío;191;121;70;2024
05;Ávila;196;Rivilla de Barajas;56;26;30;2024
05;Ávila;197;Salobral;102;57;45;2024
05;Ávila;198;Salvadiós;71;37;34;2024
05;Ávila;199;San Bartolomé de Béjar;49;24;25;2024
05;Ávila;200;San Bartolomé de Corneja;35;19;16;2024
05;Ávila;201;San Bartolomé de Pinares;489;268;221;2024
05;Ávila;204;Sanchidrián;708;355;353;2024
05;Ávila;205;Sanchorreja;79;42;37;2024
05;Ávila;206;San Esteban de los Patos;20;13;7;2024
05;Ávila;207;San Esteban del Valle;734;376;358;2024
05;Ávila;208;San Esteban de Zapardiel;40;21;19;2024
05;Ávila;209;San García de Ingelmos;66;45;21;2024
05;Ávila;210;San Juan de la Encinilla;70;36;34;2024
05;Ávila;211;San Juan de la Nava;426;239;187;2024
05;Ávila;212;San Juan del Molinillo;234;128;106;2024
05;Ávila;213;San Juan del Olmo;81;51;30;2024
05;Ávila;214;San Lorenzo de Tormes;30;15;15;2024
05;Ávila;215;San Martín de la Vega del Alberche;153;92;61;2024
05;Ávila;216;San Martín del Pimpollar;219;126;93;2024
05;Ávila;217;San Miguel de Corneja;70;38;32;2024
05;Ávila;218;San Miguel de Serrezuela;106;61;45;2024
05;Ávila;219;San Pascual;45;26;19;2024
05;Ávila;220;San Pedro del Arroyo;501;262;239;2024
05;Ávila;221;Santa Cruz del Valle;304;159;145;2024
05;Ávila;222;Santa Cruz de Pinares;170;101;69;2024
05;Ávila;224;Santa María del Arroyo;102;55;47;2024
05;Ávila;225;Santa María del Berrocal;382;193;189;2024
05;Ávila;226;Santa María de los Caballeros;72;44;28;2024
05;Ávila;227;Santa María del Tiétar;553;293;260;2024
05;Ávila;228;Santiago del Collado;162;101;61;2024
05;Ávila;229;Santo Domingo de las Posadas;69;37;32;2024
05;Ávila;230;Santo Tomé de Zabarcos;71;41;30;2024
05;Ávila;231;San Vicente de Arévalo;165;92;73;2024
05;Ávila;232;Serrada, La;135;72;63;2024
05;Ávila;233;Serranillos;252;141;111;2024
05;Ávila;234;Sigeres;41;20;21;2024
05;Ávila;235;Sinlabajos;135;61;74;2024
05;Ávila;236;Solana de Ávila;100;62;38;2024
05;Ávila;237;Solana de Rioalmar;138;79;59;2024
05;Ávila;238;Solosancho;758;411;347;2024
05;Ávila;239;Sotalbo;245;146;99;2024
05;Ávila;240;Sotillo de la Adrada;5003;2464;2539;2024
05;Ávila;241;Tiemblo, El;4526;2313;2213;2024
05;Ávila;242;Tiñosillos;756;391;365;2024
05;Ávila;243;Tolbaños;86;50;36;2024
05;Ávila;244;Tormellas;35;23;12;2024
05;Ávila;245;Tornadizos de Ávila;465;226;239;2024
05;Ávila;246;Tórtoles;38;22;16;2024
05;Ávila;247;Torre, La;212;117;95;2024
05;Ávila;249;Umbrías;100;50;50;2024
05;Ávila;251;Vadillo de la Sierra;51;33;18;2024
05;Ávila;252;Valdecasa;56;35;21;2024
05;Ávila;253;Vega de Santa María;86;43;43;2024
05;Ávila;254;Velayos;217;112;105;2024
05;Ávila;256;Villaflor;99;53;46;2024
05;Ávila;257;Villafranca de la Sierra;134;78;56;2024
05;Ávila;258;Villanueva de Gómez;115;65;50;2024
05;Ávila;259;Villanueva del Aceral;92;41;51;2024
05;Ávila;260;Villanueva del Campillo;101;56;45;2024
05;Ávila;261;Villar de Corneja;36;23;13;2024
05;Ávila;262;Villarejo del Valle;314;171;143;2024
05;Ávila;263;Villatoro;161;90;71;2024
05;Ávila;264;Viñegra de Moraña;48;24;24;2024
05;Ávila;265;Vita;71;42;29;2024
05;Ávila;266;Zapardiel de la Cañada;84;45;39;2024
05;Ávila;267;Zapardiel de la Ribera;92;45;47;2024
05;Ávila;901;San Juan de Gredos;228;126;102;2024
05;Ávila;902;Santa María del Cubillo;322;178;144;2024
05;Ávila;903;Diego del Carpio;106;66;40;2024
05;Ávila;904;Santiago del Tormes;107;57;50;2024
05;Ávila;905;Villanueva de Ávila;227;123;104;2024
06;Badajoz;001;Acedera;802;415;387;2024
06;Badajoz;002;Aceuchal;5404;2681;2723;2024
06;Badajoz;003;Ahillones;784;395;389;2024
06;Badajoz;004;Alange;1808;930;878;2024
06;Badajoz;005;Albuera, La;1992;1025;967;2024
06;Badajoz;006;Alburquerque;4998;2503;2495;2024
06;Badajoz;007;Alconchel;1626;819;807;2024
06;Badajoz;008;Alconera;756;381;375;2024
06;Badajoz;009;Aljucén;255;136;119;2024
06;Badajoz;010;Almendral;1197;600;597;2024
06;Badajoz;011;Almendralejo;34284;16949;17335;2024
06;Badajoz;012;Arroyo de San Serván;4061;2032;2029;2024
06;Badajoz;013;Atalaya;258;130;128;2024
06;Badajoz;014;Azuaga;7595;3770;3825;2024
06;Badajoz;015;Badajoz;150570;72810;77760;2024
06;Badajoz;016;Barcarrota;3473;1764;1709;2024
06;Badajoz;017;Baterno;238;134;104;2024
06;Badajoz;018;Benquerencia de la Serena;789;399;390;2024
06;Badajoz;019;Berlanga;2214;1107;1107;2024
06;Badajoz;020;Bienvenida;2021;1031;990;2024
06;Badajoz;021;Bodonal de la Sierra;993;506;487;2024
06;Badajoz;022;Burguillos del Cerro;2970;1460;1510;2024
06;Badajoz;023;Cabeza del Buey;4526;2268;2258;2024
06;Badajoz;024;Cabeza la Vaca;1255;649;606;2024
06;Badajoz;025;Calamonte;6120;3043;3077;2024
06;Badajoz;026;Calera de León;918;468;450;2024
06;Badajoz;027;Calzadilla de los Barros;685;347;338;2024
06;Badajoz;028;Campanario;4705;2324;2381;2024
06;Badajoz;029;Campillo de Llerena;1314;644;670;2024
06;Badajoz;030;Capilla;145;77;68;2024
06;Badajoz;031;Carmonita;520;262;258;2024
06;Badajoz;032;Carrascalejo, El;77;41;36;2024
06;Badajoz;033;Casas de Don Pedro;1370;711;659;2024
06;Badajoz;034;Casas de Reina;207;107;100;2024
06;Badajoz;035;Castilblanco;844;424;420;2024
06;Badajoz;036;Castuera;5497;2747;2750;2024
06;Badajoz;037;Codosera, La;2025;1044;981;2024
06;Badajoz;038;Cordobilla de Lácara;827;434;393;2024
06;Badajoz;039;Coronada, La;2148;1052;1096;2024
06;Badajoz;040;Corte de Peleas;1165;576;589;2024
06;Badajoz;041;Cristina;547;280;267;2024
06;Badajoz;042;Cheles;1177;576;601;2024
06;Badajoz;043;Don Álvaro;815;431;384;2024
06;Badajoz;044;Don Benito;37728;18563;19165;2024
06;Badajoz;045;Entrín Bajo;540;277;263;2024
06;Badajoz;046;Esparragalejo;1494;742;752;2024
06;Badajoz;047;Esparragosa de la Serena;933;472;461;2024
06;Badajoz;048;Esparragosa de Lares;854;424;430;2024
06;Badajoz;049;Feria;1047;510;537;2024
06;Badajoz;050;Fregenal de la Sierra;4743;2312;2431;2024
06;Badajoz;051;Fuenlabrada de los Montes;1709;837;872;2024
06;Badajoz;052;Fuente de Cantos;4592;2283;2309;2024
06;Badajoz;053;Fuente del Arco;660;338;322;2024
06;Badajoz;054;Fuente del Maestre;6567;3251;3316;2024
06;Badajoz;055;Fuentes de León;2158;1065;1093;2024
06;Badajoz;056;Garbayuela;475;252;223;2024
06;Badajoz;057;Garlitos;530;262;268;2024
06;Badajoz;058;Garrovilla, La;2292;1139;1153;2024
06;Badajoz;059;Granja de Torrehermosa;1900;942;958;2024
06;Badajoz;060;Guareña;6649;3312;3337;2024
06;Badajoz;061;Haba, La;1214;606;608;2024
06;Badajoz;062;Helechosa de los Montes;562;331;231;2024
06;Badajoz;063;Herrera del Duque;3399;1708;1691;2024
06;Badajoz;064;Higuera de la Serena;887;457;430;2024
06;Badajoz;065;Higuera de Llerena;339;172;167;2024
06;Badajoz;066;Higuera de Vargas;1856;943;913;2024
06;Badajoz;067;Higuera la Real;2202;1110;1092;2024
06;Badajoz;068;Hinojosa del Valle;480;227;253;2024
06;Badajoz;069;Hornachos;3396;1713;1683;2024
06;Badajoz;070;Jerez de los Caballeros;9112;4472;4640;2024
06;Badajoz;071;Lapa, La;293;151;142;2024
06;Badajoz;072;Lobón;2734;1404;1330;2024
06;Badajoz;073;Llera;802;402;400;2024
06;Badajoz;074;Llerena;5645;2814;2831;2024
06;Badajoz;075;Magacela;498;255;243;2024
06;Badajoz;076;Maguilla;929;468;461;2024
06;Badajoz;077;Malcocinado;346;195;151;2024
06;Badajoz;078;Malpartida de la Serena;518;268;250;2024
06;Badajoz;079;Manchita;737;370;367;2024
06;Badajoz;080;Medellín;2237;1138;1099;2024
06;Badajoz;081;Medina de las Torres;1166;614;552;2024
06;Badajoz;082;Mengabril;491;265;226;2024
06;Badajoz;083;Mérida;59857;29061;30796;2024
06;Badajoz;084;Mirandilla;1246;619;627;2024
06;Badajoz;085;Monesterio;4230;2143;2087;2024
06;Badajoz;086;Montemolín;1267;615;652;2024
06;Badajoz;087;Monterrubio de la Serena;2199;1081;1118;2024
06;Badajoz;088;Montijo;15232;7532;7700;2024
06;Badajoz;089;Morera, La;704;358;346;2024
06;Badajoz;090;Nava de Santiago, La;914;457;457;2024
06;Badajoz;091;Navalvillar de Pela;4345;2185;2160;2024
06;Badajoz;092;Nogales;640;316;324;2024
06;Badajoz;093;Oliva de la Frontera;4936;2475;2461;2024
06;Badajoz;094;Oliva de Mérida;1679;848;831;2024
06;Badajoz;095;Olivenza;11742;5824;5918;2024
06;Badajoz;096;Orellana de la Sierra;261;140;121;2024
06;Badajoz;097;Orellana la Vieja;2573;1322;1251;2024
06;Badajoz;098;Palomas;662;330;332;2024
06;Badajoz;099;Parra, La;1284;661;623;2024
06;Badajoz;100;Peñalsordo;824;405;419;2024
06;Badajoz;101;Peraleda del Zaucejo;479;244;235;2024
06;Badajoz;102;Puebla de Alcocer;1107;550;557;2024
06;Badajoz;103;Puebla de la Calzada;5859;2940;2919;2024
06;Badajoz;104;Puebla de la Reina;695;341;354;2024
06;Badajoz;105;Puebla del Maestre;658;343;315;2024
06;Badajoz;106;Puebla del Prior;460;239;221;2024
06;Badajoz;107;Puebla de Obando;1806;915;891;2024
06;Badajoz;108;Puebla de Sancho Pérez;2635;1326;1309;2024
06;Badajoz;109;Quintana de la Serena;4455;2262;2193;2024
06;Badajoz;110;Reina;142;76;66;2024
06;Badajoz;111;Rena;613;320;293;2024
06;Badajoz;112;Retamal de Llerena;429;227;202;2024
06;Badajoz;113;Ribera del Fresno;3187;1587;1600;2024
06;Badajoz;114;Risco;127;62;65;2024
06;Badajoz;115;Roca de la Sierra, La;1453;713;740;2024
06;Badajoz;116;Salvaleón;1656;838;818;2024
06;Badajoz;117;Salvatierra de los Barros;1559;767;792;2024
06;Badajoz;118;Sancti-Spíritus;145;82;63;2024
06;Badajoz;119;San Pedro de Mérida;861;444;417;2024
06;Badajoz;120;Santa Amalia;3920;1967;1953;2024
06;Badajoz;121;Santa Marta;4145;2077;2068;2024
06;Badajoz;122;Santos de Maimona, Los;8070;4063;4007;2024
06;Badajoz;123;San Vicente de Alcántara;5204;2618;2586;2024
06;Badajoz;124;Segura de León;1792;896;896;2024
06;Badajoz;125;Siruela;1771;897;874;2024
06;Badajoz;126;Solana de los Barros;2542;1269;1273;2024
06;Badajoz;127;Talarrubias;3259;1641;1618;2024
06;Badajoz;128;Talavera la Real;5298;2645;2653;2024
06;Badajoz;129;Táliga;660;329;331;2024
06;Badajoz;130;Tamurejo;199;99;100;2024
06;Badajoz;131;Torre de Miguel Sesmero;1241;626;615;2024
06;Badajoz;132;Torremayor;1004;491;513;2024
06;Badajoz;133;Torremejía;2222;1150;1072;2024
06;Badajoz;134;Trasierra;593;309;284;2024
06;Badajoz;135;Trujillanos;1382;693;689;2024
06;Badajoz;136;Usagre;1723;853;870;2024
06;Badajoz;137;Valdecaballeros;1051;537;514;2024
06;Badajoz;138;Valdetorres;1135;558;577;2024
06;Badajoz;139;Valencia de las Torres;480;256;224;2024
06;Badajoz;140;Valencia del Mombuey;713;369;344;2024
06;Badajoz;141;Valencia del Ventoso;1885;953;932;2024
06;Badajoz;142;Valverde de Burguillos;270;141;129;2024
06;Badajoz;143;Valverde de Leganés;4218;2096;2122;2024
06;Badajoz;144;Valverde de Llerena;566;287;279;2024
06;Badajoz;145;Valverde de Mérida;1010;515;495;2024
06;Badajoz;146;Valle de la Serena;1093;557;536;2024
06;Badajoz;147;Valle de Matamoros;332;168;164;2024
06;Badajoz;148;Valle de Santa Ana;1107;548;559;2024
06;Badajoz;149;Villafranca de los Barros;12362;6079;6283;2024
06;Badajoz;150;Villagarcía de la Torre;891;442;449;2024
06;Badajoz;151;Villagonzalo;1223;598;625;2024
06;Badajoz;152;Villalba de los Barros;1447;720;727;2024
06;Badajoz;153;Villanueva de la Serena;25784;12529;13255;2024
06;Badajoz;154;Villanueva del Fresno;3274;1658;1616;2024
06;Badajoz;155;Villar del Rey;2080;1116;964;2024
06;Badajoz;156;Villar de Rena;1323;685;638;2024
06;Badajoz;157;Villarta de los Montes;395;205;190;2024
06;Badajoz;158;Zafra;16711;7991;8720;2024
06;Badajoz;159;Zahínos;2765;1380;1385;2024
06;Badajoz;160;Zalamea de la Serena;3431;1734;1697;2024
06;Badajoz;161;Zarza-Capilla;299;147;152;2024
06;Badajoz;162;Zarza, La;3345;1686;1659;2024
06;Badajoz;901;Valdelacalzada;2755;1385;1370;2024
06;Badajoz;902;Pueblonuevo del Guadiana;1953;970;983;2024
06;Badajoz;903;Guadiana;2437;1188;1249;2024
07;Balears, Illes;001;Alaró;6037;2915;3122;2024
07;Balears, Illes;002;Alaior;10042;5047;4995;2024
07;Balears, Illes;003;Alcúdia;21683;11142;10541;2024
07;Balears, Illes;004;Algaida;6311;3212;3099;2024
07;Balears, Illes;005;Andratx;12062;6051;6011;2024
07;Balears, Illes;006;Artà;8387;4245;4142;2024
07;Balears, Illes;007;Banyalbufar;577;313;264;2024
07;Balears, Illes;008;Binissalem;9281;4618;4663;2024
07;Balears, Illes;009;Búger;1199;632;567;2024
07;Balears, Illes;010;Bunyola;7490;3663;3827;2024
07;Balears, Illes;011;Calvià;53491;26716;26775;2024
07;Balears, Illes;012;Campanet;2824;1396;1428;2024
07;Balears, Illes;013;Campos;12163;6095;6068;2024
07;Balears, Illes;014;Capdepera;12860;6520;6340;2024
07;Balears, Illes;015;Ciutadella de Menorca;31941;15920;16021;2024
07;Balears, Illes;016;Consell;4399;2192;2207;2024
07;Balears, Illes;017;Costitx;1516;749;767;2024
07;Balears, Illes;018;Deià;717;352;365;2024
07;Balears, Illes;019;Escorca;203;127;76;2024
07;Balears, Illes;020;Esporles;5252;2572;2680;2024
07;Balears, Illes;021;Estellencs;374;199;175;2024
07;Balears, Illes;022;Felanitx;18850;9481;9369;2024
07;Balears, Illes;023;Ferreries;5114;2536;2578;2024
07;Balears, Illes;024;Formentera;11389;5831;5558;2024
07;Balears, Illes;025;Fornalutx;715;348;367;2024
07;Balears, Illes;026;Eivissa;53717;26990;26727;2024
07;Balears, Illes;027;Inca;35654;17963;17691;2024
07;Balears, Illes;028;Lloret de Vistalegre;1619;815;804;2024
07;Balears, Illes;029;Lloseta;6456;3280;3176;2024
07;Balears, Illes;030;Llubí;2505;1256;1249;2024
07;Balears, Illes;031;Llucmajor;39912;20159;19753;2024
07;Balears, Illes;032;Maó;30419;14843;15576;2024
07;Balears, Illes;033;Manacor;47777;24062;23715;2024
07;Balears, Illes;034;Mancor de la Vall;1702;855;847;2024
07;Balears, Illes;035;Maria de la Salut;2397;1234;1163;2024
07;Balears, Illes;036;Marratxí;40079;20103;19976;2024
07;Balears, Illes;037;Mercadal, Es;6215;3165;3050;2024
07;Balears, Illes;038;Montuïri;3216;1622;1594;2024
07;Balears, Illes;039;Muro;8115;4099;4016;2024
07;Balears, Illes;040;Palma;431521;211093;220428;2024
07;Balears, Illes;041;Petra;3184;1569;1615;2024
07;Balears, Illes;042;Pollença;17594;8760;8834;2024
07;Balears, Illes;043;Porreres;5888;3001;2887;2024
07;Balears, Illes;044;Pobla, Sa;14630;7370;7260;2024
07;Balears, Illes;045;Puigpunyent;2035;1012;1023;2024
07;Balears, Illes;046;Sant Antoni de Portmany;28609;14933;13676;2024
07;Balears, Illes;047;Sencelles;3900;2000;1900;2024
07;Balears, Illes;048;Sant Josep de sa Talaia;29664;15252;14412;2024
07;Balears, Illes;049;Sant Joan;2228;1112;1116;2024
07;Balears, Illes;050;Sant Joan de Labritja;6948;3499;3449;2024
07;Balears, Illes;051;Sant Llorenç des Cardassar;9331;4693;4638;2024
07;Balears, Illes;052;Sant Lluís;7130;3604;3526;2024
07;Balears, Illes;053;Santa Eugènia;1899;952;947;2024
07;Balears, Illes;054;Santa Eulària des Riu;41706;21182;20524;2024
07;Balears, Illes;055;Santa Margalida;13757;7123;6634;2024
07;Balears, Illes;056;Santa María del Camí;7623;3810;3813;2024
07;Balears, Illes;057;Santanyí;12887;6463;6424;2024
07;Balears, Illes;058;Selva;4294;2100;2194;2024
07;Balears, Illes;059;Salines, Ses;5129;2539;2590;2024
07;Balears, Illes;060;Sineu;4469;2220;2249;2024
07;Balears, Illes;061;Sóller;13744;6787;6957;2024
07;Balears, Illes;062;Son Servera;12261;6043;6218;2024
07;Balears, Illes;063;Valldemossa;2016;1029;987;2024
07;Balears, Illes;064;Castell, Es;7772;3919;3853;2024
07;Balears, Illes;065;Vilafranca de Bonany;3816;1926;1890;2024
07;Balears, Illes;901;Ariany;1018;557;461;2024
07;Balears, Illes;902;Migjorn Gran, Es;1690;872;818;2024
08;Barcelona;001;Abrera;13014;6534;6480;2024
08;Barcelona;002;Aguilar de Segarra;291;156;135;2024
08;Barcelona;003;Alella;10217;4977;5240;2024
08;Barcelona;004;Alpens;270;146;124;2024
08;Barcelona;005;Ametlla del Vallès, L';9462;4764;4698;2024
08;Barcelona;006;Arenys de Mar;16642;8060;8582;2024
08;Barcelona;007;Arenys de Munt;9458;4761;4697;2024
08;Barcelona;008;Argençola;237;121;116;2024
08;Barcelona;009;Argentona;12844;6336;6508;2024
08;Barcelona;010;Artés;6084;3057;3027;2024
08;Barcelona;011;Avià;2243;1117;1126;2024
08;Barcelona;012;Avinyó;2313;1166;1147;2024
08;Barcelona;013;Avinyonet del Penedès;1744;922;822;2024
08;Barcelona;014;Aiguafreda;2576;1257;1319;2024
08;Barcelona;015;Badalona;227083;111688;115395;2024
08;Barcelona;016;Bagà;2182;1076;1106;2024
08;Barcelona;017;Balenyà;4036;2067;1969;2024
08;Barcelona;018;Balsareny;3328;1676;1652;2024
08;Barcelona;019;Barcelona;1702547;812544;890003;2024
08;Barcelona;020;Begues;7462;3701;3761;2024
08;Barcelona;021;Bellprat;69;42;27;2024
08;Barcelona;022;Berga;17160;8440;8720;2024
08;Barcelona;023;Bigues i Riells del Fai;10036;5101;4935;2024
08;Barcelona;024;Borredà;419;237;182;2024
08;Barcelona;025;Bruc, El;2288;1202;1086;2024
08;Barcelona;026;Brull, El;293;159;134;2024
08;Barcelona;027;Cabanyes, Les;1012;511;501;2024
08;Barcelona;028;Cabrera d'Anoia;1709;907;802;2024
08;Barcelona;029;Cabrera de Mar;5018;2529;2489;2024
08;Barcelona;030;Cabrils;7767;3855;3912;2024
08;Barcelona;031;Calaf;3618;1829;1789;2024
08;Barcelona;032;Caldes d'Estrac;3259;1567;1692;2024
08;Barcelona;033;Caldes de Montbui;18336;9139;9197;2024
08;Barcelona;034;Calders;1114;573;541;2024
08;Barcelona;035;Calella;20369;9807;10562;2024
08;Barcelona;036;Calonge de Segarra;174;91;83;2024
08;Barcelona;037;Calldetenes;2690;1373;1317;2024
08;Barcelona;038;Callús;2145;1036;1109;2024
08;Barcelona;039;Campins;606;299;307;2024
08;Barcelona;040;Canet de Mar;15140;7363;7777;2024
08;Barcelona;041;Canovelles;17312;8955;8357;2024
08;Barcelona;042;Cànoves i Samalús;3315;1691;1624;2024
08;Barcelona;043;Canyelles;5367;2802;2565;2024
08;Barcelona;044;Capellades;5567;2785;2782;2024
08;Barcelona;045;Capolat;92;43;49;2024
08;Barcelona;046;Cardedeu;19064;9189;9875;2024
08;Barcelona;047;Cardona;4574;2261;2313;2024
08;Barcelona;048;Carme;814;424;390;2024
08;Barcelona;049;Casserres;1676;832;844;2024
08;Barcelona;050;Castellar del Riu;163;90;73;2024
08;Barcelona;051;Castellar del Vallès;25322;12478;12844;2024
08;Barcelona;052;Castellar de n'Hug;164;85;79;2024
08;Barcelona;053;Castellbell i el Vilar;4138;2134;2004;2024
08;Barcelona;054;Castellbisbal;12972;6497;6475;2024
08;Barcelona;055;Castellcir;784;401;383;2024
08;Barcelona;056;Castelldefels;69450;33927;35523;2024
08;Barcelona;057;Castell de l'Areny;69;39;30;2024
08;Barcelona;058;Castellet i la Gornal;2674;1385;1289;2024
08;Barcelona;059;Castellfollit del Boix;459;235;224;2024
08;Barcelona;060;Castellfollit de Riubregós;151;84;67;2024
08;Barcelona;061;Castellgalí;2347;1214;1133;2024
08;Barcelona;062;Castellnou de Bages;1430;742;688;2024
08;Barcelona;063;Castellolí;658;310;348;2024
08;Barcelona;064;Castellterçol;2773;1434;1339;2024
08;Barcelona;065;Castellví de la Marca;1716;888;828;2024
08;Barcelona;066;Castellví de Rosanes;2106;1040;1066;2024
08;Barcelona;067;Centelles;7775;3801;3974;2024
08;Barcelona;068;Cervelló;9647;4868;4779;2024
08;Barcelona;069;Collbató;4849;2491;2358;2024
08;Barcelona;070;Collsuspina;389;195;194;2024
08;Barcelona;071;Copons;351;179;172;2024
08;Barcelona;072;Corbera de Llobregat;15726;7997;7729;2024
08;Barcelona;073;Cornellà de Llobregat;91589;44342;47247;2024
08;Barcelona;074;Cubelles;17243;8681;8562;2024
08;Barcelona;075;Dosrius;6142;3081;3061;2024
08;Barcelona;076;Esparreguera;22550;11385;11165;2024
08;Barcelona;077;Esplugues de Llobregat;47613;22621;24992;2024
08;Barcelona;078;Espunyola, L';262;130;132;2024
08;Barcelona;079;Estany, L';401;218;183;2024
08;Barcelona;080;Fígols;41;21;20;2024
08;Barcelona;081;Fogars de Montclús;502;275;227;2024
08;Barcelona;082;Fogars de la Selva;1680;881;799;2024
08;Barcelona;083;Folgueroles;2263;1141;1122;2024
08;Barcelona;084;Fonollosa;1585;802;783;2024
08;Barcelona;085;Font-rubí;1446;783;663;2024
08;Barcelona;086;Franqueses del Vallès, Les;20715;10446;10269;2024
08;Barcelona;087;Gallifa;172;93;79;2024
08;Barcelona;088;Garriga, La;17305;8315;8990;2024
08;Barcelona;089;Gavà;48007;23304;24703;2024
08;Barcelona;090;Gaià;178;89;89;2024
08;Barcelona;091;Gelida;8098;4059;4039;2024
08;Barcelona;092;Gironella;5055;2490;2565;2024
08;Barcelona;093;Gisclareny;30;17;13;2024
08;Barcelona;094;Granada, La;2263;1122;1141;2024
08;Barcelona;095;Granera;84;51;33;2024
08;Barcelona;096;Granollers;64181;31770;32411;2024
08;Barcelona;097;Gualba;1738;886;852;2024
08;Barcelona;098;Sant Salvador de Guardiola;3476;1784;1692;2024
08;Barcelona;099;Guardiola de Berguedà;953;481;472;2024
08;Barcelona;100;Gurb;2712;1398;1314;2024
08;Barcelona;101;Hospitalet de Llobregat, L';279993;136077;143916;2024
08;Barcelona;102;Igualada;41466;20446;21020;2024
08;Barcelona;103;Jorba;827;424;403;2024
08;Barcelona;104;Llacuna, La;982;512;470;2024
08;Barcelona;105;Llagosta, La;13085;6455;6630;2024
08;Barcelona;106;Llinars del Vallès;10740;5317;5423;2024
08;Barcelona;107;Lliçà d'Amunt;16253;8252;8001;2024
08;Barcelona;108;Lliçà de Vall;6861;3490;3371;2024
08;Barcelona;109;Lluçà;288;145;143;2024
08;Barcelona;110;Malgrat de Mar;19377;9530;9847;2024
08;Barcelona;111;Malla;272;135;137;2024
08;Barcelona;112;Manlleu;21348;10702;10646;2024
08;Barcelona;113;Manresa;80201;39458;40743;2024
08;Barcelona;114;Martorell;28507;14385;14122;2024
08;Barcelona;115;Martorelles;4987;2499;2488;2024
08;Barcelona;116;Masies de Roda, Les;750;385;365;2024
08;Barcelona;117;Masies de Voltregà, Les;3292;1626;1666;2024
08;Barcelona;118;Masnou, El;24479;11764;12715;2024
08;Barcelona;119;Masquefa;10038;5094;4944;2024
08;Barcelona;120;Matadepera;9815;4938;4877;2024
08;Barcelona;121;Mataró;131798;65435;66363;2024
08;Barcelona;122;Mediona;2637;1360;1277;2024
08;Barcelona;123;Molins de Rei;26948;13106;13842;2024
08;Barcelona;124;Mollet del Vallès;52283;25673;26610;2024
08;Barcelona;125;Montcada i Reixac;37153;18252;18901;2024
08;Barcelona;126;Montgat;12625;6221;6404;2024
08;Barcelona;127;Monistrol de Montserrat;3198;1657;1541;2024
08;Barcelona;128;Monistrol de Calders;761;405;356;2024
08;Barcelona;129;Muntanyola;712;375;337;2024
08;Barcelona;130;Montclar;132;67;65;2024
08;Barcelona;131;Montesquiu;1099;548;551;2024
08;Barcelona;132;Montmajor;472;243;229;2024
08;Barcelona;133;Montmaneu;200;111;89;2024
08;Barcelona;134;Figaró-Montmany;1188;572;616;2024
08;Barcelona;135;Montmeló;8906;4386;4520;2024
08;Barcelona;136;Montornès del Vallès;17089;8614;8475;2024
08;Barcelona;137;Montseny;380;197;183;2024
08;Barcelona;138;Moià;6738;3480;3258;2024
08;Barcelona;139;Mura;232;121;111;2024
08;Barcelona;140;Navarcles;6160;3032;3128;2024
08;Barcelona;141;Navàs;6185;3043;3142;2024
08;Barcelona;142;Nou de Berguedà, La;163;84;79;2024
08;Barcelona;143;Òdena;3710;1901;1809;2024
08;Barcelona;144;Olvan;913;459;454;2024
08;Barcelona;145;Olèrdola;3946;2059;1887;2024
08;Barcelona;146;Olesa de Bonesvalls;2093;1086;1007;2024
08;Barcelona;147;Olesa de Montserrat;24677;12292;12385;2024
08;Barcelona;148;Olivella;4419;2296;2123;2024
08;Barcelona;149;Olost;1216;604;612;2024
08;Barcelona;150;Orís;350;181;169;2024
08;Barcelona;151;Oristà;569;296;273;2024
08;Barcelona;152;Orpí;178;95;83;2024
08;Barcelona;153;Òrrius;805;405;400;2024
08;Barcelona;154;Pacs del Penedès;935;474;461;2024
08;Barcelona;155;Palafolls;9938;5000;4938;2024
08;Barcelona;156;Palau-solità i Plegamans;15456;7556;7900;2024
08;Barcelona;157;Pallejà;11825;5874;5951;2024
08;Barcelona;158;Papiol, El;4363;2186;2177;2024
08;Barcelona;159;Parets del Vallès;18881;9464;9417;2024
08;Barcelona;160;Perafita;438;226;212;2024
08;Barcelona;161;Piera;17555;9052;8503;2024
08;Barcelona;162;Hostalets de Pierola, Els;3231;1652;1579;2024
08;Barcelona;163;Pineda de Mar;29455;14594;14861;2024
08;Barcelona;164;Pla del Penedès, El;1352;680;672;2024
08;Barcelona;165;Pobla de Claramunt, La;2353;1202;1151;2024
08;Barcelona;166;Pobla de Lillet, La;1109;534;575;2024
08;Barcelona;167;Polinyà;8555;4293;4262;2024
08;Barcelona;168;Pontons;518;288;230;2024
08;Barcelona;169;Prat de Llobregat, El;66184;32406;33778;2024
08;Barcelona;170;Prats de Rei, Els;553;298;255;2024
08;Barcelona;171;Prats de Lluçanès;2688;1340;1348;2024
08;Barcelona;172;Premià de Mar;28951;14136;14815;2024
08;Barcelona;174;Puigdàlber;629;310;319;2024
08;Barcelona;175;Puig-reig;4489;2268;2221;2024
08;Barcelona;176;Pujalt;210;115;95;2024
08;Barcelona;177;Quar, La;42;28;14;2024
08;Barcelona;178;Rajadell;594;310;284;2024
08;Barcelona;179;Rellinars;920;494;426;2024
08;Barcelona;180;Ripollet;39462;19520;19942;2024
08;Barcelona;181;Roca del Vallès, La;10962;5507;5455;2024
08;Barcelona;182;Pont de Vilomara i Rocafort, El;4140;2134;2006;2024
08;Barcelona;183;Roda de Ter;6900;3512;3388;2024
08;Barcelona;184;Rubí;81532;40263;41269;2024
08;Barcelona;185;Rubió;237;134;103;2024
08;Barcelona;187;Sabadell;222177;107922;114255;2024
08;Barcelona;188;Sagàs;153;85;68;2024
08;Barcelona;189;Sant Pere Sallavinera;158;82;76;2024
08;Barcelona;190;Saldes;301;168;133;2024
08;Barcelona;191;Sallent;6927;3391;3536;2024
08;Barcelona;192;Santpedor;7716;3851;3865;2024
08;Barcelona;193;Sant Iscle de Vallalta;1458;748;710;2024
08;Barcelona;194;Sant Adrià de Besòs;38490;18952;19538;2024
08;Barcelona;195;Sant Agustí de Lluçanès;108;55;53;2024
08;Barcelona;196;Sant Andreu de la Barca;27062;13298;13764;2024
08;Barcelona;197;Sant Andreu de Llavaneres;11933;5856;6077;2024
08;Barcelona;198;Sant Antoni de Vilamajor;6668;3282;3386;2024
08;Barcelona;199;Sant Bartomeu del Grau;943;498;445;2024
08;Barcelona;200;Sant Boi de Llobregat;84831;41216;43615;2024
08;Barcelona;201;Sant Boi de Lluçanès;575;298;277;2024
08;Barcelona;202;Sant Celoni;18761;9343;9418;2024
08;Barcelona;203;Sant Cebrià de Vallalta;3828;1971;1857;2024
08;Barcelona;204;Sant Climent de Llobregat;4182;2099;2083;2024
08;Barcelona;205;Sant Cugat del Vallès;98621;48036;50585;2024
08;Barcelona;206;Sant Cugat Sesgarrigues;1031;516;515;2024
08;Barcelona;207;Sant Esteve de Palautordera;3080;1531;1549;2024
08;Barcelona;208;Sant Esteve Sesrovires;8060;4018;4042;2024
08;Barcelona;209;Sant Fost de Campsentelles;9227;4589;4638;2024
08;Barcelona;210;Sant Feliu de Codines;6661;3344;3317;2024
08;Barcelona;211;Sant Feliu de Llobregat;46554;22563;23991;2024
08;Barcelona;212;Sant Feliu Sasserra;629;335;294;2024
08;Barcelona;213;Sant Fruitós de Bages;9248;4595;4653;2024
08;Barcelona;214;Vilassar de Dalt;9281;4573;4708;2024
08;Barcelona;215;Sant Hipòlit de Voltregà;3687;1863;1824;2024
08;Barcelona;216;Sant Jaume de Frontanyà;26;13;13;2024
08;Barcelona;217;Sant Joan Despí;35083;16955;18128;2024
08;Barcelona;218;Sant Joan de Vilatorrada;11017;5457;5560;2024
08;Barcelona;219;Vilassar de Mar;21162;10108;11054;2024
08;Barcelona;220;Sant Julià de Vilatorta;3297;1639;1658;2024
08;Barcelona;221;Sant Just Desvern;20881;10033;10848;2024
08;Barcelona;222;Sant Llorenç d'Hortons;2617;1324;1293;2024
08;Barcelona;223;Sant Llorenç Savall;2586;1290;1296;2024
08;Barcelona;224;Sant Martí de Centelles;1259;644;615;2024
08;Barcelona;225;Sant Martí d'Albars;140;73;67;2024
08;Barcelona;226;Sant Martí de Tous;1275;640;635;2024
08;Barcelona;227;Sant Martí Sarroca;3391;1690;1701;2024
08;Barcelona;228;Sant Martí Sesgueioles;360;182;178;2024
08;Barcelona;229;Sant Mateu de Bages;637;332;305;2024
08;Barcelona;230;Premià de Dalt;10594;5282;5312;2024
08;Barcelona;231;Sant Pere de Ribes;32121;15838;16283;2024
08;Barcelona;232;Sant Pere de Riudebitlles;2497;1271;1226;2024
08;Barcelona;233;Sant Pere de Torelló;2592;1340;1252;2024
08;Barcelona;234;Sant Pere de Vilamajor;4941;2513;2428;2024
08;Barcelona;235;Sant Pol de Mar;5834;2826;3008;2024
08;Barcelona;236;Sant Quintí de Mediona;2504;1268;1236;2024
08;Barcelona;237;Sant Quirze de Besora;2127;1025;1102;2024
08;Barcelona;238;Sant Quirze del Vallès;20161;9839;10322;2024
08;Barcelona;239;Sant Quirze Safaja;669;361;308;2024
08;Barcelona;240;Sant Sadurní d'Anoia;12915;6354;6561;2024
08;Barcelona;241;Sant Sadurní d'Osormort;84;50;34;2024
08;Barcelona;242;Marganell;308;154;154;2024
08;Barcelona;243;Santa Cecília de Voltregà;192;103;89;2024
08;Barcelona;244;Santa Coloma de Cervelló;8335;4026;4309;2024
08;Barcelona;245;Santa Coloma de Gramenet;121203;59958;61245;2024
08;Barcelona;246;Santa Eugènia de Berga;2308;1173;1135;2024
08;Barcelona;247;Santa Eulàlia de Riuprimer;1487;747;740;2024
08;Barcelona;248;Santa Eulàlia de Ronçana;7911;3959;3952;2024
08;Barcelona;249;Santa Fe del Penedès;360;176;184;2024
08;Barcelona;250;Santa Margarida de Montbui;10549;5308;5241;2024
08;Barcelona;251;Santa Margarida i els Monjos;7736;3937;3799;2024
08;Barcelona;252;Barberà del Vallès;33575;16436;17139;2024
08;Barcelona;253;Santa Maria de Besora;164;89;75;2024
08;Barcelona;254;Esquirol, L';2277;1134;1143;2024
08;Barcelona;255;Santa Maria de Merlès;175;91;84;2024
08;Barcelona;256;Santa Maria de Martorelles;873;444;429;2024
08;Barcelona;257;Santa Maria de Miralles;137;71;66;2024
08;Barcelona;258;Santa Maria d'Oló;1077;545;532;2024
08;Barcelona;259;Santa Maria de Palautordera;10008;5006;5002;2024
08;Barcelona;260;Santa Perpètua de Mogoda;25960;12974;12986;2024
08;Barcelona;261;Santa Susanna;4023;1998;2025;2024
08;Barcelona;262;Sant Vicenç de Castellet;10131;5091;5040;2024
08;Barcelona;263;Sant Vicenç dels Horts;28568;14200;14368;2024
08;Barcelona;264;Sant Vicenç de Montalt;6712;3342;3370;2024
08;Barcelona;265;Sant Vicenç de Torelló;2092;1042;1050;2024
08;Barcelona;266;Cerdanyola del Vallès;58100;28164;29936;2024
08;Barcelona;267;Sentmenat;9553;4817;4736;2024
08;Barcelona;268;Cercs;1193;609;584;2024
08;Barcelona;269;Seva;3798;1960;1838;2024
08;Barcelona;270;Sitges;32405;16258;16147;2024
08;Barcelona;271;Sobremunt;101;41;60;2024
08;Barcelona;272;Sora;219;117;102;2024
08;Barcelona;273;Subirats;3281;1683;1598;2024
08;Barcelona;274;Súria;6090;2954;3136;2024
08;Barcelona;275;Tavèrnoles;341;178;163;2024
08;Barcelona;276;Tagamanent;339;186;153;2024
08;Barcelona;277;Talamanca;212;119;93;2024
08;Barcelona;278;Taradell;6844;3441;3403;2024
08;Barcelona;279;Terrassa;228708;112376;116332;2024
08;Barcelona;280;Tavertet;131;72;59;2024
08;Barcelona;281;Teià;6818;3376;3442;2024
08;Barcelona;282;Tiana;9305;4524;4781;2024
08;Barcelona;283;Tona;8511;4218;4293;2024
08;Barcelona;284;Tordera;18780;9504;9276;2024
08;Barcelona;285;Torelló;15093;7582;7511;2024
08;Barcelona;286;Torre de Claramunt, La;4122;2134;1988;2024
08;Barcelona;287;Torrelavit;1509;790;719;2024
08;Barcelona;288;Torrelles de Foix;2657;1398;1259;2024
08;Barcelona;289;Torrelles de Llobregat;6155;3069;3086;2024
08;Barcelona;290;Ullastrell;2176;1088;1088;2024
08;Barcelona;291;Vacarisses;7563;3865;3698;2024
08;Barcelona;292;Vallbona d'Anoia;1406;721;685;2024
08;Barcelona;293;Vallcebre;271;142;129;2024
08;Barcelona;294;Vallgorguina;3198;1638;1560;2024
08;Barcelona;295;Vallirana;15985;7984;8001;2024
08;Barcelona;296;Vallromanes;2742;1395;1347;2024
08;Barcelona;297;Veciana;172;95;77;2024
08;Barcelona;298;Vic;49530;25055;24475;2024
08;Barcelona;299;Vilada;443;241;202;2024
08;Barcelona;300;Viladecavalls;7802;3867;3935;2024
08;Barcelona;301;Viladecans;67348;33197;34151;2024
08;Barcelona;302;Vilanova del Camí;12844;6436;6408;2024
08;Barcelona;303;Vilanova de Sau;317;157;160;2024
08;Barcelona;304;Vilobí del Penedès;1150;595;555;2024
08;Barcelona;305;Vilafranca del Penedès;41504;20239;21265;2024
08;Barcelona;306;Vilalba Sasserra;780;394;386;2024
08;Barcelona;307;Vilanova i la Geltrú;70418;34058;36360;2024
08;Barcelona;308;Viver i Serrateix;175;89;86;2024
08;Barcelona;901;Rupit i Pruit;281;138;143;2024
08;Barcelona;902;Vilanova del Vallès;5632;2871;2761;2024
08;Barcelona;903;Sant Julià de Cerdanyola;232;130;102;2024
08;Barcelona;904;Badia del Vallès;13118;6397;6721;2024
08;Barcelona;905;Palma de Cervelló, La;3044;1484;1560;2024
09;Burgos;001;Abajas;28;17;11;2024
09;Burgos;003;Adrada de Haza;205;99;106;2024
09;Burgos;006;Aguas Cándidas;59;40;19;2024
09;Burgos;007;Aguilar de Bureba;50;32;18;2024
09;Burgos;009;Albillos;214;120;94;2024
09;Burgos;010;Alcocero de Mola;41;28;13;2024
09;Burgos;011;Alfoz de Bricia;68;46;22;2024
09;Burgos;012;Alfoz de Santa Gadea;101;54;47;2024
09;Burgos;013;Altable;47;28;19;2024
09;Burgos;014;Altos, Los;186;111;75;2024
09;Burgos;016;Ameyugo;108;54;54;2024
09;Burgos;017;Anguix;156;98;58;2024
09;Burgos;018;Aranda de Duero;33757;16363;17394;2024
09;Burgos;019;Arandilla;155;101;54;2024
09;Burgos;020;Arauzo de Miel;274;154;120;2024
09;Burgos;021;Arauzo de Salce;46;22;24;2024
09;Burgos;022;Arauzo de Torre;61;36;25;2024
09;Burgos;023;Arcos;1835;963;872;2024
09;Burgos;024;Arenillas de Riopisuerga;166;101;65;2024
09;Burgos;025;Arija;115;64;51;2024
09;Burgos;026;Arlanzón;424;260;164;2024
09;Burgos;027;Arraya de Oca;53;29;24;2024
09;Burgos;029;Atapuerca;180;106;74;2024
09;Burgos;030;Ausines, Los;165;101;64;2024
09;Burgos;032;Avellanosa de Muñó;96;52;44;2024
09;Burgos;033;Bahabón de Esgueva;84;47;37;2024
09;Burgos;034;Balbases, Los;302;164;138;2024
09;Burgos;035;Baños de Valdearados;318;180;138;2024
09;Burgos;036;Bañuelos de Bureba;31;20;11;2024
09;Burgos;037;Barbadillo de Herreros;104;63;41;2024
09;Burgos;038;Barbadillo del Mercado;134;73;61;2024
09;Burgos;039;Barbadillo del Pez;66;39;27;2024
09;Burgos;041;Barrio de Muñó;32;19;13;2024
09;Burgos;043;Barrios de Bureba, Los;178;96;82;2024
09;Burgos;044;Barrios de Colina;55;29;26;2024
09;Burgos;045;Basconcillos del Tozo;294;177;117;2024
09;Burgos;046;Bascuñana;18;12;6;2024
09;Burgos;047;Belbimbre;54;28;26;2024
09;Burgos;048;Belorado;1834;931;903;2024
09;Burgos;050;Berberana;48;27;21;2024
09;Burgos;051;Berlangas de Roa;203;112;91;2024
09;Burgos;052;Berzosa de Bureba;26;18;8;2024
09;Burgos;054;Bozoó;102;63;39;2024
09;Burgos;055;Brazacorta;45;30;15;2024
09;Burgos;056;Briviesca;6560;3308;3252;2024
09;Burgos;057;Bugedo;189;118;71;2024
09;Burgos;058;Buniel;612;336;276;2024
09;Burgos;059;Burgos;175895;83667;92228;2024
09;Burgos;060;Busto de Bureba;143;80;63;2024
09;Burgos;061;Cabañes de Esgueva;149;85;64;2024
09;Burgos;062;Cabezón de la Sierra;36;16;20;2024
09;Burgos;063;Cavia;248;148;100;2024
09;Burgos;064;Caleruega;400;214;186;2024
09;Burgos;065;Campillo de Aranda;171;96;75;2024
09;Burgos;066;Campolara;48;34;14;2024
09;Burgos;067;Canicosa de la Sierra;424;227;197;2024
09;Burgos;068;Cantabrana;23;15;8;2024
09;Burgos;070;Carazo;39;26;13;2024
09;Burgos;071;Carcedo de Bureba;37;19;18;2024
09;Burgos;072;Carcedo de Burgos;484;261;223;2024
09;Burgos;073;Cardeñadijo;1430;773;657;2024
09;Burgos;074;Cardeñajimeno;1169;619;550;2024
09;Burgos;075;Cardeñuela Riopico;111;64;47;2024
09;Burgos;076;Carrias;24;18;6;2024
09;Burgos;077;Cascajares de Bureba;27;17;10;2024
09;Burgos;078;Cascajares de la Sierra;27;15;12;2024
09;Burgos;079;Castellanos de Castro;46;28;18;2024
09;Burgos;082;Castildelgado;35;20;15;2024
09;Burgos;083;Castil de Peones;28;15;13;2024
09;Burgos;084;Castrillo de la Reina;158;105;53;2024
09;Burgos;085;Castrillo de la Vega;621;332;289;2024
09;Burgos;086;Castrillo del Val;823;453;370;2024
09;Burgos;088;Castrillo de Riopisuerga;58;35;23;2024
09;Burgos;090;Castrillo Mota de Judíos;52;28;24;2024
09;Burgos;091;Castrojeriz;778;411;367;2024
09;Burgos;093;Cayuela;189;111;78;2024
09;Burgos;094;Cebrecos;58;35;23;2024
09;Burgos;095;Celada del Camino;90;47;43;2024
09;Burgos;098;Cerezo de Río Tirón;490;272;218;2024
09;Burgos;100;Cerratón de Juarros;45;32;13;2024
09;Burgos;101;Ciadoncha;70;45;25;2024
09;Burgos;102;Cillaperlata;30;21;9;2024
09;Burgos;103;Cilleruelo de Abajo;209;121;88;2024
09;Burgos;104;Cilleruelo de Arriba;49;27;22;2024
09;Burgos;105;Ciruelos de Cervera;99;56;43;2024
09;Burgos;108;Cogollos;677;385;292;2024
09;Burgos;109;Condado de Treviño;1489;820;669;2024
09;Burgos;110;Contreras;87;53;34;2024
09;Burgos;112;Coruña del Conde;100;65;35;2024
09;Burgos;113;Covarrubias;505;281;224;2024
09;Burgos;114;Cubillo del Campo;101;55;46;2024
09;Burgos;115;Cubo de Bureba;101;58;43;2024
09;Burgos;117;Cueva de Roa, La;89;49;40;2024
09;Burgos;119;Cuevas de San Clemente;45;23;22;2024
09;Burgos;120;Encío;41;22;19;2024
09;Burgos;122;Espinosa de Cervera;85;54;31;2024
09;Burgos;123;Espinosa del Camino;42;24;18;2024
09;Burgos;124;Espinosa de los Monteros;1648;850;798;2024
09;Burgos;125;Estépar;634;367;267;2024
09;Burgos;127;Fontioso;54;33;21;2024
09;Burgos;128;Frandovínez;96;53;43;2024
09;Burgos;129;Fresneda de la Sierra Tirón;97;58;39;2024
09;Burgos;130;Fresneña;66;43;23;2024
09;Burgos;131;Fresnillo de las Dueñas;693;370;323;2024
09;Burgos;132;Fresno de Río Tirón;160;95;65;2024
09;Burgos;133;Fresno de Rodilla;49;28;21;2024
09;Burgos;134;Frías;270;139;131;2024
09;Burgos;135;Fuentebureba;56;33;23;2024
09;Burgos;136;Fuentecén;237;131;106;2024
09;Burgos;137;Fuentelcésped;273;144;129;2024
09;Burgos;138;Fuentelisendo;99;56;43;2024
09;Burgos;139;Fuentemolinos;91;62;29;2024
09;Burgos;140;Fuentenebro;136;81;55;2024
09;Burgos;141;Fuentespina;816;423;393;2024
09;Burgos;143;Galbarros;27;18;9;2024
09;Burgos;144;Gallega, La;39;26;13;2024
09;Burgos;148;Grijalba;112;55;57;2024
09;Burgos;149;Grisaleña;53;40;13;2024
09;Burgos;151;Gumiel de Izán;584;323;261;2024
09;Burgos;152;Gumiel de Mercado;380;210;170;2024
09;Burgos;154;Hacinas;149;90;59;2024
09;Burgos;155;Haza;34;24;10;2024
09;Burgos;159;Hontanas;71;44;27;2024
09;Burgos;160;Hontangas;99;65;34;2024
09;Burgos;162;Hontoria de la Cantera;174;99;75;2024
09;Burgos;163;Hontoria del Pinar;610;332;278;2024
09;Burgos;164;Hontoria de Valdearados;164;100;64;2024
09;Burgos;166;Hormazas, Las;99;50;49;2024
09;Burgos;167;Hornillos del Camino;46;27;19;2024
09;Burgos;168;Horra, La;303;172;131;2024
09;Burgos;169;Hortigüela;107;72;35;2024
09;Burgos;170;Hoyales de Roa;212;113;99;2024
09;Burgos;172;Huérmeces;153;85;68;2024
09;Burgos;173;Huerta de Arriba;128;72;56;2024
09;Burgos;174;Huerta de Rey;881;479;402;2024
09;Burgos;175;Humada;116;81;35;2024
09;Burgos;176;Hurones;53;33;20;2024
09;Burgos;177;Ibeas de Juarros;1445;760;685;2024
09;Burgos;178;Ibrillos;29;22;7;2024
09;Burgos;179;Iglesiarrubia;45;23;22;2024
09;Burgos;180;Iglesias;141;72;69;2024
09;Burgos;181;Isar;284;155;129;2024
09;Burgos;182;Itero del Castillo;71;43;28;2024
09;Burgos;183;Jaramillo de la Fuente;47;30;17;2024
09;Burgos;184;Jaramillo Quemado;10;8;2;2024
09;Burgos;189;Junta de Traslaloma;122;68;54;2024
09;Burgos;190;Junta de Villalba de Losa;78;41;37;2024
09;Burgos;191;Jurisdicción de Lara;41;25;16;2024
09;Burgos;192;Jurisdicción de San Zadornil;66;39;27;2024
09;Burgos;194;Lerma;2556;1277;1279;2024
09;Burgos;195;Llano de Bureba;49;36;13;2024
09;Burgos;196;Madrigal del Monte;143;87;56;2024
09;Burgos;197;Madrigalejo del Monte;176;103;73;2024
09;Burgos;198;Mahamud;105;61;44;2024
09;Burgos;199;Mambrilla de Castrejón;107;68;39;2024
09;Burgos;200;Mambrillas de Lara;56;34;22;2024
09;Burgos;201;Mamolar;28;13;15;2024
09;Burgos;202;Manciles;21;12;9;2024
09;Burgos;206;Mazuela;56;32;24;2024
09;Burgos;208;Mecerreyes;188;105;83;2024
09;Burgos;209;Medina de Pomar;5997;3040;2957;2024
09;Burgos;211;Melgar de Fernamental;1513;846;667;2024
09;Burgos;213;Merindad de Cuesta-Urria;270;161;109;2024
09;Burgos;214;Merindad de Montija;736;436;300;2024
09;Burgos;215;Merindad de Sotoscueva;412;238;174;2024
09;Burgos;216;Merindad de Valdeporres;421;214;207;2024
09;Burgos;217;Merindad de Valdivielso;401;224;177;2024
09;Burgos;218;Milagros;415;215;200;2024
09;Burgos;219;Miranda de Ebro;36018;17793;18225;2024
09;Burgos;220;Miraveche;95;58;37;2024
09;Burgos;221;Modúbar de la Emparedada;769;424;345;2024
09;Burgos;223;Monasterio de la Sierra;40;27;13;2024
09;Burgos;224;Monasterio de Rodilla;169;95;74;2024
09;Burgos;225;Moncalvillo;76;43;33;2024
09;Burgos;226;Monterrubio de la Demanda;56;33;23;2024
09;Burgos;227;Montorio;149;87;62;2024
09;Burgos;228;Moradillo de Roa;170;91;79;2024
09;Burgos;229;Nava de Roa;199;108;91;2024
09;Burgos;230;Navas de Bureba;24;12;12;2024
09;Burgos;231;Nebreda;55;34;21;2024
09;Burgos;232;Neila;119;67;52;2024
09;Burgos;235;Olmedillo de Roa;179;107;72;2024
09;Burgos;236;Olmillos de Muñó;40;23;17;2024
09;Burgos;238;Oña;951;497;454;2024
09;Burgos;239;Oquillas;49;27;22;2024
09;Burgos;241;Orbaneja Riopico;350;195;155;2024
09;Burgos;242;Padilla de Abajo;67;43;24;2024
09;Burgos;243;Padilla de Arriba;92;59;33;2024
09;Burgos;244;Padrones de Bureba;60;30;30;2024
09;Burgos;246;Palacios de la Sierra;675;344;331;2024
09;Burgos;247;Palacios de Riopisuerga;18;10;8;2024
09;Burgos;248;Palazuelos de la Sierra;93;53;40;2024
09;Burgos;249;Palazuelos de Muñó;54;31;23;2024
09;Burgos;250;Pampliega;291;163;128;2024
09;Burgos;251;Pancorbo;437;235;202;2024
09;Burgos;253;Pardilla;102;63;39;2024
09;Burgos;255;Partido de la Sierra en Tobalina;81;52;29;2024
09;Burgos;256;Pedrosa de Duero;460;271;189;2024
09;Burgos;257;Pedrosa del Páramo;89;54;35;2024
09;Burgos;258;Pedrosa del Príncipe;163;88;75;2024
09;Burgos;259;Pedrosa de Río Úrbel;243;145;98;2024
09;Burgos;261;Peñaranda de Duero;465;241;224;2024
09;Burgos;262;Peral de Arlanza;170;95;75;2024
09;Burgos;265;Piérnigas;39;23;16;2024
09;Burgos;266;Pineda de la Sierra;94;63;31;2024
09;Burgos;267;Pineda Trasmonte;98;62;36;2024
09;Burgos;268;Pinilla de los Barruecos;98;60;38;2024
09;Burgos;269;Pinilla de los Moros;33;20;13;2024
09;Burgos;270;Pinilla Trasmonte;161;93;68;2024
09;Burgos;272;Poza de la Sal;283;158;125;2024
09;Burgos;273;Prádanos de Bureba;56;36;20;2024
09;Burgos;274;Pradoluengo;1070;536;534;2024
09;Burgos;275;Presencio;207;119;88;2024
09;Burgos;276;Puebla de Arganzón, La;557;293;264;2024
09;Burgos;277;Puentedura;122;79;43;2024
09;Burgos;279;Quemada;238;140;98;2024
09;Burgos;280;Quintanabureba;31;18;13;2024
09;Burgos;281;Quintana del Pidio;149;79;70;2024
09;Burgos;283;Quintanaélez;47;29;18;2024
09;Burgos;287;Quintanaortuño;284;154;130;2024
09;Burgos;288;Quintanapalla;120;61;59;2024
09;Burgos;289;Quintanar de la Sierra;1513;788;725;2024
09;Burgos;292;Quintanavides;64;37;27;2024
09;Burgos;294;Quintanilla de la Mata;108;70;38;2024
09;Burgos;295;Quintanilla del Coco;50;26;24;2024
09;Burgos;297;Quintanillas, Las;388;227;161;2024
09;Burgos;298;Quintanilla San García;68;39;29;2024
09;Burgos;301;Quintanilla Vivar;885;471;414;2024
09;Burgos;302;Rabanera del Pinar;99;62;37;2024
09;Burgos;303;Rábanos;79;49;30;2024
09;Burgos;304;Rabé de las Calzadas;250;125;125;2024
09;Burgos;306;Rebolledo de la Torre;92;53;39;2024
09;Burgos;307;Redecilla del Camino;93;53;40;2024
09;Burgos;308;Redecilla del Campo;67;42;25;2024
09;Burgos;309;Regumiel de la Sierra;301;174;127;2024
09;Burgos;310;Reinoso;18;13;5;2024
09;Burgos;311;Retuerta;59;35;24;2024
09;Burgos;312;Revilla y Ahedo, La;101;58;43;2024
09;Burgos;314;Revilla del Campo;94;58;36;2024
09;Burgos;315;Revillarruz;634;335;299;2024
09;Burgos;316;Revilla Vallejera;115;70;45;2024
09;Burgos;317;Rezmondo;17;6;11;2024
09;Burgos;318;Riocavado de la Sierra;55;35;20;2024
09;Burgos;321;Roa;2244;1161;1083;2024
09;Burgos;323;Rojas;60;39;21;2024
09;Burgos;325;Royuela de Río Franco;170;103;67;2024
09;Burgos;326;Rubena;217;126;91;2024
09;Burgos;327;Rublacedo de Abajo;33;15;18;2024
09;Burgos;328;Rucandio;72;37;35;2024
09;Burgos;329;Salas de Bureba;129;77;52;2024
09;Burgos;330;Salas de los Infantes;1984;1033;951;2024
09;Burgos;332;Saldaña de Burgos;201;114;87;2024
09;Burgos;334;Salinillas de Bureba;48;33;15;2024
09;Burgos;335;San Adrián de Juarros;86;56;30;2024
09;Burgos;337;San Juan del Monte;152;85;67;2024
09;Burgos;338;San Mamés de Burgos;310;184;126;2024
09;Burgos;339;San Martín de Rubiales;139;84;55;2024
09;Burgos;340;San Millán de Lara;61;46;15;2024
09;Burgos;343;Santa Cecilia;105;64;41;2024
09;Burgos;345;Santa Cruz de la Salceda;134;79;55;2024
09;Burgos;346;Santa Cruz del Valle Urbión;103;67;36;2024
09;Burgos;347;Santa Gadea del Cid;161;89;72;2024
09;Burgos;348;Santa Inés;155;85;70;2024
09;Burgos;350;Santa María del Campo;523;282;241;2024
09;Burgos;351;Santa María del Invierno;67;48;19;2024
09;Burgos;352;Santa María del Mercadillo;108;70;38;2024
09;Burgos;353;Santa María Ribarredonda;95;57;38;2024
09;Burgos;354;Santa Olalla de Bureba;38;26;12;2024
09;Burgos;355;Santibáñez de Esgueva;77;42;35;2024
09;Burgos;356;Santibáñez del Val;70;40;30;2024
09;Burgos;358;Santo Domingo de Silos;247;164;83;2024
09;Burgos;360;San Vicente del Valle;28;17;11;2024
09;Burgos;361;Sargentes de la Lora;133;76;57;2024
09;Burgos;362;Sarracín;261;139;122;2024
09;Burgos;363;Sasamón;912;523;389;2024
09;Burgos;365;Sequera de Haza, La;27;19;8;2024
09;Burgos;366;Solarana;77;48;29;2024
09;Burgos;368;Sordillos;22;13;9;2024
09;Burgos;369;Sotillo de la Ribera;470;254;216;2024
09;Burgos;372;Sotragero;301;173;128;2024
09;Burgos;373;Sotresgudo;420;251;169;2024
09;Burgos;374;Susinos del Páramo;118;74;44;2024
09;Burgos;375;Tamarón;55;33;22;2024
09;Burgos;377;Tardajos;864;453;411;2024
09;Burgos;378;Tejada;35;20;15;2024
09;Burgos;380;Terradillos de Esgueva;64;30;34;2024
09;Burgos;381;Tinieblas de la Sierra;23;13;10;2024
09;Burgos;382;Tobar;27;20;7;2024
09;Burgos;384;Tordómar;298;164;134;2024
09;Burgos;386;Torrecilla del Monte;79;42;37;2024
09;Burgos;387;Torregalindo;123;69;54;2024
09;Burgos;388;Torrelara;32;21;11;2024
09;Burgos;389;Torrepadre;65;38;27;2024
09;Burgos;390;Torresandino;574;296;278;2024
09;Burgos;391;Tórtoles de Esgueva;387;219;168;2024
09;Burgos;392;Tosantos;53;28;25;2024
09;Burgos;394;Trespaderne;713;350;363;2024
09;Burgos;395;Tubilla del Agua;128;83;45;2024
09;Burgos;396;Tubilla del Lago;171;90;81;2024
09;Burgos;398;Úrbel del Castillo;58;43;15;2024
09;Burgos;400;Vadocondes;364;202;162;2024
09;Burgos;403;Valdeande;98;57;41;2024
09;Burgos;405;Valdezate;121;70;51;2024
09;Burgos;406;Valdorros;375;210;165;2024
09;Burgos;407;Valmala;26;13;13;2024
09;Burgos;408;Vallarta de Bureba;42;27;15;2024
09;Burgos;409;Valle de Manzanedo;115;63;52;2024
09;Burgos;410;Valle de Mena;4140;2094;2046;2024
09;Burgos;411;Valle de Oca;163;96;67;2024
09;Burgos;412;Valle de Tobalina;863;472;391;2024
09;Burgos;413;Valle de Valdebezana;482;265;217;2024
09;Burgos;414;Valle de Valdelaguna;191;113;78;2024
09;Burgos;415;Valle de Valdelucio;330;189;141;2024
09;Burgos;416;Valle de Zamanzas;45;29;16;2024
09;Burgos;417;Vallejera;39;23;16;2024
09;Burgos;418;Valles de Palenzuela;75;43;32;2024
09;Burgos;419;Valluércanes;63;43;20;2024
09;Burgos;421;Vid y Barrios, La;245;140;105;2024
09;Burgos;422;Vid de Bureba, La;24;13;11;2024
09;Burgos;423;Vileña;27;17;10;2024
09;Burgos;424;Viloria de Rioja;37;23;14;2024
09;Burgos;425;Vilviestre del Pinar;504;279;225;2024
09;Burgos;427;Villadiego;1455;799;656;2024
09;Burgos;428;Villaescusa de Roa;90;48;42;2024
09;Burgos;429;Villaescusa la Sombría;60;41;19;2024
09;Burgos;430;Villaespasa;22;14;8;2024
09;Burgos;431;Villafranca Montes de Oca;122;76;46;2024
09;Burgos;432;Villafruela;143;86;57;2024
09;Burgos;433;Villagalijo;52;30;22;2024
09;Burgos;434;Villagonzalo Pedernales;1882;995;887;2024
09;Burgos;437;Villahoz;287;162;125;2024
09;Burgos;438;Villalba de Duero;706;372;334;2024
09;Burgos;439;Villalbilla de Burgos;1514;811;703;2024
09;Burgos;440;Villalbilla de Gumiel;74;49;25;2024
09;Burgos;441;Villaldemiro;91;52;39;2024
09;Burgos;442;Villalmanzo;410;222;188;2024
09;Burgos;443;Villamayor de los Montes;160;78;82;2024
09;Burgos;444;Villamayor de Treviño;56;32;24;2024
09;Burgos;445;Villambistia;43;32;11;2024
09;Burgos;446;Villamedianilla;9;6;3;2024
09;Burgos;447;Villamiel de la Sierra;43;26;17;2024
09;Burgos;448;Villangómez;232;139;93;2024
09;Burgos;449;Villanueva de Argaño;122;73;49;2024
09;Burgos;450;Villanueva de Carazo;27;17;10;2024
09;Burgos;451;Villanueva de Gumiel;279;140;139;2024
09;Burgos;454;Villanueva de Teba;42;23;19;2024
09;Burgos;455;Villaquirán de la Puebla;46;28;18;2024
09;Burgos;456;Villaquirán de los Infantes;138;74;64;2024
09;Burgos;458;Villariezo;719;393;326;2024
09;Burgos;460;Villasandino;178;101;77;2024
09;Burgos;463;Villasur de Herreros;273;160;113;2024
09;Burgos;464;Villatuelda;53;28;25;2024
09;Burgos;466;Villaverde del Monte;108;64;44;2024
09;Burgos;467;Villaverde-Mogina;75;50;25;2024
09;Burgos;471;Villayerno Morquillas;205;107;98;2024
09;Burgos;472;Villazopeque;52;31;21;2024
09;Burgos;473;Villegas;79;41;38;2024
09;Burgos;476;Villoruebo;63;43;20;2024
09;Burgos;478;Vizcaínos;40;35;5;2024
09;Burgos;480;Zael;115;58;57;2024
09;Burgos;482;Zarzosa de Río Pisuerga;31;20;11;2024
09;Burgos;483;Zazuar;209;109;100;2024
09;Burgos;485;Zuñeda;57;30;27;2024
09;Burgos;901;Quintanilla del Agua y Tordueles;335;183;152;2024
09;Burgos;902;Valle de Santibáñez;479;284;195;2024
09;Burgos;903;Villarcayo de Merindad de Castilla la Vieja;4047;2066;1981;2024
09;Burgos;904;Valle de las Navas;543;318;225;2024
09;Burgos;905;Valle de Sedano;409;232;177;2024
09;Burgos;906;Merindad de Río Ubierna;1411;792;619;2024
09;Burgos;907;Alfoz de Quintanadueñas;2133;1116;1017;2024
09;Burgos;908;Valle de Losa;496;281;215;2024
10;Cáceres;001;Abadía;331;183;148;2024
10;Cáceres;002;Abertura;368;187;181;2024
10;Cáceres;003;Acebo;576;291;285;2024
10;Cáceres;004;Acehúche;805;410;395;2024
10;Cáceres;005;Aceituna;581;302;279;2024
10;Cáceres;006;Ahigal;1349;681;668;2024
10;Cáceres;007;Albalá;657;341;316;2024
10;Cáceres;008;Alcántara;1347;680;667;2024
10;Cáceres;009;Alcollarín;266;134;132;2024
10;Cáceres;010;Alcuéscar;2454;1284;1170;2024
10;Cáceres;011;Aldeacentenera;593;324;269;2024
10;Cáceres;012;Aldea del Cano;600;302;298;2024
10;Cáceres;013;Aldea del Obispo, La;286;152;134;2024
10;Cáceres;014;Aldeanueva de la Vera;1997;978;1019;2024
10;Cáceres;015;Aldeanueva del Camino;704;344;360;2024
10;Cáceres;016;Aldehuela de Jerte;352;182;170;2024
10;Cáceres;017;Alía;746;382;364;2024
10;Cáceres;018;Aliseda;1724;885;839;2024
10;Cáceres;019;Almaraz;1615;823;792;2024
10;Cáceres;020;Almoharín;1779;888;891;2024
10;Cáceres;021;Arroyo de la Luz;5520;2737;2783;2024
10;Cáceres;022;Arroyomolinos de la Vera;426;221;205;2024
10;Cáceres;023;Arroyomolinos;812;409;403;2024
10;Cáceres;024;Baños de Montemayor;737;347;390;2024
10;Cáceres;025;Barrado;382;200;182;2024
10;Cáceres;026;Belvís de Monroy;743;386;357;2024
10;Cáceres;027;Benquerencia;84;46;38;2024
10;Cáceres;028;Berrocalejo;124;66;58;2024
10;Cáceres;029;Berzocana;395;204;191;2024
10;Cáceres;030;Bohonal de Ibor;503;250;253;2024
10;Cáceres;031;Botija;188;101;87;2024
10;Cáceres;032;Brozas;1746;868;878;2024
10;Cáceres;033;Cabañas del Castillo;407;209;198;2024
10;Cáceres;034;Cabezabellosa;335;172;163;2024
10;Cáceres;035;Cabezuela del Valle;2127;1080;1047;2024
10;Cáceres;036;Cabrero;349;196;153;2024
10;Cáceres;037;Cáceres;96441;46159;50282;2024
10;Cáceres;038;Cachorrilla;82;41;41;2024
10;Cáceres;039;Cadalso;407;209;198;2024
10;Cáceres;040;Calzadilla;455;234;221;2024
10;Cáceres;041;Caminomorisco;1120;596;524;2024
10;Cáceres;042;Campillo de Deleitosa;84;40;44;2024
10;Cáceres;043;Campo Lugar;804;399;405;2024
10;Cáceres;044;Cañamero;1601;848;753;2024
10;Cáceres;045;Cañaveral;1008;515;493;2024
10;Cáceres;046;Carbajo;177;91;86;2024
10;Cáceres;047;Carcaboso;1069;547;522;2024
10;Cáceres;048;Carrascalejo;225;116;109;2024
10;Cáceres;049;Casar de Cáceres;4477;2215;2262;2024
10;Cáceres;050;Casar de Palomero;993;515;478;2024
10;Cáceres;051;Casares de las Hurdes;369;191;178;2024
10;Cáceres;052;Casas de Don Antonio;177;96;81;2024
10;Cáceres;053;Casas de Don Gómez;330;181;149;2024
10;Cáceres;054;Casas del Castañar;578;302;276;2024
10;Cáceres;055;Casas del Monte;768;396;372;2024
10;Cáceres;056;Casas de Millán;564;282;282;2024
10;Cáceres;057;Casas de Miravete;112;75;37;2024
10;Cáceres;058;Casatejada;1382;742;640;2024
10;Cáceres;059;Casillas de Coria;344;173;171;2024
10;Cáceres;060;Castañar de Ibor;1032;535;497;2024
10;Cáceres;061;Ceclavín;1781;905;876;2024
10;Cáceres;062;Cedillo;434;220;214;2024
10;Cáceres;063;Cerezo;147;73;74;2024
10;Cáceres;064;Cilleros;1555;793;762;2024
10;Cáceres;065;Collado de la Vera;276;146;130;2024
10;Cáceres;066;Conquista de la Sierra;183;111;72;2024
10;Cáceres;067;Coria;12114;5972;6142;2024
10;Cáceres;068;Cuacos de Yuste;829;415;414;2024
10;Cáceres;069;Cumbre, La;828;414;414;2024
10;Cáceres;070;Deleitosa;682;354;328;2024
10;Cáceres;071;Descargamaría;108;59;49;2024
10;Cáceres;072;Eljas;836;426;410;2024
10;Cáceres;073;Escurial;869;463;406;2024
10;Cáceres;075;Fresnedoso de Ibor;239;128;111;2024
10;Cáceres;076;Galisteo;835;417;418;2024
10;Cáceres;077;Garciaz;664;347;317;2024
10;Cáceres;078;Garganta, La;353;189;164;2024
10;Cáceres;079;Garganta la Olla;883;470;413;2024
10;Cáceres;080;Gargantilla;364;188;176;2024
10;Cáceres;081;Gargüera;182;99;83;2024
10;Cáceres;082;Garrovillas de Alconétar;1959;963;996;2024
10;Cáceres;083;Garvín;94;55;39;2024
10;Cáceres;084;Gata;1353;690;663;2024
10;Cáceres;085;Gordo, El;369;200;169;2024
10;Cáceres;086;Granja, La;313;163;150;2024
10;Cáceres;087;Guadalupe;1752;876;876;2024
10;Cáceres;088;Guijo de Coria;189;106;83;2024
10;Cáceres;089;Guijo de Galisteo;1487;748;739;2024
10;Cáceres;090;Guijo de Granadilla;487;253;234;2024
10;Cáceres;091;Guijo de Santa Bárbara;363;194;169;2024
10;Cáceres;092;Herguijuela;267;141;126;2024
10;Cáceres;093;Hernán-Pérez;411;200;211;2024
10;Cáceres;094;Herrera de Alcántara;224;122;102;2024
10;Cáceres;095;Herreruela;325;163;162;2024
10;Cáceres;096;Hervás;3921;1921;2000;2024
10;Cáceres;097;Higuera de Albalat;100;56;44;2024
10;Cáceres;098;Hinojal;388;194;194;2024
10;Cáceres;099;Holguera;593;298;295;2024
10;Cáceres;100;Hoyos;858;433;425;2024
10;Cáceres;101;Huélaga;205;98;107;2024
10;Cáceres;102;Ibahernando;545;267;278;2024
10;Cáceres;103;Jaraicejo;436;210;226;2024
10;Cáceres;104;Jaraíz de la Vera;6720;3407;3313;2024
10;Cáceres;105;Jarandilla de la Vera;2845;1411;1434;2024
10;Cáceres;106;Jarilla;139;73;66;2024
10;Cáceres;107;Jerte;1200;599;601;2024
10;Cáceres;108;Ladrillar;185;109;76;2024
10;Cáceres;109;Logrosán;1903;980;923;2024
10;Cáceres;110;Losar de la Vera;2805;1423;1382;2024
10;Cáceres;111;Madrigal de la Vera;1533;811;722;2024
10;Cáceres;112;Madrigalejo;1708;858;850;2024
10;Cáceres;113;Madroñera;2364;1189;1175;2024
10;Cáceres;114;Majadas;1267;644;623;2024
10;Cáceres;115;Malpartida de Cáceres;4030;2012;2018;2024
10;Cáceres;116;Malpartida de Plasencia;4673;2314;2359;2024
10;Cáceres;117;Marchagaz;236;129;107;2024
10;Cáceres;118;Mata de Alcántara;286;146;140;2024
10;Cáceres;119;Membrío;572;285;287;2024
10;Cáceres;120;Mesas de Ibor;152;75;77;2024
10;Cáceres;121;Miajadas;9370;4656;4714;2024
10;Cáceres;122;Millanes;223;116;107;2024
10;Cáceres;123;Mirabel;632;324;308;2024
10;Cáceres;124;Mohedas de Granadilla;850;417;433;2024
10;Cáceres;125;Monroy;884;460;424;2024
10;Cáceres;126;Montánchez;1608;811;797;2024
10;Cáceres;127;Montehermoso;5586;2843;2743;2024
10;Cáceres;128;Moraleja;6578;3260;3318;2024
10;Cáceres;129;Morcillo;369;175;194;2024
10;Cáceres;130;Navaconcejo;2044;1027;1017;2024
10;Cáceres;131;Navalmoral de la Mata;17028;8241;8787;2024
10;Cáceres;132;Navalvillar de Ibor;378;198;180;2024
10;Cáceres;133;Navas del Madroño;1259;624;635;2024
10;Cáceres;134;Navezuelas;649;335;314;2024
10;Cáceres;135;Nuñomoral;1202;648;554;2024
10;Cáceres;136;Oliva de Plasencia;292;169;123;2024
10;Cáceres;137;Palomero;445;233;212;2024
10;Cáceres;138;Pasarón de la Vera;592;283;309;2024
10;Cáceres;139;Pedroso de Acim;92;55;37;2024
10;Cáceres;140;Peraleda de la Mata;1431;714;717;2024
10;Cáceres;141;Peraleda de San Román;277;155;122;2024
10;Cáceres;142;Perales del Puerto;903;457;446;2024
10;Cáceres;143;Pescueza;150;67;83;2024
10;Cáceres;144;Pesga, La;955;496;459;2024
10;Cáceres;145;Piedras Albas;125;60;65;2024
10;Cáceres;146;Pinofranqueado;1763;926;837;2024
10;Cáceres;147;Piornal;1454;741;713;2024
10;Cáceres;148;Plasencia;39829;19139;20690;2024
10;Cáceres;149;Plasenzuela;518;260;258;2024
10;Cáceres;150;Portaje;380;194;186;2024
10;Cáceres;151;Portezuelo;206;113;93;2024
10;Cáceres;152;Pozuelo de Zarzón;428;216;212;2024
10;Cáceres;153;Puerto de Santa Cruz;264;136;128;2024
10;Cáceres;154;Rebollar;196;104;92;2024
10;Cáceres;155;Riolobos;1180;575;605;2024
10;Cáceres;156;Robledillo de Gata;94;56;38;2024
10;Cáceres;157;Robledillo de la Vera;259;135;124;2024
10;Cáceres;158;Robledillo de Trujillo;368;194;174;2024
10;Cáceres;159;Robledollano;320;181;139;2024
10;Cáceres;160;Romangordo;251;121;130;2024
10;Cáceres;161;Ruanes;81;40;41;2024
10;Cáceres;162;Salorino;537;288;249;2024
10;Cáceres;163;Salvatierra de Santiago;248;127;121;2024
10;Cáceres;164;San Martín de Trevejo;702;336;366;2024
10;Cáceres;165;Santa Ana;307;155;152;2024
10;Cáceres;166;Santa Cruz de la Sierra;322;167;155;2024
10;Cáceres;167;Santa Cruz de Paniagua;286;164;122;2024
10;Cáceres;168;Santa Marta de Magasca;292;148;144;2024
10;Cáceres;169;Santiago de Alcántara;465;229;236;2024
10;Cáceres;170;Santiago del Campo;247;125;122;2024
10;Cáceres;171;Santibáñez el Alto;379;208;171;2024
10;Cáceres;172;Santibáñez el Bajo;710;371;339;2024
10;Cáceres;173;Saucedilla;994;521;473;2024
10;Cáceres;174;Segura de Toro;180;95;85;2024
10;Cáceres;175;Serradilla;1482;737;745;2024
10;Cáceres;176;Serrejón;407;206;201;2024
10;Cáceres;177;Sierra de Fuentes;2056;1052;1004;2024
10;Cáceres;178;Talaván;769;398;371;2024
10;Cáceres;179;Talaveruela de la Vera;301;156;145;2024
10;Cáceres;180;Talayuela;7304;3891;3413;2024
10;Cáceres;181;Tejeda de Tiétar;766;400;366;2024
10;Cáceres;182;Toril;159;98;61;2024
10;Cáceres;183;Tornavacas;991;517;474;2024
10;Cáceres;184;Torno, El;833;451;382;2024
10;Cáceres;185;Torrecilla de los Ángeles;640;336;304;2024
10;Cáceres;186;Torrecillas de la Tiesa;1047;530;517;2024
10;Cáceres;187;Torre de Don Miguel;476;246;230;2024
10;Cáceres;188;Torre de Santa María;517;254;263;2024
10;Cáceres;189;Torrejoncillo;2765;1353;1412;2024
10;Cáceres;190;Torrejón el Rubio;535;273;262;2024
10;Cáceres;191;Torremenga;616;319;297;2024
10;Cáceres;192;Torremocha;736;375;361;2024
10;Cáceres;193;Torreorgaz;1676;828;848;2024
10;Cáceres;194;Torrequemada;560;276;284;2024
10;Cáceres;195;Trujillo;8619;4176;4443;2024
10;Cáceres;196;Valdastillas;319;162;157;2024
10;Cáceres;197;Valdecañas de Tajo;96;53;43;2024
10;Cáceres;198;Valdefuentes;1100;541;559;2024
10;Cáceres;199;Valdehúncar;186;103;83;2024
10;Cáceres;200;Valdelacasa de Tajo;342;178;164;2024
10;Cáceres;201;Valdemorales;215;108;107;2024
10;Cáceres;202;Valdeobispo;610;306;304;2024
10;Cáceres;203;Valencia de Alcántara;5196;2562;2634;2024
10;Cáceres;204;Valverde de la Vera;448;226;222;2024
10;Cáceres;205;Valverde del Fresno;2121;1072;1049;2024
10;Cáceres;206;Viandar de la Vera;218;112;106;2024
10;Cáceres;207;Villa del Campo;439;224;215;2024
10;Cáceres;208;Villa del Rey;116;59;57;2024
10;Cáceres;209;Villamesías;275;149;126;2024
10;Cáceres;210;Villamiel;379;188;191;2024
10;Cáceres;211;Villanueva de la Sierra;493;258;235;2024
10;Cáceres;212;Villanueva de la Vera;2110;1056;1054;2024
10;Cáceres;213;Villar del Pedroso;556;288;268;2024
10;Cáceres;214;Villar de Plasencia;231;122;109;2024
10;Cáceres;215;Villasbuenas de Gata;510;250;260;2024
10;Cáceres;216;Zarza de Granadilla;1803;914;889;2024
10;Cáceres;217;Zarza de Montánchez;519;269;250;2024
10;Cáceres;218;Zarza la Mayor;1117;562;555;2024
10;Cáceres;219;Zorita;1248;614;634;2024
10;Cáceres;901;Rosalejo;1328;683;645;2024
10;Cáceres;902;Vegaviana;844;429;415;2024
10;Cáceres;903;Alagón del Río;909;452;457;2024
10;Cáceres;904;Tiétar;854;460;394;2024
10;Cáceres;905;Pueblonuevo de Miramontes;775;388;387;2024
11;Cádiz;001;Alcalá de los Gazules;5223;2683;2540;2024
11;Cádiz;002;Alcalá del Valle;4936;2484;2452;2024
11;Cádiz;003;Algar;1436;721;715;2024
11;Cádiz;004;Algeciras;124978;61541;63437;2024
11;Cádiz;005;Algodonales;5443;2744;2699;2024
11;Cádiz;006;Arcos de la Frontera;31046;15482;15564;2024
11;Cádiz;007;Barbate;22709;11323;11386;2024
11;Cádiz;008;Barrios, Los;24404;12232;12172;2024
11;Cádiz;009;Benaocaz;754;404;350;2024
11;Cádiz;010;Bornos;7533;3756;3777;2024
11;Cádiz;011;Bosque, El;2249;1123;1126;2024
11;Cádiz;012;Cádiz;110914;52253;58661;2024
11;Cádiz;013;Castellar de la Frontera;2976;1461;1515;2024
11;Cádiz;014;Conil de la Frontera;23996;12010;11986;2024
11;Cádiz;015;Chiclana de la Frontera;89794;44751;45043;2024
11;Cádiz;016;Chipiona;19915;9948;9967;2024
11;Cádiz;017;Espera;3777;1888;1889;2024
11;Cádiz;018;Gastor, El;1698;858;840;2024
11;Cádiz;019;Grazalema;1998;991;1007;2024
11;Cádiz;020;Jerez de la Frontera;213688;104071;109617;2024
11;Cádiz;021;Jimena de la Frontera;6695;3404;3291;2024
11;Cádiz;022;Línea de la Concepción, La;64177;31608;32569;2024
11;Cádiz;023;Medina Sidonia;11764;5937;5827;2024
11;Cádiz;024;Olvera;7864;3864;4000;2024
11;Cádiz;025;Paterna de Rivera;5505;2858;2647;2024
11;Cádiz;026;Prado del Rey;5667;2786;2881;2024
11;Cádiz;027;Puerto de Santa María, El;89960;43978;45982;2024
11;Cádiz;028;Puerto Real;42151;21082;21069;2024
11;Cádiz;029;Puerto Serrano;6898;3501;3397;2024
11;Cádiz;030;Rota;29552;14631;14921;2024
11;Cádiz;031;San Fernando;93645;45604;48041;2024
11;Cádiz;032;Sanlúcar de Barrameda;69876;34751;35125;2024
11;Cádiz;033;San Roque;34190;17025;17165;2024
11;Cádiz;034;Setenil de las Bodegas;2624;1361;1263;2024
11;Cádiz;035;Tarifa;18664;9330;9334;2024
11;Cádiz;036;Torre Alháquime;798;400;398;2024
11;Cádiz;037;Trebujena;7015;3512;3503;2024
11;Cádiz;038;Ubrique;16439;8075;8364;2024
11;Cádiz;039;Vejer de la Frontera;12915;6448;6467;2024
11;Cádiz;040;Villaluenga del Rosario;462;233;229;2024
11;Cádiz;041;Villamartín;12169;6123;6046;2024
11;Cádiz;042;Zahara;1355;685;670;2024
11;Cádiz;901;Benalup-Casas Viejas;7228;3660;3568;2024
11;Cádiz;902;San José del Valle;4472;2274;2198;2024
11;Cádiz;903;San Martín del Tesorillo;2739;1411;1328;2024
12;Castellón/Castelló;001;Atzeneta del Maestrat;1309;673;636;2024
12;Castellón/Castelló;002;Aín;131;68;63;2024
12;Castellón/Castelló;003;Albocàsser;1338;666;672;2024
12;Castellón/Castelló;004;Alcalà de Xivert;7176;3631;3545;2024
12;Castellón/Castelló;005;Alcora, l';10581;5296;5285;2024
12;Castellón/Castelló;006;Alcudia de Veo;213;114;99;2024
12;Castellón/Castelló;007;Alfondeguilla;870;426;444;2024
12;Castellón/Castelló;008;Algimia de Almonacid;258;139;119;2024
12;Castellón/Castelló;009;Almassora;28497;14302;14195;2024
12;Castellón/Castelló;010;Almedíjar;288;156;132;2024
12;Castellón/Castelló;011;Almenara;6710;3318;3392;2024
12;Castellón/Castelló;012;Altura;3790;1953;1837;2024
12;Castellón/Castelló;013;Arañuel;159;90;69;2024
12;Castellón/Castelló;014;Ares del Maestrat;177;108;69;2024
12;Castellón/Castelló;015;Argelita;146;77;69;2024
12;Castellón/Castelló;016;Artana;1971;1001;970;2024
12;Castellón/Castelló;017;Ayódar;182;101;81;2024
12;Castellón/Castelló;018;Azuébar;352;183;169;2024
12;Castellón/Castelló;020;Barracas;195;103;92;2024
12;Castellón/Castelló;021;Betxí;5592;2765;2827;2024
12;Castellón/Castelló;022;Bejís;400;241;159;2024
12;Castellón/Castelló;024;Benafer;170;80;90;2024
12;Castellón/Castelló;025;Benafigos;126;74;52;2024
12;Castellón/Castelló;026;Benassal;1052;546;506;2024
12;Castellón/Castelló;027;Benicarló;29607;15082;14525;2024
12;Castellón/Castelló;028;Benicàssim/Benicasim;20322;9984;10338;2024
12;Castellón/Castelló;029;Benlloc;1115;565;550;2024
12;Castellón/Castelló;031;Borriol;5945;3044;2901;2024
12;Castellón/Castelló;032;Borriana/Burriana;36927;18411;18516;2024
12;Castellón/Castelló;033;Cabanes;3313;1720;1593;2024
12;Castellón/Castelló;034;Càlig;2048;1027;1021;2024
12;Castellón/Castelló;036;Canet lo Roig;699;355;344;2024
12;Castellón/Castelló;037;Castell de Cabres;22;13;9;2024
12;Castellón/Castelló;038;Castellfort;190;98;92;2024
12;Castellón/Castelló;039;Castellnovo;884;459;425;2024
12;Castellón/Castelló;040;Castelló de la Plana;180379;87037;93342;2024
12;Castellón/Castelló;041;Castillo de Villamalefa;113;74;39;2024
12;Castellón/Castelló;042;Catí;760;382;378;2024
12;Castellón/Castelló;043;Caudiel;722;366;356;2024
12;Castellón/Castelló;044;Cervera del Maestre;643;325;318;2024
12;Castellón/Castelló;045;Cinctorres;442;221;221;2024
12;Castellón/Castelló;046;Cirat;214;116;98;2024
12;Castellón/Castelló;048;Cortes de Arenoso;311;159;152;2024
12;Castellón/Castelló;049;Costur;535;279;256;2024
12;Castellón/Castelló;050;Coves de Vinromà, les;1865;959;906;2024
12;Castellón/Castelló;051;Culla;493;254;239;2024
12;Castellón/Castelló;052;Xert;686;344;342;2024
12;Castellón/Castelló;053;Chilches/Xilxes;3094;1585;1509;2024
12;Castellón/Castelló;055;Xodos/Chodos;116;71;45;2024
12;Castellón/Castelló;056;Chóvar;312;165;147;2024
12;Castellón/Castelló;057;Eslida;785;401;384;2024
12;Castellón/Castelló;058;Espadilla;89;49;40;2024
12;Castellón/Castelló;059;Fanzara;297;155;142;2024
12;Castellón/Castelló;060;Figueroles;518;257;261;2024
12;Castellón/Castelló;061;Forcall;477;229;248;2024
12;Castellón/Castelló;063;Fuente la Reina;59;32;27;2024
12;Castellón/Castelló;064;Fuentes de Ayódar;95;56;39;2024
12;Castellón/Castelló;065;Gaibiel;199;113;86;2024
12;Castellón/Castelló;067;Geldo;651;326;325;2024
12;Castellón/Castelló;068;Herbers;69;44;25;2024
12;Castellón/Castelló;069;Higueras;46;19;27;2024
12;Castellón/Castelló;070;Jana, la;688;355;333;2024
12;Castellón/Castelló;071;Jérica;1726;870;856;2024
12;Castellón/Castelló;072;Llucena/Lucena del Cid;1420;711;709;2024
12;Castellón/Castelló;073;Ludiente;175;98;77;2024
12;Castellón/Castelló;074;Llosa, la;1042;502;540;2024
12;Castellón/Castelló;075;Mata de Morella, la;184;103;81;2024
12;Castellón/Castelló;076;Matet;91;56;35;2024
12;Castellón/Castelló;077;Moncofa;8011;4078;3933;2024
12;Castellón/Castelló;078;Montán;421;217;204;2024
12;Castellón/Castelló;079;Montanejos;643;332;311;2024
12;Castellón/Castelló;080;Morella;2494;1233;1261;2024
12;Castellón/Castelló;081;Navajas;846;435;411;2024
12;Castellón/Castelló;082;Nules;14062;7056;7006;2024
12;Castellón/Castelló;083;Olocau del Rey;135;70;65;2024
12;Castellón/Castelló;084;Onda;25817;12922;12895;2024
12;Castellón/Castelló;085;Orpesa/Oropesa del Mar;11785;6035;5750;2024
12;Castellón/Castelló;087;Palanques;34;20;14;2024
12;Castellón/Castelló;088;Pavías;73;45;28;2024
12;Castellón/Castelló;089;Peníscola/Peñíscola;8496;4329;4167;2024
12;Castellón/Castelló;090;Pina de Montalgrao;118;67;51;2024
12;Castellón/Castelló;091;Portell de Morella;155;79;76;2024
12;Castellón/Castelló;092;Puebla de Arenoso;174;94;80;2024
12;Castellón/Castelló;093;Pobla de Benifassà, la;240;141;99;2024
12;Castellón/Castelló;094;Pobla Tornesa, la;1325;677;648;2024
12;Castellón/Castelló;095;Ribesalbes;1163;606;557;2024
12;Castellón/Castelló;096;Rossell;892;464;428;2024
12;Castellón/Castelló;097;Sacañet;77;52;25;2024
12;Castellón/Castelló;098;Salzadella, la;678;343;335;2024
12;Castellón/Castelló;099;Sant Jordi/San Jorge;1381;722;659;2024
12;Castellón/Castelló;100;Sant Mateu;2004;1001;1003;2024
12;Castellón/Castelló;101;San Rafael del Río;530;261;269;2024
12;Castellón/Castelló;102;Santa Magdalena de Pulpis;768;401;367;2024
12;Castellón/Castelló;103;Serratella, la;113;54;59;2024
12;Castellón/Castelló;104;Segorbe;9640;4792;4848;2024
12;Castellón/Castelló;105;Sierra Engarcerán;1043;550;493;2024
12;Castellón/Castelló;106;Soneja;1513;740;773;2024
12;Castellón/Castelló;107;Sot de Ferrer;498;263;235;2024
12;Castellón/Castelló;108;Suera/Sueras;573;294;279;2024
12;Castellón/Castelló;109;Tales;834;433;401;2024
12;Castellón/Castelló;110;Teresa;231;128;103;2024
12;Castellón/Castelló;111;Tírig;432;222;210;2024
12;Castellón/Castelló;112;Todolella;147;87;60;2024
12;Castellón/Castelló;113;Toga;108;59;49;2024
12;Castellón/Castelló;114;Torás;268;141;127;2024
12;Castellón/Castelló;115;Toro, El;262;138;124;2024
12;Castellón/Castelló;116;Torralba del Pinar;59;30;29;2024
12;Castellón/Castelló;117;Torreblanca;5674;2863;2811;2024
12;Castellón/Castelló;118;Torrechiva;127;66;61;2024
12;Castellón/Castelló;119;Torre d'en Besora, la;163;92;71;2024
12;Castellón/Castelló;120;Torre d'en Doménec, la;182;94;88;2024
12;Castellón/Castelló;121;Traiguera;1300;668;632;2024
12;Castellón/Castelló;122;Useres, les/Useras;961;507;454;2024
12;Castellón/Castelló;123;Vallat;71;35;36;2024
12;Castellón/Castelló;124;Vall d'Alba;3103;1642;1461;2024
12;Castellón/Castelló;125;Vall de Almonacid;281;148;133;2024
12;Castellón/Castelló;126;Vall d'Uixó, la;31884;15654;16230;2024
12;Castellón/Castelló;127;Vallibona;64;37;27;2024
12;Castellón/Castelló;128;Vilafamés;1938;1038;900;2024
12;Castellón/Castelló;129;Vilafranca/Villafranca del Cid;2139;1088;1051;2024
12;Castellón/Castelló;130;Villahermosa del Río;490;267;223;2024
12;Castellón/Castelló;131;Villamalur;97;61;36;2024
12;Castellón/Castelló;132;Vilanova d'Alcolea;585;314;271;2024
12;Castellón/Castelló;133;Villanueva de Viver;98;52;46;2024
12;Castellón/Castelló;134;Vilar de Canes;156;75;81;2024
12;Castellón/Castelló;135;Vila-real;52505;26007;26498;2024
12;Castellón/Castelló;136;Vilavella, la;3073;1525;1548;2024
12;Castellón/Castelló;137;Villores;53;25;28;2024
12;Castellón/Castelló;138;Vinaròs;30278;14942;15336;2024
12;Castellón/Castelló;139;Vistabella del Maestrat;361;200;161;2024
12;Castellón/Castelló;140;Viver;1680;869;811;2024
12;Castellón/Castelló;141;Zorita del Maestrazgo;111;54;57;2024
12;Castellón/Castelló;142;Zucaina;174;99;75;2024
12;Castellón/Castelló;901;Alqueries, les/Alquerías del Niño Perdido;4563;2293;2270;2024
12;Castellón/Castelló;902;Sant Joan de Moró;3644;1870;1774;2024
13;Ciudad Real;001;Abenójar;1324;684;640;2024
13;Ciudad Real;002;Agudo;1604;808;796;2024
13;Ciudad Real;003;Alamillo;461;239;222;2024
13;Ciudad Real;004;Albaladejo;1003;522;481;2024
13;Ciudad Real;005;Alcázar de San Juan;31382;15279;16103;2024
13;Ciudad Real;006;Alcoba;567;289;278;2024
13;Ciudad Real;007;Alcolea de Calatrava;1361;693;668;2024
13;Ciudad Real;008;Alcubillas;418;214;204;2024
13;Ciudad Real;009;Aldea del Rey;1577;801;776;2024
13;Ciudad Real;010;Alhambra;969;496;473;2024
13;Ciudad Real;011;Almadén;4902;2368;2534;2024
13;Ciudad Real;012;Almadenejos;393;201;192;2024
13;Ciudad Real;013;Almagro;9049;4493;4556;2024
13;Ciudad Real;014;Almedina;482;265;217;2024
13;Ciudad Real;015;Almodóvar del Campo;5706;2871;2835;2024
13;Ciudad Real;016;Almuradiel;752;373;379;2024
13;Ciudad Real;017;Anchuras;274;149;125;2024
13;Ciudad Real;018;Arenas de San Juan;1035;530;505;2024
13;Ciudad Real;019;Argamasilla de Alba;6925;3512;3413;2024
13;Ciudad Real;020;Argamasilla de Calatrava;5802;2918;2884;2024
13;Ciudad Real;021;Arroba de los Montes;406;220;186;2024
13;Ciudad Real;022;Ballesteros de Calatrava;361;186;175;2024
13;Ciudad Real;023;Bolaños de Calatrava;12067;6238;5829;2024
13;Ciudad Real;024;Brazatortas;1001;531;470;2024
13;Ciudad Real;025;Cabezarados;297;160;137;2024
13;Ciudad Real;026;Cabezarrubias del Puerto;488;256;232;2024
13;Ciudad Real;027;Calzada de Calatrava;3727;1865;1862;2024
13;Ciudad Real;028;Campo de Criptana;12932;6491;6441;2024
13;Ciudad Real;029;Cañada de Calatrava;103;59;44;2024
13;Ciudad Real;030;Caracuel de Calatrava;134;81;53;2024
13;Ciudad Real;031;Carrión de Calatrava;3233;1642;1591;2024
13;Ciudad Real;032;Carrizosa;1106;557;549;2024
13;Ciudad Real;033;Castellar de Santiago;1762;899;863;2024
13;Ciudad Real;034;Ciudad Real;75909;35946;39963;2024
13;Ciudad Real;035;Corral de Calatrava;1128;552;576;2024
13;Ciudad Real;036;Cortijos, Los;847;442;405;2024
13;Ciudad Real;037;Cózar;899;470;429;2024
13;Ciudad Real;038;Chillón;1773;857;916;2024
13;Ciudad Real;039;Daimiel;17645;8898;8747;2024
13;Ciudad Real;040;Fernán Caballero;965;489;476;2024
13;Ciudad Real;041;Fontanarejo;233;132;101;2024
13;Ciudad Real;042;Fuencaliente;1001;522;479;2024
13;Ciudad Real;043;Fuenllana;200;110;90;2024
13;Ciudad Real;044;Fuente el Fresno;3047;1570;1477;2024
13;Ciudad Real;045;Granátula de Calatrava;686;331;355;2024
13;Ciudad Real;046;Guadalmez;707;352;355;2024
13;Ciudad Real;047;Herencia;8459;4315;4144;2024
13;Ciudad Real;048;Hinojosas de Calatrava;508;267;241;2024
13;Ciudad Real;049;Horcajo de los Montes;795;409;386;2024
13;Ciudad Real;050;Labores, Las;547;290;257;2024
13;Ciudad Real;051;Luciana;360;190;170;2024
13;Ciudad Real;052;Malagón;7754;3878;3876;2024
13;Ciudad Real;053;Manzanares;17745;8794;8951;2024
13;Ciudad Real;054;Membrilla;5839;2913;2926;2024
13;Ciudad Real;055;Mestanza;657;346;311;2024
13;Ciudad Real;056;Miguelturra;15834;7963;7871;2024
13;Ciudad Real;057;Montiel;1197;630;567;2024
13;Ciudad Real;058;Moral de Calatrava;5103;2572;2531;2024
13;Ciudad Real;059;Navalpino;195;103;92;2024
13;Ciudad Real;060;Navas de Estena;282;151;131;2024
13;Ciudad Real;061;Pedro Muñoz;7567;3823;3744;2024
13;Ciudad Real;062;Picón;690;358;332;2024
13;Ciudad Real;063;Piedrabuena;4345;2217;2128;2024
13;Ciudad Real;064;Poblete;2940;1501;1439;2024
13;Ciudad Real;065;Porzuna;3516;1819;1697;2024
13;Ciudad Real;066;Pozuelo de Calatrava;3894;2033;1861;2024
13;Ciudad Real;067;Pozuelos de Calatrava, Los;345;178;167;2024
13;Ciudad Real;068;Puebla de Don Rodrigo;1137;620;517;2024
13;Ciudad Real;069;Puebla del Príncipe;647;341;306;2024
13;Ciudad Real;070;Puerto Lápice;865;428;437;2024
13;Ciudad Real;071;Puertollano;45195;21754;23441;2024
13;Ciudad Real;072;Retuerta del Bullaque;867;481;386;2024
13;Ciudad Real;073;Saceruela;518;262;256;2024
13;Ciudad Real;074;San Carlos del Valle;1071;542;529;2024
13;Ciudad Real;075;San Lorenzo de Calatrava;197;109;88;2024
13;Ciudad Real;076;Santa Cruz de los Cáñamos;471;223;248;2024
13;Ciudad Real;077;Santa Cruz de Mudela;3871;1926;1945;2024
13;Ciudad Real;078;Socuéllamos;12157;6128;6029;2024
13;Ciudad Real;079;Solana, La;15225;7796;7429;2024
13;Ciudad Real;080;Solana del Pino;332;171;161;2024
13;Ciudad Real;081;Terrinches;586;307;279;2024
13;Ciudad Real;082;Tomelloso;36523;18273;18250;2024
13;Ciudad Real;083;Torralba de Calatrava;3075;1535;1540;2024
13;Ciudad Real;084;Torre de Juan Abad;944;470;474;2024
13;Ciudad Real;085;Torrenueva;2669;1350;1319;2024
13;Ciudad Real;086;Valdemanco del Esteras;163;87;76;2024
13;Ciudad Real;087;Valdepeñas;30617;14946;15671;2024
13;Ciudad Real;088;Valenzuela de Calatrava;653;310;343;2024
13;Ciudad Real;089;Villahermosa;1709;851;858;2024
13;Ciudad Real;090;Villamanrique;1072;521;551;2024
13;Ciudad Real;091;Villamayor de Calatrava;619;304;315;2024
13;Ciudad Real;092;Villanueva de la Fuente;1883;974;909;2024
13;Ciudad Real;093;Villanueva de los Infantes;4785;2375;2410;2024
13;Ciudad Real;094;Villanueva de San Carlos;272;141;131;2024
13;Ciudad Real;095;Villar del Pozo;47;29;18;2024
13;Ciudad Real;096;Villarrubia de los Ojos;9620;4827;4793;2024
13;Ciudad Real;097;Villarta de San Juan;2698;1356;1342;2024
13;Ciudad Real;098;Viso del Marqués;2081;1015;1066;2024
13;Ciudad Real;901;Robledo, El;1049;551;498;2024
13;Ciudad Real;902;Ruidera;533;263;270;2024
13;Ciudad Real;903;Arenales de San Gregorio;617;325;292;2024
13;Ciudad Real;904;Llanos del Caudillo;657;320;337;2024
14;Córdoba;001;Adamuz;4091;2067;2024;2024
14;Córdoba;002;Aguilar de la Frontera;13210;6553;6657;2024
14;Córdoba;003;Alcaracejos;1501;728;773;2024
14;Córdoba;004;Almedinilla;2323;1151;1172;2024
14;Córdoba;005;Almodóvar del Río;7981;3977;4004;2024
14;Córdoba;006;Añora;1503;748;755;2024
14;Córdoba;007;Baena;18436;9204;9232;2024
14;Córdoba;008;Belalcázar;3099;1530;1569;2024
14;Córdoba;009;Belmez;2818;1361;1457;2024
14;Córdoba;010;Benamejí;4910;2419;2491;2024
14;Córdoba;011;Blázquez, Los;635;313;322;2024
14;Córdoba;012;Bujalance;7134;3580;3554;2024
14;Córdoba;013;Cabra;20024;9748;10276;2024
14;Córdoba;014;Cañete de las Torres;2806;1425;1381;2024
14;Córdoba;015;Carcabuey;2299;1160;1139;2024
14;Córdoba;016;Cardeña;1422;721;701;2024
14;Córdoba;017;Carlota, La;14381;7125;7256;2024
14;Córdoba;018;Carpio, El;4325;2121;2204;2024
14;Córdoba;019;Castro del Río;7612;3751;3861;2024
14;Córdoba;020;Conquista;373;189;184;2024
14;Córdoba;021;Córdoba;322811;154816;167995;2024
14;Córdoba;022;Doña Mencía;4478;2163;2315;2024
14;Córdoba;023;Dos Torres;2365;1178;1187;2024
14;Córdoba;024;Encinas Reales;2234;1096;1138;2024
14;Córdoba;025;Espejo;3177;1582;1595;2024
14;Córdoba;026;Espiel;2341;1180;1161;2024
14;Córdoba;027;Fernán-Núñez;9638;4768;4870;2024
14;Córdoba;028;Fuente la Lancha;339;172;167;2024
14;Córdoba;029;Fuente Obejuna;4346;2249;2097;2024
14;Córdoba;030;Fuente Palmera;9907;4940;4967;2024
14;Córdoba;031;Fuente-Tójar;681;324;357;2024
14;Córdoba;032;Granjuela, La;414;202;212;2024
14;Córdoba;033;Guadalcázar;1556;794;762;2024
14;Córdoba;034;Guijo, El;346;176;170;2024
14;Córdoba;035;Hinojosa del Duque;6563;3224;3339;2024
14;Córdoba;036;Hornachuelos;4390;2192;2198;2024
14;Córdoba;037;Iznájar;3739;1893;1846;2024
14;Córdoba;038;Lucena;43086;21377;21709;2024
14;Córdoba;039;Luque;2809;1415;1394;2024
14;Córdoba;040;Montalbán de Córdoba;4435;2179;2256;2024
14;Córdoba;041;Montemayor;3885;1965;1920;2024
14;Córdoba;042;Montilla;22333;11012;11321;2024
14;Córdoba;043;Montoro;9049;4457;4592;2024
14;Córdoba;044;Monturque;1933;962;971;2024
14;Córdoba;045;Moriles;3643;1831;1812;2024
14;Córdoba;046;Nueva Carteya;5307;2716;2591;2024
14;Córdoba;047;Obejo;2085;1088;997;2024
14;Córdoba;048;Palenciana;1431;739;692;2024
14;Córdoba;049;Palma del Río;20546;10190;10356;2024
14;Córdoba;050;Pedro Abad;2817;1431;1386;2024
14;Córdoba;051;Pedroche;1456;724;732;2024
14;Córdoba;052;Peñarroya-Pueblonuevo;10289;4959;5330;2024
14;Córdoba;053;Posadas;7224;3588;3636;2024
14;Córdoba;054;Pozoblanco;16946;8235;8711;2024
14;Córdoba;055;Priego de Córdoba;21826;10634;11192;2024
14;Córdoba;056;Puente Genil;29844;14689;15155;2024
14;Córdoba;057;Rambla, La;7438;3704;3734;2024
14;Córdoba;058;Rute;9765;4878;4887;2024
14;Córdoba;059;San Sebastián de los Ballesteros;854;423;431;2024
14;Córdoba;060;Santaella;4655;2340;2315;2024
14;Córdoba;061;Santa Eufemia;710;348;362;2024
14;Córdoba;062;Torrecampo;1000;499;501;2024
14;Córdoba;063;Valenzuela;1041;526;515;2024
14;Córdoba;064;Valsequillo;362;175;187;2024
14;Córdoba;065;Victoria, La;2335;1158;1177;2024
14;Córdoba;066;Villa del Río;6863;3419;3444;2024
14;Córdoba;067;Villafranca de Córdoba;4886;2483;2403;2024
14;Córdoba;068;Villaharta;634;305;329;2024
14;Córdoba;069;Villanueva de Córdoba;8381;4147;4234;2024
14;Córdoba;070;Villanueva del Duque;1404;698;706;2024
14;Córdoba;071;Villanueva del Rey;1014;487;527;2024
14;Córdoba;072;Villaralto;1075;549;526;2024
14;Córdoba;073;Villaviciosa de Córdoba;3064;1566;1498;2024
14;Córdoba;074;Viso, El;2511;1275;1236;2024
14;Córdoba;075;Zuheros;608;314;294;2024
14;Córdoba;901;Fuente Carreteros;1067;546;521;2024
14;Córdoba;902;Guijarrosa, La;1333;684;649;2024
15;Coruña, A;001;Abegondo;5578;2784;2794;2024
15;Coruña, A;002;Ames;32812;15739;17073;2024
15;Coruña, A;003;Aranga;1799;921;878;2024
15;Coruña, A;004;Ares;6156;3023;3133;2024
15;Coruña, A;005;Arteixo;34038;16775;17263;2024
15;Coruña, A;006;Arzúa;5887;2915;2972;2024
15;Coruña, A;007;Baña, A;3291;1561;1730;2024
15;Coruña, A;008;Bergondo;6986;3419;3567;2024
15;Coruña, A;009;Betanzos;13261;6315;6946;2024
15;Coruña, A;010;Boimorto;1801;906;895;2024
15;Coruña, A;011;Boiro;19018;9235;9783;2024
15;Coruña, A;012;Boqueixón;4200;2055;2145;2024
15;Coruña, A;013;Brión;8197;3954;4243;2024
15;Coruña, A;014;Cabana de Bergantiños;4098;1987;2111;2024
15;Coruña, A;015;Cabanas;3296;1614;1682;2024
15;Coruña, A;016;Camariñas;5098;2510;2588;2024
15;Coruña, A;017;Cambre;24781;12071;12710;2024
15;Coruña, A;018;Capela, A;1182;578;604;2024
15;Coruña, A;019;Carballo;31595;15400;16195;2024
15;Coruña, A;020;Carnota;3800;1813;1987;2024
15;Coruña, A;021;Carral;6775;3338;3437;2024
15;Coruña, A;022;Cedeira;6548;3243;3305;2024
15;Coruña, A;023;Cee;7740;3692;4048;2024
15;Coruña, A;024;Cerceda;5085;2516;2569;2024
15;Coruña, A;025;Cerdido;1004;487;517;2024
15;Coruña, A;027;Coirós;1931;955;976;2024
15;Coruña, A;028;Corcubión;1678;840;838;2024
15;Coruña, A;029;Coristanco;5744;2769;2975;2024
15;Coruña, A;030;Coruña, A;249261;115393;133868;2024
15;Coruña, A;031;Culleredo;31085;14958;16127;2024
15;Coruña, A;032;Curtis;4181;2110;2071;2024
15;Coruña, A;033;Dodro;2620;1244;1376;2024
15;Coruña, A;034;Dumbría;2776;1323;1453;2024
15;Coruña, A;035;Fene;12530;5958;6572;2024
15;Coruña, A;036;Ferrol;64218;30347;33871;2024
15;Coruña, A;037;Fisterra;4704;2393;2311;2024
15;Coruña, A;038;Frades;2163;1073;1090;2024
15;Coruña, A;039;Irixoa;1326;662;664;2024
15;Coruña, A;040;Laxe;2919;1460;1459;2024
15;Coruña, A;041;Laracha, A;11603;5709;5894;2024
15;Coruña, A;042;Lousame;3099;1548;1551;2024
15;Coruña, A;043;Malpica de Bergantiños;5267;2575;2692;2024
15;Coruña, A;044;Mañón;1223;605;618;2024
15;Coruña, A;045;Mazaricos;3719;1783;1936;2024
15;Coruña, A;046;Melide;7734;3777;3957;2024
15;Coruña, A;047;Mesía;2383;1200;1183;2024
15;Coruña, A;048;Miño;6946;3447;3499;2024
15;Coruña, A;049;Moeche;1200;585;615;2024
15;Coruña, A;050;Monfero;1818;917;901;2024
15;Coruña, A;051;Mugardos;5195;2511;2684;2024
15;Coruña, A;052;Muxía;4380;2120;2260;2024
15;Coruña, A;053;Muros;8184;3945;4239;2024
15;Coruña, A;054;Narón;39285;18911;20374;2024
15;Coruña, A;055;Neda;4868;2366;2502;2024
15;Coruña, A;056;Negreira;6961;3339;3622;2024
15;Coruña, A;057;Noia;14092;6714;7378;2024
15;Coruña, A;058;Oleiros;38333;18399;19934;2024
15;Coruña, A;059;Ordes;12772;6243;6529;2024
15;Coruña, A;060;Oroso;7757;3817;3940;2024
15;Coruña, A;061;Ortigueira;5418;2558;2860;2024
15;Coruña, A;062;Outes;6049;2916;3133;2024
15;Coruña, A;064;Paderne;2387;1171;1216;2024
15;Coruña, A;065;Padrón;8256;3988;4268;2024
15;Coruña, A;066;Pino, O;4581;2305;2276;2024
15;Coruña, A;067;Pobra do Caramiñal, A;9184;4519;4665;2024
15;Coruña, A;068;Ponteceso;5318;2681;2637;2024
15;Coruña, A;069;Pontedeume;7456;3574;3882;2024
15;Coruña, A;070;Pontes de García Rodríguez, As;9782;4774;5008;2024
15;Coruña, A;071;Porto do Son;9064;4512;4552;2024
15;Coruña, A;072;Rianxo;10748;5266;5482;2024
15;Coruña, A;073;Ribeira;27111;13411;13700;2024
15;Coruña, A;074;Rois;4395;2104;2291;2024
15;Coruña, A;075;Sada;17140;8326;8814;2024
15;Coruña, A;076;San Sadurniño;2733;1356;1377;2024
15;Coruña, A;077;Santa Comba;9319;4551;4768;2024
15;Coruña, A;078;Santiago de Compostela;99536;46134;53402;2024
15;Coruña, A;079;Santiso;1453;752;701;2024
15;Coruña, A;080;Sobrado;1754;921;833;2024
15;Coruña, A;081;Somozas, As;1068;539;529;2024
15;Coruña, A;082;Teo;19045;9313;9732;2024
15;Coruña, A;083;Toques;1070;558;512;2024
15;Coruña, A;084;Tordoia;3181;1533;1648;2024
15;Coruña, A;085;Touro;3387;1691;1696;2024
15;Coruña, A;086;Trazo;2979;1458;1521;2024
15;Coruña, A;087;Valdoviño;6857;3340;3517;2024
15;Coruña, A;088;Val do Dubra;3734;1802;1932;2024
15;Coruña, A;089;Vedra;4942;2428;2514;2024
15;Coruña, A;090;Vilasantar;1229;646;583;2024
15;Coruña, A;091;Vilarmaior;1252;643;609;2024
15;Coruña, A;092;Vimianzo;6808;3284;3524;2024
15;Coruña, A;093;Zas;4261;2055;2206;2024
15;Coruña, A;901;Cariño;3691;1814;1877;2024
15;Coruña, A;902;Oza-Cesuras;5151;2609;2542;2024
16;Cuenca;001;Abia de la Obispalía;59;38;21;2024
16;Cuenca;002;Acebrón, El;230;114;116;2024
16;Cuenca;003;Alarcón;176;78;98;2024
16;Cuenca;004;Albaladejo del Cuende;215;118;97;2024
16;Cuenca;005;Albalate de las Nogueras;271;142;129;2024
16;Cuenca;006;Albendea;119;61;58;2024
16;Cuenca;007;Alberca de Záncara, La;1531;779;752;2024
16;Cuenca;008;Alcalá de la Vega;70;42;28;2024
16;Cuenca;009;Alcantud;58;33;25;2024
16;Cuenca;010;Alcázar del Rey;167;92;75;2024
16;Cuenca;011;Alcohujate;27;15;12;2024
16;Cuenca;012;Alconchel de la Estrella;75;45;30;2024
16;Cuenca;013;Algarra;25;16;9;2024
16;Cuenca;014;Aliaguilla;611;315;296;2024
16;Cuenca;015;Almarcha, La;423;229;194;2024
16;Cuenca;016;Almendros;238;125;113;2024
16;Cuenca;017;Almodóvar del Pinar;397;212;185;2024
16;Cuenca;018;Almonacid del Marquesado;417;217;200;2024
16;Cuenca;019;Altarejos;204;116;88;2024
16;Cuenca;020;Arandilla del Arroyo;14;7;7;2024
16;Cuenca;022;Arcos de la Sierra;86;54;32;2024
16;Cuenca;023;Chillarón de Cuenca;864;460;404;2024
16;Cuenca;024;Arguisuelas;129;64;65;2024
16;Cuenca;025;Arrancacepas;16;9;7;2024
16;Cuenca;026;Atalaya del Cañavate;98;55;43;2024
16;Cuenca;027;Barajas de Melo;973;520;453;2024
16;Cuenca;029;Barchín del Hoyo;101;66;35;2024
16;Cuenca;030;Bascuñana de San Pedro;24;20;4;2024
16;Cuenca;031;Beamud;48;27;21;2024
16;Cuenca;032;Belinchón;437;223;214;2024
16;Cuenca;033;Belmonte;1769;876;893;2024
16;Cuenca;034;Belmontejo;129;76;53;2024
16;Cuenca;035;Beteta;235;123;112;2024
16;Cuenca;036;Boniches;136;70;66;2024
16;Cuenca;038;Buciegas;38;25;13;2024
16;Cuenca;039;Buenache de Alarcón;440;234;206;2024
16;Cuenca;040;Buenache de la Sierra;109;61;48;2024
16;Cuenca;041;Buendía;423;227;196;2024
16;Cuenca;042;Campillo de Altobuey;1286;658;628;2024
16;Cuenca;043;Campillos-Paravientos;110;63;47;2024
16;Cuenca;044;Campillos-Sierra;32;16;16;2024
16;Cuenca;045;Canalejas del Arroyo;157;86;71;2024
16;Cuenca;046;Cañada del Hoyo;230;125;105;2024
16;Cuenca;047;Cañada Juncosa;217;118;99;2024
16;Cuenca;048;Cañamares;454;247;207;2024
16;Cuenca;049;Cañavate, El;128;64;64;2024
16;Cuenca;050;Cañaveras;220;113;107;2024
16;Cuenca;051;Cañaveruelas;118;57;61;2024
16;Cuenca;052;Cañete;843;435;408;2024
16;Cuenca;053;Cañizares;440;241;199;2024
16;Cuenca;055;Carboneras de Guadazaón;787;405;382;2024
16;Cuenca;056;Cardenete;474;245;229;2024
16;Cuenca;057;Carrascosa;70;47;23;2024
16;Cuenca;058;Carrascosa de Haro;91;44;47;2024
16;Cuenca;060;Casas de Benítez;834;426;408;2024
16;Cuenca;061;Casas de Fernando Alonso;1088;570;518;2024
16;Cuenca;062;Casas de Garcimolina;30;17;13;2024
16;Cuenca;063;Casas de Guijarro;102;58;44;2024
16;Cuenca;064;Casas de Haro;836;447;389;2024
16;Cuenca;065;Casas de los Pinos;389;198;191;2024
16;Cuenca;066;Casasimarro;3205;1634;1571;2024
16;Cuenca;067;Castejón;130;77;53;2024
16;Cuenca;068;Castillejo de Iniesta;102;59;43;2024
16;Cuenca;070;Castillejo-Sierra;33;16;17;2024
16;Cuenca;071;Castillo-Albaráñez;21;9;12;2024
16;Cuenca;072;Castillo de Garcimuñoz;132;79;53;2024
16;Cuenca;073;Cervera del Llano;209;107;102;2024
16;Cuenca;074;Cierva, La;39;22;17;2024
16;Cuenca;078;Cuenca;53429;25286;28143;2024
16;Cuenca;079;Cueva del Hierro;25;14;11;2024
16;Cuenca;081;Chumillas;55;32;23;2024
16;Cuenca;082;Enguídanos;294;158;136;2024
16;Cuenca;083;Fresneda de Altarejos;38;20;18;2024
16;Cuenca;084;Fresneda de la Sierra;41;25;16;2024
16;Cuenca;085;Frontera, La;148;82;66;2024
16;Cuenca;086;Fuente de Pedro Naharro;1269;672;597;2024
16;Cuenca;087;Fuentelespino de Haro;245;124;121;2024
16;Cuenca;088;Fuentelespino de Moya;105;57;48;2024
16;Cuenca;089;Fuentes;468;254;214;2024
16;Cuenca;091;Fuertescusa;69;42;27;2024
16;Cuenca;092;Gabaldón;159;93;66;2024
16;Cuenca;093;Garaballa;61;30;31;2024
16;Cuenca;094;Gascueña;130;75;55;2024
16;Cuenca;095;Graja de Campalbo;85;45;40;2024
16;Cuenca;096;Graja de Iniesta;357;189;168;2024
16;Cuenca;097;Henarejos;131;65;66;2024
16;Cuenca;098;Herrumblar, El;785;395;390;2024
16;Cuenca;099;Hinojosa, La;195;97;98;2024
16;Cuenca;100;Hinojosos, Los;721;367;354;2024
16;Cuenca;101;Hito, El;130;72;58;2024
16;Cuenca;102;Honrubia;1542;767;775;2024
16;Cuenca;103;Hontanaya;257;144;113;2024
16;Cuenca;104;Hontecillas;55;31;24;2024
16;Cuenca;106;Horcajo de Santiago;3754;1920;1834;2024
16;Cuenca;107;Huélamo;70;39;31;2024
16;Cuenca;108;Huelves;88;46;42;2024
16;Cuenca;109;Huérguina;44;23;21;2024
16;Cuenca;110;Huerta de la Obispalía;130;76;54;2024
16;Cuenca;111;Huerta del Marquesado;173;96;77;2024
16;Cuenca;112;Huete;1822;950;872;2024
16;Cuenca;113;Iniesta;4525;2272;2253;2024
16;Cuenca;115;Laguna del Marquesado;59;36;23;2024
16;Cuenca;116;Lagunaseca;49;29;20;2024
16;Cuenca;117;Landete;1215;625;590;2024
16;Cuenca;118;Ledaña;1602;804;798;2024
16;Cuenca;119;Leganiel;226;116;110;2024
16;Cuenca;121;Majadas, Las;217;118;99;2024
16;Cuenca;122;Mariana;314;168;146;2024
16;Cuenca;123;Masegosa;62;35;27;2024
16;Cuenca;124;Mesas, Las;2271;1177;1094;2024
16;Cuenca;125;Minglanilla;2322;1203;1119;2024
16;Cuenca;126;Mira;921;465;456;2024
16;Cuenca;128;Monreal del Llano;45;27;18;2024
16;Cuenca;129;Montalbanejo;84;41;43;2024
16;Cuenca;130;Montalbo;705;357;348;2024
16;Cuenca;131;Monteagudo de las Salinas;124;78;46;2024
16;Cuenca;132;Mota de Altarejos;27;18;9;2024
16;Cuenca;133;Mota del Cuervo;6121;3026;3095;2024
16;Cuenca;134;Motilla del Palancar;6259;3146;3113;2024
16;Cuenca;135;Moya;148;87;61;2024
16;Cuenca;137;Narboneta;43;24;19;2024
16;Cuenca;139;Olivares de Júcar;297;152;145;2024
16;Cuenca;140;Olmeda de la Cuesta;20;12;8;2024
16;Cuenca;141;Olmeda del Rey;123;66;57;2024
16;Cuenca;142;Olmedilla de Alarcón;128;76;52;2024
16;Cuenca;143;Olmedilla de Eliz;19;14;5;2024
16;Cuenca;145;Osa de la Vega;443;226;217;2024
16;Cuenca;146;Pajarón;75;37;38;2024
16;Cuenca;147;Pajaroncillo;62;36;26;2024
16;Cuenca;148;Palomares del Campo;555;279;276;2024
16;Cuenca;149;Palomera;191;90;101;2024
16;Cuenca;150;Paracuellos;99;52;47;2024
16;Cuenca;151;Paredes;68;38;30;2024
16;Cuenca;152;Parra de las Vegas, La;35;24;11;2024
16;Cuenca;153;Pedernoso, El;1117;558;559;2024
16;Cuenca;154;Pedroñeras, Las;6518;3317;3201;2024
16;Cuenca;155;Peral, El;648;370;278;2024
16;Cuenca;156;Peraleja, La;75;46;29;2024
16;Cuenca;157;Pesquera, La;234;123;111;2024
16;Cuenca;158;Picazo, El;704;369;335;2024
16;Cuenca;159;Pinarejo;181;93;88;2024
16;Cuenca;160;Pineda de Gigüela;55;35;20;2024
16;Cuenca;161;Piqueras del Castillo;40;25;15;2024
16;Cuenca;162;Portalrubio de Guadamejud;42;22;20;2024
16;Cuenca;163;Portilla;61;31;30;2024
16;Cuenca;165;Poyatos;71;46;25;2024
16;Cuenca;166;Pozoamargo;265;142;123;2024
16;Cuenca;167;Pozorrubio de Santiago;309;144;165;2024
16;Cuenca;169;Pozuelo, El;43;26;17;2024
16;Cuenca;170;Priego;925;468;457;2024
16;Cuenca;171;Provencio, El;2358;1189;1169;2024
16;Cuenca;172;Puebla de Almenara;312;162;150;2024
16;Cuenca;173;Valle de Altomira, El;205;114;91;2024
16;Cuenca;174;Puebla del Salvador;197;104;93;2024
16;Cuenca;175;Quintanar del Rey;7484;3860;3624;2024
16;Cuenca;176;Rada de Haro;47;29;18;2024
16;Cuenca;177;Reíllo;102;63;39;2024
16;Cuenca;181;Rozalén del Monte;54;25;29;2024
16;Cuenca;185;Saceda-Trasierra;41;23;18;2024
16;Cuenca;186;Saelices;464;246;218;2024
16;Cuenca;187;Salinas del Manzano;75;44;31;2024
16;Cuenca;188;Salmeroncillos;102;60;42;2024
16;Cuenca;189;Salvacañete;288;147;141;2024
16;Cuenca;190;San Clemente;6812;3436;3376;2024
16;Cuenca;191;San Lorenzo de la Parrilla;1134;596;538;2024
16;Cuenca;192;San Martín de Boniches;39;23;16;2024
16;Cuenca;193;San Pedro Palmiches;56;34;22;2024
16;Cuenca;194;Santa Cruz de Moya;232;115;117;2024
16;Cuenca;195;Santa María del Campo Rus;525;278;247;2024
16;Cuenca;196;Santa María de los Llanos;668;358;310;2024
16;Cuenca;197;Santa María del Val;63;36;27;2024
16;Cuenca;198;Sisante;1660;855;805;2024
16;Cuenca;199;Solera de Gabaldón;33;17;16;2024
16;Cuenca;202;Talayuelas;882;459;423;2024
16;Cuenca;203;Tarancón;16462;8153;8309;2024
16;Cuenca;204;Tébar;293;162;131;2024
16;Cuenca;205;Tejadillos;103;52;51;2024
16;Cuenca;206;Tinajas;195;109;86;2024
16;Cuenca;209;Torralba;113;66;47;2024
16;Cuenca;211;Torrejoncillo del Rey;338;190;148;2024
16;Cuenca;212;Torrubia del Campo;312;150;162;2024
16;Cuenca;213;Torrubia del Castillo;42;28;14;2024
16;Cuenca;215;Tragacete;261;151;110;2024
16;Cuenca;216;Tresjuncos;262;146;116;2024
16;Cuenca;217;Tribaldos;98;53;45;2024
16;Cuenca;218;Uclés;235;125;110;2024
16;Cuenca;219;Uña;89;52;37;2024
16;Cuenca;224;Valdemeca;82;49;33;2024
16;Cuenca;225;Valdemorillo de la Sierra;56;34;22;2024
16;Cuenca;227;Valdemoro-Sierra;99;58;41;2024
16;Cuenca;228;Valdeolivas;202;125;77;2024
16;Cuenca;231;Valhermoso de la Fuente;59;34;25;2024
16;Cuenca;234;Valsalobre;20;12;8;2024
16;Cuenca;236;Valverde de Júcar;1097;553;544;2024
16;Cuenca;237;Valverdejo;87;45;42;2024
16;Cuenca;238;Vara de Rey;470;236;234;2024
16;Cuenca;239;Vega del Codorno;143;82;61;2024
16;Cuenca;240;Vellisca;125;71;54;2024
16;Cuenca;242;Villaconejos de Trabaque;325;173;152;2024
16;Cuenca;243;Villaescusa de Haro;459;250;209;2024
16;Cuenca;244;Villagarcía del Llano;757;381;376;2024
16;Cuenca;245;Villalba de la Sierra;561;277;284;2024
16;Cuenca;246;Villalba del Rey;483;268;215;2024
16;Cuenca;247;Villalgordo del Marquesado;64;38;26;2024
16;Cuenca;248;Villalpardo;1000;501;499;2024
16;Cuenca;249;Villamayor de Santiago;2370;1213;1157;2024
16;Cuenca;250;Villanueva de Guadamejud;53;37;16;2024
16;Cuenca;251;Villanueva de la Jara;2340;1192;1148;2024
16;Cuenca;253;Villar de Cañas;368;199;169;2024
16;Cuenca;254;Villar de Domingo García;215;109;106;2024
16;Cuenca;255;Villar de la Encina;149;78;71;2024
16;Cuenca;258;Villar del Humo;176;101;75;2024
16;Cuenca;259;Villar del Infantado;31;20;11;2024
16;Cuenca;263;Villar de Olalla;1512;803;709;2024
16;Cuenca;264;Villarejo de Fuentes;400;199;201;2024
16;Cuenca;265;Villarejo de la Peñuela;18;11;7;2024
16;Cuenca;266;Villarejo-Periesteban;377;191;186;2024
16;Cuenca;269;Villares del Saz;495;267;228;2024
16;Cuenca;270;Villarrubio;213;115;98;2024
16;Cuenca;271;Villarta;847;422;425;2024
16;Cuenca;272;Villas de la Ventosa;221;126;95;2024
16;Cuenca;273;Villaverde y Pasaconsol;321;174;147;2024
16;Cuenca;274;Víllora;127;65;62;2024
16;Cuenca;275;Vindel;16;10;6;2024
16;Cuenca;276;Yémeda;19;14;5;2024
16;Cuenca;277;Zafra de Záncara;90;54;36;2024
16;Cuenca;278;Zafrilla;53;29;24;2024
16;Cuenca;279;Zarza de Tajo;274;151;123;2024
16;Cuenca;280;Zarzuela;163;95;68;2024
16;Cuenca;901;Campos del Paraíso;648;330;318;2024
16;Cuenca;902;Valdetórtola;123;70;53;2024
16;Cuenca;903;Valeras, Las;1564;838;726;2024
16;Cuenca;904;Fuentenava de Jábaga;610;315;295;2024
16;Cuenca;905;Arcas;2264;1147;1117;2024
16;Cuenca;906;Valdecolmenas, Los;71;46;25;2024
16;Cuenca;908;Pozorrubielos de la Mancha;164;84;80;2024
16;Cuenca;909;Sotorribas;707;367;340;2024
16;Cuenca;910;Villar y Velasco;76;42;34;2024
17;Girona;001;Agullana;909;448;461;2024
17;Girona;002;Aiguaviva;802;403;399;2024
17;Girona;003;Albanyà;168;85;83;2024
17;Girona;004;Albons;830;425;405;2024
17;Girona;005;Far d'Empordà, El;626;313;313;2024
17;Girona;006;Alp;1728;892;836;2024
17;Girona;007;Amer;2415;1206;1209;2024
17;Girona;008;Anglès;5969;2989;2980;2024
17;Girona;009;Arbúcies;6574;3379;3195;2024
17;Girona;010;Argelaguer;452;234;218;2024
17;Girona;011;Armentera, L';1070;540;530;2024
17;Girona;012;Avinyonet de Puigventós;1684;841;843;2024
17;Girona;013;Begur;4245;2123;2122;2024
17;Girona;014;Vajol, La;96;55;41;2024
17;Girona;015;Banyoles;20599;10188;10411;2024
17;Girona;016;Bàscara;1057;539;518;2024
17;Girona;018;Bellcaire d'Empordà;737;361;376;2024
17;Girona;019;Besalú;2583;1234;1349;2024
17;Girona;020;Bescanó;5141;2588;2553;2024
17;Girona;021;Beuda;204;104;100;2024
17;Girona;022;Bisbal d'Empordà, La;11683;5870;5813;2024
17;Girona;023;Blanes;42198;20955;21243;2024
17;Girona;024;Bolvir;497;255;242;2024
17;Girona;025;Bordils;1804;906;898;2024
17;Girona;026;Borrassà;773;399;374;2024
17;Girona;027;Breda;3930;1918;2012;2024
17;Girona;028;Brunyola i Sant Martí Sapresa;395;205;190;2024
17;Girona;029;Boadella i les Escaules;260;130;130;2024
17;Girona;030;Cabanes;978;513;465;2024
17;Girona;031;Cabanelles;281;154;127;2024
17;Girona;032;Cadaqués;2918;1430;1488;2024
17;Girona;033;Caldes de Malavella;8509;4227;4282;2024
17;Girona;034;Calonge i Sant Antoni;12316;6131;6185;2024
17;Girona;035;Camós;711;347;364;2024
17;Girona;036;Campdevànol;3262;1604;1658;2024
17;Girona;037;Campelles;165;86;79;2024
17;Girona;038;Campllong;544;271;273;2024
17;Girona;039;Camprodon;2527;1228;1299;2024
17;Girona;040;Canet d'Adri;744;373;371;2024
17;Girona;041;Cantallops;346;169;177;2024
17;Girona;042;Capmany;693;357;336;2024
17;Girona;043;Queralbs;206;113;93;2024
17;Girona;044;Cassà de la Selva;10943;5573;5370;2024
17;Girona;046;Castellfollit de la Roca;957;489;468;2024
17;Girona;047;Castelló d'Empúries;12163;6249;5914;2024
17;Girona;048;Castell d'Aro, Platja d'Aro i s'Agaró;12981;6372;6609;2024
17;Girona;049;Celrà;5561;2778;2783;2024
17;Girona;050;Cervià de Ter;997;508;489;2024
17;Girona;051;Cistella;294;147;147;2024
17;Girona;052;Siurana;180;85;95;2024
17;Girona;054;Colera;491;251;240;2024
17;Girona;055;Colomers;205;107;98;2024
17;Girona;056;Cornellà del Terri;2390;1190;1200;2024
17;Girona;057;Corçà;1282;658;624;2024
17;Girona;058;Crespià;250;132;118;2024
17;Girona;060;Darnius;548;292;256;2024
17;Girona;061;Das;270;144;126;2024
17;Girona;062;Escala, L';10429;5201;5228;2024
17;Girona;063;Espinelves;254;119;135;2024
17;Girona;064;Espolla;412;206;206;2024
17;Girona;065;Esponellà;438;225;213;2024
17;Girona;066;Figueres;48875;24245;24630;2024
17;Girona;067;Flaçà;1145;548;597;2024
17;Girona;068;Foixà;292;150;142;2024
17;Girona;069;Fontanals de Cerdanya;531;277;254;2024
17;Girona;070;Fontanilles;168;91;77;2024
17;Girona;071;Fontcoberta;1503;771;732;2024
17;Girona;073;Fornells de la Selva;2781;1387;1394;2024
17;Girona;074;Fortià;801;387;414;2024
17;Girona;075;Garrigàs;472;248;224;2024
17;Girona;076;Garrigoles;185;101;84;2024
17;Girona;077;Garriguella;967;490;477;2024
17;Girona;078;Ger;494;270;224;2024
17;Girona;079;Girona;107032;51654;55378;2024
17;Girona;080;Gombrèn;196;96;100;2024
17;Girona;081;Gualta;419;250;169;2024
17;Girona;082;Guils de Cerdanya;566;302;264;2024
17;Girona;083;Hostalric;4446;2251;2195;2024
17;Girona;084;Isòvol;330;179;151;2024
17;Girona;085;Jafre;387;200;187;2024
17;Girona;086;Jonquera, La;3408;1703;1705;2024
17;Girona;087;Juià;342;181;161;2024
17;Girona;088;Lladó;829;419;410;2024
17;Girona;089;Llagostera;9508;4809;4699;2024
17;Girona;090;Llambilles;730;376;354;2024
17;Girona;091;Llanars;515;258;257;2024
17;Girona;092;Llançà;4943;2436;2507;2024
17;Girona;093;Llers;1248;625;623;2024
17;Girona;094;Llívia;1560;805;755;2024
17;Girona;095;Lloret de Mar;42600;21400;21200;2024
17;Girona;096;Llosses, Les;199;115;84;2024
17;Girona;097;Madremanya;289;145;144;2024
17;Girona;098;Maià de Montcal;491;267;224;2024
17;Girona;099;Meranges;112;63;49;2024
17;Girona;100;Masarac;297;161;136;2024
17;Girona;101;Massanes;843;443;400;2024
17;Girona;102;Maçanet de Cabrenys;772;391;381;2024
17;Girona;103;Maçanet de la Selva;7962;4113;3849;2024
17;Girona;105;Mieres;349;178;171;2024
17;Girona;106;Mollet de Peralada;215;112;103;2024
17;Girona;107;Molló;374;176;198;2024
17;Girona;109;Montagut i Oix;1000;518;482;2024
17;Girona;110;Mont-ras;1690;861;829;2024
17;Girona;111;Navata;1469;726;743;2024
17;Girona;112;Ogassa;218;124;94;2024
17;Girona;114;Olot;38822;19805;19017;2024
17;Girona;115;Ordis;400;216;184;2024
17;Girona;116;Osor;418;223;195;2024
17;Girona;117;Palafrugell;24300;12095;12205;2024
17;Girona;118;Palamós;18651;9145;9506;2024
17;Girona;119;Palau de Santa Eulàlia;136;78;58;2024
17;Girona;120;Palau-saverdera;1503;755;748;2024
17;Girona;121;Palau-sator;300;169;131;2024
17;Girona;123;Palol de Revardit;465;231;234;2024
17;Girona;124;Pals;2556;1312;1244;2024
17;Girona;125;Pardines;161;91;70;2024
17;Girona;126;Parlavà;427;213;214;2024
17;Girona;128;Pau;584;285;299;2024
17;Girona;129;Pedret i Marzà;188;90;98;2024
17;Girona;130;Pera, La;450;225;225;2024
17;Girona;132;Peralada;2047;1011;1036;2024
17;Girona;133;Planes d'Hostoles, Les;1746;887;859;2024
17;Girona;134;Planoles;306;174;132;2024
17;Girona;135;Pont de Molins;576;286;290;2024
17;Girona;136;Pontós;290;151;139;2024
17;Girona;137;Porqueres;4804;2379;2425;2024
17;Girona;138;Portbou;1082;536;546;2024
17;Girona;139;Preses, Les;1925;947;978;2024
17;Girona;140;Port de la Selva, El;1061;531;530;2024
17;Girona;141;Puigcerdà;10008;5016;4992;2024
17;Girona;142;Quart;4099;2083;2016;2024
17;Girona;143;Rabós;230;111;119;2024
17;Girona;144;Regencós;279;148;131;2024
17;Girona;145;Ribes de Freser;1847;943;904;2024
17;Girona;146;Riells i Viabrea;4499;2291;2208;2024
17;Girona;147;Ripoll;10692;5328;5364;2024
17;Girona;148;Riudarenes;2445;1243;1202;2024
17;Girona;149;Riudaura;529;263;266;2024
17;Girona;150;Riudellots de la Selva;2142;1089;1053;2024
17;Girona;151;Riumors;262;141;121;2024
17;Girona;152;Roses;20362;10285;10077;2024
17;Girona;153;Rupià;330;161;169;2024
17;Girona;154;Sales de Llierca;158;84;74;2024
17;Girona;155;Salt;33904;17940;15964;2024
17;Girona;157;Sant Andreu Salou;172;84;88;2024
17;Girona;158;Sant Climent Sescebes;675;398;277;2024
17;Girona;159;Sant Feliu de Buixalleu;878;445;433;2024
17;Girona;160;Sant Feliu de Guíxols;23050;11321;11729;2024
17;Girona;161;Sant Feliu de Pallerols;1692;906;786;2024
17;Girona;162;Sant Ferriol;233;127;106;2024
17;Girona;163;Sant Gregori;4243;2135;2108;2024
17;Girona;164;Sant Hilari Sacalm;5982;3022;2960;2024
17;Girona;165;Sant Jaume de Llierca;849;419;430;2024
17;Girona;166;Sant Jordi Desvalls;871;414;457;2024
17;Girona;167;Sant Joan de les Abadesses;3375;1680;1695;2024
17;Girona;168;Sant Joan de Mollet;526;258;268;2024
17;Girona;169;Sant Julià de Ramis;3644;1838;1806;2024
17;Girona;170;Vallfogona de Ripollès;222;115;107;2024
17;Girona;171;Sant Llorenç de la Muga;258;136;122;2024
17;Girona;172;Sant Martí de Llémena;706;356;350;2024
17;Girona;173;Sant Martí Vell;264;143;121;2024
17;Girona;174;Sant Miquel de Campmajor;254;134;120;2024
17;Girona;175;Sant Miquel de Fluvià;839;441;398;2024
17;Girona;176;Sant Mori;163;81;82;2024
17;Girona;177;Sant Pau de Segúries;724;357;367;2024
17;Girona;178;Sant Pere Pescador;2241;1198;1043;2024
17;Girona;180;Santa Coloma de Farners;13657;6909;6748;2024
17;Girona;181;Santa Cristina d'Aro;5866;2976;2890;2024
17;Girona;182;Santa Llogaia d'Àlguema;397;197;200;2024
17;Girona;183;Sant Aniol de Finestres;372;197;175;2024
17;Girona;184;Santa Pau;1611;809;802;2024
17;Girona;185;Sant Joan les Fonts;3111;1571;1540;2024
17;Girona;186;Sarrià de Ter;5392;2686;2706;2024
17;Girona;187;Saus, Camallera i Llampaies;898;444;454;2024
17;Girona;188;Selva de Mar, La;220;111;109;2024
17;Girona;189;Cellera de Ter, La;2014;1000;1014;2024
17;Girona;190;Serinyà;1198;616;582;2024
17;Girona;191;Serra de Daró;229;122;107;2024
17;Girona;192;Setcases;191;107;84;2024
17;Girona;193;Sils;6720;3447;3273;2024
17;Girona;194;Susqueda;97;59;38;2024
17;Girona;195;Tallada d'Empordà, La;478;253;225;2024
17;Girona;196;Terrades;345;166;179;2024
17;Girona;197;Torrent;173;94;79;2024
17;Girona;198;Torroella de Fluvià;772;387;385;2024
17;Girona;199;Torroella de Montgrí;12521;6459;6062;2024
17;Girona;200;Tortellà;828;387;441;2024
17;Girona;201;Toses;191;108;83;2024
17;Girona;202;Tossa de Mar;6274;3171;3103;2024
17;Girona;203;Ultramort;214;112;102;2024
17;Girona;204;Ullà;1219;655;564;2024
17;Girona;205;Ullastret;260;135;125;2024
17;Girona;206;Urús;207;107;100;2024
17;Girona;207;Vall d'en Bas, La;3219;1630;1589;2024
17;Girona;208;Vall de Bianya, La;1350;669;681;2024
17;Girona;209;Vall-llobrega;906;467;439;2024
17;Girona;210;Ventalló;891;451;440;2024
17;Girona;211;Verges;1187;587;600;2024
17;Girona;212;Vidrà;169;83;86;2024
17;Girona;213;Vidreres;8538;4436;4102;2024
17;Girona;214;Vilabertran;984;494;490;2024
17;Girona;215;Vilablareix;3772;1875;1897;2024
17;Girona;216;Viladasens;212;115;97;2024
17;Girona;217;Viladamat;492;259;233;2024
17;Girona;218;Vilademuls;866;447;419;2024
17;Girona;220;Viladrau;1172;589;583;2024
17;Girona;221;Vilafant;5706;2820;2886;2024
17;Girona;222;Vilaür;170;90;80;2024
17;Girona;223;Vilajuïga;1179;585;594;2024
17;Girona;224;Vilallonga de Ter;395;216;179;2024
17;Girona;225;Vilamacolum;376;210;166;2024
17;Girona;226;Vilamalla;1220;620;600;2024
17;Girona;227;Vilamaniscle;201;119;82;2024
17;Girona;228;Vilanant;402;194;208;2024
17;Girona;230;Vila-sacra;811;390;421;2024
17;Girona;232;Vilopriu;201;108;93;2024
17;Girona;233;Vilobí d'Onyar;3315;1709;1606;2024
17;Girona;234;Biure;223;121;102;2024
17;Girona;901;Cruïlles, Monells i Sant Sadurní de l'Heura;1329;680;649;2024
17;Girona;902;Forallac;1766;857;909;2024
17;Girona;903;Sant Julià del Llor i Bonmatí;1373;706;667;2024
18;Granada;001;Agrón;244;125;119;2024
18;Granada;002;Alamedilla;543;277;266;2024
18;Granada;003;Albolote;19587;9597;9990;2024
18;Granada;004;Albondón;712;402;310;2024
18;Granada;005;Albuñán;422;223;199;2024
18;Granada;006;Albuñol;7357;4039;3318;2024
18;Granada;007;Albuñuelas;794;401;393;2024
18;Granada;010;Aldeire;592;307;285;2024
18;Granada;011;Alfacar;5784;2940;2844;2024
18;Granada;012;Algarinejo;2335;1196;1139;2024
18;Granada;013;Alhama de Granada;5657;2937;2720;2024
18;Granada;014;Alhendín;10399;5233;5166;2024
18;Granada;015;Alicún de Ortega;454;225;229;2024
18;Granada;016;Almegíjar;325;162;163;2024
18;Granada;017;Almuñécar;27311;13553;13758;2024
18;Granada;018;Alquife;557;283;274;2024
18;Granada;020;Arenas del Rey;610;317;293;2024
18;Granada;021;Armilla;25405;12491;12914;2024
18;Granada;022;Atarfe;20455;10300;10155;2024
18;Granada;023;Baza;20562;10190;10372;2024
18;Granada;024;Beas de Granada;1009;529;480;2024
18;Granada;025;Beas de Guadix;316;160;156;2024
18;Granada;027;Benalúa;3339;1635;1704;2024
18;Granada;028;Benalúa de las Villas;1021;535;486;2024
18;Granada;029;Benamaurel;2246;1118;1128;2024
18;Granada;030;Bérchules;695;378;317;2024
18;Granada;032;Bubión;311;164;147;2024
18;Granada;033;Busquístar;308;160;148;2024
18;Granada;034;Cacín;537;281;256;2024
18;Granada;035;Cádiar;1517;810;707;2024
18;Granada;036;Cájar;5492;2694;2798;2024
18;Granada;037;Calicasas;658;325;333;2024
18;Granada;038;Campotéjar;1245;635;610;2024
18;Granada;039;Caniles;3906;1997;1909;2024
18;Granada;040;Cáñar;389;209;180;2024
18;Granada;042;Capileira;576;286;290;2024
18;Granada;043;Carataunas;227;120;107;2024
18;Granada;044;Cástaras;210;120;90;2024
18;Granada;045;Castilléjar;1289;685;604;2024
18;Granada;046;Castril;1968;1025;943;2024
18;Granada;047;Cenes de la Vega;8296;4130;4166;2024
18;Granada;048;Cijuela;3714;1880;1834;2024
18;Granada;049;Cogollos de Guadix;639;362;277;2024
18;Granada;050;Cogollos de la Vega;2084;1059;1025;2024
18;Granada;051;Colomera;1278;682;596;2024
18;Granada;053;Cortes de Baza;1793;889;904;2024
18;Granada;054;Cortes y Graena;966;496;470;2024
18;Granada;056;Cúllar;3936;1963;1973;2024
18;Granada;057;Cúllar Vega;7809;3959;3850;2024
18;Granada;059;Chauchina;5781;2849;2932;2024
18;Granada;061;Chimeneas;1242;649;593;2024
18;Granada;062;Churriana de la Vega;16693;8209;8484;2024
18;Granada;063;Darro;1695;862;833;2024
18;Granada;064;Dehesas de Guadix;383;192;191;2024
18;Granada;065;Dehesas Viejas;640;330;310;2024
18;Granada;066;Deifontes;2622;1318;1304;2024
18;Granada;067;Diezma;810;432;378;2024
18;Granada;068;Dílar;2319;1161;1158;2024
18;Granada;069;Dólar;606;327;279;2024
18;Granada;070;Dúdar;373;196;177;2024
18;Granada;071;Dúrcal;7209;3633;3576;2024
18;Granada;072;Escúzar;845;450;395;2024
18;Granada;074;Ferreira;303;157;146;2024
18;Granada;076;Fonelas;964;506;458;2024
18;Granada;077;Fornes;531;282;249;2024
18;Granada;078;Freila;922;482;440;2024
18;Granada;079;Fuente Vaqueros;4625;2313;2312;2024
18;Granada;082;Galera;1116;562;554;2024
18;Granada;083;Gobernador;237;121;116;2024
18;Granada;084;Gójar;6340;3180;3160;2024
18;Granada;085;Gor;744;385;359;2024
18;Granada;086;Gorafe;373;196;177;2024
18;Granada;087;Granada;232717;107461;125256;2024
18;Granada;088;Guadahortuna;1830;927;903;2024
18;Granada;089;Guadix;18725;9296;9429;2024
18;Granada;093;Gualchos;5309;2797;2512;2024
18;Granada;094;Güéjar Sierra;2926;1554;1372;2024
18;Granada;095;Güevéjar;2660;1378;1282;2024
18;Granada;096;Huélago;358;191;167;2024
18;Granada;097;Huéneja;1177;636;541;2024
18;Granada;098;Huéscar;7234;3584;3650;2024
18;Granada;099;Huétor de Santillán;1938;1000;938;2024
18;Granada;100;Huétor Tájar;10653;5349;5304;2024
18;Granada;101;Huétor Vega;12294;6125;6169;2024
18;Granada;102;Íllora;9918;5012;4906;2024
18;Granada;103;Ítrabo;956;484;472;2024
18;Granada;105;Iznalloz;5154;2611;2543;2024
18;Granada;106;Játar;612;328;284;2024
18;Granada;107;Jayena;989;520;469;2024
18;Granada;108;Jérez del Marquesado;990;508;482;2024
18;Granada;109;Jete;995;527;468;2024
18;Granada;111;Jun;4145;2106;2039;2024
18;Granada;112;Juviles;138;71;67;2024
18;Granada;114;Calahorra, La;681;350;331;2024
18;Granada;115;Láchar;3826;1953;1873;2024
18;Granada;116;Lanjarón;3660;1833;1827;2024
18;Granada;117;Lanteira;543;286;257;2024
18;Granada;119;Lecrín;2268;1153;1115;2024
18;Granada;120;Lentegí;350;181;169;2024
18;Granada;121;Lobras;134;67;67;2024
18;Granada;122;Loja;20846;10373;10473;2024
18;Granada;123;Lugros;308;159;149;2024
18;Granada;124;Lújar;487;260;227;2024
18;Granada;126;Malahá, La;1872;953;919;2024
18;Granada;127;Maracena;22310;10855;11455;2024
18;Granada;128;Marchal;425;196;229;2024
18;Granada;132;Moclín;3529;1767;1762;2024
18;Granada;133;Molvízar;2730;1411;1319;2024
18;Granada;134;Monachil;8608;4358;4250;2024
18;Granada;135;Montefrío;5305;2773;2532;2024
18;Granada;136;Montejícar;2020;1036;984;2024
18;Granada;137;Montillana;1057;563;494;2024
18;Granada;138;Moraleda de Zafayona;3127;1591;1536;2024
18;Granada;140;Motril;59632;29265;30367;2024
18;Granada;141;Murtas;437;244;193;2024
18;Granada;143;Nigüelas;1239;625;614;2024
18;Granada;144;Nívar;1069;552;517;2024
18;Granada;145;Ogíjares;15063;7487;7576;2024
18;Granada;146;Orce;1148;561;587;2024
18;Granada;147;Órgiva;5674;2802;2872;2024
18;Granada;148;Otívar;1038;535;503;2024
18;Granada;149;Villa de Otura;7606;3832;3774;2024
18;Granada;150;Padul;9536;4780;4756;2024
18;Granada;151;Pampaneira;314;161;153;2024
18;Granada;152;Pedro Martínez;1147;572;575;2024
18;Granada;153;Peligros;11674;5776;5898;2024
18;Granada;154;Peza, La;1107;566;541;2024
18;Granada;157;Pinos Genil;1638;837;801;2024
18;Granada;158;Pinos Puente;9708;4831;4877;2024
18;Granada;159;Píñar;1060;572;488;2024
18;Granada;161;Polícar;266;142;124;2024
18;Granada;162;Polopos;1671;911;760;2024
18;Granada;163;Pórtugos;385;193;192;2024
18;Granada;164;Puebla de Don Fadrique;2202;1128;1074;2024
18;Granada;165;Pulianas;5628;2823;2805;2024
18;Granada;167;Purullena;2338;1188;1150;2024
18;Granada;168;Quéntar;943;498;445;2024
18;Granada;170;Rubite;426;247;179;2024
18;Granada;171;Salar;2597;1308;1289;2024
18;Granada;173;Salobreña;12660;6295;6365;2024
18;Granada;174;Santa Cruz del Comercio;515;270;245;2024
18;Granada;175;Santa Fe;15269;7450;7819;2024
18;Granada;176;Soportújar;278;155;123;2024
18;Granada;177;Sorvilán;511;277;234;2024
18;Granada;178;Torre-Cardela;712;371;341;2024
18;Granada;179;Torvizcón;621;325;296;2024
18;Granada;180;Trevélez;703;373;330;2024
18;Granada;181;Turón;213;122;91;2024
18;Granada;182;Ugíjar;2561;1288;1273;2024
18;Granada;183;Válor;660;350;310;2024
18;Granada;184;Vélez de Benaudalla;3054;1564;1490;2024
18;Granada;185;Ventas de Huelma;674;373;301;2024
18;Granada;187;Villanueva de las Torres;519;291;228;2024
18;Granada;188;Villanueva Mesía;1979;972;1007;2024
18;Granada;189;Víznar;997;519;478;2024
18;Granada;192;Zafarraya;2189;1184;1005;2024
18;Granada;193;Zubia, La;20056;9867;10189;2024
18;Granada;194;Zújar;2623;1339;1284;2024
18;Granada;901;Taha, La;759;380;379;2024
18;Granada;902;Valle, El;937;476;461;2024
18;Granada;903;Nevada;1096;572;524;2024
18;Granada;904;Alpujarra de la Sierra;931;514;417;2024
18;Granada;905;Gabias, Las;23318;11756;11562;2024
18;Granada;906;Guájares, Los;1125;610;515;2024
18;Granada;907;Valle del Zalabí;2122;1070;1052;2024
18;Granada;908;Villamena;1005;527;478;2024
18;Granada;909;Morelábor;587;306;281;2024
18;Granada;910;Pinar, El;870;461;409;2024
18;Granada;911;Vegas del Genil;12325;6253;6072;2024
18;Granada;912;Cuevas del Campo;1775;888;887;2024
18;Granada;913;Zagra;890;460;430;2024
18;Granada;914;Valderrubio;2077;1027;1050;2024
18;Granada;915;Domingo Pérez de Granada;824;435;389;2024
18;Granada;916;Torrenueva Costa;3098;1602;1496;2024
19;Guadalajara;001;Abánades;60;36;24;2024
19;Guadalajara;002;Ablanque;73;49;24;2024
19;Guadalajara;003;Adobes;28;17;11;2024
19;Guadalajara;004;Alaminos;56;30;26;2024
19;Guadalajara;005;Alarilla;137;84;53;2024
19;Guadalajara;006;Albalate de Zorita;1146;629;517;2024
19;Guadalajara;007;Albares;608;316;292;2024
19;Guadalajara;008;Albendiego;44;29;15;2024
19;Guadalajara;009;Alcocer;315;162;153;2024
19;Guadalajara;010;Alcolea de las Peñas;14;10;4;2024
19;Guadalajara;011;Alcolea del Pinar;336;196;140;2024
19;Guadalajara;013;Alcoroches;127;78;49;2024
19;Guadalajara;015;Aldeanueva de Guadalajara;106;64;42;2024
19;Guadalajara;016;Algar de Mesa;46;32;14;2024
19;Guadalajara;017;Algora;96;59;37;2024
19;Guadalajara;018;Alhóndiga;176;104;72;2024
19;Guadalajara;019;Alique;15;6;9;2024
19;Guadalajara;020;Almadrones;67;43;24;2024
19;Guadalajara;021;Almoguera;1373;703;670;2024
19;Guadalajara;022;Almonacid de Zorita;659;337;322;2024
19;Guadalajara;023;Alocén;155;79;76;2024
19;Guadalajara;024;Alovera;13585;6904;6681;2024
19;Guadalajara;027;Alustante;145;85;60;2024
19;Guadalajara;031;Angón;7;6;1;2024
19;Guadalajara;032;Anguita;156;82;74;2024
19;Guadalajara;033;Anquela del Ducado;50;27;23;2024
19;Guadalajara;034;Anquela del Pedregal;29;18;11;2024
19;Guadalajara;036;Aranzueque;396;208;188;2024
19;Guadalajara;037;Arbancón;146;83;63;2024
19;Guadalajara;038;Arbeteta;16;13;3;2024
19;Guadalajara;039;Argecilla;72;50;22;2024
19;Guadalajara;040;Armallones;54;30;24;2024
19;Guadalajara;041;Armuña de Tajuña;264;135;129;2024
19;Guadalajara;042;Arroyo de las Fraguas;33;18;15;2024
19;Guadalajara;043;Atanzón;85;60;25;2024
19;Guadalajara;044;Atienza;422;247;175;2024
19;Guadalajara;045;Auñón;159;84;75;2024
19;Guadalajara;046;Azuqueca de Henares;35894;18115;17779;2024
19;Guadalajara;047;Baides;51;25;26;2024
19;Guadalajara;048;Baños de Tajo;14;10;4;2024
19;Guadalajara;049;Bañuelos;13;11;2;2024
19;Guadalajara;050;Barriopedro;24;13;11;2024
19;Guadalajara;051;Berninches;45;30;15;2024
19;Guadalajara;052;Bodera, La;20;14;6;2024
19;Guadalajara;053;Brihuega;2816;1434;1382;2024
19;Guadalajara;054;Budia;216;135;81;2024
19;Guadalajara;055;Bujalaro;53;26;27;2024
19;Guadalajara;057;Bustares;68;38;30;2024
19;Guadalajara;058;Cabanillas del Campo;11329;5725;5604;2024
19;Guadalajara;059;Campillo de Dueñas;74;44;30;2024
19;Guadalajara;060;Campillo de Ranas;152;94;58;2024
19;Guadalajara;061;Campisábalos;80;55;25;2024
19;Guadalajara;064;Canredondo;81;51;30;2024
19;Guadalajara;065;Cantalojas;117;67;50;2024
19;Guadalajara;066;Cañizar;73;41;32;2024
19;Guadalajara;067;Cardoso de la Sierra, El;50;33;17;2024
19;Guadalajara;070;Casa de Uceda;111;64;47;2024
19;Guadalajara;071;Casar, El;13628;6888;6740;2024
19;Guadalajara;073;Casas de San Galindo;20;14;6;2024
19;Guadalajara;074;Caspueñas;133;81;52;2024
19;Guadalajara;075;Castejón de Henares;59;38;21;2024
19;Guadalajara;076;Castellar de la Muela;19;10;9;2024
19;Guadalajara;078;Castilforte;56;33;23;2024
19;Guadalajara;079;Castilnuevo;8;6;2;2024
19;Guadalajara;080;Cendejas de Enmedio;71;39;32;2024
19;Guadalajara;081;Cendejas de la Torre;24;18;6;2024
19;Guadalajara;082;Centenera;140;82;58;2024
19;Guadalajara;086;Cifuentes;1701;885;816;2024
19;Guadalajara;087;Cincovillas;19;12;7;2024
19;Guadalajara;088;Ciruelas;139;79;60;2024
19;Guadalajara;089;Ciruelos del Pinar;27;16;11;2024
19;Guadalajara;090;Cobeta;103;51;52;2024
19;Guadalajara;091;Cogollor;19;12;7;2024
19;Guadalajara;092;Cogolludo;554;324;230;2024
19;Guadalajara;095;Condemios de Abajo;14;10;4;2024
19;Guadalajara;096;Condemios de Arriba;113;66;47;2024
19;Guadalajara;097;Congostrina;17;13;4;2024
19;Guadalajara;098;Copernal;46;28;18;2024
19;Guadalajara;099;Corduente;290;167;123;2024
19;Guadalajara;102;Cubillo de Uceda, El;109;65;44;2024
19;Guadalajara;103;Checa;271;156;115;2024
19;Guadalajara;104;Chequilla;14;8;6;2024
19;Guadalajara;105;Chiloeches;4067;2087;1980;2024
19;Guadalajara;106;Chillarón del Rey;84;53;31;2024
19;Guadalajara;107;Driebes;342;191;151;2024
19;Guadalajara;108;Durón;111;61;50;2024
19;Guadalajara;109;Embid;33;21;12;2024
19;Guadalajara;110;Escamilla;65;42;23;2024
19;Guadalajara;111;Escariche;185;112;73;2024
19;Guadalajara;112;Escopete;79;42;37;2024
19;Guadalajara;113;Espinosa de Henares;690;352;338;2024
19;Guadalajara;114;Esplegares;33;17;16;2024
19;Guadalajara;115;Establés;34;19;15;2024
19;Guadalajara;116;Estriégana;12;9;3;2024
19;Guadalajara;117;Fontanar;2637;1379;1258;2024
19;Guadalajara;118;Fuembellida;14;9;5;2024
19;Guadalajara;119;Fuencemillán;85;53;32;2024
19;Guadalajara;120;Fuentelahiguera de Albatages;118;71;47;2024
19;Guadalajara;121;Fuentelencina;319;170;149;2024
19;Guadalajara;122;Fuentelsaz;83;41;42;2024
19;Guadalajara;123;Fuentelviejo;56;35;21;2024
19;Guadalajara;124;Fuentenovilla;583;325;258;2024
19;Guadalajara;125;Gajanejos;54;33;21;2024
19;Guadalajara;126;Galápagos;2748;1417;1331;2024
19;Guadalajara;127;Galve de Sorbe;95;51;44;2024
19;Guadalajara;129;Gascueña de Bornova;25;18;7;2024
19;Guadalajara;130;Guadalajara;90909;43773;47136;2024
19;Guadalajara;132;Henche;84;43;41;2024
19;Guadalajara;133;Heras de Ayuso;235;134;101;2024
19;Guadalajara;134;Herrería;17;10;7;2024
19;Guadalajara;135;Hiendelaencina;110;66;44;2024
19;Guadalajara;136;Hijes;21;11;10;2024
19;Guadalajara;138;Hita;331;183;148;2024
19;Guadalajara;139;Hombrados;43;24;19;2024
19;Guadalajara;142;Hontoba;439;252;187;2024
19;Guadalajara;143;Horche;2934;1470;1464;2024
19;Guadalajara;145;Hortezuela de Océn;33;19;14;2024
19;Guadalajara;146;Huerce, La;55;34;21;2024
19;Guadalajara;147;Huérmeces del Cerro;42;30;12;2024
19;Guadalajara;148;Huertahernando;58;39;19;2024
19;Guadalajara;150;Hueva;115;72;43;2024
19;Guadalajara;151;Humanes;1784;912;872;2024
19;Guadalajara;152;Illana;919;501;418;2024
19;Guadalajara;153;Iniéstola;18;13;5;2024
19;Guadalajara;154;Inviernas, Las;53;37;16;2024
19;Guadalajara;155;Irueste;86;58;28;2024
19;Guadalajara;156;Jadraque;1458;775;683;2024
19;Guadalajara;157;Jirueque;47;31;16;2024
19;Guadalajara;159;Ledanca;99;51;48;2024
19;Guadalajara;160;Loranca de Tajuña;1608;868;740;2024
19;Guadalajara;161;Lupiana;325;172;153;2024
19;Guadalajara;162;Luzaga;68;37;31;2024
19;Guadalajara;163;Luzón;58;30;28;2024
19;Guadalajara;165;Majaelrayo;57;39;18;2024
19;Guadalajara;166;Málaga del Fresno;170;99;71;2024
19;Guadalajara;167;Malaguilla;207;112;95;2024
19;Guadalajara;168;Mandayona;292;149;143;2024
19;Guadalajara;169;Mantiel;31;20;11;2024
19;Guadalajara;170;Maranchón;218;117;101;2024
19;Guadalajara;171;Marchamalo;8497;4236;4261;2024
19;Guadalajara;172;Masegoso de Tajuña;80;46;34;2024
19;Guadalajara;173;Matarrubia;79;51;28;2024
19;Guadalajara;174;Matillas;115;60;55;2024
19;Guadalajara;175;Mazarete;27;15;12;2024
19;Guadalajara;176;Mazuecos;282;156;126;2024
19;Guadalajara;177;Medranda;73;37;36;2024
19;Guadalajara;178;Megina;27;18;9;2024
19;Guadalajara;179;Membrillera;97;58;39;2024
19;Guadalajara;181;Miedes de Atienza;59;38;21;2024
19;Guadalajara;182;Mierla, La;38;23;15;2024
19;Guadalajara;183;Milmarcos;70;42;28;2024
19;Guadalajara;184;Millana;124;75;49;2024
19;Guadalajara;185;Miñosa, La;32;19;13;2024
19;Guadalajara;186;Mirabueno;85;49;36;2024
19;Guadalajara;187;Miralrío;55;34;21;2024
19;Guadalajara;188;Mochales;35;17;18;2024
19;Guadalajara;189;Mohernando;164;93;71;2024
19;Guadalajara;190;Molina de Aragón;3280;1643;1637;2024
19;Guadalajara;191;Monasterio;15;7;8;2024
19;Guadalajara;192;Mondéjar;2900;1502;1398;2024
19;Guadalajara;193;Montarrón;32;20;12;2024
19;Guadalajara;194;Moratilla de los Meleros;96;53;43;2024
19;Guadalajara;195;Morenilla;48;27;21;2024
19;Guadalajara;196;Muduex;109;60;49;2024
19;Guadalajara;197;Navas de Jadraque, Las;38;24;14;2024
19;Guadalajara;198;Negredo;13;6;7;2024
19;Guadalajara;199;Ocentejo;15;12;3;2024
19;Guadalajara;200;Olivar, El;84;43;41;2024
19;Guadalajara;201;Olmeda de Cobeta;57;30;27;2024
19;Guadalajara;202;Olmeda de Jadraque, La;19;12;7;2024
19;Guadalajara;203;Ordial, El;36;26;10;2024
19;Guadalajara;204;Orea;195;109;86;2024
19;Guadalajara;208;Pálmaces de Jadraque;46;30;16;2024
19;Guadalajara;209;Pardos;34;21;13;2024
19;Guadalajara;210;Paredes de Sigüenza;22;11;11;2024
19;Guadalajara;211;Pareja;477;273;204;2024
19;Guadalajara;212;Pastrana;891;437;454;2024
19;Guadalajara;213;Pedregal, El;63;43;20;2024
19;Guadalajara;214;Peñalén;75;43;32;2024
19;Guadalajara;215;Peñalver;181;111;70;2024
19;Guadalajara;216;Peralejos de las Truchas;162;86;76;2024
19;Guadalajara;217;Peralveche;73;50;23;2024
19;Guadalajara;218;Pinilla de Jadraque;54;36;18;2024
19;Guadalajara;219;Pinilla de Molina;11;9;2;2024
19;Guadalajara;220;Pioz;5204;2682;2522;2024
19;Guadalajara;221;Piqueras;33;25;8;2024
19;Guadalajara;222;Pobo de Dueñas, El;99;51;48;2024
19;Guadalajara;223;Poveda de la Sierra;105;60;45;2024
19;Guadalajara;224;Pozo de Almoguera;109;63;46;2024
19;Guadalajara;225;Pozo de Guadalajara;1699;902;797;2024
19;Guadalajara;226;Prádena de Atienza;52;35;17;2024
19;Guadalajara;227;Prados Redondos;46;35;11;2024
19;Guadalajara;228;Puebla de Beleña;57;37;20;2024
19;Guadalajara;229;Puebla de Valles;61;36;25;2024
19;Guadalajara;230;Quer;1045;545;500;2024
19;Guadalajara;231;Rebollosa de Jadraque;10;6;4;2024
19;Guadalajara;232;Recuenco, El;64;37;27;2024
19;Guadalajara;233;Renera;103;68;35;2024
19;Guadalajara;234;Retiendas;53;33;20;2024
19;Guadalajara;235;Riba de Saelices;94;52;42;2024
19;Guadalajara;237;Rillo de Gallo;41;23;18;2024
19;Guadalajara;238;Riofrío del Llano;60;34;26;2024
19;Guadalajara;239;Robledillo de Mohernando;183;111;72;2024
19;Guadalajara;240;Robledo de Corpes;40;22;18;2024
19;Guadalajara;241;Romanillos de Atienza;33;23;10;2024
19;Guadalajara;242;Romanones;118;66;52;2024
19;Guadalajara;243;Rueda de la Sierra;38;27;11;2024
19;Guadalajara;244;Sacecorbo;97;64;33;2024
19;Guadalajara;245;Sacedón;1595;831;764;2024
19;Guadalajara;246;Saelices de la Sal;47;28;19;2024
19;Guadalajara;247;Salmerón;148;85;63;2024
19;Guadalajara;248;San Andrés del Congosto;68;42;26;2024
19;Guadalajara;249;San Andrés del Rey;37;22;15;2024
19;Guadalajara;250;Santiuste;16;11;5;2024
19;Guadalajara;251;Saúca;48;25;23;2024
19;Guadalajara;252;Sayatón;69;41;28;2024
19;Guadalajara;254;Selas;35;18;17;2024
19;Guadalajara;255;Setiles;84;48;36;2024
19;Guadalajara;256;Sienes;42;25;17;2024
19;Guadalajara;257;Sigüenza;4830;2489;2341;2024
19;Guadalajara;258;Solanillos del Extremo;77;51;26;2024
19;Guadalajara;259;Somolinos;26;12;14;2024
19;Guadalajara;260;Sotillo, El;31;15;16;2024
19;Guadalajara;261;Sotodosos;33;19;14;2024
19;Guadalajara;262;Tamajón;154;82;72;2024
19;Guadalajara;263;Taragudo;48;31;17;2024
19;Guadalajara;264;Taravilla;41;21;20;2024
19;Guadalajara;265;Tartanedo;157;92;65;2024
19;Guadalajara;266;Tendilla;335;178;157;2024
19;Guadalajara;267;Terzaga;20;12;8;2024
19;Guadalajara;268;Tierzo;34;20;14;2024
19;Guadalajara;269;Toba, La;75;50;25;2024
19;Guadalajara;270;Tordelrábano;11;9;2;2024
19;Guadalajara;271;Tordellego;40;21;19;2024
19;Guadalajara;272;Tordesilos;90;50;40;2024
19;Guadalajara;274;Torija;1764;907;857;2024
19;Guadalajara;277;Torrecuadrada de Molina;22;13;9;2024
19;Guadalajara;278;Torrecuadradilla;28;17;11;2024
19;Guadalajara;279;Torre del Burgo;493;291;202;2024
19;Guadalajara;280;Torrejón del Rey;6324;3295;3029;2024
19;Guadalajara;281;Torremocha de Jadraque;23;15;8;2024
19;Guadalajara;282;Torremocha del Campo;184;110;74;2024
19;Guadalajara;283;Torremocha del Pinar;35;20;15;2024
19;Guadalajara;284;Torremochuela;8;6;2;2024
19;Guadalajara;285;Torrubia;26;16;10;2024
19;Guadalajara;286;Tórtola de Henares;1384;730;654;2024
19;Guadalajara;287;Tortuera;157;80;77;2024
19;Guadalajara;288;Tortuero;21;14;7;2024
19;Guadalajara;289;Traíd;19;14;5;2024
19;Guadalajara;290;Trijueque;1626;854;772;2024
19;Guadalajara;291;Trillo;1396;739;657;2024
19;Guadalajara;293;Uceda;3303;1703;1600;2024
19;Guadalajara;294;Ujados;28;12;16;2024
19;Guadalajara;296;Utande;31;24;7;2024
19;Guadalajara;297;Valdarachas;55;28;27;2024
19;Guadalajara;298;Valdearenas;91;54;37;2024
19;Guadalajara;299;Valdeavellano;97;54;43;2024
19;Guadalajara;300;Valdeaveruelo;1290;664;626;2024
19;Guadalajara;301;Valdeconcha;45;28;17;2024
19;Guadalajara;302;Valdegrudas;52;33;19;2024
19;Guadalajara;303;Valdelcubo;41;27;14;2024
19;Guadalajara;304;Valdenuño Fernández;332;180;152;2024
19;Guadalajara;305;Valdepeñas de la Sierra;149;87;62;2024
19;Guadalajara;306;Valderrebollo;25;14;11;2024
19;Guadalajara;307;Valdesotos;31;19;12;2024
19;Guadalajara;308;Valfermoso de Tajuña;75;46;29;2024
19;Guadalajara;309;Valhermoso;18;14;4;2024
19;Guadalajara;310;Valtablado del Río;8;5;3;2024
19;Guadalajara;311;Valverde de los Arroyos;91;52;39;2024
19;Guadalajara;314;Viana de Jadraque;41;28;13;2024
19;Guadalajara;317;Villanueva de Alcorón;148;88;60;2024
19;Guadalajara;318;Villanueva de Argecilla;32;18;14;2024
19;Guadalajara;319;Villanueva de la Torre;6696;3369;3327;2024
19;Guadalajara;321;Villares de Jadraque;45;28;17;2024
19;Guadalajara;322;Villaseca de Henares;29;19;10;2024
19;Guadalajara;323;Villaseca de Uceda;57;31;26;2024
19;Guadalajara;324;Villel de Mesa;166;96;70;2024
19;Guadalajara;325;Viñuelas;183;96;87;2024
19;Guadalajara;326;Yebes;5421;2805;2616;2024
19;Guadalajara;327;Yebra;498;273;225;2024
19;Guadalajara;329;Yélamos de Abajo;58;29;29;2024
19;Guadalajara;330;Yélamos de Arriba;89;53;36;2024
19;Guadalajara;331;Yunquera de Henares;4566;2324;2242;2024
19;Guadalajara;332;Yunta, La;91;52;39;2024
19;Guadalajara;333;Zaorejas;115;78;37;2024
19;Guadalajara;334;Zarzuela de Jadraque;52;34;18;2024
19;Guadalajara;335;Zorita de los Canes;65;38;27;2024
19;Guadalajara;901;Semillas;29;18;11;2024
20;Gipuzkoa;001;Abaltzisketa;319;179;140;2024
20;Gipuzkoa;002;Aduna;499;268;231;2024
20;Gipuzkoa;003;Aizarnazabal;780;401;379;2024
20;Gipuzkoa;004;Albiztur;324;170;154;2024
20;Gipuzkoa;005;Alegia;1812;940;872;2024
20;Gipuzkoa;006;Alkiza;364;178;186;2024
20;Gipuzkoa;007;Altzo;445;234;211;2024
20;Gipuzkoa;008;Amezketa;941;494;447;2024
20;Gipuzkoa;009;Andoain;14563;7203;7360;2024
20;Gipuzkoa;010;Anoeta;2087;1072;1015;2024
20;Gipuzkoa;011;Antzuola;2069;1022;1047;2024
20;Gipuzkoa;012;Arama;178;85;93;2024
20;Gipuzkoa;013;Aretxabaleta;7194;3575;3619;2024
20;Gipuzkoa;014;Asteasu;1575;805;770;2024
20;Gipuzkoa;015;Ataun;1717;891;826;2024
20;Gipuzkoa;016;Aia;2141;1122;1019;2024
20;Gipuzkoa;017;Azkoitia;11697;5803;5894;2024
20;Gipuzkoa;018;Azpeitia;15208;7597;7611;2024
20;Gipuzkoa;019;Beasain;13961;6961;7000;2024
20;Gipuzkoa;020;Beizama;130;79;51;2024
20;Gipuzkoa;021;Belauntza;288;150;138;2024
20;Gipuzkoa;022;Berastegi;1111;575;536;2024
20;Gipuzkoa;023;Berrobi;553;288;265;2024
20;Gipuzkoa;024;Bidania-Goiatz;532;275;257;2024
20;Gipuzkoa;025;Zegama;1541;793;748;2024
20;Gipuzkoa;026;Zerain;280;136;144;2024
20;Gipuzkoa;027;Zestoa;3838;1983;1855;2024
20;Gipuzkoa;028;Zizurkil;2970;1495;1475;2024
20;Gipuzkoa;029;Deba;5399;2673;2726;2024
20;Gipuzkoa;030;Eibar;27362;13329;14033;2024
20;Gipuzkoa;031;Elduain;250;124;126;2024
20;Gipuzkoa;032;Elgoibar;11585;5726;5859;2024
20;Gipuzkoa;033;Elgeta;1130;564;566;2024
20;Gipuzkoa;034;Eskoriatza;4241;2131;2110;2024
20;Gipuzkoa;035;Ezkio-Itsaso;588;304;284;2024
20;Gipuzkoa;036;Hondarribia;16929;8398;8531;2024
20;Gipuzkoa;037;Gaintza;124;71;53;2024
20;Gipuzkoa;038;Gabiria;516;284;232;2024
20;Gipuzkoa;039;Getaria;2906;1460;1446;2024
20;Gipuzkoa;040;Hernani;20355;9926;10429;2024
20;Gipuzkoa;041;Hernialde;318;167;151;2024
20;Gipuzkoa;042;Ibarra;4112;2029;2083;2024
20;Gipuzkoa;043;Idiazabal;2268;1145;1123;2024
20;Gipuzkoa;044;Ikaztegieta;502;259;243;2024
20;Gipuzkoa;045;Irun;63656;31173;32483;2024
20;Gipuzkoa;046;Irura;1895;982;913;2024
20;Gipuzkoa;047;Itsasondo;670;339;331;2024
20;Gipuzkoa;048;Larraul;256;142;114;2024
20;Gipuzkoa;049;Lazkao;6055;3030;3025;2024
20;Gipuzkoa;050;Leaburu;389;206;183;2024
20;Gipuzkoa;051;Legazpi;8390;4238;4152;2024
20;Gipuzkoa;052;Legorreta;1449;728;721;2024
20;Gipuzkoa;053;Lezo;6012;2984;3028;2024
20;Gipuzkoa;054;Lizartza;667;343;324;2024
20;Gipuzkoa;055;Arrasate/Mondragón;22123;10853;11270;2024
20;Gipuzkoa;056;Mutriku;5281;2654;2627;2024
20;Gipuzkoa;057;Mutiloa;253;129;124;2024
20;Gipuzkoa;058;Olaberria;934;473;461;2024
20;Gipuzkoa;059;Oñati;11537;5695;5842;2024
20;Gipuzkoa;060;Orexa;108;62;46;2024
20;Gipuzkoa;061;Orio;6182;3096;3086;2024
20;Gipuzkoa;062;Ormaiztegi;1268;646;622;2024
20;Gipuzkoa;063;Oiartzun;10378;5165;5213;2024
20;Gipuzkoa;064;Pasaia;16009;7685;8324;2024
20;Gipuzkoa;065;Soraluze-Placencia de las Armas;3810;1936;1874;2024
20;Gipuzkoa;066;Errezil;580;309;271;2024
20;Gipuzkoa;067;Errenteria;39352;19005;20347;2024
20;Gipuzkoa;068;Leintz-Gatzaga;210;115;95;2024
20;Gipuzkoa;069;Donostia/San Sebastián;189093;89436;99657;2024
20;Gipuzkoa;070;Segura;1465;748;717;2024
20;Gipuzkoa;071;Tolosa;20109;9755;10354;2024
20;Gipuzkoa;072;Urnieta;6250;3126;3124;2024
20;Gipuzkoa;073;Usurbil;6438;3221;3217;2024
20;Gipuzkoa;074;Bergara;14471;7130;7341;2024
20;Gipuzkoa;075;Villabona;5859;2880;2979;2024
20;Gipuzkoa;076;Ordizia;10699;5309;5390;2024
20;Gipuzkoa;077;Urretxu;6765;3344;3421;2024
20;Gipuzkoa;078;Zaldibia;1740;890;850;2024
20;Gipuzkoa;079;Zarautz;23370;11344;12026;2024
20;Gipuzkoa;080;Zumarraga;9687;4773;4914;2024
20;Gipuzkoa;081;Zumaia;10251;5098;5153;2024
20;Gipuzkoa;901;Mendaro;2004;1006;998;2024
20;Gipuzkoa;902;Lasarte-Oria;19312;9295;10017;2024
20;Gipuzkoa;903;Astigarraga;7764;3936;3828;2024
20;Gipuzkoa;904;Baliarrain;154;86;68;2024
20;Gipuzkoa;905;Orendain;245;118;127;2024
20;Gipuzkoa;906;Altzaga;171;86;85;2024
20;Gipuzkoa;907;Gaztelu;169;85;84;2024
21;Huelva;001;Alájar;791;401;390;2024
21;Huelva;002;Aljaraque;22489;11229;11260;2024
21;Huelva;003;Almendro, El;858;436;422;2024
21;Huelva;004;Almonaster la Real;1751;921;830;2024
21;Huelva;005;Almonte;24863;12229;12634;2024
21;Huelva;006;Alosno;3982;1962;2020;2024
21;Huelva;007;Aracena;8392;4132;4260;2024
21;Huelva;008;Aroche;2997;1493;1504;2024
21;Huelva;009;Arroyomolinos de León;925;461;464;2024
21;Huelva;010;Ayamonte;21622;10794;10828;2024
21;Huelva;011;Beas;4374;2189;2185;2024
21;Huelva;012;Berrocal;288;152;136;2024
21;Huelva;013;Bollullos Par del Condado;14359;7085;7274;2024
21;Huelva;014;Bonares;6153;3060;3093;2024
21;Huelva;015;Cabezas Rubias;710;368;342;2024
21;Huelva;016;Cala;1117;556;561;2024
21;Huelva;017;Calañas;2759;1400;1359;2024
21;Huelva;018;Campillo, El;2014;987;1027;2024
21;Huelva;019;Campofrío;724;360;364;2024
21;Huelva;020;Cañaveral de León;381;192;189;2024
21;Huelva;021;Cartaya;21408;10879;10529;2024
21;Huelva;022;Castaño del Robledo;226;127;99;2024
21;Huelva;023;Cerro de Andévalo, El;2260;1127;1133;2024
21;Huelva;024;Corteconcepción;573;301;272;2024
21;Huelva;025;Cortegana;4618;2313;2305;2024
21;Huelva;026;Cortelazor;312;154;158;2024
21;Huelva;027;Cumbres de Enmedio;61;34;27;2024
21;Huelva;028;Cumbres de San Bartolomé;364;189;175;2024
21;Huelva;029;Cumbres Mayores;1729;860;869;2024
21;Huelva;030;Chucena;2238;1122;1116;2024
21;Huelva;031;Encinasola;1260;638;622;2024
21;Huelva;032;Escacena del Campo;2318;1112;1206;2024
21;Huelva;033;Fuenteheridos;814;422;392;2024
21;Huelva;034;Galaroza;1369;695;674;2024
21;Huelva;035;Gibraleón;13144;6604;6540;2024
21;Huelva;036;Granada de Río-Tinto, La;244;119;125;2024
21;Huelva;037;Granado, El;493;252;241;2024
21;Huelva;038;Higuera de la Sierra;1307;679;628;2024
21;Huelva;039;Hinojales;325;161;164;2024
21;Huelva;040;Hinojos;4056;2027;2029;2024
21;Huelva;041;Huelva;143290;68675;74615;2024
21;Huelva;042;Isla Cristina;21641;10893;10748;2024
21;Huelva;043;Jabugo;2196;1107;1089;2024
21;Huelva;044;Lepe;29241;15171;14070;2024
21;Huelva;045;Linares de la Sierra;275;136;139;2024
21;Huelva;046;Lucena del Puerto;3388;1789;1599;2024
21;Huelva;047;Manzanilla;2216;1135;1081;2024
21;Huelva;048;Marines, Los;424;219;205;2024
21;Huelva;049;Minas de Riotinto;3713;1797;1916;2024
21;Huelva;050;Moguer;23551;11826;11725;2024
21;Huelva;051;Nava, La;255;132;123;2024
21;Huelva;052;Nerva;5073;2447;2626;2024
21;Huelva;053;Niebla;4284;2142;2142;2024
21;Huelva;054;Palma del Condado, La;10709;5337;5372;2024
21;Huelva;055;Palos de la Frontera;12663;6448;6215;2024
21;Huelva;056;Paterna del Campo;3412;1731;1681;2024
21;Huelva;057;Paymogo;1143;573;570;2024
21;Huelva;058;Puebla de Guzmán;3095;1582;1513;2024
21;Huelva;059;Puerto Moral;280;138;142;2024
21;Huelva;060;Punta Umbría;16137;8172;7965;2024
21;Huelva;061;Rociana del Condado;7985;3940;4045;2024
21;Huelva;062;Rosal de la Frontera;1671;812;859;2024
21;Huelva;063;San Bartolomé de la Torre;4036;2064;1972;2024
21;Huelva;064;San Juan del Puerto;9811;4927;4884;2024
21;Huelva;065;Sanlúcar de Guadiana;416;205;211;2024
21;Huelva;066;San Silvestre de Guzmán;644;336;308;2024
21;Huelva;067;Santa Ana la Real;472;221;251;2024
21;Huelva;068;Santa Bárbara de Casa;1128;569;559;2024
21;Huelva;069;Santa Olalla del Cala;2061;1044;1017;2024
21;Huelva;070;Trigueros;8110;4028;4082;2024
21;Huelva;071;Valdelarco;237;114;123;2024
21;Huelva;072;Valverde del Camino;12611;6188;6423;2024
21;Huelva;073;Villablanca;2979;1494;1485;2024
21;Huelva;074;Villalba del Alcor;3302;1619;1683;2024
21;Huelva;075;Villanueva de las Cruces;380;183;197;2024
21;Huelva;076;Villanueva de los Castillejos;2936;1483;1453;2024
21;Huelva;077;Villarrasa;2128;1071;1057;2024
21;Huelva;078;Zalamea la Real;2963;1480;1483;2024
21;Huelva;079;Zufre;735;381;354;2024
21;Huelva;902;Zarza-Perrunal, La;1189;611;578;2024
22;Huesca;001;Abiego;264;131;133;2024
22;Huesca;002;Abizanda;163;88;75;2024
22;Huesca;003;Adahuesca;207;114;93;2024
22;Huesca;004;Agüero;140;83;57;2024
22;Huesca;006;Aisa;313;164;149;2024
22;Huesca;007;Albalate de Cinca;1142;630;512;2024
22;Huesca;008;Albalatillo;211;115;96;2024
22;Huesca;009;Albelda;709;360;349;2024
22;Huesca;011;Albero Alto;128;72;56;2024
22;Huesca;012;Albero Bajo;111;66;45;2024
22;Huesca;013;Alberuela de Tubo;283;149;134;2024
22;Huesca;014;Alcalá de Gurrea;272;146;126;2024
22;Huesca;015;Alcalá del Obispo;372;210;162;2024
22;Huesca;016;Alcampell;639;302;337;2024
22;Huesca;017;Alcolea de Cinca;1109;589;520;2024
22;Huesca;018;Alcubierre;400;220;180;2024
22;Huesca;019;Alerre;225;119;106;2024
22;Huesca;020;Alfántega;129;62;67;2024
22;Huesca;021;Almudévar;2437;1229;1208;2024
22;Huesca;022;Almunia de San Juan;708;365;343;2024
22;Huesca;023;Almuniente;444;233;211;2024
22;Huesca;024;Alquézar;338;172;166;2024
22;Huesca;025;Altorricón;1472;799;673;2024
22;Huesca;027;Angüés;364;195;169;2024
22;Huesca;028;Ansó;413;206;207;2024
22;Huesca;029;Antillón;126;64;62;2024
22;Huesca;032;Aragüés del Puerto;114;60;54;2024
22;Huesca;035;Arén;306;158;148;2024
22;Huesca;036;Argavieso;112;66;46;2024
22;Huesca;037;Arguis;165;87;78;2024
22;Huesca;039;Ayerbe;1066;531;535;2024
22;Huesca;040;Azanuy-Alins;183;94;89;2024
22;Huesca;041;Azara;164;89;75;2024
22;Huesca;042;Azlor;157;71;86;2024
22;Huesca;043;Baélls;90;55;35;2024
22;Huesca;044;Bailo;263;161;102;2024
22;Huesca;045;Baldellou;82;51;31;2024
22;Huesca;046;Ballobar;864;435;429;2024
22;Huesca;047;Banastás;328;165;163;2024
22;Huesca;048;Barbastro;17558;8582;8976;2024
22;Huesca;049;Barbués;90;58;32;2024
22;Huesca;050;Barbuñales;95;49;46;2024
22;Huesca;051;Bárcabo;122;65;57;2024
22;Huesca;052;Belver de Cinca;1270;733;537;2024
22;Huesca;053;Benabarre;1137;585;552;2024
22;Huesca;054;Benasque;2362;1260;1102;2024
22;Huesca;055;Berbegal;325;170;155;2024
22;Huesca;057;Bielsa;487;253;234;2024
22;Huesca;058;Bierge;243;139;104;2024
22;Huesca;059;Biescas;1609;854;755;2024
22;Huesca;060;Binaced;1601;878;723;2024
22;Huesca;061;Binéfar;10118;5352;4766;2024
22;Huesca;062;Bisaurri;179;99;80;2024
22;Huesca;063;Biscarrués;187;100;87;2024
22;Huesca;064;Blecua y Torres;172;88;84;2024
22;Huesca;066;Boltaña;1102;589;513;2024
22;Huesca;067;Bonansa;86;47;39;2024
22;Huesca;068;Borau;85;49;36;2024
22;Huesca;069;Broto;608;331;277;2024
22;Huesca;072;Caldearenas;237;145;92;2024
22;Huesca;074;Campo;483;252;231;2024
22;Huesca;075;Camporrélls;158;85;73;2024
22;Huesca;076;Canal de Berdún;330;178;152;2024
22;Huesca;077;Candasnos;422;229;193;2024
22;Huesca;078;Canfranc;612;352;260;2024
22;Huesca;079;Capdesaso;201;88;113;2024
22;Huesca;080;Capella;351;185;166;2024
22;Huesca;081;Casbas de Huesca;292;170;122;2024
22;Huesca;082;Castejón del Puente;334;177;157;2024
22;Huesca;083;Castejón de Monegros;468;243;225;2024
22;Huesca;084;Castejón de Sos;868;435;433;2024
22;Huesca;085;Castelflorite;103;52;51;2024
22;Huesca;086;Castiello de Jaca;265;141;124;2024
22;Huesca;087;Castigaleu;87;53;34;2024
22;Huesca;088;Castillazuelo;166;86;80;2024
22;Huesca;089;Castillonroy;322;173;149;2024
22;Huesca;090;Colungo;132;78;54;2024
22;Huesca;094;Chalamera;131;77;54;2024
22;Huesca;095;Chía;94;53;41;2024
22;Huesca;096;Chimillas;410;213;197;2024
22;Huesca;099;Esplús;664;350;314;2024
22;Huesca;102;Estada;214;125;89;2024
22;Huesca;103;Estadilla;822;406;416;2024
22;Huesca;105;Estopiñán del Castillo;136;74;62;2024
22;Huesca;106;Fago;25;16;9;2024
22;Huesca;107;Fanlo;118;68;50;2024
22;Huesca;109;Fiscal;379;211;168;2024
22;Huesca;110;Fonz;893;467;426;2024
22;Huesca;111;Foradada del Toscar;169;93;76;2024
22;Huesca;112;Fraga;15390;7907;7483;2024
22;Huesca;113;Fueva, La;597;320;277;2024
22;Huesca;114;Gistaín;116;69;47;2024
22;Huesca;115;Grado, El;386;205;181;2024
22;Huesca;116;Grañén;1696;860;836;2024
22;Huesca;117;Graus;3380;1673;1707;2024
22;Huesca;119;Gurrea de Gállego;1427;738;689;2024
22;Huesca;122;Hoz de Jaca;77;41;36;2024
22;Huesca;124;Huerto;226;124;102;2024
22;Huesca;125;Huesca;54704;26250;28454;2024
22;Huesca;126;Ibieca;104;58;46;2024
22;Huesca;127;Igriés;737;381;356;2024
22;Huesca;128;Ilche;185;95;90;2024
22;Huesca;129;Isábena;237;120;117;2024
22;Huesca;130;Jaca;13883;6778;7105;2024
22;Huesca;131;Jasa;94;56;38;2024
22;Huesca;133;Labuerda;173;88;85;2024
22;Huesca;135;Laluenga;207;107;100;2024
22;Huesca;136;Lalueza;868;440;428;2024
22;Huesca;137;Lanaja;1141;622;519;2024
22;Huesca;139;Laperdiguera;88;42;46;2024
22;Huesca;141;Lascellas-Ponzano;139;83;56;2024
22;Huesca;142;Lascuarre;135;68;67;2024
22;Huesca;143;Laspaúles;251;130;121;2024
22;Huesca;144;Laspuña;278;157;121;2024
22;Huesca;149;Loarre;351;192;159;2024
22;Huesca;150;Loporzano;557;305;252;2024
22;Huesca;151;Loscorrales;104;52;52;2024
22;Huesca;155;Monesma y Cajigar;69;37;32;2024
22;Huesca;156;Monflorite-Lascasas;490;260;230;2024
22;Huesca;157;Montanuy;227;132;95;2024
22;Huesca;158;Monzón;18152;9210;8942;2024
22;Huesca;160;Naval;273;146;127;2024
22;Huesca;162;Novales;165;78;87;2024
22;Huesca;163;Nueno;568;321;247;2024
22;Huesca;164;Olvena;65;32;33;2024
22;Huesca;165;Ontiñena;513;272;241;2024
22;Huesca;167;Osso de Cinca;652;371;281;2024
22;Huesca;168;Palo;33;17;16;2024
22;Huesca;170;Panticosa;909;480;429;2024
22;Huesca;172;Peñalba;695;382;313;2024
22;Huesca;173;Peñas de Riglos, Las;268;171;97;2024
22;Huesca;174;Peralta de Alcofea;587;294;293;2024
22;Huesca;175;Peralta de Calasanz;215;118;97;2024
22;Huesca;176;Peraltilla;215;104;111;2024
22;Huesca;177;Perarrúa;112;54;58;2024
22;Huesca;178;Pertusa;136;78;58;2024
22;Huesca;181;Piracés;95;49;46;2024
22;Huesca;182;Plan;279;147;132;2024
22;Huesca;184;Poleñino;205;111;94;2024
22;Huesca;186;Pozán de Vero;235;119;116;2024
22;Huesca;187;Puebla de Castro, La;427;224;203;2024
22;Huesca;188;Puente de Montañana;95;44;51;2024
22;Huesca;189;Puértolas;224;117;107;2024
22;Huesca;190;Pueyo de Araguás, El;171;94;77;2024
22;Huesca;193;Pueyo de Santa Cruz;323;161;162;2024
22;Huesca;195;Quicena;346;183;163;2024
22;Huesca;197;Robres;531;283;248;2024
22;Huesca;199;Sabiñánigo;9592;4788;4804;2024
22;Huesca;200;Sahún;319;168;151;2024
22;Huesca;201;Salas Altas;296;160;136;2024
22;Huesca;202;Salas Bajas;180;90;90;2024
22;Huesca;203;Salillas;101;56;45;2024
22;Huesca;204;Sallent de Gállego;1516;766;750;2024
22;Huesca;205;San Esteban de Litera;641;342;299;2024
22;Huesca;206;Sangarrén;221;119;102;2024
22;Huesca;207;San Juan de Plan;151;79;72;2024
22;Huesca;208;Santa Cilia;244;121;123;2024
22;Huesca;209;Santa Cruz de la Serós;188;109;79;2024
22;Huesca;212;Santaliestra y San Quílez;83;49;34;2024
22;Huesca;213;Sariñena;4135;2165;1970;2024
22;Huesca;214;Secastilla;149;71;78;2024
22;Huesca;215;Seira;146;85;61;2024
22;Huesca;217;Sena;476;257;219;2024
22;Huesca;218;Senés de Alcubierre;52;25;27;2024
22;Huesca;220;Sesa;162;93;69;2024
22;Huesca;221;Sesué;116;64;52;2024
22;Huesca;222;Siétamo;681;377;304;2024
22;Huesca;223;Sopeira;84;48;36;2024
22;Huesca;225;Tamarite de Litera;3429;1780;1649;2024
22;Huesca;226;Tardienta;937;482;455;2024
22;Huesca;227;Tella-Sin;217;117;100;2024
22;Huesca;228;Tierz;825;408;417;2024
22;Huesca;229;Tolva;132;74;58;2024
22;Huesca;230;Torla-Ordesa;335;179;156;2024
22;Huesca;232;Torralba de Aragón;107;62;45;2024
22;Huesca;233;Torre la Ribera;100;53;47;2024
22;Huesca;234;Torrente de Cinca;1148;646;502;2024
22;Huesca;235;Torres de Alcanadre;92;55;37;2024
22;Huesca;236;Torres de Barbués;270;133;137;2024
22;Huesca;239;Tramaced;106;65;41;2024
22;Huesca;242;Valfarta;54;35;19;2024
22;Huesca;243;Valle de Bardají;55;35;20;2024
22;Huesca;244;Valle de Lierp;58;37;21;2024
22;Huesca;245;Velilla de Cinca;507;278;229;2024
22;Huesca;246;Beranuy;69;39;30;2024
22;Huesca;247;Viacamp y Litera;41;26;15;2024
22;Huesca;248;Vicién;137;80;57;2024
22;Huesca;249;Villanova;170;92;78;2024
22;Huesca;250;Villanúa;571;302;269;2024
22;Huesca;251;Villanueva de Sigena;345;193;152;2024
22;Huesca;252;Yebra de Basa;160;95;65;2024
22;Huesca;253;Yésero;62;34;28;2024
22;Huesca;254;Zaidín;1785;943;842;2024
22;Huesca;901;Valle de Hecho;798;424;374;2024
22;Huesca;902;Puente la Reina de Jaca;264;137;127;2024
22;Huesca;903;San Miguel del Cinca;784;409;375;2024
22;Huesca;904;Sotonera, La;903;488;415;2024
22;Huesca;905;Lupiñén-Ortilla;349;177;172;2024
22;Huesca;906;Santa María de Dulcis;209;113;96;2024
22;Huesca;907;Aínsa-Sobrarbe;2317;1161;1156;2024
22;Huesca;908;Hoz y Costean;231;131;100;2024
22;Huesca;909;Vencillón;393;215;178;2024
23;Jaén;001;Albanchez de Mágina;930;488;442;2024
23;Jaén;002;Alcalá la Real;21581;10627;10954;2024
23;Jaén;003;Alcaudete;10243;5032;5211;2024
23;Jaén;004;Aldeaquemada;456;243;213;2024
23;Jaén;005;Andújar;35619;17391;18228;2024
23;Jaén;006;Arjona;5376;2636;2740;2024
23;Jaén;007;Arjonilla;3531;1783;1748;2024
23;Jaén;008;Arquillos;1685;853;832;2024
23;Jaén;009;Baeza;15677;7754;7923;2024
23;Jaén;010;Bailén;17264;8623;8641;2024
23;Jaén;011;Baños de la Encina;2563;1308;1255;2024
23;Jaén;012;Beas de Segura;4968;2575;2393;2024
23;Jaén;014;Begíjar;2947;1490;1457;2024
23;Jaén;015;Bélmez de la Moraleda;1509;737;772;2024
23;Jaén;016;Benatae;429;215;214;2024
23;Jaén;017;Cabra del Santo Cristo;1651;864;787;2024
23;Jaén;018;Cambil;2632;1379;1253;2024
23;Jaén;019;Campillo de Arenas;1703;856;847;2024
23;Jaén;020;Canena;1761;923;838;2024
23;Jaén;021;Carboneros;597;305;292;2024
23;Jaén;024;Carolina, La;14681;7304;7377;2024
23;Jaén;025;Castellar;3156;1609;1547;2024
23;Jaén;026;Castillo de Locubín;3840;1906;1934;2024
23;Jaén;027;Cazalilla;771;389;382;2024
23;Jaén;028;Cazorla;7012;3415;3597;2024
23;Jaén;029;Chiclana de Segura;869;454;415;2024
23;Jaén;030;Chilluévar;1322;659;663;2024
23;Jaén;031;Escañuela;902;444;458;2024
23;Jaén;032;Espeluy;591;292;299;2024
23;Jaén;033;Frailes;1551;778;773;2024
23;Jaén;034;Fuensanta de Martos;2990;1508;1482;2024
23;Jaén;035;Fuerte del Rey;1342;695;647;2024
23;Jaén;037;Génave;547;292;255;2024
23;Jaén;038;Guardia de Jaén, La;5218;2683;2535;2024
23;Jaén;039;Guarromán;2760;1414;1346;2024
23;Jaén;040;Lahiguera;1588;789;799;2024
23;Jaén;041;Higuera de Calatrava;591;310;281;2024
23;Jaén;042;Hinojares;343;177;166;2024
23;Jaén;043;Hornos;573;281;292;2024
23;Jaén;044;Huelma;5522;2704;2818;2024
23;Jaén;045;Huesa;2419;1217;1202;2024
23;Jaén;046;Ibros;2764;1403;1361;2024
23;Jaén;047;Iruela, La;1867;931;936;2024
23;Jaén;048;Iznatoraf;882;443;439;2024
23;Jaén;049;Jabalquinto;1961;979;982;2024
23;Jaén;050;Jaén;112074;53799;58275;2024
23;Jaén;051;Jamilena;3298;1660;1638;2024
23;Jaén;052;Jimena;1234;603;631;2024
23;Jaén;053;Jódar;11366;5669;5697;2024
23;Jaén;054;Larva;436;225;211;2024
23;Jaén;055;Linares;55261;27027;28234;2024
23;Jaén;056;Lopera;3539;1803;1736;2024
23;Jaén;057;Lupión;806;391;415;2024
23;Jaén;058;Mancha Real;11385;5682;5703;2024
23;Jaén;059;Marmolejo;6507;3255;3252;2024
23;Jaén;060;Martos;24452;12168;12284;2024
23;Jaén;061;Mengíbar;10011;5020;4991;2024
23;Jaén;062;Montizón;1585;812;773;2024
23;Jaén;063;Navas de San Juan;4409;2275;2134;2024
23;Jaén;064;Noalejo;1783;907;876;2024
23;Jaén;065;Orcera;1717;853;864;2024
23;Jaén;066;Peal de Becerro;5276;2637;2639;2024
23;Jaén;067;Pegalajar;2827;1448;1379;2024
23;Jaén;069;Porcuna;5907;2962;2945;2024
23;Jaén;070;Pozo Alcón;4550;2364;2186;2024
23;Jaén;071;Puente de Génave;2188;1114;1074;2024
23;Jaén;072;Puerta de Segura, La;2246;1130;1116;2024
23;Jaén;073;Quesada;4952;2508;2444;2024
23;Jaén;074;Rus;3407;1730;1677;2024
23;Jaén;075;Sabiote;3780;1893;1887;2024
23;Jaén;076;Santa Elena;866;457;409;2024
23;Jaén;077;Santiago de Calatrava;657;350;307;2024
23;Jaén;079;Santisteban del Puerto;4457;2279;2178;2024
23;Jaén;080;Santo Tomé;2077;1068;1009;2024
23;Jaén;081;Segura de la Sierra;1688;822;866;2024
23;Jaén;082;Siles;2109;1080;1029;2024
23;Jaén;084;Sorihuela del Guadalimar;1034;535;499;2024
23;Jaén;085;Torreblascopedro;2402;1230;1172;2024
23;Jaén;086;Torredelcampo;13944;6964;6980;2024
23;Jaén;087;Torredonjimeno;13261;6539;6722;2024
23;Jaén;088;Torreperogil;7113;3490;3623;2024
23;Jaén;090;Torres;1343;704;639;2024
23;Jaén;091;Torres de Albánchez;741;385;356;2024
23;Jaén;092;Úbeda;33674;16380;17294;2024
23;Jaén;093;Valdepeñas de Jaén;3556;1774;1782;2024
23;Jaén;094;Vilches;4190;2099;2091;2024
23;Jaén;095;Villacarrillo;10320;5176;5144;2024
23;Jaén;096;Villanueva de la Reina;2948;1510;1438;2024
23;Jaén;097;Villanueva del Arzobispo;7753;4005;3748;2024
23;Jaén;098;Villardompardo;921;465;456;2024
23;Jaén;099;Villares, Los;6079;3052;3027;2024
23;Jaén;101;Villarrodrigo;390;214;176;2024
23;Jaén;901;Cárcheles;1293;681;612;2024
23;Jaén;902;Bedmar y Garcíez;2571;1307;1264;2024
23;Jaén;903;Villatorres;4267;2187;2080;2024
23;Jaén;904;Santiago-Pontones;2701;1384;1317;2024
23;Jaén;905;Arroyo del Ojanco;2143;1083;1060;2024
24;León;001;Acebedo;184;103;81;2024
24;León;002;Algadefe;301;157;144;2024
24;León;003;Alija del Infantado;573;291;282;2024
24;León;004;Almanza;609;343;266;2024
24;León;005;Antigua, La;328;185;143;2024
24;León;006;Ardón;550;302;248;2024
24;León;007;Arganza;805;407;398;2024
24;León;008;Astorga;10308;4839;5469;2024
24;León;009;Balboa;263;156;107;2024
24;León;010;Bañeza, La;10023;4831;5192;2024
24;León;011;Barjas;145;84;61;2024
24;León;012;Barrios de Luna, Los;294;172;122;2024
24;León;014;Bembibre;8158;3920;4238;2024
24;León;015;Benavides;2342;1167;1175;2024
24;León;016;Benuza;442;265;177;2024
24;León;017;Bercianos del Páramo;522;270;252;2024
24;León;018;Bercianos del Real Camino;186;103;83;2024
24;León;019;Berlanga del Bierzo;322;149;173;2024
24;León;020;Boca de Huérgano;426;248;178;2024
24;León;021;Boñar;1766;907;859;2024
24;León;022;Borrenes;303;165;138;2024
24;León;023;Brazuelo;312;183;129;2024
24;León;024;Burgo Ranero, El;690;364;326;2024
24;León;025;Burón;288;167;121;2024
24;León;026;Bustillo del Páramo;1057;548;509;2024
24;León;027;Cabañas Raras;1302;686;616;2024
24;León;028;Cabreros del Río;408;220;188;2024
24;León;029;Cabrillanes;707;373;334;2024
24;León;030;Cacabelos;4735;2312;2423;2024
24;León;031;Calzada del Coto;223;134;89;2024
24;León;032;Campazas;107;55;52;2024
24;León;033;Campo de Villavidel;205;115;90;2024
24;León;034;Camponaraya;4104;2041;2063;2024
24;León;036;Valle de Ancares;275;153;122;2024
24;León;037;Cármenes;333;191;142;2024
24;León;038;Carracedelo;3423;1713;1710;2024
24;León;039;Carrizo;2222;1132;1090;2024
24;León;040;Carrocera;440;225;215;2024
24;León;041;Carucedo;483;242;241;2024
24;León;042;Castilfalé;62;37;25;2024
24;León;043;Castrillo de Cabrera;102;62;40;2024
24;León;044;Castrillo de la Valduerna;143;71;72;2024
24;León;046;Castrocalbón;913;473;440;2024
24;León;047;Castrocontrigo;669;370;299;2024
24;León;049;Castropodame;1574;820;754;2024
24;León;050;Castrotierra de Valmadrigal;105;52;53;2024
24;León;051;Cea;378;200;178;2024
24;León;052;Cebanico;143;88;55;2024
24;León;053;Cebrones del Río;435;238;197;2024
24;León;054;Cimanes de la Vega;435;223;212;2024
24;León;055;Cimanes del Tejar;738;408;330;2024
24;León;056;Cistierna;2905;1422;1483;2024
24;León;057;Congosto;1425;710;715;2024
24;León;058;Corbillos de los Oteros;176;101;75;2024
24;León;059;Corullón;819;417;402;2024
24;León;060;Crémenes;512;278;234;2024
24;León;061;Cuadros;2090;1058;1032;2024
24;León;062;Cubillas de los Oteros;137;76;61;2024
24;León;063;Cubillas de Rueda;385;212;173;2024
24;León;064;Cubillos del Sil;1719;895;824;2024
24;León;065;Chozas de Abajo;2678;1376;1302;2024
24;León;066;Destriana;424;207;217;2024
24;León;067;Encinedo;616;338;278;2024
24;León;068;Ercina, La;425;228;197;2024
24;León;069;Escobar de Campos;31;19;12;2024
24;León;070;Fabero;4061;1988;2073;2024
24;León;071;Folgoso de la Ribera;982;482;500;2024
24;León;073;Fresno de la Vega;477;237;240;2024
24;León;074;Fuentes de Carbajal;76;49;27;2024
24;León;076;Garrafe de Torío;1640;877;763;2024
24;León;077;Gordaliza del Pino;239;117;122;2024
24;León;078;Gordoncillo;308;153;155;2024
24;León;079;Gradefes;925;510;415;2024
24;León;080;Grajal de Campos;209;109;100;2024
24;León;081;Gusendos de los Oteros;126;64;62;2024
24;León;082;Hospital de Órbigo;956;479;477;2024
24;León;083;Igüeña;1049;543;506;2024
24;León;084;Izagre;137;70;67;2024
24;León;086;Joarilla de las Matas;245;133;112;2024
24;León;087;Laguna Dalga;626;334;292;2024
24;León;088;Laguna de Negrillos;1046;534;512;2024
24;León;089;León;122243;55446;66797;2024
24;León;090;Lucillo;356;186;170;2024
24;León;091;Luyego;554;306;248;2024
24;León;092;Llamas de la Ribera;791;417;374;2024
24;León;093;Magaz de Cepeda;349;193;156;2024
24;León;094;Mansilla de las Mulas;1663;844;819;2024
24;León;095;Mansilla Mayor;324;176;148;2024
24;León;096;Maraña;111;71;40;2024
24;León;097;Matadeón de los Oteros;221;115;106;2024
24;León;098;Matallana de Torío;1228;642;586;2024
24;León;099;Matanza;172;89;83;2024
24;León;100;Molinaseca;872;477;395;2024
24;León;101;Murias de Paredes;340;191;149;2024
24;León;102;Noceda del Bierzo;605;312;293;2024
24;León;103;Oencia;277;157;120;2024
24;León;104;Omañas, Las;259;139;120;2024
24;León;105;Onzonilla;1942;1003;939;2024
24;León;106;Oseja de Sajambre;226;138;88;2024
24;León;107;Pajares de los Oteros;235;142;93;2024
24;León;108;Palacios de la Valduerna;353;176;177;2024
24;León;109;Palacios del Sil;844;469;375;2024
24;León;110;Páramo del Sil;1169;604;565;2024
24;León;112;Peranzanes;271;162;109;2024
24;León;113;Pobladura de Pelayo García;354;181;173;2024
24;León;114;Pola de Gordón, La;2842;1429;1413;2024
24;León;115;Ponferrada;62994;29699;33295;2024
24;León;116;Posada de Valdeón;405;235;170;2024
24;León;117;Pozuelo del Páramo;392;192;200;2024
24;León;118;Prado de la Guzpeña;104;64;40;2024
24;León;119;Priaranza del Bierzo;699;349;350;2024
24;León;120;Prioro;349;203;146;2024
24;León;121;Puebla de Lillo;654;379;275;2024
24;León;122;Puente de Domingo Flórez;1385;707;678;2024
24;León;123;Quintana del Castillo;717;392;325;2024
24;León;124;Quintana del Marco;319;179;140;2024
24;León;125;Quintana y Congosto;416;222;194;2024
24;León;127;Regueras de Arriba;264;144;120;2024
24;León;129;Reyero;128;70;58;2024
24;León;130;Riaño;474;257;217;2024
24;León;131;Riego de la Vega;714;385;329;2024
24;León;132;Riello;582;329;253;2024
24;León;133;Rioseco de Tapia;399;218;181;2024
24;León;134;Robla, La;3605;1791;1814;2024
24;León;136;Roperuelos del Páramo;499;252;247;2024
24;León;137;Sabero;1021;521;500;2024
24;León;139;Sahagún;2398;1174;1224;2024
24;León;141;San Adrián del Valle;84;51;33;2024
24;León;142;San Andrés del Rabanedo;29884;14195;15689;2024
24;León;143;Sancedo;528;272;256;2024
24;León;144;San Cristóbal de la Polantera;625;326;299;2024
24;León;145;San Emiliano;596;345;251;2024
24;León;146;San Esteban de Nogales;243;129;114;2024
24;León;148;San Justo de la Vega;1775;908;867;2024
24;León;149;San Millán de los Caballeros;191;100;91;2024
24;León;150;San Pedro Bercianos;226;125;101;2024
24;León;151;Santa Colomba de Curueño;507;266;241;2024
24;León;152;Santa Colomba de Somoza;494;265;229;2024
24;León;153;Santa Cristina de Valmadrigal;273;142;131;2024
24;León;154;Santa Elena de Jamuz;1015;537;478;2024
24;León;155;Santa María de la Isla;443;230;213;2024
24;León;156;Santa María del Monte de Cea;209;116;93;2024
24;León;157;Santa María del Páramo;2999;1480;1519;2024
24;León;158;Santa María de Ordás;325;174;151;2024
24;León;159;Santa Marina del Rey;1745;872;873;2024
24;León;160;Santas Martas;752;405;347;2024
24;León;161;Santiago Millas;359;206;153;2024
24;León;162;Santovenia de la Valdoncina;2064;1045;1019;2024
24;León;163;Sariegos;5444;2689;2755;2024
24;León;164;Sena de Luna;390;194;196;2024
24;León;165;Sobrado;282;142;140;2024
24;León;166;Soto de la Vega;1493;787;706;2024
24;León;167;Soto y Amío;717;370;347;2024
24;León;168;Toral de los Guzmanes;499;275;224;2024
24;León;169;Toreno;2855;1440;1415;2024
24;León;170;Torre del Bierzo;1968;1008;960;2024
24;León;171;Trabadelo;319;185;134;2024
24;León;172;Truchas;392;209;183;2024
24;León;173;Turcia;986;506;480;2024
24;León;174;Urdiales del Páramo;449;239;210;2024
24;León;175;Valdefresno;2335;1216;1119;2024
24;León;176;Valdefuentes del Páramo;306;165;141;2024
24;León;177;Valdelugueros;486;270;216;2024
24;León;178;Valdemora;57;25;32;2024
24;León;179;Valdepiélago;308;176;132;2024
24;León;180;Valdepolo;1215;655;560;2024
24;León;181;Valderas;1489;771;718;2024
24;León;182;Valderrey;416;214;202;2024
24;León;183;Valderrueda;821;455;366;2024
24;León;184;Valdesamario;175;100;75;2024
24;León;185;Val de San Lorenzo;492;237;255;2024
24;León;187;Valdevimbre;894;460;434;2024
24;León;188;Valencia de Don Juan;5094;2470;2624;2024
24;León;189;Valverde de la Virgen;7806;4047;3759;2024
24;León;190;Valverde-Enrique;152;79;73;2024
24;León;191;Vallecillo;101;57;44;2024
24;León;193;Vecilla, La;378;212;166;2024
24;León;194;Vegacervera;258;132;126;2024
24;León;196;Vega de Espinareda;2007;1020;987;2024
24;León;197;Vega de Infanzones;839;429;410;2024
24;León;198;Vega de Valcarce;552;281;271;2024
24;León;199;Vegaquemada;437;253;184;2024
24;León;201;Vegas del Condado;1154;663;491;2024
24;León;202;Villablino;7709;3749;3960;2024
24;León;203;Villabraz;95;52;43;2024
24;León;205;Villadangos del Páramo;1235;640;595;2024
24;León;206;Toral de los Vados;1753;878;875;2024
24;León;207;Villademor de la Vega;291;160;131;2024
24;León;209;Villafranca del Bierzo;2659;1277;1382;2024
24;León;210;Villagatón;636;349;287;2024
24;León;211;Villamandos;277;148;129;2024
24;León;212;Villamañán;1076;548;528;2024
24;León;213;Villamartín de Don Sancho;144;76;68;2024
24;León;214;Villamejil;653;355;298;2024
24;León;215;Villamol;136;72;64;2024
24;León;216;Villamontán de la Valduerna;683;346;337;2024
24;León;217;Villamoratiel de las Matas;120;66;54;2024
24;León;218;Villanueva de las Manzanas;502;256;246;2024
24;León;219;Villaobispo de Otero;518;285;233;2024
24;León;221;Villaquejida;803;405;398;2024
24;León;222;Villaquilambre;18647;9219;9428;2024
24;León;223;Villarejo de Órbigo;2873;1414;1459;2024
24;León;224;Villares de Órbigo;563;307;256;2024
24;León;225;Villasabariego;1148;582;566;2024
24;León;226;Villaselán;180;101;79;2024
24;León;227;Villaturiel;1838;963;875;2024
24;León;228;Villazala;596;323;273;2024
24;León;229;Villazanzo de Valderaduey;368;216;152;2024
24;León;230;Zotes del Páramo;402;223;179;2024
24;León;901;Villamanín;876;456;420;2024
24;León;902;Villaornate y Castro;337;168;169;2024
25;Lleida;001;Abella de la Conca;158;81;77;2024
25;Lleida;002;Àger;602;326;276;2024
25;Lleida;003;Agramunt;5629;2862;2767;2024
25;Lleida;004;Alamús, Els;800;409;391;2024
25;Lleida;005;Alàs i Cerc;322;161;161;2024
25;Lleida;006;Albagés, L';344;187;157;2024
25;Lleida;007;Albatàrrec;2251;1141;1110;2024
25;Lleida;008;Albesa;1584;859;725;2024
25;Lleida;009;Albi, L';766;393;373;2024
25;Lleida;010;Alcanó;239;117;122;2024
25;Lleida;011;Alcarràs;10018;5205;4813;2024
25;Lleida;012;Alcoletge;3594;1923;1671;2024
25;Lleida;013;Alfarràs;2778;1433;1345;2024
25;Lleida;014;Alfés;281;157;124;2024
25;Lleida;015;Algerri;424;233;191;2024
25;Lleida;016;Alguaire;2986;1567;1419;2024
25;Lleida;017;Alins;275;145;130;2024
25;Lleida;019;Almacelles;6896;3707;3189;2024
25;Lleida;020;Almatret;305;168;137;2024
25;Lleida;021;Almenar;3338;1769;1569;2024
25;Lleida;022;Alòs de Balaguer;120;70;50;2024
25;Lleida;023;Alpicat;6387;3192;3195;2024
25;Lleida;024;Alt Àneu;455;257;198;2024
25;Lleida;025;Naut Aran;1899;988;911;2024
25;Lleida;027;Anglesola;1367;690;677;2024
25;Lleida;029;Arbeca;2081;1055;1026;2024
25;Lleida;030;Pont de Bar, El;165;94;71;2024
25;Lleida;031;Arres;64;44;20;2024
25;Lleida;032;Arsèguel;78;41;37;2024
25;Lleida;033;Artesa de Lleida;1539;821;718;2024
25;Lleida;034;Artesa de Segre;3485;1799;1686;2024
25;Lleida;035;Sentiu de Sió, La;455;238;217;2024
25;Lleida;036;Aspa;220;115;105;2024
25;Lleida;037;Avellanes i Santa Linya, Les;430;234;196;2024
25;Lleida;038;Aitona;2603;1386;1217;2024
25;Lleida;039;Baix Pallars;340;188;152;2024
25;Lleida;040;Balaguer;17705;9077;8628;2024
25;Lleida;041;Barbens;926;525;401;2024
25;Lleida;042;Baronia de Rialb, La;231;124;107;2024
25;Lleida;043;Vall de Boí, La;1116;599;517;2024
25;Lleida;044;Bassella;210;115;95;2024
25;Lleida;045;Bausen;60;31;29;2024
25;Lleida;046;Belianes;517;248;269;2024
25;Lleida;047;Bellcaire d'Urgell;1228;620;608;2024
25;Lleida;048;Bell-lloc d'Urgell;2359;1182;1177;2024
25;Lleida;049;Bellmunt d'Urgell;182;97;85;2024
25;Lleida;050;Bellpuig;5276;2828;2448;2024
25;Lleida;051;Bellver de Cerdanya;2260;1165;1095;2024
25;Lleida;052;Bellvís;2269;1175;1094;2024
25;Lleida;053;Benavent de Segrià;1578;828;750;2024
25;Lleida;055;Biosca;176;96;80;2024
25;Lleida;056;Bovera;247;130;117;2024
25;Lleida;057;Bòrdes, Es;280;154;126;2024
25;Lleida;058;Borges Blanques, Les;6379;3268;3111;2024
25;Lleida;059;Bossòst;1141;563;578;2024
25;Lleida;060;Cabanabona;65;29;36;2024
25;Lleida;061;Cabó;89;49;40;2024
25;Lleida;062;Camarasa;805;412;393;2024
25;Lleida;063;Canejan;101;48;53;2024
25;Lleida;064;Castellar de la Ribera;144;75;69;2024
25;Lleida;067;Castelldans;891;462;429;2024
25;Lleida;068;Castellnou de Seana;723;382;341;2024
25;Lleida;069;Castelló de Farfanya;544;287;257;2024
25;Lleida;070;Castellserà;993;512;481;2024
25;Lleida;071;Cava;39;26;13;2024
25;Lleida;072;Cervera;9533;4869;4664;2024
25;Lleida;073;Cervià de les Garrigues;641;348;293;2024
25;Lleida;074;Ciutadilla;194;104;90;2024
25;Lleida;075;Clariana de Cardener;161;84;77;2024
25;Lleida;076;Cogul, El;161;89;72;2024
25;Lleida;077;Coll de Nargó;587;316;271;2024
25;Lleida;078;Corbins;1502;820;682;2024
25;Lleida;079;Cubells;343;180;163;2024
25;Lleida;081;Espluga Calba, L';331;169;162;2024
25;Lleida;082;Espot;379;211;168;2024
25;Lleida;085;Estaràs;162;81;81;2024
25;Lleida;086;Esterri d'Àneu;921;472;449;2024
25;Lleida;087;Esterri de Cardós;63;31;32;2024
25;Lleida;088;Estamariu;132;76;56;2024
25;Lleida;089;Farrera;127;72;55;2024
25;Lleida;092;Floresta, La;164;88;76;2024
25;Lleida;093;Fondarella;805;402;403;2024
25;Lleida;094;Foradada;195;107;88;2024
25;Lleida;096;Fuliola, La;1238;612;626;2024
25;Lleida;097;Fulleda;91;48;43;2024
25;Lleida;098;Gavet de la Conca;259;133;126;2024
25;Lleida;099;Golmés;1916;971;945;2024
25;Lleida;100;Gósol;215;118;97;2024
25;Lleida;101;Granadella, La;758;441;317;2024
25;Lleida;102;Granja d'Escarp, La;943;540;403;2024
25;Lleida;103;Granyanella;140;80;60;2024
25;Lleida;104;Granyena de Segarra;145;77;68;2024
25;Lleida;105;Granyena de les Garrigues;163;95;68;2024
25;Lleida;109;Guimerà;246;133;113;2024
25;Lleida;110;Guissona;7635;4044;3591;2024
25;Lleida;111;Guixers;134;77;57;2024
25;Lleida;112;Ivars de Noguera;318;172;146;2024
25;Lleida;113;Ivars d'Urgell;1590;868;722;2024
25;Lleida;114;Ivorra;100;59;41;2024
25;Lleida;115;Isona i Conca Dellà;1046;576;470;2024
25;Lleida;118;Juncosa;390;206;184;2024
25;Lleida;119;Juneda;3473;1844;1629;2024
25;Lleida;120;Lleida;144739;72366;72373;2024
25;Lleida;121;Les;1013;529;484;2024
25;Lleida;122;Linyola;2749;1394;1355;2024
25;Lleida;123;Lladorre;254;138;116;2024
25;Lleida;124;Lladurs;185;98;87;2024
25;Lleida;125;Llardecans;428;227;201;2024
25;Lleida;126;Llavorsí;336;168;168;2024
25;Lleida;127;Lles de Cerdanya;285;166;119;2024
25;Lleida;128;Llimiana;131;74;57;2024
25;Lleida;129;Llobera;209;119;90;2024
25;Lleida;130;Maldà;236;118;118;2024
25;Lleida;131;Massalcoreig;584;328;256;2024
25;Lleida;132;Massoteres;216;111;105;2024
25;Lleida;133;Maials;921;508;413;2024
25;Lleida;134;Menàrguens;789;411;378;2024
25;Lleida;135;Miralcamp;1390;721;669;2024
25;Lleida;136;Molsosa, La;103;49;54;2024
25;Lleida;137;Mollerussa;15544;8048;7496;2024
25;Lleida;138;Montgai;637;327;310;2024
25;Lleida;139;Montellà i Martinet;620;327;293;2024
25;Lleida;140;Montferrer i Castellbò;1164;620;544;2024
25;Lleida;141;Montoliu de Segarra;180;102;78;2024
25;Lleida;142;Montoliu de Lleida;475;248;227;2024
25;Lleida;143;Montornès de Segarra;88;40;48;2024
25;Lleida;145;Nalec;89;49;40;2024
25;Lleida;146;Navès;300;152;148;2024
25;Lleida;148;Odèn;230;130;100;2024
25;Lleida;149;Oliana;1839;914;925;2024
25;Lleida;150;Oliola;196;103;93;2024
25;Lleida;151;Olius;1003;523;480;2024
25;Lleida;152;Oluges, Les;167;91;76;2024
25;Lleida;153;Omellons, Els;190;98;92;2024
25;Lleida;154;Omells de na Gaia, Els;121;65;56;2024
25;Lleida;155;Organyà;811;416;395;2024
25;Lleida;156;Os de Balaguer;1075;547;528;2024
25;Lleida;157;Ossó de Sió;195;101;94;2024
25;Lleida;158;Palau d'Anglesola, El;2205;1101;1104;2024
25;Lleida;161;Conca de Dalt;434;232;202;2024
25;Lleida;163;Coma i la Pedra, La;282;160;122;2024
25;Lleida;164;Penelles;435;252;183;2024
25;Lleida;165;Peramola;357;181;176;2024
25;Lleida;166;Pinell de Solsonès;203;114;89;2024
25;Lleida;167;Pinós;277;151;126;2024
25;Lleida;168;Poal, El;653;332;321;2024
25;Lleida;169;Pobla de Cérvoles, La;205;112;93;2024
25;Lleida;170;Bellaguarda;288;151;137;2024
25;Lleida;171;Pobla de Segur, La;3015;1550;1465;2024
25;Lleida;172;Ponts;2703;1402;1301;2024
25;Lleida;173;Pont de Suert, El;2380;1209;1171;2024
25;Lleida;174;Portella, La;735;413;322;2024
25;Lleida;175;Prats i Sansor;249;135;114;2024
25;Lleida;176;Preixana;406;210;196;2024
25;Lleida;177;Preixens;392;208;184;2024
25;Lleida;179;Prullans;252;117;135;2024
25;Lleida;180;Puiggròs;258;128;130;2024
25;Lleida;181;Puigverd d'Agramunt;240;134;106;2024
25;Lleida;182;Puigverd de Lleida;1418;735;683;2024
25;Lleida;183;Rialp;664;335;329;2024
25;Lleida;185;Ribera d'Urgellet;965;500;465;2024
25;Lleida;186;Riner;262;126;136;2024
25;Lleida;189;Rosselló;3353;1732;1621;2024
25;Lleida;190;Salàs de Pallars;349;187;162;2024
25;Lleida;191;Sanaüja;379;195;184;2024
25;Lleida;192;Sant Guim de Freixenet;1222;633;589;2024
25;Lleida;193;Sant Llorenç de Morunys;1003;486;517;2024
25;Lleida;194;Sant Ramon;495;263;232;2024
25;Lleida;196;Sant Esteve de la Sarga;127;78;49;2024
25;Lleida;197;Sant Guim de la Plana;193;99;94;2024
25;Lleida;200;Sarroca de Lleida;381;210;171;2024
25;Lleida;201;Sarroca de Bellera;115;63;52;2024
25;Lleida;202;Senterada;158;93;65;2024
25;Lleida;203;Seu d'Urgell, La;12831;6278;6553;2024
25;Lleida;204;Seròs;1902;1034;868;2024
25;Lleida;205;Sidamon;767;404;363;2024
25;Lleida;206;Soleràs, El;310;164;146;2024
25;Lleida;207;Solsona;9480;4709;4771;2024
25;Lleida;208;Soriguera;444;229;215;2024
25;Lleida;209;Sort;2213;1098;1115;2024
25;Lleida;210;Soses;1881;1004;877;2024
25;Lleida;211;Sudanell;897;508;389;2024
25;Lleida;212;Sunyer;313;168;145;2024
25;Lleida;215;Talarn;539;323;216;2024
25;Lleida;216;Talavera;280;151;129;2024
25;Lleida;217;Tàrrega;18542;9225;9317;2024
25;Lleida;218;Tarrés;125;62;63;2024
25;Lleida;219;Tarroja de Segarra;170;91;79;2024
25;Lleida;220;Térmens;1347;690;657;2024
25;Lleida;221;Tírvia;144;70;74;2024
25;Lleida;222;Tiurana;66;31;35;2024
25;Lleida;223;Torà;1207;608;599;2024
25;Lleida;224;Torms, Els;137;70;67;2024
25;Lleida;225;Tornabous;851;473;378;2024
25;Lleida;226;Torrebesses;273;142;131;2024
25;Lleida;227;Torre de Cabdella, La;785;390;395;2024
25;Lleida;228;Torrefarrera;4861;2470;2391;2024
25;Lleida;230;Torregrossa;2194;1161;1033;2024
25;Lleida;231;Torrelameu;766;460;306;2024
25;Lleida;232;Torres de Segre;2318;1207;1111;2024
25;Lleida;233;Torre-serona;435;223;212;2024
25;Lleida;234;Tremp;6015;2971;3044;2024
25;Lleida;238;Vallbona de les Monges;223;119;104;2024
25;Lleida;239;Valls de Valira, Les;810;429;381;2024
25;Lleida;240;Vallfogona de Balaguer;2000;1007;993;2024
25;Lleida;242;Verdú;886;425;461;2024
25;Lleida;243;Vielha e Mijaran;5832;2955;2877;2024
25;Lleida;244;Vilagrassa;633;332;301;2024
25;Lleida;245;Vilaller;506;282;224;2024
25;Lleida;247;Vilamòs;175;100;75;2024
25;Lleida;248;Vilanova de Bellpuig;1168;593;575;2024
25;Lleida;249;Vilanova de l'Aguda;193;101;92;2024
25;Lleida;250;Vilanova de Meià;466;306;160;2024
25;Lleida;251;Vilanova de Segrià;1065;573;492;2024
25;Lleida;252;Vila-sana;753;382;371;2024
25;Lleida;253;Vilosell, El;194;98;96;2024
25;Lleida;254;Vilanova de la Barca;1107;599;508;2024
25;Lleida;255;Vinaixa;450;239;211;2024
25;Lleida;901;Vall de Cardós;375;205;170;2024
25;Lleida;902;Sant Martí de Riucorb;673;353;320;2024
25;Lleida;903;Guingueta d'Àneu, La;285;158;127;2024
25;Lleida;904;Castell de Mur;170;95;75;2024
25;Lleida;905;Ribera d'Ondara;454;241;213;2024
25;Lleida;906;Valls d'Aguilar, Les;262;146;116;2024
25;Lleida;907;Torrefeta i Florejacs;605;321;284;2024
25;Lleida;908;Fígols i Alinyà;243;142;101;2024
25;Lleida;909;Vansa i Fórnols, La;188;97;91;2024
25;Lleida;910;Josa i Tuixén;122;73;49;2024
25;Lleida;911;Plans de Sió, Els;512;276;236;2024
25;Lleida;912;Gimenells i el Pla de la Font;1097;583;514;2024
25;Lleida;913;Riu de Cerdanya;99;56;43;2024
26;Rioja, La;001;Ábalos;256;144;112;2024
26;Rioja, La;002;Agoncillo;1314;720;594;2024
26;Rioja, La;003;Aguilar del Río Alhama;426;214;212;2024
26;Rioja, La;004;Ajamil de Cameros;85;53;32;2024
26;Rioja, La;005;Albelda de Iregua;3855;1991;1864;2024
26;Rioja, La;006;Alberite;2674;1369;1305;2024
26;Rioja, La;007;Alcanadre;647;345;302;2024
26;Rioja, La;008;Aldeanueva de Ebro;2691;1413;1278;2024
26;Rioja, La;009;Alesanco;480;245;235;2024
26;Rioja, La;010;Alesón;96;60;36;2024
26;Rioja, La;011;Alfaro;9874;4959;4915;2024
26;Rioja, La;012;Almarza de Cameros;40;25;15;2024
26;Rioja, La;013;Anguciana;427;234;193;2024
26;Rioja, La;014;Anguiano;488;266;222;2024
26;Rioja, La;015;Arenzana de Abajo;263;138;125;2024
26;Rioja, La;016;Arenzana de Arriba;35;24;11;2024
26;Rioja, La;017;Arnedillo;428;216;212;2024
26;Rioja, La;018;Arnedo;15219;7609;7610;2024
26;Rioja, La;019;Arrúbal;565;302;263;2024
26;Rioja, La;020;Ausejo;808;426;382;2024
26;Rioja, La;021;Autol;4875;2452;2423;2024
26;Rioja, La;022;Azofra;201;111;90;2024
26;Rioja, La;023;Badarán;493;250;243;2024
26;Rioja, La;024;Bañares;199;105;94;2024
26;Rioja, La;025;Baños de Rioja;83;51;32;2024
26;Rioja, La;026;Baños de Río Tobía;1605;820;785;2024
26;Rioja, La;027;Berceo;138;86;52;2024
26;Rioja, La;028;Bergasa;170;92;78;2024
26;Rioja, La;029;Bergasillas Bajera;36;18;18;2024
26;Rioja, La;030;Bezares;21;9;12;2024
26;Rioja, La;031;Bobadilla;101;53;48;2024
26;Rioja, La;032;Brieva de Cameros;38;22;16;2024
26;Rioja, La;033;Briñas;187;94;93;2024
26;Rioja, La;034;Briones;749;397;352;2024
26;Rioja, La;035;Cabezón de Cameros;22;14;8;2024
26;Rioja, La;036;Calahorra;25064;12296;12768;2024
26;Rioja, La;037;Camprovín;159;86;73;2024
26;Rioja, La;038;Canales de la Sierra;82;55;27;2024
26;Rioja, La;039;Canillas de Río Tuerto;44;25;19;2024
26;Rioja, La;040;Cañas;96;52;44;2024
26;Rioja, La;041;Cárdenas;129;69;60;2024
26;Rioja, La;042;Casalarreina;1062;530;532;2024
26;Rioja, La;043;Castañares de Rioja;404;193;211;2024
26;Rioja, La;044;Castroviejo;56;32;24;2024
26;Rioja, La;045;Cellorigo;10;4;6;2024
26;Rioja, La;046;Cenicero;2091;1081;1010;2024
26;Rioja, La;047;Cervera del Río Alhama;2255;1160;1095;2024
26;Rioja, La;048;Cidamón;17;8;9;2024
26;Rioja, La;049;Cihuri;200;106;94;2024
26;Rioja, La;050;Cirueña;193;119;74;2024
26;Rioja, La;051;Clavijo;296;171;125;2024
26;Rioja, La;052;Cordovín;159;80;79;2024
26;Rioja, La;053;Corera;273;142;131;2024
26;Rioja, La;054;Cornago;287;163;124;2024
26;Rioja, La;055;Corporales;42;26;16;2024
26;Rioja, La;056;Cuzcurrita de Río Tirón;549;284;265;2024
26;Rioja, La;057;Daroca de Rioja;66;41;25;2024
26;Rioja, La;058;Enciso;170;110;60;2024
26;Rioja, La;059;Entrena;1635;856;779;2024
26;Rioja, La;060;Estollo;86;51;35;2024
26;Rioja, La;061;Ezcaray;2098;1086;1012;2024
26;Rioja, La;062;Foncea;93;53;40;2024
26;Rioja, La;063;Fonzaleche;124;80;44;2024
26;Rioja, La;064;Fuenmayor;3278;1646;1632;2024
26;Rioja, La;065;Galbárruli;79;51;28;2024
26;Rioja, La;066;Galilea;407;203;204;2024
26;Rioja, La;067;Gallinero de Cameros;16;10;6;2024
26;Rioja, La;068;Gimileo;120;63;57;2024
26;Rioja, La;069;Grañón;221;123;98;2024
26;Rioja, La;070;Grávalos;185;103;82;2024
26;Rioja, La;071;Haro;11979;5942;6037;2024
26;Rioja, La;072;Herce;338;179;159;2024
26;Rioja, La;073;Herramélluri;110;63;47;2024
26;Rioja, La;074;Hervías;137;71;66;2024
26;Rioja, La;075;Hormilla;431;226;205;2024
26;Rioja, La;076;Hormilleja;135;71;64;2024
26;Rioja, La;077;Hornillos de Cameros;12;6;6;2024
26;Rioja, La;078;Hornos de Moncalvillo;98;58;40;2024
26;Rioja, La;079;Huércanos;840;463;377;2024
26;Rioja, La;080;Igea;649;370;279;2024
26;Rioja, La;081;Jalón de Cameros;23;11;12;2024
26;Rioja, La;082;Laguna de Cameros;115;61;54;2024
26;Rioja, La;083;Lagunilla del Jubera;390;216;174;2024
26;Rioja, La;084;Lardero;11658;5833;5825;2024
26;Rioja, La;086;Ledesma de la Cogolla;16;11;5;2024
26;Rioja, La;087;Leiva;245;120;125;2024
26;Rioja, La;088;Leza de Río Leza;43;25;18;2024
26;Rioja, La;089;Logroño;151164;71431;79733;2024
26;Rioja, La;091;Lumbreras de Cameros;147;98;49;2024
26;Rioja, La;092;Manjarrés;107;66;41;2024
26;Rioja, La;093;Mansilla de la Sierra;61;46;15;2024
26;Rioja, La;094;Manzanares de Rioja;61;38;23;2024
26;Rioja, La;095;Matute;88;52;36;2024
26;Rioja, La;096;Medrano;355;194;161;2024
26;Rioja, La;098;Munilla;98;58;40;2024
26;Rioja, La;099;Murillo de Río Leza;1665;853;812;2024
26;Rioja, La;100;Muro de Aguas;54;35;19;2024
26;Rioja, La;101;Muro en Cameros;35;19;16;2024
26;Rioja, La;102;Nájera;8174;4072;4102;2024
26;Rioja, La;103;Nalda;1307;714;593;2024
26;Rioja, La;104;Navajún;8;7;1;2024
26;Rioja, La;105;Navarrete;3038;1534;1504;2024
26;Rioja, La;106;Nestares;85;53;32;2024
26;Rioja, La;107;Nieva de Cameros;86;52;34;2024
26;Rioja, La;108;Ocón;331;200;131;2024
26;Rioja, La;109;Ochánduri;82;48;34;2024
26;Rioja, La;110;Ojacastro;179;104;75;2024
26;Rioja, La;111;Ollauri;312;169;143;2024
26;Rioja, La;112;Ortigosa de Cameros;216;135;81;2024
26;Rioja, La;113;Pazuengos;25;20;5;2024
26;Rioja, La;114;Pedroso;90;55;35;2024
26;Rioja, La;115;Pinillos;19;10;9;2024
26;Rioja, La;117;Pradejón;3754;1955;1799;2024
26;Rioja, La;118;Pradillo;64;37;27;2024
26;Rioja, La;119;Préjano;223;125;98;2024
26;Rioja, La;120;Quel;2139;1150;989;2024
26;Rioja, La;121;Rabanera;31;23;8;2024
26;Rioja, La;122;Rasillo de Cameros, El;153;87;66;2024
26;Rioja, La;123;Redal, El;142;80;62;2024
26;Rioja, La;124;Ribafrecha;1065;557;508;2024
26;Rioja, La;125;Rincón de Soto;4024;2118;1906;2024
26;Rioja, La;126;Robres del Castillo;24;15;9;2024
26;Rioja, La;127;Rodezno;222;123;99;2024
26;Rioja, La;128;Sajazarra;125;70;55;2024
26;Rioja, La;129;San Asensio;1099;581;518;2024
26;Rioja, La;130;San Millán de la Cogolla;215;143;72;2024
26;Rioja, La;131;San Millán de Yécora;32;23;9;2024
26;Rioja, La;132;San Román de Cameros;127;77;50;2024
26;Rioja, La;134;Santa Coloma;103;58;45;2024
26;Rioja, La;135;Santa Engracia del Jubera;192;116;76;2024
26;Rioja, La;136;Santa Eulalia Bajera;111;66;45;2024
26;Rioja, La;138;Santo Domingo de la Calzada;6348;3177;3171;2024
26;Rioja, La;139;San Torcuato;64;34;30;2024
26;Rioja, La;140;Santurde de Rioja;254;137;117;2024
26;Rioja, La;141;Santurdejo;96;56;40;2024
26;Rioja, La;142;San Vicente de la Sonsierra;1014;535;479;2024
26;Rioja, La;143;Sojuela;659;368;291;2024
26;Rioja, La;144;Sorzano;217;122;95;2024
26;Rioja, La;145;Sotés;260;142;118;2024
26;Rioja, La;146;Soto en Cameros;85;48;37;2024
26;Rioja, La;147;Terroba;39;19;20;2024
26;Rioja, La;148;Tirgo;171;90;81;2024
26;Rioja, La;149;Tobía;45;27;18;2024
26;Rioja, La;150;Tormantos;122;70;52;2024
26;Rioja, La;151;Torrecilla en Cameros;458;254;204;2024
26;Rioja, La;152;Torrecilla sobre Alesanco;55;34;21;2024
26;Rioja, La;153;Torre en Cameros;8;6;2;2024
26;Rioja, La;154;Torremontalbo;7;6;1;2024
26;Rioja, La;155;Treviana;146;79;67;2024
26;Rioja, La;157;Tricio;374;188;186;2024
26;Rioja, La;158;Tudelilla;367;197;170;2024
26;Rioja, La;160;Uruñuela;990;510;480;2024
26;Rioja, La;161;Valdemadera;12;9;3;2024
26;Rioja, La;162;Valgañón;132;76;56;2024
26;Rioja, La;163;Ventosa;189;100;89;2024
26;Rioja, La;164;Ventrosa;51;32;19;2024
26;Rioja, La;165;Viguera;379;215;164;2024
26;Rioja, La;166;Villalba de Rioja;161;93;68;2024
26;Rioja, La;167;Villalobar de Rioja;73;48;25;2024
26;Rioja, La;168;Villamediana de Iregua;9207;4613;4594;2024
26;Rioja, La;169;Villanueva de Cameros;71;43;28;2024
26;Rioja, La;170;Villar de Arnedo, El;617;329;288;2024
26;Rioja, La;171;Villar de Torre;147;89;58;2024
26;Rioja, La;172;Villarejo;27;21;6;2024
26;Rioja, La;173;Villarroya;4;3;1;2024
26;Rioja, La;174;Villarta-Quintana;130;73;57;2024
26;Rioja, La;175;Villavelayo;41;28;13;2024
26;Rioja, La;176;Villaverde de Rioja;75;43;32;2024
26;Rioja, La;177;Villoslada de Cameros;348;220;128;2024
26;Rioja, La;178;Viniegra de Abajo;75;48;27;2024
26;Rioja, La;179;Viniegra de Arriba;40;28;12;2024
26;Rioja, La;180;Zarratón;255;133;122;2024
26;Rioja, La;181;Zarzosa;14;9;5;2024
26;Rioja, La;183;Zorraquín;86;49;37;2024
27;Lugo;001;Abadín;2217;1103;1114;2024
27;Lugo;002;Alfoz;1523;725;798;2024
27;Lugo;003;Antas de Ulla;1822;889;933;2024
27;Lugo;004;Baleira;1120;599;521;2024
27;Lugo;005;Barreiros;3030;1462;1568;2024
27;Lugo;006;Becerreá;2703;1351;1352;2024
27;Lugo;007;Begonte;2905;1470;1435;2024
27;Lugo;008;Bóveda;1409;713;696;2024
27;Lugo;009;Carballedo;2044;1030;1014;2024
27;Lugo;010;Castro de Rei;5041;2537;2504;2024
27;Lugo;011;Castroverde;2497;1286;1211;2024
27;Lugo;012;Cervantes;1187;690;497;2024
27;Lugo;013;Cervo;4184;2060;2124;2024
27;Lugo;014;Corgo, O;3370;1737;1633;2024
27;Lugo;015;Cospeito;4213;2072;2141;2024
27;Lugo;016;Chantada;8092;3940;4152;2024
27;Lugo;017;Folgoso do Courel;978;509;469;2024
27;Lugo;018;Fonsagrada, A;3116;1628;1488;2024
27;Lugo;019;Foz;10198;4960;5238;2024
27;Lugo;020;Friol;3598;1845;1753;2024
27;Lugo;021;Xermade;1698;849;849;2024
27;Lugo;022;Guitiriz;5122;2576;2546;2024
27;Lugo;023;Guntín;2529;1287;1242;2024
27;Lugo;024;Incio, O;1508;772;736;2024
27;Lugo;025;Xove;3327;1737;1590;2024
27;Lugo;026;Láncara;2500;1279;1221;2024
27;Lugo;027;Lourenzá;2098;1025;1073;2024
27;Lugo;028;Lugo;99482;45979;53503;2024
27;Lugo;029;Meira;1756;876;880;2024
27;Lugo;030;Mondoñedo;3352;1593;1759;2024
27;Lugo;031;Monforte de Lemos;18560;8792;9768;2024
27;Lugo;032;Monterroso;3632;1798;1834;2024
27;Lugo;033;Muras;600;306;294;2024
27;Lugo;034;Navia de Suarna;979;543;436;2024
27;Lugo;035;Negueira de Muñiz;240;132;108;2024
27;Lugo;037;Nogais, As;942;498;444;2024
27;Lugo;038;Ourol;985;503;482;2024
27;Lugo;039;Outeiro de Rei;5358;2744;2614;2024
27;Lugo;040;Palas de Rei;3267;1672;1595;2024
27;Lugo;041;Pantón;2340;1157;1183;2024
27;Lugo;042;Paradela;1591;802;789;2024
27;Lugo;043;Páramo, O;1296;647;649;2024
27;Lugo;044;Pastoriza, A;2787;1404;1383;2024
27;Lugo;045;Pedrafita do Cebreiro;898;488;410;2024
27;Lugo;046;Pol;1542;773;769;2024
27;Lugo;047;Pobra do Brollón, A;1619;815;804;2024
27;Lugo;048;Pontenova, A;2124;1033;1091;2024
27;Lugo;049;Portomarín;1286;666;620;2024
27;Lugo;050;Quiroga;3057;1473;1584;2024
27;Lugo;051;Ribadeo;9978;4699;5279;2024
27;Lugo;052;Ribas de Sil;904;460;444;2024
27;Lugo;053;Ribeira de Piquín;492;262;230;2024
27;Lugo;054;Riotorto;1179;595;584;2024
27;Lugo;055;Samos;1198;629;569;2024
27;Lugo;056;Rábade;1499;739;760;2024
27;Lugo;057;Sarria;13459;6565;6894;2024
27;Lugo;058;Saviñao, O;3488;1772;1716;2024
27;Lugo;059;Sober;2129;1042;1087;2024
27;Lugo;060;Taboada;2601;1254;1347;2024
27;Lugo;061;Trabada;1083;532;551;2024
27;Lugo;062;Triacastela;609;298;311;2024
27;Lugo;063;Valadouro, O;1906;908;998;2024
27;Lugo;064;Vicedo, O;1589;770;819;2024
27;Lugo;065;Vilalba;13787;6648;7139;2024
27;Lugo;066;Viveiro;15217;7482;7735;2024
27;Lugo;901;Baralla;2455;1308;1147;2024
27;Lugo;902;Burela;9547;4790;4757;2024
28;Madrid;001;Acebeda, La;68;37;31;2024
28;Madrid;002;Ajalvir;4863;2537;2326;2024
28;Madrid;003;Alameda del Valle;255;140;115;2024
28;Madrid;004;Álamo, El;10430;5151;5279;2024
28;Madrid;005;Alcalá de Henares;200702;96841;103861;2024
28;Madrid;006;Alcobendas;121373;57849;63524;2024
28;Madrid;007;Alcorcón;173625;83028;90597;2024
28;Madrid;008;Aldea del Fresno;3422;1753;1669;2024
28;Madrid;009;Algete;21167;10307;10860;2024
28;Madrid;010;Alpedrete;15543;7620;7923;2024
28;Madrid;011;Ambite;697;349;348;2024
28;Madrid;012;Anchuelo;1392;728;664;2024
28;Madrid;013;Aranjuez;62292;30346;31946;2024
28;Madrid;014;Arganda del Rey;59513;29660;29853;2024
28;Madrid;015;Arroyomolinos;37208;18439;18769;2024
28;Madrid;016;Atazar, El;107;57;50;2024
28;Madrid;017;Batres;1943;1010;933;2024
28;Madrid;018;Becerril de la Sierra;6573;3255;3318;2024
28;Madrid;019;Belmonte de Tajo;1917;995;922;2024
28;Madrid;020;Berzosa del Lozoya;231;129;102;2024
28;Madrid;021;Berrueco, El;816;415;401;2024
28;Madrid;022;Boadilla del Monte;65839;32226;33613;2024
28;Madrid;023;Boalo, El;8547;4252;4295;2024
28;Madrid;024;Braojos;219;131;88;2024
28;Madrid;025;Brea de Tajo;579;331;248;2024
28;Madrid;026;Brunete;11300;5502;5798;2024
28;Madrid;027;Buitrago del Lozoya;1973;957;1016;2024
28;Madrid;028;Bustarviejo;2829;1378;1451;2024
28;Madrid;029;Cabanillas de la Sierra;941;483;458;2024
28;Madrid;030;Cabrera, La;2922;1439;1483;2024
28;Madrid;031;Cadalso de los Vidrios;3228;1682;1546;2024
28;Madrid;032;Camarma de Esteruelas;8106;4143;3963;2024
28;Madrid;033;Campo Real;6802;3417;3385;2024
28;Madrid;034;Canencia;469;242;227;2024
28;Madrid;035;Carabaña;2352;1193;1159;2024
28;Madrid;036;Casarrubuelos;4211;2168;2043;2024
28;Madrid;037;Cenicientos;2148;1074;1074;2024
28;Madrid;038;Cercedilla;7647;3767;3880;2024
28;Madrid;039;Cervera de Buitrago;161;94;67;2024
28;Madrid;040;Ciempozuelos;26140;13114;13026;2024
28;Madrid;041;Cobeña;7759;3803;3956;2024
28;Madrid;042;Colmenar del Arroyo;2015;1039;976;2024
28;Madrid;043;Colmenar de Oreja;8888;4493;4395;2024
28;Madrid;044;Colmenarejo;9623;4756;4867;2024
28;Madrid;045;Colmenar Viejo;57029;28139;28890;2024
28;Madrid;046;Collado Mediano;7547;3742;3805;2024
28;Madrid;047;Collado Villalba;66698;32270;34428;2024
28;Madrid;048;Corpa;792;396;396;2024
28;Madrid;049;Coslada;80760;39287;41473;2024
28;Madrid;050;Cubas de la Sagra;6988;3540;3448;2024
28;Madrid;051;Chapinería;2642;1313;1329;2024
28;Madrid;052;Chinchón;5818;2917;2901;2024
28;Madrid;053;Daganzo de Arriba;10703;5335;5368;2024
28;Madrid;054;Escorial, El;17176;8447;8729;2024
28;Madrid;055;Estremera;1467;760;707;2024
28;Madrid;056;Fresnedillas de la Oliva;1837;927;910;2024
28;Madrid;057;Fresno de Torote;2548;1323;1225;2024
28;Madrid;058;Fuenlabrada;190790;93178;97612;2024
28;Madrid;059;Fuente el Saz de Jarama;7379;3720;3659;2024
28;Madrid;060;Fuentidueña de Tajo;2328;1156;1172;2024
28;Madrid;061;Galapagar;36184;17561;18623;2024
28;Madrid;062;Garganta de los Montes;416;230;186;2024
28;Madrid;063;Gargantilla del Lozoya y Pinilla de Buitrago;397;223;174;2024
28;Madrid;064;Gascones;239;127;112;2024
28;Madrid;065;Getafe;189906;92424;97482;2024
28;Madrid;066;Griñón;10718;5330;5388;2024
28;Madrid;067;Guadalix de la Sierra;6904;3479;3425;2024
28;Madrid;068;Guadarrama;17062;8376;8686;2024
28;Madrid;069;Hiruela, La;83;52;31;2024
28;Madrid;070;Horcajo de la Sierra-Aoslos;233;113;120;2024
28;Madrid;071;Horcajuelo de la Sierra;111;55;56;2024
28;Madrid;072;Hoyo de Manzanares;9178;4624;4554;2024
28;Madrid;073;Humanes de Madrid;20074;9973;10101;2024
28;Madrid;074;Leganés;194084;93396;100688;2024
28;Madrid;075;Loeches;9200;4635;4565;2024
28;Madrid;076;Lozoya;617;324;293;2024
28;Madrid;078;Madarcos;70;36;34;2024
28;Madrid;079;Madrid;3416771;1600298;1816473;2024
28;Madrid;080;Majadahonda;73355;34677;38678;2024
28;Madrid;082;Manzanares el Real;9550;4824;4726;2024
28;Madrid;083;Meco;15732;7865;7867;2024
28;Madrid;084;Mejorada del Campo;24659;12226;12433;2024
28;Madrid;085;Miraflores de la Sierra;7139;3623;3516;2024
28;Madrid;086;Molar, El;10052;5076;4976;2024
28;Madrid;087;Molinos, Los;4731;2340;2391;2024
28;Madrid;088;Montejo de la Sierra;374;197;177;2024
28;Madrid;089;Moraleja de Enmedio;5576;2813;2763;2024
28;Madrid;090;Moralzarzal;14586;7234;7352;2024
28;Madrid;091;Morata de Tajuña;8319;4184;4135;2024
28;Madrid;092;Móstoles;214006;103595;110411;2024
28;Madrid;093;Navacerrada;3290;1618;1672;2024
28;Madrid;094;Navalafuente;1672;856;816;2024
28;Madrid;095;Navalagamella;3111;1590;1521;2024
28;Madrid;096;Navalcarnero;32683;16229;16454;2024
28;Madrid;097;Navarredonda y San Mamés;151;91;60;2024
28;Madrid;099;Navas del Rey;3347;1729;1618;2024
28;Madrid;100;Nuevo Baztán;7339;3699;3640;2024
28;Madrid;101;Olmeda de las Fuentes;408;212;196;2024
28;Madrid;102;Orusco de Tajuña;1511;780;731;2024
28;Madrid;104;Paracuellos de Jarama;27238;13575;13663;2024
28;Madrid;106;Parla;134833;66806;68027;2024
28;Madrid;107;Patones;602;270;332;2024
28;Madrid;108;Pedrezuela;6467;3264;3203;2024
28;Madrid;109;Pelayos de la Presa;3136;1591;1545;2024
28;Madrid;110;Perales de Tajuña;3207;1582;1625;2024
28;Madrid;111;Pezuela de las Torres;989;524;465;2024
28;Madrid;112;Pinilla del Valle;200;107;93;2024
28;Madrid;113;Pinto;56003;27542;28461;2024
28;Madrid;114;Piñuécar-Gandullas;185;98;87;2024
28;Madrid;115;Pozuelo de Alarcón;89378;42719;46659;2024
28;Madrid;116;Pozuelo del Rey;1292;672;620;2024
28;Madrid;117;Prádena del Rincón;139;76;63;2024
28;Madrid;118;Puebla de la Sierra;93;55;38;2024
28;Madrid;119;Quijorna;4001;1974;2027;2024
28;Madrid;120;Rascafría;1707;918;789;2024
28;Madrid;121;Redueña;288;160;128;2024
28;Madrid;122;Ribatejada;900;461;439;2024
28;Madrid;123;Rivas-Vaciamadrid;101949;50329;51620;2024
28;Madrid;124;Robledillo de la Jara;131;68;63;2024
28;Madrid;125;Robledo de Chavela;4725;2454;2271;2024
28;Madrid;126;Robregordo;73;40;33;2024
28;Madrid;127;Rozas de Madrid, Las;98590;47568;51022;2024
28;Madrid;128;Rozas de Puerto Real;580;337;243;2024
28;Madrid;129;San Agustín del Guadalix;13762;6677;7085;2024
28;Madrid;130;San Fernando de Henares;38980;18900;20080;2024
28;Madrid;131;San Lorenzo de El Escorial;18735;8909;9826;2024
28;Madrid;132;San Martín de la Vega;20733;10625;10108;2024
28;Madrid;133;San Martín de Valdeiglesias;9159;4547;4612;2024
28;Madrid;134;San Sebastián de los Reyes;94969;45936;49033;2024
28;Madrid;135;Santa María de la Alameda;1517;816;701;2024
28;Madrid;136;Santorcaz;999;498;501;2024
28;Madrid;137;Santos de la Humosa, Los;2785;1434;1351;2024
28;Madrid;138;Serna del Monte, La;105;55;50;2024
28;Madrid;140;Serranillos del Valle;4634;2274;2360;2024
28;Madrid;141;Sevilla la Nueva;9657;4728;4929;2024
28;Madrid;143;Somosierra;95;52;43;2024
28;Madrid;144;Soto del Real;9441;4671;4770;2024
28;Madrid;145;Talamanca de Jarama;4533;2193;2340;2024
28;Madrid;146;Tielmes;2810;1411;1399;2024
28;Madrid;147;Titulcia;1387;720;667;2024
28;Madrid;148;Torrejón de Ardoz;140626;68848;71778;2024
28;Madrid;149;Torrejón de la Calzada;10378;5163;5215;2024
28;Madrid;150;Torrejón de Velasco;4893;2431;2462;2024
28;Madrid;151;Torrelaguna;4991;2473;2518;2024
28;Madrid;152;Torrelodones;25316;12247;13069;2024
28;Madrid;153;Torremocha de Jarama;1132;569;563;2024
28;Madrid;154;Torres de la Alameda;7758;3981;3777;2024
28;Madrid;155;Valdaracete;645;326;319;2024
28;Madrid;156;Valdeavero;1823;920;903;2024
28;Madrid;157;Valdelaguna;1094;565;529;2024
28;Madrid;158;Valdemanco;1052;547;505;2024
28;Madrid;159;Valdemaqueda;833;434;399;2024
28;Madrid;160;Valdemorillo;14164;7087;7077;2024
28;Madrid;161;Valdemoro;83507;41033;42474;2024
28;Madrid;162;Valdeolmos-Alalpardo;4568;2329;2239;2024
28;Madrid;163;Valdepiélagos;619;323;296;2024
28;Madrid;164;Valdetorres de Jarama;5026;2508;2518;2024
28;Madrid;165;Valdilecha;3213;1651;1562;2024
28;Madrid;166;Valverde de Alcalá;553;287;266;2024
28;Madrid;167;Velilla de San Antonio;14003;6953;7050;2024
28;Madrid;168;Vellón, El;2166;1144;1022;2024
28;Madrid;169;Venturada;2559;1305;1254;2024
28;Madrid;170;Villaconejos;3508;1763;1745;2024
28;Madrid;171;Villa del Prado;7437;3805;3632;2024
28;Madrid;172;Villalbilla;18000;9068;8932;2024
28;Madrid;173;Villamanrique de Tajo;825;421;404;2024
28;Madrid;174;Villamanta;2823;1438;1385;2024
28;Madrid;175;Villamantilla;1624;808;816;2024
28;Madrid;176;Villanueva de la Cañada;23799;11534;12265;2024
28;Madrid;177;Villanueva del Pardillo;18086;8722;9364;2024
28;Madrid;178;Villanueva de Perales;1674;851;823;2024
28;Madrid;179;Villar del Olmo;2277;1146;1131;2024
28;Madrid;180;Villarejo de Salvanés;7900;3897;4003;2024
28;Madrid;181;Villaviciosa de Odón;29273;14087;15186;2024
28;Madrid;182;Villavieja del Lozoya;324;171;153;2024
28;Madrid;183;Zarzalejo;1874;971;903;2024
28;Madrid;901;Lozoyuela-Navas-Sieteiglesias;1483;760;723;2024
28;Madrid;902;Puentes Viejas;775;403;372;2024
28;Madrid;903;Tres Cantos;52932;25694;27238;2024
29;Málaga;001;Alameda;5449;2750;2699;2024
29;Málaga;002;Alcaucín;2653;1351;1302;2024
29;Málaga;003;Alfarnate;1046;542;504;2024
29;Málaga;004;Alfarnatejo;371;192;179;2024
29;Málaga;005;Algarrobo;6909;3471;3438;2024
29;Málaga;006;Algatocín;834;439;395;2024
29;Málaga;007;Alhaurín de la Torre;44057;21849;22208;2024
29;Málaga;008;Alhaurín el Grande;27647;13752;13895;2024
29;Málaga;009;Almáchar;1927;978;949;2024
29;Málaga;010;Almargen;1913;964;949;2024
29;Málaga;011;Almogía;4132;2151;1981;2024
29;Málaga;012;Álora;13570;6808;6762;2024
29;Málaga;013;Alozaina;2130;1082;1048;2024
29;Málaga;014;Alpandeire;258;135;123;2024
29;Málaga;015;Antequera;41619;20368;21251;2024
29;Málaga;016;Árchez;411;210;201;2024
29;Málaga;017;Archidona;8042;4049;3993;2024
29;Málaga;018;Ardales;2516;1270;1246;2024
29;Málaga;019;Arenas;1259;655;604;2024
29;Málaga;020;Arriate;4073;2012;2061;2024
29;Málaga;021;Atajate;187;97;90;2024
29;Málaga;022;Benadalid;234;113;121;2024
29;Málaga;023;Benahavís;9077;4518;4559;2024
29;Málaga;024;Benalauría;465;248;217;2024
29;Málaga;025;Benalmádena;77654;37965;39689;2024
29;Málaga;026;Benamargosa;1552;795;757;2024
29;Málaga;027;Benamocarra;3115;1551;1564;2024
29;Málaga;028;Benaoján;1428;731;697;2024
29;Málaga;029;Benarrabá;462;239;223;2024
29;Málaga;030;Borge, El;941;481;460;2024
29;Málaga;031;Burgo, El;1758;894;864;2024
29;Málaga;032;Campillos;8499;4255;4244;2024
29;Málaga;033;Canillas de Aceituno;1777;922;855;2024
29;Málaga;034;Canillas de Albaida;799;396;403;2024
29;Málaga;035;Cañete la Real;1587;793;794;2024
29;Málaga;036;Carratraca;786;410;376;2024
29;Málaga;037;Cartajima;229;119;110;2024
29;Málaga;038;Cártama;28934;14627;14307;2024
29;Málaga;039;Casabermeja;4065;2110;1955;2024
29;Málaga;040;Casarabonela;2758;1461;1297;2024
29;Málaga;041;Casares;8486;4329;4157;2024
29;Málaga;042;Coín;25809;12975;12834;2024
29;Málaga;043;Colmenar;3545;1818;1727;2024
29;Málaga;044;Comares;1346;722;624;2024
29;Málaga;045;Cómpeta;3735;1863;1872;2024
29;Málaga;046;Cortes de la Frontera;3000;1551;1449;2024
29;Málaga;047;Cuevas Bajas;1341;660;681;2024
29;Málaga;048;Cuevas del Becerro;1605;788;817;2024
29;Málaga;049;Cuevas de San Marcos;3620;1815;1805;2024
29;Málaga;050;Cútar;587;304;283;2024
29;Málaga;051;Estepona;78413;38202;40211;2024
29;Málaga;052;Faraján;284;145;139;2024
29;Málaga;053;Frigiliana;3310;1643;1667;2024
29;Málaga;054;Fuengirola;85859;41575;44284;2024
29;Málaga;055;Fuente de Piedra;2958;1464;1494;2024
29;Málaga;056;Gaucín;1591;823;768;2024
29;Málaga;057;Genalguacil;397;195;202;2024
29;Málaga;058;Guaro;2469;1266;1203;2024
29;Málaga;059;Humilladero;3360;1681;1679;2024
29;Málaga;060;Igualeja;774;393;381;2024
29;Málaga;061;Istán;1622;803;819;2024
29;Málaga;062;Iznate;947;485;462;2024
29;Málaga;063;Jimera de Líbar;398;204;194;2024
29;Málaga;064;Jubrique;578;293;285;2024
29;Málaga;065;Júzcar;227;133;94;2024
29;Málaga;066;Macharaviaya;506;287;219;2024
29;Málaga;067;Málaga;591637;283717;307920;2024
29;Málaga;068;Manilva;18099;9064;9035;2024
29;Málaga;069;Marbella;159000;75903;83097;2024
29;Málaga;070;Mijas;93302;46196;47106;2024
29;Málaga;071;Moclinejo;1227;629;598;2024
29;Málaga;072;Mollina;5449;2706;2743;2024
29;Málaga;073;Monda;2981;1547;1434;2024
29;Málaga;074;Montejaque;952;469;483;2024
29;Málaga;075;Nerja;22187;10882;11305;2024
29;Málaga;076;Ojén;4682;2408;2274;2024
29;Málaga;077;Parauta;281;146;135;2024
29;Málaga;079;Periana;3350;1733;1617;2024
29;Málaga;080;Pizarra;10177;5108;5069;2024
29;Málaga;081;Pujerra;290;147;143;2024
29;Málaga;082;Rincón de la Victoria;52230;25423;26807;2024
29;Málaga;083;Riogordo;2778;1457;1321;2024
29;Málaga;084;Ronda;33451;16227;17224;2024
29;Málaga;085;Salares;198;108;90;2024
29;Málaga;086;Sayalonga;1646;870;776;2024
29;Málaga;087;Sedella;600;337;263;2024
29;Málaga;088;Sierra de Yeguas;3452;1726;1726;2024
29;Málaga;089;Teba;3702;1856;1846;2024
29;Málaga;090;Tolox;2374;1215;1159;2024
29;Málaga;091;Torrox;21583;10813;10770;2024
29;Málaga;092;Totalán;776;394;382;2024
29;Málaga;093;Valle de Abdalajís;2435;1225;1210;2024
29;Málaga;094;Vélez-Málaga;85990;42240;43750;2024
29;Málaga;095;Villanueva de Algaidas;4075;2060;2015;2024
29;Málaga;096;Villanueva del Rosario;3401;1661;1740;2024
29;Málaga;097;Villanueva del Trabuco;5410;2720;2690;2024
29;Málaga;098;Villanueva de Tapia;1396;707;689;2024
29;Málaga;099;Viñuela;2006;1026;980;2024
29;Málaga;100;Yunquera;2868;1454;1414;2024
29;Málaga;901;Torremolinos;70933;35808;35125;2024
29;Málaga;902;Villanueva de la Concepción;3286;1581;1705;2024
29;Málaga;903;Montecorto;589;317;272;2024
29;Málaga;904;Serrato;453;230;223;2024
30;Murcia;001;Abanilla;6206;3180;3026;2024
30;Murcia;002;Abarán;13000;6488;6512;2024
30;Murcia;003;Águilas;37417;18586;18831;2024
30;Murcia;004;Albudeite;1400;712;688;2024
30;Murcia;005;Alcantarilla;43547;21562;21985;2024
30;Murcia;006;Aledo;1108;549;559;2024
30;Murcia;007;Alguazas;10204;5266;4938;2024
30;Murcia;008;Alhama de Murcia;23578;11907;11671;2024
30;Murcia;009;Archena;20976;11121;9855;2024
30;Murcia;010;Beniel;11535;5976;5559;2024
30;Murcia;011;Blanca;6825;3535;3290;2024
30;Murcia;012;Bullas;11793;5905;5888;2024
30;Murcia;013;Calasparra;10286;5205;5081;2024
30;Murcia;014;Campos del Río;2151;1029;1122;2024
30;Murcia;015;Caravaca de la Cruz;25996;13010;12986;2024
30;Murcia;016;Cartagena;219777;109474;110303;2024
30;Murcia;017;Cehegín;14476;7253;7223;2024
30;Murcia;018;Ceutí;12842;6483;6359;2024
30;Murcia;019;Cieza;35361;17701;17660;2024
30;Murcia;020;Fortuna;11183;5910;5273;2024
30;Murcia;021;Fuente Álamo de Murcia;18719;9860;8859;2024
30;Murcia;022;Jumilla;27263;14242;13021;2024
30;Murcia;023;Librilla;5777;2974;2803;2024
30;Murcia;024;Lorca;98334;50149;48185;2024
30;Murcia;025;Lorquí;7770;3934;3836;2024
30;Murcia;026;Mazarrón;35099;18278;16821;2024
30;Murcia;027;Molina de Segura;77493;38626;38867;2024
30;Murcia;028;Moratalla;7593;3855;3738;2024
30;Murcia;029;Mula;17585;8963;8622;2024
30;Murcia;030;Murcia;474617;232717;241900;2024
30;Murcia;031;Ojós;532;283;249;2024
30;Murcia;032;Pliego;3964;2067;1897;2024
30;Murcia;033;Puerto Lumbreras;17822;9398;8424;2024
30;Murcia;034;Ricote;1212;641;571;2024
30;Murcia;035;San Javier;35872;18050;17822;2024
30;Murcia;036;San Pedro del Pinatar;28706;14308;14398;2024
30;Murcia;037;Torre-Pacheco;40074;20753;19321;2024
30;Murcia;038;Torres de Cotillas, Las;22406;11290;11116;2024
30;Murcia;039;Totana;33663;17245;16418;2024
30;Murcia;040;Ulea;891;456;435;2024
30;Murcia;041;Unión, La;21153;10702;10451;2024
30;Murcia;042;Villanueva del Río Segura;3944;2064;1880;2024
30;Murcia;043;Yecla;35957;18115;17842;2024
30;Murcia;901;Santomera;16320;8152;8168;2024
30;Murcia;902;Alcázares, Los;19506;9946;9560;2024
31;Navarra;001;Abáigar;86;49;37;2024
31;Navarra;002;Abárzuza/Abartzuza;518;258;260;2024
31;Navarra;003;Abaurregaina/Abaurrea Alta;119;69;50;2024
31;Navarra;004;Abaurrepea/Abaurrea Baja;29;18;11;2024
31;Navarra;005;Aberin;383;203;180;2024
31;Navarra;006;Ablitas;2669;1354;1315;2024
31;Navarra;007;Adiós;191;103;88;2024
31;Navarra;008;Aguilar de Codés;75;41;34;2024
31;Navarra;009;Aibar/Oibar;762;411;351;2024
31;Navarra;010;Altsasu/Alsasua;7710;3889;3821;2024
31;Navarra;011;Allín/Allin;899;488;411;2024
31;Navarra;012;Allo;993;519;474;2024
31;Navarra;013;Améscoa Baja;727;403;324;2024
31;Navarra;014;Ancín/Antzin;346;183;163;2024
31;Navarra;015;Andosilla;2913;1484;1429;2024
31;Navarra;016;Ansoáin/Antsoain;10641;5174;5467;2024
31;Navarra;017;Anue;486;255;231;2024
31;Navarra;018;Añorbe;627;334;293;2024
31;Navarra;019;Aoiz/Agoitz;3007;1516;1491;2024
31;Navarra;020;Araitz;520;286;234;2024
31;Navarra;021;Aranarache/Aranaratxe;70;42;28;2024
31;Navarra;022;Arantza;619;321;298;2024
31;Navarra;023;Aranguren;12787;6423;6364;2024
31;Navarra;024;Arano;110;61;49;2024
31;Navarra;025;Arakil;999;537;462;2024
31;Navarra;026;Aras;155;80;75;2024
31;Navarra;027;Arbizu;1108;585;523;2024
31;Navarra;028;Arce/Artzi;301;165;136;2024
31;Navarra;029;Arcos, Los;1191;597;594;2024
31;Navarra;030;Arellano;159;90;69;2024
31;Navarra;031;Areso;266;138;128;2024
31;Navarra;032;Arguedas;2303;1172;1131;2024
31;Navarra;033;Aria;47;30;17;2024
31;Navarra;034;Aribe;32;18;14;2024
31;Navarra;035;Armañanzas;53;27;26;2024
31;Navarra;036;Arróniz;1054;567;487;2024
31;Navarra;037;Arruazu;122;68;54;2024
31;Navarra;038;Artajona;1774;911;863;2024
31;Navarra;039;Artazu;124;58;66;2024
31;Navarra;040;Atetz;216;123;93;2024
31;Navarra;041;Ayegui/Aiegi;2550;1350;1200;2024
31;Navarra;042;Azagra;3756;1903;1853;2024
31;Navarra;043;Azuelo;33;10;23;2024
31;Navarra;044;Bakaiku;340;179;161;2024
31;Navarra;045;Barásoain;594;313;281;2024
31;Navarra;046;Barbarin;46;27;19;2024
31;Navarra;047;Bargota;247;123;124;2024
31;Navarra;048;Barillas;238;127;111;2024
31;Navarra;049;Basaburua;833;475;358;2024
31;Navarra;050;Baztan;7863;3988;3875;2024
31;Navarra;051;Beire;288;147;141;2024
31;Navarra;052;Belascoáin;129;62;67;2024
31;Navarra;053;Berbinzana;674;349;325;2024
31;Navarra;054;Bertizarana;654;326;328;2024
31;Navarra;055;Betelu;383;196;187;2024
31;Navarra;056;Biurrun-Olcoz;236;121;115;2024
31;Navarra;057;Buñuel;2315;1150;1165;2024
31;Navarra;058;Auritz/Burguete;230;123;107;2024
31;Navarra;059;Burgui/Burgi;190;116;74;2024
31;Navarra;060;Burlada/Burlata;21078;10150;10928;2024
31;Navarra;061;Busto, El;54;27;27;2024
31;Navarra;062;Cabanillas;1376;707;669;2024
31;Navarra;063;Cabredo;75;42;33;2024
31;Navarra;064;Cadreita;2197;1154;1043;2024
31;Navarra;065;Caparroso;2861;1514;1347;2024
31;Navarra;066;Cárcar;1140;582;558;2024
31;Navarra;067;Carcastillo;2411;1211;1200;2024
31;Navarra;068;Cascante;4131;2069;2062;2024
31;Navarra;069;Cáseda;943;495;448;2024
31;Navarra;070;Castejón;4473;2261;2212;2024
31;Navarra;071;Castillonuevo;15;9;6;2024
31;Navarra;072;Cintruénigo;8333;4325;4008;2024
31;Navarra;073;Ziordia;353;184;169;2024
31;Navarra;074;Cirauqui/Zirauki;465;247;218;2024
31;Navarra;075;Ciriza/Ziritza;161;82;79;2024
31;Navarra;076;Cizur;3940;2021;1919;2024
31;Navarra;077;Corella;8712;4404;4308;2024
31;Navarra;078;Cortes;3160;1623;1537;2024
31;Navarra;079;Desojo;70;35;35;2024
31;Navarra;080;Dicastillo;571;308;263;2024
31;Navarra;081;Donamaria;452;226;226;2024
31;Navarra;082;Etxalar;814;427;387;2024
31;Navarra;083;Echarri/Etxarri;78;38;40;2024
31;Navarra;084;Etxarri Aranatz;2545;1322;1223;2024
31;Navarra;085;Etxauri;662;342;320;2024
31;Navarra;086;Valle de Egüés/Eguesibar;22443;11163;11280;2024
31;Navarra;087;Elgorriaga;210;105;105;2024
31;Navarra;088;Noáin (Valle de Elorz)/Noain (Elortzibar);8469;4253;4216;2024
31;Navarra;089;Enériz/Eneritz;327;167;160;2024
31;Navarra;090;Eratsun;153;90;63;2024
31;Navarra;091;Ergoiena;382;202;180;2024
31;Navarra;092;Erro;811;447;364;2024
31;Navarra;093;Ezcároz/Ezkaroze;304;177;127;2024
31;Navarra;094;Eslava;106;51;55;2024
31;Navarra;095;Esparza de Salazar/Espartza Zaraitzu;76;38;38;2024
31;Navarra;096;Espronceda;108;56;52;2024
31;Navarra;097;Estella-Lizarra;14329;6933;7396;2024
31;Navarra;098;Esteribar;2877;1490;1387;2024
31;Navarra;099;Etayo;70;37;33;2024
31;Navarra;100;Eulate;271;148;123;2024
31;Navarra;101;Ezcabarte;1870;976;894;2024
31;Navarra;102;Ezkurra;136;94;42;2024
31;Navarra;103;Ezprogui;51;26;25;2024
31;Navarra;104;Falces;2353;1212;1141;2024
31;Navarra;105;Fitero;2222;1125;1097;2024
31;Navarra;106;Fontellas;1022;520;502;2024
31;Navarra;107;Funes;2558;1379;1179;2024
31;Navarra;108;Fustiñana;2451;1225;1226;2024
31;Navarra;109;Galar;2400;1225;1175;2024
31;Navarra;110;Gallipienzo/Galipentzu;98;55;43;2024
31;Navarra;111;Gallués/Galoze;93;60;33;2024
31;Navarra;112;Garaioa;90;53;37;2024
31;Navarra;113;Garde;131;78;53;2024
31;Navarra;114;Garínoain;526;282;244;2024
31;Navarra;115;Garralda;180;90;90;2024
31;Navarra;116;Genevilla;68;44;24;2024
31;Navarra;117;Goizueta;692;368;324;2024
31;Navarra;118;Goñi;172;104;68;2024
31;Navarra;119;Güesa/Gorza;35;20;15;2024
31;Navarra;120;Guesálaz/Gesalatz;433;244;189;2024
31;Navarra;121;Guirguillano;73;39;34;2024
31;Navarra;122;Huarte/Uharte;7737;3854;3883;2024
31;Navarra;123;Uharte Arakil;791;415;376;2024
31;Navarra;124;Ibargoiti;270;152;118;2024
31;Navarra;125;Igúzquiza;302;148;154;2024
31;Navarra;126;Imotz;412;229;183;2024
31;Navarra;127;Irañeta;170;92;78;2024
31;Navarra;128;Isaba/Izaba;385;187;198;2024
31;Navarra;129;Ituren;526;258;268;2024
31;Navarra;130;Iturmendi;432;217;215;2024
31;Navarra;131;Iza/Itza;1380;735;645;2024
31;Navarra;132;Izagaondoa;159;110;49;2024
31;Navarra;133;Izalzu/Itzaltzu;38;22;16;2024
31;Navarra;134;Jaurrieta;180;105;75;2024
31;Navarra;135;Javier;111;28;83;2024
31;Navarra;136;Juslapeña/Txulapain;565;307;258;2024
31;Navarra;137;Beintza-Labaien;217;125;92;2024
31;Navarra;138;Lakuntza;1325;699;626;2024
31;Navarra;139;Lana;157;90;67;2024
31;Navarra;140;Lantz;151;87;64;2024
31;Navarra;141;Lapoblación;126;73;53;2024
31;Navarra;142;Larraga;2133;1119;1014;2024
31;Navarra;143;Larraona;105;52;53;2024
31;Navarra;144;Larraun;901;487;414;2024
31;Navarra;145;Lazagurría;174;90;84;2024
31;Navarra;146;Leache/Leatxe;40;20;20;2024
31;Navarra;147;Legarda;146;80;66;2024
31;Navarra;148;Legaria;119;60;59;2024
31;Navarra;149;Leitza;3011;1547;1464;2024
31;Navarra;150;Leoz/Leotz;210;134;76;2024
31;Navarra;151;Lerga;43;24;19;2024
31;Navarra;152;Lerín;1783;933;850;2024
31;Navarra;153;Lesaka;2716;1372;1344;2024
31;Navarra;154;Lezaun;247;142;105;2024
31;Navarra;155;Liédena;351;183;168;2024
31;Navarra;156;Lizoain-Arriasgoiti/Lizoainibar-Arriasgoiti;288;171;117;2024
31;Navarra;157;Lodosa;4931;2511;2420;2024
31;Navarra;158;Lónguida/Longida;301;163;138;2024
31;Navarra;159;Lumbier;1327;693;634;2024
31;Navarra;160;Luquin;131;68;63;2024
31;Navarra;161;Mañeru;450;236;214;2024
31;Navarra;162;Marañón;50;28;22;2024
31;Navarra;163;Marcilla;2921;1473;1448;2024
31;Navarra;164;Mélida;732;382;350;2024
31;Navarra;165;Mendavia;3535;1769;1766;2024
31;Navarra;166;Mendaza;291;147;144;2024
31;Navarra;167;Mendigorria;1218;640;578;2024
31;Navarra;168;Metauten;262;150;112;2024
31;Navarra;169;Milagro;3639;1855;1784;2024
31;Navarra;170;Mirafuentes;58;28;30;2024
31;Navarra;171;Miranda de Arga;903;481;422;2024
31;Navarra;172;Monreal/Elo;512;276;236;2024
31;Navarra;173;Monteagudo;1085;563;522;2024
31;Navarra;174;Morentin;107;49;58;2024
31;Navarra;175;Mues;76;44;32;2024
31;Navarra;176;Murchante;4239;2139;2100;2024
31;Navarra;177;Murieta;344;175;169;2024
31;Navarra;178;Murillo el Cuende;712;378;334;2024
31;Navarra;179;Murillo el Fruto;664;353;311;2024
31;Navarra;180;Muruzábal;275;133;142;2024
31;Navarra;181;Navascués/Nabaskoze;116;68;48;2024
31;Navarra;182;Nazar;43;24;19;2024
31;Navarra;183;Obanos;910;456;454;2024
31;Navarra;184;Oco;63;35;28;2024
31;Navarra;185;Ochagavía/Otsagabia;488;266;222;2024
31;Navarra;186;Odieta;378;200;178;2024
31;Navarra;187;Oiz;133;70;63;2024
31;Navarra;188;Olaibar;407;229;178;2024
31;Navarra;189;Olazti/Olazagutía;1464;746;718;2024
31;Navarra;190;Olejua;47;28;19;2024
31;Navarra;191;Olite/Erriberri;4087;2072;2015;2024
31;Navarra;192;Olóriz/Oloritz;215;123;92;2024
31;Navarra;193;Cendea de Olza/Oltza Zendea;1842;923;919;2024
31;Navarra;194;Valle de Ollo/Ollaran;436;238;198;2024
31;Navarra;195;Orbaizeta;187;90;97;2024
31;Navarra;196;Orbara;29;15;14;2024
31;Navarra;197;Orísoain;72;43;29;2024
31;Navarra;198;Oronz/Orontze;51;25;26;2024
31;Navarra;199;Oroz-Betelu/Orotz-Betelu;143;83;60;2024
31;Navarra;200;Oteiza;950;499;451;2024
31;Navarra;201;Pamplona/Iruña;207777;98268;109509;2024
31;Navarra;202;Peralta/Azkoien;6003;3053;2950;2024
31;Navarra;203;Petilla de Aragón;26;15;11;2024
31;Navarra;204;Piedramillera;45;29;16;2024
31;Navarra;205;Pitillas;529;258;271;2024
31;Navarra;206;Puente la Reina/Gares;2930;1483;1447;2024
31;Navarra;207;Pueyo/Puiu;361;203;158;2024
31;Navarra;208;Ribaforada;3701;1909;1792;2024
31;Navarra;209;Romanzado/Erromantzatua;191;105;86;2024
31;Navarra;210;Roncal/Erronkari;214;114;100;2024
31;Navarra;211;Orreaga/Roncesvalles;21;11;10;2024
31;Navarra;212;Sada;128;70;58;2024
31;Navarra;213;Saldías;123;66;57;2024
31;Navarra;214;Salinas de Oro/Jaitz;112;58;54;2024
31;Navarra;215;San Adrián;6481;3249;3232;2024
31;Navarra;216;Sangüesa/Zangoza;4862;2465;2397;2024
31;Navarra;217;San Martín de Unx;364;194;170;2024
31;Navarra;219;Sansol;89;45;44;2024
31;Navarra;220;Santacara;858;440;418;2024
31;Navarra;221;Doneztebe/Santesteban;1860;914;946;2024
31;Navarra;222;Sarriés/Sartze;59;43;16;2024
31;Navarra;223;Sartaguda;1325;682;643;2024
31;Navarra;224;Sesma;1247;654;593;2024
31;Navarra;225;Sorlada;43;26;17;2024
31;Navarra;226;Sunbilla;674;349;325;2024
31;Navarra;227;Tafalla;10778;5387;5391;2024
31;Navarra;228;Tiebas-Muruarte de Reta;660;359;301;2024
31;Navarra;229;Tirapu;51;29;22;2024
31;Navarra;230;Torralba del Río;97;51;46;2024
31;Navarra;231;Torres del Río;115;59;56;2024
31;Navarra;232;Tudela;38685;19088;19597;2024
31;Navarra;233;Tulebras;155;72;83;2024
31;Navarra;234;Ucar;190;108;82;2024
31;Navarra;235;Ujué/Uxue;172;94;78;2024
31;Navarra;236;Ultzama;1628;839;789;2024
31;Navarra;237;Unciti;233;143;90;2024
31;Navarra;238;Unzué/Untzue;165;85;80;2024
31;Navarra;239;Urdazubi/Urdax;364;182;182;2024
31;Navarra;240;Urdiain;642;330;312;2024
31;Navarra;241;Urraul Alto;136;90;46;2024
31;Navarra;242;Urraul Bajo;323;142;181;2024
31;Navarra;243;Urroz-Villa;404;210;194;2024
31;Navarra;244;Urroz;173;96;77;2024
31;Navarra;245;Urzainqui/Urzainki;78;46;32;2024
31;Navarra;246;Uterga;171;94;77;2024
31;Navarra;247;Uztárroz/Uztarroze;140;68;72;2024
31;Navarra;248;Luzaide/Valcarlos;309;167;142;2024
31;Navarra;249;Valtierra;2464;1249;1215;2024
31;Navarra;250;Bera;3763;1850;1913;2024
31;Navarra;251;Viana;4413;2248;2165;2024
31;Navarra;252;Vidángoz/Bidankoze;76;43;33;2024
31;Navarra;253;Bidaurreta;170;89;81;2024
31;Navarra;254;Villafranca;3077;1607;1470;2024
31;Navarra;255;Villamayor de Monjardín;113;59;54;2024
31;Navarra;256;Hiriberri/Villanueva de Aezkoa;99;55;44;2024
31;Navarra;257;Villatuerta;1268;632;636;2024
31;Navarra;258;Villava/Atarrabia;10016;4861;5155;2024
31;Navarra;259;Igantzi;591;317;274;2024
31;Navarra;260;Valle de Yerri/Deierri;1566;801;765;2024
31;Navarra;261;Yesa;290;167;123;2024
31;Navarra;262;Zabalza/Zabaltza;297;159;138;2024
31;Navarra;263;Zubieta;290;147;143;2024
31;Navarra;264;Zugarramurdi;227;109;118;2024
31;Navarra;265;Zúñiga;82;48;34;2024
31;Navarra;901;Barañáin/Barañain;19606;9447;10159;2024
31;Navarra;902;Berrioplano/Berriobeiti;7631;3902;3729;2024
31;Navarra;903;Berriozar;11201;5635;5566;2024
31;Navarra;904;Irurtzun;2316;1200;1116;2024
31;Navarra;905;Beriáin;4197;2064;2133;2024
31;Navarra;906;Orkoien;4097;2079;2018;2024
31;Navarra;907;Zizur Mayor/Zizur Nagusia;16124;7881;8243;2024
31;Navarra;908;Lekunberri;1697;868;829;2024
32;Ourense;001;Allariz;6410;3185;3225;2024
32;Ourense;002;Amoeiro;2399;1200;1199;2024
32;Ourense;003;Arnoia, A;970;470;500;2024
32;Ourense;004;Avión;1727;792;935;2024
32;Ourense;005;Baltar;853;459;394;2024
32;Ourense;006;Bande;1473;743;730;2024
32;Ourense;007;Baños de Molgas;1504;761;743;2024
32;Ourense;008;Barbadás;11176;5414;5762;2024
32;Ourense;009;Barco de Valdeorras, O;13300;6455;6845;2024
32;Ourense;010;Beade;366;183;183;2024
32;Ourense;011;Beariz;949;438;511;2024
32;Ourense;012;Blancos, Os;716;385;331;2024
32;Ourense;013;Boborás;2199;1051;1148;2024
32;Ourense;014;Bola, A;1091;525;566;2024
32;Ourense;015;Bolo, O;792;399;393;2024
32;Ourense;016;Calvos de Randín;644;335;309;2024
32;Ourense;017;Carballeda de Valdeorras;1341;690;651;2024
32;Ourense;018;Carballeda de Avia;1194;589;605;2024
32;Ourense;019;Carballiño, O;14075;6539;7536;2024
32;Ourense;020;Cartelle;2500;1226;1274;2024
32;Ourense;021;Castrelo do Val;951;492;459;2024
32;Ourense;022;Castrelo de Miño;1292;662;630;2024
32;Ourense;023;Castro Caldelas;1238;643;595;2024
32;Ourense;024;Celanova;5727;2693;3034;2024
32;Ourense;025;Cenlle;1076;528;548;2024
32;Ourense;026;Coles;3172;1596;1576;2024
32;Ourense;027;Cortegada;1024;513;511;2024
32;Ourense;028;Cualedro;1586;835;751;2024
32;Ourense;029;Chandrexa de Queixa;478;248;230;2024
32;Ourense;030;Entrimo;1079;516;563;2024
32;Ourense;031;Esgos;1102;562;540;2024
32;Ourense;032;Xinzo de Limia;9632;4669;4963;2024
32;Ourense;033;Gomesende;664;337;327;2024
32;Ourense;034;Gudiña, A;1186;618;568;2024
32;Ourense;035;Irixo, O;1357;664;693;2024
32;Ourense;036;Xunqueira de Ambía;1352;667;685;2024
32;Ourense;037;Xunqueira de Espadanedo;673;338;335;2024
32;Ourense;038;Larouco;437;206;231;2024
32;Ourense;039;Laza;1164;608;556;2024
32;Ourense;040;Leiro;1481;721;760;2024
32;Ourense;041;Lobeira;718;358;360;2024
32;Ourense;042;Lobios;1820;898;922;2024
32;Ourense;043;Maceda;2837;1412;1425;2024
32;Ourense;044;Manzaneda;798;388;410;2024
32;Ourense;045;Maside;2742;1375;1367;2024
32;Ourense;046;Melón;1109;535;574;2024
32;Ourense;047;Merca, A;1916;963;953;2024
32;Ourense;048;Mezquita, A;1006;514;492;2024
32;Ourense;049;Montederramo;670;360;310;2024
32;Ourense;050;Monterrei;2397;1215;1182;2024
32;Ourense;051;Muíños;1418;716;702;2024
32;Ourense;052;Nogueira de Ramuín;2048;1039;1009;2024
32;Ourense;053;Oímbra;1711;936;775;2024
32;Ourense;054;Ourense;104891;47538;57353;2024
32;Ourense;055;Paderne de Allariz;1352;677;675;2024
32;Ourense;056;Padrenda;1534;761;773;2024
32;Ourense;057;Parada de Sil;522;282;240;2024
32;Ourense;058;Pereiro de Aguiar, O;6731;3452;3279;2024
32;Ourense;059;Peroxa, A;1761;859;902;2024
32;Ourense;060;Petín;861;437;424;2024
32;Ourense;061;Piñor;1119;576;543;2024
32;Ourense;062;Porqueira;832;392;440;2024
32;Ourense;063;Pobra de Trives, A;1968;966;1002;2024
32;Ourense;064;Pontedeva;458;231;227;2024
32;Ourense;065;Punxín;755;364;391;2024
32;Ourense;066;Quintela de Leirado;594;281;313;2024
32;Ourense;067;Rairiz de Veiga;1179;606;573;2024
32;Ourense;068;Ramirás;1508;710;798;2024
32;Ourense;069;Ribadavia;4936;2417;2519;2024
32;Ourense;070;San Xoán de Río;518;265;253;2024
32;Ourense;071;Riós;1407;729;678;2024
32;Ourense;072;Rúa, A;4223;2107;2116;2024
32;Ourense;073;Rubiá;1390;683;707;2024
32;Ourense;074;San Amaro;1039;514;525;2024
32;Ourense;075;San Cibrao das Viñas;5718;2876;2842;2024
32;Ourense;076;San Cristovo de Cea;1989;990;999;2024
32;Ourense;077;Sandiás;1113;529;584;2024
32;Ourense;078;Sarreaus;1069;531;538;2024
32;Ourense;079;Taboadela;1488;757;731;2024
32;Ourense;080;Teixeira, A;326;177;149;2024
32;Ourense;081;Toén;2333;1178;1155;2024
32;Ourense;082;Trasmiras;1220;611;609;2024
32;Ourense;083;Veiga, A;887;471;416;2024
32;Ourense;084;Verea;955;473;482;2024
32;Ourense;085;Verín;13798;6659;7139;2024
32;Ourense;086;Viana do Bolo;2736;1372;1364;2024
32;Ourense;087;Vilamarín;1854;946;908;2024
32;Ourense;088;Vilamartín de Valdeorras;1822;918;904;2024
32;Ourense;089;Vilar de Barrio;1199;605;594;2024
32;Ourense;090;Vilar de Santos;795;396;399;2024
32;Ourense;091;Vilardevós;1662;882;780;2024
32;Ourense;092;Vilariño de Conso;510;287;223;2024
33;Asturias;001;Allande;1530;766;764;2024
33;Asturias;002;Aller;10012;4934;5078;2024
33;Asturias;003;Amieva;603;335;268;2024
33;Asturias;004;Avilés;75351;35534;39817;2024
33;Asturias;005;Belmonte de Miranda;1394;748;646;2024
33;Asturias;006;Bimenes;1649;809;840;2024
33;Asturias;007;Boal;1380;707;673;2024
33;Asturias;008;Cabrales;1908;962;946;2024
33;Asturias;009;Cabranes;1097;554;543;2024
33;Asturias;010;Candamo;1899;931;968;2024
33;Asturias;011;Cangas del Narcea;11421;5551;5870;2024
33;Asturias;012;Cangas de Onís;6316;3065;3251;2024
33;Asturias;013;Caravia;492;258;234;2024
33;Asturias;014;Carreño;10256;4960;5296;2024
33;Asturias;015;Caso;1427;826;601;2024
33;Asturias;016;Castrillón;22124;10649;11475;2024
33;Asturias;017;Castropol;3252;1584;1668;2024
33;Asturias;018;Coaña;3323;1639;1684;2024
33;Asturias;019;Colunga;3148;1572;1576;2024
33;Asturias;020;Corvera de Asturias;15637;7665;7972;2024
33;Asturias;021;Cudillero;4896;2411;2485;2024
33;Asturias;022;Degaña;780;395;385;2024
33;Asturias;023;Franco, El;3744;1821;1923;2024
33;Asturias;024;Gijón;268561;126299;142262;2024
33;Asturias;025;Gozón;10405;5083;5322;2024
33;Asturias;026;Grado;9688;4689;4999;2024
33;Asturias;027;Grandas de Salime;779;402;377;2024
33;Asturias;028;Ibias;1098;623;475;2024
33;Asturias;029;Illano;289;150;139;2024
33;Asturias;030;Illas;1034;528;506;2024
33;Asturias;031;Langreo;38282;18255;20027;2024
33;Asturias;032;Laviana;12284;5901;6383;2024
33;Asturias;033;Lena;10259;4939;5320;2024
33;Asturias;034;Valdés;10895;5360;5535;2024
33;Asturias;035;Llanera;13938;6878;7060;2024
33;Asturias;036;Llanes;13549;6610;6939;2024
33;Asturias;037;Mieres;36132;17203;18929;2024
33;Asturias;038;Morcín;2537;1280;1257;2024
33;Asturias;039;Muros de Nalón;1942;937;1005;2024
33;Asturias;040;Nava;5203;2552;2651;2024
33;Asturias;041;Navia;8112;3898;4214;2024
33;Asturias;042;Noreña;5102;2450;2652;2024
33;Asturias;043;Onís;732;383;349;2024
33;Asturias;044;Oviedo;220543;102094;118449;2024
33;Asturias;045;Parres;5152;2528;2624;2024
33;Asturias;046;Peñamellera Alta;518;271;247;2024
33;Asturias;047;Peñamellera Baja;1188;593;595;2024
33;Asturias;048;Pesoz;135;71;64;2024
33;Asturias;049;Piloña;6753;3280;3473;2024
33;Asturias;050;Ponga;576;340;236;2024
33;Asturias;051;Pravia;7790;3798;3992;2024
33;Asturias;052;Proaza;675;397;278;2024
33;Asturias;053;Quirós;1160;678;482;2024
33;Asturias;054;Regueras, Las;1875;951;924;2024
33;Asturias;055;Ribadedeva;1693;818;875;2024
33;Asturias;056;Ribadesella;5552;2634;2918;2024
33;Asturias;057;Ribera de Arriba;1852;927;925;2024
33;Asturias;058;Riosa;1712;860;852;2024
33;Asturias;059;Salas;4799;2382;2417;2024
33;Asturias;060;San Martín del Rey Aurelio;15405;7371;8034;2024
33;Asturias;061;San Martín de Oscos;336;164;172;2024
33;Asturias;062;Santa Eulalia de Oscos;425;224;201;2024
33;Asturias;063;San Tirso de Abres;400;187;213;2024
33;Asturias;064;Santo Adriano;289;144;145;2024
33;Asturias;065;Sariego;1265;604;661;2024
33;Asturias;066;Siero;52593;25698;26895;2024
33;Asturias;067;Sobrescobio;845;443;402;2024
33;Asturias;068;Somiedo;1065;625;440;2024
33;Asturias;069;Soto del Barco;3807;1862;1945;2024
33;Asturias;070;Tapia de Casariego;3579;1726;1853;2024
33;Asturias;071;Taramundi;558;274;284;2024
33;Asturias;072;Teverga;1539;839;700;2024
33;Asturias;073;Tineo;8769;4447;4322;2024
33;Asturias;074;Vegadeo;3930;1874;2056;2024
33;Asturias;075;Villanueva de Oscos;248;126;122;2024
33;Asturias;076;Villaviciosa;15342;7589;7753;2024
33;Asturias;077;Villayón;1064;548;516;2024
33;Asturias;078;Yernes y Tameza;136;75;61;2024
34;Palencia;001;Abarca de Campos;38;23;15;2024
34;Palencia;003;Abia de las Torres;170;92;78;2024
34;Palencia;004;Aguilar de Campoo;6823;3304;3519;2024
34;Palencia;005;Alar del Rey;912;462;450;2024
34;Palencia;006;Alba de Cerrato;82;47;35;2024
34;Palencia;009;Amayuelas de Arriba;38;23;15;2024
34;Palencia;010;Ampudia;579;299;280;2024
34;Palencia;011;Amusco;410;234;176;2024
34;Palencia;012;Antigüedad;336;189;147;2024
34;Palencia;015;Arconada;44;26;18;2024
34;Palencia;017;Astudillo;1039;524;515;2024
34;Palencia;018;Autilla del Pino;219;122;97;2024
34;Palencia;019;Autillo de Campos;130;70;60;2024
34;Palencia;020;Ayuela;53;35;18;2024
34;Palencia;022;Baltanás;1228;634;594;2024
34;Palencia;023;Venta de Baños;6331;3196;3135;2024
34;Palencia;024;Baquerín de Campos;22;14;8;2024
34;Palencia;025;Bárcena de Campos;53;27;26;2024
34;Palencia;027;Barruelo de Santullán;1160;580;580;2024
34;Palencia;028;Báscones de Ojeda;134;71;63;2024
34;Palencia;029;Becerril de Campos;757;377;380;2024
34;Palencia;031;Belmonte de Campos;30;16;14;2024
34;Palencia;032;Berzosilla;47;28;19;2024
34;Palencia;033;Boada de Campos;16;12;4;2024
34;Palencia;034;Boadilla del Camino;114;67;47;2024
34;Palencia;035;Boadilla de Rioseco;101;62;39;2024
34;Palencia;036;Brañosera;253;142;111;2024
34;Palencia;037;Buenavista de Valdavia;296;166;130;2024
34;Palencia;038;Bustillo de la Vega;269;151;118;2024
34;Palencia;039;Bustillo del Páramo de Carrión;55;35;20;2024
34;Palencia;041;Calahorra de Boedo;83;39;44;2024
34;Palencia;042;Calzada de los Molinos;305;164;141;2024
34;Palencia;045;Capillas;72;42;30;2024
34;Palencia;046;Cardeñosa de Volpejera;60;35;25;2024
34;Palencia;047;Carrión de los Condes;1999;967;1032;2024
34;Palencia;048;Castil de Vela;55;29;26;2024
34;Palencia;049;Castrejón de la Peña;320;170;150;2024
34;Palencia;050;Castrillo de Don Juan;181;102;79;2024
34;Palencia;051;Castrillo de Onielo;91;50;41;2024
34;Palencia;052;Castrillo de Villavega;168;91;77;2024
34;Palencia;053;Castromocho;197;105;92;2024
34;Palencia;055;Cervatos de la Cueza;241;138;103;2024
34;Palencia;056;Cervera de Pisuerga;2284;1112;1172;2024
34;Palencia;057;Cevico de la Torre;475;240;235;2024
34;Palencia;058;Cevico Navero;178;105;73;2024
34;Palencia;059;Cisneros;430;210;220;2024
34;Palencia;060;Cobos de Cerrato;128;71;57;2024
34;Palencia;061;Collazos de Boedo;99;58;41;2024
34;Palencia;062;Congosto de Valdavia;140;88;52;2024
34;Palencia;063;Cordovilla la Real;129;72;57;2024
34;Palencia;066;Cubillas de Cerrato;64;38;26;2024
34;Palencia;067;Dehesa de Montejo;135;83;52;2024
34;Palencia;068;Dehesa de Romanos;46;29;17;2024
34;Palencia;069;Dueñas;2587;1310;1277;2024
34;Palencia;070;Espinosa de Cerrato;124;71;53;2024
34;Palencia;071;Espinosa de Villagonzalo;154;85;69;2024
34;Palencia;072;Frechilla;136;73;63;2024
34;Palencia;073;Fresno del Río;171;83;88;2024
34;Palencia;074;Frómista;748;376;372;2024
34;Palencia;076;Fuentes de Nava;567;299;268;2024
34;Palencia;077;Fuentes de Valdepero;484;246;238;2024
34;Palencia;079;Grijota;2789;1428;1361;2024
34;Palencia;080;Guardo;5548;2735;2813;2024
34;Palencia;081;Guaza de Campos;55;33;22;2024
34;Palencia;082;Hérmedes de Cerrato;74;38;36;2024
34;Palencia;083;Herrera de Pisuerga;1898;946;952;2024
34;Palencia;084;Herrera de Valdecañas;158;86;72;2024
34;Palencia;086;Hontoria de Cerrato;106;55;51;2024
34;Palencia;087;Hornillos de Cerrato;170;92;78;2024
34;Palencia;088;Husillos;393;215;178;2024
34;Palencia;089;Itero de la Vega;144;84;60;2024
34;Palencia;091;Lagartos;117;63;54;2024
34;Palencia;092;Lantadilla;273;148;125;2024
34;Palencia;093;Vid de Ojeda, La;90;56;34;2024
34;Palencia;094;Ledigos;62;35;27;2024
34;Palencia;096;Lomas;41;26;15;2024
34;Palencia;098;Magaz de Pisuerga;1031;545;486;2024
34;Palencia;099;Manquillos;58;37;21;2024
34;Palencia;100;Mantinos;145;83;62;2024
34;Palencia;101;Marcilla de Campos;58;25;33;2024
34;Palencia;102;Mazariegos;202;118;84;2024
34;Palencia;103;Mazuecos de Valdeginate;79;51;28;2024
34;Palencia;104;Melgar de Yuso;271;159;112;2024
34;Palencia;106;Meneses de Campos;101;60;41;2024
34;Palencia;107;Micieces de Ojeda;71;42;29;2024
34;Palencia;108;Monzón de Campos;583;310;273;2024
34;Palencia;109;Moratinos;59;32;27;2024
34;Palencia;110;Mudá;80;46;34;2024
34;Palencia;112;Nogal de las Huertas;46;26;20;2024
34;Palencia;113;Olea de Boedo;39;15;24;2024
34;Palencia;114;Olmos de Ojeda;170;108;62;2024
34;Palencia;116;Osornillo;59;32;27;2024
34;Palencia;120;Palencia;76738;36141;40597;2024
34;Palencia;121;Palenzuela;215;122;93;2024
34;Palencia;122;Páramo de Boedo;104;63;41;2024
34;Palencia;123;Paredes de Nava;1911;974;937;2024
34;Palencia;124;Payo de Ojeda;57;34;23;2024
34;Palencia;125;Pedraza de Campos;72;41;31;2024
34;Palencia;126;Pedrosa de la Vega;280;157;123;2024
34;Palencia;127;Perales;118;54;64;2024
34;Palencia;129;Pino del Río;163;96;67;2024
34;Palencia;130;Piña de Campos;193;103;90;2024
34;Palencia;131;Población de Arroyo;42;22;20;2024
34;Palencia;132;Población de Campos;122;69;53;2024
34;Palencia;133;Población de Cerrato;98;55;43;2024
34;Palencia;134;Polentinos;40;22;18;2024
34;Palencia;135;Pomar de Valdivia;490;266;224;2024
34;Palencia;136;Poza de la Vega;166;93;73;2024
34;Palencia;137;Pozo de Urama;18;13;5;2024
34;Palencia;139;Prádanos de Ojeda;181;99;82;2024
34;Palencia;140;Puebla de Valdavia, La;81;42;39;2024
34;Palencia;141;Quintana del Puente;251;139;112;2024
34;Palencia;143;Quintanilla de Onsoña;180;101;79;2024
34;Palencia;146;Reinoso de Cerrato;57;35;22;2024
34;Palencia;147;Renedo de la Vega;192;105;87;2024
34;Palencia;149;Requena de Campos;29;15;14;2024
34;Palencia;151;Respenda de la Peña;141;89;52;2024
34;Palencia;152;Revenga de Campos;136;67;69;2024
34;Palencia;154;Revilla de Collazos;75;40;35;2024
34;Palencia;155;Ribas de Campos;153;77;76;2024
34;Palencia;156;Riberos de la Cueza;54;32;22;2024
34;Palencia;157;Saldaña;2869;1466;1403;2024
34;Palencia;158;Salinas de Pisuerga;329;173;156;2024
34;Palencia;159;San Cebrián de Campos;407;234;173;2024
34;Palencia;160;San Cebrián de Mudá;150;81;69;2024
34;Palencia;161;San Cristóbal de Boedo;20;13;7;2024
34;Palencia;163;San Mamés de Campos;49;25;24;2024
34;Palencia;165;San Román de la Cuba;53;32;21;2024
34;Palencia;167;Santa Cecilia del Alcor;92;47;45;2024
34;Palencia;168;Santa Cruz de Boedo;52;28;24;2024
34;Palencia;169;Santervás de la Vega;400;226;174;2024
34;Palencia;170;Santibáñez de Ecla;42;25;17;2024
34;Palencia;171;Santibáñez de la Peña;934;457;477;2024
34;Palencia;174;Santoyo;192;106;86;2024
34;Palencia;175;Serna, La;93;57;36;2024
34;Palencia;176;Sotobañado y Priorato;158;91;67;2024
34;Palencia;177;Soto de Cerrato;176;101;75;2024
34;Palencia;178;Tabanera de Cerrato;138;74;64;2024
34;Palencia;179;Tabanera de Valdavia;22;16;6;2024
34;Palencia;180;Támara de Campos;74;39;35;2024
34;Palencia;181;Tariego de Cerrato;500;260;240;2024
34;Palencia;182;Torquemada;966;531;435;2024
34;Palencia;184;Torremormojón;45;26;19;2024
34;Palencia;185;Triollo;74;44;30;2024
34;Palencia;186;Valbuena de Pisuerga;52;27;25;2024
34;Palencia;189;Valdeolmillos;60;36;24;2024
34;Palencia;190;Valderrábano;47;25;22;2024
34;Palencia;192;Valde-Ucieza;76;48;28;2024
34;Palencia;196;Valle de Cerrato;83;45;38;2024
34;Palencia;199;Velilla del Río Carrión;1129;572;557;2024
34;Palencia;201;Vertavillo;167;88;79;2024
34;Palencia;202;Villabasta de Valdavia;33;20;13;2024
34;Palencia;204;Villacidaler;46;26;20;2024
34;Palencia;205;Villaconancio;50;30;20;2024
34;Palencia;206;Villada;834;423;411;2024
34;Palencia;208;Villaeles de Valdavia;48;31;17;2024
34;Palencia;210;Villahán;99;58;41;2024
34;Palencia;211;Villaherreros;209;107;102;2024
34;Palencia;213;Villalaco;61;35;26;2024
34;Palencia;214;Villalba de Guardo;201;110;91;2024
34;Palencia;215;Villalcázar de Sirga;174;93;81;2024
34;Palencia;216;Villalcón;48;27;21;2024
34;Palencia;217;Villalobón;1900;952;948;2024
34;Palencia;218;Villaluenga de la Vega;519;298;221;2024
34;Palencia;220;Villamartín de Campos;169;95;74;2024
34;Palencia;221;Villamediana;183;110;73;2024
34;Palencia;222;Villameriel;105;59;46;2024
34;Palencia;223;Villamoronta;239;143;96;2024
34;Palencia;224;Villamuera de la Cueza;37;25;12;2024
34;Palencia;225;Villamuriel de Cerrato;6508;3344;3164;2024
34;Palencia;227;Villanueva del Rebollar;67;36;31;2024
34;Palencia;228;Villanuño de Valdavia;93;51;42;2024
34;Palencia;229;Villaprovedo;46;31;15;2024
34;Palencia;230;Villarmentero de Campos;28;16;12;2024
34;Palencia;231;Villarrabé;176;92;84;2024
34;Palencia;232;Villarramiel;788;415;373;2024
34;Palencia;233;Villasarracino;132;81;51;2024
34;Palencia;234;Villasila de Valdavia;60;40;20;2024
34;Palencia;236;Villaturde;147;79;68;2024
34;Palencia;237;Villaumbrales;623;318;305;2024
34;Palencia;238;Villaviudas;366;180;186;2024
34;Palencia;240;Villerías de Campos;76;41;35;2024
34;Palencia;241;Villodre;24;14;10;2024
34;Palencia;242;Villodrigo;96;51;45;2024
34;Palencia;243;Villoldo;339;182;157;2024
34;Palencia;245;Villota del Páramo;299;176;123;2024
34;Palencia;246;Villovieco;62;35;27;2024
34;Palencia;901;Osorno la Mayor;1190;619;571;2024
34;Palencia;902;Valle del Retortillo;168;97;71;2024
34;Palencia;903;Loma de Ucieza;193;120;73;2024
34;Palencia;904;Pernía, La;313;183;130;2024
35;Palmas, Las;001;Agaete;5670;2841;2829;2024
35;Palmas, Las;002;Agüimes;33179;16662;16517;2024
35;Palmas, Las;003;Antigua;13832;7205;6627;2024
35;Palmas, Las;004;Arrecife;68169;34046;34123;2024
35;Palmas, Las;005;Artenara;1029;594;435;2024
35;Palmas, Las;006;Arucas;38936;19256;19680;2024
35;Palmas, Las;007;Betancuria;812;438;374;2024
35;Palmas, Las;008;Firgas;7688;3886;3802;2024
35;Palmas, Las;009;Gáldar;24811;12390;12421;2024
35;Palmas, Las;010;Haría;5567;2848;2719;2024
35;Palmas, Las;011;Ingenio;32747;16523;16224;2024
35;Palmas, Las;012;Mogán;21175;10893;10282;2024
35;Palmas, Las;013;Moya;7987;4057;3930;2024
35;Palmas, Las;014;Oliva, La;29693;15332;14361;2024
35;Palmas, Las;015;Pájara;21614;11158;10456;2024
35;Palmas, Las;016;Palmas de Gran Canaria, Las;380436;183254;197182;2024
35;Palmas, Las;017;Puerto del Rosario;44638;22460;22178;2024
35;Palmas, Las;018;San Bartolomé;19443;9620;9823;2024
35;Palmas, Las;019;San Bartolomé de Tirajana;54116;28268;25848;2024
35;Palmas, Las;020;Aldea de San Nicolás, La;7449;3841;3608;2024
35;Palmas, Las;021;Santa Brígida;18551;9244;9307;2024
35;Palmas, Las;022;Santa Lucía de Tirajana;77098;38298;38800;2024
35;Palmas, Las;023;Santa María de Guía de Gran Canaria;14135;7019;7116;2024
35;Palmas, Las;024;Teguise;23848;11937;11911;2024
35;Palmas, Las;025;Tejeda;1826;1001;825;2024
35;Palmas, Las;026;Telde;102867;50421;52446;2024
35;Palmas, Las;027;Teror;12878;6573;6305;2024
35;Palmas, Las;028;Tías;21462;10952;10510;2024
35;Palmas, Las;029;Tinajo;6865;3502;3363;2024
35;Palmas, Las;030;Tuineje;16454;8445;8009;2024
35;Palmas, Las;031;Valsequillo de Gran Canaria;9768;4917;4851;2024
35;Palmas, Las;032;Valleseco;3741;1965;1776;2024
35;Palmas, Las;033;Vega de San Mateo;7856;4002;3854;2024
35;Palmas, Las;034;Yaiza;18113;9317;8796;2024
36;Pontevedra;001;Arbo;2636;1362;1274;2024
36;Pontevedra;002;Barro;3657;1796;1861;2024
36;Pontevedra;003;Baiona;12380;6063;6317;2024
36;Pontevedra;004;Bueu;11837;5853;5984;2024
36;Pontevedra;005;Caldas de Reis;9614;4651;4963;2024
36;Pontevedra;006;Cambados;13752;6631;7121;2024
36;Pontevedra;007;Campo Lameiro;1697;813;884;2024
36;Pontevedra;008;Cangas;26714;13215;13499;2024
36;Pontevedra;009;Cañiza, A;5046;2460;2586;2024
36;Pontevedra;010;Catoira;3268;1586;1682;2024
36;Pontevedra;013;Covelo;2422;1258;1164;2024
36;Pontevedra;014;Crecente;1938;950;988;2024
36;Pontevedra;015;Cuntis;4515;2146;2369;2024
36;Pontevedra;016;Dozón;985;509;476;2024
36;Pontevedra;017;Estrada, A;20139;9672;10467;2024
36;Pontevedra;018;Forcarei;3127;1492;1635;2024
36;Pontevedra;019;Fornelos de Montes;1637;796;841;2024
36;Pontevedra;020;Agolada;2282;1150;1132;2024
36;Pontevedra;021;Gondomar;15103;7516;7587;2024
36;Pontevedra;022;Grove, O;10821;5315;5506;2024
36;Pontevedra;023;Guarda, A;10041;4907;5134;2024
36;Pontevedra;024;Lalín;20277;9921;10356;2024
36;Pontevedra;025;Lama, A;2515;1260;1255;2024
36;Pontevedra;026;Marín;24154;11902;12252;2024
36;Pontevedra;027;Meaño;5264;2569;2695;2024
36;Pontevedra;028;Meis;4703;2254;2449;2024
36;Pontevedra;029;Moaña;19315;9395;9920;2024
36;Pontevedra;030;Mondariz;4425;2198;2227;2024
36;Pontevedra;031;Mondariz-Balneario;711;358;353;2024
36;Pontevedra;032;Moraña;4110;2008;2102;2024
36;Pontevedra;033;Mos;15152;7443;7709;2024
36;Pontevedra;034;Neves, As;3678;1809;1869;2024
36;Pontevedra;035;Nigrán;18208;8960;9248;2024
36;Pontevedra;036;Oia;3080;1532;1548;2024
36;Pontevedra;037;Pazos de Borbén;3002;1467;1535;2024
36;Pontevedra;038;Pontevedra;83077;39218;43859;2024
36;Pontevedra;039;Porriño, O;20711;10165;10546;2024
36;Pontevedra;040;Portas;2781;1346;1435;2024
36;Pontevedra;041;Poio;17425;8560;8865;2024
36;Pontevedra;042;Ponteareas;23196;11231;11965;2024
36;Pontevedra;043;Ponte Caldelas;5580;2675;2905;2024
36;Pontevedra;044;Pontecesures;3088;1506;1582;2024
36;Pontevedra;045;Redondela;28976;14006;14970;2024
36;Pontevedra;046;Ribadumia;5212;2523;2689;2024
36;Pontevedra;047;Rodeiro;2244;1138;1106;2024
36;Pontevedra;048;Rosal, O;6509;3215;3294;2024
36;Pontevedra;049;Salceda de Caselas;9430;4698;4732;2024
36;Pontevedra;050;Salvaterra de Miño;10471;5251;5220;2024
36;Pontevedra;051;Sanxenxo;17914;8868;9046;2024
36;Pontevedra;052;Silleda;8870;4363;4507;2024
36;Pontevedra;053;Soutomaior;7584;3797;3787;2024
36;Pontevedra;054;Tomiño;13782;6916;6866;2024
36;Pontevedra;055;Tui;17454;8517;8937;2024
36;Pontevedra;056;Valga;5671;2770;2901;2024
36;Pontevedra;057;Vigo;293977;138336;155641;2024
36;Pontevedra;058;Vilaboa;5869;2880;2989;2024
36;Pontevedra;059;Vila de Cruces;5033;2530;2503;2024
36;Pontevedra;060;Vilagarcía de Arousa;37761;18062;19699;2024
36;Pontevedra;061;Vilanova de Arousa;10225;4991;5234;2024
36;Pontevedra;901;Illa de Arousa, A;4849;2399;2450;2024
36;Pontevedra;902;Cerdedo-Cotobade;5705;2783;2922;2024
37;Salamanca;001;Abusejo;143;73;70;2024
37;Salamanca;002;Agallas;132;74;58;2024
37;Salamanca;003;Ahigal de los Aceiteros;88;46;42;2024
37;Salamanca;004;Ahigal de Villarino;31;18;13;2024
37;Salamanca;005;Alameda de Gardón, La;74;38;36;2024
37;Salamanca;006;Alamedilla, La;101;49;52;2024
37;Salamanca;007;Alaraz;448;236;212;2024
37;Salamanca;008;Alba de Tormes;5122;2582;2540;2024
37;Salamanca;009;Alba de Yeltes;200;111;89;2024
37;Salamanca;010;Alberca, La;1045;517;528;2024
37;Salamanca;011;Alberguería de Argañán, La;98;54;44;2024
37;Salamanca;012;Alconada;134;75;59;2024
37;Salamanca;013;Aldeacipreste;91;49;42;2024
37;Salamanca;014;Aldeadávila de la Ribera;1120;568;552;2024
37;Salamanca;015;Aldea del Obispo;252;143;109;2024
37;Salamanca;016;Aldealengua;713;354;359;2024
37;Salamanca;017;Aldeanueva de Figueroa;253;137;116;2024
37;Salamanca;018;Aldeanueva de la Sierra;98;64;34;2024
37;Salamanca;019;Aldearrodrigo;150;83;67;2024
37;Salamanca;020;Aldearrubia;519;277;242;2024
37;Salamanca;021;Aldeaseca de Alba;64;38;26;2024
37;Salamanca;022;Aldeaseca de la Frontera;248;126;122;2024
37;Salamanca;023;Aldeatejada;2587;1316;1271;2024
37;Salamanca;024;Aldeavieja de Tormes;99;53;46;2024
37;Salamanca;025;Aldehuela de la Bóveda;265;144;121;2024
37;Salamanca;026;Aldehuela de Yeltes;181;98;83;2024
37;Salamanca;027;Almenara de Tormes;305;164;141;2024
37;Salamanca;028;Almendra;132;71;61;2024
37;Salamanca;029;Anaya de Alba;183;105;78;2024
37;Salamanca;030;Añover de Tormes;89;48;41;2024
37;Salamanca;031;Arabayona de Mógica;325;185;140;2024
37;Salamanca;032;Arapiles;739;400;339;2024
37;Salamanca;033;Arcediano;96;52;44;2024
37;Salamanca;034;Arco, El;89;44;45;2024
37;Salamanca;035;Armenteros;186;110;76;2024
37;Salamanca;036;San Miguel del Robledo;43;23;20;2024
37;Salamanca;037;Atalaya, La;100;53;47;2024
37;Salamanca;038;Babilafuente;925;484;441;2024
37;Salamanca;039;Bañobárez;280;140;140;2024
37;Salamanca;040;Barbadillo;390;210;180;2024
37;Salamanca;041;Barbalos;73;44;29;2024
37;Salamanca;042;Barceo;48;29;19;2024
37;Salamanca;044;Barruecopardo;421;233;188;2024
37;Salamanca;045;Bastida, La;26;14;12;2024
37;Salamanca;046;Béjar;11957;5664;6293;2024
37;Salamanca;047;Beleña;251;129;122;2024
37;Salamanca;049;Bermellar;131;69;62;2024
37;Salamanca;050;Berrocal de Huebra;75;41;34;2024
37;Salamanca;051;Berrocal de Salvatierra;70;38;32;2024
37;Salamanca;052;Boada;268;137;131;2024
37;Salamanca;054;Bodón, El;245;132;113;2024
37;Salamanca;055;Bogajo;129;71;58;2024
37;Salamanca;056;Bouza, La;49;20;29;2024
37;Salamanca;057;Bóveda del Río Almar;196;103;93;2024
37;Salamanca;058;Brincones;59;32;27;2024
37;Salamanca;059;Buenamadre;109;54;55;2024
37;Salamanca;060;Buenavista;365;191;174;2024
37;Salamanca;061;Cabaco, El;225;116;109;2024
37;Salamanca;062;Cabezabellosa de la Calzada;74;47;27;2024
37;Salamanca;063;Cabeza de Béjar, La;60;40;20;2024
37;Salamanca;065;Cabeza del Caballo;237;126;111;2024
37;Salamanca;067;Cabrerizos;4226;2110;2116;2024
37;Salamanca;068;Cabrillas;322;161;161;2024
37;Salamanca;069;Calvarrasa de Abajo;1201;631;570;2024
37;Salamanca;070;Calvarrasa de Arriba;615;335;280;2024
37;Salamanca;071;Calzada de Béjar, La;85;50;35;2024
37;Salamanca;072;Calzada de Don Diego;131;68;63;2024
37;Salamanca;073;Calzada de Valdunciel;700;351;349;2024
37;Salamanca;074;Campillo de Azaba;142;89;53;2024
37;Salamanca;077;Campo de Peñaranda, El;250;146;104;2024
37;Salamanca;078;Candelario;843;436;407;2024
37;Salamanca;079;Canillas de Abajo;70;48;22;2024
37;Salamanca;080;Cantagallo;279;141;138;2024
37;Salamanca;081;Cantalapiedra;911;448;463;2024
37;Salamanca;082;Cantalpino;804;434;370;2024
37;Salamanca;083;Cantaracillo;190;100;90;2024
37;Salamanca;085;Carbajosa de la Sagrada;7636;3760;3876;2024
37;Salamanca;086;Carpio de Azaba;112;60;52;2024
37;Salamanca;087;Carrascal de Barregas;1439;752;687;2024
37;Salamanca;088;Carrascal del Obispo;187;104;83;2024
37;Salamanca;089;Casafranca;68;34;34;2024
37;Salamanca;090;Casas del Conde, Las;63;30;33;2024
37;Salamanca;091;Casillas de Flores;168;82;86;2024
37;Salamanca;092;Castellanos de Moriscos;3051;1554;1497;2024
37;Salamanca;096;Castillejo de Martín Viejo;205;122;83;2024
37;Salamanca;097;Castraz;34;23;11;2024
37;Salamanca;098;Cepeda;303;155;148;2024
37;Salamanca;099;Cereceda de la Sierra;62;34;28;2024
37;Salamanca;100;Cerezal de Peñahorcada;67;35;32;2024
37;Salamanca;101;Cerralbo;111;62;49;2024
37;Salamanca;102;Cerro, El;365;181;184;2024
37;Salamanca;103;Cespedosa de Tormes;496;271;225;2024
37;Salamanca;104;Cilleros de la Bastida;23;13;10;2024
37;Salamanca;106;Cipérez;225;121;104;2024
37;Salamanca;107;Ciudad Rodrigo;11846;5680;6166;2024
37;Salamanca;108;Coca de Alba;95;50;45;2024
37;Salamanca;109;Colmenar de Montemayor;173;104;69;2024
37;Salamanca;110;Cordovilla;108;60;48;2024
37;Salamanca;112;Cristóbal;162;97;65;2024
37;Salamanca;113;Cubo de Don Sancho, El;377;197;180;2024
37;Salamanca;114;Chagarcía Medianero;73;40;33;2024
37;Salamanca;115;Dios le Guarde;125;68;57;2024
37;Salamanca;116;Doñinos de Ledesma;65;32;33;2024
37;Salamanca;117;Doñinos de Salamanca;2209;1165;1044;2024
37;Salamanca;118;Éjeme;144;82;62;2024
37;Salamanca;119;Encina, La;100;59;41;2024
37;Salamanca;120;Encina de San Silvestre;108;51;57;2024
37;Salamanca;121;Encinas de Abajo;619;320;299;2024
37;Salamanca;122;Encinas de Arriba;226;113;113;2024
37;Salamanca;123;Encinasola de los Comendadores;148;83;65;2024
37;Salamanca;124;Endrinal;204;118;86;2024
37;Salamanca;125;Escurial de la Sierra;244;135;109;2024
37;Salamanca;126;Espadaña;34;20;14;2024
37;Salamanca;127;Espeja;211;115;96;2024
37;Salamanca;128;Espino de la Orbada;245;135;110;2024
37;Salamanca;129;Florida de Liébana;244;135;109;2024
37;Salamanca;130;Forfoleda;204;112;92;2024
37;Salamanca;131;Frades de la Sierra;167;94;73;2024
37;Salamanca;132;Fregeneda, La;308;158;150;2024
37;Salamanca;133;Fresnedoso;98;54;44;2024
37;Salamanca;134;Fresno Alhándiga;181;94;87;2024
37;Salamanca;135;Fuente de San Esteban, La;1279;646;633;2024
37;Salamanca;136;Fuenteguinaldo;652;314;338;2024
37;Salamanca;137;Fuenteliante;84;41;43;2024
37;Salamanca;138;Fuenterroble de Salvatierra;252;134;118;2024
37;Salamanca;139;Fuentes de Béjar;244;126;118;2024
37;Salamanca;140;Fuentes de Oñoro;1009;531;478;2024
37;Salamanca;141;Gajates;140;69;71;2024
37;Salamanca;142;Galindo y Perahuy;704;397;307;2024
37;Salamanca;143;Galinduste;400;195;205;2024
37;Salamanca;144;Galisancho;325;174;151;2024
37;Salamanca;145;Gallegos de Argañán;264;136;128;2024
37;Salamanca;146;Gallegos de Solmirón;109;60;49;2024
37;Salamanca;147;Garcibuey;204;116;88;2024
37;Salamanca;148;Garcihernández;411;212;199;2024
37;Salamanca;149;Garcirrey;55;32;23;2024
37;Salamanca;150;Gejuelo del Barro;31;18;13;2024
37;Salamanca;151;Golpejas;144;77;67;2024
37;Salamanca;152;Gomecello;412;219;193;2024
37;Salamanca;154;Guadramiro;124;76;48;2024
37;Salamanca;155;Guijo de Ávila;78;44;34;2024
37;Salamanca;156;Guijuelo;5508;2793;2715;2024
37;Salamanca;157;Herguijuela de Ciudad Rodrigo;69;42;27;2024
37;Salamanca;158;Herguijuela de la Sierra;226;126;100;2024
37;Salamanca;159;Herguijuela del Campo;62;32;30;2024
37;Salamanca;160;Hinojosa de Duero;577;292;285;2024
37;Salamanca;161;Horcajo de Montemayor;101;56;45;2024
37;Salamanca;162;Horcajo Medianero;205;109;96;2024
37;Salamanca;163;Hoya, La;30;18;12;2024
37;Salamanca;164;Huerta;285;155;130;2024
37;Salamanca;165;Iruelos;31;16;15;2024
37;Salamanca;166;Ituero de Azaba;199;105;94;2024
37;Salamanca;167;Juzbado;183;95;88;2024
37;Salamanca;168;Lagunilla;428;235;193;2024
37;Salamanca;169;Larrodrigo;186;102;84;2024
37;Salamanca;170;Ledesma;1517;760;757;2024
37;Salamanca;171;Ledrada;465;241;224;2024
37;Salamanca;172;Linares de Riofrío;913;503;410;2024
37;Salamanca;173;Lumbrales;1510;776;734;2024
37;Salamanca;174;Macotera;1001;518;483;2024
37;Salamanca;175;Machacón;445;233;212;2024
37;Salamanca;176;Madroñal;135;75;60;2024
37;Salamanca;177;Maíllo, El;282;159;123;2024
37;Salamanca;178;Malpartida;80;41;39;2024
37;Salamanca;179;Mancera de Abajo;197;102;95;2024
37;Salamanca;180;Manzano, El;57;30;27;2024
37;Salamanca;181;Martiago;250;138;112;2024
37;Salamanca;182;Martinamor;82;53;29;2024
37;Salamanca;183;Martín de Yeltes;387;199;188;2024
37;Salamanca;184;Masueco;251;130;121;2024
37;Salamanca;185;Castellanos de Villiquera;703;365;338;2024
37;Salamanca;186;Mata de Ledesma, La;101;55;46;2024
37;Salamanca;187;Matilla de los Caños del Río;613;299;314;2024
37;Salamanca;188;Maya, La;158;89;69;2024
37;Salamanca;189;Membribe de la Sierra;105;64;41;2024
37;Salamanca;190;Mieza;176;92;84;2024
37;Salamanca;191;Milano, El;88;54;34;2024
37;Salamanca;192;Miranda de Azán;447;248;199;2024
37;Salamanca;193;Miranda del Castañar;381;209;172;2024
37;Salamanca;194;Mogarraz;252;128;124;2024
37;Salamanca;195;Molinillo;43;23;20;2024
37;Salamanca;196;Monforte de la Sierra;53;25;28;2024
37;Salamanca;197;Monleón;85;51;34;2024
37;Salamanca;198;Monleras;245;122;123;2024
37;Salamanca;199;Monsagro;127;72;55;2024
37;Salamanca;200;Montejo;198;109;89;2024
37;Salamanca;201;Montemayor del Río;262;148;114;2024
37;Salamanca;202;Monterrubio de Armuña;1331;689;642;2024
37;Salamanca;203;Monterrubio de la Sierra;148;87;61;2024
37;Salamanca;204;Morasverdes;229;119;110;2024
37;Salamanca;205;Morille;224;116;108;2024
37;Salamanca;206;Moríñigo;88;48;40;2024
37;Salamanca;207;Moriscos;566;305;261;2024
37;Salamanca;208;Moronta;76;47;29;2024
37;Salamanca;209;Mozárbez;510;271;239;2024
37;Salamanca;211;Narros de Matalayegua;198;112;86;2024
37;Salamanca;212;Navacarros;133;71;62;2024
37;Salamanca;213;Nava de Béjar;74;43;31;2024
37;Salamanca;214;Nava de Francia;120;63;57;2024
37;Salamanca;215;Nava de Sotrobal;160;93;67;2024
37;Salamanca;216;Navales;311;174;137;2024
37;Salamanca;217;Navalmoral de Béjar;56;28;28;2024
37;Salamanca;218;Navamorales;44;28;16;2024
37;Salamanca;219;Navarredonda de la Rinconada;151;81;70;2024
37;Salamanca;221;Navasfrías;362;195;167;2024
37;Salamanca;222;Negrilla de Palencia;76;44;32;2024
37;Salamanca;223;Olmedo de Camaces;94;55;39;2024
37;Salamanca;224;Orbada, La;182;94;88;2024
37;Salamanca;225;Pajares de la Laguna;114;61;53;2024
37;Salamanca;226;Palacios del Arzobispo;151;81;70;2024
37;Salamanca;228;Palaciosrubios;299;161;138;2024
37;Salamanca;229;Palencia de Negrilla;138;87;51;2024
37;Salamanca;230;Parada de Arriba;272;139;133;2024
37;Salamanca;231;Parada de Rubiales;241;130;111;2024
37;Salamanca;232;Paradinas de San Juan;384;222;162;2024
37;Salamanca;233;Pastores;56;33;23;2024
37;Salamanca;234;Payo, El;313;155;158;2024
37;Salamanca;235;Pedraza de Alba;220;116;104;2024
37;Salamanca;236;Pedrosillo de Alba;124;74;50;2024
37;Salamanca;237;Pedrosillo de los Aires;314;182;132;2024
37;Salamanca;238;Pedrosillo el Ralo;135;70;65;2024
37;Salamanca;239;Pedroso de la Armuña, El;215;116;99;2024
37;Salamanca;240;Pelabravo;1366;743;623;2024
37;Salamanca;241;Pelarrodríguez;159;93;66;2024
37;Salamanca;242;Pelayos;72;41;31;2024
37;Salamanca;243;Peña, La;70;37;33;2024
37;Salamanca;244;Peñacaballera;153;71;82;2024
37;Salamanca;245;Peñaparda;308;157;151;2024
37;Salamanca;246;Peñaranda de Bracamonte;6063;2985;3078;2024
37;Salamanca;247;Peñarandilla;181;100;81;2024
37;Salamanca;248;Peralejos de Abajo;171;91;80;2024
37;Salamanca;249;Peralejos de Arriba;35;23;12;2024
37;Salamanca;250;Pereña de la Ribera;314;168;146;2024
37;Salamanca;251;Peromingo;122;59;63;2024
37;Salamanca;252;Pinedas;94;59;35;2024
37;Salamanca;253;Pino de Tormes, El;149;83;66;2024
37;Salamanca;254;Pitiegua;182;105;77;2024
37;Salamanca;255;Pizarral;64;38;26;2024
37;Salamanca;256;Poveda de las Cintas;194;115;79;2024
37;Salamanca;257;Pozos de Hinojo;52;28;24;2024
37;Salamanca;258;Puebla de Azaba;142;80;62;2024
37;Salamanca;259;Puebla de San Medel;33;18;15;2024
37;Salamanca;260;Puebla de Yeltes;142;74;68;2024
37;Salamanca;261;Puente del Congosto;225;131;94;2024
37;Salamanca;262;Puertas;65;40;25;2024
37;Salamanca;263;Puerto de Béjar;352;171;181;2024
37;Salamanca;264;Puerto Seguro;55;29;26;2024
37;Salamanca;265;Rágama;197;98;99;2024
37;Salamanca;266;Redonda, La;65;38;27;2024
37;Salamanca;267;Retortillo;174;95;79;2024
37;Salamanca;268;Rinconada de la Sierra, La;100;57;43;2024
37;Salamanca;269;Robleda;457;256;201;2024
37;Salamanca;270;Robliza de Cojos;187;105;82;2024
37;Salamanca;271;Rollán;337;192;145;2024
37;Salamanca;272;Saelices el Chico;173;97;76;2024
37;Salamanca;273;Sagrada, La;82;44;38;2024
37;Salamanca;274;Salamanca;144866;65286;79580;2024
37;Salamanca;275;Saldeana;99;58;41;2024
37;Salamanca;276;Salmoral;112;67;45;2024
37;Salamanca;277;Salvatierra de Tormes;72;36;36;2024
37;Salamanca;278;San Cristóbal de la Cuesta;1143;596;547;2024
37;Salamanca;279;Sancti-Spíritus;731;396;335;2024
37;Salamanca;280;Sanchón de la Ribera;67;36;31;2024
37;Salamanca;281;Sanchón de la Sagrada;51;32;19;2024
37;Salamanca;282;Sanchotello;212;106;106;2024
37;Salamanca;283;Sando;113;67;46;2024
37;Salamanca;284;San Esteban de la Sierra;372;214;158;2024
37;Salamanca;285;San Felices de los Gallegos;350;189;161;2024
37;Salamanca;286;San Martín del Castañar;234;126;108;2024
37;Salamanca;287;San Miguel de Valero;303;159;144;2024
37;Salamanca;288;San Morales;366;202;164;2024
37;Salamanca;289;San Muñoz;201;100;101;2024
37;Salamanca;290;San Pedro del Valle;145;82;63;2024
37;Salamanca;291;San Pedro de Rozados;269;151;118;2024
37;Salamanca;292;San Pelayo de Guareña;92;57;35;2024
37;Salamanca;293;Santa María de Sando;95;47;48;2024
37;Salamanca;294;Santa Marta de Tormes;14726;7123;7603;2024
37;Salamanca;296;Santiago de la Puebla;282;146;136;2024
37;Salamanca;297;Santibáñez de Béjar;444;225;219;2024
37;Salamanca;298;Santibáñez de la Sierra;149;86;63;2024
37;Salamanca;299;Santiz;229;128;101;2024
37;Salamanca;300;Santos, Los;580;294;286;2024
37;Salamanca;301;Sardón de los Frailes;101;55;46;2024
37;Salamanca;302;Saucelle;252;128;124;2024
37;Salamanca;303;Sahugo, El;181;97;84;2024
37;Salamanca;304;Sepulcro-Hilario;157;85;72;2024
37;Salamanca;305;Sequeros;207;100;107;2024
37;Salamanca;306;Serradilla del Arroyo;246;130;116;2024
37;Salamanca;307;Serradilla del Llano;138;74;64;2024
37;Salamanca;309;Sierpe, La;42;21;21;2024
37;Salamanca;310;Sieteiglesias de Tormes;164;79;85;2024
37;Salamanca;311;Sobradillo;173;87;86;2024
37;Salamanca;312;Sorihuela;256;138;118;2024
37;Salamanca;313;Sotoserrano;513;268;245;2024
37;Salamanca;314;Tabera de Abajo;99;55;44;2024
37;Salamanca;315;Tala, La;76;42;34;2024
37;Salamanca;316;Tamames;785;396;389;2024
37;Salamanca;317;Tarazona de Guareña;269;150;119;2024
37;Salamanca;318;Tardáguila;197;120;77;2024
37;Salamanca;319;Tejado, El;83;49;34;2024
37;Salamanca;320;Tejeda y Segoyuela;97;52;45;2024
37;Salamanca;321;Tenebrón;121;64;57;2024
37;Salamanca;322;Terradillos;3220;1579;1641;2024
37;Salamanca;323;Topas;511;272;239;2024
37;Salamanca;324;Tordillos;316;170;146;2024
37;Salamanca;325;Tornadizo, El;86;52;34;2024
37;Salamanca;327;Torresmenudas;184;105;79;2024
37;Salamanca;328;Trabanca;160;78;82;2024
37;Salamanca;329;Tremedal de Tormes;35;21;14;2024
37;Salamanca;330;Valdecarros;310;159;151;2024
37;Salamanca;331;Valdefuentes de Sangusín;189;107;82;2024
37;Salamanca;332;Valdehijaderos;84;44;40;2024
37;Salamanca;333;Valdelacasa;189;109;80;2024
37;Salamanca;334;Valdelageve;67;37;30;2024
37;Salamanca;335;Valdelosa;404;204;200;2024
37;Salamanca;336;Valdemierque;59;36;23;2024
37;Salamanca;337;Valderrodrigo;128;67;61;2024
37;Salamanca;338;Valdunciel;110;56;54;2024
37;Salamanca;339;Valero;286;165;121;2024
37;Salamanca;340;Valsalabroso;119;66;53;2024
37;Salamanca;341;Valverde de Valdelacasa;57;29;28;2024
37;Salamanca;342;Valverdón;264;136;128;2024
37;Salamanca;343;Vallejera de Riofrío;72;37;35;2024
37;Salamanca;344;Vecinos;219;105;114;2024
37;Salamanca;345;Vega de Tirados;149;80;69;2024
37;Salamanca;346;Veguillas, Las;275;141;134;2024
37;Salamanca;347;Vellés, La;540;291;249;2024
37;Salamanca;348;Ventosa del Río Almar;99;55;44;2024
37;Salamanca;349;Vídola, La;107;54;53;2024
37;Salamanca;350;Vilvestre;395;197;198;2024
37;Salamanca;351;Villaflores;260;127;133;2024
37;Salamanca;352;Villagonzalo de Tormes;216;130;86;2024
37;Salamanca;353;Villalba de los Llanos;110;62;48;2024
37;Salamanca;354;Villamayor;7669;3826;3843;2024
37;Salamanca;355;Villanueva del Conde;174;92;82;2024
37;Salamanca;356;Villar de Argañán;98;56;42;2024
37;Salamanca;357;Villar de Ciervo;253;138;115;2024
37;Salamanca;358;Villar de Gallimazo;198;128;70;2024
37;Salamanca;359;Villar de la Yegua;155;84;71;2024
37;Salamanca;360;Villar de Peralonso;204;106;98;2024
37;Salamanca;361;Villar de Samaniego;78;44;34;2024
37;Salamanca;362;Villares de la Reina;6723;3309;3414;2024
37;Salamanca;363;Villares de Yeltes;96;46;50;2024
37;Salamanca;364;Villarino de los Aires;739;391;348;2024
37;Salamanca;365;Villarmayor;154;86;68;2024
37;Salamanca;366;Villarmuerto;40;27;13;2024
37;Salamanca;367;Villasbuenas;164;88;76;2024
37;Salamanca;368;Villasdardo;22;7;15;2024
37;Salamanca;369;Villaseco de los Gamitos;137;81;56;2024
37;Salamanca;370;Villaseco de los Reyes;298;179;119;2024
37;Salamanca;371;Villasrubias;236;128;108;2024
37;Salamanca;372;Villaverde de Guareña;138;73;65;2024
37;Salamanca;373;Villavieja de Yeltes;688;369;319;2024
37;Salamanca;374;Villoria;1258;648;610;2024
37;Salamanca;375;Villoruela;731;370;361;2024
37;Salamanca;376;Vitigudino;2361;1139;1222;2024
37;Salamanca;377;Yecla de Yeltes;222;116;106;2024
37;Salamanca;378;Zamarra;71;40;31;2024
37;Salamanca;379;Zamayón;192;115;77;2024
37;Salamanca;380;Zarapicos;49;30;19;2024
37;Salamanca;381;Zarza de Pumareda, La;133;83;50;2024
37;Salamanca;382;Zorita de la Frontera;152;73;79;2024
38;Santa Cruz de Tenerife;001;Adeje;50549;25283;25266;2024
38;Santa Cruz de Tenerife;002;Agulo;1108;559;549;2024
38;Santa Cruz de Tenerife;003;Alajeró;2071;1087;984;2024
38;Santa Cruz de Tenerife;004;Arafo;5776;2901;2875;2024
38;Santa Cruz de Tenerife;005;Arico;9120;4715;4405;2024
38;Santa Cruz de Tenerife;006;Arona;86624;43674;42950;2024
38;Santa Cruz de Tenerife;007;Barlovento;2014;1023;991;2024
38;Santa Cruz de Tenerife;008;Breña Alta;7428;3614;3814;2024
38;Santa Cruz de Tenerife;009;Breña Baja;6112;3083;3029;2024
38;Santa Cruz de Tenerife;010;Buenavista del Norte;4680;2348;2332;2024
38;Santa Cruz de Tenerife;011;Candelaria;28795;13856;14939;2024
38;Santa Cruz de Tenerife;012;Fasnia;3066;1607;1459;2024
38;Santa Cruz de Tenerife;013;Frontera;4528;2272;2256;2024
38;Santa Cruz de Tenerife;014;Fuencaliente de la Palma;1900;952;948;2024
38;Santa Cruz de Tenerife;015;Garachico;4924;2450;2474;2024
38;Santa Cruz de Tenerife;016;Garafía;1983;1036;947;2024
38;Santa Cruz de Tenerife;017;Granadilla de Abona;57143;28424;28719;2024
38;Santa Cruz de Tenerife;018;Guancha, La;5593;2742;2851;2024
38;Santa Cruz de Tenerife;019;Guía de Isora;22642;11244;11398;2024
38;Santa Cruz de Tenerife;020;Güímar;21716;10731;10985;2024
38;Santa Cruz de Tenerife;021;Hermigua;1887;993;894;2024
38;Santa Cruz de Tenerife;022;Icod de los Vinos;24285;11908;12377;2024
38;Santa Cruz de Tenerife;023;San Cristóbal de La Laguna;160258;76999;83259;2024
38;Santa Cruz de Tenerife;024;Llanos de Aridane, Los;20283;9836;10447;2024
38;Santa Cruz de Tenerife;025;Matanza de Acentejo, La;9160;4566;4594;2024
38;Santa Cruz de Tenerife;026;Orotava, La;42585;20805;21780;2024
38;Santa Cruz de Tenerife;027;Paso, El;8156;4057;4099;2024
38;Santa Cruz de Tenerife;028;Puerto de la Cruz;31377;15188;16189;2024
38;Santa Cruz de Tenerife;029;Puntagorda;2355;1204;1151;2024
38;Santa Cruz de Tenerife;030;Puntallana;2699;1356;1343;2024
38;Santa Cruz de Tenerife;031;Realejos, Los;37522;18390;19132;2024
38;Santa Cruz de Tenerife;032;Rosario, El;17983;9100;8883;2024
38;Santa Cruz de Tenerife;033;San Andrés y Sauces;4296;2144;2152;2024
38;Santa Cruz de Tenerife;034;San Juan de la Rambla;4904;2448;2456;2024
38;Santa Cruz de Tenerife;035;San Miguel de Abona;23138;11675;11463;2024
38;Santa Cruz de Tenerife;036;San Sebastián de la Gomera;9562;4772;4790;2024
38;Santa Cruz de Tenerife;037;Santa Cruz de la Palma;15565;7475;8090;2024
38;Santa Cruz de Tenerife;038;Santa Cruz de Tenerife;211359;100527;110832;2024
38;Santa Cruz de Tenerife;039;Santa Úrsula;15386;7594;7792;2024
38;Santa Cruz de Tenerife;040;Santiago del Teide;12373;6118;6255;2024
38;Santa Cruz de Tenerife;041;Sauzal, El;9278;4605;4673;2024
38;Santa Cruz de Tenerife;042;Silos, Los;4705;2361;2344;2024
38;Santa Cruz de Tenerife;043;Tacoronte;24746;12327;12419;2024
38;Santa Cruz de Tenerife;044;Tanque, El;2787;1348;1439;2024
38;Santa Cruz de Tenerife;045;Tazacorte;4559;2342;2217;2024
38;Santa Cruz de Tenerife;046;Tegueste;11405;5609;5796;2024
38;Santa Cruz de Tenerife;047;Tijarafe;2684;1371;1313;2024
38;Santa Cruz de Tenerife;048;Valverde;5268;2622;2646;2024
38;Santa Cruz de Tenerife;049;Valle Gran Rey;4854;2469;2385;2024
38;Santa Cruz de Tenerife;050;Vallehermoso;2954;1529;1425;2024
38;Santa Cruz de Tenerife;051;Victoria de Acentejo, La;9313;4615;4698;2024
38;Santa Cruz de Tenerife;052;Vilaflor de Chasna;1871;948;923;2024
38;Santa Cruz de Tenerife;053;Villa de Mazo;5070;2568;2502;2024
38;Santa Cruz de Tenerife;901;Pinar de El Hierro, El;2010;1058;952;2024
39;Cantabria;001;Alfoz de Lloredo;2499;1290;1209;2024
39;Cantabria;002;Ampuero;4477;2249;2228;2024
39;Cantabria;003;Anievas;267;147;120;2024
39;Cantabria;004;Arenas de Iguña;1756;885;871;2024
39;Cantabria;005;Argoños;1872;940;932;2024
39;Cantabria;006;Arnuero;2279;1137;1142;2024
39;Cantabria;007;Arredondo;477;268;209;2024
39;Cantabria;008;Astillero, El;18467;8985;9482;2024
39;Cantabria;009;Bárcena de Cicero;4741;2440;2301;2024
39;Cantabria;010;Bárcena de Pie de Concha;674;342;332;2024
39;Cantabria;011;Bareyo;2133;1075;1058;2024
39;Cantabria;012;Cabezón de la Sal;8162;3932;4230;2024
39;Cantabria;013;Cabezón de Liébana;540;311;229;2024
39;Cantabria;014;Cabuérniga;998;524;474;2024
39;Cantabria;015;Camaleño;969;540;429;2024
39;Cantabria;016;Camargo;30422;14836;15586;2024
39;Cantabria;017;Campoo de Yuso;673;361;312;2024
39;Cantabria;018;Cartes;5865;2927;2938;2024
39;Cantabria;019;Castañeda;3252;1637;1615;2024
39;Cantabria;020;Castro-Urdiales;33482;16515;16967;2024
39;Cantabria;021;Cieza;546;281;265;2024
39;Cantabria;022;Cillorigo de Liébana;1362;717;645;2024
39;Cantabria;023;Colindres;8540;4171;4369;2024
39;Cantabria;024;Comillas;2146;1020;1126;2024
39;Cantabria;025;Corrales de Buelna, Los;10813;5283;5530;2024
39;Cantabria;026;Corvera de Toranzo;2139;1081;1058;2024
39;Cantabria;027;Campoo de Enmedio;3736;1909;1827;2024
39;Cantabria;028;Entrambasaguas;5646;2838;2808;2024
39;Cantabria;029;Escalante;736;368;368;2024
39;Cantabria;030;Guriezo;2458;1288;1170;2024
39;Cantabria;031;Hazas de Cesto;1867;915;952;2024
39;Cantabria;032;Hermandad de Campoo de Suso;1616;897;719;2024
39;Cantabria;033;Herrerías;581;326;255;2024
39;Cantabria;034;Lamasón;246;155;91;2024
39;Cantabria;035;Laredo;10752;5116;5636;2024
39;Cantabria;036;Liendo;1226;642;584;2024
39;Cantabria;037;Liérganes;2390;1193;1197;2024
39;Cantabria;038;Limpias;1991;999;992;2024
39;Cantabria;039;Luena;608;330;278;2024
39;Cantabria;040;Marina de Cudeyo;5190;2590;2600;2024
39;Cantabria;041;Mazcuerras;2093;1084;1009;2024
39;Cantabria;042;Medio Cudeyo;7686;3705;3981;2024
39;Cantabria;043;Meruelo;2311;1148;1163;2024
39;Cantabria;044;Miengo;5221;2682;2539;2024
39;Cantabria;045;Miera;398;211;187;2024
39;Cantabria;046;Molledo;1480;730;750;2024
39;Cantabria;047;Noja;2700;1367;1333;2024
39;Cantabria;048;Penagos;2254;1137;1117;2024
39;Cantabria;049;Peñarrubia;314;161;153;2024
39;Cantabria;050;Pesaguero;276;154;122;2024
39;Cantabria;051;Pesquera;70;44;26;2024
39;Cantabria;052;Piélagos;26783;13296;13487;2024
39;Cantabria;053;Polaciones;202;127;75;2024
39;Cantabria;054;Polanco;6239;3110;3129;2024
39;Cantabria;055;Potes;1353;639;714;2024
39;Cantabria;056;Puente Viesgo;2881;1467;1414;2024
39;Cantabria;057;Ramales de la Victoria;3061;1525;1536;2024
39;Cantabria;058;Rasines;970;507;463;2024
39;Cantabria;059;Reinosa;8566;4009;4557;2024
39;Cantabria;060;Reocín;8400;4154;4246;2024
39;Cantabria;061;Ribamontán al Mar;4615;2352;2263;2024
39;Cantabria;062;Ribamontán al Monte;2538;1281;1257;2024
39;Cantabria;063;Rionansa;1002;563;439;2024
39;Cantabria;064;Riotuerto;1675;804;871;2024
39;Cantabria;065;Rozas de Valdearroyo, Las;261;140;121;2024
39;Cantabria;066;Ruente;1072;580;492;2024
39;Cantabria;067;Ruesga;829;447;382;2024
39;Cantabria;068;Ruiloba;760;388;372;2024
39;Cantabria;069;San Felices de Buelna;2376;1190;1186;2024
39;Cantabria;070;San Miguel de Aguayo;168;85;83;2024
39;Cantabria;071;San Pedro del Romeral;432;238;194;2024
39;Cantabria;072;San Roque de Riomiera;342;204;138;2024
39;Cantabria;073;Santa Cruz de Bezana;13832;6784;7048;2024
39;Cantabria;074;Santa María de Cayón;9367;4675;4692;2024
39;Cantabria;075;Santander;174101;80127;93974;2024
39;Cantabria;076;Santillana del Mar;4211;2056;2155;2024
39;Cantabria;077;Santiurde de Reinosa;256;147;109;2024
39;Cantabria;078;Santiurde de Toranzo;1739;924;815;2024
39;Cantabria;079;Santoña;10916;5322;5594;2024
39;Cantabria;080;San Vicente de la Barquera;3992;1940;2052;2024
39;Cantabria;081;Saro;508;267;241;2024
39;Cantabria;082;Selaya;1846;932;914;2024
39;Cantabria;083;Soba;1076;611;465;2024
39;Cantabria;084;Solórzano;1115;591;524;2024
39;Cantabria;085;Suances;9092;4430;4662;2024
39;Cantabria;086;Tojos, Los;375;230;145;2024
39;Cantabria;087;Torrelavega;51663;24351;27312;2024
39;Cantabria;088;Tresviso;53;35;18;2024
39;Cantabria;089;Tudanca;157;108;49;2024
39;Cantabria;090;Udías;946;480;466;2024
39;Cantabria;091;Valdáliga;2152;1112;1040;2024
39;Cantabria;092;Valdeolea;884;484;400;2024
39;Cantabria;093;Valdeprado del Río;320;184;136;2024
39;Cantabria;094;Valderredible;931;531;400;2024
39;Cantabria;095;Val de San Vicente;2796;1440;1356;2024
39;Cantabria;096;Vega de Liébana;690;367;323;2024
39;Cantabria;097;Vega de Pas;768;411;357;2024
39;Cantabria;098;Villacarriedo;1685;873;812;2024
39;Cantabria;099;Villaescusa;3953;1973;1980;2024
39;Cantabria;100;Villafufre;1020;529;491;2024
39;Cantabria;101;Valle de Villaverde;252;145;107;2024
39;Cantabria;102;Voto;2945;1540;1405;2024
40;Segovia;001;Abades;859;422;437;2024
40;Segovia;002;Adrada de Pirón;40;22;18;2024
40;Segovia;003;Adrados;123;75;48;2024
40;Segovia;004;Aguilafuente;564;285;279;2024
40;Segovia;005;Alconada de Maderuelo;26;15;11;2024
40;Segovia;006;Aldealcorvo;18;10;8;2024
40;Segovia;007;Aldealengua de Pedraza;79;48;31;2024
40;Segovia;008;Aldealengua de Santa María;59;29;30;2024
40;Segovia;009;Aldeanueva de la Serrezuela;42;29;13;2024
40;Segovia;010;Aldeanueva del Codonal;108;59;49;2024
40;Segovia;012;Aldea Real;287;152;135;2024
40;Segovia;013;Aldeasoña;67;38;29;2024
40;Segovia;014;Aldehorno;59;34;25;2024
40;Segovia;015;Aldehuela del Codonal;24;12;12;2024
40;Segovia;016;Aldeonte;55;32;23;2024
40;Segovia;017;Anaya;119;59;60;2024
40;Segovia;018;Añe;66;40;26;2024
40;Segovia;019;Arahuetes;31;21;10;2024
40;Segovia;020;Arcones;180;92;88;2024
40;Segovia;021;Arevalillo de Cega;18;11;7;2024
40;Segovia;022;Armuña;241;137;104;2024
40;Segovia;024;Ayllón;1105;577;528;2024
40;Segovia;025;Barbolla;150;87;63;2024
40;Segovia;026;Basardilla;136;65;71;2024
40;Segovia;028;Bercial;105;55;50;2024
40;Segovia;029;Bercimuel;36;21;15;2024
40;Segovia;030;Bernardos;463;260;203;2024
40;Segovia;031;Bernuy de Porreros;1247;650;597;2024
40;Segovia;032;Boceguillas;721;367;354;2024
40;Segovia;033;Brieva;86;50;36;2024
40;Segovia;034;Caballar;75;44;31;2024
40;Segovia;035;Cabañas de Polendos;199;103;96;2024
40;Segovia;036;Cabezuela;656;350;306;2024
40;Segovia;037;Calabazas de Fuentidueña;25;17;8;2024
40;Segovia;039;Campo de San Pedro;259;144;115;2024
40;Segovia;040;Cantalejo;3558;1785;1773;2024
40;Segovia;041;Cantimpalos;1427;756;671;2024
40;Segovia;043;Carbonero el Mayor;2502;1286;1216;2024
40;Segovia;044;Carrascal del Río;136;77;59;2024
40;Segovia;045;Casla;155;81;74;2024
40;Segovia;046;Castillejo de Mesleón;110;62;48;2024
40;Segovia;047;Castro de Fuentidueña;48;30;18;2024
40;Segovia;048;Castrojimeno;31;16;15;2024
40;Segovia;049;Castroserna de Abajo;32;19;13;2024
40;Segovia;051;Castroserracín;24;14;10;2024
40;Segovia;052;Cedillo de la Torre;81;45;36;2024
40;Segovia;053;Cerezo de Abajo;145;83;62;2024
40;Segovia;054;Cerezo de Arriba;134;71;63;2024
40;Segovia;055;Cilleruelo de San Mamés;35;21;14;2024
40;Segovia;056;Cobos de Fuentidueña;28;13;15;2024
40;Segovia;057;Coca;1703;857;846;2024
40;Segovia;058;Codorniz;307;160;147;2024
40;Segovia;059;Collado Hermoso;118;64;54;2024
40;Segovia;060;Condado de Castilnovo;79;42;37;2024
40;Segovia;061;Corral de Ayllón;77;45;32;2024
40;Segovia;062;Cubillo;73;45;28;2024
40;Segovia;063;Cuéllar;9530;4801;4729;2024
40;Segovia;065;Chañe;741;370;371;2024
40;Segovia;068;Domingo García;32;19;13;2024
40;Segovia;069;Donhierro;75;40;35;2024
40;Segovia;070;Duruelo;171;106;65;2024
40;Segovia;071;Encinas;40;20;20;2024
40;Segovia;072;Encinillas;352;187;165;2024
40;Segovia;073;Escalona del Prado;468;250;218;2024
40;Segovia;074;Escarabajosa de Cabezas;276;149;127;2024
40;Segovia;075;Escobar de Polendos;166;93;73;2024
40;Segovia;076;Espinar, El;10145;5103;5042;2024
40;Segovia;077;Espirdo;1607;836;771;2024
40;Segovia;078;Fresneda de Cuéllar;170;99;71;2024
40;Segovia;079;Fresno de Cantespino;288;160;128;2024
40;Segovia;080;Fresno de la Fuente;77;45;32;2024
40;Segovia;081;Frumales;120;68;52;2024
40;Segovia;082;Fuente de Santa Cruz;99;55;44;2024
40;Segovia;083;Fuente el Olmo de Fuentidueña;395;89;306;2024
40;Segovia;084;Fuente el Olmo de Íscar;45;27;18;2024
40;Segovia;086;Fuentepelayo;772;393;379;2024
40;Segovia;087;Fuentepiñel;68;40;28;2024
40;Segovia;088;Fuenterrebollo;339;179;160;2024
40;Segovia;089;Fuentesaúco de Fuentidueña;223;122;101;2024
40;Segovia;091;Fuentesoto;100;60;40;2024
40;Segovia;092;Fuentidueña;133;77;56;2024
40;Segovia;093;Gallegos;93;51;42;2024
40;Segovia;094;Garcillán;515;275;240;2024
40;Segovia;095;Gomezserracín;625;322;303;2024
40;Segovia;097;Grajera;256;144;112;2024
40;Segovia;099;Honrubia de la Cuesta;49;29;20;2024
40;Segovia;100;Hontalbilla;299;168;131;2024
40;Segovia;101;Hontanares de Eresma;1662;854;808;2024
40;Segovia;103;Huertos, Los;170;90;80;2024
40;Segovia;104;Ituero y Lama;448;235;213;2024
40;Segovia;105;Juarros de Riomoros;45;28;17;2024
40;Segovia;106;Juarros de Voltoya;184;94;90;2024
40;Segovia;107;Labajos;106;59;47;2024
40;Segovia;108;Laguna de Contreras;115;68;47;2024
40;Segovia;109;Languilla;84;50;34;2024
40;Segovia;110;Lastras de Cuéllar;307;169;138;2024
40;Segovia;111;Lastras del Pozo;64;33;31;2024
40;Segovia;112;Lastrilla, La;4697;2356;2341;2024
40;Segovia;113;Losa, La;531;290;241;2024
40;Segovia;115;Maderuelo;101;58;43;2024
40;Segovia;118;Marazuela;53;32;21;2024
40;Segovia;119;Martín Miguel;263;156;107;2024
40;Segovia;120;Martín Muñoz de la Dehesa;307;163;144;2024
40;Segovia;121;Martín Muñoz de las Posadas;249;142;107;2024
40;Segovia;122;Marugán;763;408;355;2024
40;Segovia;123;Matabuena;207;113;94;2024
40;Segovia;124;Mata de Cuéllar;263;139;124;2024
40;Segovia;125;Matilla, La;71;43;28;2024
40;Segovia;126;Melque de Cercos;65;39;26;2024
40;Segovia;127;Membibre de la Hoz;43;24;19;2024
40;Segovia;128;Migueláñez;138;74;64;2024
40;Segovia;129;Montejo de Arévalo;161;90;71;2024
40;Segovia;130;Montejo de la Vega de la Serrezuela;124;76;48;2024
40;Segovia;131;Monterrubio;56;30;26;2024
40;Segovia;132;Moral de Hornuez;40;25;15;2024
40;Segovia;134;Mozoncillo;907;500;407;2024
40;Segovia;135;Muñopedro;309;160;149;2024
40;Segovia;136;Muñoveros;145;72;73;2024
40;Segovia;138;Nava de la Asunción;2787;1417;1370;2024
40;Segovia;139;Navafría;279;151;128;2024
40;Segovia;140;Navalilla;97;50;47;2024
40;Segovia;141;Navalmanzano;1044;557;487;2024
40;Segovia;142;Navares de Ayuso;53;29;24;2024
40;Segovia;143;Navares de Enmedio;92;50;42;2024
40;Segovia;144;Navares de las Cuevas;25;15;10;2024
40;Segovia;145;Navas de Oro;1274;658;616;2024
40;Segovia;146;Navas de San Antonio;366;203;163;2024
40;Segovia;148;Nieva;256;129;127;2024
40;Segovia;149;Olombrada;503;274;229;2024
40;Segovia;150;Orejana;62;35;27;2024
40;Segovia;151;Ortigosa de Pestaño;53;27;26;2024
40;Segovia;152;Otero de Herreros;966;500;466;2024
40;Segovia;154;Pajarejos;24;14;10;2024
40;Segovia;155;Palazuelos de Eresma;5968;3098;2870;2024
40;Segovia;156;Pedraza;349;199;150;2024
40;Segovia;157;Pelayos del Arroyo;48;27;21;2024
40;Segovia;158;Perosillo;20;12;8;2024
40;Segovia;159;Pinarejos;194;110;84;2024
40;Segovia;160;Pinarnegrillo;96;55;41;2024
40;Segovia;161;Carabias;54;38;16;2024
40;Segovia;162;Prádena;468;248;220;2024
40;Segovia;163;Puebla de Pedraza;51;29;22;2024
40;Segovia;164;Rapariegos;194;109;85;2024
40;Segovia;165;Rebollo;74;37;37;2024
40;Segovia;166;Remondo;316;154;162;2024
40;Segovia;168;Riaguas de San Bartolomé;27;16;11;2024
40;Segovia;170;Riaza;2144;1142;1002;2024
40;Segovia;171;Ribota;43;30;13;2024
40;Segovia;172;Riofrío de Riaza;27;17;10;2024
40;Segovia;173;Roda de Eresma;253;136;117;2024
40;Segovia;174;Sacramenia;330;165;165;2024
40;Segovia;176;Samboal;461;248;213;2024
40;Segovia;177;San Cristóbal de Cuéllar;154;88;66;2024
40;Segovia;178;San Cristóbal de la Vega;83;44;39;2024
40;Segovia;179;Sanchonuño;1027;511;516;2024
40;Segovia;180;Sangarcía;279;150;129;2024
40;Segovia;181;Real Sitio de San Ildefonso;5205;2549;2656;2024
40;Segovia;182;San Martín y Mudrián;251;120;131;2024
40;Segovia;183;San Miguel de Bernuy;134;63;71;2024
40;Segovia;184;San Pedro de Gaíllos;311;158;153;2024
40;Segovia;185;Santa María la Real de Nieva;885;497;388;2024
40;Segovia;186;Santa Marta del Cerro;49;26;23;2024
40;Segovia;188;Santiuste de Pedraza;85;54;31;2024
40;Segovia;189;Santiuste de San Juan Bautista;535;291;244;2024
40;Segovia;190;Santo Domingo de Pirón;51;28;23;2024
40;Segovia;191;Santo Tomé del Puerto;234;133;101;2024
40;Segovia;192;Sauquillo de Cabezas;137;78;59;2024
40;Segovia;193;Sebúlcor;241;130;111;2024
40;Segovia;194;Segovia;51525;24105;27420;2024
40;Segovia;195;Sepúlveda;988;491;497;2024
40;Segovia;196;Sequera de Fresno;47;29;18;2024
40;Segovia;198;Sotillo;30;16;14;2024
40;Segovia;199;Sotosalbos;135;76;59;2024
40;Segovia;200;Tabanera la Luenga;53;27;26;2024
40;Segovia;201;Tolocirio;36;15;21;2024
40;Segovia;202;Torreadrada;50;26;24;2024
40;Segovia;203;Torrecaballeros;1496;768;728;2024
40;Segovia;204;Torrecilla del Pinar;179;100;79;2024
40;Segovia;205;Torreiglesias;256;128;128;2024
40;Segovia;206;Torre Val de San Pedro;180;100;80;2024
40;Segovia;207;Trescasas;1105;574;531;2024
40;Segovia;208;Turégano;1017;519;498;2024
40;Segovia;210;Urueñas;98;67;31;2024
40;Segovia;211;Valdeprados;60;32;28;2024
40;Segovia;212;Valdevacas de Montejo;29;16;13;2024
40;Segovia;213;Valdevacas y Guijar;80;43;37;2024
40;Segovia;214;Valseca;218;119;99;2024
40;Segovia;215;Valtiendas;77;48;29;2024
40;Segovia;216;Valverde del Majano;1126;561;565;2024
40;Segovia;218;Valle de Tabladillo;74;46;28;2024
40;Segovia;219;Vallelado;728;379;349;2024
40;Segovia;220;Valleruela de Pedraza;65;31;34;2024
40;Segovia;221;Valleruela de Sepúlveda;52;24;28;2024
40;Segovia;222;Veganzones;197;104;93;2024
40;Segovia;223;Vegas de Matute;339;202;137;2024
40;Segovia;224;Ventosilla y Tejadilla;17;12;5;2024
40;Segovia;225;Villacastín;1525;780;745;2024
40;Segovia;228;Villaverde de Íscar;593;306;287;2024
40;Segovia;229;Villaverde de Montejo;21;13;8;2024
40;Segovia;230;Villeguillo;120;63;57;2024
40;Segovia;231;Yanguas de Eresma;117;65;52;2024
40;Segovia;233;Zarzuela del Monte;498;255;243;2024
40;Segovia;234;Zarzuela del Pinar;408;213;195;2024
40;Segovia;901;Ortigosa del Monte;587;293;294;2024
40;Segovia;902;Cozuelos de Fuentidueña;105;57;48;2024
40;Segovia;903;Marazoleja;96;64;32;2024
40;Segovia;904;Navas de Riofrío;439;205;234;2024
40;Segovia;905;Cuevas de Provanco;132;75;57;2024
40;Segovia;906;San Cristóbal de Segovia;3153;1593;1560;2024
41;Sevilla;001;Aguadulce;2042;1009;1033;2024
41;Sevilla;002;Alanís;1673;826;847;2024
41;Sevilla;003;Albaida del Aljarafe;3223;1579;1644;2024
41;Sevilla;004;Alcalá de Guadaíra;76922;38146;38776;2024
41;Sevilla;005;Alcalá del Río;12250;6207;6043;2024
41;Sevilla;006;Alcolea del Río;3279;1640;1639;2024
41;Sevilla;007;Algaba, La;16666;8198;8468;2024
41;Sevilla;008;Algámitas;1241;650;591;2024
41;Sevilla;009;Almadén de la Plata;1328;689;639;2024
41;Sevilla;010;Almensilla;6653;3309;3344;2024
41;Sevilla;011;Arahal;19417;9628;9789;2024
41;Sevilla;012;Aznalcázar;4886;2477;2409;2024
41;Sevilla;013;Aznalcóllar;6079;3082;2997;2024
41;Sevilla;014;Badolatosa;3078;1583;1495;2024
41;Sevilla;015;Benacazón;7358;3684;3674;2024
41;Sevilla;016;Bollullos de la Mitación;11251;5607;5644;2024
41;Sevilla;017;Bormujos;22970;11353;11617;2024
41;Sevilla;018;Brenes;12883;6403;6480;2024
41;Sevilla;019;Burguillos;7327;3701;3626;2024
41;Sevilla;020;Cabezas de San Juan, Las;16410;8144;8266;2024
41;Sevilla;021;Camas;28705;14129;14576;2024
41;Sevilla;022;Campana, La;5132;2562;2570;2024
41;Sevilla;023;Cantillana;10728;5394;5334;2024
41;Sevilla;024;Carmona;29871;15106;14765;2024
41;Sevilla;025;Carrión de los Céspedes;2617;1274;1343;2024
41;Sevilla;026;Casariche;5307;2715;2592;2024
41;Sevilla;027;Castilblanco de los Arroyos;5134;2594;2540;2024
41;Sevilla;028;Castilleja de Guzmán;2863;1477;1386;2024
41;Sevilla;029;Castilleja de la Cuesta;17153;8292;8861;2024
41;Sevilla;030;Castilleja del Campo;612;304;308;2024
41;Sevilla;031;Castillo de las Guardas, El;1511;795;716;2024
41;Sevilla;032;Cazalla de la Sierra;4629;2288;2341;2024
41;Sevilla;033;Constantina;5742;2855;2887;2024
41;Sevilla;034;Coria del Río;31095;15344;15751;2024
41;Sevilla;035;Coripe;1198;588;610;2024
41;Sevilla;036;Coronil, El;4697;2371;2326;2024
41;Sevilla;037;Corrales, Los;3970;2012;1958;2024
41;Sevilla;038;Dos Hermanas;140430;68745;71685;2024
41;Sevilla;039;Écija;39500;19421;20079;2024
41;Sevilla;040;Espartinas;16482;8235;8247;2024
41;Sevilla;041;Estepa;12394;6117;6277;2024
41;Sevilla;042;Fuentes de Andalucía;7247;3594;3653;2024
41;Sevilla;043;Garrobo, El;812;417;395;2024
41;Sevilla;044;Gelves;10473;5168;5305;2024
41;Sevilla;045;Gerena;7923;3921;4002;2024
41;Sevilla;046;Gilena;3658;1852;1806;2024
41;Sevilla;047;Gines;13524;6609;6915;2024
41;Sevilla;048;Guadalcanal;2522;1263;1259;2024
41;Sevilla;049;Guillena;14064;7129;6935;2024
41;Sevilla;050;Herrera;6566;3265;3301;2024
41;Sevilla;051;Huévar del Aljarafe;3360;1726;1634;2024
41;Sevilla;052;Lantejuela;3861;1981;1880;2024
41;Sevilla;053;Lebrija;27745;13812;13933;2024
41;Sevilla;054;Lora de Estepa;888;468;420;2024
41;Sevilla;055;Lora del Río;18189;8934;9255;2024
41;Sevilla;056;Luisiana, La;4626;2313;2313;2024
41;Sevilla;057;Madroño, El;305;153;152;2024
41;Sevilla;058;Mairena del Alcor;24238;12109;12129;2024
41;Sevilla;059;Mairena del Aljarafe;47898;23210;24688;2024
41;Sevilla;060;Marchena;19382;9563;9819;2024
41;Sevilla;061;Marinaleda;2555;1291;1264;2024
41;Sevilla;062;Martín de la Jara;2643;1362;1281;2024
41;Sevilla;063;Molares, Los;3636;1856;1780;2024
41;Sevilla;064;Montellano;7031;3509;3522;2024
41;Sevilla;065;Morón de la Frontera;27228;13380;13848;2024
41;Sevilla;066;Navas de la Concepción, Las;1520;753;767;2024
41;Sevilla;067;Olivares;9504;4770;4734;2024
41;Sevilla;068;Osuna;17374;8611;8763;2024
41;Sevilla;069;Palacios y Villafranca, Los;38757;19269;19488;2024
41;Sevilla;070;Palomares del Río;9277;4635;4642;2024
41;Sevilla;071;Paradas;6779;3388;3391;2024
41;Sevilla;072;Pedrera;5085;2507;2578;2024
41;Sevilla;073;Pedroso, El;2074;1036;1038;2024
41;Sevilla;074;Peñaflor;3670;1845;1825;2024
41;Sevilla;075;Pilas;14105;7049;7056;2024
41;Sevilla;076;Pruna;2509;1277;1232;2024
41;Sevilla;077;Puebla de Cazalla, La;10799;5383;5416;2024
41;Sevilla;078;Puebla de los Infantes, La;2927;1425;1502;2024
41;Sevilla;079;Puebla del Río, La;11871;5831;6040;2024
41;Sevilla;080;Real de la Jara, El;1531;762;769;2024
41;Sevilla;081;Rinconada, La;40529;20145;20384;2024
41;Sevilla;082;Roda de Andalucía, La;4180;2064;2116;2024
41;Sevilla;083;Ronquillo, El;1439;732;707;2024
41;Sevilla;084;Rubio, El;3290;1645;1645;2024
41;Sevilla;085;Salteras;5580;2717;2863;2024
41;Sevilla;086;San Juan de Aznalfarache;23090;11127;11963;2024
41;Sevilla;087;Sanlúcar la Mayor;14375;7063;7312;2024
41;Sevilla;088;San Nicolás del Puerto;600;308;292;2024
41;Sevilla;089;Santiponce;8625;4235;4390;2024
41;Sevilla;090;Saucejo, El;4213;2089;2124;2024
41;Sevilla;091;Sevilla;687488;325795;361693;2024
41;Sevilla;092;Tocina;9373;4630;4743;2024
41;Sevilla;093;Tomares;25488;12533;12955;2024
41;Sevilla;094;Umbrete;9394;4658;4736;2024
41;Sevilla;095;Utrera;52173;25731;26442;2024
41;Sevilla;096;Valencina de la Concepción;8080;3950;4130;2024
41;Sevilla;097;Villamanrique de la Condesa;4677;2287;2390;2024
41;Sevilla;098;Villanueva del Ariscal;6938;3358;3580;2024
41;Sevilla;099;Villanueva del Río y Minas;5033;2559;2474;2024
41;Sevilla;100;Villanueva de San Juan;1002;505;497;2024
41;Sevilla;101;Villaverde del Río;7794;3934;3860;2024
41;Sevilla;102;Viso del Alcor, El;19310;9572;9738;2024
41;Sevilla;901;Cañada Rosal;3410;1684;1726;2024
41;Sevilla;902;Isla Mayor;5781;2881;2900;2024
41;Sevilla;903;Cuervo de Sevilla, El;8716;4394;4322;2024
41;Sevilla;904;Palmar de Troya, El;2306;1146;1160;2024
42;Soria;001;Abejar;386;199;187;2024
42;Soria;003;Adradas;58;33;25;2024
42;Soria;004;Ágreda;3094;1594;1500;2024
42;Soria;006;Alconaba;199;132;67;2024
42;Soria;007;Alcubilla de Avellaneda;107;63;44;2024
42;Soria;008;Alcubilla de las Peñas;59;38;21;2024
42;Soria;009;Aldealafuente;83;45;38;2024
42;Soria;010;Aldealices;20;14;6;2024
42;Soria;011;Aldealpozo;18;7;11;2024
42;Soria;012;Aldealseñor;28;15;13;2024
42;Soria;013;Aldehuela de Periáñez;30;19;11;2024
42;Soria;014;Aldehuelas, Las;60;36;24;2024
42;Soria;015;Alentisque;24;16;8;2024
42;Soria;016;Aliud;21;14;7;2024
42;Soria;017;Almajano;182;98;84;2024
42;Soria;018;Almaluez;124;74;50;2024
42;Soria;019;Almarza;626;347;279;2024
42;Soria;020;Almazán;5476;2811;2665;2024
42;Soria;021;Almazul;60;41;19;2024
42;Soria;022;Almenar de Soria;216;134;82;2024
42;Soria;023;Alpanseque;51;32;19;2024
42;Soria;024;Arancón;76;51;25;2024
42;Soria;025;Arcos de Jalón;1545;787;758;2024
42;Soria;026;Arenillas;42;27;15;2024
42;Soria;027;Arévalo de la Sierra;70;44;26;2024
42;Soria;028;Ausejo de la Sierra;115;60;55;2024
42;Soria;029;Baraona;122;73;49;2024
42;Soria;030;Barca;107;67;40;2024
42;Soria;031;Barcones;25;15;10;2024
42;Soria;032;Bayubas de Abajo;144;75;69;2024
42;Soria;033;Bayubas de Arriba;60;35;25;2024
42;Soria;034;Beratón;41;20;21;2024
42;Soria;035;Berlanga de Duero;831;432;399;2024
42;Soria;036;Blacos;38;18;20;2024
42;Soria;037;Bliecos;26;16;10;2024
42;Soria;038;Borjabad;30;17;13;2024
42;Soria;039;Borobia;228;129;99;2024
42;Soria;041;Buberos;28;14;14;2024
42;Soria;042;Buitrago;74;39;35;2024
42;Soria;043;Burgo de Osma-Ciudad de Osma;5204;2604;2600;2024
42;Soria;044;Cabrejas del Campo;53;31;22;2024
42;Soria;045;Cabrejas del Pinar;299;172;127;2024
42;Soria;046;Calatañazor;43;25;18;2024
42;Soria;048;Caltojar;51;35;16;2024
42;Soria;049;Candilichera;104;66;38;2024
42;Soria;050;Cañamaque;27;20;7;2024
42;Soria;051;Carabantes;22;14;8;2024
42;Soria;052;Caracena;14;9;5;2024
42;Soria;053;Carrascosa de Abajo;18;12;6;2024
42;Soria;054;Carrascosa de la Sierra;19;14;5;2024
42;Soria;055;Casarejos;146;77;69;2024
42;Soria;056;Castilfrío de la Sierra;34;20;14;2024
42;Soria;057;Castilruiz;158;90;68;2024
42;Soria;058;Castillejo de Robledo;95;56;39;2024
42;Soria;059;Centenera de Andaluz;21;10;11;2024
42;Soria;060;Cerbón;30;21;9;2024
42;Soria;061;Cidones;314;188;126;2024
42;Soria;062;Cigudosa;15;12;3;2024
42;Soria;063;Cihuela;39;26;13;2024
42;Soria;064;Ciria;70;38;32;2024
42;Soria;065;Cirujales del Río;20;15;5;2024
42;Soria;068;Coscurita;68;43;25;2024
42;Soria;069;Covaleda;1574;816;758;2024
42;Soria;070;Cubilla;24;14;10;2024
42;Soria;071;Cubo de la Solana;163;95;68;2024
42;Soria;073;Cueva de Ágreda;69;43;26;2024
42;Soria;075;Dévanos;72;43;29;2024
42;Soria;076;Deza;165;94;71;2024
42;Soria;078;Duruelo de la Sierra;1026;522;504;2024
42;Soria;079;Escobosa de Almazán;20;12;8;2024
42;Soria;080;Espeja de San Marcelino;151;89;62;2024
42;Soria;081;Espejón;128;67;61;2024
42;Soria;082;Estepa de San Juan;13;8;5;2024
42;Soria;083;Frechilla de Almazán;21;11;10;2024
42;Soria;084;Fresno de Caracena;19;12;7;2024
42;Soria;085;Fuentearmegil;150;88;62;2024
42;Soria;086;Fuentecambrón;32;19;13;2024
42;Soria;087;Fuentecantos;65;33;32;2024
42;Soria;088;Fuentelmonge;61;36;25;2024
42;Soria;089;Fuentelsaz de Soria;64;31;33;2024
42;Soria;090;Fuentepinilla;78;47;31;2024
42;Soria;092;Fuentes de Magaña;51;32;19;2024
42;Soria;093;Fuentestrún;52;36;16;2024
42;Soria;094;Garray;785;420;365;2024
42;Soria;095;Golmayo;3059;1589;1470;2024
42;Soria;096;Gómara;288;168;120;2024
42;Soria;097;Gormaz;26;19;7;2024
42;Soria;098;Herrera de Soria;11;8;3;2024
42;Soria;100;Hinojosa del Campo;25;17;8;2024
42;Soria;103;Langa de Duero;716;385;331;2024
42;Soria;105;Liceras;49;26;23;2024
42;Soria;106;Losilla, La;13;9;4;2024
42;Soria;107;Magaña;64;41;23;2024
42;Soria;108;Maján;9;6;3;2024
42;Soria;110;Matalebreras;81;53;28;2024
42;Soria;111;Matamala de Almazán;254;143;111;2024
42;Soria;113;Medinaceli;671;350;321;2024
42;Soria;115;Miño de Medinaceli;78;48;30;2024
42;Soria;116;Miño de San Esteban;40;26;14;2024
42;Soria;117;Molinos de Duero;158;90;68;2024
42;Soria;118;Momblona;18;15;3;2024
42;Soria;119;Monteagudo de las Vicarías;177;92;85;2024
42;Soria;120;Montejo de Tiermes;140;88;52;2024
42;Soria;121;Montenegro de Cameros;45;30;15;2024
42;Soria;123;Morón de Almazán;202;104;98;2024
42;Soria;124;Muriel de la Fuente;55;36;19;2024
42;Soria;125;Muriel Viejo;75;49;26;2024
42;Soria;127;Nafría de Ucero;36;21;15;2024
42;Soria;128;Narros;71;44;27;2024
42;Soria;129;Navaleno;732;389;343;2024
42;Soria;130;Nepas;50;36;14;2024
42;Soria;131;Nolay;48;27;21;2024
42;Soria;132;Noviercas;172;94;78;2024
42;Soria;134;Ólvega;3838;2034;1804;2024
42;Soria;135;Oncala;61;40;21;2024
42;Soria;139;Pinilla del Campo;18;10;8;2024
42;Soria;140;Portillo de Soria;12;10;2;2024
42;Soria;141;Póveda de Soria, La;110;67;43;2024
42;Soria;142;Pozalmuro;46;23;23;2024
42;Soria;144;Quintana Redonda;512;297;215;2024
42;Soria;145;Quintanas de Gormaz;127;76;51;2024
42;Soria;148;Quiñonería;10;6;4;2024
42;Soria;149;Rábanos, Los;476;262;214;2024
42;Soria;151;Rebollar;36;19;17;2024
42;Soria;152;Recuerda;62;39;23;2024
42;Soria;153;Rello;20;13;7;2024
42;Soria;154;Renieblas;110;72;38;2024
42;Soria;155;Retortillo de Soria;130;79;51;2024
42;Soria;156;Reznos;22;14;8;2024
42;Soria;157;Riba de Escalote, La;8;5;3;2024
42;Soria;158;Rioseco de Soria;123;74;49;2024
42;Soria;159;Rollamienta;44;29;15;2024
42;Soria;160;Royo, El;251;136;115;2024
42;Soria;161;Salduero;145;82;63;2024
42;Soria;162;San Esteban de Gormaz;2935;1549;1386;2024
42;Soria;163;San Felices;59;36;23;2024
42;Soria;164;San Leonardo de Yagüe;1949;999;950;2024
42;Soria;165;San Pedro Manrique;619;352;267;2024
42;Soria;166;Santa Cruz de Yanguas;56;33;23;2024
42;Soria;167;Santa María de Huerta;242;135;107;2024
42;Soria;168;Santa María de las Hoyas;113;64;49;2024
42;Soria;171;Serón de Nágima;122;67;55;2024
42;Soria;172;Soliedra;33;18;15;2024
42;Soria;173;Soria;40750;19238;21512;2024
42;Soria;174;Sotillo del Rincón;175;103;72;2024
42;Soria;175;Suellacabras;33;17;16;2024
42;Soria;176;Tajahuerce;23;12;11;2024
42;Soria;177;Tajueco;57;35;22;2024
42;Soria;178;Talveila;101;66;35;2024
42;Soria;181;Tardelcuende;424;224;200;2024
42;Soria;182;Taroda;46;25;21;2024
42;Soria;183;Tejado;96;57;39;2024
42;Soria;184;Torlengua;45;30;15;2024
42;Soria;185;Torreblacos;26;14;12;2024
42;Soria;187;Torrubia de Soria;56;39;17;2024
42;Soria;188;Trévago;47;24;23;2024
42;Soria;189;Ucero;91;52;39;2024
42;Soria;190;Vadillo;83;46;37;2024
42;Soria;191;Valdeavellano de Tera;218;119;99;2024
42;Soria;192;Valdegeña;37;27;10;2024
42;Soria;193;Valdelagua del Cerro;13;8;5;2024
42;Soria;194;Valdemaluque;137;69;68;2024
42;Soria;195;Valdenebro;94;55;39;2024
42;Soria;196;Valdeprado;8;3;5;2024
42;Soria;197;Valderrodilla;62;35;27;2024
42;Soria;198;Valtajeros;19;13;6;2024
42;Soria;200;Velamazán;67;48;19;2024
42;Soria;201;Velilla de la Sierra;27;17;10;2024
42;Soria;202;Velilla de los Ajos;15;10;5;2024
42;Soria;204;Viana de Duero;49;37;12;2024
42;Soria;205;Villaciervos;86;51;35;2024
42;Soria;206;Villanueva de Gormaz;8;5;3;2024
42;Soria;207;Villar del Ala;50;25;25;2024
42;Soria;208;Villar del Campo;30;17;13;2024
42;Soria;209;Villar del Río;156;95;61;2024
42;Soria;211;Villares de Soria, Los;75;42;33;2024
42;Soria;212;Villasayas;60;41;19;2024
42;Soria;213;Villaseca de Arciel;24;15;9;2024
42;Soria;215;Vinuesa;833;433;400;2024
42;Soria;216;Vizmanos;30;19;11;2024
42;Soria;217;Vozmediano;33;22;11;2024
42;Soria;218;Yanguas;106;63;43;2024
42;Soria;219;Yelo;37;22;15;2024
43;Tarragona;001;Aiguamúrcia;957;502;455;2024
43;Tarragona;002;Albinyana;2677;1380;1297;2024
43;Tarragona;003;Albiol, L';537;285;252;2024
43;Tarragona;004;Alcanar;9943;5024;4919;2024
43;Tarragona;005;Alcover;5348;2658;2690;2024
43;Tarragona;006;Aldover;880;451;429;2024
43;Tarragona;007;Aleixar, L';962;494;468;2024
43;Tarragona;008;Alfara de Carles;361;186;175;2024
43;Tarragona;009;Alforja;2019;1022;997;2024
43;Tarragona;010;Alió;504;245;259;2024
43;Tarragona;011;Almoster;1338;674;664;2024
43;Tarragona;012;Altafulla;5838;2808;3030;2024
43;Tarragona;013;Ametlla de Mar, L';7373;3764;3609;2024
43;Tarragona;014;Amposta;22637;11529;11108;2024
43;Tarragona;015;Arbolí;129;76;53;2024
43;Tarragona;016;Arboç, L';5758;2928;2830;2024
43;Tarragona;017;Argentera, L';129;75;54;2024
43;Tarragona;018;Arnes;463;232;231;2024
43;Tarragona;019;Ascó;1608;827;781;2024
43;Tarragona;020;Banyeres del Penedès;3347;1671;1676;2024
43;Tarragona;021;Barberà de la Conca;471;257;214;2024
43;Tarragona;022;Batea;1877;933;944;2024
43;Tarragona;023;Bellmunt del Priorat;298;157;141;2024
43;Tarragona;024;Bellvei;2417;1248;1169;2024
43;Tarragona;025;Benifallet;718;350;368;2024
43;Tarragona;026;Benissanet;1186;654;532;2024
43;Tarragona;027;Bisbal de Falset, La;208;118;90;2024
43;Tarragona;028;Bisbal del Penedès, La;4168;2168;2000;2024
43;Tarragona;029;Blancafort;393;199;194;2024
43;Tarragona;030;Bonastre;760;405;355;2024
43;Tarragona;031;Borges del Camp, Les;2260;1164;1096;2024
43;Tarragona;032;Bot;554;276;278;2024
43;Tarragona;033;Botarell;1174;609;565;2024
43;Tarragona;034;Bràfim;696;347;349;2024
43;Tarragona;035;Cabacés;302;167;135;2024
43;Tarragona;036;Cabra del Camp;1321;701;620;2024
43;Tarragona;037;Calafell;31828;15860;15968;2024
43;Tarragona;038;Cambrils;36849;17939;18910;2024
43;Tarragona;039;Capafonts;106;59;47;2024
43;Tarragona;040;Capçanes;428;215;213;2024
43;Tarragona;041;Caseres;240;117;123;2024
43;Tarragona;042;Castellvell del Camp;2995;1502;1493;2024
43;Tarragona;043;Catllar, El;5218;2722;2496;2024
43;Tarragona;044;Sénia, La;5594;2817;2777;2024
43;Tarragona;045;Colldejou;160;91;69;2024
43;Tarragona;046;Conesa;113;59;54;2024
43;Tarragona;047;Constantí;6888;3507;3381;2024
43;Tarragona;048;Corbera d'Ebre;1019;538;481;2024
43;Tarragona;049;Cornudella de Montsant;1023;542;481;2024
43;Tarragona;050;Creixell;4190;2087;2103;2024
43;Tarragona;051;Cunit;15804;7796;8008;2024
43;Tarragona;052;Xerta;1156;571;585;2024
43;Tarragona;053;Duesaigües;222;121;101;2024
43;Tarragona;054;Espluga de Francolí, L';3817;1880;1937;2024
43;Tarragona;055;Falset;2856;1476;1380;2024
43;Tarragona;056;Fatarella, La;852;425;427;2024
43;Tarragona;057;Febró, La;36;22;14;2024
43;Tarragona;058;Figuera, La;122;68;54;2024
43;Tarragona;059;Figuerola del Camp;345;170;175;2024
43;Tarragona;060;Flix;3324;1684;1640;2024
43;Tarragona;061;Forès;40;25;15;2024
43;Tarragona;062;Freginals;424;233;191;2024
43;Tarragona;063;Galera, La;708;361;347;2024
43;Tarragona;064;Gandesa;3166;1594;1572;2024
43;Tarragona;065;Garcia;543;273;270;2024
43;Tarragona;066;Garidells, Els;202;98;104;2024
43;Tarragona;067;Ginestar;794;414;380;2024
43;Tarragona;068;Godall;612;304;308;2024
43;Tarragona;069;Gratallops;229;126;103;2024
43;Tarragona;070;Guiamets, Els;258;130;128;2024
43;Tarragona;071;Horta de Sant Joan;1157;599;558;2024
43;Tarragona;072;Lloar, El;101;52;49;2024
43;Tarragona;073;Llorac;101;55;46;2024
43;Tarragona;074;Llorenç del Penedès;2431;1208;1223;2024
43;Tarragona;075;Margalef;106;64;42;2024
43;Tarragona;076;Marçà;598;320;278;2024
43;Tarragona;077;Mas de Barberans;547;276;271;2024
43;Tarragona;078;Masdenverge;1149;617;532;2024
43;Tarragona;079;Masllorenç;573;317;256;2024
43;Tarragona;080;Masó, La;288;149;139;2024
43;Tarragona;081;Maspujols;889;462;427;2024
43;Tarragona;082;Masroig, El;480;265;215;2024
43;Tarragona;083;Milà, El;197;99;98;2024
43;Tarragona;084;Miravet;688;363;325;2024
43;Tarragona;085;Molar, El;307;151;156;2024
43;Tarragona;086;Montblanc;7550;3863;3687;2024
43;Tarragona;088;Montbrió del Camp;3128;1611;1517;2024
43;Tarragona;089;Montferri;473;251;222;2024
43;Tarragona;090;Montmell, El;1917;1031;886;2024
43;Tarragona;091;Mont-ral;184;99;85;2024
43;Tarragona;092;Mont-roig del Camp;14114;7260;6854;2024
43;Tarragona;093;Móra d'Ebre;5726;2897;2829;2024
43;Tarragona;094;Móra la Nova;3314;1661;1653;2024
43;Tarragona;095;Morell, El;3878;1992;1886;2024
43;Tarragona;096;Morera de Montsant, La;138;81;57;2024
43;Tarragona;097;Nou de Gaià, La;611;303;308;2024
43;Tarragona;098;Nulles;552;288;264;2024
43;Tarragona;099;Palma d'Ebre, La;335;163;172;2024
43;Tarragona;100;Pallaresos, Els;5006;2527;2479;2024
43;Tarragona;101;Passanant i Belltall;162;99;63;2024
43;Tarragona;102;Paüls;544;274;270;2024
43;Tarragona;103;Perafort;1308;674;634;2024
43;Tarragona;104;Perelló, El;2907;1499;1408;2024
43;Tarragona;105;Piles, Les;229;128;101;2024
43;Tarragona;106;Pinell de Brai, El;979;487;492;2024
43;Tarragona;107;Pira;498;266;232;2024
43;Tarragona;108;Pla de Santa Maria, El;2389;1242;1147;2024
43;Tarragona;109;Pobla de Mafumet, La;4115;2081;2034;2024
43;Tarragona;110;Pobla de Massaluca, La;344;191;153;2024
43;Tarragona;111;Pobla de Montornès, La;3329;1715;1614;2024
43;Tarragona;112;Poboleda;334;170;164;2024
43;Tarragona;113;Pont d'Armentera, El;498;244;254;2024
43;Tarragona;114;Porrera;417;215;202;2024
43;Tarragona;115;Pradell de la Teixeta;178;92;86;2024
43;Tarragona;116;Prades;665;354;311;2024
43;Tarragona;117;Prat de Comte;185;97;88;2024
43;Tarragona;118;Pratdip;759;394;365;2024
43;Tarragona;119;Puigpelat;1205;627;578;2024
43;Tarragona;120;Querol;591;334;257;2024
43;Tarragona;121;Rasquera;792;394;398;2024
43;Tarragona;122;Renau;158;80;78;2024
43;Tarragona;123;Reus;109930;53449;56481;2024
43;Tarragona;124;Riba, La;569;316;253;2024
43;Tarragona;125;Riba-roja d'Ebre;1128;603;525;2024
43;Tarragona;126;Riera de Gaià, La;1807;893;914;2024
43;Tarragona;127;Riudecanyes;1345;712;633;2024
43;Tarragona;128;Riudecols;1232;629;603;2024
43;Tarragona;129;Riudoms;6905;3516;3389;2024
43;Tarragona;130;Rocafort de Queralt;246;132;114;2024
43;Tarragona;131;Roda de Berà;8048;4074;3974;2024
43;Tarragona;132;Rodonyà;521;285;236;2024
43;Tarragona;133;Roquetes;8369;4318;4051;2024
43;Tarragona;134;Rourell, El;403;204;199;2024
43;Tarragona;135;Salomó;525;277;248;2024
43;Tarragona;136;Ràpita, La;15683;7690;7993;2024
43;Tarragona;137;Sant Jaume dels Domenys;2803;1432;1371;2024
43;Tarragona;138;Santa Bàrbara;3827;1940;1887;2024
43;Tarragona;139;Santa Coloma de Queralt;2800;1411;1389;2024
43;Tarragona;140;Santa Oliva;3672;1867;1805;2024
43;Tarragona;141;Pontils;123;68;55;2024
43;Tarragona;142;Sarral;1583;806;777;2024
43;Tarragona;143;Savallà del Comtat;50;28;22;2024
43;Tarragona;144;Secuita, La;1828;931;897;2024
43;Tarragona;145;Selva del Camp, La;5819;2894;2925;2024
43;Tarragona;146;Senan;46;29;17;2024
43;Tarragona;147;Solivella;626;333;293;2024
43;Tarragona;148;Tarragona;141151;68775;72376;2024
43;Tarragona;149;Tivenys;936;489;447;2024
43;Tarragona;150;Tivissa;1632;824;808;2024
43;Tarragona;151;Torre de Fontaubella, La;119;64;55;2024
43;Tarragona;152;Torre de l'Espanyol, La;631;327;304;2024
43;Tarragona;153;Torredembarra;17984;8763;9221;2024
43;Tarragona;154;Torroja del Priorat;137;71;66;2024
43;Tarragona;155;Tortosa;35265;17724;17541;2024
43;Tarragona;156;Ulldecona;6551;3494;3057;2024
43;Tarragona;157;Ulldemolins;416;234;182;2024
43;Tarragona;158;Vallclara;89;55;34;2024
43;Tarragona;159;Vallfogona de Riucorb;97;54;43;2024
43;Tarragona;160;Vallmoll;1951;989;962;2024
43;Tarragona;161;Valls;25047;12665;12382;2024
43;Tarragona;162;Vandellòs i l'Hospitalet de l'Infant;7104;3539;3565;2024
43;Tarragona;163;Vendrell, El;40440;20031;20409;2024
43;Tarragona;164;Vespella de Gaià;506;268;238;2024
43;Tarragona;165;Vilabella;723;371;352;2024
43;Tarragona;166;Vilallonga del Camp;2451;1234;1217;2024
43;Tarragona;167;Vilanova d'Escornalbou;610;319;291;2024
43;Tarragona;168;Vilanova de Prades;111;60;51;2024
43;Tarragona;169;Vilaplana;553;291;262;2024
43;Tarragona;170;Vila-rodona;1374;725;649;2024
43;Tarragona;171;Vila-seca;23826;11969;11857;2024
43;Tarragona;172;Vilaverd;468;249;219;2024
43;Tarragona;173;Vilella Alta, La;128;69;59;2024
43;Tarragona;174;Vilella Baixa, La;207;115;92;2024
43;Tarragona;175;Vilalba dels Arcs;608;305;303;2024
43;Tarragona;176;Vimbodí i Poblet;893;483;410;2024
43;Tarragona;177;Vinebre;424;224;200;2024
43;Tarragona;178;Vinyols i els Arcs;2400;1232;1168;2024
43;Tarragona;901;Deltebre;11951;6018;5933;2024
43;Tarragona;902;Sant Jaume d'Enveja;3667;1845;1822;2024
43;Tarragona;903;Camarles;3392;1728;1664;2024
43;Tarragona;904;Aldea, L';4471;2405;2066;2024
43;Tarragona;905;Salou;30810;15683;15127;2024
43;Tarragona;906;Ampolla, L';3681;1868;1813;2024
43;Tarragona;907;Canonja, La;5943;2897;3046;2024
44;Teruel;001;Ababuj;74;44;30;2024
44;Teruel;002;Abejuela;57;37;20;2024
44;Teruel;003;Aguatón;17;7;10;2024
44;Teruel;004;Aguaviva;547;261;286;2024
44;Teruel;005;Aguilar del Alfambra;82;45;37;2024
44;Teruel;006;Alacón;208;108;100;2024
44;Teruel;007;Alba;187;112;75;2024
44;Teruel;008;Albalate del Arzobispo;1933;1007;926;2024
44;Teruel;009;Albarracín;1002;516;486;2024
44;Teruel;010;Albentosa;299;153;146;2024
44;Teruel;011;Alcaine;39;25;14;2024
44;Teruel;012;Alcalá de la Selva;378;212;166;2024
44;Teruel;013;Alcañiz;16247;8120;8127;2024
44;Teruel;014;Alcorisa;3234;1644;1590;2024
44;Teruel;016;Alfambra;487;261;226;2024
44;Teruel;017;Aliaga;345;202;143;2024
44;Teruel;018;Almohaja;12;10;2;2024
44;Teruel;019;Alobras;69;45;24;2024
44;Teruel;020;Alpeñés;26;13;13;2024
44;Teruel;021;Allepuz;124;63;61;2024
44;Teruel;022;Alloza;551;283;268;2024
44;Teruel;023;Allueva;30;20;10;2024
44;Teruel;024;Anadón;34;21;13;2024
44;Teruel;025;Andorra;7258;3591;3667;2024
44;Teruel;026;Arcos de las Salinas;110;69;41;2024
44;Teruel;027;Arens de Lledó;194;90;104;2024
44;Teruel;028;Argente;201;103;98;2024
44;Teruel;029;Ariño;632;327;305;2024
44;Teruel;031;Azaila;95;56;39;2024
44;Teruel;032;Bádenas;24;15;9;2024
44;Teruel;033;Báguena;295;170;125;2024
44;Teruel;034;Bañón;155;86;69;2024
44;Teruel;035;Barrachina;115;64;51;2024
44;Teruel;036;Bea;27;18;9;2024
44;Teruel;037;Beceite;562;289;273;2024
44;Teruel;038;Belmonte de San José;135;69;66;2024
44;Teruel;039;Bello;213;107;106;2024
44;Teruel;040;Berge;216;113;103;2024
44;Teruel;041;Bezas;68;40;28;2024
44;Teruel;042;Blancas;134;79;55;2024
44;Teruel;043;Blesa;76;54;22;2024
44;Teruel;044;Bordón;113;66;47;2024
44;Teruel;045;Bronchales;451;250;201;2024
44;Teruel;046;Bueña;55;28;27;2024
44;Teruel;047;Burbáguena;352;191;161;2024
44;Teruel;048;Cabra de Mora;66;41;25;2024
44;Teruel;049;Calaceite;960;477;483;2024
44;Teruel;050;Calamocha;4542;2274;2268;2024
44;Teruel;051;Calanda;3678;1832;1846;2024
44;Teruel;052;Calomarde;74;45;29;2024
44;Teruel;053;Camañas;127;69;58;2024
44;Teruel;054;Camarena de la Sierra;142;76;66;2024
44;Teruel;055;Camarillas;120;71;49;2024
44;Teruel;056;Caminreal;603;321;282;2024
44;Teruel;059;Cantavieja;719;371;348;2024
44;Teruel;060;Cañada de Benatanduz;39;24;15;2024
44;Teruel;061;Cañada de Verich, La;80;48;32;2024
44;Teruel;062;Cañada Vellida;38;24;14;2024
44;Teruel;063;Cañizar del Olivar;111;65;46;2024
44;Teruel;064;Cascante del Río;65;39;26;2024
44;Teruel;065;Castejón de Tornos;66;39;27;2024
44;Teruel;066;Castel de Cabra;84;46;38;2024
44;Teruel;067;Castelnou;99;51;48;2024
44;Teruel;068;Castelserás;801;422;379;2024
44;Teruel;070;Castellar, El;56;37;19;2024
44;Teruel;071;Castellote;663;340;323;2024
44;Teruel;074;Cedrillas;647;334;313;2024
44;Teruel;075;Celadas;329;189;140;2024
44;Teruel;076;Cella;2690;1383;1307;2024
44;Teruel;077;Cerollera, La;77;48;29;2024
44;Teruel;080;Codoñera, La;321;172;149;2024
44;Teruel;082;Corbalán;118;58;60;2024
44;Teruel;084;Cortes de Aragón;65;31;34;2024
44;Teruel;085;Cosa;62;36;26;2024
44;Teruel;086;Cretas;570;289;281;2024
44;Teruel;087;Crivillén;91;53;38;2024
44;Teruel;088;Cuba, La;50;24;26;2024
44;Teruel;089;Cubla;58;38;20;2024
44;Teruel;090;Cucalón;79;53;26;2024
44;Teruel;092;Cuervo, El;95;45;50;2024
44;Teruel;093;Cuevas de Almudén;115;61;54;2024
44;Teruel;094;Cuevas Labradas;136;72;64;2024
44;Teruel;096;Ejulve;169;81;88;2024
44;Teruel;097;Escorihuela;141;69;72;2024
44;Teruel;099;Escucha;772;417;355;2024
44;Teruel;100;Estercuel;203;116;87;2024
44;Teruel;101;Ferreruela de Huerva;78;46;32;2024
44;Teruel;102;Fonfría;35;20;15;2024
44;Teruel;103;Formiche Alto;158;90;68;2024
44;Teruel;105;Fórnoles;72;38;34;2024
44;Teruel;106;Fortanete;216;122;94;2024
44;Teruel;107;Foz-Calanda;281;146;135;2024
44;Teruel;108;Fresneda, La;459;255;204;2024
44;Teruel;109;Frías de Albarracín;112;61;51;2024
44;Teruel;110;Fuenferrada;35;23;12;2024
44;Teruel;111;Fuentes Calientes;82;49;33;2024
44;Teruel;112;Fuentes Claras;435;235;200;2024
44;Teruel;113;Fuentes de Rubielos;156;87;69;2024
44;Teruel;114;Fuentespalda;289;144;145;2024
44;Teruel;115;Galve;144;75;69;2024
44;Teruel;116;Gargallo;87;46;41;2024
44;Teruel;117;Gea de Albarracín;467;256;211;2024
44;Teruel;118;Ginebrosa, La;196;110;86;2024
44;Teruel;119;Griegos;142;88;54;2024
44;Teruel;120;Guadalaviar;237;127;110;2024
44;Teruel;121;Gúdar;73;43;30;2024
44;Teruel;122;Híjar;1760;902;858;2024
44;Teruel;123;Hinojosa de Jarque;99;59;40;2024
44;Teruel;124;Hoz de la Vieja, La;87;46;41;2024
44;Teruel;125;Huesa del Común;57;35;22;2024
44;Teruel;126;Iglesuela del Cid, La;377;193;184;2024
44;Teruel;127;Jabaloyas;63;40;23;2024
44;Teruel;128;Jarque de la Val;62;30;32;2024
44;Teruel;129;Jatiel;49;29;20;2024
44;Teruel;130;Jorcas;39;22;17;2024
44;Teruel;131;Josa;35;21;14;2024
44;Teruel;132;Lagueruela;71;42;29;2024
44;Teruel;133;Lanzuela;24;16;8;2024
44;Teruel;135;Libros;102;58;44;2024
44;Teruel;136;Lidón;56;32;24;2024
44;Teruel;137;Linares de Mora;233;135;98;2024
44;Teruel;138;Loscos;112;73;39;2024
44;Teruel;141;Lledó;153;78;75;2024
44;Teruel;142;Maicas;35;21;14;2024
44;Teruel;143;Manzanera;539;298;241;2024
44;Teruel;144;Martín del Río;370;177;193;2024
44;Teruel;145;Mas de las Matas;1225;627;598;2024
44;Teruel;146;Mata de los Olmos, La;271;143;128;2024
44;Teruel;147;Mazaleón;481;249;232;2024
44;Teruel;148;Mezquita de Jarque;81;45;36;2024
44;Teruel;149;Mirambel;107;62;45;2024
44;Teruel;150;Miravete de la Sierra;32;21;11;2024
44;Teruel;151;Molinos;228;124;104;2024
44;Teruel;152;Monforte de Moyuela;75;50;25;2024
44;Teruel;153;Monreal del Campo;2541;1244;1297;2024
44;Teruel;154;Monroyo;308;170;138;2024
44;Teruel;155;Montalbán;1165;595;570;2024
44;Teruel;156;Monteagudo del Castillo;43;25;18;2024
44;Teruel;157;Monterde de Albarracín;58;34;24;2024
44;Teruel;158;Mora de Rubielos;1618;807;811;2024
44;Teruel;159;Moscardón;61;33;28;2024
44;Teruel;160;Mosqueruela;544;297;247;2024
44;Teruel;161;Muniesa;572;307;265;2024
44;Teruel;163;Noguera de Albarracín;130;76;54;2024
44;Teruel;164;Nogueras;32;22;10;2024
44;Teruel;165;Nogueruelas;193;112;81;2024
44;Teruel;167;Obón;31;18;13;2024
44;Teruel;168;Odón;197;97;100;2024
44;Teruel;169;Ojos Negros;328;186;142;2024
44;Teruel;171;Olba;294;156;138;2024
44;Teruel;172;Oliete;367;199;168;2024
44;Teruel;173;Olmos, Los;117;66;51;2024
44;Teruel;174;Orihuela del Tremedal;458;249;209;2024
44;Teruel;175;Orrios;119;65;54;2024
44;Teruel;176;Palomar de Arroyos;160;95;65;2024
44;Teruel;177;Pancrudo;113;66;47;2024
44;Teruel;178;Parras de Castellote, Las;57;33;24;2024
44;Teruel;179;Peñarroya de Tastavins;460;248;212;2024
44;Teruel;180;Peracense;74;38;36;2024
44;Teruel;181;Peralejos;89;48;41;2024
44;Teruel;182;Perales del Alfambra;271;141;130;2024
44;Teruel;183;Pitarque;61;29;32;2024
44;Teruel;184;Plou;46;27;19;2024
44;Teruel;185;Pobo, El;98;62;36;2024
44;Teruel;187;Portellada, La;241;125;116;2024
44;Teruel;189;Pozondón;54;33;21;2024
44;Teruel;190;Pozuel del Campo;66;36;30;2024
44;Teruel;191;Puebla de Híjar, La;934;485;449;2024
44;Teruel;192;Puebla de Valverde, La;465;255;210;2024
44;Teruel;193;Puertomingalvo;141;77;64;2024
44;Teruel;194;Ráfales;149;89;60;2024
44;Teruel;195;Rillo;98;55;43;2024
44;Teruel;196;Riodeva;121;54;67;2024
44;Teruel;197;Ródenas;61;34;27;2024
44;Teruel;198;Royuela;225;117;108;2024
44;Teruel;199;Rubiales;43;23;20;2024
44;Teruel;200;Rubielos de la Cérida;26;17;9;2024
44;Teruel;201;Rubielos de Mora;615;314;301;2024
44;Teruel;203;Salcedillo;13;6;7;2024
44;Teruel;204;Saldón;26;17;9;2024
44;Teruel;205;Samper de Calanda;730;384;346;2024
44;Teruel;206;San Agustín;137;87;50;2024
44;Teruel;207;San Martín del Río;136;69;67;2024
44;Teruel;208;Santa Cruz de Nogueras;24;16;8;2024
44;Teruel;209;Santa Eulalia;1020;533;487;2024
44;Teruel;210;Sarrión;1216;612;604;2024
44;Teruel;211;Segura de los Baños;48;32;16;2024
44;Teruel;212;Seno;38;16;22;2024
44;Teruel;213;Singra;75;41;34;2024
44;Teruel;215;Terriente;210;124;86;2024
44;Teruel;216;Teruel;36713;17468;19245;2024
44;Teruel;217;Toril y Masegoso;34;26;8;2024
44;Teruel;218;Tormón;31;19;12;2024
44;Teruel;219;Tornos;182;96;86;2024
44;Teruel;220;Torralba de los Sisones;146;81;65;2024
44;Teruel;221;Torrecilla de Alcañiz;436;232;204;2024
44;Teruel;222;Torrecilla del Rebollar;117;75;42;2024
44;Teruel;223;Torre de Arcas;82;41;41;2024
44;Teruel;224;Torre de las Arcas;20;10;10;2024
44;Teruel;225;Torre del Compte;122;63;59;2024
44;Teruel;226;Torrelacárcel;131;79;52;2024
44;Teruel;227;Torre los Negros;80;42;38;2024
44;Teruel;228;Torremocha de Jiloca;103;54;49;2024
44;Teruel;229;Torres de Albarracín;191;101;90;2024
44;Teruel;230;Torrevelilla;182;90;92;2024
44;Teruel;231;Torrijas;36;16;20;2024
44;Teruel;232;Torrijo del Campo;502;264;238;2024
44;Teruel;234;Tramacastiel;58;34;24;2024
44;Teruel;235;Tramacastilla;130;62;68;2024
44;Teruel;236;Tronchón;60;34;26;2024
44;Teruel;237;Urrea de Gaén;440;225;215;2024
44;Teruel;238;Utrillas;3102;1598;1504;2024
44;Teruel;239;Valacloche;32;17;15;2024
44;Teruel;240;Valbona;192;110;82;2024
44;Teruel;241;Valdealgorfa;580;286;294;2024
44;Teruel;243;Valdecuenca;28;16;12;2024
44;Teruel;244;Valdelinares;75;47;28;2024
44;Teruel;245;Valdeltormo;305;153;152;2024
44;Teruel;246;Valderrobres;2545;1297;1248;2024
44;Teruel;247;Valjunquera;328;171;157;2024
44;Teruel;249;Vallecillo, El;37;21;16;2024
44;Teruel;250;Veguillas de la Sierra;24;14;10;2024
44;Teruel;251;Villafranca del Campo;296;162;134;2024
44;Teruel;252;Villahermosa del Campo;93;54;39;2024
44;Teruel;256;Villanueva del Rebollar de la Sierra;48;27;21;2024
44;Teruel;257;Villar del Cobo;162;99;63;2024
44;Teruel;258;Villar del Salz;53;33;20;2024
44;Teruel;260;Villarluengo;163;97;66;2024
44;Teruel;261;Villarquemado;870;454;416;2024
44;Teruel;262;Villarroya de los Pinares;163;86;77;2024
44;Teruel;263;Villastar;551;281;270;2024
44;Teruel;264;Villel;337;189;148;2024
44;Teruel;265;Vinaceite;182;98;84;2024
44;Teruel;266;Visiedo;131;62;69;2024
44;Teruel;267;Vivel del Río Martín;63;34;29;2024
44;Teruel;268;Zoma, La;27;14;13;2024
45;Toledo;001;Ajofrín;2350;1173;1177;2024
45;Toledo;002;Alameda de la Sagra;4239;2239;2000;2024
45;Toledo;003;Albarreal de Tajo;762;385;377;2024
45;Toledo;004;Alcabón;761;383;378;2024
45;Toledo;005;Alcañizo;275;132;143;2024
45;Toledo;006;Alcaudete de la Jara;1662;836;826;2024
45;Toledo;007;Alcolea de Tajo;829;418;411;2024
45;Toledo;008;Aldea en Cabo;205;104;101;2024
45;Toledo;009;Aldeanueva de Barbarroya;461;235;226;2024
45;Toledo;010;Aldeanueva de San Bartolomé;413;214;199;2024
45;Toledo;011;Almendral de la Cañada;345;181;164;2024
45;Toledo;012;Almonacid de Toledo;931;475;456;2024
45;Toledo;013;Almorox;2472;1298;1174;2024
45;Toledo;014;Añover de Tajo;5354;2711;2643;2024
45;Toledo;015;Arcicóllar;1082;555;527;2024
45;Toledo;016;Argés;7014;3498;3516;2024
45;Toledo;017;Azután;289;138;151;2024
45;Toledo;018;Barcience;1049;554;495;2024
45;Toledo;019;Bargas;11099;5525;5574;2024
45;Toledo;020;Belvís de la Jara;1428;737;691;2024
45;Toledo;021;Borox;4250;2249;2001;2024
45;Toledo;022;Buenaventura;377;190;187;2024
45;Toledo;023;Burguillos de Toledo;3743;1942;1801;2024
45;Toledo;024;Burujón;1332;673;659;2024
45;Toledo;025;Cabañas de la Sagra;2137;1085;1052;2024
45;Toledo;026;Cabañas de Yepes;306;164;142;2024
45;Toledo;027;Cabezamesada;332;184;148;2024
45;Toledo;028;Calera y Chozas;4773;2394;2379;2024
45;Toledo;029;Caleruela;201;104;97;2024
45;Toledo;030;Calzada de Oropesa;518;286;232;2024
45;Toledo;031;Camarena;4634;2416;2218;2024
45;Toledo;032;Camarenilla;606;309;297;2024
45;Toledo;033;Campillo de la Jara, El;322;170;152;2024
45;Toledo;034;Camuñas;1767;930;837;2024
45;Toledo;035;Cardiel de los Montes;390;211;179;2024
45;Toledo;036;Carmena;836;425;411;2024
45;Toledo;037;Carpio de Tajo, El;1873;946;927;2024
45;Toledo;038;Carranque;5418;2782;2636;2024
45;Toledo;039;Carriches;266;138;128;2024
45;Toledo;040;Casar de Escalona, El;2128;1102;1026;2024
45;Toledo;041;Casarrubios del Monte;7098;3674;3424;2024
45;Toledo;042;Casasbuenas;193;97;96;2024
45;Toledo;043;Castillo de Bayuela;921;473;448;2024
45;Toledo;045;Cazalegas;2098;1085;1013;2024
45;Toledo;046;Cebolla;3234;1606;1628;2024
45;Toledo;047;Cedillo del Condado;4337;2255;2082;2024
45;Toledo;048;Cerralbos, Los;425;227;198;2024
45;Toledo;049;Cervera de los Montes;495;258;237;2024
45;Toledo;050;Ciruelos;679;360;319;2024
45;Toledo;051;Cobeja;2668;1391;1277;2024
45;Toledo;052;Cobisa;4500;2268;2232;2024
45;Toledo;053;Consuegra;9758;4929;4829;2024
45;Toledo;054;Corral de Almaguer;5237;2767;2470;2024
45;Toledo;055;Cuerva;1260;652;608;2024
45;Toledo;056;Chozas de Canales;4887;2531;2356;2024
45;Toledo;057;Chueca;249;124;125;2024
45;Toledo;058;Domingo Pérez;395;202;193;2024
45;Toledo;059;Dosbarrios;2203;1134;1069;2024
45;Toledo;060;Erustes;226;120;106;2024
45;Toledo;061;Escalona;3801;1940;1861;2024
45;Toledo;062;Escalonilla;1497;727;770;2024
45;Toledo;063;Espinoso del Rey;418;243;175;2024
45;Toledo;064;Esquivias;5832;2965;2867;2024
45;Toledo;065;Estrella, La;267;142;125;2024
45;Toledo;066;Fuensalida;12508;6288;6220;2024
45;Toledo;067;Gálvez;3006;1519;1487;2024
45;Toledo;068;Garciotum;215;106;109;2024
45;Toledo;069;Gerindote;2767;1404;1363;2024
45;Toledo;070;Guadamur;1782;897;885;2024
45;Toledo;071;Guardia, La;2160;1112;1048;2024
45;Toledo;072;Herencias, Las;792;421;371;2024
45;Toledo;073;Herreruela de Oropesa;328;173;155;2024
45;Toledo;074;Hinojosa de San Vicente;380;209;171;2024
45;Toledo;075;Hontanar;151;94;57;2024
45;Toledo;076;Hormigos;992;541;451;2024
45;Toledo;077;Huecas;875;449;426;2024
45;Toledo;078;Huerta de Valdecarábanos;1771;899;872;2024
45;Toledo;079;Iglesuela del Tiétar, La;451;234;217;2024
45;Toledo;080;Illán de Vacas;2;2;0;2024
45;Toledo;081;Illescas;32159;16119;16040;2024
45;Toledo;082;Lagartera;1315;642;673;2024
45;Toledo;083;Layos;906;456;450;2024
45;Toledo;084;Lillo;2493;1303;1190;2024
45;Toledo;085;Lominchar;2815;1512;1303;2024
45;Toledo;086;Lucillos;629;330;299;2024
45;Toledo;087;Madridejos;10102;5070;5032;2024
45;Toledo;088;Magán;4114;2097;2017;2024
45;Toledo;089;Malpica de Tajo;1678;867;811;2024
45;Toledo;090;Manzaneque;398;202;196;2024
45;Toledo;091;Maqueda;504;243;261;2024
45;Toledo;092;Marjaliza;264;138;126;2024
45;Toledo;093;Marrupe;162;80;82;2024
45;Toledo;094;Mascaraque;424;214;210;2024
45;Toledo;095;Mata, La;915;448;467;2024
45;Toledo;096;Mazarambroz;1270;659;611;2024
45;Toledo;097;Mejorada;1385;703;682;2024
45;Toledo;098;Menasalbas;2485;1293;1192;2024
45;Toledo;099;Méntrida;6273;3189;3084;2024
45;Toledo;100;Mesegar de Tajo;200;110;90;2024
45;Toledo;101;Miguel Esteban;4733;2382;2351;2024
45;Toledo;102;Mocejón;5172;2598;2574;2024
45;Toledo;103;Mohedas de la Jara;410;218;192;2024
45;Toledo;104;Montearagón;588;310;278;2024
45;Toledo;105;Montesclaros;365;191;174;2024
45;Toledo;106;Mora;9930;5002;4928;2024
45;Toledo;107;Nambroca;5250;2656;2594;2024
45;Toledo;108;Nava de Ricomalillo, La;515;269;246;2024
45;Toledo;109;Navahermosa;3592;1881;1711;2024
45;Toledo;110;Navalcán;1863;963;900;2024
45;Toledo;111;Navalmoralejo;54;27;27;2024
45;Toledo;112;Navalmorales, Los;2120;1086;1034;2024
45;Toledo;113;Navalucillos, Los;1897;960;937;2024
45;Toledo;114;Navamorcuende;599;300;299;2024
45;Toledo;115;Noblejas;3952;1977;1975;2024
45;Toledo;116;Noez;990;510;480;2024
45;Toledo;117;Nombela;895;484;411;2024
45;Toledo;118;Novés;3463;1770;1693;2024
45;Toledo;119;Numancia de la Sagra;5616;2921;2695;2024
45;Toledo;120;Nuño Gómez;171;88;83;2024
45;Toledo;121;Ocaña;14469;7261;7208;2024
45;Toledo;122;Olías del Rey;8947;4498;4449;2024
45;Toledo;123;Ontígola;4992;2607;2385;2024
45;Toledo;124;Orgaz;2595;1306;1289;2024
45;Toledo;125;Oropesa;2564;1222;1342;2024
45;Toledo;126;Otero;431;223;208;2024
45;Toledo;127;Palomeque;1182;642;540;2024
45;Toledo;128;Pantoja;3523;1756;1767;2024
45;Toledo;129;Paredes de Escalona;129;70;59;2024
45;Toledo;130;Parrillas;351;182;169;2024
45;Toledo;131;Pelahustán;331;191;140;2024
45;Toledo;132;Pepino;3259;1673;1586;2024
45;Toledo;133;Polán;3932;1992;1940;2024
45;Toledo;134;Portillo de Toledo;2346;1199;1147;2024
45;Toledo;135;Puebla de Almoradiel, La;4887;2481;2406;2024
45;Toledo;136;Puebla de Montalbán, La;8032;4059;3973;2024
45;Toledo;137;Pueblanueva, La;2138;1113;1025;2024
45;Toledo;138;Puente del Arzobispo, El;1151;577;574;2024
45;Toledo;139;Puerto de San Vicente;147;82;65;2024
45;Toledo;140;Pulgar;1600;839;761;2024
45;Toledo;141;Quero;979;495;484;2024
45;Toledo;142;Quintanar de la Orden;11194;5555;5639;2024
45;Toledo;143;Quismondo;1798;897;901;2024
45;Toledo;144;Real de San Vicente, El;981;524;457;2024
45;Toledo;145;Recas;5023;2787;2236;2024
45;Toledo;146;Retamoso de la Jara;110;56;54;2024
45;Toledo;147;Rielves;859;430;429;2024
45;Toledo;148;Robledo del Mazo;252;140;112;2024
45;Toledo;149;Romeral, El;541;266;275;2024
45;Toledo;150;San Bartolomé de las Abiertas;603;322;281;2024
45;Toledo;151;San Martín de Montalbán;759;397;362;2024
45;Toledo;152;San Martín de Pusa;604;328;276;2024
45;Toledo;153;San Pablo de los Montes;1644;829;815;2024
45;Toledo;154;San Román de los Montes;2112;1090;1022;2024
45;Toledo;155;Santa Ana de Pusa;342;196;146;2024
45;Toledo;156;Santa Cruz de la Zarza;4100;2113;1987;2024
45;Toledo;157;Santa Cruz del Retamar;4038;2105;1933;2024
45;Toledo;158;Santa Olalla;3502;1775;1727;2024
45;Toledo;159;Sartajada;100;62;38;2024
45;Toledo;160;Segurilla;1378;692;686;2024
45;Toledo;161;Seseña;30165;15471;14694;2024
45;Toledo;162;Sevilleja de la Jara;620;347;273;2024
45;Toledo;163;Sonseca;11328;5757;5571;2024
45;Toledo;164;Sotillo de las Palomas;183;95;88;2024
45;Toledo;165;Talavera de la Reina;84738;40640;44098;2024
45;Toledo;166;Tembleque;2009;1019;990;2024
45;Toledo;167;Toboso, El;1723;866;857;2024
45;Toledo;168;Toledo;86526;41199;45327;2024
45;Toledo;169;Torralba de Oropesa;193;104;89;2024
45;Toledo;170;Torrecilla de la Jara;222;123;99;2024
45;Toledo;171;Torre de Esteban Hambrán, La;1932;959;973;2024
45;Toledo;172;Torrico;702;356;346;2024
45;Toledo;173;Torrijos;14099;6939;7160;2024
45;Toledo;174;Totanés;371;185;186;2024
45;Toledo;175;Turleque;692;356;336;2024
45;Toledo;176;Ugena;5802;2999;2803;2024
45;Toledo;177;Urda;2494;1268;1226;2024
45;Toledo;179;Valdeverdeja;565;284;281;2024
45;Toledo;180;Valmojado;4771;2387;2384;2024
45;Toledo;181;Velada;2907;1492;1415;2024
45;Toledo;182;Ventas con Peña Aguilera, Las;1118;567;551;2024
45;Toledo;183;Ventas de Retamosa, Las;4160;2160;2000;2024
45;Toledo;184;Ventas de San Julián, Las;231;112;119;2024
45;Toledo;185;Villacañas;9489;4746;4743;2024
45;Toledo;186;Villa de Don Fadrique, La;3553;1778;1775;2024
45;Toledo;187;Villafranca de los Caballeros;4897;2491;2406;2024
45;Toledo;188;Villaluenga de la Sagra;4171;2118;2053;2024
45;Toledo;189;Villamiel de Toledo;1069;544;525;2024
45;Toledo;190;Villaminaya;497;249;248;2024
45;Toledo;191;Villamuelas;613;320;293;2024
45;Toledo;192;Villanueva de Alcardete;2963;1520;1443;2024
45;Toledo;193;Villanueva de Bogas;676;348;328;2024
45;Toledo;194;Villarejo de Montalbán;78;41;37;2024
45;Toledo;195;Villarrubia de Santiago;2559;1306;1253;2024
45;Toledo;196;Villaseca de la Sagra;1859;933;926;2024
45;Toledo;197;Villasequilla;2621;1348;1273;2024
45;Toledo;198;Villatobas;2858;1466;1392;2024
45;Toledo;199;Viso de San Juan, El;6164;3289;2875;2024
45;Toledo;200;Yébenes, Los;5753;2945;2808;2024
45;Toledo;201;Yeles;6649;3495;3154;2024
45;Toledo;202;Yepes;5541;2819;2722;2024
45;Toledo;203;Yuncler;5033;2601;2432;2024
45;Toledo;204;Yunclillos;816;434;382;2024
45;Toledo;205;Yuncos;12831;6563;6268;2024
45;Toledo;901;Santo Domingo-Caudilla;1229;647;582;2024
46;Valencia/València;001;Ademuz;1004;538;466;2024
46;Valencia/València;002;Ador;1729;916;813;2024
46;Valencia/València;003;Atzeneta d'Albaida;1169;582;587;2024
46;Valencia/València;004;Agullent;2416;1202;1214;2024
46;Valencia/València;005;Alaquàs;30022;14621;15401;2024
46;Valencia/València;006;Albaida;6235;3071;3164;2024
46;Valencia/València;007;Albal;17038;8508;8530;2024
46;Valencia/València;008;Albalat de la Ribera;3446;1738;1708;2024
46;Valencia/València;009;Albalat dels Sorells;4249;2085;2164;2024
46;Valencia/València;010;Albalat dels Tarongers;1516;799;717;2024
46;Valencia/València;011;Alberic;10945;5462;5483;2024
46;Valencia/València;012;Alborache;1471;778;693;2024
46;Valencia/València;013;Alboraia/Alboraya;26259;12719;13540;2024
46;Valencia/València;014;Albuixech;4419;2110;2309;2024
46;Valencia/València;015;Alcàsser;10676;5352;5324;2024
46;Valencia/València;016;Alcàntera de Xúquer;1425;709;716;2024
46;Valencia/València;017;Alzira;47335;23089;24246;2024
46;Valencia/València;018;Alcublas;683;365;318;2024
46;Valencia/València;019;Alcúdia, l';12402;6125;6277;2024
46;Valencia/València;020;Alcúdia de Crespins, l';5438;2678;2760;2024
46;Valencia/València;021;Aldaia;34035;17136;16899;2024
46;Valencia/València;022;Alfafar;22131;10837;11294;2024
46;Valencia/València;023;Alfauir;489;249;240;2024
46;Valencia/València;024;Alfara de la Baronia;614;304;310;2024
46;Valencia/València;025;Alfara del Patriarca;3623;1690;1933;2024
46;Valencia/València;026;Alfarb;1676;869;807;2024
46;Valencia/València;027;Alfarrasí;1175;581;594;2024
46;Valencia/València;028;Algar de Palància;542;287;255;2024
46;Valencia/València;029;Algemesí;27968;13817;14151;2024
46;Valencia/València;030;Algímia d'Alfara;1104;542;562;2024
46;Valencia/València;031;Alginet;14652;7400;7252;2024
46;Valencia/València;032;Almàssera;7672;3736;3936;2024
46;Valencia/València;033;Almiserà;285;148;137;2024
46;Valencia/València;034;Almoines;2643;1337;1306;2024
46;Valencia/València;035;Almussafes;9057;4505;4552;2024
46;Valencia/València;036;Alpuente;700;382;318;2024
46;Valencia/València;037;Alqueria de la Comtessa, l';1544;755;789;2024
46;Valencia/València;038;Andilla;324;215;109;2024
46;Valencia/València;039;Anna;2595;1302;1293;2024
46;Valencia/València;040;Antella;1114;537;577;2024
46;Valencia/València;041;Aras de los Olmos;392;223;169;2024
46;Valencia/València;042;Aielo de Malferit;4599;2313;2286;2024
46;Valencia/València;043;Aielo de Rugat;160;87;73;2024
46;Valencia/València;044;Ayora;5284;2588;2696;2024
46;Valencia/València;045;Barxeta;1586;809;777;2024
46;Valencia/València;046;Barx;1498;768;730;2024
46;Valencia/València;047;Bèlgida;640;323;317;2024
46;Valencia/València;048;Bellreguard;4943;2458;2485;2024
46;Valencia/València;049;Bellús;302;157;145;2024
46;Valencia/València;050;Benagéber;171;101;70;2024
46;Valencia/València;051;Benaguasil;12336;6261;6075;2024
46;Valencia/València;052;Benavites;661;315;346;2024
46;Valencia/València;053;Beneixida;649;311;338;2024
46;Valencia/València;054;Benetússer;16322;7990;8332;2024
46;Valencia/València;055;Beniarjó;1907;948;959;2024
46;Valencia/València;056;Beniatjar;209;112;97;2024
46;Valencia/València;057;Benicolet;605;293;312;2024
46;Valencia/València;058;Benifairó de les Valls;2318;1153;1165;2024
46;Valencia/València;059;Benifairó de la Valldigna;1560;775;785;2024
46;Valencia/València;060;Benifaió;12130;5955;6175;2024
46;Valencia/València;061;Beniflá;502;252;250;2024
46;Valencia/València;062;Benigànim;5695;2896;2799;2024
46;Valencia/València;063;Benimodo;2316;1187;1129;2024
46;Valencia/València;064;Benimuslem;665;355;310;2024
46;Valencia/València;065;Beniparrell;2091;1059;1032;2024
46;Valencia/València;066;Benirredrà;1561;735;826;2024
46;Valencia/València;067;Benissanó;2427;1186;1241;2024
46;Valencia/València;068;Benissoda;485;260;225;2024
46;Valencia/València;069;Benissuera;185;97;88;2024
46;Valencia/València;070;Bétera;27584;13744;13840;2024
46;Valencia/València;071;Bicorp;560;273;287;2024
46;Valencia/València;072;Bocairent;4148;2082;2066;2024
46;Valencia/València;073;Bolbaite;1333;659;674;2024
46;Valencia/València;074;Bonrepòs i Mirambell;4048;1988;2060;2024
46;Valencia/València;075;Bufali;154;79;75;2024
46;Valencia/València;076;Bugarra;781;404;377;2024
46;Valencia/València;077;Buñol;9765;4845;4920;2024
46;Valencia/València;078;Burjassot;40634;19523;21111;2024
46;Valencia/València;079;Calles;447;257;190;2024
46;Valencia/València;080;Camporrobles;1188;609;579;2024
46;Valencia/València;081;Canals;13415;6693;6722;2024
46;Valencia/València;082;Canet d'En Berenguer;7771;3907;3864;2024
46;Valencia/València;083;Carcaixent;21317;10605;10712;2024
46;Valencia/València;084;Càrcer;1806;876;930;2024
46;Valencia/València;085;Carlet;16428;8201;8227;2024
46;Valencia/València;086;Carrícola;99;49;50;2024
46;Valencia/València;087;Casas Altas;139;73;66;2024
46;Valencia/València;088;Casas Bajas;167;86;81;2024
46;Valencia/València;089;Casinos;3113;1570;1543;2024
46;Valencia/València;090;Castelló de Rugat;2352;1178;1174;2024
46;Valencia/València;091;Castellonet de la Conquesta;144;72;72;2024
46;Valencia/València;092;Castielfabib;287;153;134;2024
46;Valencia/València;093;Catadau;2967;1488;1479;2024
46;Valencia/València;094;Catarroja;30142;14866;15276;2024
46;Valencia/València;095;Caudete de las Fuentes;720;376;344;2024
46;Valencia/València;096;Cerdà;367;183;184;2024
46;Valencia/València;097;Cofrentes;1123;562;561;2024
46;Valencia/València;098;Corbera;3173;1586;1587;2024
46;Valencia/València;099;Cortes de Pallás;758;416;342;2024
46;Valencia/València;100;Cotes;311;160;151;2024
46;Valencia/València;101;Quart de les Valls;1040;492;548;2024
46;Valencia/València;102;Quart de Poblet;26304;12728;13576;2024
46;Valencia/València;103;Quartell;1657;780;877;2024
46;Valencia/València;104;Quatretonda;2206;1098;1108;2024
46;Valencia/València;105;Cullera;24181;12081;12100;2024
46;Valencia/València;106;Chelva;1677;858;819;2024
46;Valencia/València;107;Chella;2439;1213;1226;2024
46;Valencia/València;108;Chera;491;262;229;2024
46;Valencia/València;109;Cheste;9022;4615;4407;2024
46;Valencia/València;110;Xirivella;31745;15714;16031;2024
46;Valencia/València;111;Chiva;17245;8854;8391;2024
46;Valencia/València;112;Chulilla;677;360;317;2024
46;Valencia/València;113;Daimús;3419;1729;1690;2024
46;Valencia/València;114;Domeño;691;346;345;2024
46;Valencia/València;115;Dos Aguas;338;199;139;2024
46;Valencia/València;116;Eliana, l';19597;9601;9996;2024
46;Valencia/València;117;Emperador;693;364;329;2024
46;Valencia/València;118;Enguera;4769;2389;2380;2024
46;Valencia/València;119;Énova, l';924;477;447;2024
46;Valencia/València;120;Estivella;1631;781;850;2024
46;Valencia/València;121;Estubeny;109;54;55;2024
46;Valencia/València;122;Faura;3671;1814;1857;2024
46;Valencia/València;123;Favara;2701;1380;1321;2024
46;Valencia/València;124;Fontanars dels Alforins;947;489;458;2024
46;Valencia/València;125;Fortaleny;1005;494;511;2024
46;Valencia/València;126;Foios;7761;3793;3968;2024
46;Valencia/València;127;Font d'en Carròs, la;3938;1979;1959;2024
46;Valencia/València;128;Font de la Figuera, la;2043;1038;1005;2024
46;Valencia/València;129;Fuenterrobles;695;372;323;2024
46;Valencia/València;130;Gavarda;1036;486;550;2024
46;Valencia/València;131;Gandia;80095;39248;40847;2024
46;Valencia/València;132;Genovés, el;2823;1436;1387;2024
46;Valencia/València;133;Gestalgar;560;288;272;2024
46;Valencia/València;134;Gilet;3887;1979;1908;2024
46;Valencia/València;135;Godella;13437;6441;6996;2024
46;Valencia/València;136;Godelleta;4182;2132;2050;2024
46;Valencia/València;137;Granja de la Costera, la;294;146;148;2024
46;Valencia/València;138;Guadasséquies;468;228;240;2024
46;Valencia/València;139;Guadassuar;5992;2901;3091;2024
46;Valencia/València;140;Guardamar de la Safor;607;316;291;2024
46;Valencia/València;141;Higueruelas;534;279;255;2024
46;Valencia/València;142;Jalance;803;415;388;2024
46;Valencia/València;143;Xeraco;6044;3030;3014;2024
46;Valencia/València;144;Jarafuel;757;390;367;2024
46;Valencia/València;145;Xàtiva;30378;14871;15507;2024
46;Valencia/València;146;Xeresa;2341;1178;1163;2024
46;Valencia/València;147;Llíria;25077;12618;12459;2024
46;Valencia/València;148;Loriguilla;2186;1124;1062;2024
46;Valencia/València;149;Losa del Obispo;523;263;260;2024
46;Valencia/València;150;Llutxent;2335;1190;1145;2024
46;Valencia/València;151;Llocnou d'En Fenollet;924;472;452;2024
46;Valencia/València;152;Llocnou de la Corona;121;59;62;2024
46;Valencia/València;153;Llocnou de Sant Jeroni;586;294;292;2024
46;Valencia/València;154;Llanera de Ranes;1057;540;517;2024
46;Valencia/València;155;Llaurí;1236;638;598;2024
46;Valencia/València;156;Llombai;2767;1374;1393;2024
46;Valencia/València;157;Llosa de Ranes, la;3736;1901;1835;2024
46;Valencia/València;158;Macastre;1475;776;699;2024
46;Valencia/València;159;Manises;32273;15960;16313;2024
46;Valencia/València;160;Manuel;2524;1266;1258;2024
46;Valencia/València;161;Marines;1921;991;930;2024
46;Valencia/València;162;Massalavés;1811;925;886;2024
46;Valencia/València;163;Massalfassar;2653;1319;1334;2024
46;Valencia/València;164;Massamagrell;17216;8496;8720;2024
46;Valencia/València;165;Massanassa;10345;5022;5323;2024
46;Valencia/València;166;Meliana;10990;5373;5617;2024
46;Valencia/València;167;Millares;329;166;163;2024
46;Valencia/València;168;Miramar;3020;1528;1492;2024
46;Valencia/València;169;Mislata;46153;22298;23855;2024
46;Valencia/València;170;Moixent/Mogente;4373;2183;2190;2024
46;Valencia/València;171;Moncada;21993;10640;11353;2024
46;Valencia/València;172;Montserrat;9656;4977;4679;2024
46;Valencia/València;173;Montaverner;1626;807;819;2024
46;Valencia/València;174;Montesa;1134;571;563;2024
46;Valencia/València;175;Montitxelvo/Montichelvo;577;280;297;2024
46;Valencia/València;176;Montroi/Montroy;3477;1837;1640;2024
46;Valencia/València;177;Museros;6739;3428;3311;2024
46;Valencia/València;178;Nàquera/Náquera;8308;4303;4005;2024
46;Valencia/València;179;Navarrés;3055;1519;1536;2024
46;Valencia/València;180;Novetlè;849;417;432;2024
46;Valencia/València;181;Oliva;26122;12827;13295;2024
46;Valencia/València;182;Olocau;2425;1288;1137;2024
46;Valencia/València;183;Olleria, l';8648;4356;4292;2024
46;Valencia/València;184;Ontinyent;36430;17975;18455;2024
46;Valencia/València;185;Otos;440;227;213;2024
46;Valencia/València;186;Paiporta;27748;13556;14192;2024
46;Valencia/València;187;Palma de Gandía;1816;960;856;2024
46;Valencia/València;188;Palmera;1028;518;510;2024
46;Valencia/València;189;Palomar, el;598;307;291;2024
46;Valencia/València;190;Paterna;74822;36814;38008;2024
46;Valencia/València;191;Pedralba;3124;1628;1496;2024
46;Valencia/València;192;Petrés;1142;573;569;2024
46;Valencia/València;193;Picanya;11876;5864;6012;2024
46;Valencia/València;194;Picassent;22695;11333;11362;2024
46;Valencia/València;195;Piles;3195;1570;1625;2024
46;Valencia/València;196;Pinet;148;72;76;2024
46;Valencia/València;197;Polinyà de Xúquer;2551;1315;1236;2024
46;Valencia/València;198;Potries;1104;571;533;2024
46;Valencia/València;199;Pobla de Farnals, la;9076;4499;4577;2024
46;Valencia/València;200;Pobla del Duc, la;2449;1184;1265;2024
46;Valencia/València;201;Puebla de San Miguel;51;38;13;2024
46;Valencia/València;202;Pobla de Vallbona, la;27056;13528;13528;2024
46;Valencia/València;203;Pobla Llarga, la;4569;2293;2276;2024
46;Valencia/València;204;Puig de Santa Maria, el;9367;4565;4802;2024
46;Valencia/València;205;Puçol;21298;10464;10834;2024
46;Valencia/València;206;Quesa;675;344;331;2024
46;Valencia/València;207;Rafelbunyol;9710;4735;4975;2024
46;Valencia/València;208;Rafelcofer;1374;669;705;2024
46;Valencia/València;209;Rafelguaraf;2350;1162;1188;2024
46;Valencia/València;210;Ráfol de Salem;464;235;229;2024
46;Valencia/València;211;Real de Gandia, el;2670;1351;1319;2024
46;Valencia/València;212;Real;2435;1267;1168;2024
46;Valencia/València;213;Requena;20740;10408;10332;2024
46;Valencia/València;214;Riba-roja de Túria;24230;12247;11983;2024
46;Valencia/València;215;Riola;1770;879;891;2024
46;Valencia/València;216;Rocafort;7753;3787;3966;2024
46;Valencia/València;217;Rotglà i Corberà;1158;577;581;2024
46;Valencia/València;218;Ròtova;1271;638;633;2024
46;Valencia/València;219;Rugat;171;95;76;2024
46;Valencia/València;220;Sagunt/Sagunto;71377;34788;36589;2024
46;Valencia/València;221;Salem;394;199;195;2024
46;Valencia/València;222;Sant Joanet;526;256;270;2024
46;Valencia/València;223;Sedaví;10908;5333;5575;2024
46;Valencia/València;224;Segart;167;93;74;2024
46;Valencia/València;225;Sellent;383;200;183;2024
46;Valencia/València;226;Sempere;29;15;14;2024
46;Valencia/València;227;Senyera;1124;548;576;2024
46;Valencia/València;228;Serra;3725;1877;1848;2024
46;Valencia/València;229;Siete Aguas;1279;655;624;2024
46;Valencia/València;230;Silla;20117;9950;10167;2024
46;Valencia/València;231;Simat de la Valldigna;3289;1641;1648;2024
46;Valencia/València;232;Sinarcas;1153;606;547;2024
46;Valencia/València;233;Sollana;5035;2486;2549;2024
46;Valencia/València;234;Sot de Chera;432;232;200;2024
46;Valencia/València;235;Sueca;28480;14079;14401;2024
46;Valencia/València;236;Sumacàrcer;1042;504;538;2024
46;Valencia/València;237;Tavernes Blanques;9635;4680;4955;2024
46;Valencia/València;238;Tavernes de la Valldigna;17631;8732;8899;2024
46;Valencia/València;239;Teresa de Cofrentes;605;308;297;2024
46;Valencia/València;240;Terrateig;290;151;139;2024
46;Valencia/València;241;Titaguas;494;251;243;2024
46;Valencia/València;242;Torrebaja;391;214;177;2024
46;Valencia/València;243;Torrella;150;80;70;2024
46;Valencia/València;244;Torrent;89401;43686;45715;2024
46;Valencia/València;245;Torres Torres;750;415;335;2024
46;Valencia/València;246;Tous;1357;677;680;2024
46;Valencia/València;247;Tuéjar;1233;661;572;2024
46;Valencia/València;248;Turís;7544;3924;3620;2024
46;Valencia/València;249;Utiel;11703;5834;5869;2024
46;Valencia/València;250;València;825948;391970;433978;2024
46;Valencia/València;251;Vallada;3079;1579;1500;2024
46;Valencia/València;252;Vallanca;131;69;62;2024
46;Valencia/València;253;Vallés;148;83;65;2024
46;Valencia/València;254;Venta del Moro;1158;624;534;2024
46;Valencia/València;255;Vilallonga/Villalonga;4713;2340;2373;2024
46;Valencia/València;256;Vilamarxant;11041;5729;5312;2024
46;Valencia/València;257;Castelló;6897;3393;3504;2024
46;Valencia/València;258;Villar del Arzobispo;3775;1919;1856;2024
46;Valencia/València;259;Villargordo del Cabriel;594;301;293;2024
46;Valencia/València;260;Vinalesa;3531;1716;1815;2024
46;Valencia/València;261;Yátova;2242;1161;1081;2024
46;Valencia/València;262;Yesa, La;235;127;108;2024
46;Valencia/València;263;Zarra;386;212;174;2024
46;Valencia/València;902;Gátova;429;223;206;2024
46;Valencia/València;903;San Antonio de Benagéber;10630;5227;5403;2024
46;Valencia/València;904;Benicull de Xúquer;1144;579;565;2024
47;Valladolid;001;Adalia;50;30;20;2024
47;Valladolid;002;Aguasal;19;12;7;2024
47;Valladolid;003;Aguilar de Campos;259;156;103;2024
47;Valladolid;004;Alaejos;1407;747;660;2024
47;Valladolid;005;Alcazarén;614;334;280;2024
47;Valladolid;006;Aldea de San Miguel;218;120;98;2024
47;Valladolid;007;Aldeamayor de San Martín;6163;3151;3012;2024
47;Valladolid;008;Almenara de Adaja;22;14;8;2024
47;Valladolid;009;Amusquillo;99;59;40;2024
47;Valladolid;010;Arroyo de la Encomienda;22268;11103;11165;2024
47;Valladolid;011;Ataquines;573;314;259;2024
47;Valladolid;012;Bahabón;93;45;48;2024
47;Valladolid;013;Barcial de la Loma;100;51;49;2024
47;Valladolid;014;Barruelo del Valle;52;29;23;2024
47;Valladolid;015;Becilla de Valderaduey;200;118;82;2024
47;Valladolid;016;Benafarces;70;37;33;2024
47;Valladolid;017;Bercero;177;100;77;2024
47;Valladolid;018;Berceruelo;36;21;15;2024
47;Valladolid;019;Berrueces;93;50;43;2024
47;Valladolid;020;Bobadilla del Campo;284;158;126;2024
47;Valladolid;021;Bocigas;75;41;34;2024
47;Valladolid;022;Bocos de Duero;81;42;39;2024
47;Valladolid;023;Boecillo;4357;2179;2178;2024
47;Valladolid;024;Bolaños de Campos;254;142;112;2024
47;Valladolid;025;Brahojos de Medina;101;53;48;2024
47;Valladolid;026;Bustillo de Chaves;65;37;28;2024
47;Valladolid;027;Cabezón de Pisuerga;3895;1988;1907;2024
47;Valladolid;028;Cabezón de Valderaduey;33;17;16;2024
47;Valladolid;029;Cabreros del Monte;56;32;24;2024
47;Valladolid;030;Campaspero;1004;558;446;2024
47;Valladolid;031;Campillo, El;198;119;79;2024
47;Valladolid;032;Camporredondo;147;87;60;2024
47;Valladolid;033;Canalejas de Peñafiel;252;132;120;2024
47;Valladolid;034;Canillas de Esgueva;73;44;29;2024
47;Valladolid;035;Carpio;938;506;432;2024
47;Valladolid;036;Casasola de Arión;215;126;89;2024
47;Valladolid;037;Castrejón de Trabancos;176;91;85;2024
47;Valladolid;038;Castrillo de Duero;121;64;57;2024
47;Valladolid;039;Castrillo-Tejeriego;152;89;63;2024
47;Valladolid;040;Castrobol;45;24;21;2024
47;Valladolid;041;Castrodeza;142;92;50;2024
47;Valladolid;042;Castromembibre;49;33;16;2024
47;Valladolid;043;Castromonte;326;168;158;2024
47;Valladolid;044;Castronuevo de Esgueva;393;210;183;2024
47;Valladolid;045;Castronuño;767;378;389;2024
47;Valladolid;046;Castroponce;128;67;61;2024
47;Valladolid;047;Castroverde de Cerrato;189;121;68;2024
47;Valladolid;048;Ceinos de Campos;172;104;68;2024
47;Valladolid;049;Cervillego de la Cruz;91;53;38;2024
47;Valladolid;050;Cigales;5364;2763;2601;2024
47;Valladolid;051;Ciguñuela;358;184;174;2024
47;Valladolid;052;Cistérniga;9281;4657;4624;2024
47;Valladolid;053;Cogeces de Íscar;144;74;70;2024
47;Valladolid;054;Cogeces del Monte;644;347;297;2024
47;Valladolid;055;Corcos;210;119;91;2024
47;Valladolid;056;Corrales de Duero;105;62;43;2024
47;Valladolid;057;Cubillas de Santa Marta;404;236;168;2024
47;Valladolid;058;Cuenca de Campos;192;101;91;2024
47;Valladolid;059;Curiel de Duero;119;75;44;2024
47;Valladolid;060;Encinas de Esgueva;218;120;98;2024
47;Valladolid;061;Esguevillas de Esgueva;258;146;112;2024
47;Valladolid;062;Fombellida;175;103;72;2024
47;Valladolid;063;Fompedraza;111;59;52;2024
47;Valladolid;064;Fontihoyuelo;31;20;11;2024
47;Valladolid;065;Fresno el Viejo;836;451;385;2024
47;Valladolid;066;Fuensaldaña;2137;1100;1037;2024
47;Valladolid;067;Fuente el Sol;153;82;71;2024
47;Valladolid;068;Fuente-Olmedo;42;21;21;2024
47;Valladolid;069;Gallegos de Hornija;109;53;56;2024
47;Valladolid;070;Gatón de Campos;41;24;17;2024
47;Valladolid;071;Geria;488;227;261;2024
47;Valladolid;073;Herrín de Campos;112;63;49;2024
47;Valladolid;074;Hornillos de Eresma;171;98;73;2024
47;Valladolid;075;Íscar;6396;3225;3171;2024
47;Valladolid;076;Laguna de Duero;22907;11349;11558;2024
47;Valladolid;077;Langayo;250;157;93;2024
47;Valladolid;078;Lomoviejo;161;87;74;2024
47;Valladolid;079;Llano de Olmedo;51;27;24;2024
47;Valladolid;080;Manzanillo;48;27;21;2024
47;Valladolid;081;Marzales;41;18;23;2024
47;Valladolid;082;Matapozuelos;1015;513;502;2024
47;Valladolid;083;Matilla de los Caños;113;63;50;2024
47;Valladolid;084;Mayorga;1409;706;703;2024
47;Valladolid;085;Medina del Campo;20097;9872;10225;2024
47;Valladolid;086;Medina de Rioseco;4537;2239;2298;2024
47;Valladolid;087;Megeces;422;225;197;2024
47;Valladolid;088;Melgar de Abajo;114;61;53;2024
47;Valladolid;089;Melgar de Arriba;162;95;67;2024
47;Valladolid;090;Mojados;3393;1764;1629;2024
47;Valladolid;091;Monasterio de Vega;79;43;36;2024
47;Valladolid;092;Montealegre de Campos;105;63;42;2024
47;Valladolid;093;Montemayor de Pililla;860;464;396;2024
47;Valladolid;094;Moral de la Reina;146;82;64;2024
47;Valladolid;095;Moraleja de las Panaderas;38;23;15;2024
47;Valladolid;096;Morales de Campos;130;73;57;2024
47;Valladolid;097;Mota del Marqués;330;177;153;2024
47;Valladolid;098;Mucientes;691;344;347;2024
47;Valladolid;099;Mudarra, La;169;88;81;2024
47;Valladolid;100;Muriel;111;57;54;2024
47;Valladolid;101;Nava del Rey;1925;969;956;2024
47;Valladolid;102;Nueva Villa de las Torres;278;158;120;2024
47;Valladolid;103;Olivares de Duero;327;182;145;2024
47;Valladolid;104;Olmedo;3564;1759;1805;2024
47;Valladolid;105;Olmos de Esgueva;197;107;90;2024
47;Valladolid;106;Olmos de Peñafiel;38;23;15;2024
47;Valladolid;109;Palazuelo de Vedija;164;87;77;2024
47;Valladolid;110;Parrilla, La;480;236;244;2024
47;Valladolid;111;Pedraja de Portillo, La;1175;602;573;2024
47;Valladolid;112;Pedrajas de San Esteban;3406;1738;1668;2024
47;Valladolid;113;Pedrosa del Rey;148;83;65;2024
47;Valladolid;114;Peñafiel;5188;2657;2531;2024
47;Valladolid;115;Peñaflor de Hornija;350;184;166;2024
47;Valladolid;116;Pesquera de Duero;423;228;195;2024
47;Valladolid;117;Piña de Esgueva;310;165;145;2024
47;Valladolid;118;Piñel de Abajo;163;93;70;2024
47;Valladolid;119;Piñel de Arriba;88;46;42;2024
47;Valladolid;121;Pollos;562;313;249;2024
47;Valladolid;122;Portillo;2368;1211;1157;2024
47;Valladolid;123;Pozal de Gallinas;538;286;252;2024
47;Valladolid;124;Pozaldez;500;268;232;2024
47;Valladolid;125;Pozuelo de la Orden;50;32;18;2024
47;Valladolid;126;Puras;45;25;20;2024
47;Valladolid;127;Quintanilla de Arriba;155;88;67;2024
47;Valladolid;128;Quintanilla del Molar;47;22;25;2024
47;Valladolid;129;Quintanilla de Onésimo;992;528;464;2024
47;Valladolid;130;Quintanilla de Trigueros;101;52;49;2024
47;Valladolid;131;Rábano;176;94;82;2024
47;Valladolid;132;Ramiro;46;27;19;2024
47;Valladolid;133;Renedo de Esgueva;3972;2017;1955;2024
47;Valladolid;134;Roales de Campos;165;91;74;2024
47;Valladolid;135;Robladillo;87;49;38;2024
47;Valladolid;137;Roturas;26;16;10;2024
47;Valladolid;138;Rubí de Bracamonte;214;124;90;2024
47;Valladolid;139;Rueda;1103;574;529;2024
47;Valladolid;140;Saelices de Mayorga;111;70;41;2024
47;Valladolid;141;Salvador de Zapardiel;103;57;46;2024
47;Valladolid;142;San Cebrián de Mazote;103;63;40;2024
47;Valladolid;143;San Llorente;94;56;38;2024
47;Valladolid;144;San Martín de Valvení;84;45;39;2024
47;Valladolid;145;San Miguel del Arroyo;646;344;302;2024
47;Valladolid;146;San Miguel del Pino;367;185;182;2024
47;Valladolid;147;San Pablo de la Moraleja;107;62;45;2024
47;Valladolid;148;San Pedro de Latarce;434;238;196;2024
47;Valladolid;149;San Pelayo;48;23;25;2024
47;Valladolid;150;San Román de Hornija;301;143;158;2024
47;Valladolid;151;San Salvador;23;14;9;2024
47;Valladolid;152;Santa Eufemia del Arroyo;73;43;30;2024
47;Valladolid;153;Santervás de Campos;108;59;49;2024
47;Valladolid;154;Santibáñez de Valcorba;187;111;76;2024
47;Valladolid;155;Santovenia de Pisuerga;4703;2382;2321;2024
47;Valladolid;156;San Vicente del Palacio;160;83;77;2024
47;Valladolid;157;Sardón de Duero;607;318;289;2024
47;Valladolid;158;Seca, La;1013;535;478;2024
47;Valladolid;159;Serrada;1109;573;536;2024
47;Valladolid;160;Siete Iglesias de Trabancos;419;220;199;2024
47;Valladolid;161;Simancas;5538;2798;2740;2024
47;Valladolid;162;Tamariz de Campos;84;48;36;2024
47;Valladolid;163;Tiedra;282;142;140;2024
47;Valladolid;164;Tordehumos;375;203;172;2024
47;Valladolid;165;Tordesillas;8638;4356;4282;2024
47;Valladolid;166;Torrecilla de la Abadesa;250;118;132;2024
47;Valladolid;167;Torrecilla de la Orden;227;116;111;2024
47;Valladolid;168;Torrecilla de la Torre;28;19;9;2024
47;Valladolid;169;Torre de Esgueva;62;33;29;2024
47;Valladolid;170;Torre de Peñafiel;57;36;21;2024
47;Valladolid;171;Torrelobatón;386;205;181;2024
47;Valladolid;172;Torrescárcela;164;87;77;2024
47;Valladolid;173;Traspinedo;1240;652;588;2024
47;Valladolid;174;Trigueros del Valle;314;168;146;2024
47;Valladolid;175;Tudela de Duero;8786;4443;4343;2024
47;Valladolid;176;Unión de Campos, La;202;95;107;2024
47;Valladolid;177;Urones de Castroponce;100;61;39;2024
47;Valladolid;178;Urueña;203;111;92;2024
47;Valladolid;179;Valbuena de Duero;399;230;169;2024
47;Valladolid;180;Valdearcos de la Vega;64;37;27;2024
47;Valladolid;181;Valdenebro de los Valles;185;105;80;2024
47;Valladolid;182;Valdestillas;1612;833;779;2024
47;Valladolid;183;Valdunquillo;116;59;57;2024
47;Valladolid;184;Valoria la Buena;745;415;330;2024
47;Valladolid;185;Valverde de Campos;91;53;38;2024
47;Valladolid;186;Valladolid;300618;140820;159798;2024
47;Valladolid;187;Vega de Ruiponce;81;47;34;2024
47;Valladolid;188;Vega de Valdetronco;91;50;41;2024
47;Valladolid;189;Velascálvaro;163;85;78;2024
47;Valladolid;190;Velilla;113;57;56;2024
47;Valladolid;191;Velliza;121;80;41;2024
47;Valladolid;192;Ventosa de la Cuesta;101;56;45;2024
47;Valladolid;193;Viana de Cega;2292;1173;1119;2024
47;Valladolid;194;Viloria;331;172;159;2024
47;Valladolid;195;Villabáñez;507;272;235;2024
47;Valladolid;196;Villabaruz de Campos;32;15;17;2024
47;Valladolid;197;Villabrágima;1048;558;490;2024
47;Valladolid;198;Villacarralón;66;44;22;2024
47;Valladolid;199;Villacid de Campos;82;45;37;2024
47;Valladolid;200;Villaco;75;48;27;2024
47;Valladolid;203;Villafrades de Campos;61;28;33;2024
47;Valladolid;204;Villafranca de Duero;241;131;110;2024
47;Valladolid;205;Villafrechós;468;257;211;2024
47;Valladolid;206;Villafuerte;86;50;36;2024
47;Valladolid;207;Villagarcía de Campos;288;172;116;2024
47;Valladolid;208;Villagómez la Nueva;51;28;23;2024
47;Valladolid;209;Villalán de Campos;32;20;12;2024
47;Valladolid;210;Villalar de los Comuneros;490;240;250;2024
47;Valladolid;211;Villalba de la Loma;58;31;27;2024
47;Valladolid;212;Villalba de los Alcores;392;215;177;2024
47;Valladolid;213;Villalbarba;100;50;50;2024
47;Valladolid;214;Villalón de Campos;1496;738;758;2024
47;Valladolid;215;Villamuriel de Campos;51;27;24;2024
47;Valladolid;216;Villán de Tordesillas;122;72;50;2024
47;Valladolid;217;Villanubla;2915;1521;1394;2024
47;Valladolid;218;Villanueva de Duero;1258;665;593;2024
47;Valladolid;219;Villanueva de la Condesa;59;26;33;2024
47;Valladolid;220;Villanueva de los Caballeros;157;87;70;2024
47;Valladolid;221;Villanueva de los Infantes;112;67;45;2024
47;Valladolid;222;Villanueva de San Mancio;102;56;46;2024
47;Valladolid;223;Villardefrades;136;81;55;2024
47;Valladolid;224;Villarmentero de Esgueva;102;54;48;2024
47;Valladolid;225;Villasexmir;67;39;28;2024
47;Valladolid;226;Villavaquerín;145;82;63;2024
47;Valladolid;227;Villavellid;53;29;24;2024
47;Valladolid;228;Villaverde de Medina;529;278;251;2024
47;Valladolid;229;Villavicencio de los Caballeros;221;115;106;2024
47;Valladolid;230;Wamba;295;161;134;2024
47;Valladolid;231;Zaratán;6383;3245;3138;2024
47;Valladolid;232;Zarza, La;118;67;51;2024
48;Bizkaia;001;Abadiño;7742;3858;3884;2024
48;Bizkaia;002;Abanto y Ciérvana-Abanto Zierbena;9409;4692;4717;2024
48;Bizkaia;003;Amorebieta-Etxano;19678;9650;10028;2024
48;Bizkaia;004;Amoroto;394;210;184;2024
48;Bizkaia;005;Arakaldo;160;74;86;2024
48;Bizkaia;006;Arantzazu;394;198;196;2024
48;Bizkaia;007;Munitibar-Arbatzegi Gerrikaitz;466;262;204;2024
48;Bizkaia;008;Artzentales;736;382;354;2024
48;Bizkaia;009;Arrankudiaga-Zollo;1007;498;509;2024
48;Bizkaia;010;Arrieta;579;300;279;2024
48;Bizkaia;011;Arrigorriaga;11952;5847;6105;2024
48;Bizkaia;012;Bakio;2821;1399;1422;2024
48;Bizkaia;013;Barakaldo;101984;49299;52685;2024
48;Bizkaia;014;Barrika;1549;784;765;2024
48;Bizkaia;015;Basauri;40388;19562;20826;2024
48;Bizkaia;016;Berango;7647;3721;3926;2024
48;Bizkaia;017;Bermeo;17042;8385;8657;2024
48;Bizkaia;018;Berriatua;1247;673;574;2024
48;Bizkaia;019;Berriz;4600;2281;2319;2024
48;Bizkaia;020;Bilbao;348089;165223;182866;2024
48;Bizkaia;021;Busturia;1656;819;837;2024
48;Bizkaia;022;Karrantza Harana/Valle de Carranza;2711;1418;1293;2024
48;Bizkaia;023;Artea;748;382;366;2024
48;Bizkaia;024;Zeanuri;1250;625;625;2024
48;Bizkaia;025;Zeberio;1081;550;531;2024
48;Bizkaia;026;Dima;1505;779;726;2024
48;Bizkaia;027;Durango;29887;14590;15297;2024
48;Bizkaia;028;Ea;842;438;404;2024
48;Bizkaia;029;Etxebarri;11941;5960;5981;2024
48;Bizkaia;030;Etxebarria;774;394;380;2024
48;Bizkaia;031;Elantxobe;349;168;181;2024
48;Bizkaia;032;Elorrio;7266;3530;3736;2024
48;Bizkaia;033;Ereño;272;150;122;2024
48;Bizkaia;034;Ermua;15627;7736;7891;2024
48;Bizkaia;035;Fruiz;576;277;299;2024
48;Bizkaia;036;Galdakao;24774;12128;12646;2024
48;Bizkaia;037;Galdames;821;435;386;2024
48;Bizkaia;038;Gamiz-Fika;1381;697;684;2024
48;Bizkaia;039;Garai;342;168;174;2024
48;Bizkaia;040;Gatika;1633;824;809;2024
48;Bizkaia;041;Gautegiz Arteaga;878;445;433;2024
48;Bizkaia;042;Gordexola;1711;866;845;2024
48;Bizkaia;043;Gorliz;6015;2975;3040;2024
48;Bizkaia;044;Getxo;75981;35624;40357;2024
48;Bizkaia;045;Güeñes;6771;3258;3513;2024
48;Bizkaia;046;Gernika-Lumo;17033;8201;8832;2024
48;Bizkaia;047;Gizaburuaga;197;106;91;2024
48;Bizkaia;048;Ibarrangelu;680;354;326;2024
48;Bizkaia;049;Ispaster;712;372;340;2024
48;Bizkaia;050;Izurtza;230;152;78;2024
48;Bizkaia;051;Lanestosa;246;130;116;2024
48;Bizkaia;052;Larrabetzu;2047;995;1052;2024
48;Bizkaia;053;Laukiz;1245;607;638;2024
48;Bizkaia;054;Leioa;32683;15979;16704;2024
48;Bizkaia;055;Lemoa;3586;1810;1776;2024
48;Bizkaia;056;Lemoiz;1337;704;633;2024
48;Bizkaia;057;Lekeitio;7163;3529;3634;2024
48;Bizkaia;058;Mallabia;1157;595;562;2024
48;Bizkaia;059;Mañaria;531;280;251;2024
48;Bizkaia;060;Markina-Xemein;5078;2548;2530;2024
48;Bizkaia;061;Maruri-Jatabe;1073;556;517;2024
48;Bizkaia;062;Mendata;380;201;179;2024
48;Bizkaia;063;Mendexa;424;223;201;2024
48;Bizkaia;064;Meñaka;767;400;367;2024
48;Bizkaia;065;Ugao-Miraballes;4175;2102;2073;2024
48;Bizkaia;066;Morga;412;216;196;2024
48;Bizkaia;067;Muxika;1545;811;734;2024
48;Bizkaia;068;Mundaka;1828;902;926;2024
48;Bizkaia;069;Mungia;17997;8734;9263;2024
48;Bizkaia;070;Aulesti;643;319;324;2024
48;Bizkaia;071;Muskiz;7361;3600;3761;2024
48;Bizkaia;072;Otxandio;1357;693;664;2024
48;Bizkaia;073;Ondarroa;8113;4054;4059;2024
48;Bizkaia;074;Urduña/Orduña;4203;2168;2035;2024
48;Bizkaia;075;Orozko;2666;1331;1335;2024
48;Bizkaia;076;Sukarrieta;353;179;174;2024
48;Bizkaia;077;Plentzia;4390;2138;2252;2024
48;Bizkaia;078;Portugalete;44766;21331;23435;2024
48;Bizkaia;079;Errigoiti;511;272;239;2024
48;Bizkaia;080;Valle de Trápaga-Trapagaran;11898;5804;6094;2024
48;Bizkaia;081;Lezama;2459;1223;1236;2024
48;Bizkaia;082;Santurtzi;46247;22228;24019;2024
48;Bizkaia;083;Ortuella;8629;4239;4390;2024
48;Bizkaia;084;Sestao;28228;13610;14618;2024
48;Bizkaia;085;Sopela;14940;7393;7547;2024
48;Bizkaia;086;Sopuerta;2765;1393;1372;2024
48;Bizkaia;087;Trucios-Turtzioz;515;271;244;2024
48;Bizkaia;088;Ubide;164;82;82;2024
48;Bizkaia;089;Urduliz;5711;2794;2917;2024
48;Bizkaia;090;Balmaseda;7633;3693;3940;2024
48;Bizkaia;091;Atxondo;1356;687;669;2024
48;Bizkaia;092;Bedia;1117;537;580;2024
48;Bizkaia;093;Areatza;1287;628;659;2024
48;Bizkaia;094;Igorre;4330;2111;2219;2024
48;Bizkaia;095;Zaldibar;3027;1534;1493;2024
48;Bizkaia;096;Zalla;8316;4068;4248;2024
48;Bizkaia;097;Zaratamo;1611;813;798;2024
48;Bizkaia;901;Derio;7168;3528;3640;2024
48;Bizkaia;902;Erandio;24662;11913;12749;2024
48;Bizkaia;903;Loiu;2359;1169;1190;2024
48;Bizkaia;904;Sondika;4587;2223;2364;2024
48;Bizkaia;905;Zamudio;3314;1654;1660;2024
48;Bizkaia;906;Forua;949;455;494;2024
48;Bizkaia;907;Kortezubi;444;211;233;2024
48;Bizkaia;908;Murueta;322;168;154;2024
48;Bizkaia;909;Nabarniz;274;137;137;2024
48;Bizkaia;910;Iurreta;3873;1919;1954;2024
48;Bizkaia;911;Ajangiz;475;248;227;2024
48;Bizkaia;912;Alonsotegi;3020;1494;1526;2024
48;Bizkaia;913;Zierbena;1493;789;704;2024
48;Bizkaia;914;Arratzu;414;195;219;2024
48;Bizkaia;915;Ziortza-Bolibar;409;215;194;2024
48;Bizkaia;916;Usansolo;4572;2250;2322;2024
49;Zamora;002;Abezames;60;34;26;2024
49;Zamora;003;Alcañices;1061;559;502;2024
49;Zamora;004;Alcubilla de Nogales;108;58;50;2024
49;Zamora;005;Alfaraz de Sayago;124;75;49;2024
49;Zamora;006;Algodre;135;74;61;2024
49;Zamora;007;Almaraz de Duero;397;208;189;2024
49;Zamora;008;Almeida de Sayago;422;236;186;2024
49;Zamora;009;Andavías;420;213;207;2024
49;Zamora;010;Arcenillas;448;229;219;2024
49;Zamora;011;Arcos de la Polvorosa;216;125;91;2024
49;Zamora;012;Argañín;80;39;41;2024
49;Zamora;013;Argujillo;218;110;108;2024
49;Zamora;014;Arquillinos;113;61;52;2024
49;Zamora;015;Arrabalde;194;101;93;2024
49;Zamora;016;Aspariegos;225;98;127;2024
49;Zamora;017;Asturianos;260;133;127;2024
49;Zamora;018;Ayoó de Vidriales;274;141;133;2024
49;Zamora;019;Barcial del Barco;253;133;120;2024
49;Zamora;020;Belver de los Montes;253;141;112;2024
49;Zamora;021;Benavente;17246;8276;8970;2024
49;Zamora;022;Benegiles;268;145;123;2024
49;Zamora;023;Bermillo de Sayago;1026;551;475;2024
49;Zamora;024;Bóveda de Toro, La;676;348;328;2024
49;Zamora;025;Bretó;166;99;67;2024
49;Zamora;026;Bretocino;195;103;92;2024
49;Zamora;027;Brime de Sog;116;55;61;2024
49;Zamora;028;Brime de Urz;99;58;41;2024
49;Zamora;029;Burganes de Valverde;618;328;290;2024
49;Zamora;030;Bustillo del Oro;79;46;33;2024
49;Zamora;031;Cabañas de Sayago;151;80;71;2024
49;Zamora;032;Calzadilla de Tera;287;144;143;2024
49;Zamora;033;Camarzana de Tera;746;384;362;2024
49;Zamora;034;Cañizal;421;225;196;2024
49;Zamora;035;Cañizo;201;112;89;2024
49;Zamora;036;Carbajales de Alba;466;241;225;2024
49;Zamora;037;Carbellino;182;102;80;2024
49;Zamora;038;Casaseca de Campeán;86;50;36;2024
49;Zamora;039;Casaseca de las Chanas;373;198;175;2024
49;Zamora;040;Castrillo de la Guareña;118;65;53;2024
49;Zamora;041;Castrogonzalo;430;235;195;2024
49;Zamora;042;Castronuevo;218;116;102;2024
49;Zamora;043;Castroverde de Campos;256;137;119;2024
49;Zamora;044;Cazurra;74;42;32;2024
49;Zamora;046;Cerecinos de Campos;234;127;107;2024
49;Zamora;047;Cerecinos del Carrizal;108;66;42;2024
49;Zamora;048;Cernadilla;110;58;52;2024
49;Zamora;050;Cobreros;545;299;246;2024
49;Zamora;052;Coomonte;179;96;83;2024
49;Zamora;053;Coreses;1037;534;503;2024
49;Zamora;054;Corrales del Vino;929;461;468;2024
49;Zamora;055;Cotanes del Monte;82;44;38;2024
49;Zamora;056;Cubillos;295;146;149;2024
49;Zamora;057;Cubo de Benavente;117;64;53;2024
49;Zamora;058;Cubo de Tierra del Vino, El;298;160;138;2024
49;Zamora;059;Cuelgamures;80;48;32;2024
49;Zamora;061;Entrala;127;72;55;2024
49;Zamora;062;Espadañedo;104;59;45;2024
49;Zamora;063;Faramontanos de Tábara;340;182;158;2024
49;Zamora;064;Fariza;496;261;235;2024
49;Zamora;065;Fermoselle;1149;589;560;2024
49;Zamora;066;Ferreras de Abajo;451;220;231;2024
49;Zamora;067;Ferreras de Arriba;358;198;160;2024
49;Zamora;068;Ferreruela;419;234;185;2024
49;Zamora;069;Figueruela de Arriba;318;162;156;2024
49;Zamora;071;Fonfría;763;408;355;2024
49;Zamora;075;Fresno de la Polvorosa;114;61;53;2024
49;Zamora;076;Fresno de la Ribera;342;175;167;2024
49;Zamora;077;Fresno de Sayago;143;72;71;2024
49;Zamora;078;Friera de Valverde;127;69;58;2024
49;Zamora;079;Fuente Encalada;89;48;41;2024
49;Zamora;080;Fuentelapeña;599;319;280;2024
49;Zamora;081;Fuentesaúco;1606;816;790;2024
49;Zamora;082;Fuentes de Ropel;361;193;168;2024
49;Zamora;083;Fuentesecas;44;24;20;2024
49;Zamora;084;Fuentespreadas;290;152;138;2024
49;Zamora;085;Galende;1024;523;501;2024
49;Zamora;086;Gallegos del Pan;116;66;50;2024
49;Zamora;087;Gallegos del Río;467;262;205;2024
49;Zamora;088;Gamones;92;52;40;2024
49;Zamora;090;Gema;197;105;92;2024
49;Zamora;091;Granja de Moreruela;250;130;120;2024
49;Zamora;092;Granucillo;104;60;44;2024
49;Zamora;093;Guarrate;314;158;156;2024
49;Zamora;094;Hermisende;216;120;96;2024
49;Zamora;095;Hiniesta, La;307;165;142;2024
49;Zamora;096;Jambrina;149;82;67;2024
49;Zamora;097;Justel;78;50;28;2024
49;Zamora;098;Losacino;187;105;82;2024
49;Zamora;099;Losacio;89;49;40;2024
49;Zamora;100;Lubián;290;152;138;2024
49;Zamora;101;Luelmo;149;82;67;2024
49;Zamora;102;Maderal, El;169;93;76;2024
49;Zamora;103;Madridanos;453;240;213;2024
49;Zamora;104;Mahide;310;173;137;2024
49;Zamora;105;Maire de Castroponce;140;76;64;2024
49;Zamora;107;Malva;100;47;53;2024
49;Zamora;108;Manganeses de la Lampreana;439;230;209;2024
49;Zamora;109;Manganeses de la Polvorosa;641;313;328;2024
49;Zamora;110;Manzanal de Arriba;350;185;165;2024
49;Zamora;111;Manzanal del Barco;128;67;61;2024
49;Zamora;112;Manzanal de los Infantes;135;74;61;2024
49;Zamora;113;Matilla de Arzón;157;91;66;2024
49;Zamora;114;Matilla la Seca;36;21;15;2024
49;Zamora;115;Mayalde;152;85;67;2024
49;Zamora;116;Melgar de Tera;351;181;170;2024
49;Zamora;117;Micereces de Tera;414;216;198;2024
49;Zamora;118;Milles de la Polvorosa;199;110;89;2024
49;Zamora;119;Molacillos;233;127;106;2024
49;Zamora;120;Molezuelas de la Carballeda;46;25;21;2024
49;Zamora;121;Mombuey;386;201;185;2024
49;Zamora;122;Monfarracinos;995;514;481;2024
49;Zamora;123;Montamarta;543;295;248;2024
49;Zamora;124;Moral de Sayago;262;153;109;2024
49;Zamora;125;Moraleja del Vino;1806;911;895;2024
49;Zamora;126;Moraleja de Sayago;299;152;147;2024
49;Zamora;127;Morales del Vino;3085;1613;1472;2024
49;Zamora;128;Morales de Rey;517;258;259;2024
49;Zamora;129;Morales de Toro;919;472;447;2024
49;Zamora;130;Morales de Valverde;150;77;73;2024
49;Zamora;131;Moralina;219;116;103;2024
49;Zamora;132;Moreruela de los Infanzones;324;163;161;2024
49;Zamora;133;Moreruela de Tábara;288;154;134;2024
49;Zamora;134;Muelas de los Caballeros;188;110;78;2024
49;Zamora;135;Muelas del Pan;616;331;285;2024
49;Zamora;136;Muga de Sayago;317;155;162;2024
49;Zamora;137;Navianos de Valverde;163;90;73;2024
49;Zamora;138;Olmillos de Castro;193;104;89;2024
49;Zamora;139;Otero de Bodas;166;81;85;2024
49;Zamora;141;Pajares de la Lampreana;280;144;136;2024
49;Zamora;142;Palacios del Pan;240;124;116;2024
49;Zamora;143;Palacios de Sanabria;230;116;114;2024
49;Zamora;145;Pedralba de la Pradería;195;112;83;2024
49;Zamora;146;Pego, El;284;152;132;2024
49;Zamora;147;Peleagonzalo;294;152;142;2024
49;Zamora;148;Peleas de Abajo;255;122;133;2024
49;Zamora;149;Peñausende;375;191;184;2024
49;Zamora;150;Peque;122;56;66;2024
49;Zamora;151;Perdigón, El;650;343;307;2024
49;Zamora;152;Pereruela;496;275;221;2024
49;Zamora;153;Perilla de Castro;148;85;63;2024
49;Zamora;154;Pías;94;54;40;2024
49;Zamora;155;Piedrahita de Castro;106;56;50;2024
49;Zamora;156;Pinilla de Toro;184;97;87;2024
49;Zamora;157;Pino del Oro;175;84;91;2024
49;Zamora;158;Piñero, El;215;110;105;2024
49;Zamora;159;Pobladura del Valle;273;145;128;2024
49;Zamora;160;Pobladura de Valderaduey;35;21;14;2024
49;Zamora;162;Porto;156;91;65;2024
49;Zamora;163;Pozoantiguo;190;99;91;2024
49;Zamora;164;Pozuelo de Tábara;145;80;65;2024
49;Zamora;165;Prado;53;31;22;2024
49;Zamora;166;Puebla de Sanabria;1366;659;707;2024
49;Zamora;167;Pueblica de Valverde;177;96;81;2024
49;Zamora;168;Quintanilla del Monte;95;52;43;2024
49;Zamora;169;Quintanilla del Olmo;45;22;23;2024
49;Zamora;170;Quintanilla de Urz;97;48;49;2024
49;Zamora;171;Quiruelas de Vidriales;635;338;297;2024
49;Zamora;172;Rabanales;488;269;219;2024
49;Zamora;173;Rábano de Aliste;314;160;154;2024
49;Zamora;174;Requejo;111;59;52;2024
49;Zamora;175;Revellinos;229;121;108;2024
49;Zamora;176;Riofrío de Aliste;599;330;269;2024
49;Zamora;177;Rionegro del Puente;234;124;110;2024
49;Zamora;178;Roales;1022;525;497;2024
49;Zamora;179;Robleda-Cervantes;400;210;190;2024
49;Zamora;180;Roelos de Sayago;138;69;69;2024
49;Zamora;181;Rosinos de la Requejada;305;164;141;2024
49;Zamora;183;Salce;85;40;45;2024
49;Zamora;184;Samir de los Caños;156;89;67;2024
49;Zamora;185;San Agustín del Pozo;166;85;81;2024
49;Zamora;186;San Cebrián de Castro;249;131;118;2024
49;Zamora;187;San Cristóbal de Entreviñas;1318;694;624;2024
49;Zamora;188;San Esteban del Molar;109;64;45;2024
49;Zamora;189;San Justo;215;120;95;2024
49;Zamora;190;San Martín de Valderaduey;45;22;23;2024
49;Zamora;191;San Miguel de la Ribera;252;133;119;2024
49;Zamora;192;San Miguel del Valle;119;58;61;2024
49;Zamora;193;San Pedro de Ceque;421;227;194;2024
49;Zamora;194;San Pedro de la Nave-Almendra;322;167;155;2024
49;Zamora;197;Santa Clara de Avedillo;159;77;82;2024
49;Zamora;199;Santa Colomba de las Monjas;232;114;118;2024
49;Zamora;200;Santa Cristina de la Polvorosa;1027;526;501;2024
49;Zamora;201;Santa Croya de Tera;260;135;125;2024
49;Zamora;202;Santa Eufemia del Barco;169;98;71;2024
49;Zamora;203;Santa María de la Vega;290;148;142;2024
49;Zamora;204;Santa María de Valverde;51;24;27;2024
49;Zamora;205;Santibáñez de Tera;358;188;170;2024
49;Zamora;206;Santibáñez de Vidriales;844;433;411;2024
49;Zamora;207;Santovenia;227;124;103;2024
49;Zamora;208;San Vicente de la Cabeza;323;169;154;2024
49;Zamora;209;San Vitero;429;243;186;2024
49;Zamora;210;Sanzoles;466;243;223;2024
49;Zamora;214;Tábara;748;361;387;2024
49;Zamora;216;Tapioles;124;73;51;2024
49;Zamora;219;Toro;8369;4079;4290;2024
49;Zamora;220;Torre del Valle, La;125;68;57;2024
49;Zamora;221;Torregamones;226;119;107;2024
49;Zamora;222;Torres del Carrizal;407;208;199;2024
49;Zamora;223;Trabazos;838;447;391;2024
49;Zamora;224;Trefacio;165;95;70;2024
49;Zamora;225;Uña de Quintana;121;68;53;2024
49;Zamora;226;Vadillo de la Guareña;243;137;106;2024
49;Zamora;227;Valcabado;415;215;200;2024
49;Zamora;228;Valdefinjas;59;39;20;2024
49;Zamora;229;Valdescorriel;131;69;62;2024
49;Zamora;230;Vallesa de la Guareña;68;38;30;2024
49;Zamora;231;Vega de Tera;287;145;142;2024
49;Zamora;232;Vega de Villalobos;91;43;48;2024
49;Zamora;233;Vegalatrave;79;43;36;2024
49;Zamora;234;Venialbo;431;227;204;2024
49;Zamora;235;Vezdemarbán;439;232;207;2024
49;Zamora;236;Vidayanes;76;39;37;2024
49;Zamora;237;Videmala;140;69;71;2024
49;Zamora;238;Villabrázaro;263;148;115;2024
49;Zamora;239;Villabuena del Puente;586;306;280;2024
49;Zamora;240;Villadepera;179;99;80;2024
49;Zamora;241;Villaescusa;237;128;109;2024
49;Zamora;242;Villafáfila;440;227;213;2024
49;Zamora;243;Villaferrueña;106;56;50;2024
49;Zamora;244;Villageriz;64;36;28;2024
49;Zamora;245;Villalazán;248;127;121;2024
49;Zamora;246;Villalba de la Lampreana;212;119;93;2024
49;Zamora;247;Villalcampo;379;195;184;2024
49;Zamora;248;Villalobos;193;95;98;2024
49;Zamora;249;Villalonso;79;37;42;2024
49;Zamora;250;Villalpando;1399;669;730;2024
49;Zamora;251;Villalube;147;80;67;2024
49;Zamora;252;Villamayor de Campos;339;178;161;2024
49;Zamora;255;Villamor de los Escuderos;365;194;171;2024
49;Zamora;256;Villanázar;249;136;113;2024
49;Zamora;257;Villanueva de Azoague;381;202;179;2024
49;Zamora;258;Villanueva de Campeán;117;62;55;2024
49;Zamora;259;Villanueva de las Peras;89;45;44;2024
49;Zamora;260;Villanueva del Campo;761;373;388;2024
49;Zamora;261;Villaralbo;1805;924;881;2024
49;Zamora;262;Villardeciervos;392;198;194;2024
49;Zamora;263;Villar de Fallaves;49;28;21;2024
49;Zamora;264;Villar del Buey;514;263;251;2024
49;Zamora;265;Villardiegua de la Ribera;116;58;58;2024
49;Zamora;266;Villárdiga;62;37;25;2024
49;Zamora;267;Villardondiego;127;75;52;2024
49;Zamora;268;Villarrín de Campos;415;224;191;2024
49;Zamora;269;Villaseco del Pan;207;101;106;2024
49;Zamora;270;Villavendimio;156;98;58;2024
49;Zamora;271;Villaveza del Agua;163;86;77;2024
49;Zamora;272;Villaveza de Valverde;72;33;39;2024
49;Zamora;273;Viñas;160;87;73;2024
49;Zamora;275;Zamora;59506;27543;31963;2024
50;Zaragoza;001;Abanto;80;51;29;2024
50;Zaragoza;002;Acered;141;85;56;2024
50;Zaragoza;003;Agón;133;76;57;2024
50;Zaragoza;004;Aguarón;599;320;279;2024
50;Zaragoza;005;Aguilón;273;149;124;2024
50;Zaragoza;006;Ainzón;1043;549;494;2024
50;Zaragoza;007;Aladrén;62;40;22;2024
50;Zaragoza;008;Alagón;7450;3733;3717;2024
50;Zaragoza;009;Alarba;93;51;42;2024
50;Zaragoza;010;Alberite de San Juan;84;47;37;2024
50;Zaragoza;011;Albeta;141;73;68;2024
50;Zaragoza;012;Alborge;102;58;44;2024
50;Zaragoza;013;Alcalá de Ebro;243;117;126;2024
50;Zaragoza;014;Alcalá de Moncayo;153;86;67;2024
50;Zaragoza;015;Alconchel de Ariza;78;46;32;2024
50;Zaragoza;016;Aldehuela de Liestos;49;33;16;2024
50;Zaragoza;017;Alfajarín;2415;1228;1187;2024
50;Zaragoza;018;Alfamén;1494;780;714;2024
50;Zaragoza;019;Alforque;61;35;26;2024
50;Zaragoza;020;Alhama de Aragón;925;484;441;2024
50;Zaragoza;021;Almochuel;22;12;10;2024
50;Zaragoza;022;Almolda, La;543;267;276;2024
50;Zaragoza;023;Almonacid de la Cuba;233;119;114;2024
50;Zaragoza;024;Almonacid de la Sierra;759;441;318;2024
50;Zaragoza;025;Almunia de Doña Godina, La;7937;4122;3815;2024
50;Zaragoza;026;Alpartir;589;313;276;2024
50;Zaragoza;027;Ambel;254;126;128;2024
50;Zaragoza;028;Anento;112;81;31;2024
50;Zaragoza;029;Aniñón;683;356;327;2024
50;Zaragoza;030;Añón de Moncayo;216;122;94;2024
50;Zaragoza;031;Aranda de Moncayo;117;79;38;2024
50;Zaragoza;032;Arándiga;264;150;114;2024
50;Zaragoza;033;Ardisa;76;46;30;2024
50;Zaragoza;034;Ariza;1082;552;530;2024
50;Zaragoza;035;Artieda;86;46;40;2024
50;Zaragoza;036;Asín;89;49;40;2024
50;Zaragoza;037;Atea;136;83;53;2024
50;Zaragoza;038;Ateca;1732;900;832;2024
50;Zaragoza;039;Azuara;537;297;240;2024
50;Zaragoza;040;Badules;81;44;37;2024
50;Zaragoza;041;Bagüés;17;7;10;2024
50;Zaragoza;042;Balconchán;19;6;13;2024
50;Zaragoza;043;Bárboles;286;157;129;2024
50;Zaragoza;044;Bardallur;228;115;113;2024
50;Zaragoza;045;Belchite;1509;765;744;2024
50;Zaragoza;046;Belmonte de Gracián;181;104;77;2024
50;Zaragoza;047;Berdejo;38;27;11;2024
50;Zaragoza;048;Berrueco;33;19;14;2024
50;Zaragoza;050;Bijuesca;93;62;31;2024
50;Zaragoza;051;Biota;840;420;420;2024
50;Zaragoza;052;Bisimbre;91;52;39;2024
50;Zaragoza;053;Boquiñeni;751;374;377;2024
50;Zaragoza;054;Bordalba;47;28;19;2024
50;Zaragoza;055;Borja;5191;2641;2550;2024
50;Zaragoza;056;Botorrita;579;315;264;2024
50;Zaragoza;057;Brea de Aragón;1506;773;733;2024
50;Zaragoza;058;Bubierca;57;28;29;2024
50;Zaragoza;059;Bujaraloz;953;491;462;2024
50;Zaragoza;060;Bulbuente;240;132;108;2024
50;Zaragoza;061;Bureta;208;108;100;2024
50;Zaragoza;062;Burgo de Ebro, El;2704;1351;1353;2024
50;Zaragoza;063;Buste, El;59;34;25;2024
50;Zaragoza;064;Cabañas de Ebro;481;251;230;2024
50;Zaragoza;065;Cabolafuente;50;30;20;2024
50;Zaragoza;066;Cadrete;4639;2425;2214;2024
50;Zaragoza;067;Calatayud;19850;9793;10057;2024
50;Zaragoza;068;Calatorao;2906;1520;1386;2024
50;Zaragoza;069;Calcena;72;43;29;2024
50;Zaragoza;070;Calmarza;58;33;25;2024
50;Zaragoza;071;Campillo de Aragón;112;67;45;2024
50;Zaragoza;072;Carenas;167;94;73;2024
50;Zaragoza;073;Cariñena;3456;1761;1695;2024
50;Zaragoza;074;Caspe;10432;5578;4854;2024
50;Zaragoza;075;Castejón de Alarba;79;51;28;2024
50;Zaragoza;076;Castejón de las Armas;88;43;45;2024
50;Zaragoza;077;Castejón de Valdejasa;198;97;101;2024
50;Zaragoza;078;Castiliscar;214;107;107;2024
50;Zaragoza;079;Cervera de la Cañada;259;148;111;2024
50;Zaragoza;080;Cerveruela;37;25;12;2024
50;Zaragoza;081;Cetina;552;282;270;2024
50;Zaragoza;082;Cimballa;80;39;41;2024
50;Zaragoza;083;Cinco Olivas;102;52;50;2024
50;Zaragoza;084;Clarés de Ribota;70;39;31;2024
50;Zaragoza;085;Codo;201;111;90;2024
50;Zaragoza;086;Codos;217;144;73;2024
50;Zaragoza;087;Contamina;33;21;12;2024
50;Zaragoza;088;Cosuenda;329;166;163;2024
50;Zaragoza;089;Cuarte de Huerva;15112;7658;7454;2024
50;Zaragoza;090;Cubel;143;67;76;2024
50;Zaragoza;091;Cuerlas, Las;41;22;19;2024
50;Zaragoza;092;Chiprana;500;260;240;2024
50;Zaragoza;093;Chodes;102;52;50;2024
50;Zaragoza;094;Daroca;1919;957;962;2024
50;Zaragoza;095;Ejea de los Caballeros;17133;8770;8363;2024
50;Zaragoza;096;Embid de Ariza;29;16;13;2024
50;Zaragoza;098;Encinacorba;182;97;85;2024
50;Zaragoza;099;Épila;4565;2362;2203;2024
50;Zaragoza;100;Erla;371;191;180;2024
50;Zaragoza;101;Escatrón;1177;598;579;2024
50;Zaragoza;102;Fabara;1047;572;475;2024
50;Zaragoza;104;Farlete;394;189;205;2024
50;Zaragoza;105;Fayón;430;245;185;2024
50;Zaragoza;106;Fayos, Los;133;70;63;2024
50;Zaragoza;107;Figueruelas;1270;619;651;2024
50;Zaragoza;108;Fombuena;55;33;22;2024
50;Zaragoza;109;Frago, El;134;81;53;2024
50;Zaragoza;110;Frasno, El;361;205;156;2024
50;Zaragoza;111;Fréscano;194;106;88;2024
50;Zaragoza;113;Fuendejalón;763;407;356;2024
50;Zaragoza;114;Fuendetodos;145;84;61;2024
50;Zaragoza;115;Fuentes de Ebro;4631;2398;2233;2024
50;Zaragoza;116;Fuentes de Jiloca;209;116;93;2024
50;Zaragoza;117;Gallocanta;133;72;61;2024
50;Zaragoza;118;Gallur;2603;1318;1285;2024
50;Zaragoza;119;Gelsa;986;524;462;2024
50;Zaragoza;120;Godojos;54;33;21;2024
50;Zaragoza;121;Gotor;306;164;142;2024
50;Zaragoza;122;Grisel;96;58;38;2024
50;Zaragoza;123;Grisén;632;325;307;2024
50;Zaragoza;124;Herrera de los Navarros;504;284;220;2024
50;Zaragoza;125;Ibdes;372;195;177;2024
50;Zaragoza;126;Illueca;2727;1402;1325;2024
50;Zaragoza;128;Isuerre;30;15;15;2024
50;Zaragoza;129;Jaraba;295;163;132;2024
50;Zaragoza;130;Jarque de Moncayo;381;201;180;2024
50;Zaragoza;131;Jaulín;292;149;143;2024
50;Zaragoza;132;Joyosa, La;1132;570;562;2024
50;Zaragoza;133;Lagata;115;62;53;2024
50;Zaragoza;134;Langa del Castillo;110;60;50;2024
50;Zaragoza;135;Layana;98;54;44;2024
50;Zaragoza;136;Lécera;599;312;287;2024
50;Zaragoza;137;Leciñena;1090;554;536;2024
50;Zaragoza;138;Lechón;44;27;17;2024
50;Zaragoza;139;Letux;356;191;165;2024
50;Zaragoza;140;Litago;192;112;80;2024
50;Zaragoza;141;Lituénigo;124;63;61;2024
50;Zaragoza;142;Lobera de Onsella;27;14;13;2024
50;Zaragoza;143;Longares;830;487;343;2024
50;Zaragoza;144;Longás;45;27;18;2024
50;Zaragoza;146;Lucena de Jalón;224;120;104;2024
50;Zaragoza;147;Luceni;1003;514;489;2024
50;Zaragoza;148;Luesia;331;177;154;2024
50;Zaragoza;149;Luesma;41;23;18;2024
50;Zaragoza;150;Lumpiaque;862;464;398;2024
50;Zaragoza;151;Luna;675;362;313;2024
50;Zaragoza;152;Maella;2089;1128;961;2024
50;Zaragoza;153;Magallón;1093;552;541;2024
50;Zaragoza;154;Mainar;171;92;79;2024
50;Zaragoza;155;Malanquilla;73;50;23;2024
50;Zaragoza;156;Maleján;279;157;122;2024
50;Zaragoza;157;Malón;442;226;216;2024
50;Zaragoza;159;Maluenda;915;465;450;2024
50;Zaragoza;160;Mallén;2951;1543;1408;2024
50;Zaragoza;161;Manchones;96;53;43;2024
50;Zaragoza;162;Mara;161;75;86;2024
50;Zaragoza;163;María de Huerva;6371;3193;3178;2024
50;Zaragoza;164;Mediana de Aragón;457;222;235;2024
50;Zaragoza;165;Mequinenza;2232;1122;1110;2024
50;Zaragoza;166;Mesones de Isuela;266;140;126;2024
50;Zaragoza;167;Mezalocha;206;111;95;2024
50;Zaragoza;168;Mianos;28;17;11;2024
50;Zaragoza;169;Miedes de Aragón;403;214;189;2024
50;Zaragoza;170;Monegrillo;380;210;170;2024
50;Zaragoza;171;Moneva;118;72;46;2024
50;Zaragoza;172;Monreal de Ariza;173;105;68;2024
50;Zaragoza;173;Monterde;152;95;57;2024
50;Zaragoza;174;Montón;96;56;40;2024
50;Zaragoza;175;Morata de Jalón;1082;532;550;2024
50;Zaragoza;176;Morata de Jiloca;235;134;101;2024
50;Zaragoza;177;Morés;303;163;140;2024
50;Zaragoza;178;Moros;269;137;132;2024
50;Zaragoza;179;Moyuela;227;128;99;2024
50;Zaragoza;180;Mozota;130;70;60;2024
50;Zaragoza;181;Muel;1474;769;705;2024
50;Zaragoza;182;Muela, La;6564;3431;3133;2024
50;Zaragoza;183;Munébrega;361;192;169;2024
50;Zaragoza;184;Murero;92;50;42;2024
50;Zaragoza;185;Murillo de Gállego;203;123;80;2024
50;Zaragoza;186;Navardún;39;23;16;2024
50;Zaragoza;187;Nigüella;62;36;26;2024
50;Zaragoza;188;Nombrevilla;39;21;18;2024
50;Zaragoza;189;Nonaspe;1012;546;466;2024
50;Zaragoza;190;Novallas;859;452;407;2024
50;Zaragoza;191;Novillas;502;253;249;2024
50;Zaragoza;192;Nuévalos;306;168;138;2024
50;Zaragoza;193;Nuez de Ebro;907;450;457;2024
50;Zaragoza;194;Olvés;111;59;52;2024
50;Zaragoza;195;Orcajo;58;37;21;2024
50;Zaragoza;196;Orera;101;55;46;2024
50;Zaragoza;197;Orés;74;43;31;2024
50;Zaragoza;198;Oseja;44;29;15;2024
50;Zaragoza;199;Osera de Ebro;428;224;204;2024
50;Zaragoza;200;Paniza;575;308;267;2024
50;Zaragoza;201;Paracuellos de Jiloca;607;316;291;2024
50;Zaragoza;202;Paracuellos de la Ribera;112;63;49;2024
50;Zaragoza;203;Pastriz;1305;647;658;2024
50;Zaragoza;204;Pedrola;3766;1947;1819;2024
50;Zaragoza;205;Pedrosas, Las;113;56;57;2024
50;Zaragoza;206;Perdiguera;544;294;250;2024
50;Zaragoza;207;Piedratajada;97;54;43;2024
50;Zaragoza;208;Pina de Ebro;2446;1243;1203;2024
50;Zaragoza;209;Pinseque;4551;2324;2227;2024
50;Zaragoza;210;Pintanos, Los;37;25;12;2024
50;Zaragoza;211;Plasencia de Jalón;382;204;178;2024
50;Zaragoza;212;Pleitas;30;11;19;2024
50;Zaragoza;213;Plenas;111;63;48;2024
50;Zaragoza;214;Pomer;24;16;8;2024
50;Zaragoza;215;Pozuel de Ariza;24;12;12;2024
50;Zaragoza;216;Pozuelo de Aragón;249;133;116;2024
50;Zaragoza;217;Pradilla de Ebro;546;297;249;2024
50;Zaragoza;218;Puebla de Albortón;136;81;55;2024
50;Zaragoza;219;Puebla de Alfindén, La;6426;3301;3125;2024
50;Zaragoza;220;Puendeluna;42;26;16;2024
50;Zaragoza;221;Purujosa;29;19;10;2024
50;Zaragoza;222;Quinto;1884;966;918;2024
50;Zaragoza;223;Remolinos;1023;516;507;2024
50;Zaragoza;224;Retascón;73;38;35;2024
50;Zaragoza;225;Ricla;2949;1608;1341;2024
50;Zaragoza;227;Romanos;145;75;70;2024
50;Zaragoza;228;Rueda de Jalón;325;174;151;2024
50;Zaragoza;229;Ruesca;66;28;38;2024
50;Zaragoza;230;Sádaba;1258;655;603;2024
50;Zaragoza;231;Salillas de Jalón;359;174;185;2024
50;Zaragoza;232;Salvatierra de Esca;194;94;100;2024
50;Zaragoza;233;Samper del Salz;82;46;36;2024
50;Zaragoza;234;San Martín de la Virgen de Moncayo;274;158;116;2024
50;Zaragoza;235;San Mateo de Gállego;3409;1720;1689;2024
50;Zaragoza;236;Santa Cruz de Grío;104;67;37;2024
50;Zaragoza;237;Santa Cruz de Moncayo;124;66;58;2024
50;Zaragoza;238;Santa Eulalia de Gállego;101;54;47;2024
50;Zaragoza;239;Santed;71;43;28;2024
50;Zaragoza;240;Sástago;1091;549;542;2024
50;Zaragoza;241;Sabiñán;691;373;318;2024
50;Zaragoza;242;Sediles;111;64;47;2024
50;Zaragoza;243;Sestrica;340;198;142;2024
50;Zaragoza;244;Sierra de Luna;259;132;127;2024
50;Zaragoza;245;Sigüés;70;39;31;2024
50;Zaragoza;246;Sisamón;47;33;14;2024
50;Zaragoza;247;Sobradiel;1127;547;580;2024
50;Zaragoza;248;Sos del Rey Católico;585;310;275;2024
50;Zaragoza;249;Tabuenca;311;187;124;2024
50;Zaragoza;250;Talamantes;82;40;42;2024
50;Zaragoza;251;Tarazona;10803;5375;5428;2024
50;Zaragoza;252;Tauste;6817;3433;3384;2024
50;Zaragoza;253;Terrer;585;316;269;2024
50;Zaragoza;254;Tierga;177;100;77;2024
50;Zaragoza;255;Tobed;198;109;89;2024
50;Zaragoza;256;Torralba de los Frailes;68;35;33;2024
50;Zaragoza;257;Torralba de Ribota;169;98;71;2024
50;Zaragoza;258;Torralbilla;40;25;15;2024
50;Zaragoza;259;Torrehermosa;74;37;37;2024
50;Zaragoza;260;Torrelapaja;29;19;10;2024
50;Zaragoza;261;Torrellas;231;122;109;2024
50;Zaragoza;262;Torres de Berrellén;1506;786;720;2024
50;Zaragoza;263;Torrijo de la Cañada;193;116;77;2024
50;Zaragoza;264;Tosos;175;104;71;2024
50;Zaragoza;265;Trasmoz;83;45;38;2024
50;Zaragoza;266;Trasobares;122;75;47;2024
50;Zaragoza;267;Uncastillo;615;296;319;2024
50;Zaragoza;268;Undués de Lerda;55;31;24;2024
50;Zaragoza;269;Urrea de Jalón;440;253;187;2024
50;Zaragoza;270;Urriés;49;23;26;2024
50;Zaragoza;271;Used;260;141;119;2024
50;Zaragoza;272;Utebo;19022;9456;9566;2024
50;Zaragoza;273;Valdehorna;31;19;12;2024
50;Zaragoza;274;Val de San Martín;59;37;22;2024
50;Zaragoza;275;Valmadrid;127;75;52;2024
50;Zaragoza;276;Valpalmas;126;62;64;2024
50;Zaragoza;277;Valtorres;75;37;38;2024
50;Zaragoza;278;Velilla de Ebro;207;107;100;2024
50;Zaragoza;279;Velilla de Jiloca;74;34;40;2024
50;Zaragoza;280;Vera de Moncayo;315;174;141;2024
50;Zaragoza;281;Vierlas;90;51;39;2024
50;Zaragoza;282;Vilueña, La;57;31;26;2024
50;Zaragoza;283;Villadoz;81;44;37;2024
50;Zaragoza;284;Villafeliche;159;91;68;2024
50;Zaragoza;285;Villafranca de Ebro;835;429;406;2024
50;Zaragoza;286;Villalba de Perejil;84;39;45;2024
50;Zaragoza;287;Villalengua;289;159;130;2024
50;Zaragoza;288;Villanueva de Gállego;4814;2391;2423;2024
50;Zaragoza;289;Villanueva de Jiloca;69;35;34;2024
50;Zaragoza;290;Villanueva de Huerva;376;200;176;2024
50;Zaragoza;291;Villar de los Navarros;157;85;72;2024
50;Zaragoza;292;Villarreal de Huerva;269;162;107;2024
50;Zaragoza;293;Villarroya de la Sierra;413;220;193;2024
50;Zaragoza;294;Villarroya del Campo;69;39;30;2024
50;Zaragoza;295;Vistabella;51;29;22;2024
50;Zaragoza;296;Zaida, La;428;215;213;2024
50;Zaragoza;297;Zaragoza;686986;328678;358308;2024
50;Zaragoza;298;Zuera;8709;4472;4237;2024
50;Zaragoza;901;Biel;170;104;66;2024
50;Zaragoza;902;Marracos;85;43;42;2024
50;Zaragoza;903;Villamayor de Gállego;2854;1446;1408;2024
51;Ceuta;001;Ceuta;83229;41980;41249;2024
52;Melilla;001;Melilla;85811;43154;42657;2024