CPRO;PROVINCIA;CMUN;NOMBRE;POB24;HOMBRES;MUJERES
01;Araba/Álava;001;Alegría-Dulantzi;2971;1531;1440
01;Araba/Álava;002;Amurrio;10330;5149;5181
01;Araba/Álava;003;Aramaio;1381;709;672
01;Araba/Álava;004;Artziniega;1856;913;943
01;Araba/Álava;006;Armiñón;247;127;120
01;Araba/Álava;008;Arratzua-Ubarrundia;1047;552;495
01;Araba/Álava;009;Asparrena;1611;813;798
01;Araba/Álava;010;Ayala/Aiara;2942;1491;1451
01;Araba/Álava;011;Baños de Ebro/Mañueta;291;168;123
01;Araba/Álava;013;Barrundia;879;490;389
01;Araba/Álava;014;Berantevilla;459;238;221
01;Araba/Álava;016;Bernedo;546;318;228
01;Araba/Álava;017;Campezo/Kanpezu;1085;574;511
01;Araba/Álava;018;Zigoitia;1844;990;854
01;Araba/Álava;019;Kripan;178;90;88
01;Araba/Álava;020;Kuartango;408;229;179
01;Araba/Álava;021;Elburgo/Burgelu;642;334;308
01;Araba/Álava;022;Elciego;955;478;477
01;Araba/Álava;023;Elvillar/Bilar;319;152;167
01;Araba/Álava;027;Iruraiz-Gauna;553;298;255
01;Araba/Álava;028;Labastida/Bastida;1565;800;765
01;Araba/Álava;030;Lagrán;170;96;74
01;Araba/Álava;031;Laguardia;1478;790;688
01;Araba/Álava;032;Lanciego/Lantziego;685;354;331
01;Araba/Álava;033;Lapuebla de Labarca;859;436;423
01;Araba/Álava;034;Leza;210;107;103
01;Araba/Álava;036;Laudio/Llodio;17982;8712;9270
01;Araba/Álava;037;Arraia-Maeztu;822;451;371
01;Araba/Álava;039;Moreda de Álava/Moreda Araba;215;114;101
01;Araba/Álava;041;Navaridas;191;106;85
01;Araba/Álava;042;Okondo;1194;630;564
01;Araba/Álava;043;Oyón-Oion;3413;1724;1689
01;Araba/Álava;044;Peñacerrada-Urizaharra;302;181;121
01;Araba/Álava;046;Erriberagoitia/Ribera Alta;845;504;341
01;Araba/Álava;047;Ribera Baja/Erriberabeitia;1439;767;672
01;Araba/Álava;049;Añana;142;86;56
01;Araba/Álava;051;Agurain/Salvatierra;5155;2601;2554
01;Araba/Álava;052;Samaniego;290;144;146
01;Araba/Álava;053;San Millán/Donemiliaga;720;388;332
01;Araba/Álava;054;Urkabustaiz;1462;761;701
01;Araba/Álava;055;Valdegovía/Gaubea;1072;577;495
01;Araba/Álava;056;Harana/Valle de Arana;214;117;97
01;Araba/Álava;057;Villabuena de Álava/Eskuernaga;290;154;136
01;Araba/Álava;058;Legutio;2086;1078;1008
01;Araba/Álava;059;Vitoria-Gasteiz;257968;125412;132556
01;Araba/Álava;060;Yécora/Iekora;265;143;122
01;Araba/Álava;061;Zalduondo;194;105;89
01;Araba/Álava;062;Zambrana;442;242;200
01;Araba/Álava;063;Zuia;2372;1237;1135
01;Araba/Álava;901;Iruña Oka/Iruña de Oca;3625;1923;1702
01;Araba/Álava;902;Lantarón;926;531;395
02;Albacete;001;Abengibre;759;374;385
02;Albacete;002;Alatoz;497;267;230
02;Albacete;003;Albacete;174137;85115;89022
02;Albacete;004;Albatana;663;342;321
02;Albacete;005;Alborea;676;363;313
02;Albacete;006;Alcadozo;641;351;290
02;Albacete;007;Alcalá del Júcar;1117;585;532
02;Albacete;008;Alcaraz;1304;676;628
02;Albacete;009;Almansa;24281;12041;12240
02;Albacete;010;Alpera;2260;1192;1068
02;Albacete;011;Ayna;608;337;271
02;Albacete;012;Balazote;2379;1210;1169
02;Albacete;013;Balsa de Ves;124;70;54
02;Albacete;014;Ballestero, El;413;213;200
02;Albacete;015;Barrax;1864;968;896
02;Albacete;016;Bienservida;552;300;252
02;Albacete;017;Bogarra;748;401;347
02;Albacete;018;Bonete;970;506;464
02;Albacete;019;Bonillo, El;2624;1342;1282
02;Albacete;020;Carcelén;487;257;230
02;Albacete;021;Casas de Juan Núñez;1361;730;631
02;Albacete;022;Casas de Lázaro;311;180;131
02;Albacete;023;Casas de Ves;548;290;258
02;Albacete;024;Casas-Ibáñez;4591;2328;2263
02;Albacete;025;Caudete;10249;5246;5003
02;Albacete;026;Cenizate;1160;587;573
02;Albacete;027;Corral-Rubio;302;161;141
02;Albacete;028;Cotillas;126;72;54
02;Albacete;029;Chinchilla de Monte-Aragón;4626;2395;2231
02;Albacete;030;Elche de la Sierra;3596;1762;1834
02;Albacete;031;Férez;605;298;307
02;Albacete;032;Fuensanta;287;154;133
02;Albacete;033;Fuente-Álamo;2417;1273;1144
02;Albacete;034;Fuentealbilla;1799;941;858
02;Albacete;035;Gineta, La;2635;1357;1278
02;Albacete;036;Golosalvo;85;44;41
02;Albacete;037;Hellín;30812;15493;15319
02;Albacete;038;Herrera, La;303;161;142
02;Albacete;039;Higueruela;1142;600;542
02;Albacete;040;Hoya-Gonzalo;593;319;274
02;Albacete;041;Jorquera;358;194;164
02;Albacete;042;Letur;922;466;456
02;Albacete;043;Lezuza;1305;688;617
02;Albacete;044;Liétor;1063;552;511
02;Albacete;045;Madrigueras;4658;2365;2293
02;Albacete;046;Mahora;1465;762;703
02;Albacete;047;Masegoso;116;68;48
02;Albacete;048;Minaya;1387;694;693
02;Albacete;049;Molinicos;785;403;382
02;Albacete;050;Montalvos;81;48;33
02;Albacete;051;Montealegre del Castillo;2038;1059;979
02;Albacete;052;Motilleja;668;364;304
02;Albacete;053;Munera;3395;1756;1639
02;Albacete;054;Navas de Jorquera;533;282;251
02;Albacete;055;Nerpio;1150;652;498
02;Albacete;056;Ontur;1890;942;948
02;Albacete;057;Ossa de Montiel;2216;1127;1089
02;Albacete;058;Paterna del Madera;339;190;149
02;Albacete;059;Peñascosa;328;187;141
02;Albacete;060;Peñas de San Pedro;1466;867;599
02;Albacete;061;Pétrola;665;354;311
02;Albacete;062;Povedilla;392;210;182
02;Albacete;063;Pozohondo;1553;818;735
02;Albacete;064;Pozo-Lorente;386;201;185
02;Albacete;065;Pozuelo;467;256;211
02;Albacete;066;Recueja, La;221;121;100
02;Albacete;067;Riópar;1353;686;667
02;Albacete;068;Robledo;393;219;174
02;Albacete;069;Roda, La;15610;7852;7758
02;Albacete;070;Salobre;442;237;205
02;Albacete;071;San Pedro;1185;607;578
02;Albacete;072;Socovos;1662;871;791
02;Albacete;073;Tarazona de la Mancha;6117;3144;2973
02;Albacete;074;Tobarra;7947;4128;3819
02;Albacete;075;Valdeganga;1961;1008;953
02;Albacete;076;Vianos;320;165;155
02;Albacete;077;Villa de Ves;55;32;23
02;Albacete;078;Villalgordo del Júcar;1128;592;536
02;Albacete;079;Villamalea;3973;2041;1932
02;Albacete;080;Villapalacios;562;295;267
02;Albacete;081;Villarrobledo;25262;12489;12773
02;Albacete;082;Villatoya;113;67;46
02;Albacete;083;Villavaliente;201;122;79
02;Albacete;084;Villaverde de Guadalimar;310;167;143
02;Albacete;085;Viveros;305;159;146
02;Albacete;086;Yeste;2509;1310;1199
02;Albacete;901;Pozo Cañada;2692;1371;1321
03;Alicante/Alacant;001;Atzúbia, l';594;314;280
03;Alicante/Alacant;002;Agost;5107;2586;2521
03;Alicante/Alacant;003;Agres;610;327;283
03;Alicante/Alacant;004;Aigües;1189;598;591
03;Alicante/Alacant;005;Albatera;13296;6785;6511
03;Alicante/Alacant;006;Alcalalí;1406;690;716
03;Alicante/Alacant;007;Alcosser;259;129;130
03;Alicante/Alacant;008;Alcoleja;186;100;86
03;Alicante/Alacant;009;Alcoi/Alcoy;60372;29529;30843
03;Alicante/Alacant;010;Alfafara;413;194;219
03;Alicante/Alacant;011;Alfàs del Pi, l';20160;9890;10270
03;Alicante/Alacant;012;Algorfa;3684;1848;1836
03;Alicante/Alacant;013;Algueña;1342;684;658
03;Alicante/Alacant;014;Alacant/Alicante;358720;173006;185714
03;Alicante/Alacant;015;Almoradí;22464;11331;11133
03;Alicante/Alacant;016;Almudaina;118;57;61
03;Alicante/Alacant;017;Alqueria d'Asnar, l';519;254;265
03;Alicante/Alacant;018;Altea;23963;11693;12270
03;Alicante/Alacant;019;Aspe;21969;11046;10923
03;Alicante/Alacant;020;Balones;131;66;65
03;Alicante/Alacant;021;Banyeres de Mariola;7307;3724;3583
03;Alicante/Alacant;022;Benasau;171;81;90
03;Alicante/Alacant;023;Beneixama;1679;831;848
03;Alicante/Alacant;024;Benejúzar;5697;2842;2855
03;Alicante/Alacant;025;Benferri;2053;1049;1004
03;Alicante/Alacant;026;Beniarbeig;2384;1195;1189
03;Alicante/Alacant;027;Beniardà;235;119;116
03;Alicante/Alacant;028;Beniarrés;1096;564;532
03;Alicante/Alacant;029;Benigembla;559;276;283
03;Alicante/Alacant;030;Benidoleig;1219;611;608
03;Alicante/Alacant;031;Benidorm;74663;37089;37574
03;Alicante/Alacant;032;Benifallim;116;64;52
03;Alicante/Alacant;033;Benifato;144;81;63
03;Alicante/Alacant;034;Benijófar;3471;1698;1773
03;Alicante/Alacant;035;Benilloba;747;397;350
03;Alicante/Alacant;036;Benillup;109;58;51
03;Alicante/Alacant;037;Benimantell;548;276;272
03;Alicante/Alacant;038;Benimarfull;447;237;210
03;Alicante/Alacant;039;Benimassot;96;52;44
03;Alicante/Alacant;040;Benimeli;453;202;251
03;Alicante/Alacant;041;Benissa;12317;6072;6245
03;Alicante/Alacant;042;Poble Nou de Benitatxell, el/Benitachell;4851;2408;2443
03;Alicante/Alacant;043;Biar;3634;1777;1857
03;Alicante/Alacant;044;Bigastro;7431;3743;3688
03;Alicante/Alacant;045;Bolulla;486;250;236
03;Alicante/Alacant;046;Busot;3629;1807;1822
03;Alicante/Alacant;047;Calp;26821;13239;13582
03;Alicante/Alacant;048;Callosa d'en Sarrià;7959;4140;3819
03;Alicante/Alacant;049;Callosa de Segura;19658;10055;9603
03;Alicante/Alacant;050;Campello, el;30600;14849;15751
03;Alicante/Alacant;051;Camp de Mirra, el/Campo de Mirra;445;231;214
03;Alicante/Alacant;052;Cañada;1225;611;614
03;Alicante/Alacant;053;Castalla;11622;5887;5735
03;Alicante/Alacant;054;Castell de Castells;444;228;216
03;Alicante/Alacant;055;Catral;9423;4706;4717
03;Alicante/Alacant;056;Cocentaina;11411;5755;5656
03;Alicante/Alacant;057;Confrides;296;159;137
03;Alicante/Alacant;058;Cox;7622;3838;3784
03;Alicante/Alacant;059;Crevillent;30585;15491;15094
03;Alicante/Alacant;060;Quatretondeta;134;74;60
03;Alicante/Alacant;061;Daya Nueva;1832;886;946
03;Alicante/Alacant;062;Daya Vieja;657;330;327
03;Alicante/Alacant;063;Dénia;46942;22822;24120
03;Alicante/Alacant;064;Dolores;8102;4075;4027
03;Alicante/Alacant;065;Elx/Elche;243128;120333;122795
03;Alicante/Alacant;066;Elda;53818;26301;27517
03;Alicante/Alacant;067;Fageca;100;52;48
03;Alicante/Alacant;068;Famorca;44;24;20
03;Alicante/Alacant;069;Finestrat;9352;4768;4584
03;Alicante/Alacant;070;Formentera del Segura;4749;2408;2341
03;Alicante/Alacant;071;Gata de Gorgos;6659;3415;3244
03;Alicante/Alacant;072;Gaianes;553;278;275
03;Alicante/Alacant;073;Gorga;284;149;135
03;Alicante/Alacant;074;Granja de Rocamora;2739;1416;1323
03;Alicante/Alacant;075;Castell de Guadalest, el;282;134;148
03;Alicante/Alacant;076;Guardamar del Segura;18111;8824;9287
03;Alicante/Alacant;077;Fondó de les Neus, el/Hondón de las Nieves;2696;1394;1302
03;Alicante/Alacant;078;Hondón de los Frailes;1310;680;630
03;Alicante/Alacant;079;Ibi;24210;12053;12157
03;Alicante/Alacant;080;Jacarilla;2122;1079;1043
03;Alicante/Alacant;081;Xaló;3042;1516;1526
03;Alicante/Alacant;082;Xàbia/Jávea;30131;15065;15066
03;Alicante/Alacant;083;Xixona/Jijona;7307;3570;3737
03;Alicante/Alacant;084;Orxa, l'/Lorcha;581;294;287
03;Alicante/Alacant;085;Llíber;905;449;456
03;Alicante/Alacant;086;Millena;249;136;113
03;Alicante/Alacant;088;Monforte del Cid;8967;4637;4330
03;Alicante/Alacant;089;Monòver/Monóvar;12764;6364;6400
03;Alicante/Alacant;090;Mutxamel;27761;13895;13866
03;Alicante/Alacant;091;Murla;585;278;307
03;Alicante/Alacant;092;Muro de Alcoy;9345;4717;4628
03;Alicante/Alacant;093;Novelda;26213;13018;13195
03;Alicante/Alacant;094;Nucia, la;18783;9522;9261
03;Alicante/Alacant;095;Ondara;7522;3764;3758
03;Alicante/Alacant;096;Onil;7959;4017;3942
03;Alicante/Alacant;097;Orba;2387;1141;1246
03;Alicante/Alacant;098;Orxeta;879;447;432
03;Alicante/Alacant;099;Orihuela;83720;41427;42293
03;Alicante/Alacant;100;Parcent;1021;496;525
03;Alicante/Alacant;101;Pedreguer;8687;4325;4362
03;Alicante/Alacant;102;Pego;10632;5300;5332
03;Alicante/Alacant;103;Penàguila;293;146;147
03;Alicante/Alacant;104;Petrer;34076;16803;17273
03;Alicante/Alacant;105;Pinós, el/Pinoso;8407;4257;4150
03;Alicante/Alacant;106;Planes;696;372;324
03;Alicante/Alacant;107;Polop;5650;2832;2818
03;Alicante/Alacant;109;Rafal;4900;2435;2465
03;Alicante/Alacant;110;Ràfol d'Almúnia, el;703;360;343
03;Alicante/Alacant;111;Redován;8285;4289;3996
03;Alicante/Alacant;112;Relleu;1288;665;623
03;Alicante/Alacant;113;Rojales;17162;8693;8469
03;Alicante/Alacant;114;Romana, la;2672;1396;1276
03;Alicante/Alacant;115;Sagra;441;217;224
03;Alicante/Alacant;116;Salinas;1775;919;856
03;Alicante/Alacant;117;Sanet y Negrals;722;364;358
03;Alicante/Alacant;118;San Fulgencio;9433;4707;4726
03;Alicante/Alacant;119;Sant Joan d'Alacant;25918;12524;13394
03;Alicante/Alacant;120;San Miguel de Salinas;6976;3494;3482
03;Alicante/Alacant;121;Santa Pola;38556;19193;19363
03;Alicante/Alacant;122;Sant Vicent del Raspeig/San Vicente del Raspeig;60269;29791;30478
03;Alicante/Alacant;123;Sax;10172;5069;5103
03;Alicante/Alacant;124;Sella;604;318;286
03;Alicante/Alacant;125;Senija;696;357;339
03;Alicante/Alacant;127;Tàrbena;634;336;298
03;Alicante/Alacant;128;Teulada;12834;6422;6412
03;Alicante/Alacant;129;Tibi;1803;945;858
03;Alicante/Alacant;130;Tollos;38;26;12
03;Alicante/Alacant;131;Tormos;328;158;170
03;Alicante/Alacant;132;Torre de les Maçanes, la/Torremanzanas;744;393;351
03;Alicante/Alacant;133;Torrevieja;94803;46076;48727
03;Alicante/Alacant;134;Vall d'Alcalà, la;175;90;85
03;Alicante/Alacant;135;Vall d'Ebo, la;230;121;109
03;Alicante/Alacant;136;Vall de Gallinera, la;584;296;288
03;Alicante/Alacant;137;Vall de Laguar, la;903;455;448
03;Alicante/Alacant;138;Verger, el;5272;2599;2673
03;Alicante/Alacant;139;Vila Joiosa, la/Villajoyosa;36891;18204;18687
03;Alicante/Alacant;140;Villena;34385;17238;17147
03;Alicante/Alacant;901;Poblets, els;2684;1279;1405
03;Alicante/Alacant;902;Pilar de la Horadada;23844;12199;11645
03;Alicante/Alacant;903;Montesinos, Los;5682;2873;2809
03;Alicante/Alacant;904;San Isidro;2312;1186;1126
04;Almería;001;Abla;1272;656;616
04;Almería;002;Abrucena;1235;650;585
04;Almería;003;Adra;25515;13049;12466
04;Almería;004;Albanchez;682;367;315
04;Almería;005;Alboloduy;585;284;301
04;Almería;006;Albox;12408;6336;6072
04;Almería;007;Alcolea;829;432;397
04;Almería;008;Alcóntar;557;308;249
04;Almería;009;Alcudia de Monteagud;128;66;62
04;Almería;010;Alhabia;725;395;330
04;Almería;011;Alhama de Almería;3878;1980;1898
04;Almería;012;Alicún;215;106;109
04;Almería;013;Almería;202675;98600;104075
04;Almería;014;Almócita;210;108;102
04;Almería;015;Alsodux;138;78;60
04;Almería;016;Antas;3450;1818;1632
04;Almería;017;Arboleas;4319;2172;2147
04;Almería;018;Armuña de Almanzora;331;166;165
04;Almería;019;Bacares;239;127;112
04;Almería;020;Bayárcal;296;156;140
04;Almería;021;Bayarque;224;106;118
04;Almería;022;Bédar;976;489;487
04;Almería;023;Beires;148;83;65
04;Almería;024;Benahadux;4808;2381;2427
04;Almería;026;Benitagla;60;34;26
04;Almería;027;Benizalón;252;146;106
04;Almería;028;Bentarique;227;123;104
04;Almería;029;Berja;12939;6661;6278
04;Almería;030;Canjáyar;1134;593;541
04;Almería;031;Cantoria;3569;1798;1771
04;Almería;032;Carboneras;8441;4314;4127
04;Almería;033;Castro de Filabres;101;54;47
04;Almería;034;Cóbdar;190;106;84
04;Almería;035;Cuevas del Almanzora;15246;7928;7318
04;Almería;036;Chercos;303;157;146
04;Almería;037;Chirivel;1567;815;752
04;Almería;038;Dalías;4169;2076;2093
04;Almería;041;Enix;598;325;273
04;Almería;043;Felix;770;449;321
04;Almería;044;Fines;2286;1215;1071
04;Almería;045;Fiñana;1984;1008;976
04;Almería;046;Fondón;1133;587;546
04;Almería;047;Gádor;3067;1616;1451
04;Almería;048;Gallardos, Los;3071;1532;1539
04;Almería;049;Garrucha;10603;5528;5075
04;Almería;050;Gérgal;1191;654;537
04;Almería;051;Huécija;537;261;276
04;Almería;052;Huércal de Almería;18584;9387;9197
04;Almería;053;Huércal-Overa;20609;10260;10349
04;Almería;054;Íllar;460;237;223
04;Almería;055;Instinción;498;255;243
04;Almería;056;Laroya;209;116;93
04;Almería;057;Láujar de Andarax;1658;840;818
04;Almería;058;Líjar;393;210;183
04;Almería;059;Lubrín;1428;717;711
04;Almería;060;Lucainena de las Torres;714;369;345
04;Almería;061;Lúcar;825;412;413
04;Almería;062;Macael;5428;2763;2665
04;Almería;063;María;1195;616;579
04;Almería;064;Mojácar;7517;3689;3828
04;Almería;065;Nacimiento;501;261;240
04;Almería;066;Níjar;33076;18800;14276
04;Almería;067;Ohanes;547;283;264
04;Almería;068;Olula de Castro;181;101;80
04;Almería;069;Olula del Río;6429;3290;3139
04;Almería;070;Oria;2199;1148;1051
04;Almería;071;Padules;440;238;202
04;Almería;072;Partaloa;875;438;437
04;Almería;073;Paterna del Río;396;219;177
04;Almería;074;Pechina;4463;2308;2155
04;Almería;075;Pulpí;11906;6183;5723
04;Almería;076;Purchena;1533;779;754
04;Almería;077;Rágol;298;155;143
04;Almería;078;Rioja;1589;819;770
04;Almería;079;Roquetas de Mar;109204;56839;52365
04;Almería;080;Santa Cruz de Marchena;245;132;113
04;Almería;081;Santa Fe de Mondújar;494;250;244
04;Almería;082;Senés;278;155;123
04;Almería;083;Serón;2133;1105;1028
04;Almería;084;Sierro;376;207;169
04;Almería;085;Somontín;524;275;249
04;Almería;086;Sorbas;2525;1299;1226
04;Almería;087;Suflí;231;120;111
04;Almería;088;Tabernas;4097;2127;1970
04;Almería;089;Taberno;962;476;486
04;Almería;090;Tahal;375;194;181
04;Almería;091;Terque;384;205;179
04;Almería;092;Tíjola;3549;1783;1766
04;Almería;093;Turre;4209;2166;2043
04;Almería;094;Turrillas;268;152;116
04;Almería;095;Uleila del Campo;816;409;407
04;Almería;096;Urrácal;350;183;167
04;Almería;097;Velefique;246;140;106
04;Almería;098;Vélez-Blanco;1933;995;938
04;Almería;099;Vélez-Rubio;6613;3224;3389
04;Almería;100;Vera;19488;9925;9563
04;Almería;101;Viator;6271;3192;3079
04;Almería;102;Vícar;28835;15574;13261
04;Almería;103;Zurgena;2990;1537;1453
04;Almería;901;Tres Villas, Las;574;318;256
04;Almería;902;Ejido, El;90135;47231;42904
04;Almería;903;Mojonera, La;8677;4747;3930
04;Almería;904;Balanegra;3016;1586;1430
05;Ávila;001;Adanero;208;120;88
05;Ávila;002;Adrada, La;2796;1428;1368
05;Ávila;005;Albornos;175;92;83
05;Ávila;007;Aldeanueva de Santa Cruz;102;55;47
05;Ávila;008;Aldeaseca;203;103;100
05;Ávila;010;Aldehuela, La;143;73;70
05;Ávila;012;Amavida;133;72;61
05;Ávila;013;Arenal, El;978;476;502
05;Ávila;014;Arenas de San Pedro;6438;3130;3308
05;Ávila;015;Arevalillo;58;27;31
05;Ávila;016;Arévalo;7830;3815;4015
05;Ávila;017;Aveinte;73;42;31
05;Ávila;018;Avellaneda;23;15;8
05;Ávila;019;Ávila;58111;27616;30495
05;Ávila;021;Barco de Ávila, El;2297;1108;1189
05;Ávila;022;Barraco, El;2027;1015;1012
05;Ávila;023;Barromán;175;95;80
05;Ávila;024;Becedas;151;83;68
05;Ávila;025;Becedillas;69;37;32
05;Ávila;026;Bercial de Zapardiel;173;90;83
05;Ávila;027;Berlanas, Las;323;170;153
05;Ávila;029;Bernuy-Zapardiel;84;49;35
05;Ávila;030;Berrocalejo de Aragona;56;31;25
05;Ávila;033;Blascomillán;170;85;85
05;Ávila;034;Blasconuño de Matacabras;14;9;5
05;Ávila;035;Blascosancho;100;51;49
05;Ávila;036;Bohodón, El;110;56;54
05;Ávila;037;Bohoyo;214;126;88
05;Ávila;038;Bonilla de la Sierra;163;94;69
05;Ávila;039;Brabos;35;23;12
05;Ávila;040;Bularros;55;38;17
05;Ávila;041;Burgohondo;1249;668;581
05;Ávila;042;Cabezas de Alambre;153;70;83
05;Ávila;043;Cabezas del Pozo;82;41;41
05;Ávila;044;Cabezas del Villar;224;128;96
05;Ávila;045;Cabizuela;88;46;42
05;Ávila;046;Canales;35;19;16
05;Ávila;047;Candeleda;5031;2516;2515
05;Ávila;048;Cantiveros;99;60;39
05;Ávila;049;Cardeñosa;419;225;194
05;Ávila;051;Carrera, La;160;86;74
05;Ávila;052;Casas del Puerto;83;42;41
05;Ávila;053;Casasola;63;37;26
05;Ávila;054;Casavieja;1394;718;676
05;Ávila;055;Casillas;669;368;301
05;Ávila;056;Castellanos de Zapardiel;113;61;52
05;Ávila;057;Cebreros;3239;1679;1560
05;Ávila;058;Cepeda la Mora;66;38;28
05;Ávila;059;Cillán;79;47;32
05;Ávila;060;Cisla;102;55;47
05;Ávila;061;Colilla, La;375;191;184
05;Ávila;062;Collado de Contreras;145;76;69
05;Ávila;063;Collado del Mirón;20;11;9
05;Ávila;064;Constanzana;99;59;40
05;Ávila;065;Crespos;482;257;225
05;Ávila;066;Cuevas del Valle;517;285;232
05;Ávila;067;Chamartín;62;35;27
05;Ávila;069;Donjimeno;72;40;32
05;Ávila;070;Donvidas;36;22;14
05;Ávila;072;Espinosa de los Caballeros;97;51;46
05;Ávila;073;Flores de Ávila;270;142;128
05;Ávila;074;Fontiveros;725;377;348
05;Ávila;075;Fresnedilla;97;50;47
05;Ávila;076;Fresno, El;591;308;283
05;Ávila;077;Fuente el Saúz;151;85;66
05;Ávila;078;Fuentes de Año;88;51;37
05;Ávila;079;Gallegos de Altamiros;60;38;22
05;Ávila;080;Gallegos de Sobrinos;45;23;22
05;Ávila;081;Garganta del Villar;39;25;14
05;Ávila;082;Gavilanes;529;288;241
05;Ávila;083;Gemuño;142;76;66
05;Ávila;084;Gilbuena;47;32;15
05;Ávila;085;Gil García;48;25;23
05;Ávila;086;Gimialcón;66;43;23
05;Ávila;087;Gotarrendura;167;61;106
05;Ávila;088;Grandes y San Martín;32;15;17
05;Ávila;089;Guisando;474;245;229
05;Ávila;090;Gutierre-Muñoz;64;32;32
05;Ávila;092;Hernansancho;142;80;62
05;Ávila;093;Herradón de Pinares;495;267;228
05;Ávila;094;Herreros de Suso;140;80;60
05;Ávila;095;Higuera de las Dueñas;270;155;115
05;Ávila;096;Hija de Dios, La;75;47;28
05;Ávila;097;Horcajada, La;457;229;228
05;Ávila;099;Horcajo de las Torres;441;248;193
05;Ávila;100;Hornillo, El;280;151;129
05;Ávila;101;Hoyocasero;311;176;135
05;Ávila;102;Hoyo de Pinares, El;2183;1132;1051
05;Ávila;103;Hoyorredondo;59;32;27
05;Ávila;104;Hoyos del Collado;30;17;13
05;Ávila;105;Hoyos del Espino;344;179;165
05;Ávila;106;Hoyos de Miguel Muñoz;27;14;13
05;Ávila;107;Hurtumpascual;42;26;16
05;Ávila;108;Junciana;40;22;18
05;Ávila;109;Langa;450;231;219
05;Ávila;110;Lanzahíta;788;404;384
05;Ávila;112;Losar del Barco, El;103;59;44
05;Ávila;113;Llanos de Tormes, Los;63;28;35
05;Ávila;114;Madrigal de las Altas Torres;1299;667;632
05;Ávila;115;Maello;700;379;321
05;Ávila;116;Malpartida de Corneja;91;46;45
05;Ávila;117;Mamblas;196;111;85
05;Ávila;118;Mancera de Arriba;70;37;33
05;Ávila;119;Manjabálago y Ortigosa de Rioalmar;26;13;13
05;Ávila;120;Marlín;31;21;10
05;Ávila;121;Martiherrero;361;189;172
05;Ávila;122;Martínez;108;55;53
05;Ávila;123;Mediana de Voltoya;117;61;56
05;Ávila;124;Medinilla;77;41;36
05;Ávila;125;Mengamuñoz;54;28;26
05;Ávila;126;Mesegar de Corneja;66;36;30
05;Ávila;127;Mijares;731;398;333
05;Ávila;128;Mingorría;410;216;194
05;Ávila;129;Mirón, El;98;61;37
05;Ávila;130;Mironcillo;112;59;53
05;Ávila;131;Mirueña de los Infanzones;95;51;44
05;Ávila;132;Mombeltrán;916;479;437
05;Ávila;133;Monsalupe;59;32;27
05;Ávila;134;Moraleja de Matacabras;53;29;24
05;Ávila;135;Muñana;502;269;233
05;Ávila;136;Muñico;80;47;33
05;Ávila;138;Muñogalindo;300;151;149
05;Ávila;139;Muñogrande;74;38;36
05;Ávila;140;Muñomer del Peco;111;62;49
05;Ávila;141;Muñopepe;104;54;50
05;Ávila;142;Muñosancho;88;46;42
05;Ávila;143;Muñotello;49;27;22
05;Ávila;144;Narrillos del Álamo;59;33;26
05;Ávila;145;Narrillos del Rebollar;34;21;13
05;Ávila;147;Narros del Castillo;152;85;67
05;Ávila;148;Narros del Puerto;28;15;13
05;Ávila;149;Narros de Saldueña;106;54;52
05;Ávila;151;Navacepedilla de Corneja;100;55;45
05;Ávila;152;Nava de Arévalo;663;337;326
05;Ávila;153;Nava del Barco;83;46;37
05;Ávila;154;Navadijos;29;19;10
05;Ávila;155;Navaescurial;53;32;21
05;Ávila;156;Navahondilla;353;206;147
05;Ávila;157;Navalacruz;204;121;83
05;Ávila;158;Navalmoral;412;220;192
05;Ávila;159;Navalonguilla;185;90;95
05;Ávila;160;Navalosa;324;188;136
05;Ávila;161;Navalperal de Pinares;826;440;386
05;Ávila;162;Navalperal de Tormes;77;46;31
05;Ávila;163;Navaluenga;2172;1083;1089
05;Ávila;164;Navaquesera;43;23;20
05;Ávila;165;Navarredonda de Gredos;446;234;212
05;Ávila;166;Navarredondilla;158;90;68
05;Ávila;167;Navarrevisca;299;168;131
05;Ávila;168;Navas del Marqués, Las;5590;2860;2730
05;Ávila;169;Navatalgordo;237;137;100
05;Ávila;170;Navatejares;50;23;27
05;Ávila;171;Neila de San Miguel;62;34;28
05;Ávila;172;Niharra;183;109;74
05;Ávila;173;Ojos-Albos;96;50;46
05;Ávila;174;Orbita;69;37;32
05;Ávila;175;Oso, El;129;78;51
05;Ávila;176;Padiernos;275;150;125
05;Ávila;177;Pajares de Adaja;127;69;58
05;Ávila;178;Palacios de Goda;397;215;182
05;Ávila;179;Papatrigo;219;106;113
05;Ávila;180;Parral, El;62;39;23
05;Ávila;181;Pascualcobo;39;27;12
05;Ávila;182;Pedro Bernardo;758;398;360
05;Ávila;183;Pedro-Rodríguez;134;68;66
05;Ávila;184;Peguerinos;294;162;132
05;Ávila;185;Peñalba de Ávila;105;56;49
05;Ávila;186;Piedrahíta;1637;797;840
05;Ávila;187;Piedralaves;2150;1077;1073
05;Ávila;188;Poveda;33;18;15
05;Ávila;189;Poyales del Hoyo;487;270;217
05;Ávila;190;Pozanco;60;37;23
05;Ávila;191;Pradosegar;117;64;53
05;Ávila;192;Puerto Castilla;98;62;36
05;Ávila;193;Rasueros;160;91;69
05;Ávila;194;Riocabado;125;76;49
05;Ávila;195;Riofrío;191;121;70
05;Ávila;196;Rivilla de Barajas;56;26;30
05;Ávila;197;Salobral;102;57;45
05;Ávila;198;Salvadiós;71;37;34
05;Ávila;199;San Bartolomé de Béjar;49;24;25
05;Ávila;200;San Bartolomé de Corneja;35;19;16
05;Ávila;201;San Bartolomé de Pinares;489;268;221
05;Ávila;204;Sanchidrián;708;355;353
05;Ávila;205;Sanchorreja;79;42;37
05;Ávila;206;San Esteban de los Patos;20;13;7
05;Ávila;207;San Esteban del Valle;734;376;358
05;Ávila;208;San Esteban de Zapardiel;40;21;19
05;Ávila;209;San García de Ingelmos;66;45;21
05;Ávila;210;San Juan de la Encinilla;70;36;34
05;Ávila;211;San Juan de la Nava;426;239;187
05;Ávila;212;San Juan del Molinillo;234;128;106
05;Ávila;213;San Juan del Olmo;81;51;30
05;Ávila;214;San Lorenzo de Tormes;30;15;15
05;Ávila;215;San Martín de la Vega del Alberche;153;92;61
05;Ávila;216;San Martín del Pimpollar;219;126;93
05;Ávila;217;San Miguel de Corneja;70;38;32
05;Ávila;218;San Miguel de Serrezuela;106;61;45
05;Ávila;219;San Pascual;45;26;19
05;Ávila;220;San Pedro del Arroyo;501;262;239
05;Ávila;221;Santa Cruz del Valle;304;159;145
05;Ávila;222;Santa Cruz de Pinares;170;101;69
05;Ávila;224;Santa María del Arroyo;102;55;47
05;Ávila;225;Santa María del Berrocal;382;193;189
05;Ávila;226;Santa María de los Caballeros;72;44;28
05;Ávila;227;Santa María del Tiétar;553;293;260
05;Ávila;228;Santiago del Collado;162;101;61
05;Ávila;229;Santo Domingo de las Posadas;69;37;32
05;Ávila;230;Santo Tomé de Zabarcos;71;41;30
05;Ávila;231;San Vicente de Arévalo;165;92;73
05;Ávila;232;Serrada, La;135;72;63
05;Ávila;233;Serranillos;252;141;111
05;Ávila;234;Sigeres;41;20;21
05;Ávila;235;Sinlabajos;135;61;74
05;Ávila;236;Solana de Ávila;100;62;38
05;Ávila;237;Solana de Rioalmar;138;79;59
05;Ávila;238;Solosancho;758;411;347
05;Ávila;239;Sotalbo;245;146;99
05;Ávila;240;Sotillo de la Adrada;5003;2464;2539
05;Ávila;241;Tiemblo, El;4526;2313;2213
05;Ávila;242;Tiñosillos;756;391;365
05;Ávila;243;Tolbaños;86;50;36
05;Ávila;244;Tormellas;35;23;12
05;Ávila;245;Tornadizos de Ávila;465;226;239
05;Ávila;246;Tórtoles;38;22;16
05;Ávila;247;Torre, La;212;117;95
05;Ávila;249;Umbrías;100;50;50
05;Ávila;251;Vadillo de la Sierra;51;33;18
05;Ávila;252;Valdecasa;56;35;21
05;Ávila;253;Vega de Santa María;86;43;43
05;Ávila;254;Velayos;217;112;105
05;Ávila;256;Villaflor;99;53;46
05;Ávila;257;Villafranca de la Sierra;134;78;56
05;Ávila;258;Villanueva de Gómez;115;65;50
05;Ávila;259;Villanueva del Aceral;92;41;51
05;Ávila;260;Villanueva del Campillo;101;56;45
05;Ávila;261;Villar de Corneja;36;23;13
05;Ávila;262;Villarejo del Valle;314;171;143
05;Ávila;263;Villatoro;161;90;71
05;Ávila;264;Viñegra de Moraña;48;24;24
05;Ávila;265;Vita;71;42;29
05;Ávila;266;Zapardiel de la Cañada;84;45;39
05;Ávila;267;Zapardiel de la Ribera;92;45;47
05;Ávila;901;San Juan de Gredos;228;126;102
05;Ávila;902;Santa María del Cubillo;322;178;144
05;Ávila;903;Diego del Carpio;106;66;40
05;Ávila;904;Santiago del Tormes;107;57;50
05;Ávila;905;Villanueva de Ávila;227;123;104
06;Badajoz;001;Acedera;802;415;387
06;Badajoz;002;Aceuchal;5404;2681;2723
06;Badajoz;003;Ahillones;784;395;389
06;Badajoz;004;Alange;1808;930;878
06;Badajoz;005;Albuera, La;1992;1025;967
06;Badajoz;006;Alburquerque;4998;2503;2495
06;Badajoz;007;Alconchel;1626;819;807
06;Badajoz;008;Alconera;756;381;375
06;Badajoz;009;Aljucén;255;136;119
06;Badajoz;010;Almendral;1197;600;597
06;Badajoz;011;Almendralejo;34284;16949;17335
06;Badajoz;012;Arroyo de San Serván;4061;2032;2029
06;Badajoz;013;Atalaya;258;130;128
06;Badajoz;014;Azuaga;7595;3770;3825
06;Badajoz;015;Badajoz;150570;72810;77760
06;Badajoz;016;Barcarrota;3473;1764;1709
06;Badajoz;017;Baterno;238;134;104
06;Badajoz;018;Benquerencia de la Serena;789;399;390
06;Badajoz;019;Berlanga;2214;1107;1107
06;Badajoz;020;Bienvenida;2021;1031;990
06;Badajoz;021;Bodonal de la Sierra;993;506;487
06;Badajoz;022;Burguillos del Cerro;2970;1460;1510
06;Badajoz;023;Cabeza del Buey;4526;2268;2258
06;Badajoz;024;Cabeza la Vaca;1255;649;606
06;Badajoz;025;Calamonte;6120;3043;3077
06;Badajoz;026;Calera de León;918;468;450
06;Badajoz;027;Calzadilla de los Barros;685;347;338
06;Badajoz;028;Campanario;4705;2324;2381
06;Badajoz;029;Campillo de Llerena;1314;644;670
06;Badajoz;030;Capilla;145;77;68
06;Badajoz;031;Carmonita;520;262;258
06;Badajoz;032;Carrascalejo, El;77;41;36
06;Badajoz;033;Casas de Don Pedro;1370;711;659
06;Badajoz;034;Casas de Reina;207;107;100
06;Badajoz;035;Castilblanco;844;424;420
06;Badajoz;036;Castuera;5497;2747;2750
06;Badajoz;037;Codosera, La;2025;1044;981
06;Badajoz;038;Cordobilla de Lácara;827;434;393
06;Badajoz;039;Coronada, La;2148;1052;1096
06;Badajoz;040;Corte de Peleas;1165;576;589
06;Badajoz;041;Cristina;547;280;267
06;Badajoz;042;Cheles;1177;576;601
06;Badajoz;043;Don Álvaro;815;431;384
06;Badajoz;044;Don Benito;37728;18563;19165
06;Badajoz;045;Entrín Bajo;540;277;263
06;Badajoz;046;Esparragalejo;1494;742;752
06;Badajoz;047;Esparragosa de la Serena;933;472;461
06;Badajoz;048;Esparragosa de Lares;854;424;430
06;Badajoz;049;Feria;1047;510;537
06;Badajoz;050;Fregenal de la Sierra;4743;2312;2431
06;Badajoz;051;Fuenlabrada de los Montes;1709;837;872
06;Badajoz;052;Fuente de Cantos;4592;2283;2309
06;Badajoz;053;Fuente del Arco;660;338;322
06;Badajoz;054;Fuente del Maestre;6567;3251;3316
06;Badajoz;055;Fuentes de León;2158;1065;1093
06;Badajoz;056;Garbayuela;475;252;223
06;Badajoz;057;Garlitos;530;262;268
06;Badajoz;058;Garrovilla, La;2292;1139;1153
06;Badajoz;059;Granja de Torrehermosa;1900;942;958
06;Badajoz;060;Guareña;6649;3312;3337
06;Badajoz;061;Haba, La;1214;606;608
06;Badajoz;062;Helechosa de los Montes;562;331;231
06;Badajoz;063;Herrera del Duque;3399;1708;1691
06;Badajoz;064;Higuera de la Serena;887;457;430
06;Badajoz;065;Higuera de Llerena;339;172;167
06;Badajoz;066;Higuera de Vargas;1856;943;913
06;Badajoz;067;Higuera la Real;2202;1110;1092
06;Badajoz;068;Hinojosa del Valle;480;227;253
06;Badajoz;069;Hornachos;3396;1713;1683
06;Badajoz;070;Jerez de los Caballeros;9112;4472;4640
06;Badajoz;071;Lapa, La;293;151;142
06;Badajoz;072;Lobón;2734;1404;1330
06;Badajoz;073;Llera;802;402;400
06;Badajoz;074;Llerena;5645;2814;2831
06;Badajoz;075;Magacela;498;255;243
06;Badajoz;076;Maguilla;929;468;461
06;Badajoz;077;Malcocinado;346;195;151
06;Badajoz;078;Malpartida de la Serena;518;268;250
06;Badajoz;079;Manchita;737;370;367
06;Badajoz;080;Medellín;2237;1138;1099
06;Badajoz;081;Medina de las Torres;1166;614;552
06;Badajoz;082;Mengabril;491;265;226
06;Badajoz;083;Mérida;59857;29061;30796
06;Badajoz;084;Mirandilla;1246;619;627
06;Badajoz;085;Monesterio;4230;2143;2087
06;Badajoz;086;Montemolín;1267;615;652
06;Badajoz;087;Monterrubio de la Serena;2199;1081;1118
06;Badajoz;088;Montijo;15232;7532;7700
06;Badajoz;089;Morera, La;704;358;346
06;Badajoz;090;Nava de Santiago, La;914;457;457
06;Badajoz;091;Navalvillar de Pela;4345;2185;2160
06;Badajoz;092;Nogales;640;316;324
06;Badajoz;093;Oliva de la Frontera;4936;2475;2461
06;Badajoz;094;Oliva de Mérida;1679;848;831
06;Badajoz;095;Olivenza;11742;5824;5918
06;Badajoz;096;Orellana de la Sierra;261;140;121
06;Badajoz;097;Orellana la Vieja;2573;1322;1251
06;Badajoz;098;Palomas;662;330;332
06;Badajoz;099;Parra, La;1284;661;623
06;Badajoz;100;Peñalsordo;824;405;419
06;Badajoz;101;Peraleda del Zaucejo;479;244;235
06;Badajoz;102;Puebla de Alcocer;1107;550;557
06;Badajoz;103;Puebla de la Calzada;5859;2940;2919
06;Badajoz;104;Puebla de la Reina;695;341;354
06;Badajoz;105;Puebla del Maestre;658;343;315
06;Badajoz;106;Puebla del Prior;460;239;221
06;Badajoz;107;Puebla de Obando;1806;915;891
06;Badajoz;108;Puebla de Sancho Pérez;2635;1326;1309
06;Badajoz;109;Quintana de la Serena;4455;2262;2193
06;Badajoz;110;Reina;142;76;66
06;Badajoz;111;Rena;613;320;293
06;Badajoz;112;Retamal de Llerena;429;227;202
06;Badajoz;113;Ribera del Fresno;3187;1587;1600
06;Badajoz;114;Risco;127;62;65
06;Badajoz;115;Roca de la Sierra, La;1453;713;740
06;Badajoz;116;Salvaleón;1656;838;818
06;Badajoz;117;Salvatierra de los Barros;1559;767;792
06;Badajoz;118;Sancti-Spíritus;145;82;63
06;Badajoz;119;San Pedro de Mérida;861;444;417
06;Badajoz;120;Santa Amalia;3920;1967;1953
06;Badajoz;121;Santa Marta;4145;2077;2068
06;Badajoz;122;Santos de Maimona, Los;8070;4063;4007
06;Badajoz;123;San Vicente de Alcántara;5204;2618;2586
06;Badajoz;124;Segura de León;1792;896;896
06;Badajoz;125;Siruela;1771;897;874
06;Badajoz;126;Solana de los Barros;2542;1269;1273
06;Badajoz;127;Talarrubias;3259;1641;1618
06;Badajoz;128;Talavera la Real;5298;2645;2653
06;Badajoz;129;Táliga;660;329;331
06;Badajoz;130;Tamurejo;199;99;100
06;Badajoz;131;Torre de Miguel Sesmero;1241;626;615
06;Badajoz;132;Torremayor;1004;491;513
06;Badajoz;133;Torremejía;2222;1150;1072
06;Badajoz;134;Trasierra;593;309;284
06;Badajoz;135;Trujillanos;1382;693;689
06;Badajoz;136;Usagre;1723;853;870
06;Badajoz;137;Valdecaballeros;1051;537;514
06;Badajoz;138;Valdetorres;1135;558;577
06;Badajoz;139;Valencia de las Torres;480;256;224
06;Badajoz;140;Valencia del Mombuey;713;369;344
06;Badajoz;141;Valencia del Ventoso;1885;953;932
06;Badajoz;142;Valverde de Burguillos;270;141;129
06;Badajoz;143;Valverde de Leganés;4218;2096;2122
06;Badajoz;144;Valverde de Llerena;566;287;279
06;Badajoz;145;Valverde de Mérida;1010;515;495
06;Badajoz;146;Valle de la Serena;1093;557;536
06;Badajoz;147;Valle de Matamoros;332;168;164
06;Badajoz;148;Valle de Santa Ana;1107;548;559
06;Badajoz;149;Villafranca de los Barros;12362;6079;6283
06;Badajoz;150;Villagarcía de la Torre;891;442;449
06;Badajoz;151;Villagonzalo;1223;598;625
06;Badajoz;152;Villalba de los Barros;1447;720;727
06;Badajoz;153;Villanueva de la Serena;25784;12529;13255
06;Badajoz;154;Villanueva del Fresno;3274;1658;1616
06;Badajoz;155;Villar del Rey;2080;1116;964
06;Badajoz;156;Villar de Rena;1323;685;638
06;Badajoz;157;Villarta de los Montes;395;205;190
06;Badajoz;158;Zafra;16711;7991;8720
06;Badajoz;159;Zahínos;2765;1380;1385
06;Badajoz;160;Zalamea de la Serena;3431;1734;1697
06;Badajoz;161;Zarza-Capilla;299;147;152
06;Badajoz;162;Zarza, La;3345;1686;1659
06;Badajoz;901;Valdelacalzada;2755;1385;1370
06;Badajoz;902;Pueblonuevo del Guadiana;1953;970;983
06;Badajoz;903;Guadiana;2437;1188;1249
07;Balears, Illes;001;Alaró;6037;2915;3122
07;Balears, Illes;002;Alaior;10042;5047;4995
07;Balears, Illes;003;Alcúdia;21683;11142;10541
07;Balears, Illes;004;Algaida;6311;3212;3099
07;Balears, Illes;005;Andratx;12062;6051;6011
07;Balears, Illes;006;Artà;8387;4245;4142
07;Balears, Illes;007;Banyalbufar;577;313;264
07;Balears, Illes;008;Binissalem;9281;4618;4663
07;Balears, Illes;009;Búger;1199;632;567
07;Balears, Illes;010;Bunyola;7490;3663;3827
07;Balears, Illes;011;Calvià;53491;26716;26775
07;Balears, Illes;012;Campanet;2824;1396;1428
07;Balears, Illes;013;Campos;12163;6095;6068
07;Balears, Illes;014;Capdepera;12860;6520;6340
07;Balears, Illes;015;Ciutadella de Menorca;31941;15920;16021
07;Balears, Illes;016;Consell;4399;2192;2207
07;Balears, Illes;017;Costitx;1516;749;767
07;Balears, Illes;018;Deià;717;352;365
07;Balears, Illes;019;Escorca;203;127;76
07;Balears, Illes;020;Esporles;5252;2572;2680
07;Balears, Illes;021;Estellencs;374;199;175
07;Balears, Illes;022;Felanitx;18850;9481;9369
07;Balears, Illes;023;Ferreries;5114;2536;2578
07;Balears, Illes;024;Formentera;11389;5831;5558
07;Balears, Illes;025;Fornalutx;715;348;367
07;Balears, Illes;026;Eivissa;53717;26990;26727
07;Balears, Illes;027;Inca;35654;17963;17691
07;Balears, Illes;028;Lloret de Vistalegre;1619;815;804
07;Balears, Illes;029;Lloseta;6456;3280;3176
07;Balears, Illes;030;Llubí;2505;1256;1249
07;Balears, Illes;031;Llucmajor;39912;20159;19753
07;Balears, Illes;032;Maó;30419;14843;15576
07;Balears, Illes;033;Manacor;47777;24062;23715
07;Balears, Illes;034;Mancor de la Vall;1702;855;847
07;Balears, Illes;035;Maria de la Salut;2397;1234;1163
07;Balears, Illes;036;Marratxí;40079;20103;19976
07;Balears, Illes;037;Mercadal, Es;6215;3165;3050
07;Balears, Illes;038;Montuïri;3216;1622;1594
07;Balears, Illes;039;Muro;8115;4099;4016
07;Balears, Illes;040;Palma;431521;211093;220428
07;Balears, Illes;041;Petra;3184;1569;1615
07;Balears, Illes;042;Pollença;17594;8760;8834
07;Balears, Illes;043;Porreres;5888;3001;2887
07;Balears, Illes;044;Pobla, Sa;14630;7370;7260
07;Balears, Illes;045;Puigpunyent;2035;1012;1023
07;Balears, Illes;046;Sant Antoni de Portmany;28609;14933;13676
07;Balears, Illes;047;Sencelles;3900;2000;1900
07;Balears, Illes;048;Sant Josep de sa Talaia;29664;15252;14412
07;Balears, Illes;049;Sant Joan;2228;1112;1116
07;Balears, Illes;050;Sant Joan de Labritja;6948;3499;3449
07;Balears, Illes;051;Sant Llorenç des Cardassar;9331;4693;4638
07;Balears, Illes;052;Sant Lluís;7130;3604;3526
07;Balears, Illes;053;Santa Eugènia;1899;952;947
07;Balears, Illes;054;Santa Eulària des Riu;41706;21182;20524
07;Balears, Illes;055;Santa Margalida;13757;7123;6634
07;Balears, Illes;056;Santa María del Camí;7623;3810;3813
07;Balears, Illes;057;Santanyí;12887;6463;6424
07;Balears, Illes;058;Selva;4294;2100;2194
07;Balears, Illes;059;Salines, Ses;5129;2539;2590
07;Balears, Illes;060;Sineu;4469;2220;2249
07;Balears, Illes;061;Sóller;13744;6787;6957
07;Balears, Illes;062;Son Servera;12261;6043;6218
07;Balears, Illes;063;Valldemossa;2016;1029;987
07;Balears, Illes;064;Castell, Es;7772;3919;3853
07;Balears, Illes;065;Vilafranca de Bonany;3816;1926;1890
07;Balears, Illes;901;Ariany;1018;557;461
07;Balears, Illes;902;Migjorn Gran, Es;1690;872;818
08;Barcelona;001;Abrera;13014;6534;6480
08;Barcelona;002;Aguilar de Segarra;291;156;135
08;Barcelona;003;Alella;10217;4977;5240
08;Barcelona;004;Alpens;270;146;124
08;Barcelona;005;Ametlla del Vallès, L';9462;4764;4698
08;Barcelona;006;Arenys de Mar;16642;8060;8582
08;Barcelona;007;Arenys de Munt;9458;4761;4697
08;Barcelona;008;Argençola;237;121;116
08;Barcelona;009;Argentona;12844;6336;6508
08;Barcelona;010;Artés;6084;3057;3027
08;Barcelona;011;Avià;2243;1117;1126
08;Barcelona;012;Avinyó;2313;1166;1147
08;Barcelona;013;Avinyonet del Penedès;1744;922;822
08;Barcelona;014;Aiguafreda;2576;1257;1319
08;Barcelona;015;Badalona;227083;111688;115395
08;Barcelona;016;Bagà;2182;1076;1106
08;Barcelona;017;Balenyà;4036;2067;1969
08;Barcelona;018;Balsareny;3328;1676;1652
08;Barcelona;019;Barcelona;1702547;812544;890003
08;Barcelona;020;Begues;7462;3701;3761
08;Barcelona;021;Bellprat;69;42;27
08;Barcelona;022;Berga;17160;8440;8720
08;Barcelona;023;Bigues i Riells del Fai;10036;5101;4935
08;Barcelona;024;Borredà;419;237;182
08;Barcelona;025;Bruc, El;2288;1202;1086
08;Barcelona;026;Brull, El;293;159;134
08;Barcelona;027;Cabanyes, Les;1012;511;501
08;Barcelona;028;Cabrera d'Anoia;1709;907;802
08;Barcelona;029;Cabrera de Mar;5018;2529;2489
08;Barcelona;030;Cabrils;7767;3855;3912
08;Barcelona;031;Calaf;3618;1829;1789
08;Barcelona;032;Caldes d'Estrac;3259;1567;1692
08;Barcelona;033;Caldes de Montbui;18336;9139;9197
08;Barcelona;034;Calders;1114;573;541
08;Barcelona;035;Calella;20369;9807;10562
08;Barcelona;036;Calonge de Segarra;174;91;83
08;Barcelona;037;Calldetenes;2690;1373;1317
08;Barcelona;038;Callús;2145;1036;1109
08;Barcelona;039;Campins;606;299;307
08;Barcelona;040;Canet de Mar;15140;7363;7777
08;Barcelona;041;Canovelles;17312;8955;8357
08;Barcelona;042;Cànoves i Samalús;3315;1691;1624
08;Barcelona;043;Canyelles;5367;2802;2565
08;Barcelona;044;Capellades;5567;2785;2782
08;Barcelona;045;Capolat;92;43;49
08;Barcelona;046;Cardedeu;19064;9189;9875
08;Barcelona;047;Cardona;4574;2261;2313
08;Barcelona;048;Carme;814;424;390
08;Barcelona;049;Casserres;1676;832;844
08;Barcelona;050;Castellar del Riu;163;90;73
08;Barcelona;051;Castellar del Vallès;25322;12478;12844
08;Barcelona;052;Castellar de n'Hug;164;85;79
08;Barcelona;053;Castellbell i el Vilar;4138;2134;2004
08;Barcelona;054;Castellbisbal;12972;6497;6475
08;Barcelona;055;Castellcir;784;401;383
08;Barcelona;056;Castelldefels;69450;33927;35523
08;Barcelona;057;Castell de l'Areny;69;39;30
08;Barcelona;058;Castellet i la Gornal;2674;1385;1289
08;Barcelona;059;Castellfollit del Boix;459;235;224
08;Barcelona;060;Castellfollit de Riubregós;151;84;67
08;Barcelona;061;Castellgalí;2347;1214;1133
08;Barcelona;062;Castellnou de Bages;1430;742;688
08;Barcelona;063;Castellolí;658;310;348
08;Barcelona;064;Castellterçol;2773;1434;1339
08;Barcelona;065;Castellví de la Marca;1716;888;828
08;Barcelona;066;Castellví de Rosanes;2106;1040;1066
08;Barcelona;067;Centelles;7775;3801;3974
08;Barcelona;068;Cervelló;9647;4868;4779
08;Barcelona;069;Collbató;4849;2491;2358
08;Barcelona;070;Collsuspina;389;195;194
08;Barcelona;071;Copons;351;179;172
08;Barcelona;072;Corbera de Llobregat;15726;7997;7729
08;Barcelona;073;Cornellà de Llobregat;91589;44342;47247
08;Barcelona;074;Cubelles;17243;8681;8562
08;Barcelona;075;Dosrius;6142;3081;3061
08;Barcelona;076;Esparreguera;22550;11385;11165
08;Barcelona;077;Esplugues de Llobregat;47613;22621;24992
08;Barcelona;078;Espunyola, L';262;130;132
08;Barcelona;079;Estany, L';401;218;183
08;Barcelona;080;Fígols;41;21;20
08;Barcelona;081;Fogars de Montclús;502;275;227
08;Barcelona;082;Fogars de la Selva;1680;881;799
08;Barcelona;083;Folgueroles;2263;1141;1122
08;Barcelona;084;Fonollosa;1585;802;783
08;Barcelona;085;Font-rubí;1446;783;663
08;Barcelona;086;Franqueses del Vallès, Les;20715;10446;10269
08;Barcelona;087;Gallifa;172;93;79
08;Barcelona;088;Garriga, La;17305;8315;8990
08;Barcelona;089;Gavà;48007;23304;24703
08;Barcelona;090;Gaià;178;89;89
08;Barcelona;091;Gelida;8098;4059;4039
08;Barcelona;092;Gironella;5055;2490;2565
08;Barcelona;093;Gisclareny;30;17;13
08;Barcelona;094;Granada, La;2263;1122;1141
08;Barcelona;095;Granera;84;51;33
08;Barcelona;096;Granollers;64181;31770;32411
08;Barcelona;097;Gualba;1738;886;852
08;Barcelona;098;Sant Salvador de Guardiola;3476;1784;1692
08;Barcelona;099;Guardiola de Berguedà;953;481;472
08;Barcelona;100;Gurb;2712;1398;1314
08;Barcelona;101;Hospitalet de Llobregat, L';279993;136077;143916
08;Barcelona;102;Igualada;41466;20446;21020
08;Barcelona;103;Jorba;827;424;403
08;Barcelona;104;Llacuna, La;982;512;470
08;Barcelona;105;Llagosta, La;13085;6455;6630
08;Barcelona;106;Llinars del Vallès;10740;5317;5423
08;Barcelona;107;Lliçà d'Amunt;16253;8252;8001
08;Barcelona;108;Lliçà de Vall;6861;3490;3371
08;Barcelona;109;Lluçà;288;145;143
08;Barcelona;110;Malgrat de Mar;19377;9530;9847
08;Barcelona;111;Malla;272;135;137
08;Barcelona;112;Manlleu;21348;10702;10646
08;Barcelona;113;Manresa;80201;39458;40743
08;Barcelona;114;Martorell;28507;14385;14122
08;Barcelona;115;Martorelles;4987;2499;2488
08;Barcelona;116;Masies de Roda, Les;750;385;365
08;Barcelona;117;Masies de Voltregà, Les;3292;1626;1666
08;Barcelona;118;Masnou, El;24479;11764;12715
08;Barcelona;119;Masquefa;10038;5094;4944
08;Barcelona;120;Matadepera;9815;4938;4877
08;Barcelona;121;Mataró;131798;65435;66363
08;Barcelona;122;Mediona;2637;1360;1277
08;Barcelona;123;Molins de Rei;26948;13106;13842
08;Barcelona;124;Mollet del Vallès;52283;25673;26610
08;Barcelona;125;Montcada i Reixac;37153;18252;18901
08;Barcelona;126;Montgat;12625;6221;6404
08;Barcelona;127;Monistrol de Montserrat;3198;1657;1541
08;Barcelona;128;Monistrol de Calders;761;405;356
08;Barcelona;129;Muntanyola;712;375;337
08;Barcelona;130;Montclar;132;67;65
08;Barcelona;131;Montesquiu;1099;548;551
08;Barcelona;132;Montmajor;472;243;229
08;Barcelona;133;Montmaneu;200;111;89
08;Barcelona;134;Figaró-Montmany;1188;572;616
08;Barcelona;135;Montmeló;8906;4386;4520
08;Barcelona;136;Montornès del Vallès;17089;8614;8475
08;Barcelona;137;Montseny;380;197;183
08;Barcelona;138;Moià;6738;3480;3258
08;Barcelona;139;Mura;232;121;111
08;Barcelona;140;Navarcles;6160;3032;3128
08;Barcelona;141;Navàs;6185;3043;3142
08;Barcelona;142;Nou de Berguedà, La;163;84;79
08;Barcelona;143;Òdena;3710;1901;1809
08;Barcelona;144;Olvan;913;459;454
08;Barcelona;145;Olèrdola;3946;2059;1887
08;Barcelona;146;Olesa de Bonesvalls;2093;1086;1007
08;Barcelona;147;Olesa de Montserrat;24677;12292;12385
08;Barcelona;148;Olivella;4419;2296;2123
08;Barcelona;149;Olost;1216;604;612
08;Barcelona;150;Orís;350;181;169
08;Barcelona;151;Oristà;569;296;273
08;Barcelona;152;Orpí;178;95;83
08;Barcelona;153;Òrrius;805;405;400
08;Barcelona;154;Pacs del Penedès;935;474;461
08;Barcelona;155;Palafolls;9938;5000;4938
08;Barcelona;156;Palau-solità i Plegamans;15456;7556;7900
08;Barcelona;157;Pallejà;11825;5874;5951
08;Barcelona;158;Papiol, El;4363;2186;2177
08;Barcelona;159;Parets del Vallès;18881;9464;9417
08;Barcelona;160;Perafita;438;226;212
08;Barcelona;161;Piera;17555;9052;8503
08;Barcelona;162;Hostalets de Pierola, Els;3231;1652;1579
08;Barcelona;163;Pineda de Mar;29455;14594;14861
08;Barcelona;164;Pla del Penedès, El;1352;680;672
08;Barcelona;165;Pobla de Claramunt, La;2353;1202;1151
08;Barcelona;166;Pobla de Lillet, La;1109;534;575
08;Barcelona;167;Polinyà;8555;4293;4262
08;Barcelona;168;Pontons;518;288;230
08;Barcelona;169;Prat de Llobregat, El;66184;32406;33778
08;Barcelona;170;Prats de Rei, Els;553;298;255
08;Barcelona;171;Prats de Lluçanès;2688;1340;1348
08;Barcelona;172;Premià de Mar;28951;14136;14815
08;Barcelona;174;Puigdàlber;629;310;319
08;Barcelona;175;Puig-reig;4489;2268;2221
08;Barcelona;176;Pujalt;210;115;95
08;Barcelona;177;Quar, La;42;28;14
08;Barcelona;178;Rajadell;594;310;284
08;Barcelona;179;Rellinars;920;494;426
08;Barcelona;180;Ripollet;39462;19520;19942
08;Barcelona;181;Roca del Vallès, La;10962;5507;5455
08;Barcelona;182;Pont de Vilomara i Rocafort, El;4140;2134;2006
08;Barcelona;183;Roda de Ter;6900;3512;3388
08;Barcelona;184;Rubí;81532;40263;41269
08;Barcelona;185;Rubió;237;134;103
08;Barcelona;187;Sabadell;222177;107922;114255
08;Barcelona;188;Sagàs;153;85;68
08;Barcelona;189;Sant Pere Sallavinera;158;82;76
08;Barcelona;190;Saldes;301;168;133
08;Barcelona;191;Sallent;6927;3391;3536
08;Barcelona;192;Santpedor;7716;3851;3865
08;Barcelona;193;Sant Iscle de Vallalta;1458;748;710
08;Barcelona;194;Sant Adrià de Besòs;38490;18952;19538
08;Barcelona;195;Sant Agustí de Lluçanès;108;55;53
08;Barcelona;196;Sant Andreu de la Barca;27062;13298;13764
08;Barcelona;197;Sant Andreu de Llavaneres;11933;5856;6077
08;Barcelona;198;Sant Antoni de Vilamajor;6668;3282;3386
08;Barcelona;199;Sant Bartomeu del Grau;943;498;445
08;Barcelona;200;Sant Boi de Llobregat;84831;41216;43615
08;Barcelona;201;Sant Boi de Lluçanès;575;298;277
08;Barcelona;202;Sant Celoni;18761;9343;9418
08;Barcelona;203;Sant Cebrià de Vallalta;3828;1971;1857
08;Barcelona;204;Sant Climent de Llobregat;4182;2099;2083
08;Barcelona;205;Sant Cugat del Vallès;98621;48036;50585
08;Barcelona;206;Sant Cugat Sesgarrigues;1031;516;515
08;Barcelona;207;Sant Esteve de Palautordera;3080;1531;1549
08;Barcelona;208;Sant Esteve Sesrovires;8060;4018;4042
08;Barcelona;209;Sant Fost de Campsentelles;9227;4589;4638
08;Barcelona;210;Sant Feliu de Codines;6661;3344;3317
08;Barcelona;211;Sant Feliu de Llobregat;46554;22563;23991
08;Barcelona;212;Sant Feliu Sasserra;629;335;294
08;Barcelona;213;Sant Fruitós de Bages;9248;4595;4653
08;Barcelona;214;Vilassar de Dalt;9281;4573;4708
08;Barcelona;215;Sant Hipòlit de Voltregà;3687;1863;1824
08;Barcelona;216;Sant Jaume de Frontanyà;26;13;13
08;Barcelona;217;Sant Joan Despí;35083;16955;18128
08;Barcelona;218;Sant Joan de Vilatorrada;11017;5457;5560
08;Barcelona;219;Vilassar de Mar;21162;10108;11054
08;Barcelona;220;Sant Julià de Vilatorta;3297;1639;1658
08;Barcelona;221;Sant Just Desvern;20881;10033;10848
08;Barcelona;222;Sant Llorenç d'Hortons;2617;1324;1293
08;Barcelona;223;Sant Llorenç Savall;2586;1290;1296
08;Barcelona;224;Sant Martí de Centelles;1259;644;615
08;Barcelona;225;Sant Martí d'Albars;140;73;67
08;Barcelona;226;Sant Martí de Tous;1275;640;635
08;Barcelona;227;Sant Martí Sarroca;3391;1690;1701
08;Barcelona;228;Sant Martí Sesgueioles;360;182;178
08;Barcelona;229;Sant Mateu de Bages;637;332;305
08;Barcelona;230;Premià de Dalt;10594;5282;5312
08;Barcelona;231;Sant Pere de Ribes;32121;15838;16283
08;Barcelona;232;Sant Pere de Riudebitlles;2497;1271;1226
08;Barcelona;233;Sant Pere de Torelló;2592;1340;1252
08;Barcelona;234;Sant Pere de Vilamajor;4941;2513;2428
08;Barcelona;235;Sant Pol de Mar;5834;2826;3008
08;Barcelona;236;Sant Quintí de Mediona;2504;1268;1236
08;Barcelona;237;Sant Quirze de Besora;2127;1025;1102
08;Barcelona;238;Sant Quirze del Vallès;20161;9839;10322
08;Barcelona;239;Sant Quirze Safaja;669;361;308
08;Barcelona;240;Sant Sadurní d'Anoia;12915;6354;6561
08;Barcelona;241;Sant Sadurní d'Osormort;84;50;34
08;Barcelona;242;Marganell;308;154;154
08;Barcelona;243;Santa Cecília de Voltregà;192;103;89
08;Barcelona;244;Santa Coloma de Cervelló;8335;4026;4309
08;Barcelona;245;Santa Coloma de Gramenet;121203;59958;61245
08;Barcelona;246;Santa Eugènia de Berga;2308;1173;1135
08;Barcelona;247;Santa Eulàlia de Riuprimer;1487;747;740
08;Barcelona;248;Santa Eulàlia de Ronçana;7911;3959;3952
08;Barcelona;249;Santa Fe del Penedès;360;176;184
08;Barcelona;250;Santa Margarida de Montbui;10549;5308;5241
08;Barcelona;251;Santa Margarida i els Monjos;7736;3937;3799
08;Barcelona;252;Barberà del Vallès;33575;16436;17139
08;Barcelona;253;Santa Maria de Besora;164;89;75
08;Barcelona;254;Esquirol, L';2277;1134;1143
08;Barcelona;255;Santa Maria de Merlès;175;91;84
08;Barcelona;256;Santa Maria de Martorelles;873;444;429
08;Barcelona;257;Santa Maria de Miralles;137;71;66
08;Barcelona;258;Santa Maria d'Oló;1077;545;532
08;Barcelona;259;Santa Maria de Palautordera;10008;5006;5002
08;Barcelona;260;Santa Perpètua de Mogoda;25960;12974;12986
08;Barcelona;261;Santa Susanna;4023;1998;2025
08;Barcelona;262;Sant Vicenç de Castellet;10131;5091;5040
08;Barcelona;263;Sant Vicenç dels Horts;28568;14200;14368
08;Barcelona;264;Sant Vicenç de Montalt;6712;3342;3370
08;Barcelona;265;Sant Vicenç de Torelló;2092;1042;1050
08;Barcelona;266;Cerdanyola del Vallès;58100;28164;29936
08;Barcelona;267;Sentmenat;9553;4817;4736
08;Barcelona;268;Cercs;1193;609;584
08;Barcelona;269;Seva;3798;1960;1838
08;Barcelona;270;Sitges;32405;16258;16147
08;Barcelona;271;Sobremunt;101;41;60
08;Barcelona;272;Sora;219;117;102
08;Barcelona;273;Subirats;3281;1683;1598
08;Barcelona;274;Súria;6090;2954;3136
08;Barcelona;275;Tavèrnoles;341;178;163
08;Barcelona;276;Tagamanent;339;186;153
08;Barcelona;277;Talamanca;212;119;93
08;Barcelona;278;Taradell;6844;3441;3403
08;Barcelona;279;Terrassa;228708;112376;116332
08;Barcelona;280;Tavertet;131;72;59
08;Barcelona;281;Teià;6818;3376;3442
08;Barcelona;282;Tiana;9305;4524;4781
08;Barcelona;283;Tona;8511;4218;4293
08;Barcelona;284;Tordera;18780;9504;9276
08;Barcelona;285;Torelló;15093;7582;7511
08;Barcelona;286;Torre de Claramunt, La;4122;2134;1988
08;Barcelona;287;Torrelavit;1509;790;719
08;Barcelona;288;Torrelles de Foix;2657;1398;1259
08;Barcelona;289;Torrelles de Llobregat;6155;3069;3086
08;Barcelona;290;Ullastrell;2176;1088;1088
08;Barcelona;291;Vacarisses;7563;3865;3698
08;Barcelona;292;Vallbona d'Anoia;1406;721;685
08;Barcelona;293;Vallcebre;271;142;129
08;Barcelona;294;Vallgorguina;3198;1638;1560
08;Barcelona;295;Vallirana;15985;7984;8001
08;Barcelona;296;Vallromanes;2742;1395;1347
08;Barcelona;297;Veciana;172;95;77
08;Barcelona;298;Vic;49530;25055;24475
08;Barcelona;299;Vilada;443;241;202
08;Barcelona;300;Viladecavalls;7802;3867;3935
08;Barcelona;301;Viladecans;67348;33197;34151
08;Barcelona;302;Vilanova del Camí;12844;6436;6408
08;Barcelona;303;Vilanova de Sau;317;157;160
08;Barcelona;304;Vilobí del Penedès;1150;595;555
08;Barcelona;305;Vilafranca del Penedès;41504;20239;21265
08;Barcelona;306;Vilalba Sasserra;780;394;386
08;Barcelona;307;Vilanova i la Geltrú;70418;34058;36360
08;Barcelona;308;Viver i Serrateix;175;89;86
08;Barcelona;901;Rupit i Pruit;281;138;143
08;Barcelona;902;Vilanova del Vallès;5632;2871;2761
08;Barcelona;903;Sant Julià de Cerdanyola;232;130;102
08;Barcelona;904;Badia del Vallès;13118;6397;6721
08;Barcelona;905;Palma de Cervelló, La;3044;1484;1560
09;Burgos;001;Abajas;28;17;11
09;Burgos;003;Adrada de Haza;205;99;106
09;Burgos;006;Aguas Cándidas;59;40;19
09;Burgos;007;Aguilar de Bureba;50;32;18
09;Burgos;009;Albillos;214;120;94
09;Burgos;010;Alcocero de Mola;41;28;13
09;Burgos;011;Alfoz de Bricia;68;46;22
09;Burgos;012;Alfoz de Santa Gadea;101;54;47
09;Burgos;013;Altable;47;28;19
09;Burgos;014;Altos, Los;186;111;75
09;Burgos;016;Ameyugo;108;54;54
09;Burgos;017;Anguix;156;98;58
09;Burgos;018;Aranda de Duero;33757;16363;17394
09;Burgos;019;Arandilla;155;101;54
09;Burgos;020;Arauzo de Miel;274;154;120
09;Burgos;021;Arauzo de Salce;46;22;24
09;Burgos;022;Arauzo de Torre;61;36;25
09;Burgos;023;Arcos;1835;963;872
09;Burgos;024;Arenillas de Riopisuerga;166;101;65
09;Burgos;025;Arija;115;64;51
09;Burgos;026;Arlanzón;424;260;164
09;Burgos;027;Arraya de Oca;53;29;24
09;Burgos;029;Atapuerca;180;106;74
09;Burgos;030;Ausines, Los;165;101;64
09;Burgos;032;Avellanosa de Muñó;96;52;44
09;Burgos;033;Bahabón de Esgueva;84;47;37
09;Burgos;034;Balbases, Los;302;164;138
09;Burgos;035;Baños de Valdearados;318;180;138
09;Burgos;036;Bañuelos de Bureba;31;20;11
09;Burgos;037;Barbadillo de Herreros;104;63;41
09;Burgos;038;Barbadillo del Mercado;134;73;61
09;Burgos;039;Barbadillo del Pez;66;39;27
09;Burgos;041;Barrio de Muñó;32;19;13
09;Burgos;043;Barrios de Bureba, Los;178;96;82
09;Burgos;044;Barrios de Colina;55;29;26
09;Burgos;045;Basconcillos del Tozo;294;177;117
09;Burgos;046;Bascuñana;18;12;6
09;Burgos;047;Belbimbre;54;28;26
09;Burgos;048;Belorado;1834;931;903
09;Burgos;050;Berberana;48;27;21
09;Burgos;051;Berlangas de Roa;203;112;91
09;Burgos;052;Berzosa de Bureba;26;18;8
09;Burgos;054;Bozoó;102;63;39
09;Burgos;055;Brazacorta;45;30;15
09;Burgos;056;Briviesca;6560;3308;3252
09;Burgos;057;Bugedo;189;118;71
09;Burgos;058;Buniel;612;336;276
09;Burgos;059;Burgos;175895;83667;92228
09;Burgos;060;Busto de Bureba;143;80;63
09;Burgos;061;Cabañes de Esgueva;149;85;64
09;Burgos;062;Cabezón de la Sierra;36;16;20
09;Burgos;063;Cavia;248;148;100
09;Burgos;064;Caleruega;400;214;186
09;Burgos;065;Campillo de Aranda;171;96;75
09;Burgos;066;Campolara;48;34;14
09;Burgos;067;Canicosa de la Sierra;424;227;197
09;Burgos;068;Cantabrana;23;15;8
09;Burgos;070;Carazo;39;26;13
09;Burgos;071;Carcedo de Bureba;37;19;18
09;Burgos;072;Carcedo de Burgos;484;261;223
09;Burgos;073;Cardeñadijo;1430;773;657
09;Burgos;074;Cardeñajimeno;1169;619;550
09;Burgos;075;Cardeñuela Riopico;111;64;47
09;Burgos;076;Carrias;24;18;6
09;Burgos;077;Cascajares de Bureba;27;17;10
09;Burgos;078;Cascajares de la Sierra;27;15;12
09;Burgos;079;Castellanos de Castro;46;28;18
09;Burgos;082;Castildelgado;35;20;15
09;Burgos;083;Castil de Peones;28;15;13
09;Burgos;084;Castrillo de la Reina;158;105;53
09;Burgos;085;Castrillo de la Vega;621;332;289
09;Burgos;086;Castrillo del Val;823;453;370
09;Burgos;088;Castrillo de Riopisuerga;58;35;23
09;Burgos;090;Castrillo Mota de Judíos;52;28;24
09;Burgos;091;Castrojeriz;778;411;367
09;Burgos;093;Cayuela;189;111;78
09;Burgos;094;Cebrecos;58;35;23
09;Burgos;095;Celada del Camino;90;47;43
09;Burgos;098;Cerezo de Río Tirón;490;272;218
09;Burgos;100;Cerratón de Juarros;45;32;13
09;Burgos;101;Ciadoncha;70;45;25
09;Burgos;102;Cillaperlata;30;21;9
09;Burgos;103;Cilleruelo de Abajo;209;121;88
09;Burgos;104;Cilleruelo de Arriba;49;27;22
09;Burgos;105;Ciruelos de Cervera;99;56;43
09;Burgos;108;Cogollos;677;385;292
09;Burgos;109;Condado de Treviño;1489;820;669
09;Burgos;110;Contreras;87;53;34
09;Burgos;112;Coruña del Conde;100;65;35
09;Burgos;113;Covarrubias;505;281;224
09;Burgos;114;Cubillo del Campo;101;55;46
09;Burgos;115;Cubo de Bureba;101;58;43
09;Burgos;117;Cueva de Roa, La;89;49;40
09;Burgos;119;Cuevas de San Clemente;45;23;22
09;Burgos;120;Encío;41;22;19
09;Burgos;122;Espinosa de Cervera;85;54;31
09;Burgos;123;Espinosa del Camino;42;24;18
09;Burgos;124;Espinosa de los Monteros;1648;850;798
09;Burgos;125;Estépar;634;367;267
09;Burgos;127;Fontioso;54;33;21
09;Burgos;128;Frandovínez;96;53;43
09;Burgos;129;Fresneda de la Sierra Tirón;97;58;39
09;Burgos;130;Fresneña;66;43;23
09;Burgos;131;Fresnillo de las Dueñas;693;370;323
09;Burgos;132;Fresno de Río Tirón;160;95;65
09;Burgos;133;Fresno de Rodilla;49;28;21
09;Burgos;134;Frías;270;139;131
09;Burgos;135;Fuentebureba;56;33;23
09;Burgos;136;Fuentecén;237;131;106
09;Burgos;137;Fuentelcésped;273;144;129
09;Burgos;138;Fuentelisendo;99;56;43
09;Burgos;139;Fuentemolinos;91;62;29
09;Burgos;140;Fuentenebro;136;81;55
09;Burgos;141;Fuentespina;816;423;393
09;Burgos;143;Galbarros;27;18;9
09;Burgos;144;Gallega, La;39;26;13
09;Burgos;148;Grijalba;112;55;57
09;Burgos;149;Grisaleña;53;40;13
09;Burgos;151;Gumiel de Izán;584;323;261
09;Burgos;152;Gumiel de Mercado;380;210;170
09;Burgos;154;Hacinas;149;90;59
09;Burgos;155;Haza;34;24;10
09;Burgos;159;Hontanas;71;44;27
09;Burgos;160;Hontangas;99;65;34
09;Burgos;162;Hontoria de la Cantera;174;99;75
09;Burgos;163;Hontoria del Pinar;610;332;278
09;Burgos;164;Hontoria de Valdearados;164;100;64
09;Burgos;166;Hormazas, Las;99;50;49
09;Burgos;167;Hornillos del Camino;46;27;19
09;Burgos;168;Horra, La;303;172;131
09;Burgos;169;Hortigüela;107;72;35
09;Burgos;170;Hoyales de Roa;212;113;99
09;Burgos;172;Huérmeces;153;85;68
09;Burgos;173;Huerta de Arriba;128;72;56
09;Burgos;174;Huerta de Rey;881;479;402
09;Burgos;175;Humada;116;81;35
09;Burgos;176;Hurones;53;33;20
09;Burgos;177;Ibeas de Juarros;1445;760;685
09;Burgos;178;Ibrillos;29;22;7
09;Burgos;179;Iglesiarrubia;45;23;22
09;Burgos;180;Iglesias;141;72;69
09;Burgos;181;Isar;284;155;129
09;Burgos;182;Itero del Castillo;71;43;28
09;Burgos;183;Jaramillo de la Fuente;47;30;17
09;Burgos;184;Jaramillo Quemado;10;8;2
09;Burgos;189;Junta de Traslaloma;122;68;54
09;Burgos;190;Junta de Villalba de Losa;78;41;37
09;Burgos;191;Jurisdicción de Lara;41;25;16
09;Burgos;192;Jurisdicción de San Zadornil;66;39;27
09;Burgos;194;Lerma;2556;1277;1279
09;Burgos;195;Llano de Bureba;49;36;13
09;Burgos;196;Madrigal del Monte;143;87;56
09;Burgos;197;Madrigalejo del Monte;176;103;73
09;Burgos;198;Mahamud;105;61;44
09;Burgos;199;Mambrilla de Castrejón;107;68;39
09;Burgos;200;Mambrillas de Lara;56;34;22
09;Burgos;201;Mamolar;28;13;15
09;Burgos;202;Manciles;21;12;9
09;Burgos;206;Mazuela;56;32;24
09;Burgos;208;Mecerreyes;188;105;83
09;Burgos;209;Medina de Pomar;5997;3040;2957
09;Burgos;211;Melgar de Fernamental;1513;846;667
09;Burgos;213;Merindad de Cuesta-Urria;270;161;109
09;Burgos;214;Merindad de Montija;736;436;300
09;Burgos;215;Merindad de Sotoscueva;412;238;174
09;Burgos;216;Merindad de Valdeporres;421;214;207
09;Burgos;217;Merindad de Valdivielso;401;224;177
09;Burgos;218;Milagros;415;215;200
09;Burgos;219;Miranda de Ebro;36018;17793;18225
09;Burgos;220;Miraveche;95;58;37
09;Burgos;221;Modúbar de la Emparedada;769;424;345
09;Burgos;223;Monasterio de la Sierra;40;27;13
09;Burgos;224;Monasterio de Rodilla;169;95;74
09;Burgos;225;Moncalvillo;76;43;33
09;Burgos;226;Monterrubio de la Demanda;56;33;23
09;Burgos;227;Montorio;149;87;62
09;Burgos;228;Moradillo de Roa;170;91;79
09;Burgos;229;Nava de Roa;199;108;91
09;Burgos;230;Navas de Bureba;24;12;12
09;Burgos;231;Nebreda;55;34;21
09;Burgos;232;Neila;119;67;52
09;Burgos;235;Olmedillo de Roa;179;107;72
09;Burgos;236;Olmillos de Muñó;40;23;17
09;Burgos;238;Oña;951;497;454
09;Burgos;239;Oquillas;49;27;22
09;Burgos;241;Orbaneja Riopico;350;195;155
09;Burgos;242;Padilla de Abajo;67;43;24
09;Burgos;243;Padilla de Arriba;92;59;33
09;Burgos;244;Padrones de Bureba;60;30;30
09;Burgos;246;Palacios de la Sierra;675;344;331
09;Burgos;247;Palacios de Riopisuerga;18;10;8
09;Burgos;248;Palazuelos de la Sierra;93;53;40
09;Burgos;249;Palazuelos de Muñó;54;31;23
09;Burgos;250;Pampliega;291;163;128
09;Burgos;251;Pancorbo;437;235;202
09;Burgos;253;Pardilla;102;63;39
09;Burgos;255;Partido de la Sierra en Tobalina;81;52;29
09;Burgos;256;Pedrosa de Duero;460;271;189
09;Burgos;257;Pedrosa del Páramo;89;54;35
09;Burgos;258;Pedrosa del Príncipe;163;88;75
09;Burgos;259;Pedrosa de Río Úrbel;243;145;98
09;Burgos;261;Peñaranda de Duero;465;241;224
09;Burgos;262;Peral de Arlanza;170;95;75
09;Burgos;265;Piérnigas;39;23;16
09;Burgos;266;Pineda de la Sierra;94;63;31
09;Burgos;267;Pineda Trasmonte;98;62;36
09;Burgos;268;Pinilla de los Barruecos;98;60;38
09;Burgos;269;Pinilla de los Moros;33;20;13
09;Burgos;270;Pinilla Trasmonte;161;93;68
09;Burgos;272;Poza de la Sal;283;158;125
09;Burgos;273;Prádanos de Bureba;56;36;20
09;Burgos;274;Pradoluengo;1070;536;534
09;Burgos;275;Presencio;207;119;88
09;Burgos;276;Puebla de Arganzón, La;557;293;264
09;Burgos;277;Puentedura;122;79;43
09;Burgos;279;Quemada;238;140;98
09;Burgos;280;Quintanabureba;31;18;13
09;Burgos;281;Quintana del Pidio;149;79;70
09;Burgos;283;Quintanaélez;47;29;18
09;Burgos;287;Quintanaortuño;284;154;130
09;Burgos;288;Quintanapalla;120;61;59
09;Burgos;289;Quintanar de la Sierra;1513;788;725
09;Burgos;292;Quintanavides;64;37;27
09;Burgos;294;Quintanilla de la Mata;108;70;38
09;Burgos;295;Quintanilla del Coco;50;26;24
09;Burgos;297;Quintanillas, Las;388;227;161
09;Burgos;298;Quintanilla San García;68;39;29
09;Burgos;301;Quintanilla Vivar;885;471;414
09;Burgos;302;Rabanera del Pinar;99;62;37
09;Burgos;303;Rábanos;79;49;30
09;Burgos;304;Rabé de las Calzadas;250;125;125
09;Burgos;306;Rebolledo de la Torre;92;53;39
09;Burgos;307;Redecilla del Camino;93;53;40
09;Burgos;308;Redecilla del Campo;67;42;25
09;Burgos;309;Regumiel de la Sierra;301;174;127
09;Burgos;310;Reinoso;18;13;5
09;Burgos;311;Retuerta;59;35;24
09;Burgos;312;Revilla y Ahedo, La;101;58;43
09;Burgos;314;Revilla del Campo;94;58;36
09;Burgos;315;Revillarruz;634;335;299
09;Burgos;316;Revilla Vallejera;115;70;45
09;Burgos;317;Rezmondo;17;6;11
09;Burgos;318;Riocavado de la Sierra;55;35;20
09;Burgos;321;Roa;2244;1161;1083
09;Burgos;323;Rojas;60;39;21
09;Burgos;325;Royuela de Río Franco;170;103;67
09;Burgos;326;Rubena;217;126;91
09;Burgos;327;Rublacedo de Abajo;33;15;18
09;Burgos;328;Rucandio;72;37;35
09;Burgos;329;Salas de Bureba;129;77;52
09;Burgos;330;Salas de los Infantes;1984;1033;951
09;Burgos;332;Saldaña de Burgos;201;114;87
09;Burgos;334;Salinillas de Bureba;48;33;15
09;Burgos;335;San Adrián de Juarros;86;56;30
09;Burgos;337;San Juan del Monte;152;85;67
09;Burgos;338;San Mamés de Burgos;310;184;126
09;Burgos;339;San Martín de Rubiales;139;84;55
09;Burgos;340;San Millán de Lara;61;46;15
09;Burgos;343;Santa Cecilia;105;64;41
09;Burgos;345;Santa Cruz de la Salceda;134;79;55
09;Burgos;346;Santa Cruz del Valle Urbión;103;67;36
09;Burgos;347;Santa Gadea del Cid;161;89;72
09;Burgos;348;Santa Inés;155;85;70
09;Burgos;350;Santa María del Campo;523;282;241
09;Burgos;351;Santa María del Invierno;67;48;19
09;Burgos;352;Santa María del Mercadillo;108;70;38
09;Burgos;353;Santa María Ribarredonda;95;57;38
09;Burgos;354;Santa Olalla de Bureba;38;26;12
09;Burgos;355;Santibáñez de Esgueva;77;42;35
09;Burgos;356;Santibáñez del Val;70;40;30
09;Burgos;358;Santo Domingo de Silos;247;164;83
09;Burgos;360;San Vicente del Valle;28;17;11
09;Burgos;361;Sargentes de la Lora;133;76;57
09;Burgos;362;Sarracín;261;139;122
09;Burgos;363;Sasamón;912;523;389
09;Burgos;365;Sequera de Haza, La;27;19;8
09;Burgos;366;Solarana;77;48;29
09;Burgos;368;Sordillos;22;13;9
09;Burgos;369;Sotillo de la Ribera;470;254;216
09;Burgos;372;Sotragero;301;173;128
09;Burgos;373;Sotresgudo;420;251;169
09;Burgos;374;Susinos del Páramo;118;74;44
09;Burgos;375;Tamarón;55;33;22
09;Burgos;377;Tardajos;864;453;411
09;Burgos;378;Tejada;35;20;15
09;Burgos;380;Terradillos de Esgueva;64;30;34
09;Burgos;381;Tinieblas de la Sierra;23;13;10
09;Burgos;382;Tobar;27;20;7
09;Burgos;384;Tordómar;298;164;134
09;Burgos;386;Torrecilla del Monte;79;42;37
09;Burgos;387;Torregalindo;123;69;54
09;Burgos;388;Torrelara;32;21;11
09;Burgos;389;Torrepadre;65;38;27
09;Burgos;390;Torresandino;574;296;278
09;Burgos;391;Tórtoles de Esgueva;387;219;168
09;Burgos;392;Tosantos;53;28;25
09;Burgos;394;Trespaderne;713;350;363
09;Burgos;395;Tubilla del Agua;128;83;45
09;Burgos;396;Tubilla del Lago;171;90;81
09;Burgos;398;Úrbel del Castillo;58;43;15
09;Burgos;400;Vadocondes;364;202;162
09;Burgos;403;Valdeande;98;57;41
09;Burgos;405;Valdezate;121;70;51
09;Burgos;406;Valdorros;375;210;165
09;Burgos;407;Valmala;26;13;13
09;Burgos;408;Vallarta de Bureba;42;27;15
09;Burgos;409;Valle de Manzanedo;115;63;52
09;Burgos;410;Valle de Mena;4140;2094;2046
09;Burgos;411;Valle de Oca;163;96;67
09;Burgos;412;Valle de Tobalina;863;472;391
09;Burgos;413;Valle de Valdebezana;482;265;217
09;Burgos;414;Valle de Valdelaguna;191;113;78
09;Burgos;415;Valle de Valdelucio;330;189;141
09;Burgos;416;Valle de Zamanzas;45;29;16
09;Burgos;417;Vallejera;39;23;16
09;Burgos;418;Valles de Palenzuela;75;43;32
09;Burgos;419;Valluércanes;63;43;20
09;Burgos;421;Vid y Barrios, La;245;140;105
09;Burgos;422;Vid de Bureba, La;24;13;11
09;Burgos;423;Vileña;27;17;10
09;Burgos;424;Viloria de Rioja;37;23;14
09;Burgos;425;Vilviestre del Pinar;504;279;225
09;Burgos;427;Villadiego;1455;799;656
09;Burgos;428;Villaescusa de Roa;90;48;42
09;Burgos;429;Villaescusa la Sombría;60;41;19
09;Burgos;430;Villaespasa;22;14;8
09;Burgos;431;Villafranca Montes de Oca;122;76;46
09;Burgos;432;Villafruela;143;86;57
09;Burgos;433;Villagalijo;52;30;22
09;Burgos;434;Villagonzalo Pedernales;1882;995;887
09;Burgos;437;Villahoz;287;162;125
09;Burgos;438;Villalba de Duero;706;372;334
09;Burgos;439;Villalbilla de Burgos;1514;811;703
09;Burgos;440;Villalbilla de Gumiel;74;49;25
09;Burgos;441;Villaldemiro;91;52;39
09;Burgos;442;Villalmanzo;410;222;188
09;Burgos;443;Villamayor de los Montes;160;78;82
09;Burgos;444;Villamayor de Treviño;56;32;24
09;Burgos;445;Villambistia;43;32;11
09;Burgos;446;Villamedianilla;9;6;3
09;Burgos;447;Villamiel de la Sierra;43;26;17
09;Burgos;448;Villangómez;232;139;93
09;Burgos;449;Villanueva de Argaño;122;73;49
09;Burgos;450;Villanueva de Carazo;27;17;10
09;Burgos;451;Villanueva de Gumiel;279;140;139
09;Burgos;454;Villanueva de Teba;42;23;19
09;Burgos;455;Villaquirán de la Puebla;46;28;18
09;Burgos;456;Villaquirán de los Infantes;138;74;64
09;Burgos;458;Villariezo;719;393;326
09;Burgos;460;Villasandino;178;101;77
09;Burgos;463;Villasur de Herreros;273;160;113
09;Burgos;464;Villatuelda;53;28;25
09;Burgos;466;Villaverde del Monte;108;64;44
09;Burgos;467;Villaverde-Mogina;75;50;25
09;Burgos;471;Villayerno Morquillas;205;107;98
09;Burgos;472;Villazopeque;52;31;21
09;Burgos;473;Villegas;79;41;38
09;Burgos;476;Villoruebo;63;43;20
09;Burgos;478;Vizcaínos;40;35;5
09;Burgos;480;Zael;115;58;57
09;Burgos;482;Zarzosa de Río Pisuerga;31;20;11
09;Burgos;483;Zazuar;209;109;100
09;Burgos;485;Zuñeda;57;30;27
09;Burgos;901;Quintanilla del Agua y Tordueles;335;183;152
09;Burgos;902;Valle de Santibáñez;479;284;195
09;Burgos;903;Villarcayo de Merindad de Castilla la Vieja;4047;2066;1981
09;Burgos;904;Valle de las Navas;543;318;225
09;Burgos;905;Valle de Sedano;409;232;177
09;Burgos;906;Merindad de Río Ubierna;1411;792;619
09;Burgos;907;Alfoz de Quintanadueñas;2133;1116;1017
09;Burgos;908;Valle de Losa;496;281;215
10;Cáceres;001;Abadía;331;183;148
10;Cáceres;002;Abertura;368;187;181
10;Cáceres;003;Acebo;576;291;285
10;Cáceres;004;Acehúche;805;410;395
10;Cáceres;005;Aceituna;581;302;279
10;Cáceres;006;Ahigal;1349;681;668
10;Cáceres;007;Albalá;657;341;316
10;Cáceres;008;Alcántara;1347;680;667
10;Cáceres;009;Alcollarín;266;134;132
10;Cáceres;010;Alcuéscar;2454;1284;1170
10;Cáceres;011;Aldeacentenera;593;324;269
10;Cáceres;012;Aldea del Cano;600;302;298
10;Cáceres;013;Aldea del Obispo, La;286;152;134
10;Cáceres;014;Aldeanueva de la Vera;1997;978;1019
10;Cáceres;015;Aldeanueva del Camino;704;344;360
10;Cáceres;016;Aldehuela de Jerte;352;182;170
10;Cáceres;017;Alía;746;382;364
10;Cáceres;018;Aliseda;1724;885;839
10;Cáceres;019;Almaraz;1615;823;792
10;Cáceres;020;Almoharín;1779;888;891
10;Cáceres;021;Arroyo de la Luz;5520;2737;2783
10;Cáceres;022;Arroyomolinos de la Vera;426;221;205
10;Cáceres;023;Arroyomolinos;812;409;403
10;Cáceres;024;Baños de Montemayor;737;347;390
10;Cáceres;025;Barrado;382;200;182
10;Cáceres;026;Belvís de Monroy;743;386;357
10;Cáceres;027;Benquerencia;84;46;38
10;Cáceres;028;Berrocalejo;124;66;58
10;Cáceres;029;Berzocana;395;204;191
10;Cáceres;030;Bohonal de Ibor;503;250;253
10;Cáceres;031;Botija;188;101;87
10;Cáceres;032;Brozas;1746;868;878
10;Cáceres;033;Cabañas del Castillo;407;209;198
10;Cáceres;034;Cabezabellosa;335;172;163
10;Cáceres;035;Cabezuela del Valle;2127;1080;1047
10;Cáceres;036;Cabrero;349;196;153
10;Cáceres;037;Cáceres;96441;46159;50282
10;Cáceres;038;Cachorrilla;82;41;41
10;Cáceres;039;Cadalso;407;209;198
10;Cáceres;040;Calzadilla;455;234;221
10;Cáceres;041;Caminomorisco;1120;596;524
10;Cáceres;042;Campillo de Deleitosa;84;40;44
10;Cáceres;043;Campo Lugar;804;399;405
10;Cáceres;044;Cañamero;1601;848;753
10;Cáceres;045;Cañaveral;1008;515;493
10;Cáceres;046;Carbajo;177;91;86
10;Cáceres;047;Carcaboso;1069;547;522
10;Cáceres;048;Carrascalejo;225;116;109
10;Cáceres;049;Casar de Cáceres;4477;2215;2262
10;Cáceres;050;Casar de Palomero;993;515;478
10;Cáceres;051;Casares de las Hurdes;369;191;178
10;Cáceres;052;Casas de Don Antonio;177;96;81
10;Cáceres;053;Casas de Don Gómez;330;181;149
10;Cáceres;054;Casas del Castañar;578;302;276
10;Cáceres;055;Casas del Monte;768;396;372
10;Cáceres;056;Casas de Millán;564;282;282
10;Cáceres;057;Casas de Miravete;112;75;37
10;Cáceres;058;Casatejada;1382;742;640
10;Cáceres;059;Casillas de Coria;344;173;171
10;Cáceres;060;Castañar de Ibor;1032;535;497
10;Cáceres;061;Ceclavín;1781;905;876
10;Cáceres;062;Cedillo;434;220;214
10;Cáceres;063;Cerezo;147;73;74
10;Cáceres;064;Cilleros;1555;793;762
10;Cáceres;065;Collado de la Vera;276;146;130
10;Cáceres;066;Conquista de la Sierra;183;111;72
10;Cáceres;067;Coria;12114;5972;6142
10;Cáceres;068;Cuacos de Yuste;829;415;414
10;Cáceres;069;Cumbre, La;828;414;414
10;Cáceres;070;Deleitosa;682;354;328
10;Cáceres;071;Descargamaría;108;59;49
10;Cáceres;072;Eljas;836;426;410
10;Cáceres;073;Escurial;869;463;406
10;Cáceres;075;Fresnedoso de Ibor;239;128;111
10;Cáceres;076;Galisteo;835;417;418
10;Cáceres;077;Garciaz;664;347;317
10;Cáceres;078;Garganta, La;353;189;164
10;Cáceres;079;Garganta la Olla;883;470;413
10;Cáceres;080;Gargantilla;364;188;176
10;Cáceres;081;Gargüera;182;99;83
10;Cáceres;082;Garrovillas de Alconétar;1959;963;996
10;Cáceres;083;Garvín;94;55;39
10;Cáceres;084;Gata;1353;690;663
10;Cáceres;085;Gordo, El;369;200;169
10;Cáceres;086;Granja, La;313;163;150
10;Cáceres;087;Guadalupe;1752;876;876
10;Cáceres;088;Guijo de Coria;189;106;83
10;Cáceres;089;Guijo de Galisteo;1487;748;739
10;Cáceres;090;Guijo de Granadilla;487;253;234
10;Cáceres;091;Guijo de Santa Bárbara;363;194;169
10;Cáceres;092;Herguijuela;267;141;126
10;Cáceres;093;Hernán-Pérez;411;200;211
10;Cáceres;094;Herrera de Alcántara;224;122;102
10;Cáceres;095;Herreruela;325;163;162
10;Cáceres;096;Hervás;3921;1921;2000
10;Cáceres;097;Higuera de Albalat;100;56;44
10;Cáceres;098;Hinojal;388;194;194
10;Cáceres;099;Holguera;593;298;295
10;Cáceres;100;Hoyos;858;433;425
10;Cáceres;101;Huélaga;205;98;107
10;Cáceres;102;Ibahernando;545;267;278
10;Cáceres;103;Jaraicejo;436;210;226
10;Cáceres;104;Jaraíz de la Vera;6720;3407;3313
10;Cáceres;105;Jarandilla de la Vera;2845;1411;1434
10;Cáceres;106;Jarilla;139;73;66
10;Cáceres;107;Jerte;1200;599;601
10;Cáceres;108;Ladrillar;185;109;76
10;Cáceres;109;Logrosán;1903;980;923
10;Cáceres;110;Losar de la Vera;2805;1423;1382
10;Cáceres;111;Madrigal de la Vera;1533;811;722
10;Cáceres;112;Madrigalejo;1708;858;850
10;Cáceres;113;Madroñera;2364;1189;1175
10;Cáceres;114;Majadas;1267;644;623
10;Cáceres;115;Malpartida de Cáceres;4030;2012;2018
10;Cáceres;116;Malpartida de Plasencia;4673;2314;2359
10;Cáceres;117;Marchagaz;236;129;107
10;Cáceres;118;Mata de Alcántara;286;146;140
10;Cáceres;119;Membrío;572;285;287
10;Cáceres;120;Mesas de Ibor;152;75;77
10;Cáceres;121;Miajadas;9370;4656;4714
10;Cáceres;122;Millanes;223;116;107
10;Cáceres;123;Mirabel;632;324;308
10;Cáceres;124;Mohedas de Granadilla;850;417;433
10;Cáceres;125;Monroy;884;460;424
10;Cáceres;126;Montánchez;1608;811;797
10;Cáceres;127;Montehermoso;5586;2843;2743
10;Cáceres;128;Moraleja;6578;3260;3318
10;Cáceres;129;Morcillo;369;175;194
10;Cáceres;130;Navaconcejo;2044;1027;1017
10;Cáceres;131;Navalmoral de la Mata;17028;8241;8787
10;Cáceres;132;Navalvillar de Ibor;378;198;180
10;Cáceres;133;Navas del Madroño;1259;624;635
10;Cáceres;134;Navezuelas;649;335;314
10;Cáceres;135;Nuñomoral;1202;648;554
10;Cáceres;136;Oliva de Plasencia;292;169;123
10;Cáceres;137;Palomero;445;233;212
10;Cáceres;138;Pasarón de la Vera;592;283;309
10;Cáceres;139;Pedroso de Acim;92;55;37
10;Cáceres;140;Peraleda de la Mata;1431;714;717
10;Cáceres;141;Peraleda de San Román;277;155;122
10;Cáceres;142;Perales del Puerto;903;457;446
10;Cáceres;143;Pescueza;150;67;83
10;Cáceres;144;Pesga, La;955;496;459
10;Cáceres;145;Piedras Albas;125;60;65
10;Cáceres;146;Pinofranqueado;1763;926;837
10;Cáceres;147;Piornal;1454;741;713
10;Cáceres;148;Plasencia;39829;19139;20690
10;Cáceres;149;Plasenzuela;518;260;258
10;Cáceres;150;Portaje;380;194;186
10;Cáceres;151;Portezuelo;206;113;93
10;Cáceres;152;Pozuelo de Zarzón;428;216;212
10;Cáceres;153;Puerto de Santa Cruz;264;136;128
10;Cáceres;154;Rebollar;196;104;92
10;Cáceres;155;Riolobos;1180;575;605
10;Cáceres;156;Robledillo de Gata;94;56;38
10;Cáceres;157;Robledillo de la Vera;259;135;124
10;Cáceres;158;Robledillo de Trujillo;368;194;174
10;Cáceres;159;Robledollano;320;181;139
10;Cáceres;160;Romangordo;251;121;130
10;Cáceres;161;Ruanes;81;40;41
10;Cáceres;162;Salorino;537;288;249
10;Cáceres;163;Salvatierra de Santiago;248;127;121
10;Cáceres;164;San Martín de Trevejo;702;336;366
10;Cáceres;165;Santa Ana;307;155;152
10;Cáceres;166;Santa Cruz de la Sierra;322;167;155
10;Cáceres;167;Santa Cruz de Paniagua;286;164;122
10;Cáceres;168;Santa Marta de Magasca;292;148;144
10;Cáceres;169;Santiago de Alcántara;465;229;236
10;Cáceres;170;Santiago del Campo;247;125;122
10;Cáceres;171;Santibáñez el Alto;379;208;171
10;Cáceres;172;Santibáñez el Bajo;710;371;339
10;Cáceres;173;Saucedilla;994;521;473
10;Cáceres;174;Segura de Toro;180;95;85
10;Cáceres;175;Serradilla;1482;737;745
10;Cáceres;176;Serrejón;407;206;201
10;Cáceres;177;Sierra de Fuentes;2056;1052;1004
10;Cáceres;178;Talaván;769;398;371
10;Cáceres;179;Talaveruela de la Vera;301;156;145
10;Cáceres;180;Talayuela;7304;3891;3413
10;Cáceres;181;Tejeda de Tiétar;766;400;366
10;Cáceres;182;Toril;159;98;61
10;Cáceres;183;Tornavacas;991;517;474
10;Cáceres;184;Torno, El;833;451;382
10;Cáceres;185;Torrecilla de los Ángeles;640;336;304
10;Cáceres;186;Torrecillas de la Tiesa;1047;530;517
10;Cáceres;187;Torre de Don Miguel;476;246;230
10;Cáceres;188;Torre de Santa María;517;254;263
10;Cáceres;189;Torrejoncillo;2765;1353;1412
10;Cáceres;190;Torrejón el Rubio;535;273;262
10;Cáceres;191;Torremenga;616;319;297
10;Cáceres;192;Torremocha;736;375;361
10;Cáceres;193;Torreorgaz;1676;828;848
10;Cáceres;194;Torrequemada;560;276;284
10;Cáceres;195;Trujillo;8619;4176;4443
10;Cáceres;196;Valdastillas;319;162;157
10;Cáceres;197;Valdecañas de Tajo;96;53;43
10;Cáceres;198;Valdefuentes;1100;541;559
10;Cáceres;199;Valdehúncar;186;103;83
10;Cáceres;200;Valdelacasa de Tajo;342;178;164
10;Cáceres;201;Valdemorales;215;108;107
10;Cáceres;202;Valdeobispo;610;306;304
10;Cáceres;203;Valencia de Alcántara;5196;2562;2634
10;Cáceres;204;Valverde de la Vera;448;226;222
10;Cáceres;205;Valverde del Fresno;2121;1072;1049
10;Cáceres;206;Viandar de la Vera;218;112;106
10;Cáceres;207;Villa del Campo;439;224;215
10;Cáceres;208;Villa del Rey;116;59;57
10;Cáceres;209;Villamesías;275;149;126
10;Cáceres;210;Villamiel;379;188;191
10;Cáceres;211;Villanueva de la Sierra;493;258;235
10;Cáceres;212;Villanueva de la Vera;2110;1056;1054
10;Cáceres;213;Villar del Pedroso;556;288;268
10;Cáceres;214;Villar de Plasencia;231;122;109
10;Cáceres;215;Villasbuenas de Gata;510;250;260
10;Cáceres;216;Zarza de Granadilla;1803;914;889
10;Cáceres;217;Zarza de Montánchez;519;269;250
10;Cáceres;218;Zarza la Mayor;1117;562;555
10;Cáceres;219;Zorita;1248;614;634
10;Cáceres;901;Rosalejo;1328;683;645
10;Cáceres;902;Vegaviana;844;429;415
10;Cáceres;903;Alagón del Río;909;452;457
10;Cáceres;904;Tiétar;854;460;394
10;Cáceres;905;Pueblonuevo de Miramontes;775;388;387
11;Cádiz;001;Alcalá de los Gazules;5223;2683;2540
11;Cádiz;002;Alcalá del Valle;4936;2484;2452
11;Cádiz;003;Algar;1436;721;715
11;Cádiz;004;Algeciras;124978;61541;63437
11;Cádiz;005;Algodonales;5443;2744;2699
11;Cádiz;006;Arcos de la Frontera;31046;15482;15564
11;Cádiz;007;Barbate;22709;11323;11386
11;Cádiz;008;Barrios, Los;24404;12232;12172
11;Cádiz;009;Benaocaz;754;404;350
11;Cádiz;010;Bornos;7533;3756;3777
11;Cádiz;011;Bosque, El;2249;1123;1126
11;Cádiz;012;Cádiz;110914;52253;58661
11;Cádiz;013;Castellar de la Frontera;2976;1461;1515
11;Cádiz;014;Conil de la Frontera;23996;12010;11986
11;Cádiz;015;Chiclana de la Frontera;89794;44751;45043
11;Cádiz;016;Chipiona;19915;9948;9967
11;Cádiz;017;Espera;3777;1888;1889
11;Cádiz;018;Gastor, El;1698;858;840
11;Cádiz;019;Grazalema;1998;991;1007
11;Cádiz;020;Jerez de la Frontera;213688;104071;109617
11;Cádiz;021;Jimena de la Frontera;6695;3404;3291
11;Cádiz;022;Línea de la Concepción, La;64177;31608;32569
11;Cádiz;023;Medina Sidonia;11764;5937;5827
11;Cádiz;024;Olvera;7864;3864;4000
11;Cádiz;025;Paterna de Rivera;5505;2858;2647
11;Cádiz;026;Prado del Rey;5667;2786;2881
11;Cádiz;027;Puerto de Santa María, El;89960;43978;45982
11;Cádiz;028;Puerto Real;42151;21082;21069
11;Cádiz;029;Puerto Serrano;6898;3501;3397
11;Cádiz;030;Rota;29552;14631;14921
11;Cádiz;031;San Fernando;93645;45604;48041
11;Cádiz;032;Sanlúcar de Barrameda;69876;34751;35125
11;Cádiz;033;San Roque;34190;17025;17165
11;Cádiz;034;Setenil de las Bodegas;2624;1361;1263
11;Cádiz;035;Tarifa;18664;9330;9334
11;Cádiz;036;Torre Alháquime;798;400;398
11;Cádiz;037;Trebujena;7015;3512;3503
11;Cádiz;038;Ubrique;16439;8075;8364
11;Cádiz;039;Vejer de la Frontera;12915;6448;6467
11;Cádiz;040;Villaluenga del Rosario;462;233;229
11;Cádiz;041;Villamartín;12169;6123;6046
11;Cádiz;042;Zahara;1355;685;670
11;Cádiz;901;Benalup-Casas Viejas;7228;3660;3568
11;Cádiz;902;San José del Valle;4472;2274;2198
11;Cádiz;903;San Martín del Tesorillo;2739;1411;1328
12;Castellón/Castelló;001;Atzeneta del Maestrat;1309;673;636
12;Castellón/Castelló;002;Aín;131;68;63
12;Castellón/Castelló;003;Albocàsser;1338;666;672
12;Castellón/Castelló;004;Alcalà de Xivert;7176;3631;3545
12;Castellón/Castelló;005;Alcora, l';10581;5296;5285
12;Castellón/Castelló;006;Alcudia de Veo;213;114;99
12;Castellón/Castelló;007;Alfondeguilla;870;426;444
12;Castellón/Castelló;008;Algimia de Almonacid;258;139;119
12;Castellón/Castelló;009;Almassora;28497;14302;14195
12;Castellón/Castelló;010;Almedíjar;288;156;132
12;Castellón/Castelló;011;Almenara;6710;3318;3392
12;Castellón/Castelló;012;Altura;3790;1953;1837
12;Castellón/Castelló;013;Arañuel;159;90;69
12;Castellón/Castelló;014;Ares del Maestrat;177;108;69
12;Castellón/Castelló;015;Argelita;146;77;69
12;Castellón/Castelló;016;Artana;1971;1001;970
12;Castellón/Castelló;017;Ayódar;182;101;81
12;Castellón/Castelló;018;Azuébar;352;183;169
12;Castellón/Castelló;020;Barracas;195;103;92
12;Castellón/Castelló;021;Betxí;5592;2765;2827
12;Castellón/Castelló;022;Bejís;400;241;159
12;Castellón/Castelló;024;Benafer;170;80;90
12;Castellón/Castelló;025;Benafigos;126;74;52
12;Castellón/Castelló;026;Benassal;1052;546;506
12;Castellón/Castelló;027;Benicarló;29607;15082;14525
12;Castellón/Castelló;028;Benicàssim/Benicasim;20322;9984;10338
12;Castellón/Castelló;029;Benlloc;1115;565;550
12;Castellón/Castelló;031;Borriol;5945;3044;2901
12;Castellón/Castelló;032;Borriana/Burriana;36927;18411;18516
12;Castellón/Castelló;033;Cabanes;3313;1720;1593
12;Castellón/Castelló;034;Càlig;2048;1027;1021
12;Castellón/Castelló;036;Canet lo Roig;699;355;344
12;Castellón/Castelló;037;Castell de Cabres;22;13;9
12;Castellón/Castelló;038;Castellfort;190;98;92
12;Castellón/Castelló;039;Castellnovo;884;459;425
12;Castellón/Castelló;040;Castelló de la Plana;180379;87037;93342
12;Castellón/Castelló;041;Castillo de Villamalefa;113;74;39
12;Castellón/Castelló;042;Catí;760;382;378
12;Castellón/Castelló;043;Caudiel;722;366;356
12;Castellón/Castelló;044;Cervera del Maestre;643;325;318
12;Castellón/Castelló;045;Cinctorres;442;221;221
12;Castellón/Castelló;046;Cirat;214;116;98
12;Castellón/Castelló;048;Cortes de Arenoso;311;159;152
12;Castellón/Castelló;049;Costur;535;279;256
12;Castellón/Castelló;050;Coves de Vinromà, les;1865;959;906
12;Castellón/Castelló;051;Culla;493;254;239
12;Castellón/Castelló;052;Xert;686;344;342
12;Castellón/Castelló;053;Chilches/Xilxes;3094;1585;1509
12;Castellón/Castelló;055;Xodos/Chodos;116;71;45
12;Castellón/Castelló;056;Chóvar;312;165;147
12;Castellón/Castelló;057;Eslida;785;401;384
12;Castellón/Castelló;058;Espadilla;89;49;40
12;Castellón/Castelló;059;Fanzara;297;155;142
12;Castellón/Castelló;060;Figueroles;518;257;261
12;Castellón/Castelló;061;Forcall;477;229;248
12;Castellón/Castelló;063;Fuente la Reina;59;32;27
12;Castellón/Castelló;064;Fuentes de Ayódar;95;56;39
12;Castellón/Castelló;065;Gaibiel;199;113;86
12;Castellón/Castelló;067;Geldo;651;326;325
12;Castellón/Castelló;068;Herbers;69;44;25
12;Castellón/Castelló;069;Higueras;46;19;27
12;Castellón/Castelló;070;Jana, la;688;355;333
12;Castellón/Castelló;071;Jérica;1726;870;856
12;Castellón/Castelló;072;Llucena/Lucena del Cid;1420;711;709
12;Castellón/Castelló;073;Ludiente;175;98;77
12;Castellón/Castelló;074;Llosa, la;1042;502;540
12;Castellón/Castelló;075;Mata de Morella, la;184;103;81
12;Castellón/Castelló;076;Matet;91;56;35
12;Castellón/Castelló;077;Moncofa;8011;4078;3933
12;Castellón/Castelló;078;Montán;421;217;204
12;Castellón/Castelló;079;Montanejos;643;332;311
12;Castellón/Castelló;080;Morella;2494;1233;1261
12;Castellón/Castelló;081;Navajas;846;435;411
12;Castellón/Castelló;082;Nules;14062;7056;7006
12;Castellón/Castelló;083;Olocau del Rey;135;70;65
12;Castellón/Castelló;084;Onda;25817;12922;12895
12;Castellón/Castelló;085;Orpesa/Oropesa del Mar;11785;6035;5750
12;Castellón/Castelló;087;Palanques;34;20;14
12;Castellón/Castelló;088;Pavías;73;45;28
12;Castellón/Castelló;089;Peníscola/Peñíscola;8496;4329;4167
12;Castellón/Castelló;090;Pina de Montalgrao;118;67;51
12;Castellón/Castelló;091;Portell de Morella;155;79;76
12;Castellón/Castelló;092;Puebla de Arenoso;174;94;80
12;Castellón/Castelló;093;Pobla de Benifassà, la;240;141;99
12;Castellón/Castelló;094;Pobla Tornesa, la;1325;677;648
12;Castellón/Castelló;095;Ribesalbes;1163;606;557
12;Castellón/Castelló;096;Rossell;892;464;428
12;Castellón/Castelló;097;Sacañet;77;52;25
12;Castellón/Castelló;098;Salzadella, la;678;343;335
12;Castellón/Castelló;099;Sant Jordi/San Jorge;1381;722;659
12;Castellón/Castelló;100;Sant Mateu;2004;1001;1003
12;Castellón/Castelló;101;San Rafael del Río;530;261;269
12;Castellón/Castelló;102;Santa Magdalena de Pulpis;768;401;367
12;Castellón/Castelló;103;Serratella, la;113;54;59
12;Castellón/Castelló;104;Segorbe;9640;4792;4848
12;Castellón/Castelló;105;Sierra Engarcerán;1043;550;493
12;Castellón/Castelló;106;Soneja;1513;740;773
12;Castellón/Castelló;107;Sot de Ferrer;498;263;235
12;Castellón/Castelló;108;Suera/Sueras;573;294;279
12;Castellón/Castelló;109;Tales;834;433;401
12;Castellón/Castelló;110;Teresa;231;128;103
12;Castellón/Castelló;111;Tírig;432;222;210
12;Castellón/Castelló;112;Todolella;147;87;60
12;Castellón/Castelló;113;Toga;108;59;49
12;Castellón/Castelló;114;Torás;268;141;127
12;Castellón/Castelló;115;Toro, El;262;138;124
12;Castellón/Castelló;116;Torralba del Pinar;59;30;29
12;Castellón/Castelló;117;Torreblanca;5674;2863;2811
12;Castellón/Castelló;118;Torrechiva;127;66;61
12;Castellón/Castelló;119;Torre d'en Besora, la;163;92;71
12;Castellón/Castelló;120;Torre d'en Doménec, la;182;94;88
12;Castellón/Castelló;121;Traiguera;1300;668;632
12;Castellón/Castelló;122;Useres, les/Useras;961;507;454
12;Castellón/Castelló;123;Vallat;71;35;36
12;Castellón/Castelló;124;Vall d'Alba;3103;1642;1461
12;Castellón/Castelló;125;Vall de Almonacid;281;148;133
12;Castellón/Castelló;126;Vall d'Uixó, la;31884;15654;16230
12;Castellón/Castelló;127;Vallibona;64;37;27
12;Castellón/Castelló;128;Vilafamés;1938;1038;900
12;Castellón/Castelló;129;Vilafranca/Villafranca del Cid;2139;1088;1051
12;Castellón/Castelló;130;Villahermosa del Río;490;267;223
12;Castellón/Castelló;131;Villamalur;97;61;36
12;Castellón/Castelló;132;Vilanova d'Alcolea;585;314;271
12;Castellón/Castelló;133;Villanueva de Viver;98;52;46
12;Castellón/Castelló;134;Vilar de Canes;156;75;81
12;Castellón/Castelló;135;Vila-real;52505;26007;26498
12;Castellón/Castelló;136;Vilavella, la;3073;1525;1548
12;Castellón/Castelló;137;Villores;53;25;28
12;Castellón/Castelló;138;Vinaròs;30278;14942;15336
12;Castellón/Castelló;139;Vistabella del Maestrat;361;200;161
12;Castellón/Castelló;140;Viver;1680;869;811
12;Castellón/Castelló;141;Zorita del Maestrazgo;111;54;57
12;Castellón/Castelló;142;Zucaina;174;99;75
12;Castellón/Castelló;901;Alqueries, les/Alquerías del Niño Perdido;4563;2293;2270
12;Castellón/Castelló;902;Sant Joan de Moró;3644;1870;1774
13;Ciudad Real;001;Abenójar;1324;684;640
13;Ciudad Real;002;Agudo;1604;808;796
13;Ciudad Real;003;Alamillo;461;239;222
13;Ciudad Real;004;Albaladejo;1003;522;481
13;Ciudad Real;005;Alcázar de San Juan;31382;15279;16103
13;Ciudad Real;006;Alcoba;567;289;278
13;Ciudad Real;007;Alcolea de Calatrava;1361;693;668
13;Ciudad Real;008;Alcubillas;418;214;204
13;Ciudad Real;009;Aldea del Rey;1577;801;776
13;Ciudad Real;010;Alhambra;969;496;473
13;Ciudad Real;011;Almadén;4902;2368;2534
13;Ciudad Real;012;Almadenejos;393;201;192
13;Ciudad Real;013;Almagro;9049;4493;4556
13;Ciudad Real;014;Almedina;482;265;217
13;Ciudad Real;015;Almodóvar del Campo;5706;2871;2835
13;Ciudad Real;016;Almuradiel;752;373;379
13;Ciudad Real;017;Anchuras;274;149;125
13;Ciudad Real;018;Arenas de San Juan;1035;530;505
13;Ciudad Real;019;Argamasilla de Alba;6925;3512;3413
13;Ciudad Real;020;Argamasilla de Calatrava;5802;2918;2884
13;Ciudad Real;021;Arroba de los Montes;406;220;186
13;Ciudad Real;022;Ballesteros de Calatrava;361;186;175
13;Ciudad Real;023;Bolaños de Calatrava;12067;6238;5829
13;Ciudad Real;024;Brazatortas;1001;531;470
13;Ciudad Real;025;Cabezarados;297;160;137
13;Ciudad Real;026;Cabezarrubias del Puerto;488;256;232
13;Ciudad Real;027;Calzada de Calatrava;3727;1865;1862
13;Ciudad Real;028;Campo de Criptana;12932;6491;6441
13;Ciudad Real;029;Cañada de Calatrava;103;59;44
13;Ciudad Real;030;Caracuel de Calatrava;134;81;53
13;Ciudad Real;031;Carrión de Calatrava;3233;1642;1591
13;Ciudad Real;032;Carrizosa;1106;557;549
13;Ciudad Real;033;Castellar de Santiago;1762;899;863
13;Ciudad Real;034;Ciudad Real;75909;35946;39963
13;Ciudad Real;035;Corral de Calatrava;1128;552;576
13;Ciudad Real;036;Cortijos, Los;847;442;405
13;Ciudad Real;037;Cózar;899;470;429
13;Ciudad Real;038;Chillón;1773;857;916
13;Ciudad Real;039;Daimiel;17645;8898;8747
13;Ciudad Real;040;Fernán Caballero;965;489;476
13;Ciudad Real;041;Fontanarejo;233;132;101
13;Ciudad Real;042;Fuencaliente;1001;522;479
13;Ciudad Real;043;Fuenllana;200;110;90
13;Ciudad Real;044;Fuente el Fresno;3047;1570;1477
13;Ciudad Real;045;Granátula de Calatrava;686;331;355
13;Ciudad Real;046;Guadalmez;707;352;355
13;Ciudad Real;047;Herencia;8459;4315;4144
13;Ciudad Real;048;Hinojosas de Calatrava;508;267;241
13;Ciudad Real;049;Horcajo de los Montes;795;409;386
13;Ciudad Real;050;Labores, Las;547;290;257
13;Ciudad Real;051;Luciana;360;190;170
13;Ciudad Real;052;Malagón;7754;3878;3876
13;Ciudad Real;053;Manzanares;17745;8794;8951
13;Ciudad Real;054;Membrilla;5839;2913;2926
13;Ciudad Real;055;Mestanza;657;346;311
13;Ciudad Real;056;Miguelturra;15834;7963;7871
13;Ciudad Real;057;Montiel;1197;630;567
13;Ciudad Real;058;Moral de Calatrava;5103;2572;2531
13;Ciudad Real;059;Navalpino;195;103;92
13;Ciudad Real;060;Navas de Estena;282;151;131
13;Ciudad Real;061;Pedro Muñoz;7567;3823;3744
13;Ciudad Real;062;Picón;690;358;332
13;Ciudad Real;063;Piedrabuena;4345;2217;2128
13;Ciudad Real;064;Poblete;2940;1501;1439
13;Ciudad Real;065;Porzuna;3516;1819;1697
13;Ciudad Real;066;Pozuelo de Calatrava;3894;2033;1861
13;Ciudad Real;067;Pozuelos de Calatrava, Los;345;178;167
13;Ciudad Real;068;Puebla de Don Rodrigo;1137;620;517
13;Ciudad Real;069;Puebla del Príncipe;647;341;306
13;Ciudad Real;070;Puerto Lápice;865;428;437
13;Ciudad Real;071;Puertollano;45195;21754;23441
13;Ciudad Real;072;Retuerta del Bullaque;867;481;386
13;Ciudad Real;073;Saceruela;518;262;256
13;Ciudad Real;074;San Carlos del Valle;1071;542;529
13;Ciudad Real;075;San Lorenzo de Calatrava;197;109;88
13;Ciudad Real;076;Santa Cruz de los Cáñamos;471;223;248
13;Ciudad Real;077;Santa Cruz de Mudela;3871;1926;1945
13;Ciudad Real;078;Socuéllamos;12157;6128;6029
13;Ciudad Real;079;Solana, La;15225;7796;7429
13;Ciudad Real;080;Solana del Pino;332;171;161
13;Ciudad Real;081;Terrinches;586;307;279
13;Ciudad Real;082;Tomelloso;36523;18273;18250
13;Ciudad Real;083;Torralba de Calatrava;3075;1535;1540
13;Ciudad Real;084;Torre de Juan Abad;944;470;474
13;Ciudad Real;085;Torrenueva;2669;1350;1319
13;Ciudad Real;086;Valdemanco del Esteras;163;87;76
13;Ciudad Real;087;Valdepeñas;30617;14946;15671
13;Ciudad Real;088;Valenzuela de Calatrava;653;310;343
13;Ciudad Real;089;Villahermosa;1709;851;858
13;Ciudad Real;090;Villamanrique;1072;521;551
13;Ciudad Real;091;Villamayor de Calatrava;619;304;315
13;Ciudad Real;092;Villanueva de la Fuente;1883;974;909
13;Ciudad Real;093;Villanueva de los Infantes;4785;2375;2410
13;Ciudad Real;094;Villanueva de San Carlos;272;141;131
13;Ciudad Real;095;Villar del Pozo;47;29;18
13;Ciudad Real;096;Villarrubia de los Ojos;9620;4827;4793
13;Ciudad Real;097;Villarta de San Juan;2698;1356;1342
13;Ciudad Real;098;Viso del Marqués;2081;1015;1066
13;Ciudad Real;901;Robledo, El;1049;551;498
13;Ciudad Real;902;Ruidera;533;263;270
13;Ciudad Real;903;Arenales de San Gregorio;617;325;292
13;Ciudad Real;904;Llanos del Caudillo;657;320;337
14;Córdoba;001;Adamuz;4091;2067;2024
14;Córdoba;002;Aguilar de la Frontera;13210;6553;6657
14;Córdoba;003;Alcaracejos;1501;728;773
14;Córdoba;004;Almedinilla;2323;1151;1172
14;Córdoba;005;Almodóvar del Río;7981;3977;4004
14;Córdoba;006;Añora;1503;748;755
14;Córdoba;007;Baena;18436;9204;9232
14;Córdoba;008;Belalcázar;3099;1530;1569
14;Córdoba;009;Belmez;2818;1361;1457
14;Córdoba;010;Benamejí;4910;2419;2491
14;Córdoba;011;Blázquez, Los;635;313;322
14;Córdoba;012;Bujalance;7134;3580;3554
14;Córdoba;013;Cabra;20024;9748;10276
14;Córdoba;014;Cañete de las Torres;2806;1425;1381
14;Córdoba;015;Carcabuey;2299;1160;1139
14;Córdoba;016;Cardeña;1422;721;701
14;Córdoba;017;Carlota, La;14381;7125;7256
14;Córdoba;018;Carpio, El;4325;2121;2204
14;Córdoba;019;Castro del Río;7612;3751;3861
14;Córdoba;020;Conquista;373;189;184
14;Córdoba;021;Córdoba;322811;154816;167995
14;Córdoba;022;Doña Mencía;4478;2163;2315
14;Córdoba;023;Dos Torres;2365;1178;1187
14;Córdoba;024;Encinas Reales;2234;1096;1138
14;Córdoba;025;Espejo;3177;1582;1595
14;Córdoba;026;Espiel;2341;1180;1161
14;Córdoba;027;Fernán-Núñez;9638;4768;4870
14;Córdoba;028;Fuente la Lancha;339;172;167
14;Córdoba;029;Fuente Obejuna;4346;2249;2097
14;Córdoba;030;Fuente Palmera;9907;4940;4967
14;Córdoba;031;Fuente-Tójar;681;324;357
14;Córdoba;032;Granjuela, La;414;202;212
14;Córdoba;033;Guadalcázar;1556;794;762
14;Córdoba;034;Guijo, El;346;176;170
14;Córdoba;035;Hinojosa del Duque;6563;3224;3339
14;Córdoba;036;Hornachuelos;4390;2192;2198
14;Córdoba;037;Iznájar;3739;1893;1846
14;Córdoba;038;Lucena;43086;21377;21709
14;Córdoba;039;Luque;2809;1415;1394
14;Córdoba;040;Montalbán de Córdoba;4435;2179;2256
14;Córdoba;041;Montemayor;3885;1965;1920
14;Córdoba;042;Montilla;22333;11012;11321
14;Córdoba;043;Montoro;9049;4457;4592
14;Córdoba;044;Monturque;1933;962;971
14;Córdoba;045;Moriles;3643;1831;1812
14;Córdoba;046;Nueva Carteya;5307;2716;2591
14;Córdoba;047;Obejo;2085;1088;997
14;Córdoba;048;Palenciana;1431;739;692
14;Córdoba;049;Palma del Río;20546;10190;10356
14;Córdoba;050;Pedro Abad;2817;1431;1386
14;Córdoba;051;Pedroche;1456;724;732
14;Córdoba;052;Peñarroya-Pueblonuevo;10289;4959;5330
14;Córdoba;053;Posadas;7224;3588;3636
14;Córdoba;054;Pozoblanco;16946;8235;8711
14;Córdoba;055;Priego de Córdoba;21826;10634;11192
14;Córdoba;056;Puente Genil;29844;14689;15155
14;Córdoba;057;Rambla, La;7438;3704;3734
14;Córdoba;058;Rute;9765;4878;4887
14;Córdoba;059;San Sebastián de los Ballesteros;854;423;431
14;Córdoba;060;Santaella;4655;2340;2315
14;Córdoba;061;Santa Eufemia;710;348;362
14;Córdoba;062;Torrecampo;1000;499;501
14;Córdoba;063;Valenzuela;1041;526;515
14;Córdoba;064;Valsequillo;362;175;187
14;Córdoba;065;Victoria, La;2335;1158;1177
14;Córdoba;066;Villa del Río;6863;3419;3444
14;Córdoba;067;Villafranca de Córdoba;4886;2483;2403
14;Córdoba;068;Villaharta;634;305;329
14;Córdoba;069;Villanueva de Córdoba;8381;4147;4234
14;Córdoba;070;Villanueva del Duque;1404;698;706
14;Córdoba;071;Villanueva del Rey;1014;487;527
14;Córdoba;072;Villaralto;1075;549;526
14;Córdoba;073;Villaviciosa de Córdoba;3064;1566;1498
14;Córdoba;074;Viso, El;2511;1275;1236
14;Córdoba;075;Zuheros;608;314;294
14;Córdoba;901;Fuente Carreteros;1067;546;521
14;Córdoba;902;Guijarrosa, La;1333;684;649
15;Coruña, A;001;Abegondo;5578;2784;2794
15;Coruña, A;002;Ames;32812;15739;17073
15;Coruña, A;003;Aranga;1799;921;878
15;Coruña, A;004;Ares;6156;3023;3133
15;Coruña, A;005;Arteixo;34038;16775;17263
15;Coruña, A;006;Arzúa;5887;2915;2972
15;Coruña, A;007;Baña, A;3291;1561;1730
15;Coruña, A;008;Bergondo;6986;3419;3567
15;Coruña, A;009;Betanzos;13261;6315;6946
15;Coruña, A;010;Boimorto;1801;906;895
15;Coruña, A;011;Boiro;19018;9235;9783
15;Coruña, A;012;Boqueixón;4200;2055;2145
15;Coruña, A;013;Brión;8197;3954;4243
15;Coruña, A;014;Cabana de Bergantiños;4098;1987;2111
15;Coruña, A;015;Cabanas;3296;1614;1682
15;Coruña, A;016;Camariñas;5098;2510;2588
15;Coruña, A;017;Cambre;24781;12071;12710
15;Coruña, A;018;Capela, A;1182;578;604
15;Coruña, A;019;Carballo;31595;15400;16195
15;Coruña, A;020;Carnota;3800;1813;1987
15;Coruña, A;021;Carral;6775;3338;3437
15;Coruña, A;022;Cedeira;6548;3243;3305
15;Coruña, A;023;Cee;7740;3692;4048
15;Coruña, A;024;Cerceda;5085;2516;2569
15;Coruña, A;025;Cerdido;1004;487;517
15;Coruña, A;027;Coirós;1931;955;976
15;Coruña, A;028;Corcubión;1678;840;838
15;Coruña, A;029;Coristanco;5744;2769;2975
15;Coruña, A;030;Coruña, A;249261;115393;133868
15;Coruña, A;031;Culleredo;31085;14958;16127
15;Coruña, A;032;Curtis;4181;2110;2071
15;Coruña, A;033;Dodro;2620;1244;1376
15;Coruña, A;034;Dumbría;2776;1323;1453
15;Coruña, A;035;Fene;12530;5958;6572
15;Coruña, A;036;Ferrol;64218;30347;33871
15;Coruña, A;037;Fisterra;4704;2393;2311
15;Coruña, A;038;Frades;2163;1073;1090
15;Coruña, A;039;Irixoa;1326;662;664
15;Coruña, A;040;Laxe;2919;1460;1459
15;Coruña, A;041;Laracha, A;11603;5709;5894
15;Coruña, A;042;Lousame;3099;1548;1551
15;Coruña, A;043;Malpica de Bergantiños;5267;2575;2692
15;Coruña, A;044;Mañón;1223;605;618
15;Coruña, A;045;Mazaricos;3719;1783;1936
15;Coruña, A;046;Melide;7734;3777;3957
15;Coruña, A;047;Mesía;2383;1200;1183
15;Coruña, A;048;Miño;6946;3447;3499
15;Coruña, A;049;Moeche;1200;585;615
15;Coruña, A;050;Monfero;1818;917;901
15;Coruña, A;051;Mugardos;5195;2511;2684
15;Coruña, A;052;Muxía;4380;2120;2260
15;Coruña, A;053;Muros;8184;3945;4239
15;Coruña, A;054;Narón;39285;18911;20374
15;Coruña, A;055;Neda;4868;2366;2502
15;Coruña, A;056;Negreira;6961;3339;3622
15;Coruña, A;057;Noia;14092;6714;7378
15;Coruña, A;058;Oleiros;38333;18399;19934
15;Coruña, A;059;Ordes;12772;6243;6529
15;Coruña, A;060;Oroso;7757;3817;3940
15;Coruña, A;061;Ortigueira;5418;2558;2860
15;Coruña, A;062;Outes;6049;2916;3133
15;Coruña, A;064;Paderne;2387;1171;1216
15;Coruña, A;065;Padrón;8256;3988;4268
15;Coruña, A;066;Pino, O;4581;2305;2276
15;Coruña, A;067;Pobra do Caramiñal, A;9184;4519;4665
15;Coruña, A;068;Ponteceso;5318;2681;2637
15;Coruña, A;069;Pontedeume;7456;3574;3882
15;Coruña, A;070;Pontes de García Rodríguez, As;9782;4774;5008
15;Coruña, A;071;Porto do Son;9064;4512;4552
15;Coruña, A;072;Rianxo;10748;5266;5482
15;Coruña, A;073;Ribeira;27111;13411;13700
15;Coruña, A;074;Rois;4395;2104;2291
15;Coruña, A;075;Sada;17140;8326;8814
15;Coruña, A;076;San Sadurniño;2733;1356;1377
15;Coruña, A;077;Santa Comba;9319;4551;4768
15;Coruña, A;078;Santiago de Compostela;99536;46134;53402
15;Coruña, A;079;Santiso;1453;752;701
15;Coruña, A;080;Sobrado;1754;921;833
15;Coruña, A;081;Somozas, As;1068;539;529
15;Coruña, A;082;Teo;19045;9313;9732
15;Coruña, A;083;Toques;1070;558;512
15;Coruña, A;084;Tordoia;3181;1533;1648
15;Coruña, A;085;Touro;3387;1691;1696
15;Coruña, A;086;Trazo;2979;1458;1521
15;Coruña, A;087;Valdoviño;6857;3340;3517
15;Coruña, A;088;Val do Dubra;3734;1802;1932
15;Coruña, A;089;Vedra;4942;2428;2514
15;Coruña, A;090;Vilasantar;1229;646;583
15;Coruña, A;091;Vilarmaior;1252;643;609
15;Coruña, A;092;Vimianzo;6808;3284;3524
15;Coruña, A;093;Zas;4261;2055;2206
15;Coruña, A;901;Cariño;3691;1814;1877
15;Coruña, A;902;Oza-Cesuras;5151;2609;2542
16;Cuenca;001;Abia de la Obispalía;59;38;21
16;Cuenca;002;Acebrón, El;230;114;116
16;Cuenca;003;Alarcón;176;78;98
16;Cuenca;004;Albaladejo del Cuende;215;118;97
16;Cuenca;005;Albalate de las Nogueras;271;142;129
16;Cuenca;006;Albendea;119;61;58
16;Cuenca;007;Alberca de Záncara, La;1531;779;752
16;Cuenca;008;Alcalá de la Vega;70;42;28
16;Cuenca;009;Alcantud;58;33;25
16;Cuenca;010;Alcázar del Rey;167;92;75
16;Cuenca;011;Alcohujate;27;15;12
16;Cuenca;012;Alconchel de la Estrella;75;45;30
16;Cuenca;013;Algarra;25;16;9
16;Cuenca;014;Aliaguilla;611;315;296
16;Cuenca;015;Almarcha, La;423;229;194
16;Cuenca;016;Almendros;238;125;113
16;Cuenca;017;Almodóvar del Pinar;397;212;185
16;Cuenca;018;Almonacid del Marquesado;417;217;200
16;Cuenca;019;Altarejos;204;116;88
16;Cuenca;020;Arandilla del Arroyo;14;7;7
16;Cuenca;022;Arcos de la Sierra;86;54;32
16;Cuenca;023;Chillarón de Cuenca;864;460;404
16;Cuenca;024;Arguisuelas;129;64;65
16;Cuenca;025;Arrancacepas;16;9;7
16;Cuenca;026;Atalaya del Cañavate;98;55;43
16;Cuenca;027;Barajas de Melo;973;520;453
16;Cuenca;029;Barchín del Hoyo;101;66;35
16;Cuenca;030;Bascuñana de San Pedro;24;20;4
16;Cuenca;031;Beamud;48;27;21
16;Cuenca;032;Belinchón;437;223;214
16;Cuenca;033;Belmonte;1769;876;893
16;Cuenca;034;Belmontejo;129;76;53
16;Cuenca;035;Beteta;235;123;112
16;Cuenca;036;Boniches;136;70;66
16;Cuenca;038;Buciegas;38;25;13
16;Cuenca;039;Buenache de Alarcón;440;234;206
16;Cuenca;040;Buenache de la Sierra;109;61;48
16;Cuenca;041;Buendía;423;227;196
16;Cuenca;042;Campillo de Altobuey;1286;658;628
16;Cuenca;043;Campillos-Paravientos;110;63;47
16;Cuenca;044;Campillos-Sierra;32;16;16
16;Cuenca;045;Canalejas del Arroyo;157;86;71
16;Cuenca;046;Cañada del Hoyo;230;125;105
16;Cuenca;047;Cañada Juncosa;217;118;99
16;Cuenca;048;Cañamares;454;247;207
16;Cuenca;049;Cañavate, El;128;64;64
16;Cuenca;050;Cañaveras;220;113;107
16;Cuenca;051;Cañaveruelas;118;57;61
16;Cuenca;052;Cañete;843;435;408
16;Cuenca;053;Cañizares;440;241;199
16;Cuenca;055;Carboneras de Guadazaón;787;405;382
16;Cuenca;056;Cardenete;474;245;229
16;Cuenca;057;Carrascosa;70;47;23
16;Cuenca;058;Carrascosa de Haro;91;44;47
16;Cuenca;060;Casas de Benítez;834;426;408
16;Cuenca;061;Casas de Fernando Alonso;1088;570;518
16;Cuenca;062;Casas de Garcimolina;30;17;13
16;Cuenca;063;Casas de Guijarro;102;58;44
16;Cuenca;064;Casas de Haro;836;447;389
16;Cuenca;065;Casas de los Pinos;389;198;191
16;Cuenca;066;Casasimarro;3205;1634;1571
16;Cuenca;067;Castejón;130;77;53
16;Cuenca;068;Castillejo de Iniesta;102;59;43
16;Cuenca;070;Castillejo-Sierra;33;16;17
16;Cuenca;071;Castillo-Albaráñez;21;9;12
16;Cuenca;072;Castillo de Garcimuñoz;132;79;53
16;Cuenca;073;Cervera del Llano;209;107;102
16;Cuenca;074;Cierva, La;39;22;17
16;Cuenca;078;Cuenca;53429;25286;28143
16;Cuenca;079;Cueva del Hierro;25;14;11
16;Cuenca;081;Chumillas;55;32;23
16;Cuenca;082;Enguídanos;294;158;136
16;Cuenca;083;Fresneda de Altarejos;38;20;18
16;Cuenca;084;Fresneda de la Sierra;41;25;16
16;Cuenca;085;Frontera, La;148;82;66
16;Cuenca;086;Fuente de Pedro Naharro;1269;672;597
16;Cuenca;087;Fuentelespino de Haro;245;124;121
16;Cuenca;088;Fuentelespino de Moya;105;57;48
16;Cuenca;089;Fuentes;468;254;214
16;Cuenca;091;Fuertescusa;69;42;27
16;Cuenca;092;Gabaldón;159;93;66
16;Cuenca;093;Garaballa;61;30;31
16;Cuenca;094;Gascueña;130;75;55
16;Cuenca;095;Graja de Campalbo;85;45;40
16;Cuenca;096;Graja de Iniesta;357;189;168
16;Cuenca;097;Henarejos;131;65;66
16;Cuenca;098;Herrumblar, El;785;395;390
16;Cuenca;099;Hinojosa, La;195;97;98
16;Cuenca;100;Hinojosos, Los;721;367;354
16;Cuenca;101;Hito, El;130;72;58
16;Cuenca;102;Honrubia;1542;767;775
16;Cuenca;103;Hontanaya;257;144;113
16;Cuenca;104;Hontecillas;55;31;24
16;Cuenca;106;Horcajo de Santiago;3754;1920;1834
16;Cuenca;107;Huélamo;70;39;31
16;Cuenca;108;Huelves;88;46;42
16;Cuenca;109;Huérguina;44;23;21
16;Cuenca;110;Huerta de la Obispalía;130;76;54
16;Cuenca;111;Huerta del Marquesado;173;96;77
16;Cuenca;112;Huete;1822;950;872
16;Cuenca;113;Iniesta;4525;2272;2253
16;Cuenca;115;Laguna del Marquesado;59;36;23
16;Cuenca;116;Lagunaseca;49;29;20
16;Cuenca;117;Landete;1215;625;590
16;Cuenca;118;Ledaña;1602;804;798
16;Cuenca;119;Leganiel;226;116;110
16;Cuenca;121;Majadas, Las;217;118;99
16;Cuenca;122;Mariana;314;168;146
16;Cuenca;123;Masegosa;62;35;27
16;Cuenca;124;Mesas, Las;2271;1177;1094
16;Cuenca;125;Minglanilla;2322;1203;1119
16;Cuenca;126;Mira;921;465;456
16;Cuenca;128;Monreal del Llano;45;27;18
16;Cuenca;129;Montalbanejo;84;41;43
16;Cuenca;130;Montalbo;705;357;348
16;Cuenca;131;Monteagudo de las Salinas;124;78;46
16;Cuenca;132;Mota de Altarejos;27;18;9
16;Cuenca;133;Mota del Cuervo;6121;3026;3095
16;Cuenca;134;Motilla del Palancar;6259;3146;3113
16;Cuenca;135;Moya;148;87;61
16;Cuenca;137;Narboneta;43;24;19
16;Cuenca;139;Olivares de Júcar;297;152;145
16;Cuenca;140;Olmeda de la Cuesta;20;12;8
16;Cuenca;141;Olmeda del Rey;123;66;57
16;Cuenca;142;Olmedilla de Alarcón;128;76;52
16;Cuenca;143;Olmedilla de Eliz;19;14;5
16;Cuenca;145;Osa de la Vega;443;226;217
16;Cuenca;146;Pajarón;75;37;38
16;Cuenca;147;Pajaroncillo;62;36;26
16;Cuenca;148;Palomares del Campo;555;279;276
16;Cuenca;149;Palomera;191;90;101
16;Cuenca;150;Paracuellos;99;52;47
16;Cuenca;151;Paredes;68;38;30
16;Cuenca;152;Parra de las Vegas, La;35;24;11
16;Cuenca;153;Pedernoso, El;1117;558;559
16;Cuenca;154;Pedroñeras, Las;6518;3317;3201
16;Cuenca;155;Peral, El;648;370;278
16;Cuenca;156;Peraleja, La;75;46;29
16;Cuenca;157;Pesquera, La;234;123;111
16;Cuenca;158;Picazo, El;704;369;335
16;Cuenca;159;Pinarejo;181;93;88
16;Cuenca;160;Pineda de Gigüela;55;35;20
16;Cuenca;161;Piqueras del Castillo;40;25;15
16;Cuenca;162;Portalrubio de Guadamejud;42;22;20
16;Cuenca;163;Portilla;61;31;30
16;Cuenca;165;Poyatos;71;46;25
16;Cuenca;166;Pozoamargo;265;142;123
16;Cuenca;167;Pozorrubio de Santiago;309;144;165
16;Cuenca;169;Pozuelo, El;43;26;17
16;Cuenca;170;Priego;925;468;457
16;Cuenca;171;Provencio, El;2358;1189;1169
16;Cuenca;172;Puebla de Almenara;312;162;150
16;Cuenca;173;Valle de Altomira, El;205;114;91
16;Cuenca;174;Puebla del Salvador;197;104;93
16;Cuenca;175;Quintanar del Rey;7484;3860;3624
16;Cuenca;176;Rada de Haro;47;29;18
16;Cuenca;177;Reíllo;102;63;39
16;Cuenca;181;Rozalén del Monte;54;25;29
16;Cuenca;185;Saceda-Trasierra;41;23;18
16;Cuenca;186;Saelices;464;246;218
16;Cuenca;187;Salinas del Manzano;75;44;31
16;Cuenca;188;Salmeroncillos;102;60;42
16;Cuenca;189;Salvacañete;288;147;141
16;Cuenca;190;San Clemente;6812;3436;3376
16;Cuenca;191;San Lorenzo de la Parrilla;1134;596;538
16;Cuenca;192;San Martín de Boniches;39;23;16
16;Cuenca;193;San Pedro Palmiches;56;34;22
16;Cuenca;194;Santa Cruz de Moya;232;115;117
16;Cuenca;195;Santa María del Campo Rus;525;278;247
16;Cuenca;196;Santa María de los Llanos;668;358;310
16;Cuenca;197;Santa María del Val;63;36;27
16;Cuenca;198;Sisante;1660;855;805
16;Cuenca;199;Solera de Gabaldón;33;17;16
16;Cuenca;202;Talayuelas;882;459;423
16;Cuenca;203;Tarancón;16462;8153;8309
16;Cuenca;204;Tébar;293;162;131
16;Cuenca;205;Tejadillos;103;52;51
16;Cuenca;206;Tinajas;195;109;86
16;Cuenca;209;Torralba;113;66;47
16;Cuenca;211;Torrejoncillo del Rey;338;190;148
16;Cuenca;212;Torrubia del Campo;312;150;162
16;Cuenca;213;Torrubia del Castillo;42;28;14
16;Cuenca;215;Tragacete;261;151;110
16;Cuenca;216;Tresjuncos;262;146;116
16;Cuenca;217;Tribaldos;98;53;45
16;Cuenca;218;Uclés;235;125;110
16;Cuenca;219;Uña;89;52;37
16;Cuenca;224;Valdemeca;82;49;33
16;Cuenca;225;Valdemorillo de la Sierra;56;34;22
16;Cuenca;227;Valdemoro-Sierra;99;58;41
16;Cuenca;228;Valdeolivas;202;125;77
16;Cuenca;231;Valhermoso de la Fuente;59;34;25
16;Cuenca;234;Valsalobre;20;12;8
16;Cuenca;236;Valverde de Júcar;1097;553;544
16;Cuenca;237;Valverdejo;87;45;42
16;Cuenca;238;Vara de Rey;470;236;234
16;Cuenca;239;Vega del Codorno;143;82;61
16;Cuenca;240;Vellisca;125;71;54
16;Cuenca;242;Villaconejos de Trabaque;325;173;152
16;Cuenca;243;Villaescusa de Haro;459;250;209
16;Cuenca;244;Villagarcía del Llano;757;381;376
16;Cuenca;245;Villalba de la Sierra;561;277;284
16;Cuenca;246;Villalba del Rey;483;268;215
16;Cuenca;247;Villalgordo del Marquesado;64;38;26
16;Cuenca;248;Villalpardo;1000;501;499
16;Cuenca;249;Villamayor de Santiago;2370;1213;1157
16;Cuenca;250;Villanueva de Guadamejud;53;37;16
16;Cuenca;251;Villanueva de la Jara;2340;1192;1148
16;Cuenca;253;Villar de Cañas;368;199;169
16;Cuenca;254;Villar de Domingo García;215;109;106
16;Cuenca;255;Villar de la Encina;149;78;71
16;Cuenca;258;Villar del Humo;176;101;75
16;Cuenca;259;Villar del Infantado;31;20;11
16;Cuenca;263;Villar de Olalla;1512;803;709
16;Cuenca;264;Villarejo de Fuentes;400;199;201
16;Cuenca;265;Villarejo de la Peñuela;18;11;7
16;Cuenca;266;Villarejo-Periesteban;377;191;186
16;Cuenca;269;Villares del Saz;495;267;228
16;Cuenca;270;Villarrubio;213;115;98
16;Cuenca;271;Villarta;847;422;425
16;Cuenca;272;Villas de la Ventosa;221;126;95
16;Cuenca;273;Villaverde y Pasaconsol;321;174;147
16;Cuenca;274;Víllora;127;65;62
16;Cuenca;275;Vindel;16;10;6
16;Cuenca;276;Yémeda;19;14;5
16;Cuenca;277;Zafra de Záncara;90;54;36
16;Cuenca;278;Zafrilla;53;29;24
16;Cuenca;279;Zarza de Tajo;274;151;123
16;Cuenca;280;Zarzuela;163;95;68
16;Cuenca;901;Campos del Paraíso;648;330;318
16;Cuenca;902;Valdetórtola;123;70;53
16;Cuenca;903;Valeras, Las;1564;838;726
16;Cuenca;904;Fuentenava de Jábaga;610;315;295
16;Cuenca;905;Arcas;2264;1147;1117
16;Cuenca;906;Valdecolmenas, Los;71;46;25
16;Cuenca;908;Pozorrubielos de la Mancha;164;84;80
16;Cuenca;909;Sotorribas;707;367;340
16;Cuenca;910;Villar y Velasco;76;42;34
17;Girona;001;Agullana;909;448;461
17;Girona;002;Aiguaviva;802;403;399
17;Girona;003;Albanyà;168;85;83
17;Girona;004;Albons;830;425;405
17;Girona;005;Far d'Empordà, El;626;313;313
17;Girona;006;Alp;1728;892;836
17;Girona;007;Amer;2415;1206;1209
17;Girona;008;Anglès;5969;2989;2980
17;Girona;009;Arbúcies;6574;3379;3195
17;Girona;010;Argelaguer;452;234;218
17;Girona;011;Armentera, L';1070;540;530
17;Girona;012;Avinyonet de Puigventós;1684;841;843
17;Girona;013;Begur;4245;2123;2122
17;Girona;014;Vajol, La;96;55;41
17;Girona;015;Banyoles;20599;10188;10411
17;Girona;016;Bàscara;1057;539;518
17;Girona;018;Bellcaire d'Empordà;737;361;376
17;Girona;019;Besalú;2583;1234;1349
17;Girona;020;Bescanó;5141;2588;2553
17;Girona;021;Beuda;204;104;100
17;Girona;022;Bisbal d'Empordà, La;11683;5870;5813
17;Girona;023;Blanes;42198;20955;21243
17;Girona;024;Bolvir;497;255;242
17;Girona;025;Bordils;1804;906;898
17;Girona;026;Borrassà;773;399;374
17;Girona;027;Breda;3930;1918;2012
17;Girona;028;Brunyola i Sant Martí Sapresa;395;205;190
17;Girona;029;Boadella i les Escaules;260;130;130
17;Girona;030;Cabanes;978;513;465
17;Girona;031;Cabanelles;281;154;127
17;Girona;032;Cadaqués;2918;1430;1488
17;Girona;033;Caldes de Malavella;8509;4227;4282
17;Girona;034;Calonge i Sant Antoni;12316;6131;6185
17;Girona;035;Camós;711;347;364
17;Girona;036;Campdevànol;3262;1604;1658
17;Girona;037;Campelles;165;86;79
17;Girona;038;Campllong;544;271;273
17;Girona;039;Camprodon;2527;1228;1299
17;Girona;040;Canet d'Adri;744;373;371
17;Girona;041;Cantallops;346;169;177
17;Girona;042;Capmany;693;357;336
17;Girona;043;Queralbs;206;113;93
17;Girona;044;Cassà de la Selva;10943;5573;5370
17;Girona;046;Castellfollit de la Roca;957;489;468
17;Girona;047;Castelló d'Empúries;12163;6249;5914
17;Girona;048;Castell d'Aro, Platja d'Aro i s'Agaró;12981;6372;6609
17;Girona;049;Celrà;5561;2778;2783
17;Girona;050;Cervià de Ter;997;508;489
17;Girona;051;Cistella;294;147;147
17;Girona;052;Siurana;180;85;95
17;Girona;054;Colera;491;251;240
17;Girona;055;Colomers;205;107;98
17;Girona;056;Cornellà del Terri;2390;1190;1200
17;Girona;057;Corçà;1282;658;624
17;Girona;058;Crespià;250;132;118
17;Girona;060;Darnius;548;292;256
17;Girona;061;Das;270;144;126
17;Girona;062;Escala, L';10429;5201;5228
17;Girona;063;Espinelves;254;119;135
17;Girona;064;Espolla;412;206;206
17;Girona;065;Esponellà;438;225;213
17;Girona;066;Figueres;48875;24245;24630
17;Girona;067;Flaçà;1145;548;597
17;Girona;068;Foixà;292;150;142
17;Girona;069;Fontanals de Cerdanya;531;277;254
17;Girona;070;Fontanilles;168;91;77
17;Girona;071;Fontcoberta;1503;771;732
17;Girona;073;Fornells de la Selva;2781;1387;1394
17;Girona;074;Fortià;801;387;414
17;Girona;075;Garrigàs;472;248;224
17;Girona;076;Garrigoles;185;101;84
17;Girona;077;Garriguella;967;490;477
17;Girona;078;Ger;494;270;224
17;Girona;079;Girona;107032;51654;55378
17;Girona;080;Gombrèn;196;96;100
17;Girona;081;Gualta;419;250;169
17;Girona;082;Guils de Cerdanya;566;302;264
17;Girona;083;Hostalric;4446;2251;2195
17;Girona;084;Isòvol;330;179;151
17;Girona;085;Jafre;387;200;187
17;Girona;086;Jonquera, La;3408;1703;1705
17;Girona;087;Juià;342;181;161
17;Girona;088;Lladó;829;419;410
17;Girona;089;Llagostera;9508;4809;4699
17;Girona;090;Llambilles;730;376;354
17;Girona;091;Llanars;515;258;257
17;Girona;092;Llançà;4943;2436;2507
17;Girona;093;Llers;1248;625;623
17;Girona;094;Llívia;1560;805;755
17;Girona;095;Lloret de Mar;42600;21400;21200
17;Girona;096;Llosses, Les;199;115;84
17;Girona;097;Madremanya;289;145;144
17;Girona;098;Maià de Montcal;491;267;224
17;Girona;099;Meranges;112;63;49
17;Girona;100;Masarac;297;161;136
17;Girona;101;Massanes;843;443;400
17;Girona;102;Maçanet de Cabrenys;772;391;381
17;Girona;103;Maçanet de la Selva;7962;4113;3849
17;Girona;105;Mieres;349;178;171
17;Girona;106;Mollet de Peralada;215;112;103
17;Girona;107;Molló;374;176;198
17;Girona;109;Montagut i Oix;1000;518;482
17;Girona;110;Mont-ras;1690;861;829
17;Girona;111;Navata;1469;726;743
17;Girona;112;Ogassa;218;124;94
17;Girona;114;Olot;38822;19805;19017
17;Girona;115;Ordis;400;216;184
17;Girona;116;Osor;418;223;195
17;Girona;117;Palafrugell;24300;12095;12205
17;Girona;118;Palamós;18651;9145;9506
17;Girona;119;Palau de Santa Eulàlia;136;78;58
17;Girona;120;Palau-saverdera;1503;755;748
17;Girona;121;Palau-sator;300;169;131
17;Girona;123;Palol de Revardit;465;231;234
17;Girona;124;Pals;2556;1312;1244
17;Girona;125;Pardines;161;91;70
17;Girona;126;Parlavà;427;213;214
17;Girona;128;Pau;584;285;299
17;Girona;129;Pedret i Marzà;188;90;98
17;Girona;130;Pera, La;450;225;225
17;Girona;132;Peralada;2047;1011;1036
17;Girona;133;Planes d'Hostoles, Les;1746;887;859
17;Girona;134;Planoles;306;174;132
17;Girona;135;Pont de Molins;576;286;290
17;Girona;136;Pontós;290;151;139
17;Girona;137;Porqueres;4804;2379;2425
17;Girona;138;Portbou;1082;536;546
17;Girona;139;Preses, Les;1925;947;978
17;Girona;140;Port de la Selva, El;1061;531;530
17;Girona;141;Puigcerdà;10008;5016;4992
17;Girona;142;Quart;4099;2083;2016
17;Girona;143;Rabós;230;111;119
17;Girona;144;Regencós;279;148;131
17;Girona;145;Ribes de Freser;1847;943;904
17;Girona;146;Riells i Viabrea;4499;2291;2208
17;Girona;147;Ripoll;10692;5328;5364
17;Girona;148;Riudarenes;2445;1243;1202
17;Girona;149;Riudaura;529;263;266
17;Girona;150;Riudellots de la Selva;2142;1089;1053
17;Girona;151;Riumors;262;141;121
17;Girona;152;Roses;20362;10285;10077
17;Girona;153;Rupià;330;161;169
17;Girona;154;Sales de Llierca;158;84;74
17;Girona;155;Salt;33904;17940;15964
17;Girona;157;Sant Andreu Salou;172;84;88
17;Girona;158;Sant Climent Sescebes;675;398;277
17;Girona;159;Sant Feliu de Buixalleu;878;445;433
17;Girona;160;Sant Feliu de Guíxols;23050;11321;11729
17;Girona;161;Sant Feliu de Pallerols;1692;906;786
17;Girona;162;Sant Ferriol;233;127;106
17;Girona;163;Sant Gregori;4243;2135;2108
17;Girona;164;Sant Hilari Sacalm;5982;3022;2960
17;Girona;165;Sant Jaume de Llierca;849;419;430
17;Girona;166;Sant Jordi Desvalls;871;414;457
17;Girona;167;Sant Joan de les Abadesses;3375;1680;1695
17;Girona;168;Sant Joan de Mollet;526;258;268
17;Girona;169;Sant Julià de Ramis;3644;1838;1806
17;Girona;170;Vallfogona de Ripollès;222;115;107
17;Girona;171;Sant Llorenç de la Muga;258;136;122
17;Girona;172;Sant Martí de Llémena;706;356;350
17;Girona;173;Sant Martí Vell;264;143;121
17;Girona;174;Sant Miquel de Campmajor;254;134;120
17;Girona;175;Sant Miquel de Fluvià;839;441;398
17;Girona;176;Sant Mori;163;81;82
17;Girona;177;Sant Pau de Segúries;724;357;367
17;Girona;178;Sant Pere Pescador;2241;1198;1043
17;Girona;180;Santa Coloma de Farners;13657;6909;6748
17;Girona;181;Santa Cristina d'Aro;5866;2976;2890
17;Girona;182;Santa Llogaia d'Àlguema;397;197;200
17;Girona;183;Sant Aniol de Finestres;372;197;175
17;Girona;184;Santa Pau;1611;809;802
17;Girona;185;Sant Joan les Fonts;3111;1571;1540
17;Girona;186;Sarrià de Ter;5392;2686;2706
17;Girona;187;Saus, Camallera i Llampaies;898;444;454
17;Girona;188;Selva de Mar, La;220;111;109
17;Girona;189;Cellera de Ter, La;2014;1000;1014
17;Girona;190;Serinyà;1198;616;582
17;Girona;191;Serra de Daró;229;122;107
17;Girona;192;Setcases;191;107;84
17;Girona;193;Sils;6720;3447;3273
17;Girona;194;Susqueda;97;59;38
17;Girona;195;Tallada d'Empordà, La;478;253;225
17;Girona;196;Terrades;345;166;179
17;Girona;197;Torrent;173;94;79
17;Girona;198;Torroella de Fluvià;772;387;385
17;Girona;199;Torroella de Montgrí;12521;6459;6062
17;Girona;200;Tortellà;828;387;441
17;Girona;201;Toses;191;108;83
17;Girona;202;Tossa de Mar;6274;3171;3103
17;Girona;203;Ultramort;214;112;102
17;Girona;204;Ullà;1219;655;564
17;Girona;205;Ullastret;260;135;125
17;Girona;206;Urús;207;107;100
17;Girona;207;Vall d'en Bas, La;3219;1630;1589
17;Girona;208;Vall de Bianya, La;1350;669;681
17;Girona;209;Vall-llobrega;906;467;439
17;Girona;210;Ventalló;891;451;440
17;Girona;211;Verges;1187;587;600
17;Girona;212;Vidrà;169;83;86
17;Girona;213;Vidreres;8538;4436;4102
17;Girona;214;Vilabertran;984;494;490
17;Girona;215;Vilablareix;3772;1875;1897
17;Girona;216;Viladasens;212;115;97
17;Girona;217;Viladamat;492;259;233
17;Girona;218;Vilademuls;866;447;419
17;Girona;220;Viladrau;1172;589;583
17;Girona;221;Vilafant;5706;2820;2886
17;Girona;222;Vilaür;170;90;80
17;Girona;223;Vilajuïga;1179;585;594
17;Girona;224;Vilallonga de Ter;395;216;179
17;Girona;225;Vilamacolum;376;210;166
17;Girona;226;Vilamalla;1220;620;600
17;Girona;227;Vilamaniscle;201;119;82
17;Girona;228;Vilanant;402;194;208
17;Girona;230;Vila-sacra;811;390;421
17;Girona;232;Vilopriu;201;108;93
17;Girona;233;Vilobí d'Onyar;3315;1709;1606
17;Girona;234;Biure;223;121;102
17;Girona;901;Cruïlles, Monells i Sant Sadurní de l'Heura;1329;680;649
17;Girona;902;Forallac;1766;857;909
17;Girona;903;Sant Julià del Llor i Bonmatí;1373;706;667
18;Granada;001;Agrón;244;125;119
18;Granada;002;Alamedilla;543;277;266
18;Granada;003;Albolote;19587;9597;9990
18;Granada;004;Albondón;712;402;310
18;Granada;005;Albuñán;422;223;199
18;Granada;006;Albuñol;7357;4039;3318
18;Granada;007;Albuñuelas;794;401;393
18;Granada;010;Aldeire;592;307;285
18;Granada;011;Alfacar;5784;2940;2844
18;Granada;012;Algarinejo;2335;1196;1139
18;Granada;013;Alhama de Granada;5657;2937;2720
18;Granada;014;Alhendín;10399;5233;5166
18;Granada;015;Alicún de Ortega;454;225;229
18;Granada;016;Almegíjar;325;162;163
18;Granada;017;Almuñécar;27311;13553;13758
18;Granada;018;Alquife;557;283;274
18;Granada;020;Arenas del Rey;610;317;293
18;Granada;021;Armilla;25405;12491;12914
18;Granada;022;Atarfe;20455;10300;10155
18;Granada;023;Baza;20562;10190;10372
18;Granada;024;Beas de Granada;1009;529;480
18;Granada;025;Beas de Guadix;316;160;156
18;Granada;027;Benalúa;3339;1635;1704
18;Granada;028;Benalúa de las Villas;1021;535;486
18;Granada;029;Benamaurel;2246;1118;1128
18;Granada;030;Bérchules;695;378;317
18;Granada;032;Bubión;311;164;147
18;Granada;033;Busquístar;308;160;148
18;Granada;034;Cacín;537;281;256
18;Granada;035;Cádiar;1517;810;707
18;Granada;036;Cájar;5492;2694;2798
18;Granada;037;Calicasas;658;325;333
18;Granada;038;Campotéjar;1245;635;610
18;Granada;039;Caniles;3906;1997;1909
18;Granada;040;Cáñar;389;209;180
18;Granada;042;Capileira;576;286;290
18;Granada;043;Carataunas;227;120;107
18;Granada;044;Cástaras;210;120;90
18;Granada;045;Castilléjar;1289;685;604
18;Granada;046;Castril;1968;1025;943
18;Granada;047;Cenes de la Vega;8296;4130;4166
18;Granada;048;Cijuela;3714;1880;1834
18;Granada;049;Cogollos de Guadix;639;362;277
18;Granada;050;Cogollos de la Vega;2084;1059;1025
18;Granada;051;Colomera;1278;682;596
18;Granada;053;Cortes de Baza;1793;889;904
18;Granada;054;Cortes y Graena;966;496;470
18;Granada;056;Cúllar;3936;1963;1973
18;Granada;057;Cúllar Vega;7809;3959;3850
18;Granada;059;Chauchina;5781;2849;2932
18;Granada;061;Chimeneas;1242;649;593
18;Granada;062;Churriana de la Vega;16693;8209;8484
18;Granada;063;Darro;1695;862;833
18;Granada;064;Dehesas de Guadix;383;192;191
18;Granada;065;Dehesas Viejas;640;330;310
18;Granada;066;Deifontes;2622;1318;1304
18;Granada;067;Diezma;810;432;378
18;Granada;068;Dílar;2319;1161;1158
18;Granada;069;Dólar;606;327;279
18;Granada;070;Dúdar;373;196;177
18;Granada;071;Dúrcal;7209;3633;3576
18;Granada;072;Escúzar;845;450;395
18;Granada;074;Ferreira;303;157;146
18;Granada;076;Fonelas;964;506;458
18;Granada;077;Fornes;531;282;249
18;Granada;078;Freila;922;482;440
18;Granada;079;Fuente Vaqueros;4625;2313;2312
18;Granada;082;Galera;1116;562;554
18;Granada;083;Gobernador;237;121;116
18;Granada;084;Gójar;6340;3180;3160
18;Granada;085;Gor;744;385;359
18;Granada;086;Gorafe;373;196;177
18;Granada;087;Granada;232717;107461;125256
18;Granada;088;Guadahortuna;1830;927;903
18;Granada;089;Guadix;18725;9296;9429
18;Granada;093;Gualchos;5309;2797;2512
18;Granada;094;Güéjar Sierra;2926;1554;1372
18;Granada;095;Güevéjar;2660;1378;1282
18;Granada;096;Huélago;358;191;167
18;Granada;097;Huéneja;1177;636;541
18;Granada;098;Huéscar;7234;3584;3650
18;Granada;099;Huétor de Santillán;1938;1000;938
18;Granada;100;Huétor Tájar;10653;5349;5304
18;Granada;101;Huétor Vega;12294;6125;6169
18;Granada;102;Íllora;9918;5012;4906
18;Granada;103;Ítrabo;956;484;472
18;Granada;105;Iznalloz;5154;2611;2543
18;Granada;106;Játar;612;328;284
18;Granada;107;Jayena;989;520;469
18;Granada;108;Jérez del Marquesado;990;508;482
18;Granada;109;Jete;995;527;468
18;Granada;111;Jun;4145;2106;2039
18;Granada;112;Juviles;138;71;67
18;Granada;114;Calahorra, La;681;350;331
18;Granada;115;Láchar;3826;1953;1873
18;Granada;116;Lanjarón;3660;1833;1827
18;Granada;117;Lanteira;543;286;257
18;Granada;119;Lecrín;2268;1153;1115
18;Granada;120;Lentegí;350;181;169
18;Granada;121;Lobras;134;67;67
18;Granada;122;Loja;20846;10373;10473
18;Granada;123;Lugros;308;159;149
18;Granada;124;Lújar;487;260;227
18;Granada;126;Malahá, La;1872;953;919
18;Granada;127;Maracena;22310;10855;11455
18;Granada;128;Marchal;425;196;229
18;Granada;132;Moclín;3529;1767;1762
18;Granada;133;Molvízar;2730;1411;1319
18;Granada;134;Monachil;8608;4358;4250
18;Granada;135;Montefrío;5305;2773;2532
18;Granada;136;Montejícar;2020;1036;984
18;Granada;137;Montillana;1057;563;494
18;Granada;138;Moraleda de Zafayona;3127;1591;1536
18;Granada;140;Motril;59632;29265;30367
18;Granada;141;Murtas;437;244;193
18;Granada;143;Nigüelas;1239;625;614
18;Granada;144;Nívar;1069;552;517
18;Granada;145;Ogíjares;15063;7487;7576
18;Granada;146;Orce;1148;561;587
18;Granada;147;Órgiva;5674;2802;2872
18;Granada;148;Otívar;1038;535;503
18;Granada;149;Villa de Otura;7606;3832;3774
18;Granada;150;Padul;9536;4780;4756
18;Granada;151;Pampaneira;314;161;153
18;Granada;152;Pedro Martínez;1147;572;575
18;Granada;153;Peligros;11674;5776;5898
18;Granada;154;Peza, La;1107;566;541
18;Granada;157;Pinos Genil;1638;837;801
18;Granada;158;Pinos Puente;9708;4831;4877
18;Granada;159;Píñar;1060;572;488
18;Granada;161;Polícar;266;142;124
18;Granada;162;Polopos;1671;911;760
18;Granada;163;Pórtugos;385;193;192
18;Granada;164;Puebla de Don Fadrique;2202;1128;1074
18;Granada;165;Pulianas;5628;2823;2805
18;Granada;167;Purullena;2338;1188;1150
18;Granada;168;Quéntar;943;498;445
18;Granada;170;Rubite;426;247;179
18;Granada;171;Salar;2597;1308;1289
18;Granada;173;Salobreña;12660;6295;6365
18;Granada;174;Santa Cruz del Comercio;515;270;245
18;Granada;175;Santa Fe;15269;7450;7819
18;Granada;176;Soportújar;278;155;123
18;Granada;177;Sorvilán;511;277;234
18;Granada;178;Torre-Cardela;712;371;341
18;Granada;179;Torvizcón;621;325;296
18;Granada;180;Trevélez;703;373;330
18;Granada;181;Turón;213;122;91
18;Granada;182;Ugíjar;2561;1288;1273
18;Granada;183;Válor;660;350;310
18;Granada;184;Vélez de Benaudalla;3054;1564;1490
18;Granada;185;Ventas de Huelma;674;373;301
18;Granada;187;Villanueva de las Torres;519;291;228
18;Granada;188;Villanueva Mesía;1979;972;1007
18;Granada;189;Víznar;997;519;478
18;Granada;192;Zafarraya;2189;1184;1005
18;Granada;193;Zubia, La;20056;9867;10189
18;Granada;194;Zújar;2623;1339;1284
18;Granada;901;Taha, La;759;380;379
18;Granada;902;Valle, El;937;476;461
18;Granada;903;Nevada;1096;572;524
18;Granada;904;Alpujarra de la Sierra;931;514;417
18;Granada;905;Gabias, Las;23318;11756;11562
18;Granada;906;Guájares, Los;1125;610;515
18;Granada;907;Valle del Zalabí;2122;1070;1052
18;Granada;908;Villamena;1005;527;478
18;Granada;909;Morelábor;587;306;281
18;Granada;910;Pinar, El;870;461;409
18;Granada;911;Vegas del Genil;12325;6253;6072
18;Granada;912;Cuevas del Campo;1775;888;887
18;Granada;913;Zagra;890;460;430
18;Granada;914;Valderrubio;2077;1027;1050
18;Granada;915;Domingo Pérez de Granada;824;435;389
18;Granada;916;Torrenueva Costa;3098;1602;1496
19;Guadalajara;001;Abánades;60;36;24
19;Guadalajara;002;Ablanque;73;49;24
19;Guadalajara;003;Adobes;28;17;11
19;Guadalajara;004;Alaminos;56;30;26
19;Guadalajara;005;Alarilla;137;84;53
19;Guadalajara;006;Albalate de Zorita;1146;629;517
19;Guadalajara;007;Albares;608;316;292
19;Guadalajara;008;Albendiego;44;29;15
19;Guadalajara;009;Alcocer;315;162;153
19;Guadalajara;010;Alcolea de las Peñas;14;10;4
19;Guadalajara;011;Alcolea del Pinar;336;196;140
19;Guadalajara;013;Alcoroches;127;78;49
19;Guadalajara;015;Aldeanueva de Guadalajara;106;64;42
19;Guadalajara;016;Algar de Mesa;46;32;14
19;Guadalajara;017;Algora;96;59;37
19;Guadalajara;018;Alhóndiga;176;104;72
19;Guadalajara;019;Alique;15;6;9
19;Guadalajara;020;Almadrones;67;43;24
19;Guadalajara;021;Almoguera;1373;703;670
19;Guadalajara;022;Almonacid de Zorita;659;337;322
19;Guadalajara;023;Alocén;155;79;76
19;Guadalajara;024;Alovera;13585;6904;6681
19;Guadalajara;027;Alustante;145;85;60
19;Guadalajara;031;Angón;7;6;1
19;Guadalajara;032;Anguita;156;82;74
19;Guadalajara;033;Anquela del Ducado;50;27;23
19;Guadalajara;034;Anquela del Pedregal;29;18;11
19;Guadalajara;036;Aranzueque;396;208;188
19;Guadalajara;037;Arbancón;146;83;63
19;Guadalajara;038;Arbeteta;16;13;3
19;Guadalajara;039;Argecilla;72;50;22
19;Guadalajara;040;Armallones;54;30;24
19;Guadalajara;041;Armuña de Tajuña;264;135;129
19;Guadalajara;042;Arroyo de las Fraguas;33;18;15
19;Guadalajara;043;Atanzón;85;60;25
19;Guadalajara;044;Atienza;422;247;175
19;Guadalajara;045;Auñón;159;84;75
19;Guadalajara;046;Azuqueca de Henares;35894;18115;17779
19;Guadalajara;047;Baides;51;25;26
19;Guadalajara;048;Baños de Tajo;14;10;4
19;Guadalajara;049;Bañuelos;13;11;2
19;Guadalajara;050;Barriopedro;24;13;11
19;Guadalajara;051;Berninches;45;30;15
19;Guadalajara;052;Bodera, La;20;14;6
19;Guadalajara;053;Brihuega;2816;1434;1382
19;Guadalajara;054;Budia;216;135;81
19;Guadalajara;055;Bujalaro;53;26;27
19;Guadalajara;057;Bustares;68;38;30
19;Guadalajara;058;Cabanillas del Campo;11329;5725;5604
19;Guadalajara;059;Campillo de Dueñas;74;44;30
19;Guadalajara;060;Campillo de Ranas;152;94;58
19;Guadalajara;061;Campisábalos;80;55;25
19;Guadalajara;064;Canredondo;81;51;30
19;Guadalajara;065;Cantalojas;117;67;50
19;Guadalajara;066;Cañizar;73;41;32
19;Guadalajara;067;Cardoso de la Sierra, El;50;33;17
19;Guadalajara;070;Casa de Uceda;111;64;47
19;Guadalajara;071;Casar, El;13628;6888;6740
19;Guadalajara;073;Casas de San Galindo;20;14;6
19;Guadalajara;074;Caspueñas;133;81;52
19;Guadalajara;075;Castejón de Henares;59;38;21
19;Guadalajara;076;Castellar de la Muela;19;10;9
19;Guadalajara;078;Castilforte;56;33;23
19;Guadalajara;079;Castilnuevo;8;6;2
19;Guadalajara;080;Cendejas de Enmedio;71;39;32
19;Guadalajara;081;Cendejas de la Torre;24;18;6
19;Guadalajara;082;Centenera;140;82;58
19;Guadalajara;086;Cifuentes;1701;885;816
19;Guadalajara;087;Cincovillas;19;12;7
19;Guadalajara;088;Ciruelas;139;79;60
19;Guadalajara;089;Ciruelos del Pinar;27;16;11
19;Guadalajara;090;Cobeta;103;51;52
19;Guadalajara;091;Cogollor;19;12;7
19;Guadalajara;092;Cogolludo;554;324;230
19;Guadalajara;095;Condemios de Abajo;14;10;4
19;Guadalajara;096;Condemios de Arriba;113;66;47
19;Guadalajara;097;Congostrina;17;13;4
19;Guadalajara;098;Copernal;46;28;18
19;Guadalajara;099;Corduente;290;167;123
19;Guadalajara;102;Cubillo de Uceda, El;109;65;44
19;Guadalajara;103;Checa;271;156;115
19;Guadalajara;104;Chequilla;14;8;6
19;Guadalajara;105;Chiloeches;4067;2087;1980
19;Guadalajara;106;Chillarón del Rey;84;53;31
19;Guadalajara;107;Driebes;342;191;151
19;Guadalajara;108;Durón;111;61;50
19;Guadalajara;109;Embid;33;21;12
19;Guadalajara;110;Escamilla;65;42;23
19;Guadalajara;111;Escariche;185;112;73
19;Guadalajara;112;Escopete;79;42;37
19;Guadalajara;113;Espinosa de Henares;690;352;338
19;Guadalajara;114;Esplegares;33;17;16
19;Guadalajara;115;Establés;34;19;15
19;Guadalajara;116;Estriégana;12;9;3
19;Guadalajara;117;Fontanar;2637;1379;1258
19;Guadalajara;118;Fuembellida;14;9;5
19;Guadalajara;119;Fuencemillán;85;53;32
19;Guadalajara;120;Fuentelahiguera de Albatages;118;71;47
19;Guadalajara;121;Fuentelencina;319;170;149
19;Guadalajara;122;Fuentelsaz;83;41;42
19;Guadalajara;123;Fuentelviejo;56;35;21
19;Guadalajara;124;Fuentenovilla;583;325;258
19;Guadalajara;125;Gajanejos;54;33;21
19;Guadalajara;126;Galápagos;2748;1417;1331
19;Guadalajara;127;Galve de Sorbe;95;51;44
19;Guadalajara;129;Gascueña de Bornova;25;18;7
19;Guadalajara;130;Guadalajara;90909;43773;47136
19;Guadalajara;132;Henche;84;43;41
19;Guadalajara;133;Heras de Ayuso;235;134;101
19;Guadalajara;134;Herrería;17;10;7
19;Guadalajara;135;Hiendelaencina;110;66;44
19;Guadalajara;136;Hijes;21;11;10
19;Guadalajara;138;Hita;331;183;148
19;Guadalajara;139;Hombrados;43;24;19
19;Guadalajara;142;Hontoba;439;252;187
19;Guadalajara;143;Horche;2934;1470;1464
19;Guadalajara;145;Hortezuela de Océn;33;19;14
19;Guadalajara;146;Huerce, La;55;34;21
19;Guadalajara;147;Huérmeces del Cerro;42;30;12
19;Guadalajara;148;Huertahernando;58;39;19
19;Guadalajara;150;Hueva;115;72;43
19;Guadalajara;151;Humanes;1784;912;872
19;Guadalajara;152;Illana;919;501;418
19;Guadalajara;153;Iniéstola;18;13;5
19;Guadalajara;154;Inviernas, Las;53;37;16
19;Guadalajara;155;Irueste;86;58;28
19;Guadalajara;156;Jadraque;1458;775;683
19;Guadalajara;157;Jirueque;47;31;16
19;Guadalajara;159;Ledanca;99;51;48
19;Guadalajara;160;Loranca de Tajuña;1608;868;740
19;Guadalajara;161;Lupiana;325;172;153
19;Guadalajara;162;Luzaga;68;37;31
19;Guadalajara;163;Luzón;58;30;28
19;Guadalajara;165;Majaelrayo;57;39;18
19;Guadalajara;166;Málaga del Fresno;170;99;71
19;Guadalajara;167;Malaguilla;207;112;95
19;Guadalajara;168;Mandayona;292;149;143
19;Guadalajara;169;Mantiel;31;20;11
19;Guadalajara;170;Maranchón;218;117;101
19;Guadalajara;171;Marchamalo;8497;4236;4261
19;Guadalajara;172;Masegoso de Tajuña;80;46;34
19;Guadalajara;173;Matarrubia;79;51;28
19;Guadalajara;174;Matillas;115;60;55
19;Guadalajara;175;Mazarete;27;15;12
19;Guadalajara;176;Mazuecos;282;156;126
19;Guadalajara;177;Medranda;73;37;36
19;Guadalajara;178;Megina;27;18;9
19;Guadalajara;179;Membrillera;97;58;39
19;Guadalajara;181;Miedes de Atienza;59;38;21
19;Guadalajara;182;Mierla, La;38;23;15
19;Guadalajara;183;Milmarcos;70;42;28
19;Guadalajara;184;Millana;124;75;49
19;Guadalajara;185;Miñosa, La;32;19;13
19;Guadalajara;186;Mirabueno;85;49;36
19;Guadalajara;187;Miralrío;55;34;21
19;Guadalajara;188;Mochales;35;17;18
19;Guadalajara;189;Mohernando;164;93;71
19;Guadalajara;190;Molina de Aragón;3280;1643;1637
19;Guadalajara;191;Monasterio;15;7;8
19;Guadalajara;192;Mondéjar;2900;1502;1398
19;Guadalajara;193;Montarrón;32;20;12
19;Guadalajara;194;Moratilla de los Meleros;96;53;43
19;Guadalajara;195;Morenilla;48;27;21
19;Guadalajara;196;Muduex;109;60;49
19;Guadalajara;197;Navas de Jadraque, Las;38;24;14
19;Guadalajara;198;Negredo;13;6;7
19;Guadalajara;199;Ocentejo;15;12;3
19;Guadalajara;200;Olivar, El;84;43;41
19;Guadalajara;201;Olmeda de Cobeta;57;30;27
19;Guadalajara;202;Olmeda de Jadraque, La;19;12;7
19;Guadalajara;203;Ordial, El;36;26;10
19;Guadalajara;204;Orea;195;109;86
19;Guadalajara;208;Pálmaces de Jadraque;46;30;16
19;Guadalajara;209;Pardos;34;21;13
19;Guadalajara;210;Paredes de Sigüenza;22;11;11
19;Guadalajara;211;Pareja;477;273;204
19;Guadalajara;212;Pastrana;891;437;454
19;Guadalajara;213;Pedregal, El;63;43;20
19;Guadalajara;214;Peñalén;75;43;32
19;Guadalajara;215;Peñalver;181;111;70
19;Guadalajara;216;Peralejos de las Truchas;162;86;76
19;Guadalajara;217;Peralveche;73;50;23
19;Guadalajara;218;Pinilla de Jadraque;54;36;18
19;Guadalajara;219;Pinilla de Molina;11;9;2
19;Guadalajara;220;Pioz;5204;2682;2522
19;Guadalajara;221;Piqueras;33;25;8
19;Guadalajara;222;Pobo de Dueñas, El;99;51;48
19;Guadalajara;223;Poveda de la Sierra;105;60;45
19;Guadalajara;224;Pozo de Almoguera;109;63;46
19;Guadalajara;225;Pozo de Guadalajara;1699;902;797
19;Guadalajara;226;Prádena de Atienza;52;35;17
19;Guadalajara;227;Prados Redondos;46;35;11
19;Guadalajara;228;Puebla de Beleña;57;37;20
19;Guadalajara;229;Puebla de Valles;61;36;25
19;Guadalajara;230;Quer;1045;545;500
19;Guadalajara;231;Rebollosa de Jadraque;10;6;4
19;Guadalajara;232;Recuenco, El;64;37;27
19;Guadalajara;233;Renera;103;68;35
19;Guadalajara;234;Retiendas;53;33;20
19;Guadalajara;235;Riba de Saelices;94;52;42
19;Guadalajara;237;Rillo de Gallo;41;23;18
19;Guadalajara;238;Riofrío del Llano;60;34;26
19;Guadalajara;239;Robledillo de Mohernando;183;111;72
19;Guadalajara;240;Robledo de Corpes;40;22;18
19;Guadalajara;241;Romanillos de Atienza;33;23;10
19;Guadalajara;242;Romanones;118;66;52
19;Guadalajara;243;Rueda de la Sierra;38;27;11
19;Guadalajara;244;Sacecorbo;97;64;33
19;Guadalajara;245;Sacedón;1595;831;764
19;Guadalajara;246;Saelices de la Sal;47;28;19
19;Guadalajara;247;Salmerón;148;85;63
19;Guadalajara;248;San Andrés del Congosto;68;42;26
19;Guadalajara;249;San Andrés del Rey;37;22;15
19;Guadalajara;250;Santiuste;16;11;5
19;Guadalajara;251;Saúca;48;25;23
19;Guadalajara;252;Sayatón;69;41;28
19;Guadalajara;254;Selas;35;18;17
19;Guadalajara;255;Setiles;84;48;36
19;Guadalajara;256;Sienes;42;25;17
19;Guadalajara;257;Sigüenza;4830;2489;2341
19;Guadalajara;258;Solanillos del Extremo;77;51;26
19;Guadalajara;259;Somolinos;26;12;14
19;Guadalajara;260;Sotillo, El;31;15;16
19;Guadalajara;261;Sotodosos;33;19;14
19;Guadalajara;262;Tamajón;154;82;72
19;Guadalajara;263;Taragudo;48;31;17
19;Guadalajara;264;Taravilla;41;21;20
19;Guadalajara;265;Tartanedo;157;92;65
19;Guadalajara;266;Tendilla;335;178;157
19;Guadalajara;267;Terzaga;20;12;8
19;Guadalajara;268;Tierzo;34;20;14
19;Guadalajara;269;Toba, La;75;50;25
19;Guadalajara;270;Tordelrábano;11;9;2
19;Guadalajara;271;Tordellego;40;21;19
19;Guadalajara;272;Tordesilos;90;50;40
19;Guadalajara;274;Torija;1764;907;857
19;Guadalajara;277;Torrecuadrada de Molina;22;13;9
19;Guadalajara;278;Torrecuadradilla;28;17;11
19;Guadalajara;279;Torre del Burgo;493;291;202
19;Guadalajara;280;Torrejón del Rey;6324;3295;3029
19;Guadalajara;281;Torremocha de Jadraque;23;15;8
19;Guadalajara;282;Torremocha del Campo;184;110;74
19;Guadalajara;283;Torremocha del Pinar;35;20;15
19;Guadalajara;284;Torremochuela;8;6;2
19;Guadalajara;285;Torrubia;26;16;10
19;Guadalajara;286;Tórtola de Henares;1384;730;654
19;Guadalajara;287;Tortuera;157;80;77
19;Guadalajara;288;Tortuero;21;14;7
19;Guadalajara;289;Traíd;19;14;5
19;Guadalajara;290;Trijueque;1626;854;772
19;Guadalajara;291;Trillo;1396;739;657
19;Guadalajara;293;Uceda;3303;1703;1600
19;Guadalajara;294;Ujados;28;12;16
19;Guadalajara;296;Utande;31;24;7
19;Guadalajara;297;Valdarachas;55;28;27
19;Guadalajara;298;Valdearenas;91;54;37
19;Guadalajara;299;Valdeavellano;97;54;43
19;Guadalajara;300;Valdeaveruelo;1290;664;626
19;Guadalajara;301;Valdeconcha;45;28;17
19;Guadalajara;302;Valdegrudas;52;33;19
19;Guadalajara;303;Valdelcubo;41;27;14
19;Guadalajara;304;Valdenuño Fernández;332;180;152
19;Guadalajara;305;Valdepeñas de la Sierra;149;87;62
19;Guadalajara;306;Valderrebollo;25;14;11
19;Guadalajara;307;Valdesotos;31;19;12
19;Guadalajara;308;Valfermoso de Tajuña;75;46;29
19;Guadalajara;309;Valhermoso;18;14;4
19;Guadalajara;310;Valtablado del Río;8;5;3
19;Guadalajara;311;Valverde de los Arroyos;91;52;39
19;Guadalajara;314;Viana de Jadraque;41;28;13
19;Guadalajara;317;Villanueva de Alcorón;148;88;60
19;Guadalajara;318;Villanueva de Argecilla;32;18;14
19;Guadalajara;319;Villanueva de la Torre;6696;3369;3327
19;Guadalajara;321;Villares de Jadraque;45;28;17
19;Guadalajara;322;Villaseca de Henares;29;19;10
19;Guadalajara;323;Villaseca de Uceda;57;31;26
19;Guadalajara;324;Villel de Mesa;166;96;70
19;Guadalajara;325;Viñuelas;183;96;87
19;Guadalajara;326;Yebes;5421;2805;2616
19;Guadalajara;327;Yebra;498;273;225
19;Guadalajara;329;Yélamos de Abajo;58;29;29
19;Guadalajara;330;Yélamos de Arriba;89;53;36
19;Guadalajara;331;Yunquera de Henares;4566;2324;2242
19;Guadalajara;332;Yunta, La;91;52;39
19;Guadalajara;333;Zaorejas;115;78;37
19;Guadalajara;334;Zarzuela de Jadraque;52;34;18
19;Guadalajara;335;Zorita de los Canes;65;38;27
19;Guadalajara;901;Semillas;29;18;11
20;Gipuzkoa;001;Abaltzisketa;319;179;140
20;Gipuzkoa;002;Aduna;499;268;231
20;Gipuzkoa;003;Aizarnazabal;780;401;379
20;Gipuzkoa;004;Albiztur;324;170;154
20;Gipuzkoa;005;Alegia;1812;940;872
20;Gipuzkoa;006;Alkiza;364;178;186
20;Gipuzkoa;007;Altzo;445;234;211
20;Gipuzkoa;008;Amezketa;941;494;447
20;Gipuzkoa;009;Andoain;14563;7203;7360
20;Gipuzkoa;010;Anoeta;2087;1072;1015
20;Gipuzkoa;011;Antzuola;2069;1022;1047
20;Gipuzkoa;012;Arama;178;85;93
20;Gipuzkoa;013;Aretxabaleta;7194;3575;3619
20;Gipuzkoa;014;Asteasu;1575;805;770
20;Gipuzkoa;015;Ataun;1717;891;826
20;Gipuzkoa;016;Aia;2141;1122;1019
20;Gipuzkoa;017;Azkoitia;11697;5803;5894
20;Gipuzkoa;018;Azpeitia;15208;7597;7611
20;Gipuzkoa;019;Beasain;13961;6961;7000
20;Gipuzkoa;020;Beizama;130;79;51
20;Gipuzkoa;021;Belauntza;288;150;138
20;Gipuzkoa;022;Berastegi;1111;575;536
20;Gipuzkoa;023;Berrobi;553;288;265
20;Gipuzkoa;024;Bidania-Goiatz;532;275;257
20;Gipuzkoa;025;Zegama;1541;793;748
20;Gipuzkoa;026;Zerain;280;136;144
20;Gipuzkoa;027;Zestoa;3838;1983;1855
20;Gipuzkoa;028;Zizurkil;2970;1495;1475
20;Gipuzkoa;029;Deba;5399;2673;2726
20;Gipuzkoa;030;Eibar;27362;13329;14033
20;Gipuzkoa;031;Elduain;250;124;126
20;Gipuzkoa;032;Elgoibar;11585;5726;5859
20;Gipuzkoa;033;Elgeta;1130;564;566
20;Gipuzkoa;034;Eskoriatza;4241;2131;2110
20;Gipuzkoa;035;Ezkio-Itsaso;588;304;284
20;Gipuzkoa;036;Hondarribia;16929;8398;8531
20;Gipuzkoa;037;Gaintza;124;71;53
20;Gipuzkoa;038;Gabiria;516;284;232
20;Gipuzkoa;039;Getaria;2906;1460;1446
20;Gipuzkoa;040;Hernani;20355;9926;10429
20;Gipuzkoa;041;Hernialde;318;167;151
20;Gipuzkoa;042;Ibarra;4112;2029;2083
20;Gipuzkoa;043;Idiazabal;2268;1145;1123
20;Gipuzkoa;044;Ikaztegieta;502;259;243
20;Gipuzkoa;045;Irun;63656;31173;32483
20;Gipuzkoa;046;Irura;1895;982;913
20;Gipuzkoa;047;Itsasondo;670;339;331
20;Gipuzkoa;048;Larraul;256;142;114
20;Gipuzkoa;049;Lazkao;6055;3030;3025
20;Gipuzkoa;050;Leaburu;389;206;183
20;Gipuzkoa;051;Legazpi;8390;4238;4152
20;Gipuzkoa;052;Legorreta;1449;728;721
20;Gipuzkoa;053;Lezo;6012;2984;3028
20;Gipuzkoa;054;Lizartza;667;343;324
20;Gipuzkoa;055;Arrasate/Mondragón;22123;10853;11270
20;Gipuzkoa;056;Mutriku;5281;2654;2627
20;Gipuzkoa;057;Mutiloa;253;129;124
20;Gipuzkoa;058;Olaberria;934;473;461
20;Gipuzkoa;059;Oñati;11537;5695;5842
20;Gipuzkoa;060;Orexa;108;62;46
20;Gipuzkoa;061;Orio;6182;3096;3086
20;Gipuzkoa;062;Ormaiztegi;1268;646;622
20;Gipuzkoa;063;Oiartzun;10378;5165;5213
20;Gipuzkoa;064;Pasaia;16009;7685;8324
20;Gipuzkoa;065;Soraluze-Placencia de las Armas;3810;1936;1874
20;Gipuzkoa;066;Errezil;580;309;271
20;Gipuzkoa;067;Errenteria;39352;19005;20347
20;Gipuzkoa;068;Leintz-Gatzaga;210;115;95
20;Gipuzkoa;069;Donostia/San Sebastián;189093;89436;99657
20;Gipuzkoa;070;Segura;1465;748;717
20;Gipuzkoa;071;Tolosa;20109;9755;10354
20;Gipuzkoa;072;Urnieta;6250;3126;3124
20;Gipuzkoa;073;Usurbil;6438;3221;3217
20;Gipuzkoa;074;Bergara;14471;7130;7341
20;Gipuzkoa;075;Villabona;5859;2880;2979
20;Gipuzkoa;076;Ordizia;10699;5309;5390
20;Gipuzkoa;077;Urretxu;6765;3344;3421
20;Gipuzkoa;078;Zaldibia;1740;890;850
20;Gipuzkoa;079;Zarautz;23370;11344;12026
20;Gipuzkoa;080;Zumarraga;9687;4773;4914
20;Gipuzkoa;081;Zumaia;10251;5098;5153
20;Gipuzkoa;901;Mendaro;2004;1006;998
20;Gipuzkoa;902;Lasarte-Oria;19312;9295;10017
20;Gipuzkoa;903;Astigarraga;7764;3936;3828
20;Gipuzkoa;904;Baliarrain;154;86;68
20;Gipuzkoa;905;Orendain;245;118;127
20;Gipuzkoa;906;Altzaga;171;86;85
20;Gipuzkoa;907;Gaztelu;169;85;84
21;Huelva;001;Alájar;791;401;390
21;Huelva;002;Aljaraque;22489;11229;11260
21;Huelva;003;Almendro, El;858;436;422
21;Huelva;004;Almonaster la Real;1751;921;830
21;Huelva;005;Almonte;24863;12229;12634
21;Huelva;006;Alosno;3982;1962;2020
21;Huelva;007;Aracena;8392;4132;4260
21;Huelva;008;Aroche;2997;1493;1504
21;Huelva;009;Arroyomolinos de León;925;461;464
21;Huelva;010;Ayamonte;21622;10794;10828
21;Huelva;011;Beas;4374;2189;2185
21;Huelva;012;Berrocal;288;152;136
21;Huelva;013;Bollullos Par del Condado;14359;7085;7274
21;Huelva;014;Bonares;6153;3060;3093
21;Huelva;015;Cabezas Rubias;710;368;342
21;Huelva;016;Cala;1117;556;561
21;Huelva;017;Calañas;2759;1400;1359
21;Huelva;018;Campillo, El;2014;987;1027
21;Huelva;019;Campofrío;724;360;364
21;Huelva;020;Cañaveral de León;381;192;189
21;Huelva;021;Cartaya;21408;10879;10529
21;Huelva;022;Castaño del Robledo;226;127;99
21;Huelva;023;Cerro de Andévalo, El;2260;1127;1133
21;Huelva;024;Corteconcepción;573;301;272
21;Huelva;025;Cortegana;4618;2313;2305
21;Huelva;026;Cortelazor;312;154;158
21;Huelva;027;Cumbres de Enmedio;61;34;27
21;Huelva;028;Cumbres de San Bartolomé;364;189;175
21;Huelva;029;Cumbres Mayores;1729;860;869
21;Huelva;030;Chucena;2238;1122;1116
21;Huelva;031;Encinasola;1260;638;622
21;Huelva;032;Escacena del Campo;2318;1112;1206
21;Huelva;033;Fuenteheridos;814;422;392
21;Huelva;034;Galaroza;1369;695;674
21;Huelva;035;Gibraleón;13144;6604;6540
21;Huelva;036;Granada de Río-Tinto, La;244;119;125
21;Huelva;037;Granado, El;493;252;241
21;Huelva;038;Higuera de la Sierra;1307;679;628
21;Huelva;039;Hinojales;325;161;164
21;Huelva;040;Hinojos;4056;2027;2029
21;Huelva;041;Huelva;143290;68675;74615
21;Huelva;042;Isla Cristina;21641;10893;10748
21;Huelva;043;Jabugo;2196;1107;1089
21;Huelva;044;Lepe;29241;15171;14070
21;Huelva;045;Linares de la Sierra;275;136;139
21;Huelva;046;Lucena del Puerto;3388;1789;1599
21;Huelva;047;Manzanilla;2216;1135;1081
21;Huelva;048;Marines, Los;424;219;205
21;Huelva;049;Minas de Riotinto;3713;1797;1916
21;Huelva;050;Moguer;23551;11826;11725
21;Huelva;051;Nava, La;255;132;123
21;Huelva;052;Nerva;5073;2447;2626
21;Huelva;053;Niebla;4284;2142;2142
21;Huelva;054;Palma del Condado, La;10709;5337;5372
21;Huelva;055;Palos de la Frontera;12663;6448;6215
21;Huelva;056;Paterna del Campo;3412;1731;1681
21;Huelva;057;Paymogo;1143;573;570
21;Huelva;058;Puebla de Guzmán;3095;1582;1513
21;Huelva;059;Puerto Moral;280;138;142
21;Huelva;060;Punta Umbría;16137;8172;7965
21;Huelva;061;Rociana del Condado;7985;3940;4045
21;Huelva;062;Rosal de la Frontera;1671;812;859
21;Huelva;063;San Bartolomé de la Torre;4036;2064;1972
21;Huelva;064;San Juan del Puerto;9811;4927;4884
21;Huelva;065;Sanlúcar de Guadiana;416;205;211
21;Huelva;066;San Silvestre de Guzmán;644;336;308
21;Huelva;067;Santa Ana la Real;472;221;251
21;Huelva;068;Santa Bárbara de Casa;1128;569;559
21;Huelva;069;Santa Olalla del Cala;2061;1044;1017
21;Huelva;070;Trigueros;8110;4028;4082
21;Huelva;071;Valdelarco;237;114;123
21;Huelva;072;Valverde del Camino;12611;6188;6423
21;Huelva;073;Villablanca;2979;1494;1485
21;Huelva;074;Villalba del Alcor;3302;1619;1683
21;Huelva;075;Villanueva de las Cruces;380;183;197
21;Huelva;076;Villanueva de los Castillejos;2936;1483;1453
21;Huelva;077;Villarrasa;2128;1071;1057
21;Huelva;078;Zalamea la Real;2963;1480;1483
21;Huelva;079;Zufre;735;381;354
21;Huelva;902;Zarza-Perrunal, La;1189;611;578
22;Huesca;001;Abiego;264;131;133
22;Huesca;002;Abizanda;163;88;75
22;Huesca;003;Adahuesca;207;114;93
22;Huesca;004;Agüero;140;83;57
22;Huesca;006;Aisa;313;164;149
22;Huesca;007;Albalate de Cinca;1142;630;512
22;Huesca;008;Albalatillo;211;115;96
22;Huesca;009;Albelda;709;360;349
22;Huesca;011;Albero Alto;128;72;56
22;Huesca;012;Albero Bajo;111;66;45
22;Huesca;013;Alberuela de Tubo;283;149;134
22;Huesca;014;Alcalá de Gurrea;272;146;126
22;Huesca;015;Alcalá del Obispo;372;210;162
22;Huesca;016;Alcampell;639;302;337
22;Huesca;017;Alcolea de Cinca;1109;589;520
22;Huesca;018;Alcubierre;400;220;180
22;Huesca;019;Alerre;225;119;106
22;Huesca;020;Alfántega;129;62;67
22;Huesca;021;Almudévar;2437;1229;1208
22;Huesca;022;Almunia de San Juan;708;365;343
22;Huesca;023;Almuniente;444;233;211
22;Huesca;024;Alquézar;338;172;166
22;Huesca;025;Altorricón;1472;799;673
22;Huesca;027;Angüés;364;195;169
22;Huesca;028;Ansó;413;206;207
22;Huesca;029;Antillón;126;64;62
22;Huesca;032;Aragüés del Puerto;114;60;54
22;Huesca;035;Arén;306;158;148
22;Huesca;036;Argavieso;112;66;46
22;Huesca;037;Arguis;165;87;78
22;Huesca;039;Ayerbe;1066;531;535
22;Huesca;040;Azanuy-Alins;183;94;89
22;Huesca;041;Azara;164;89;75
22;Huesca;042;Azlor;157;71;86
22;Huesca;043;Baélls;90;55;35
22;Huesca;044;Bailo;263;161;102
22;Huesca;045;Baldellou;82;51;31
22;Huesca;046;Ballobar;864;435;429
22;Huesca;047;Banastás;328;165;163
22;Huesca;048;Barbastro;17558;8582;8976
22;Huesca;049;Barbués;90;58;32
22;Huesca;050;Barbuñales;95;49;46
22;Huesca;051;Bárcabo;122;65;57
22;Huesca;052;Belver de Cinca;1270;733;537
22;Huesca;053;Benabarre;1137;585;552
22;Huesca;054;Benasque;2362;1260;1102
22;Huesca;055;Berbegal;325;170;155
22;Huesca;057;Bielsa;487;253;234
22;Huesca;058;Bierge;243;139;104
22;Huesca;059;Biescas;1609;854;755
22;Huesca;060;Binaced;1601;878;723
22;Huesca;061;Binéfar;10118;5352;4766
22;Huesca;062;Bisaurri;179;99;80
22;Huesca;063;Biscarrués;187;100;87
22;Huesca;064;Blecua y Torres;172;88;84
22;Huesca;066;Boltaña;1102;589;513
22;Huesca;067;Bonansa;86;47;39
22;Huesca;068;Borau;85;49;36
22;Huesca;069;Broto;608;331;277
22;Huesca;072;Caldearenas;237;145;92
22;Huesca;074;Campo;483;252;231
22;Huesca;075;Camporrélls;158;85;73
22;Huesca;076;Canal de Berdún;330;178;152
22;Huesca;077;Candasnos;422;229;193
22;Huesca;078;Canfranc;612;352;260
22;Huesca;079;Capdesaso;201;88;113
22;Huesca;080;Capella;351;185;166
22;Huesca;081;Casbas de Huesca;292;170;122
22;Huesca;082;Castejón del Puente;334;177;157
22;Huesca;083;Castejón de Monegros;468;243;225
22;Huesca;084;Castejón de Sos;868;435;433
22;Huesca;085;Castelflorite;103;52;51
22;Huesca;086;Castiello de Jaca;265;141;124
22;Huesca;087;Castigaleu;87;53;34
22;Huesca;088;Castillazuelo;166;86;80
22;Huesca;089;Castillonroy;322;173;149
22;Huesca;090;Colungo;132;78;54
22;Huesca;094;Chalamera;131;77;54
22;Huesca;095;Chía;94;53;41
22;Huesca;096;Chimillas;410;213;197
22;Huesca;099;Esplús;664;350;314
22;Huesca;102;Estada;214;125;89
22;Huesca;103;Estadilla;822;406;416
22;Huesca;105;Estopiñán del Castillo;136;74;62
22;Huesca;106;Fago;25;16;9
22;Huesca;107;Fanlo;118;68;50
22;Huesca;109;Fiscal;379;211;168
22;Huesca;110;Fonz;893;467;426
22;Huesca;111;Foradada del Toscar;169;93;76
22;Huesca;112;Fraga;15390;7907;7483
22;Huesca;113;Fueva, La;597;320;277
22;Huesca;114;Gistaín;116;69;47
22;Huesca;115;Grado, El;386;205;181
22;Huesca;116;Grañén;1696;860;836
22;Huesca;117;Graus;3380;1673;1707
22;Huesca;119;Gurrea de Gállego;1427;738;689
22;Huesca;122;Hoz de Jaca;77;41;36
22;Huesca;124;Huerto;226;124;102
22;Huesca;125;Huesca;54704;26250;28454
22;Huesca;126;Ibieca;104;58;46
22;Huesca;127;Igriés;737;381;356
22;Huesca;128;Ilche;185;95;90
22;Huesca;129;Isábena;237;120;117
22;Huesca;130;Jaca;13883;6778;7105
22;Huesca;131;Jasa;94;56;38
22;Huesca;133;Labuerda;173;88;85
22;Huesca;135;Laluenga;207;107;100
22;Huesca;136;Lalueza;868;440;428
22;Huesca;137;Lanaja;1141;622;519
22;Huesca;139;Laperdiguera;88;42;46
22;Huesca;141;Lascellas-Ponzano;139;83;56
22;Huesca;142;Lascuarre;135;68;67
22;Huesca;143;Laspaúles;251;130;121
22;Huesca;144;Laspuña;278;157;121
22;Huesca;149;Loarre;351;192;159
22;Huesca;150;Loporzano;557;305;252
22;Huesca;151;Loscorrales;104;52;52
22;Huesca;155;Monesma y Cajigar;69;37;32
22;Huesca;156;Monflorite-Lascasas;490;260;230
22;Huesca;157;Montanuy;227;132;95
22;Huesca;158;Monzón;18152;9210;8942
22;Huesca;160;Naval;273;146;127
22;Huesca;162;Novales;165;78;87
22;Huesca;163;Nueno;568;321;247
22;Huesca;164;Olvena;65;32;33
22;Huesca;165;Ontiñena;513;272;241
22;Huesca;167;Osso de Cinca;652;371;281
22;Huesca;168;Palo;33;17;16
22;Huesca;170;Panticosa;909;480;429
22;Huesca;172;Peñalba;695;382;313
22;Huesca;173;Peñas de Riglos, Las;268;171;97
22;Huesca;174;Peralta de Alcofea;587;294;293
22;Huesca;175;Peralta de Calasanz;215;118;97
22;Huesca;176;Peraltilla;215;104;111
22;Huesca;177;Perarrúa;112;54;58
22;Huesca;178;Pertusa;136;78;58
22;Huesca;181;Piracés;95;49;46
22;Huesca;182;Plan;279;147;132
22;Huesca;184;Poleñino;205;111;94
22;Huesca;186;Pozán de Vero;235;119;116
22;Huesca;187;Puebla de Castro, La;427;224;203
22;Huesca;188;Puente de Montañana;95;44;51
22;Huesca;189;Puértolas;224;117;107
22;Huesca;190;Pueyo de Araguás, El;171;94;77
22;Huesca;193;Pueyo de Santa Cruz;323;161;162
22;Huesca;195;Quicena;346;183;163
22;Huesca;197;Robres;531;283;248
22;Huesca;199;Sabiñánigo;9592;4788;4804
22;Huesca;200;Sahún;319;168;151
22;Huesca;201;Salas Altas;296;160;136
22;Huesca;202;Salas Bajas;180;90;90
22;Huesca;203;Salillas;101;56;45
22;Huesca;204;Sallent de Gállego;1516;766;750
22;Huesca;205;San Esteban de Litera;641;342;299
22;Huesca;206;Sangarrén;221;119;102
22;Huesca;207;San Juan de Plan;151;79;72
22;Huesca;208;Santa Cilia;244;121;123
22;Huesca;209;Santa Cruz de la Serós;188;109;79
22;Huesca;212;Santaliestra y San Quílez;83;49;34
22;Huesca;213;Sariñena;4135;2165;1970
22;Huesca;214;Secastilla;149;71;78
22;Huesca;215;Seira;146;85;61
22;Huesca;217;Sena;476;257;219
22;Huesca;218;Senés de Alcubierre;52;25;27
22;Huesca;220;Sesa;162;93;69
22;Huesca;221;Sesué;116;64;52
22;Huesca;222;Siétamo;681;377;304
22;Huesca;223;Sopeira;84;48;36
22;Huesca;225;Tamarite de Litera;3429;1780;1649
22;Huesca;226;Tardienta;937;482;455
22;Huesca;227;Tella-Sin;217;117;100
22;Huesca;228;Tierz;825;408;417
22;Huesca;229;Tolva;132;74;58
22;Huesca;230;Torla-Ordesa;335;179;156
22;Huesca;232;Torralba de Aragón;107;62;45
22;Huesca;233;Torre la Ribera;100;53;47
22;Huesca;234;Torrente de Cinca;1148;646;502
22;Huesca;235;Torres de Alcanadre;92;55;37
22;Huesca;236;Torres de Barbués;270;133;137
22;Huesca;239;Tramaced;106;65;41
22;Huesca;242;Valfarta;54;35;19
22;Huesca;243;Valle de Bardají;55;35;20
22;Huesca;244;Valle de Lierp;58;37;21
22;Huesca;245;Velilla de Cinca;507;278;229
22;Huesca;246;Beranuy;69;39;30
22;Huesca;247;Viacamp y Litera;41;26;15
22;Huesca;248;Vicién;137;80;57
22;Huesca;249;Villanova;170;92;78
22;Huesca;250;Villanúa;571;302;269
22;Huesca;251;Villanueva de Sigena;345;193;152
22;Huesca;252;Yebra de Basa;160;95;65
22;Huesca;253;Yésero;62;34;28
22;Huesca;254;Zaidín;1785;943;842
22;Huesca;901;Valle de Hecho;798;424;374
22;Huesca;902;Puente la Reina de Jaca;264;137;127
22;Huesca;903;San Miguel del Cinca;784;409;375
22;Huesca;904;Sotonera, La;903;488;415
22;Huesca;905;Lupiñén-Ortilla;349;177;172
22;Huesca;906;Santa María de Dulcis;209;113;96
22;Huesca;907;Aínsa-Sobrarbe;2317;1161;1156
22;Huesca;908;Hoz y Costean;231;131;100
22;Huesca;909;Vencillón;393;215;178
23;Jaén;001;Albanchez de Mágina;930;488;442
23;Jaén;002;Alcalá la Real;21581;10627;10954
23;Jaén;003;Alcaudete;10243;5032;5211
23;Jaén;004;Aldeaquemada;456;243;213
23;Jaén;005;Andújar;35619;17391;18228
23;Jaén;006;Arjona;5376;2636;2740
23;Jaén;007;Arjonilla;3531;1783;1748
23;Jaén;008;Arquillos;1685;853;832
23;Jaén;009;Baeza;15677;7754;7923
23;Jaén;010;Bailén;17264;8623;8641
23;Jaén;011;Baños de la Encina;2563;1308;1255
23;Jaén;012;Beas de Segura;4968;2575;2393
23;Jaén;014;Begíjar;2947;1490;1457
23;Jaén;015;Bélmez de la Moraleda;1509;737;772
23;Jaén;016;Benatae;429;215;214
23;Jaén;017;Cabra del Santo Cristo;1651;864;787
23;Jaén;018;Cambil;2632;1379;1253
23;Jaén;019;Campillo de Arenas;1703;856;847
23;Jaén;020;Canena;1761;923;838
23;Jaén;021;Carboneros;597;305;292
23;Jaén;024;Carolina, La;14681;7304;7377
23;Jaén;025;Castellar;3156;1609;1547
23;Jaén;026;Castillo de Locubín;3840;1906;1934
23;Jaén;027;Cazalilla;771;389;382
23;Jaén;028;Cazorla;7012;3415;3597
23;Jaén;029;Chiclana de Segura;869;454;415
23;Jaén;030;Chilluévar;1322;659;663
23;Jaén;031;Escañuela;902;444;458
23;Jaén;032;Espeluy;591;292;299
23;Jaén;033;Frailes;1551;778;773
23;Jaén;034;Fuensanta de Martos;2990;1508;1482
23;Jaén;035;Fuerte del Rey;1342;695;647
23;Jaén;037;Génave;547;292;255
23;Jaén;038;Guardia de Jaén, La;5218;2683;2535
23;Jaén;039;Guarromán;2760;1414;1346
23;Jaén;040;Lahiguera;1588;789;799
23;Jaén;041;Higuera de Calatrava;591;310;281
23;Jaén;042;Hinojares;343;177;166
23;Jaén;043;Hornos;573;281;292
23;Jaén;044;Huelma;5522;2704;2818
23;Jaén;045;Huesa;2419;1217;1202
23;Jaén;046;Ibros;2764;1403;1361
23;Jaén;047;Iruela, La;1867;931;936
23;Jaén;048;Iznatoraf;882;443;439
23;Jaén;049;Jabalquinto;1961;979;982
23;Jaén;050;Jaén;112074;53799;58275
23;Jaén;051;Jamilena;3298;1660;1638
23;Jaén;052;Jimena;1234;603;631
23;Jaén;053;Jódar;11366;5669;5697
23;Jaén;054;Larva;436;225;211
23;Jaén;055;Linares;55261;27027;28234
23;Jaén;056;Lopera;3539;1803;1736
23;Jaén;057;Lupión;806;391;415
23;Jaén;058;Mancha Real;11385;5682;5703
23;Jaén;059;Marmolejo;6507;3255;3252
23;Jaén;060;Martos;24452;12168;12284
23;Jaén;061;Mengíbar;10011;5020;4991
23;Jaén;062;Montizón;1585;812;773
23;Jaén;063;Navas de San Juan;4409;2275;2134
23;Jaén;064;Noalejo;1783;907;876
23;Jaén;065;Orcera;1717;853;864
23;Jaén;066;Peal de Becerro;5276;2637;2639
23;Jaén;067;Pegalajar;2827;1448;1379
23;Jaén;069;Porcuna;5907;2962;2945
23;Jaén;070;Pozo Alcón;4550;2364;2186
23;Jaén;071;Puente de Génave;2188;1114;1074
23;Jaén;072;Puerta de Segura, La;2246;1130;1116
23;Jaén;073;Quesada;4952;2508;2444
23;Jaén;074;Rus;3407;1730;1677
23;Jaén;075;Sabiote;3780;1893;1887
23;Jaén;076;Santa Elena;866;457;409
23;Jaén;077;Santiago de Calatrava;657;350;307
23;Jaén;079;Santisteban del Puerto;4457;2279;2178
23;Jaén;080;Santo Tomé;2077;1068;1009
23;Jaén;081;Segura de la Sierra;1688;822;866
23;Jaén;082;Siles;2109;1080;1029
23;Jaén;084;Sorihuela del Guadalimar;1034;535;499
23;Jaén;085;Torreblascopedro;2402;1230;1172
23;Jaén;086;Torredelcampo;13944;6964;6980
23;Jaén;087;Torredonjimeno;13261;6539;6722
23;Jaén;088;Torreperogil;7113;3490;3623
23;Jaén;090;Torres;1343;704;639
23;Jaén;091;Torres de Albánchez;741;385;356
23;Jaén;092;Úbeda;33674;16380;17294
23;Jaén;093;Valdepeñas de Jaén;3556;1774;1782
23;Jaén;094;Vilches;4190;2099;2091
23;Jaén;095;Villacarrillo;10320;5176;5144
23;Jaén;096;Villanueva de la Reina;2948;1510;1438
23;Jaén;097;Villanueva del Arzobispo;7753;4005;3748
23;Jaén;098;Villardompardo;921;465;456
23;Jaén;099;Villares, Los;6079;3052;3027
23;Jaén;101;Villarrodrigo;390;214;176
23;Jaén;901;Cárcheles;1293;681;612
23;Jaén;902;Bedmar y Garcíez;2571;1307;1264
23;Jaén;903;Villatorres;4267;2187;2080
23;Jaén;904;Santiago-Pontones;2701;1384;1317
23;Jaén;905;Arroyo del Ojanco;2143;1083;1060
24;León;001;Acebedo;184;103;81
24;León;002;Algadefe;301;157;144
24;León;003;Alija del Infantado;573;291;282
24;León;004;Almanza;609;343;266
24;León;005;Antigua, La;328;185;143
24;León;006;Ardón;550;302;248
24;León;007;Arganza;805;407;398
24;León;008;Astorga;10308;4839;5469
24;León;009;Balboa;263;156;107
24;León;010;Bañeza, La;10023;4831;5192
24;León;011;Barjas;145;84;61
24;León;012;Barrios de Luna, Los;294;172;122
24;León;014;Bembibre;8158;3920;4238
24;León;015;Benavides;2342;1167;1175
24;León;016;Benuza;442;265;177
24;León;017;Bercianos del Páramo;522;270;252
24;León;018;Bercianos del Real Camino;186;103;83
24;León;019;Berlanga del Bierzo;322;149;173
24;León;020;Boca de Huérgano;426;248;178
24;León;021;Boñar;1766;907;859
24;León;022;Borrenes;303;165;138
24;León;023;Brazuelo;312;183;129
24;León;024;Burgo Ranero, El;690;364;326
24;León;025;Burón;288;167;121
24;León;026;Bustillo del Páramo;1057;548;509
24;León;027;Cabañas Raras;1302;686;616
24;León;028;Cabreros del Río;408;220;188
24;León;029;Cabrillanes;707;373;334
24;León;030;Cacabelos;4735;2312;2423
24;León;031;Calzada del Coto;223;134;89
24;León;032;Campazas;107;55;52
24;León;033;Campo de Villavidel;205;115;90
24;León;034;Camponaraya;4104;2041;2063
24;León;036;Valle de Ancares;275;153;122
24;León;037;Cármenes;333;191;142
24;León;038;Carracedelo;3423;1713;1710
24;León;039;Carrizo;2222;1132;1090
24;León;040;Carrocera;440;225;215
24;León;041;Carucedo;483;242;241
24;León;042;Castilfalé;62;37;25
24;León;043;Castrillo de Cabrera;102;62;40
24;León;044;Castrillo de la Valduerna;143;71;72
24;León;046;Castrocalbón;913;473;440
24;León;047;Castrocontrigo;669;370;299
24;León;049;Castropodame;1574;820;754
24;León;050;Castrotierra de Valmadrigal;105;52;53
24;León;051;Cea;378;200;178
24;León;052;Cebanico;143;88;55
24;León;053;Cebrones del Río;435;238;197
24;León;054;Cimanes de la Vega;435;223;212
24;León;055;Cimanes del Tejar;738;408;330
24;León;056;Cistierna;2905;1422;1483
24;León;057;Congosto;1425;710;715
24;León;058;Corbillos de los Oteros;176;101;75
24;León;059;Corullón;819;417;402
24;León;060;Crémenes;512;278;234
24;León;061;Cuadros;2090;1058;1032
24;León;062;Cubillas de los Oteros;137;76;61
24;León;063;Cubillas de Rueda;385;212;173
24;León;064;Cubillos del Sil;1719;895;824
24;León;065;Chozas de Abajo;2678;1376;1302
24;León;066;Destriana;424;207;217
24;León;067;Encinedo;616;338;278
24;León;068;Ercina, La;425;228;197
24;León;069;Escobar de Campos;31;19;12
24;León;070;Fabero;4061;1988;2073
24;León;071;Folgoso de la Ribera;982;482;500
24;León;073;Fresno de la Vega;477;237;240
24;León;074;Fuentes de Carbajal;76;49;27
24;León;076;Garrafe de Torío;1640;877;763
24;León;077;Gordaliza del Pino;239;117;122
24;León;078;Gordoncillo;308;153;155
24;León;079;Gradefes;925;510;415
24;León;080;Grajal de Campos;209;109;100
24;León;081;Gusendos de los Oteros;126;64;62
24;León;082;Hospital de Órbigo;956;479;477
24;León;083;Igüeña;1049;543;506
24;León;084;Izagre;137;70;67
24;León;086;Joarilla de las Matas;245;133;112
24;León;087;Laguna Dalga;626;334;292
24;León;088;Laguna de Negrillos;1046;534;512
24;León;089;León;122243;55446;66797
24;León;090;Lucillo;356;186;170
24;León;091;Luyego;554;306;248
24;León;092;Llamas de la Ribera;791;417;374
24;León;093;Magaz de Cepeda;349;193;156
24;León;094;Mansilla de las Mulas;1663;844;819
24;León;095;Mansilla Mayor;324;176;148
24;León;096;Maraña;111;71;40
24;León;097;Matadeón de los Oteros;221;115;106
24;León;098;Matallana de Torío;1228;642;586
24;León;099;Matanza;172;89;83
24;León;100;Molinaseca;872;477;395
24;León;101;Murias de Paredes;340;191;149
24;León;102;Noceda del Bierzo;605;312;293
24;León;103;Oencia;277;157;120
24;León;104;Omañas, Las;259;139;120
24;León;105;Onzonilla;1942;1003;939
24;León;106;Oseja de Sajambre;226;138;88
24;León;107;Pajares de los Oteros;235;142;93
24;León;108;Palacios de la Valduerna;353;176;177
24;León;109;Palacios del Sil;844;469;375
24;León;110;Páramo del Sil;1169;604;565
24;León;112;Peranzanes;271;162;109
24;León;113;Pobladura de Pelayo García;354;181;173
24;León;114;Pola de Gordón, La;2842;1429;1413
24;León;115;Ponferrada;62994;29699;33295
24;León;116;Posada de Valdeón;405;235;170
24;León;117;Pozuelo del Páramo;392;192;200
24;León;118;Prado de la Guzpeña;104;64;40
24;León;119;Priaranza del Bierzo;699;349;350
24;León;120;Prioro;349;203;146
24;León;121;Puebla de Lillo;654;379;275
24;León;122;Puente de Domingo Flórez;1385;707;678
24;León;123;Quintana del Castillo;717;392;325
24;León;124;Quintana del Marco;319;179;140
24;León;125;Quintana y Congosto;416;222;194
24;León;127;Regueras de Arriba;264;144;120
24;León;129;Reyero;128;70;58
24;León;130;Riaño;474;257;217
24;León;131;Riego de la Vega;714;385;329
24;León;132;Riello;582;329;253
24;León;133;Rioseco de Tapia;399;218;181
24;León;134;Robla, La;3605;1791;1814
24;León;136;Roperuelos del Páramo;499;252;247
24;León;137;Sabero;1021;521;500
24;León;139;Sahagún;2398;1174;1224
24;León;141;San Adrián del Valle;84;51;33
24;León;142;San Andrés del Rabanedo;29884;14195;15689
24;León;143;Sancedo;528;272;256
24;León;144;San Cristóbal de la Polantera;625;326;299
24;León;145;San Emiliano;596;345;251
24;León;146;San Esteban de Nogales;243;129;114
24;León;148;San Justo de la Vega;1775;908;867
24;León;149;San Millán de los Caballeros;191;100;91
24;León;150;San Pedro Bercianos;226;125;101
24;León;151;Santa Colomba de Curueño;507;266;241
24;León;152;Santa Colomba de Somoza;494;265;229
24;León;153;Santa Cristina de Valmadrigal;273;142;131
24;León;154;Santa Elena de Jamuz;1015;537;478
24;León;155;Santa María de la Isla;443;230;213
24;León;156;Santa María del Monte de Cea;209;116;93
24;León;157;Santa María del Páramo;2999;1480;1519
24;León;158;Santa María de Ordás;325;174;151
24;León;159;Santa Marina del Rey;1745;872;873
24;León;160;Santas Martas;752;405;347
24;León;161;Santiago Millas;359;206;153
24;León;162;Santovenia de la Valdoncina;2064;1045;1019
24;León;163;Sariegos;5444;2689;2755
24;León;164;Sena de Luna;390;194;196
24;León;165;Sobrado;282;142;140
24;León;166;Soto de la Vega;1493;787;706
24;León;167;Soto y Amío;717;370;347
24;León;168;Toral de los Guzmanes;499;275;224
24;León;169;Toreno;2855;1440;1415
24;León;170;Torre del Bierzo;1968;1008;960
24;León;171;Trabadelo;319;185;134
24;León;172;Truchas;392;209;183
24;León;173;Turcia;986;506;480
24;León;174;Urdiales del Páramo;449;239;210
24;León;175;Valdefresno;2335;1216;1119
24;León;176;Valdefuentes del Páramo;306;165;141
24;León;177;Valdelugueros;486;270;216
24;León;178;Valdemora;57;25;32
24;León;179;Valdepiélago;308;176;132
24;León;180;Valdepolo;1215;655;560
24;León;181;Valderas;1489;771;718
24;León;182;Valderrey;416;214;202
24;León;183;Valderrueda;821;455;366
24;León;184;Valdesamario;175;100;75
24;León;185;Val de San Lorenzo;492;237;255
24;León;187;Valdevimbre;894;460;434
24;León;188;Valencia de Don Juan;5094;2470;2624
24;León;189;Valverde de la Virgen;7806;4047;3759
24;León;190;Valverde-Enrique;152;79;73
24;León;191;Vallecillo;101;57;44
24;León;193;Vecilla, La;378;212;166
24;León;194;Vegacervera;258;132;126
24;León;196;Vega de Espinareda;2007;1020;987
24;León;197;Vega de Infanzones;839;429;410
24;León;198;Vega de Valcarce;552;281;271
24;León;199;Vegaquemada;437;253;184
24;León;201;Vegas del Condado;1154;663;491
24;León;202;Villablino;7709;3749;3960
24;León;203;Villabraz;95;52;43
24;León;205;Villadangos del Páramo;1235;640;595
24;León;206;Toral de los Vados;1753;878;875
24;León;207;Villademor de la Vega;291;160;131
24;León;209;Villafranca del Bierzo;2659;1277;1382
24;León;210;Villagatón;636;349;287
24;León;211;Villamandos;277;148;129
24;León;212;Villamañán;1076;548;528
24;León;213;Villamartín de Don Sancho;144;76;68
24;León;214;Villamejil;653;355;298
24;León;215;Villamol;136;72;64
24;León;216;Villamontán de la Valduerna;683;346;337
24;León;217;Villamoratiel de las Matas;120;66;54
24;León;218;Villanueva de las Manzanas;502;256;246
24;León;219;Villaobispo de Otero;518;285;233
24;León;221;Villaquejida;803;405;398
24;León;222;Villaquilambre;18647;9219;9428
24;León;223;Villarejo de Órbigo;2873;1414;1459
24;León;224;Villares de Órbigo;563;307;256
24;León;225;Villasabariego;1148;582;566
24;León;226;Villaselán;180;101;79
24;León;227;Villaturiel;1838;963;875
24;León;228;Villazala;596;323;273
24;León;229;Villazanzo de Valderaduey;368;216;152
24;León;230;Zotes del Páramo;402;223;179
24;León;901;Villamanín;876;456;420
24;León;902;Villaornate y Castro;337;168;169
25;Lleida;001;Abella de la Conca;158;81;77
25;Lleida;002;Àger;602;326;276
25;Lleida;003;Agramunt;5629;2862;2767
25;Lleida;004;Alamús, Els;800;409;391
25;Lleida;005;Alàs i Cerc;322;161;161
25;Lleida;006;Albagés, L';344;187;157
25;Lleida;007;Albatàrrec;2251;1141;1110
25;Lleida;008;Albesa;1584;859;725
25;Lleida;009;Albi, L';766;393;373
25;Lleida;010;Alcanó;239;117;122
25;Lleida;011;Alcarràs;10018;5205;4813
25;Lleida;012;Alcoletge;3594;1923;1671
25;Lleida;013;Alfarràs;2778;1433;1345
25;Lleida;014;Alfés;281;157;124
25;Lleida;015;Algerri;424;233;191
25;Lleida;016;Alguaire;2986;1567;1419
25;Lleida;017;Alins;275;145;130
25;Lleida;019;Almacelles;6896;3707;3189
25;Lleida;020;Almatret;305;168;137
25;Lleida;021;Almenar;3338;1769;1569
25;Lleida;022;Alòs de Balaguer;120;70;50
25;Lleida;023;Alpicat;6387;3192;3195
25;Lleida;024;Alt Àneu;455;257;198
25;Lleida;025;Naut Aran;1899;988;911
25;Lleida;027;Anglesola;1367;690;677
25;Lleida;029;Arbeca;2081;1055;1026
25;Lleida;030;Pont de Bar, El;165;94;71
25;Lleida;031;Arres;64;44;20
25;Lleida;032;Arsèguel;78;41;37
25;Lleida;033;Artesa de Lleida;1539;821;718
25;Lleida;034;Artesa de Segre;3485;1799;1686
25;Lleida;035;Sentiu de Sió, La;455;238;217
25;Lleida;036;Aspa;220;115;105
25;Lleida;037;Avellanes i Santa Linya, Les;430;234;196
25;Lleida;038;Aitona;2603;1386;1217
25;Lleida;039;Baix Pallars;340;188;152
25;Lleida;040;Balaguer;17705;9077;8628
25;Lleida;041;Barbens;926;525;401
25;Lleida;042;Baronia de Rialb, La;231;124;107
25;Lleida;043;Vall de Boí, La;1116;599;517
25;Lleida;044;Bassella;210;115;95
25;Lleida;045;Bausen;60;31;29
25;Lleida;046;Belianes;517;248;269
25;Lleida;047;Bellcaire d'Urgell;1228;620;608
25;Lleida;048;Bell-lloc d'Urgell;2359;1182;1177
25;Lleida;049;Bellmunt d'Urgell;182;97;85
25;Lleida;050;Bellpuig;5276;2828;2448
25;Lleida;051;Bellver de Cerdanya;2260;1165;1095
25;Lleida;052;Bellvís;2269;1175;1094
25;Lleida;053;Benavent de Segrià;1578;828;750
25;Lleida;055;Biosca;176;96;80
25;Lleida;056;Bovera;247;130;117
25;Lleida;057;Bòrdes, Es;280;154;126
25;Lleida;058;Borges Blanques, Les;6379;3268;3111
25;Lleida;059;Bossòst;1141;563;578
25;Lleida;060;Cabanabona;65;29;36
25;Lleida;061;Cabó;89;49;40
25;Lleida;062;Camarasa;805;412;393
25;Lleida;063;Canejan;101;48;53
25;Lleida;064;Castellar de la Ribera;144;75;69
25;Lleida;067;Castelldans;891;462;429
25;Lleida;068;Castellnou de Seana;723;382;341
25;Lleida;069;Castelló de Farfanya;544;287;257
25;Lleida;070;Castellserà;993;512;481
25;Lleida;071;Cava;39;26;13
25;Lleida;072;Cervera;9533;4869;4664
25;Lleida;073;Cervià de les Garrigues;641;348;293
25;Lleida;074;Ciutadilla;194;104;90
25;Lleida;075;Clariana de Cardener;161;84;77
25;Lleida;076;Cogul, El;161;89;72
25;Lleida;077;Coll de Nargó;587;316;271
25;Lleida;078;Corbins;1502;820;682
25;Lleida;079;Cubells;343;180;163
25;Lleida;081;Espluga Calba, L';331;169;162
25;Lleida;082;Espot;379;211;168
25;Lleida;085;Estaràs;162;81;81
25;Lleida;086;Esterri d'Àneu;921;472;449
25;Lleida;087;Esterri de Cardós;63;31;32
25;Lleida;088;Estamariu;132;76;56
25;Lleida;089;Farrera;127;72;55
25;Lleida;092;Floresta, La;164;88;76
25;Lleida;093;Fondarella;805;402;403
25;Lleida;094;Foradada;195;107;88
25;Lleida;096;Fuliola, La;1238;612;626
25;Lleida;097;Fulleda;91;48;43
25;Lleida;098;Gavet de la Conca;259;133;126
25;Lleida;099;Golmés;1916;971;945
25;Lleida;100;Gósol;215;118;97
25;Lleida;101;Granadella, La;758;441;317
25;Lleida;102;Granja d'Escarp, La;943;540;403
25;Lleida;103;Granyanella;140;80;60
25;Lleida;104;Granyena de Segarra;145;77;68
25;Lleida;105;Granyena de les Garrigues;163;95;68
25;Lleida;109;Guimerà;246;133;113
25;Lleida;110;Guissona;7635;4044;3591
25;Lleida;111;Guixers;134;77;57
25;Lleida;112;Ivars de Noguera;318;172;146
25;Lleida;113;Ivars d'Urgell;1590;868;722
25;Lleida;114;Ivorra;100;59;41
25;Lleida;115;Isona i Conca Dellà;1046;576;470
25;Lleida;118;Juncosa;390;206;184
25;Lleida;119;Juneda;3473;1844;1629
25;Lleida;120;Lleida;144739;72366;72373
25;Lleida;121;Les;1013;529;484
25;Lleida;122;Linyola;2749;1394;1355
25;Lleida;123;Lladorre;254;138;116
25;Lleida;124;Lladurs;185;98;87
25;Lleida;125;Llardecans;428;227;201
25;Lleida;126;Llavorsí;336;168;168
25;Lleida;127;Lles de Cerdanya;285;166;119
25;Lleida;128;Llimiana;131;74;57
25;Lleida;129;Llobera;209;119;90
25;Lleida;130;Maldà;236;118;118
25;Lleida;131;Massalcoreig;584;328;256
25;Lleida;132;Massoteres;216;111;105
25;Lleida;133;Maials;921;508;413
25;Lleida;134;Menàrguens;789;411;378
25;Lleida;135;Miralcamp;1390;721;669
25;Lleida;136;Molsosa, La;103;49;54
25;Lleida;137;Mollerussa;15544;8048;7496
25;Lleida;138;Montgai;637;327;310
25;Lleida;139;Montellà i Martinet;620;327;293
25;Lleida;140;Montferrer i Castellbò;1164;620;544
25;Lleida;141;Montoliu de Segarra;180;102;78
25;Lleida;142;Montoliu de Lleida;475;248;227
25;Lleida;143;Montornès de Segarra;88;40;48
25;Lleida;145;Nalec;89;49;40
25;Lleida;146;Navès;300;152;148
25;Lleida;148;Odèn;230;130;100
25;Lleida;149;Oliana;1839;914;925
25;Lleida;150;Oliola;196;103;93
25;Lleida;151;Olius;1003;523;480
25;Lleida;152;Oluges, Les;167;91;76
25;Lleida;153;Omellons, Els;190;98;92
25;Lleida;154;Omells de na Gaia, Els;121;65;56
25;Lleida;155;Organyà;811;416;395
25;Lleida;156;Os de Balaguer;1075;547;528
25;Lleida;157;Ossó de Sió;195;101;94
25;Lleida;158;Palau d'Anglesola, El;2205;1101;1104
25;Lleida;161;Conca de Dalt;434;232;202
25;Lleida;163;Coma i la Pedra, La;282;160;122
25;Lleida;164;Penelles;435;252;183
25;Lleida;165;Peramola;357;181;176
25;Lleida;166;Pinell de Solsonès;203;114;89
25;Lleida;167;Pinós;277;151;126
25;Lleida;168;Poal, El;653;332;321
25;Lleida;169;Pobla de Cérvoles, La;205;112;93
25;Lleida;170;Bellaguarda;288;151;137
25;Lleida;171;Pobla de Segur, La;3015;1550;1465
25;Lleida;172;Ponts;2703;1402;1301
25;Lleida;173;Pont de Suert, El;2380;1209;1171
25;Lleida;174;Portella, La;735;413;322
25;Lleida;175;Prats i Sansor;249;135;114
25;Lleida;176;Preixana;406;210;196
25;Lleida;177;Preixens;392;208;184
25;Lleida;179;Prullans;252;117;135
25;Lleida;180;Puiggròs;258;128;130
25;Lleida;181;Puigverd d'Agramunt;240;134;106
25;Lleida;182;Puigverd de Lleida;1418;735;683
25;Lleida;183;Rialp;664;335;329
25;Lleida;185;Ribera d'Urgellet;965;500;465
25;Lleida;186;Riner;262;126;136
25;Lleida;189;Rosselló;3353;1732;1621
25;Lleida;190;Salàs de Pallars;349;187;162
25;Lleida;191;Sanaüja;379;195;184
25;Lleida;192;Sant Guim de Freixenet;1222;633;589
25;Lleida;193;Sant Llorenç de Morunys;1003;486;517
25;Lleida;194;Sant Ramon;495;263;232
25;Lleida;196;Sant Esteve de la Sarga;127;78;49
25;Lleida;197;Sant Guim de la Plana;193;99;94
25;Lleida;200;Sarroca de Lleida;381;210;171
25;Lleida;201;Sarroca de Bellera;115;63;52
25;Lleida;202;Senterada;158;93;65
25;Lleida;203;Seu d'Urgell, La;12831;6278;6553
25;Lleida;204;Seròs;1902;1034;868
25;Lleida;205;Sidamon;767;404;363
25;Lleida;206;Soleràs, El;310;164;146
25;Lleida;207;Solsona;9480;4709;4771
25;Lleida;208;Soriguera;444;229;215
25;Lleida;209;Sort;2213;1098;1115
25;Lleida;210;Soses;1881;1004;877
25;Lleida;211;Sudanell;897;508;389
25;Lleida;212;Sunyer;313;168;145
25;Lleida;215;Talarn;539;323;216
25;Lleida;216;Talavera;280;151;129
25;Lleida;217;Tàrrega;18542;9225;9317
25;Lleida;218;Tarrés;125;62;63
25;Lleida;219;Tarroja de Segarra;170;91;79
25;Lleida;220;Térmens;1347;690;657
25;Lleida;221;Tírvia;144;70;74
25;Lleida;222;Tiurana;66;31;35
25;Lleida;223;Torà;1207;608;599
25;Lleida;224;Torms, Els;137;70;67
25;Lleida;225;Tornabous;851;473;378
25;Lleida;226;Torrebesses;273;142;131
25;Lleida;227;Torre de Cabdella, La;785;390;395
25;Lleida;228;Torrefarrera;4861;2470;2391
25;Lleida;230;Torregrossa;2194;1161;1033
25;Lleida;231;Torrelameu;766;460;306
25;Lleida;232;Torres de Segre;2318;1207;1111
25;Lleida;233;Torre-serona;435;223;212
25;Lleida;234;Tremp;6015;2971;3044
25;Lleida;238;Vallbona de les Monges;223;119;104
25;Lleida;239;Valls de Valira, Les;810;429;381
25;Lleida;240;Vallfogona de Balaguer;2000;1007;993
25;Lleida;242;Verdú;886;425;461
25;Lleida;243;Vielha e Mijaran;5832;2955;2877
25;Lleida;244;Vilagrassa;633;332;301
25;Lleida;245;Vilaller;506;282;224
25;Lleida;247;Vilamòs;175;100;75
25;Lleida;248;Vilanova de Bellpuig;1168;593;575
25;Lleida;249;Vilanova de l'Aguda;193;101;92
25;Lleida;250;Vilanova de Meià;466;306;160
25;Lleida;251;Vilanova de Segrià;1065;573;492
25;Lleida;252;Vila-sana;753;382;371
25;Lleida;253;Vilosell, El;194;98;96
25;Lleida;254;Vilanova de la Barca;1107;599;508
25;Lleida;255;Vinaixa;450;239;211
25;Lleida;901;Vall de Cardós;375;205;170
25;Lleida;902;Sant Martí de Riucorb;673;353;320
25;Lleida;903;Guingueta d'Àneu, La;285;158;127
25;Lleida;904;Castell de Mur;170;95;75
25;Lleida;905;Ribera d'Ondara;454;241;213
25;Lleida;906;Valls d'Aguilar, Les;262;146;116
25;Lleida;907;Torrefeta i Florejacs;605;321;284
25;Lleida;908;Fígols i Alinyà;243;142;101
25;Lleida;909;Vansa i Fórnols, La;188;97;91
25;Lleida;910;Josa i Tuixén;122;73;49
25;Lleida;911;Plans de Sió, Els;512;276;236
25;Lleida;912;Gimenells i el Pla de la Font;1097;583;514
25;Lleida;913;Riu de Cerdanya;99;56;43
26;Rioja, La;001;Ábalos;256;144;112
26;Rioja, La;002;Agoncillo;1314;720;594
26;Rioja, La;003;Aguilar del Río Alhama;426;214;212
26;Rioja, La;004;Ajamil de Cameros;85;53;32
26;Rioja, La;005;Albelda de Iregua;3855;1991;1864
26;Rioja, La;006;Alberite;2674;1369;1305
26;Rioja, La;007;Alcanadre;647;345;302
26;Rioja, La;008;Aldeanueva de Ebro;2691;1413;1278
26;Rioja, La;009;Alesanco;480;245;235
26;Rioja, La;010;Alesón;96;60;36
26;Rioja, La;011;Alfaro;9874;4959;4915
26;Rioja, La;012;Almarza de Cameros;40;25;15
26;Rioja, La;013;Anguciana;427;234;193
26;Rioja, La;014;Anguiano;488;266;222
26;Rioja, La;015;Arenzana de Abajo;263;138;125
26;Rioja, La;016;Arenzana de Arriba;35;24;11
26;Rioja, La;017;Arnedillo;428;216;212
26;Rioja, La;018;Arnedo;15219;7609;7610
26;Rioja, La;019;Arrúbal;565;302;263
26;Rioja, La;020;Ausejo;808;426;382
26;Rioja, La;021;Autol;4875;2452;2423
26;Rioja, La;022;Azofra;201;111;90
26;Rioja, La;023;Badarán;493;250;243
26;Rioja, La;024;Bañares;199;105;94
26;Rioja, La;025;Baños de Rioja;83;51;32
26;Rioja, La;026;Baños de Río Tobía;1605;820;785
26;Rioja, La;027;Berceo;138;86;52
26;Rioja, La;028;Bergasa;170;92;78
26;Rioja, La;029;Bergasillas Bajera;36;18;18
26;Rioja, La;030;Bezares;21;9;12
26;Rioja, La;031;Bobadilla;101;53;48
26;Rioja, La;032;Brieva de Cameros;38;22;16
26;Rioja, La;033;Briñas;187;94;93
26;Rioja, La;034;Briones;749;397;352
26;Rioja, La;035;Cabezón de Cameros;22;14;8
26;Rioja, La;036;Calahorra;25064;12296;12768
26;Rioja, La;037;Camprovín;159;86;73
26;Rioja, La;038;Canales de la Sierra;82;55;27
26;Rioja, La;039;Canillas de Río Tuerto;44;25;19
26;Rioja, La;040;Cañas;96;52;44
26;Rioja, La;041;Cárdenas;129;69;60
26;Rioja, La;042;Casalarreina;1062;530;532
26;Rioja, La;043;Castañares de Rioja;404;193;211
26;Rioja, La;044;Castroviejo;56;32;24
26;Rioja, La;045;Cellorigo;10;4;6
26;Rioja, La;046;Cenicero;2091;1081;1010
26;Rioja, La;047;Cervera del Río Alhama;2255;1160;1095
26;Rioja, La;048;Cidamón;17;8;9
26;Rioja, La;049;Cihuri;200;106;94
26;Rioja, La;050;Cirueña;193;119;74
26;Rioja, La;051;Clavijo;296;171;125
26;Rioja, La;052;Cordovín;159;80;79
26;Rioja, La;053;Corera;273;142;131
26;Rioja, La;054;Cornago;287;163;124
26;Rioja, La;055;Corporales;42;26;16
26;Rioja, La;056;Cuzcurrita de Río Tirón;549;284;265
26;Rioja, La;057;Daroca de Rioja;66;41;25
26;Rioja, La;058;Enciso;170;110;60
26;Rioja, La;059;Entrena;1635;856;779
26;Rioja, La;060;Estollo;86;51;35
26;Rioja, La;061;Ezcaray;2098;1086;1012
26;Rioja, La;062;Foncea;93;53;40
26;Rioja, La;063;Fonzaleche;124;80;44
26;Rioja, La;064;Fuenmayor;3278;1646;1632
26;Rioja, La;065;Galbárruli;79;51;28
26;Rioja, La;066;Galilea;407;203;204
26;Rioja, La;067;Gallinero de Cameros;16;10;6
26;Rioja, La;068;Gimileo;120;63;57
26;Rioja, La;069;Grañón;221;123;98
26;Rioja, La;070;Grávalos;185;103;82
26;Rioja, La;071;Haro;11979;5942;6037
26;Rioja, La;072;Herce;338;179;159
26;Rioja, La;073;Herramélluri;110;63;47
26;Rioja, La;074;Hervías;137;71;66
26;Rioja, La;075;Hormilla;431;226;205
26;Rioja, La;076;Hormilleja;135;71;64
26;Rioja, La;077;Hornillos de Cameros;12;6;6
26;Rioja, La;078;Hornos de Moncalvillo;98;58;40
26;Rioja, La;079;Huércanos;840;463;377
26;Rioja, La;080;Igea;649;370;279
26;Rioja, La;081;Jalón de Cameros;23;11;12
26;Rioja, La;082;Laguna de Cameros;115;61;54
26;Rioja, La;083;Lagunilla del Jubera;390;216;174
26;Rioja, La;084;Lardero;11658;5833;5825
26;Rioja, La;086;Ledesma de la Cogolla;16;11;5
26;Rioja, La;087;Leiva;245;120;125
26;Rioja, La;088;Leza de Río Leza;43;25;18
26;Rioja, La;089;Logroño;151164;71431;79733
26;Rioja, La;091;Lumbreras de Cameros;147;98;49
26;Rioja, La;092;Manjarrés;107;66;41
26;Rioja, La;093;Mansilla de la Sierra;61;46;15
26;Rioja, La;094;Manzanares de Rioja;61;38;23
26;Rioja, La;095;Matute;88;52;36
26;Rioja, La;096;Medrano;355;194;161
26;Rioja, La;098;Munilla;98;58;40
26;Rioja, La;099;Murillo de Río Leza;1665;853;812
26;Rioja, La;100;Muro de Aguas;54;35;19
26;Rioja, La;101;Muro en Cameros;35;19;16
26;Rioja, La;102;Nájera;8174;4072;4102
26;Rioja, La;103;Nalda;1307;714;593
26;Rioja, La;104;Navajún;8;7;1
26;Rioja, La;105;Navarrete;3038;1534;1504
26;Rioja, La;106;Nestares;85;53;32
26;Rioja, La;107;Nieva de Cameros;86;52;34
26;Rioja, La;108;Ocón;331;200;131
26;Rioja, La;109;Ochánduri;82;48;34
26;Rioja, La;110;Ojacastro;179;104;75
26;Rioja, La;111;Ollauri;312;169;143
26;Rioja, La;112;Ortigosa de Cameros;216;135;81
26;Rioja, La;113;Pazuengos;25;20;5
26;Rioja, La;114;Pedroso;90;55;35
26;Rioja, La;115;Pinillos;19;10;9
26;Rioja, La;117;Pradejón;3754;1955;1799
26;Rioja, La;118;Pradillo;64;37;27
26;Rioja, La;119;Préjano;223;125;98
26;Rioja, La;120;Quel;2139;1150;989
26;Rioja, La;121;Rabanera;31;23;8
26;Rioja, La;122;Rasillo de Cameros, El;153;87;66
26;Rioja, La;123;Redal, El;142;80;62
26;Rioja, La;124;Ribafrecha;1065;557;508
26;Rioja, La;125;Rincón de Soto;4024;2118;1906
26;Rioja, La;126;Robres del Castillo;24;15;9
26;Rioja, La;127;Rodezno;222;123;99
26;Rioja, La;128;Sajazarra;125;70;55
26;Rioja, La;129;San Asensio;1099;581;518
26;Rioja, La;130;San Millán de la Cogolla;215;143;72
26;Rioja, La;131;San Millán de Yécora;32;23;9
26;Rioja, La;132;San Román de Cameros;127;77;50
26;Rioja, La;134;Santa Coloma;103;58;45
26;Rioja, La;135;Santa Engracia del Jubera;192;116;76
26;Rioja, La;136;Santa Eulalia Bajera;111;66;45
26;Rioja, La;138;Santo Domingo de la Calzada;6348;3177;3171
26;Rioja, La;139;San Torcuato;64;34;30
26;Rioja, La;140;Santurde de Rioja;254;137;117
26;Rioja, La;141;Santurdejo;96;56;40
26;Rioja, La;142;San Vicente de la Sonsierra;1014;535;479
26;Rioja, La;143;Sojuela;659;368;291
26;Rioja, La;144;Sorzano;217;122;95
26;Rioja, La;145;Sotés;260;142;118
26;Rioja, La;146;Soto en Cameros;85;48;37
26;Rioja, La;147;Terroba;39;19;20
26;Rioja, La;148;Tirgo;171;90;81
26;Rioja, La;149;Tobía;45;27;18
26;Rioja, La;150;Tormantos;122;70;52
26;Rioja, La;151;Torrecilla en Cameros;458;254;204
26;Rioja, La;152;Torrecilla sobre Alesanco;55;34;21
26;Rioja, La;153;Torre en Cameros;8;6;2
26;Rioja, La;154;Torremontalbo;7;6;1
26;Rioja, La;155;Treviana;146;79;67
26;Rioja, La;157;Tricio;374;188;186
26;Rioja, La;158;Tudelilla;367;197;170
26;Rioja, La;160;Uruñuela;990;510;480
26;Rioja, La;161;Valdemadera;12;9;3
26;Rioja, La;162;Valgañón;132;76;56
26;Rioja, La;163;Ventosa;189;100;89
26;Rioja, La;164;Ventrosa;51;32;19
26;Rioja, La;165;Viguera;379;215;164
26;Rioja, La;166;Villalba de Rioja;161;93;68
26;Rioja, La;167;Villalobar de Rioja;73;48;25
26;Rioja, La;168;Villamediana de Iregua;9207;4613;4594
26;Rioja, La;169;Villanueva de Cameros;71;43;28
26;Rioja, La;170;Villar de Arnedo, El;617;329;288
26;Rioja, La;171;Villar de Torre;147;89;58
26;Rioja, La;172;Villarejo;27;21;6
26;Rioja, La;173;Villarroya;4;3;1
26;Rioja, La;174;Villarta-Quintana;130;73;57
26;Rioja, La;175;Villavelayo;41;28;13
26;Rioja, La;176;Villaverde de Rioja;75;43;32
26;Rioja, La;177;Villoslada de Cameros;348;220;128
26;Rioja, La;178;Viniegra de Abajo;75;48;27
26;Rioja, La;179;Viniegra de Arriba;40;28;12
26;Rioja, La;180;Zarratón;255;133;122
26;Rioja, La;181;Zarzosa;14;9;5
26;Rioja, La;183;Zorraquín;86;49;37
27;Lugo;001;Abadín;2217;1103;1114
27;Lugo;002;Alfoz;1523;725;798
27;Lugo;003;Antas de Ulla;1822;889;933
27;Lugo;004;Baleira;1120;599;521
27;Lugo;005;Barreiros;3030;1462;1568
27;Lugo;006;Becerreá;2703;1351;1352
27;Lugo;007;Begonte;2905;1470;1435
27;Lugo;008;Bóveda;1409;713;696
27;Lugo;009;Carballedo;2044;1030;1014
27;Lugo;010;Castro de Rei;5041;2537;2504
27;Lugo;011;Castroverde;2497;1286;1211
27;Lugo;012;Cervantes;1187;690;497
27;Lugo;013;Cervo;4184;2060;2124
27;Lugo;014;Corgo, O;3370;1737;1633
27;Lugo;015;Cospeito;4213;2072;2141
27;Lugo;016;Chantada;8092;3940;4152
27;Lugo;017;Folgoso do Courel;978;509;469
27;Lugo;018;Fonsagrada, A;3116;1628;1488
27;Lugo;019;Foz;10198;4960;5238
27;Lugo;020;Friol;3598;1845;1753
27;Lugo;021;Xermade;1698;849;849
27;Lugo;022;Guitiriz;5122;2576;2546
27;Lugo;023;Guntín;2529;1287;1242
27;Lugo;024;Incio, O;1508;772;736
27;Lugo;025;Xove;3327;1737;1590
27;Lugo;026;Láncara;2500;1279;1221
27;Lugo;027;Lourenzá;2098;1025;1073
27;Lugo;028;Lugo;99482;45979;53503
27;Lugo;029;Meira;1756;876;880
27;Lugo;030;Mondoñedo;3352;1593;1759
27;Lugo;031;Monforte de Lemos;18560;8792;9768
27;Lugo;032;Monterroso;3632;1798;1834
27;Lugo;033;Muras;600;306;294
27;Lugo;034;Navia de Suarna;979;543;436
27;Lugo;035;Negueira de Muñiz;240;132;108
27;Lugo;037;Nogais, As;942;498;444
27;Lugo;038;Ourol;985;503;482
27;Lugo;039;Outeiro de Rei;5358;2744;2614
27;Lugo;040;Palas de Rei;3267;1672;1595
27;Lugo;041;Pantón;2340;1157;1183
27;Lugo;042;Paradela;1591;802;789
27;Lugo;043;Páramo, O;1296;647;649
27;Lugo;044;Pastoriza, A;2787;1404;1383
27;Lugo;045;Pedrafita do Cebreiro;898;488;410
27;Lugo;046;Pol;1542;773;769
27;Lugo;047;Pobra do Brollón, A;1619;815;804
27;Lugo;048;Pontenova, A;2124;1033;1091
27;Lugo;049;Portomarín;1286;666;620
27;Lugo;050;Quiroga;3057;1473;1584
27;Lugo;051;Ribadeo;9978;4699;5279
27;Lugo;052;Ribas de Sil;904;460;444
27;Lugo;053;Ribeira de Piquín;492;262;230
27;Lugo;054;Riotorto;1179;595;584
27;Lugo;055;Samos;1198;629;569
27;Lugo;056;Rábade;1499;739;760
27;Lugo;057;Sarria;13459;6565;6894
27;Lugo;058;Saviñao, O;3488;1772;1716
27;Lugo;059;Sober;2129;1042;1087
27;Lugo;060;Taboada;2601;1254;1347
27;Lugo;061;Trabada;1083;532;551
27;Lugo;062;Triacastela;609;298;311
27;Lugo;063;Valadouro, O;1906;908;998
27;Lugo;064;Vicedo, O;1589;770;819
27;Lugo;065;Vilalba;13787;6648;7139
27;Lugo;066;Viveiro;15217;7482;7735
27;Lugo;901;Baralla;2455;1308;1147
27;Lugo;902;Burela;9547;4790;4757
28;Madrid;001;Acebeda, La;68;37;31
28;Madrid;002;Ajalvir;4863;2537;2326
28;Madrid;003;Alameda del Valle;255;140;115
28;Madrid;004;Álamo, El;10430;5151;5279
28;Madrid;005;Alcalá de Henares;200702;96841;103861
28;Madrid;006;Alcobendas;121373;57849;63524
28;Madrid;007;Alcorcón;173625;83028;90597
28;Madrid;008;Aldea del Fresno;3422;1753;1669
28;Madrid;009;Algete;21167;10307;10860
28;Madrid;010;Alpedrete;15543;7620;7923
28;Madrid;011;Ambite;697;349;348
28;Madrid;012;Anchuelo;1392;728;664
28;Madrid;013;Aranjuez;62292;30346;31946
28;Madrid;014;Arganda del Rey;59513;29660;29853
28;Madrid;015;Arroyomolinos;37208;18439;18769
28;Madrid;016;Atazar, El;107;57;50
28;Madrid;017;Batres;1943;1010;933
28;Madrid;018;Becerril de la Sierra;6573;3255;3318
28;Madrid;019;Belmonte de Tajo;1917;995;922
28;Madrid;020;Berzosa del Lozoya;231;129;102
28;Madrid;021;Berrueco, El;816;415;401
28;Madrid;022;Boadilla del Monte;65839;32226;33613
28;Madrid;023;Boalo, El;8547;4252;4295
28;Madrid;024;Braojos;219;131;88
28;Madrid;025;Brea de Tajo;579;331;248
28;Madrid;026;Brunete;11300;5502;5798
28;Madrid;027;Buitrago del Lozoya;1973;957;1016
28;Madrid;028;Bustarviejo;2829;1378;1451
28;Madrid;029;Cabanillas de la Sierra;941;483;458
28;Madrid;030;Cabrera, La;2922;1439;1483
28;Madrid;031;Cadalso de los Vidrios;3228;1682;1546
28;Madrid;032;Camarma de Esteruelas;8106;4143;3963
28;Madrid;033;Campo Real;6802;3417;3385
28;Madrid;034;Canencia;469;242;227
28;Madrid;035;Carabaña;2352;1193;1159
28;Madrid;036;Casarrubuelos;4211;2168;2043
28;Madrid;037;Cenicientos;2148;1074;1074
28;Madrid;038;Cercedilla;7647;3767;3880
28;Madrid;039;Cervera de Buitrago;161;94;67
28;Madrid;040;Ciempozuelos;26140;13114;13026
28;Madrid;041;Cobeña;7759;3803;3956
28;Madrid;042;Colmenar del Arroyo;2015;1039;976
28;Madrid;043;Colmenar de Oreja;8888;4493;4395
28;Madrid;044;Colmenarejo;9623;4756;4867
28;Madrid;045;Colmenar Viejo;57029;28139;28890
28;Madrid;046;Collado Mediano;7547;3742;3805
28;Madrid;047;Collado Villalba;66698;32270;34428
28;Madrid;048;Corpa;792;396;396
28;Madrid;049;Coslada;80760;39287;41473
28;Madrid;050;Cubas de la Sagra;6988;3540;3448
28;Madrid;051;Chapinería;2642;1313;1329
28;Madrid;052;Chinchón;5818;2917;2901
28;Madrid;053;Daganzo de Arriba;10703;5335;5368
28;Madrid;054;Escorial, El;17176;8447;8729
28;Madrid;055;Estremera;1467;760;707
28;Madrid;056;Fresnedillas de la Oliva;1837;927;910
28;Madrid;057;Fresno de Torote;2548;1323;1225
28;Madrid;058;Fuenlabrada;190790;93178;97612
28;Madrid;059;Fuente el Saz de Jarama;7379;3720;3659
28;Madrid;060;Fuentidueña de Tajo;2328;1156;1172
28;Madrid;061;Galapagar;36184;17561;18623
28;Madrid;062;Garganta de los Montes;416;230;186
28;Madrid;063;Gargantilla del Lozoya y Pinilla de Buitrago;397;223;174
28;Madrid;064;Gascones;239;127;112
28;Madrid;065;Getafe;189906;92424;97482
28;Madrid;066;Griñón;10718;5330;5388
28;Madrid;067;Guadalix de la Sierra;6904;3479;3425
28;Madrid;068;Guadarrama;17062;8376;8686
28;Madrid;069;Hiruela, La;83;52;31
28;Madrid;070;Horcajo de la Sierra-Aoslos;233;113;120
28;Madrid;071;Horcajuelo de la Sierra;111;55;56
28;Madrid;072;Hoyo de Manzanares;9178;4624;4554
28;Madrid;073;Humanes de Madrid;20074;9973;10101
28;Madrid;074;Leganés;194084;93396;100688
28;Madrid;075;Loeches;9200;4635;4565
28;Madrid;076;Lozoya;617;324;293
28;Madrid;078;Madarcos;70;36;34
28;Madrid;079;Madrid;3416771;1600298;1816473
28;Madrid;080;Majadahonda;73355;34677;38678
28;Madrid;082;Manzanares el Real;9550;4824;4726
28;Madrid;083;Meco;15732;7865;7867
28;Madrid;084;Mejorada del Campo;24659;12226;12433
28;Madrid;085;Miraflores de la Sierra;7139;3623;3516
28;Madrid;086;Molar, El;10052;5076;4976
28;Madrid;087;Molinos, Los;4731;2340;2391
28;Madrid;088;Montejo de la Sierra;374;197;177
28;Madrid;089;Moraleja de Enmedio;5576;2813;2763
28;Madrid;090;Moralzarzal;14586;7234;7352
28;Madrid;091;Morata de Tajuña;8319;4184;4135
28;Madrid;092;Móstoles;214006;103595;110411
28;Madrid;093;Navacerrada;3290;1618;1672
28;Madrid;094;Navalafuente;1672;856;816
28;Madrid;095;Navalagamella;3111;1590;1521
28;Madrid;096;Navalcarnero;32683;16229;16454
28;Madrid;097;Navarredonda y San Mamés;151;91;60
28;Madrid;099;Navas del Rey;3347;1729;1618
28;Madrid;100;Nuevo Baztán;7339;3699;3640
28;Madrid;101;Olmeda de las Fuentes;408;212;196
28;Madrid;102;Orusco de Tajuña;1511;780;731
28;Madrid;104;Paracuellos de Jarama;27238;13575;13663
28;Madrid;106;Parla;134833;66806;68027
28;Madrid;107;Patones;602;270;332
28;Madrid;108;Pedrezuela;6467;3264;3203
28;Madrid;109;Pelayos de la Presa;3136;1591;1545
28;Madrid;110;Perales de Tajuña;3207;1582;1625
28;Madrid;111;Pezuela de las Torres;989;524;465
28;Madrid;112;Pinilla del Valle;200;107;93
28;Madrid;113;Pinto;56003;27542;28461
28;Madrid;114;Piñuécar-Gandullas;185;98;87
28;Madrid;115;Pozuelo de Alarcón;89378;42719;46659
28;Madrid;116;Pozuelo del Rey;1292;672;620
28;Madrid;117;Prádena del Rincón;139;76;63
28;Madrid;118;Puebla de la Sierra;93;55;38
28;Madrid;119;Quijorna;4001;1974;2027
28;Madrid;120;Rascafría;1707;918;789
28;Madrid;121;Redueña;288;160;128
28;Madrid;122;Ribatejada;900;461;439
28;Madrid;123;Rivas-Vaciamadrid;101949;50329;51620
28;Madrid;124;Robledillo de la Jara;131;68;63
28;Madrid;125;Robledo de Chavela;4725;2454;2271
28;Madrid;126;Robregordo;73;40;33
28;Madrid;127;Rozas de Madrid, Las;98590;47568;51022
28;Madrid;128;Rozas de Puerto Real;580;337;243
28;Madrid;129;San Agustín del Guadalix;13762;6677;7085
28;Madrid;130;San Fernando de Henares;38980;18900;20080
28;Madrid;131;San Lorenzo de El Escorial;18735;8909;9826
28;Madrid;132;San Martín de la Vega;20733;10625;10108
28;Madrid;133;San Martín de Valdeiglesias;9159;4547;4612
28;Madrid;134;San Sebastián de los Reyes;94969;45936;49033
28;Madrid;135;Santa María de la Alameda;1517;816;701
28;Madrid;136;Santorcaz;999;498;501
28;Madrid;137;Santos de la Humosa, Los;2785;1434;1351
28;Madrid;138;Serna del Monte, La;105;55;50
28;Madrid;140;Serranillos del Valle;4634;2274;2360
28;Madrid;141;Sevilla la Nueva;9657;4728;4929
28;Madrid;143;Somosierra;95;52;43
28;Madrid;144;Soto del Real;9441;4671;4770
28;Madrid;145;Talamanca de Jarama;4533;2193;2340
28;Madrid;146;Tielmes;2810;1411;1399
28;Madrid;147;Titulcia;1387;720;667
28;Madrid;148;Torrejón de Ardoz;140626;68848;71778
28;Madrid;149;Torrejón de la Calzada;10378;5163;5215
28;Madrid;150;Torrejón de Velasco;4893;2431;2462
28;Madrid;151;Torrelaguna;4991;2473;2518
28;Madrid;152;Torrelodones;25316;12247;13069
28;Madrid;153;Torremocha de Jarama;1132;569;563
28;Madrid;154;Torres de la Alameda;7758;3981;3777
28;Madrid;155;Valdaracete;645;326;319
28;Madrid;156;Valdeavero;1823;920;903
28;Madrid;157;Valdelaguna;1094;565;529
28;Madrid;158;Valdemanco;1052;547;505
28;Madrid;159;Valdemaqueda;833;434;399
28;Madrid;160;Valdemorillo;14164;7087;7077
28;Madrid;161;Valdemoro;83507;41033;42474
28;Madrid;162;Valdeolmos-Alalpardo;4568;2329;2239
28;Madrid;163;Valdepiélagos;619;323;296
28;Madrid;164;Valdetorres de Jarama;5026;2508;2518
28;Madrid;165;Valdilecha;3213;1651;1562
28;Madrid;166;Valverde de Alcalá;553;287;266
28;Madrid;167;Velilla de San Antonio;14003;6953;7050
28;Madrid;168;Vellón, El;2166;1144;1022
28;Madrid;169;Venturada;2559;1305;1254
28;Madrid;170;Villaconejos;3508;1763;1745
28;Madrid;171;Villa del Prado;7437;3805;3632
28;Madrid;172;Villalbilla;18000;9068;8932
28;Madrid;173;Villamanrique de Tajo;825;421;404
28;Madrid;174;Villamanta;2823;1438;1385
28;Madrid;175;Villamantilla;1624;808;816
28;Madrid;176;Villanueva de la Cañada;23799;11534;12265
28;Madrid;177;Villanueva del Pardillo;18086;8722;9364
28;Madrid;178;Villanueva de Perales;1674;851;823
28;Madrid;179;Villar del Olmo;2277;1146;1131
28;Madrid;180;Villarejo de Salvanés;7900;3897;4003
28;Madrid;181;Villaviciosa de Odón;29273;14087;15186
28;Madrid;182;Villavieja del Lozoya;324;171;153
28;Madrid;183;Zarzalejo;1874;971;903
28;Madrid;901;Lozoyuela-Navas-Sieteiglesias;1483;760;723
28;Madrid;902;Puentes Viejas;775;403;372
28;Madrid;903;Tres Cantos;52932;25694;27238
29;Málaga;001;Alameda;5449;2750;2699
29;Málaga;002;Alcaucín;2653;1351;1302
29;Málaga;003;Alfarnate;1046;542;504
29;Málaga;004;Alfarnatejo;371;192;179
29;Málaga;005;Algarrobo;6909;3471;3438
29;Málaga;006;Algatocín;834;439;395
29;Málaga;007;Alhaurín de la Torre;44057;21849;22208
29;Málaga;008;Alhaurín el Grande;27647;13752;13895
29;Málaga;009;Almáchar;1927;978;949
29;Málaga;010;Almargen;1913;964;949
29;Málaga;011;Almogía;4132;2151;1981
29;Málaga;012;Álora;13570;6808;6762
29;Málaga;013;Alozaina;2130;1082;1048
29;Málaga;014;Alpandeire;258;135;123
29;Málaga;015;Antequera;41619;20368;21251
29;Málaga;016;Árchez;411;210;201
29;Málaga;017;Archidona;8042;4049;3993
29;Málaga;018;Ardales;2516;1270;1246
29;Málaga;019;Arenas;1259;655;604
29;Málaga;020;Arriate;4073;2012;2061
29;Málaga;021;Atajate;187;97;90
29;Málaga;022;Benadalid;234;113;121
29;Málaga;023;Benahavís;9077;4518;4559
29;Málaga;024;Benalauría;465;248;217
29;Málaga;025;Benalmádena;77654;37965;39689
29;Málaga;026;Benamargosa;1552;795;757
29;Málaga;027;Benamocarra;3115;1551;1564
29;Málaga;028;Benaoján;1428;731;697
29;Málaga;029;Benarrabá;462;239;223
29;Málaga;030;Borge, El;941;481;460
29;Málaga;031;Burgo, El;1758;894;864
29;Málaga;032;Campillos;8499;4255;4244
29;Málaga;033;Canillas de Aceituno;1777;922;855
29;Málaga;034;Canillas de Albaida;799;396;403
29;Málaga;035;Cañete la Real;1587;793;794
29;Málaga;036;Carratraca;786;410;376
29;Málaga;037;Cartajima;229;119;110
29;Málaga;038;Cártama;28934;14627;14307
29;Málaga;039;Casabermeja;4065;2110;1955
29;Málaga;040;Casarabonela;2758;1461;1297
29;Málaga;041;Casares;8486;4329;4157
29;Málaga;042;Coín;25809;12975;12834
29;Málaga;043;Colmenar;3545;1818;1727
29;Málaga;044;Comares;1346;722;624
29;Málaga;045;Cómpeta;3735;1863;1872
29;Málaga;046;Cortes de la Frontera;3000;1551;1449
29;Málaga;047;Cuevas Bajas;1341;660;681
29;Málaga;048;Cuevas del Becerro;1605;788;817
29;Málaga;049;Cuevas de San Marcos;3620;1815;1805
29;Málaga;050;Cútar;587;304;283
29;Málaga;051;Estepona;78413;38202;40211
29;Málaga;052;Faraján;284;145;139
29;Málaga;053;Frigiliana;3310;1643;1667
29;Málaga;054;Fuengirola;85859;41575;44284
29;Málaga;055;Fuente de Piedra;2958;1464;1494
29;Málaga;056;Gaucín;1591;823;768
29;Málaga;057;Genalguacil;397;195;202
29;Málaga;058;Guaro;2469;1266;1203
29;Málaga;059;Humilladero;3360;1681;1679
29;Málaga;060;Igualeja;774;393;381
29;Málaga;061;Istán;1622;803;819
29;Málaga;062;Iznate;947;485;462
29;Málaga;063;Jimera de Líbar;398;204;194
29;Málaga;064;Jubrique;578;293;285
29;Málaga;065;Júzcar;227;133;94
29;Málaga;066;Macharaviaya;506;287;219
29;Málaga;067;Málaga;591637;283717;307920
29;Málaga;068;Manilva;18099;9064;9035
29;Málaga;069;Marbella;159000;75903;83097
29;Málaga;070;Mijas;93302;46196;47106
29;Málaga;071;Moclinejo;1227;629;598
29;Málaga;072;Mollina;5449;2706;2743
29;Málaga;073;Monda;2981;1547;1434
29;Málaga;074;Montejaque;952;469;483
29;Málaga;075;Nerja;22187;10882;11305
29;Málaga;076;Ojén;4682;2408;2274
29;Málaga;077;Parauta;281;146;135
29;Málaga;079;Periana;3350;1733;1617
29;Málaga;080;Pizarra;10177;5108;5069
29;Málaga;081;Pujerra;290;147;143
29;Málaga;082;Rincón de la Victoria;52230;25423;26807
29;Málaga;083;Riogordo;2778;1457;1321
29;Málaga;084;Ronda;33451;16227;17224
29;Málaga;085;Salares;198;108;90
29;Málaga;086;Sayalonga;1646;870;776
29;Málaga;087;Sedella;600;337;263
29;Málaga;088;Sierra de Yeguas;3452;1726;1726
29;Málaga;089;Teba;3702;1856;1846
29;Málaga;090;Tolox;2374;1215;1159
29;Málaga;091;Torrox;21583;10813;10770
29;Málaga;092;Totalán;776;394;382
29;Málaga;093;Valle de Abdalajís;2435;1225;1210
29;Málaga;094;Vélez-Málaga;85990;42240;43750
29;Málaga;095;Villanueva de Algaidas;4075;2060;2015
29;Málaga;096;Villanueva del Rosario;3401;1661;1740
29;Málaga;097;Villanueva del Trabuco;5410;2720;2690
29;Málaga;098;Villanueva de Tapia;1396;707;689
29;Málaga;099;Viñuela;2006;1026;980
29;Málaga;100;Yunquera;2868;1454;1414
29;Málaga;901;Torremolinos;70933;35808;35125
29;Málaga;902;Villanueva de la Concepción;3286;1581;1705
29;Málaga;903;Montecorto;589;317;272
29;Málaga;904;Serrato;453;230;223
30;Murcia;001;Abanilla;6206;3180;3026
30;Murcia;002;Abarán;13000;6488;6512
30;Murcia;003;Águilas;37417;18586;18831
30;Murcia;004;Albudeite;1400;712;688
30;Murcia;005;Alcantarilla;43547;21562;21985
30;Murcia;006;Aledo;1108;549;559
30;Murcia;007;Alguazas;10204;5266;4938
30;Murcia;008;Alhama de Murcia;23578;11907;11671
30;Murcia;009;Archena;20976;11121;9855
30;Murcia;010;Beniel;11535;5976;5559
30;Murcia;011;Blanca;6825;3535;3290
30;Murcia;012;Bullas;11793;5905;5888
30;Murcia;013;Calasparra;10286;5205;5081
30;Murcia;014;Campos del Río;2151;1029;1122
30;Murcia;015;Caravaca de la Cruz;25996;13010;12986
30;Murcia;016;Cartagena;219777;109474;110303
30;Murcia;017;Cehegín;14476;7253;7223
30;Murcia;018;Ceutí;12842;6483;6359
30;Murcia;019;Cieza;35361;17701;17660
30;Murcia;020;Fortuna;11183;5910;5273
30;Murcia;021;Fuente Álamo de Murcia;18719;9860;8859
30;Murcia;022;Jumilla;27263;14242;13021
30;Murcia;023;Librilla;5777;2974;2803
30;Murcia;024;Lorca;98334;50149;48185
30;Murcia;025;Lorquí;7770;3934;3836
30;Murcia;026;Mazarrón;35099;18278;16821
30;Murcia;027;Molina de Segura;77493;38626;38867
30;Murcia;028;Moratalla;7593;3855;3738
30;Murcia;029;Mula;17585;8963;8622
30;Murcia;030;Murcia;474617;232717;241900
30;Murcia;031;Ojós;532;283;249
30;Murcia;032;Pliego;3964;2067;1897
30;Murcia;033;Puerto Lumbreras;17822;9398;8424
30;Murcia;034;Ricote;1212;641;571
30;Murcia;035;San Javier;35872;18050;17822
30;Murcia;036;San Pedro del Pinatar;28706;14308;14398
30;Murcia;037;Torre-Pacheco;40074;20753;19321
30;Murcia;038;Torres de Cotillas, Las;22406;11290;11116
30;Murcia;039;Totana;33663;17245;16418
30;Murcia;040;Ulea;891;456;435
30;Murcia;041;Unión, La;21153;10702;10451
30;Murcia;042;Villanueva del Río Segura;3944;2064;1880
30;Murcia;043;Yecla;35957;18115;17842
30;Murcia;901;Santomera;16320;8152;8168
30;Murcia;902;Alcázares, Los;19506;9946;9560
31;Navarra;001;Abáigar;86;49;37
31;Navarra;002;Abárzuza/Abartzuza;518;258;260
31;Navarra;003;Abaurregaina/Abaurrea Alta;119;69;50
31;Navarra;004;Abaurrepea/Abaurrea Baja;29;18;11
31;Navarra;005;Aberin;383;203;180
31;Navarra;006;Ablitas;2669;1354;1315
31;Navarra;007;Adiós;191;103;88
31;Navarra;008;Aguilar de Codés;75;41;34
31;Navarra;009;Aibar/Oibar;762;411;351
31;Navarra;010;Altsasu/Alsasua;7710;3889;3821
31;Navarra;011;Allín/Allin;899;488;411
31;Navarra;012;Allo;993;519;474
31;Navarra;013;Améscoa Baja;727;403;324
31;Navarra;014;Ancín/Antzin;346;183;163
31;Navarra;015;Andosilla;2913;1484;1429
31;Navarra;016;Ansoáin/Antsoain;10641;5174;5467
31;Navarra;017;Anue;486;255;231
31;Navarra;018;Añorbe;627;334;293
31;Navarra;019;Aoiz/Agoitz;3007;1516;1491
31;Navarra;020;Araitz;520;286;234
31;Navarra;021;Aranarache/Aranaratxe;70;42;28
31;Navarra;022;Arantza;619;321;298
31;Navarra;023;Aranguren;12787;6423;6364
31;Navarra;024;Arano;110;61;49
31;Navarra;025;Arakil;999;537;462
31;Navarra;026;Aras;155;80;75
31;Navarra;027;Arbizu;1108;585;523
31;Navarra;028;Arce/Artzi;301;165;136
31;Navarra;029;Arcos, Los;1191;597;594
31;Navarra;030;Arellano;159;90;69
31;Navarra;031;Areso;266;138;128
31;Navarra;032;Arguedas;2303;1172;1131
31;Navarra;033;Aria;47;30;17
31;Navarra;034;Aribe;32;18;14
31;Navarra;035;Armañanzas;53;27;26
31;Navarra;036;Arróniz;1054;567;487
31;Navarra;037;Arruazu;122;68;54
31;Navarra;038;Artajona;1774;911;863
31;Navarra;039;Artazu;124;58;66
31;Navarra;040;Atetz;216;123;93
31;Navarra;041;Ayegui/Aiegi;2550;1350;1200
31;Navarra;042;Azagra;3756;1903;1853
31;Navarra;043;Azuelo;33;10;23
31;Navarra;044;Bakaiku;340;179;161
31;Navarra;045;Barásoain;594;313;281
31;Navarra;046;Barbarin;46;27;19
31;Navarra;047;Bargota;247;123;124
31;Navarra;048;Barillas;238;127;111
31;Navarra;049;Basaburua;833;475;358
31;Navarra;050;Baztan;7863;3988;3875
31;Navarra;051;Beire;288;147;141
31;Navarra;052;Belascoáin;129;62;67
31;Navarra;053;Berbinzana;674;349;325
31;Navarra;054;Bertizarana;654;326;328
31;Navarra;055;Betelu;383;196;187
31;Navarra;056;Biurrun-Olcoz;236;121;115
31;Navarra;057;Buñuel;2315;1150;1165
31;Navarra;058;Auritz/Burguete;230;123;107
31;Navarra;059;Burgui/Burgi;190;116;74
31;Navarra;060;Burlada/Burlata;21078;10150;10928
31;Navarra;061;Busto, El;54;27;27
31;Navarra;062;Cabanillas;1376;707;669
31;Navarra;063;Cabredo;75;42;33
31;Navarra;064;Cadreita;2197;1154;1043
31;Navarra;065;Caparroso;2861;1514;1347
31;Navarra;066;Cárcar;1140;582;558
31;Navarra;067;Carcastillo;2411;1211;1200
31;Navarra;068;Cascante;4131;2069;2062
31;Navarra;069;Cáseda;943;495;448
31;Navarra;070;Castejón;4473;2261;2212
31;Navarra;071;Castillonuevo;15;9;6
31;Navarra;072;Cintruénigo;8333;4325;4008
31;Navarra;073;Ziordia;353;184;169
31;Navarra;074;Cirauqui/Zirauki;465;247;218
31;Navarra;075;Ciriza/Ziritza;161;82;79
31;Navarra;076;Cizur;3940;2021;1919
31;Navarra;077;Corella;8712;4404;4308
31;Navarra;078;Cortes;3160;1623;1537
31;Navarra;079;Desojo;70;35;35
31;Navarra;080;Dicastillo;571;308;263
31;Navarra;081;Donamaria;452;226;226
31;Navarra;082;Etxalar;814;427;387
31;Navarra;083;Echarri/Etxarri;78;38;40
31;Navarra;084;Etxarri Aranatz;2545;1322;1223
31;Navarra;085;Etxauri;662;342;320
31;Navarra;086;Valle de Egüés/Eguesibar;22443;11163;11280
31;Navarra;087;Elgorriaga;210;105;105
31;Navarra;088;Noáin (Valle de Elorz)/Noain (Elortzibar);8469;4253;4216
31;Navarra;089;Enériz/Eneritz;327;167;160
31;Navarra;090;Eratsun;153;90;63
31;Navarra;091;Ergoiena;382;202;180
31;Navarra;092;Erro;811;447;364
31;Navarra;093;Ezcároz/Ezkaroze;304;177;127
31;Navarra;094;Eslava;106;51;55
31;Navarra;095;Esparza de Salazar/Espartza Zaraitzu;76;38;38
31;Navarra;096;Espronceda;108;56;52
31;Navarra;097;Estella-Lizarra;14329;6933;7396
31;Navarra;098;Esteribar;2877;1490;1387
31;Navarra;099;Etayo;70;37;33
31;Navarra;100;Eulate;271;148;123
31;Navarra;101;Ezcabarte;1870;976;894
31;Navarra;102;Ezkurra;136;94;42
31;Navarra;103;Ezprogui;51;26;25
31;Navarra;104;Falces;2353;1212;1141
31;Navarra;105;Fitero;2222;1125;1097
31;Navarra;106;Fontellas;1022;520;502
31;Navarra;107;Funes;2558;1379;1179
31;Navarra;108;Fustiñana;2451;1225;1226
31;Navarra;109;Galar;2400;1225;1175
31;Navarra;110;Gallipienzo/Galipentzu;98;55;43
31;Navarra;111;Gallués/Galoze;93;60;33
31;Navarra;112;Garaioa;90;53;37
31;Navarra;113;Garde;131;78;53
31;Navarra;114;Garínoain;526;282;244
31;Navarra;115;Garralda;180;90;90
31;Navarra;116;Genevilla;68;44;24
31;Navarra;117;Goizueta;692;368;324
31;Navarra;118;Goñi;172;104;68
31;Navarra;119;Güesa/Gorza;35;20;15
31;Navarra;120;Guesálaz/Gesalatz;433;244;189
31;Navarra;121;Guirguillano;73;39;34
31;Navarra;122;Huarte/Uharte;7737;3854;3883
31;Navarra;123;Uharte Arakil;791;415;376
31;Navarra;124;Ibargoiti;270;152;118
31;Navarra;125;Igúzquiza;302;148;154
31;Navarra;126;Imotz;412;229;183
31;Navarra;127;Irañeta;170;92;78
31;Navarra;128;Isaba/Izaba;385;187;198
31;Navarra;129;Ituren;526;258;268
31;Navarra;130;Iturmendi;432;217;215
31;Navarra;131;Iza/Itza;1380;735;645
31;Navarra;132;Izagaondoa;159;110;49
31;Navarra;133;Izalzu/Itzaltzu;38;22;16
31;Navarra;134;Jaurrieta;180;105;75
31;Navarra;135;Javier;111;28;83
31;Navarra;136;Juslapeña/Txulapain;565;307;258
31;Navarra;137;Beintza-Labaien;217;125;92
31;Navarra;138;Lakuntza;1325;699;626
31;Navarra;139;Lana;157;90;67
31;Navarra;140;Lantz;151;87;64
31;Navarra;141;Lapoblación;126;73;53
31;Navarra;142;Larraga;2133;1119;1014
31;Navarra;143;Larraona;105;52;53
31;Navarra;144;Larraun;901;487;414
31;Navarra;145;Lazagurría;174;90;84
31;Navarra;146;Leache/Leatxe;40;20;20
31;Navarra;147;Legarda;146;80;66
31;Navarra;148;Legaria;119;60;59
31;Navarra;149;Leitza;3011;1547;1464
31;Navarra;150;Leoz/Leotz;210;134;76
31;Navarra;151;Lerga;43;24;19
31;Navarra;152;Lerín;1783;933;850
31;Navarra;153;Lesaka;2716;1372;1344
31;Navarra;154;Lezaun;247;142;105
31;Navarra;155;Liédena;351;183;168
31;Navarra;156;Lizoain-Arriasgoiti/Lizoainibar-Arriasgoiti;288;171;117
31;Navarra;157;Lodosa;4931;2511;2420
31;Navarra;158;Lónguida/Longida;301;163;138
31;Navarra;159;Lumbier;1327;693;634
31;Navarra;160;Luquin;131;68;63
31;Navarra;161;Mañeru;450;236;214
31;Navarra;162;Marañón;50;28;22
31;Navarra;163;Marcilla;2921;1473;1448
31;Navarra;164;Mélida;732;382;350
31;Navarra;165;Mendavia;3535;1769;1766
31;Navarra;166;Mendaza;291;147;144
31;Navarra;167;Mendigorria;1218;640;578
31;Navarra;168;Metauten;262;150;112
31;Navarra;169;Milagro;3639;1855;1784
31;Navarra;170;Mirafuentes;58;28;30
31;Navarra;171;Miranda de Arga;903;481;422
31;Navarra;172;Monreal/Elo;512;276;236
31;Navarra;173;Monteagudo;1085;563;522
31;Navarra;174;Morentin;107;49;58
31;Navarra;175;Mues;76;44;32
31;Navarra;176;Murchante;4239;2139;2100
31;Navarra;177;Murieta;344;175;169
31;Navarra;178;Murillo el Cuende;712;378;334
31;Navarra;179;Murillo el Fruto;664;353;311
31;Navarra;180;Muruzábal;275;133;142
31;Navarra;181;Navascués/Nabaskoze;116;68;48
31;Navarra;182;Nazar;43;24;19
31;Navarra;183;Obanos;910;456;454
31;Navarra;184;Oco;63;35;28
31;Navarra;185;Ochagavía/Otsagabia;488;266;222
31;Navarra;186;Odieta;378;200;178
31;Navarra;187;Oiz;133;70;63
31;Navarra;188;Olaibar;407;229;178
31;Navarra;189;Olazti/Olazagutía;1464;746;718
31;Navarra;190;Olejua;47;28;19
31;Navarra;191;Olite/Erriberri;4087;2072;2015
31;Navarra;192;Olóriz/Oloritz;215;123;92
31;Navarra;193;Cendea de Olza/Oltza Zendea;1842;923;919
31;Navarra;194;Valle de Ollo/Ollaran;436;238;198
31;Navarra;195;Orbaizeta;187;90;97
31;Navarra;196;Orbara;29;15;14
31;Navarra;197;Orísoain;72;43;29
31;Navarra;198;Oronz/Orontze;51;25;26
31;Navarra;199;Oroz-Betelu/Orotz-Betelu;143;83;60
31;Navarra;200;Oteiza;950;499;451
31;Navarra;201;Pamplona/Iruña;207777;98268;109509
31;Navarra;202;Peralta/Azkoien;6003;3053;2950
31;Navarra;203;Petilla de Aragón;26;15;11
31;Navarra;204;Piedramillera;45;29;16
31;Navarra;205;Pitillas;529;258;271
31;Navarra;206;Puente la Reina/Gares;2930;1483;1447
31;Navarra;207;Pueyo/Puiu;361;203;158
31;Navarra;208;Ribaforada;3701;1909;1792
31;Navarra;209;Romanzado/Erromantzatua;191;105;86
31;Navarra;210;Roncal/Erronkari;214;114;100
31;Navarra;211;Orreaga/Roncesvalles;21;11;10
31;Navarra;212;Sada;128;70;58
31;Navarra;213;Saldías;123;66;57
31;Navarra;214;Salinas de Oro/Jaitz;112;58;54
31;Navarra;215;San Adrián;6481;3249;3232
31;Navarra;216;Sangüesa/Zangoza;4862;2465;2397
31;Navarra;217;San Martín de Unx;364;194;170
31;Navarra;219;Sansol;89;45;44
31;Navarra;220;Santacara;858;440;418
31;Navarra;221;Doneztebe/Santesteban;1860;914;946
31;Navarra;222;Sarriés/Sartze;59;43;16
31;Navarra;223;Sartaguda;1325;682;643
31;Navarra;224;Sesma;1247;654;593
31;Navarra;225;Sorlada;43;26;17
31;Navarra;226;Sunbilla;674;349;325
31;Navarra;227;Tafalla;10778;5387;5391
31;Navarra;228;Tiebas-Muruarte de Reta;660;359;301
31;Navarra;229;Tirapu;51;29;22
31;Navarra;230;Torralba del Río;97;51;46
31;Navarra;231;Torres del Río;115;59;56
31;Navarra;232;Tudela;38685;19088;19597
31;Navarra;233;Tulebras;155;72;83
31;Navarra;234;Ucar;190;108;82
31;Navarra;235;Ujué/Uxue;172;94;78
31;Navarra;236;Ultzama;1628;839;789
31;Navarra;237;Unciti;233;143;90
31;Navarra;238;Unzué/Untzue;165;85;80
31;Navarra;239;Urdazubi/Urdax;364;182;182
31;Navarra;240;Urdiain;642;330;312
31;Navarra;241;Urraul Alto;136;90;46
31;Navarra;242;Urraul Bajo;323;142;181
31;Navarra;243;Urroz-Villa;404;210;194
31;Navarra;244;Urroz;173;96;77
31;Navarra;245;Urzainqui/Urzainki;78;46;32
31;Navarra;246;Uterga;171;94;77
31;Navarra;247;Uztárroz/Uztarroze;140;68;72
31;Navarra;248;Luzaide/Valcarlos;309;167;142
31;Navarra;249;Valtierra;2464;1249;1215
31;Navarra;250;Bera;3763;1850;1913
31;Navarra;251;Viana;4413;2248;2165
31;Navarra;252;Vidángoz/Bidankoze;76;43;33
31;Navarra;253;Bidaurreta;170;89;81
31;Navarra;254;Villafranca;3077;1607;1470
31;Navarra;255;Villamayor de Monjardín;113;59;54
31;Navarra;256;Hiriberri/Villanueva de Aezkoa;99;55;44
31;Navarra;257;Villatuerta;1268;632;636
31;Navarra;258;Villava/Atarrabia;10016;4861;5155
31;Navarra;259;Igantzi;591;317;274
31;Navarra;260;Valle de Yerri/Deierri;1566;801;765
31;Navarra;261;Yesa;290;167;123
31;Navarra;262;Zabalza/Zabaltza;297;159;138
31;Navarra;263;Zubieta;290;147;143
31;Navarra;264;Zugarramurdi;227;109;118
31;Navarra;265;Zúñiga;82;48;34
31;Navarra;901;Barañáin/Barañain;19606;9447;10159
31;Navarra;902;Berrioplano/Berriobeiti;7631;3902;3729
31;Navarra;903;Berriozar;11201;5635;5566
31;Navarra;904;Irurtzun;2316;1200;1116
31;Navarra;905;Beriáin;4197;2064;2133
31;Navarra;906;Orkoien;4097;2079;2018
31;Navarra;907;Zizur Mayor/Zizur Nagusia;16124;7881;8243
31;Navarra;908;Lekunberri;1697;868;829
32;Ourense;001;Allariz;6410;3185;3225
32;Ourense;002;Amoeiro;2399;1200;1199
32;Ourense;003;Arnoia, A;970;470;500
32;Ourense;004;Avión;1727;792;935
32;Ourense;005;Baltar;853;459;394
32;Ourense;006;Bande;1473;743;730
32;Ourense;007;Baños de Molgas;1504;761;743
32;Ourense;008;Barbadás;11176;5414;5762
32;Ourense;009;Barco de Valdeorras, O;13300;6455;6845
32;Ourense;010;Beade;366;183;183
32;Ourense;011;Beariz;949;438;511
32;Ourense;012;Blancos, Os;716;385;331
32;Ourense;013;Boborás;2199;1051;1148
32;Ourense;014;Bola, A;1091;525;566
32;Ourense;015;Bolo, O;792;399;393
32;Ourense;016;Calvos de Randín;644;335;309
32;Ourense;017;Carballeda de Valdeorras;1341;690;651
32;Ourense;018;Carballeda de Avia;1194;589;605
32;Ourense;019;Carballiño, O;14075;6539;7536
32;Ourense;020;Cartelle;2500;1226;1274
32;Ourense;021;Castrelo do Val;951;492;459
32;Ourense;022;Castrelo de Miño;1292;662;630
32;Ourense;023;Castro Caldelas;1238;643;595
32;Ourense;024;Celanova;5727;2693;3034
32;Ourense;025;Cenlle;1076;528;548
32;Ourense;026;Coles;3172;1596;1576
32;Ourense;027;Cortegada;1024;513;511
32;Ourense;028;Cualedro;1586;835;751
32;Ourense;029;Chandrexa de Queixa;478;248;230
32;Ourense;030;Entrimo;1079;516;563
32;Ourense;031;Esgos;1102;562;540
32;Ourense;032;Xinzo de Limia;9632;4669;4963
32;Ourense;033;Gomesende;664;337;327
32;Ourense;034;Gudiña, A;1186;618;568
32;Ourense;035;Irixo, O;1357;664;693
32;Ourense;036;Xunqueira de Ambía;1352;667;685
32;Ourense;037;Xunqueira de Espadanedo;673;338;335
32;Ourense;038;Larouco;437;206;231
32;Ourense;039;Laza;1164;608;556
32;Ourense;040;Leiro;1481;721;760
32;Ourense;041;Lobeira;718;358;360
32;Ourense;042;Lobios;1820;898;922
32;Ourense;043;Maceda;2837;1412;1425
32;Ourense;044;Manzaneda;798;388;410
32;Ourense;045;Maside;2742;1375;1367
32;Ourense;046;Melón;1109;535;574
32;Ourense;047;Merca, A;1916;963;953
32;Ourense;048;Mezquita, A;1006;514;492
32;Ourense;049;Montederramo;670;360;310
32;Ourense;050;Monterrei;2397;1215;1182
32;Ourense;051;Muíños;1418;716;702
32;Ourense;052;Nogueira de Ramuín;2048;1039;1009
32;Ourense;053;Oímbra;1711;936;775
32;Ourense;054;Ourense;104891;47538;57353
32;Ourense;055;Paderne de Allariz;1352;677;675
32;Ourense;056;Padrenda;1534;761;773
32;Ourense;057;Parada de Sil;522;282;240
32;Ourense;058;Pereiro de Aguiar, O;6731;3452;3279
32;Ourense;059;Peroxa, A;1761;859;902
32;Ourense;060;Petín;861;437;424
32;Ourense;061;Piñor;1119;576;543
32;Ourense;062;Porqueira;832;392;440
32;Ourense;063;Pobra de Trives, A;1968;966;1002
32;Ourense;064;Pontedeva;458;231;227
32;Ourense;065;Punxín;755;364;391
32;Ourense;066;Quintela de Leirado;594;281;313
32;Ourense;067;Rairiz de Veiga;1179;606;573
32;Ourense;068;Ramirás;1508;710;798
32;Ourense;069;Ribadavia;4936;2417;2519
32;Ourense;070;San Xoán de Río;518;265;253
32;Ourense;071;Riós;1407;729;678
32;Ourense;072;Rúa, A;4223;2107;2116
32;Ourense;073;Rubiá;1390;683;707
32;Ourense;074;San Amaro;1039;514;525
32;Ourense;075;San Cibrao das Viñas;5718;2876;2842
32;Ourense;076;San Cristovo de Cea;1989;990;999
32;Ourense;077;Sandiás;1113;529;584
32;Ourense;078;Sarreaus;1069;531;538
32;Ourense;079;Taboadela;1488;757;731
32;Ourense;080;Teixeira, A;326;177;149
32;Ourense;081;Toén;2333;1178;1155
32;Ourense;082;Trasmiras;1220;611;609
32;Ourense;083;Veiga, A;887;471;416
32;Ourense;084;Verea;955;473;482
32;Ourense;085;Verín;13798;6659;7139
32;Ourense;086;Viana do Bolo;2736;1372;1364
32;Ourense;087;Vilamarín;1854;946;908
32;Ourense;088;Vilamartín de Valdeorras;1822;918;904
32;Ourense;089;Vilar de Barrio;1199;605;594
32;Ourense;090;Vilar de Santos;795;396;399
32;Ourense;091;Vilardevós;1662;882;780
32;Ourense;092;Vilariño de Conso;510;287;223
33;Asturias;001;Allande;1530;766;764
33;Asturias;002;Aller;10012;4934;5078
33;Asturias;003;Amieva;603;335;268
33;Asturias;004;Avilés;75351;35534;39817
33;Asturias;005;Belmonte de Miranda;1394;748;646
33;Asturias;006;Bimenes;1649;809;840
33;Asturias;007;Boal;1380;707;673
33;Asturias;008;Cabrales;1908;962;946
33;Asturias;009;Cabranes;1097;554;543
33;Asturias;010;Candamo;1899;931;968
33;Asturias;011;Cangas del Narcea;11421;5551;5870
33;Asturias;012;Cangas de Onís;6316;3065;3251
33;Asturias;013;Caravia;492;258;234
33;Asturias;014;Carreño;10256;4960;5296
33;Asturias;015;Caso;1427;826;601
33;Asturias;016;Castrillón;22124;10649;11475
33;Asturias;017;Castropol;3252;1584;1668
33;Asturias;018;Coaña;3323;1639;1684
33;Asturias;019;Colunga;3148;1572;1576
33;Asturias;020;Corvera de Asturias;15637;7665;7972
33;Asturias;021;Cudillero;4896;2411;2485
33;Asturias;022;Degaña;780;395;385
33;Asturias;023;Franco, El;3744;1821;1923
33;Asturias;024;Gijón;268561;126299;142262
33;Asturias;025;Gozón;10405;5083;5322
33;Asturias;026;Grado;9688;4689;4999
33;Asturias;027;Grandas de Salime;779;402;377
33;Asturias;028;Ibias;1098;623;475
33;Asturias;029;Illano;289;150;139
33;Asturias;030;Illas;1034;528;506
33;Asturias;031;Langreo;38282;18255;20027
33;Asturias;032;Laviana;12284;5901;6383
33;Asturias;033;Lena;10259;4939;5320
33;Asturias;034;Valdés;10895;5360;5535
33;Asturias;035;Llanera;13938;6878;7060
33;Asturias;036;Llanes;13549;6610;6939
33;Asturias;037;Mieres;36132;17203;18929
33;Asturias;038;Morcín;2537;1280;1257
33;Asturias;039;Muros de Nalón;1942;937;1005
33;Asturias;040;Nava;5203;2552;2651
33;Asturias;041;Navia;8112;3898;4214
33;Asturias;042;Noreña;5102;2450;2652
33;Asturias;043;Onís;732;383;349
33;Asturias;044;Oviedo;220543;102094;118449
33;Asturias;045;Parres;5152;2528;2624
33;Asturias;046;Peñamellera Alta;518;271;247
33;Asturias;047;Peñamellera Baja;1188;593;595
33;Asturias;048;Pesoz;135;71;64
33;Asturias;049;Piloña;6753;3280;3473
33;Asturias;050;Ponga;576;340;236
33;Asturias;051;Pravia;7790;3798;3992
33;Asturias;052;Proaza;675;397;278
33;Asturias;053;Quirós;1160;678;482
33;Asturias;054;Regueras, Las;1875;951;924
33;Asturias;055;Ribadedeva;1693;818;875
33;Asturias;056;Ribadesella;5552;2634;2918
33;Asturias;057;Ribera de Arriba;1852;927;925
33;Asturias;058;Riosa;1712;860;852
33;Asturias;059;Salas;4799;2382;2417
33;Asturias;060;San Martín del Rey Aurelio;15405;7371;8034
33;Asturias;061;San Martín de Oscos;336;164;172
33;Asturias;062;Santa Eulalia de Oscos;425;224;201
33;Asturias;063;San Tirso de Abres;400;187;213
33;Asturias;064;Santo Adriano;289;144;145
33;Asturias;065;Sariego;1265;604;661
33;Asturias;066;Siero;52593;25698;26895
33;Asturias;067;Sobrescobio;845;443;402
33;Asturias;068;Somiedo;1065;625;440
33;Asturias;069;Soto del Barco;3807;1862;1945
33;Asturias;070;Tapia de Casariego;3579;1726;1853
33;Asturias;071;Taramundi;558;274;284
33;Asturias;072;Teverga;1539;839;700
33;Asturias;073;Tineo;8769;4447;4322
33;Asturias;074;Vegadeo;3930;1874;2056
33;Asturias;075;Villanueva de Oscos;248;126;122
33;Asturias;076;Villaviciosa;15342;7589;7753
33;Asturias;077;Villayón;1064;548;516
33;Asturias;078;Yernes y Tameza;136;75;61
34;Palencia;001;Abarca de Campos;38;23;15
34;Palencia;003;Abia de las Torres;170;92;78
34;Palencia;004;Aguilar de Campoo;6823;3304;3519
34;Palencia;005;Alar del Rey;912;462;450
34;Palencia;006;Alba de Cerrato;82;47;35
34;Palencia;009;Amayuelas de Arriba;38;23;15
34;Palencia;010;Ampudia;579;299;280
34;Palencia;011;Amusco;410;234;176
34;Palencia;012;Antigüedad;336;189;147
34;Palencia;015;Arconada;44;26;18
34;Palencia;017;Astudillo;1039;524;515
34;Palencia;018;Autilla del Pino;219;122;97
34;Palencia;019;Autillo de Campos;130;70;60
34;Palencia;020;Ayuela;53;35;18
34;Palencia;022;Baltanás;1228;634;594
34;Palencia;023;Venta de Baños;6331;3196;3135
34;Palencia;024;Baquerín de Campos;22;14;8
34;Palencia;025;Bárcena de Campos;53;27;26
34;Palencia;027;Barruelo de Santullán;1160;580;580
34;Palencia;028;Báscones de Ojeda;134;71;63
34;Palencia;029;Becerril de Campos;757;377;380
34;Palencia;031;Belmonte de Campos;30;16;14
34;Palencia;032;Berzosilla;47;28;19
34;Palencia;033;Boada de Campos;16;12;4
34;Palencia;034;Boadilla del Camino;114;67;47
34;Palencia;035;Boadilla de Rioseco;101;62;39
34;Palencia;036;Brañosera;253;142;111
34;Palencia;037;Buenavista de Valdavia;296;166;130
34;Palencia;038;Bustillo de la Vega;269;151;118
34;Palencia;039;Bustillo del Páramo de Carrión;55;35;20
34;Palencia;041;Calahorra de Boedo;83;39;44
34;Palencia;042;Calzada de los Molinos;305;164;141
34;Palencia;045;Capillas;72;42;30
34;Palencia;046;Cardeñosa de Volpejera;60;35;25
34;Palencia;047;Carrión de los Condes;1999;967;1032
34;Palencia;048;Castil de Vela;55;29;26
34;Palencia;049;Castrejón de la Peña;320;170;150
34;Palencia;050;Castrillo de Don Juan;181;102;79
34;Palencia;051;Castrillo de Onielo;91;50;41
34;Palencia;052;Castrillo de Villavega;168;91;77
34;Palencia;053;Castromocho;197;105;92
34;Palencia;055;Cervatos de la Cueza;241;138;103
34;Palencia;056;Cervera de Pisuerga;2284;1112;1172
34;Palencia;057;Cevico de la Torre;475;240;235
34;Palencia;058;Cevico Navero;178;105;73
34;Palencia;059;Cisneros;430;210;220
34;Palencia;060;Cobos de Cerrato;128;71;57
34;Palencia;061;Collazos de Boedo;99;58;41
34;Palencia;062;Congosto de Valdavia;140;88;52
34;Palencia;063;Cordovilla la Real;129;72;57
34;Palencia;066;Cubillas de Cerrato;64;38;26
34;Palencia;067;Dehesa de Montejo;135;83;52
34;Palencia;068;Dehesa de Romanos;46;29;17
34;Palencia;069;Dueñas;2587;1310;1277
34;Palencia;070;Espinosa de Cerrato;124;71;53
34;Palencia;071;Espinosa de Villagonzalo;154;85;69
34;Palencia;072;Frechilla;136;73;63
34;Palencia;073;Fresno del Río;171;83;88
34;Palencia;074;Frómista;748;376;372
34;Palencia;076;Fuentes de Nava;567;299;268
34;Palencia;077;Fuentes de Valdepero;484;246;238
34;Palencia;079;Grijota;2789;1428;1361
34;Palencia;080;Guardo;5548;2735;2813
34;Palencia;081;Guaza de Campos;55;33;22
34;Palencia;082;Hérmedes de Cerrato;74;38;36
34;Palencia;083;Herrera de Pisuerga;1898;946;952
34;Palencia;084;Herrera de Valdecañas;158;86;72
34;Palencia;086;Hontoria de Cerrato;106;55;51
34;Palencia;087;Hornillos de Cerrato;170;92;78
34;Palencia;088;Husillos;393;215;178
34;Palencia;089;Itero de la Vega;144;84;60
34;Palencia;091;Lagartos;117;63;54
34;Palencia;092;Lantadilla;273;148;125
34;Palencia;093;Vid de Ojeda, La;90;56;34
34;Palencia;094;Ledigos;62;35;27
34;Palencia;096;Lomas;41;26;15
34;Palencia;098;Magaz de Pisuerga;1031;545;486
34;Palencia;099;Manquillos;58;37;21
34;Palencia;100;Mantinos;145;83;62
34;Palencia;101;Marcilla de Campos;58;25;33
34;Palencia;102;Mazariegos;202;118;84
34;Palencia;103;Mazuecos de Valdeginate;79;51;28
34;Palencia;104;Melgar de Yuso;271;159;112
34;Palencia;106;Meneses de Campos;101;60;41
34;Palencia;107;Micieces de Ojeda;71;42;29
34;Palencia;108;Monzón de Campos;583;310;273
34;Palencia;109;Moratinos;59;32;27
34;Palencia;110;Mudá;80;46;34
34;Palencia;112;Nogal de las Huertas;46;26;20
34;Palencia;113;Olea de Boedo;39;15;24
34;Palencia;114;Olmos de Ojeda;170;108;62
34;Palencia;116;Osornillo;59;32;27
34;Palencia;120;Palencia;76738;36141;40597
34;Palencia;121;Palenzuela;215;122;93
34;Palencia;122;Páramo de Boedo;104;63;41
34;Palencia;123;Paredes de Nava;1911;974;937
34;Palencia;124;Payo de Ojeda;57;34;23
34;Palencia;125;Pedraza de Campos;72;41;31
34;Palencia;126;Pedrosa de la Vega;280;157;123
34;Palencia;127;Perales;118;54;64
34;Palencia;129;Pino del Río;163;96;67
34;Palencia;130;Piña de Campos;193;103;90
34;Palencia;131;Población de Arroyo;42;22;20
34;Palencia;132;Población de Campos;122;69;53
34;Palencia;133;Población de Cerrato;98;55;43
34;Palencia;134;Polentinos;40;22;18
34;Palencia;135;Pomar de Valdivia;490;266;224
34;Palencia;136;Poza de la Vega;166;93;73
34;Palencia;137;Pozo de Urama;18;13;5
34;Palencia;139;Prádanos de Ojeda;181;99;82
34;Palencia;140;Puebla de Valdavia, La;81;42;39
34;Palencia;141;Quintana del Puente;251;139;112
34;Palencia;143;Quintanilla de Onsoña;180;101;79
34;Palencia;146;Reinoso de Cerrato;57;35;22
34;Palencia;147;Renedo de la Vega;192;105;87
34;Palencia;149;Requena de Campos;29;15;14
34;Palencia;151;Respenda de la Peña;141;89;52
34;Palencia;152;Revenga de Campos;136;67;69
34;Palencia;154;Revilla de Collazos;75;40;35
34;Palencia;155;Ribas de Campos;153;77;76
34;Palencia;156;Riberos de la Cueza;54;32;22
34;Palencia;157;Saldaña;2869;1466;1403
34;Palencia;158;Salinas de Pisuerga;329;173;156
34;Palencia;159;San Cebrián de Campos;407;234;173
34;Palencia;160;San Cebrián de Mudá;150;81;69
34;Palencia;161;San Cristóbal de Boedo;20;13;7
34;Palencia;163;San Mamés de Campos;49;25;24
34;Palencia;165;San Román de la Cuba;53;32;21
34;Palencia;167;Santa Cecilia del Alcor;92;47;45
34;Palencia;168;Santa Cruz de Boedo;52;28;24
34;Palencia;169;Santervás de la Vega;400;226;174
34;Palencia;170;Santibáñez de Ecla;42;25;17
34;Palencia;171;Santibáñez de la Peña;934;457;477
34;Palencia;174;Santoyo;192;106;86
34;Palencia;175;Serna, La;93;57;36
34;Palencia;176;Sotobañado y Priorato;158;91;67
34;Palencia;177;Soto de Cerrato;176;101;75
34;Palencia;178;Tabanera de Cerrato;138;74;64
34;Palencia;179;Tabanera de Valdavia;22;16;6
34;Palencia;180;Támara de Campos;74;39;35
34;Palencia;181;Tariego de Cerrato;500;260;240
34;Palencia;182;Torquemada;966;531;435
34;Palencia;184;Torremormojón;45;26;19
34;Palencia;185;Triollo;74;44;30
34;Palencia;186;Valbuena de Pisuerga;52;27;25
34;Palencia;189;Valdeolmillos;60;36;24
34;Palencia;190;Valderrábano;47;25;22
34;Palencia;192;Valde-Ucieza;76;48;28
34;Palencia;196;Valle de Cerrato;83;45;38
34;Palencia;199;Velilla del Río Carrión;1129;572;557
34;Palencia;201;Vertavillo;167;88;79
34;Palencia;202;Villabasta de Valdavia;33;20;13
34;Palencia;204;Villacidaler;46;26;20
34;Palencia;205;Villaconancio;50;30;20
34;Palencia;206;Villada;834;423;411
34;Palencia;208;Villaeles de Valdavia;48;31;17
34;Palencia;210;Villahán;99;58;41
34;Palencia;211;Villaherreros;209;107;102
34;Palencia;213;Villalaco;61;35;26
34;Palencia;214;Villalba de Guardo;201;110;91
34;Palencia;215;Villalcázar de Sirga;174;93;81
34;Palencia;216;Villalcón;48;27;21
34;Palencia;217;Villalobón;1900;952;948
34;Palencia;218;Villaluenga de la Vega;519;298;221
34;Palencia;220;Villamartín de Campos;169;95;74
34;Palencia;221;Villamediana;183;110;73
34;Palencia;222;Villameriel;105;59;46
34;Palencia;223;Villamoronta;239;143;96
34;Palencia;224;Villamuera de la Cueza;37;25;12
34;Palencia;225;Villamuriel de Cerrato;6508;3344;3164
34;Palencia;227;Villanueva del Rebollar;67;36;31
34;Palencia;228;Villanuño de Valdavia;93;51;42
34;Palencia;229;Villaprovedo;46;31;15
34;Palencia;230;Villarmentero de Campos;28;16;12
34;Palencia;231;Villarrabé;176;92;84
34;Palencia;232;Villarramiel;788;415;373
34;Palencia;233;Villasarracino;132;81;51
34;Palencia;234;Villasila de Valdavia;60;40;20
34;Palencia;236;Villaturde;147;79;68
34;Palencia;237;Villaumbrales;623;318;305
34;Palencia;238;Villaviudas;366;180;186
34;Palencia;240;Villerías de Campos;76;41;35
34;Palencia;241;Villodre;24;14;10
34;Palencia;242;Villodrigo;96;51;45
34;Palencia;243;Villoldo;339;182;157
34;Palencia;245;Villota del Páramo;299;176;123
34;Palencia;246;Villovieco;62;35;27
34;Palencia;901;Osorno la Mayor;1190;619;571
34;Palencia;902;Valle del Retortillo;168;97;71
34;Palencia;903;Loma de Ucieza;193;120;73
34;Palencia;904;Pernía, La;313;183;130
35;Palmas, Las;001;Agaete;5670;2841;2829
35;Palmas, Las;002;Agüimes;33179;16662;16517
35;Palmas, Las;003;Antigua;13832;7205;6627
35;Palmas, Las;004;Arrecife;68169;34046;34123
35;Palmas, Las;005;Artenara;1029;594;435
35;Palmas, Las;006;Arucas;38936;19256;19680
35;Palmas, Las;007;Betancuria;812;438;374
35;Palmas, Las;008;Firgas;7688;3886;3802
35;Palmas, Las;009;Gáldar;24811;12390;12421
35;Palmas, Las;010;Haría;5567;2848;2719
35;Palmas, Las;011;Ingenio;32747;16523;16224
35;Palmas, Las;012;Mogán;21175;10893;10282
35;Palmas, Las;013;Moya;7987;4057;3930
35;Palmas, Las;014;Oliva, La;29693;15332;14361
35;Palmas, Las;015;Pájara;21614;11158;10456
35;Palmas, Las;016;Palmas de Gran Canaria, Las;380436;183254;197182
35;Palmas, Las;017;Puerto del Rosario;44638;22460;22178
35;Palmas, Las;018;San Bartolomé;19443;9620;9823
35;Palmas, Las;019;San Bartolomé de Tirajana;54116;28268;25848
35;Palmas, Las;020;Aldea de San Nicolás, La;7449;3841;3608
35;Palmas, Las;021;Santa Brígida;18551;9244;9307
35;Palmas, Las;022;Santa Lucía de Tirajana;77098;38298;38800
35;Palmas, Las;023;Santa María de Guía de Gran Canaria;14135;7019;7116
35;Palmas, Las;024;Teguise;23848;11937;11911
35;Palmas, Las;025;Tejeda;1826;1001;825
35;Palmas, Las;026;Telde;102867;50421;52446
35;Palmas, Las;027;Teror;12878;6573;6305
35;Palmas, Las;028;Tías;21462;10952;10510
35;Palmas, Las;029;Tinajo;6865;3502;3363
35;Palmas, Las;030;Tuineje;16454;8445;8009
35;Palmas, Las;031;Valsequillo de Gran Canaria;9768;4917;4851
35;Palmas, Las;032;Valleseco;3741;1965;1776
35;Palmas, Las;033;Vega de San Mateo;7856;4002;3854
35;Palmas, Las;034;Yaiza;18113;9317;8796
36;Pontevedra;001;Arbo;2636;1362;1274
36;Pontevedra;002;Barro;3657;1796;1861
36;Pontevedra;003;Baiona;12380;6063;6317
36;Pontevedra;004;Bueu;11837;5853;5984
36;Pontevedra;005;Caldas de Reis;9614;4651;4963
36;Pontevedra;006;Cambados;13752;6631;7121
36;Pontevedra;007;Campo Lameiro;1697;813;884
36;Pontevedra;008;Cangas;26714;13215;13499
36;Pontevedra;009;Cañiza, A;5046;2460;2586
36;Pontevedra;010;Catoira;3268;1586;1682
36;Pontevedra;013;Covelo;2422;1258;1164
36;Pontevedra;014;Crecente;1938;950;988
36;Pontevedra;015;Cuntis;4515;2146;2369
36;Pontevedra;016;Dozón;985;509;476
36;Pontevedra;017;Estrada, A;20139;9672;10467
36;Pontevedra;018;Forcarei;3127;1492;1635
36;Pontevedra;019;Fornelos de Montes;1637;796;841
36;Pontevedra;020;Agolada;2282;1150;1132
36;Pontevedra;021;Gondomar;15103;7516;7587
36;Pontevedra;022;Grove, O;10821;5315;5506
36;Pontevedra;023;Guarda, A;10041;4907;5134
36;Pontevedra;024;Lalín;20277;9921;10356
36;Pontevedra;025;Lama, A;2515;1260;1255
36;Pontevedra;026;Marín;24154;11902;12252
36;Pontevedra;027;Meaño;5264;2569;2695
36;Pontevedra;028;Meis;4703;2254;2449
36;Pontevedra;029;Moaña;19315;9395;9920
36;Pontevedra;030;Mondariz;4425;2198;2227
36;Pontevedra;031;Mondariz-Balneario;711;358;353
36;Pontevedra;032;Moraña;4110;2008;2102
36;Pontevedra;033;Mos;15152;7443;7709
36;Pontevedra;034;Neves, As;3678;1809;1869
36;Pontevedra;035;Nigrán;18208;8960;9248
36;Pontevedra;036;Oia;3080;1532;1548
36;Pontevedra;037;Pazos de Borbén;3002;1467;1535
36;Pontevedra;038;Pontevedra;83077;39218;43859
36;Pontevedra;039;Porriño, O;20711;10165;10546
36;Pontevedra;040;Portas;2781;1346;1435
36;Pontevedra;041;Poio;17425;8560;8865
36;Pontevedra;042;Ponteareas;23196;11231;11965
36;Pontevedra;043;Ponte Caldelas;5580;2675;2905
36;Pontevedra;044;Pontecesures;3088;1506;1582
36;Pontevedra;045;Redondela;28976;14006;14970
36;Pontevedra;046;Ribadumia;5212;2523;2689
36;Pontevedra;047;Rodeiro;2244;1138;1106
36;Pontevedra;048;Rosal, O;6509;3215;3294
36;Pontevedra;049;Salceda de Caselas;9430;4698;4732
36;Pontevedra;050;Salvaterra de Miño;10471;5251;5220
36;Pontevedra;051;Sanxenxo;17914;8868;9046
36;Pontevedra;052;Silleda;8870;4363;4507
36;Pontevedra;053;Soutomaior;7584;3797;3787
36;Pontevedra;054;Tomiño;13782;6916;6866
36;Pontevedra;055;Tui;17454;8517;8937
36;Pontevedra;056;Valga;5671;2770;2901
36;Pontevedra;057;Vigo;293977;138336;155641
36;Pontevedra;058;Vilaboa;5869;2880;2989
36;Pontevedra;059;Vila de Cruces;5033;2530;2503
36;Pontevedra;060;Vilagarcía de Arousa;37761;18062;19699
36;Pontevedra;061;Vilanova de Arousa;10225;4991;5234
36;Pontevedra;901;Illa de Arousa, A;4849;2399;2450
36;Pontevedra;902;Cerdedo-Cotobade;5705;2783;2922
37;Salamanca;001;Abusejo;143;73;70
37;Salamanca;002;Agallas;132;74;58
37;Salamanca;003;Ahigal de los Aceiteros;88;46;42
37;Salamanca;004;Ahigal de Villarino;31;18;13
37;Salamanca;005;Alameda de Gardón, La;74;38;36
37;Salamanca;006;Alamedilla, La;101;49;52
37;Salamanca;007;Alaraz;448;236;212
37;Salamanca;008;Alba de Tormes;5122;2582;2540
37;Salamanca;009;Alba de Yeltes;200;111;89
37;Salamanca;010;Alberca, La;1045;517;528
37;Salamanca;011;Alberguería de Argañán, La;98;54;44
37;Salamanca;012;Alconada;134;75;59
37;Salamanca;013;Aldeacipreste;91;49;42
37;Salamanca;014;Aldeadávila de la Ribera;1120;568;552
37;Salamanca;015;Aldea del Obispo;252;143;109
37;Salamanca;016;Aldealengua;713;354;359
37;Salamanca;017;Aldeanueva de Figueroa;253;137;116
37;Salamanca;018;Aldeanueva de la Sierra;98;64;34
37;Salamanca;019;Aldearrodrigo;150;83;67
37;Salamanca;020;Aldearrubia;519;277;242
37;Salamanca;021;Aldeaseca de Alba;64;38;26
37;Salamanca;022;Aldeaseca de la Frontera;248;126;122
37;Salamanca;023;Aldeatejada;2587;1316;1271
37;Salamanca;024;Aldeavieja de Tormes;99;53;46
37;Salamanca;025;Aldehuela de la Bóveda;265;144;121
37;Salamanca;026;Aldehuela de Yeltes;181;98;83
37;Salamanca;027;Almenara de Tormes;305;164;141
37;Salamanca;028;Almendra;132;71;61
37;Salamanca;029;Anaya de Alba;183;105;78
37;Salamanca;030;Añover de Tormes;89;48;41
37;Salamanca;031;Arabayona de Mógica;325;185;140
37;Salamanca;032;Arapiles;739;400;339
37;Salamanca;033;Arcediano;96;52;44
37;Salamanca;034;Arco, El;89;44;45
37;Salamanca;035;Armenteros;186;110;76
37;Salamanca;036;San Miguel del Robledo;43;23;20
37;Salamanca;037;Atalaya, La;100;53;47
37;Salamanca;038;Babilafuente;925;484;441
37;Salamanca;039;Bañobárez;280;140;140
37;Salamanca;040;Barbadillo;390;210;180
37;Salamanca;041;Barbalos;73;44;29
37;Salamanca;042;Barceo;48;29;19
37;Salamanca;044;Barruecopardo;421;233;188
37;Salamanca;045;Bastida, La;26;14;12
37;Salamanca;046;Béjar;11957;5664;6293
37;Salamanca;047;Beleña;251;129;122
37;Salamanca;049;Bermellar;131;69;62
37;Salamanca;050;Berrocal de Huebra;75;41;34
37;Salamanca;051;Berrocal de Salvatierra;70;38;32
37;Salamanca;052;Boada;268;137;131
37;Salamanca;054;Bodón, El;245;132;113
37;Salamanca;055;Bogajo;129;71;58
37;Salamanca;056;Bouza, La;49;20;29
37;Salamanca;057;Bóveda del Río Almar;196;103;93
37;Salamanca;058;Brincones;59;32;27
37;Salamanca;059;Buenamadre;109;54;55
37;Salamanca;060;Buenavista;365;191;174
37;Salamanca;061;Cabaco, El;225;116;109
37;Salamanca;062;Cabezabellosa de la Calzada;74;47;27
37;Salamanca;063;Cabeza de Béjar, La;60;40;20
37;Salamanca;065;Cabeza del Caballo;237;126;111
37;Salamanca;067;Cabrerizos;4226;2110;2116
37;Salamanca;068;Cabrillas;322;161;161
37;Salamanca;069;Calvarrasa de Abajo;1201;631;570
37;Salamanca;070;Calvarrasa de Arriba;615;335;280
37;Salamanca;071;Calzada de Béjar, La;85;50;35
37;Salamanca;072;Calzada de Don Diego;131;68;63
37;Salamanca;073;Calzada de Valdunciel;700;351;349
37;Salamanca;074;Campillo de Azaba;142;89;53
37;Salamanca;077;Campo de Peñaranda, El;250;146;104
37;Salamanca;078;Candelario;843;436;407
37;Salamanca;079;Canillas de Abajo;70;48;22
37;Salamanca;080;Cantagallo;279;141;138
37;Salamanca;081;Cantalapiedra;911;448;463
37;Salamanca;082;Cantalpino;804;434;370
37;Salamanca;083;Cantaracillo;190;100;90
37;Salamanca;085;Carbajosa de la Sagrada;7636;3760;3876
37;Salamanca;086;Carpio de Azaba;112;60;52
37;Salamanca;087;Carrascal de Barregas;1439;752;687
37;Salamanca;088;Carrascal del Obispo;187;104;83
37;Salamanca;089;Casafranca;68;34;34
37;Salamanca;090;Casas del Conde, Las;63;30;33
37;Salamanca;091;Casillas de Flores;168;82;86
37;Salamanca;092;Castellanos de Moriscos;3051;1554;1497
37;Salamanca;096;Castillejo de Martín Viejo;205;122;83
37;Salamanca;097;Castraz;34;23;11
37;Salamanca;098;Cepeda;303;155;148
37;Salamanca;099;Cereceda de la Sierra;62;34;28
37;Salamanca;100;Cerezal de Peñahorcada;67;35;32
37;Salamanca;101;Cerralbo;111;62;49
37;Salamanca;102;Cerro, El;365;181;184
37;Salamanca;103;Cespedosa de Tormes;496;271;225
37;Salamanca;104;Cilleros de la Bastida;23;13;10
37;Salamanca;106;Cipérez;225;121;104
37;Salamanca;107;Ciudad Rodrigo;11846;5680;6166
37;Salamanca;108;Coca de Alba;95;50;45
37;Salamanca;109;Colmenar de Montemayor;173;104;69
37;Salamanca;110;Cordovilla;108;60;48
37;Salamanca;112;Cristóbal;162;97;65
37;Salamanca;113;Cubo de Don Sancho, El;377;197;180
37;Salamanca;114;Chagarcía Medianero;73;40;33
37;Salamanca;115;Dios le Guarde;125;68;57
37;Salamanca;116;Doñinos de Ledesma;65;32;33
37;Salamanca;117;Doñinos de Salamanca;2209;1165;1044
37;Salamanca;118;Éjeme;144;82;62
37;Salamanca;119;Encina, La;100;59;41
37;Salamanca;120;Encina de San Silvestre;108;51;57
37;Salamanca;121;Encinas de Abajo;619;320;299
37;Salamanca;122;Encinas de Arriba;226;113;113
37;Salamanca;123;Encinasola de los Comendadores;148;83;65
37;Salamanca;124;Endrinal;204;118;86
37;Salamanca;125;Escurial de la Sierra;244;135;109
37;Salamanca;126;Espadaña;34;20;14
37;Salamanca;127;Espeja;211;115;96
37;Salamanca;128;Espino de la Orbada;245;135;110
37;Salamanca;129;Florida de Liébana;244;135;109
37;Salamanca;130;Forfoleda;204;112;92
37;Salamanca;131;Frades de la Sierra;167;94;73
37;Salamanca;132;Fregeneda, La;308;158;150
37;Salamanca;133;Fresnedoso;98;54;44
37;Salamanca;134;Fresno Alhándiga;181;94;87
37;Salamanca;135;Fuente de San Esteban, La;1279;646;633
37;Salamanca;136;Fuenteguinaldo;652;314;338
37;Salamanca;137;Fuenteliante;84;41;43
37;Salamanca;138;Fuenterroble de Salvatierra;252;134;118
37;Salamanca;139;Fuentes de Béjar;244;126;118
37;Salamanca;140;Fuentes de Oñoro;1009;531;478
37;Salamanca;141;Gajates;140;69;71
37;Salamanca;142;Galindo y Perahuy;704;397;307
37;Salamanca;143;Galinduste;400;195;205
37;Salamanca;144;Galisancho;325;174;151
37;Salamanca;145;Gallegos de Argañán;264;136;128
37;Salamanca;146;Gallegos de Solmirón;109;60;49
37;Salamanca;147;Garcibuey;204;116;88
37;Salamanca;148;Garcihernández;411;212;199
37;Salamanca;149;Garcirrey;55;32;23
37;Salamanca;150;Gejuelo del Barro;31;18;13
37;Salamanca;151;Golpejas;144;77;67
37;Salamanca;152;Gomecello;412;219;193
37;Salamanca;154;Guadramiro;124;76;48
37;Salamanca;155;Guijo de Ávila;78;44;34
37;Salamanca;156;Guijuelo;5508;2793;2715
37;Salamanca;157;Herguijuela de Ciudad Rodrigo;69;42;27
37;Salamanca;158;Herguijuela de la Sierra;226;126;100
37;Salamanca;159;Herguijuela del Campo;62;32;30
37;Salamanca;160;Hinojosa de Duero;577;292;285
37;Salamanca;161;Horcajo de Montemayor;101;56;45
37;Salamanca;162;Horcajo Medianero;205;109;96
37;Salamanca;163;Hoya, La;30;18;12
37;Salamanca;164;Huerta;285;155;130
37;Salamanca;165;Iruelos;31;16;15
37;Salamanca;166;Ituero de Azaba;199;105;94
37;Salamanca;167;Juzbado;183;95;88
37;Salamanca;168;Lagunilla;428;235;193
37;Salamanca;169;Larrodrigo;186;102;84
37;Salamanca;170;Ledesma;1517;760;757
37;Salamanca;171;Ledrada;465;241;224
37;Salamanca;172;Linares de Riofrío;913;503;410
37;Salamanca;173;Lumbrales;1510;776;734
37;Salamanca;174;Macotera;1001;518;483
37;Salamanca;175;Machacón;445;233;212
37;Salamanca;176;Madroñal;135;75;60
37;Salamanca;177;Maíllo, El;282;159;123
37;Salamanca;178;Malpartida;80;41;39
37;Salamanca;179;Mancera de Abajo;197;102;95
37;Salamanca;180;Manzano, El;57;30;27
37;Salamanca;181;Martiago;250;138;112
37;Salamanca;182;Martinamor;82;53;29
37;Salamanca;183;Martín de Yeltes;387;199;188
37;Salamanca;184;Masueco;251;130;121
37;Salamanca;185;Castellanos de Villiquera;703;365;338
37;Salamanca;186;Mata de Ledesma, La;101;55;46
37;Salamanca;187;Matilla de los Caños del Río;613;299;314
37;Salamanca;188;Maya, La;158;89;69
37;Salamanca;189;Membribe de la Sierra;105;64;41
37;Salamanca;190;Mieza;176;92;84
37;Salamanca;191;Milano, El;88;54;34
37;Salamanca;192;Miranda de Azán;447;248;199
37;Salamanca;193;Miranda del Castañar;381;209;172
37;Salamanca;194;Mogarraz;252;128;124
37;Salamanca;195;Molinillo;43;23;20
37;Salamanca;196;Monforte de la Sierra;53;25;28
37;Salamanca;197;Monleón;85;51;34
37;Salamanca;198;Monleras;245;122;123
37;Salamanca;199;Monsagro;127;72;55
37;Salamanca;200;Montejo;198;109;89
37;Salamanca;201;Montemayor del Río;262;148;114
37;Salamanca;202;Monterrubio de Armuña;1331;689;642
37;Salamanca;203;Monterrubio de la Sierra;148;87;61
37;Salamanca;204;Morasverdes;229;119;110
37;Salamanca;205;Morille;224;116;108
37;Salamanca;206;Moríñigo;88;48;40
37;Salamanca;207;Moriscos;566;305;261
37;Salamanca;208;Moronta;76;47;29
37;Salamanca;209;Mozárbez;510;271;239
37;Salamanca;211;Narros de Matalayegua;198;112;86
37;Salamanca;212;Navacarros;133;71;62
37;Salamanca;213;Nava de Béjar;74;43;31
37;Salamanca;214;Nava de Francia;120;63;57
37;Salamanca;215;Nava de Sotrobal;160;93;67
37;Salamanca;216;Navales;311;174;137
37;Salamanca;217;Navalmoral de Béjar;56;28;28
37;Salamanca;218;Navamorales;44;28;16
37;Salamanca;219;Navarredonda de la Rinconada;151;81;70
37;Salamanca;221;Navasfrías;362;195;167
37;Salamanca;222;Negrilla de Palencia;76;44;32
37;Salamanca;223;Olmedo de Camaces;94;55;39
37;Salamanca;224;Orbada, La;182;94;88
37;Salamanca;225;Pajares de la Laguna;114;61;53
37;Salamanca;226;Palacios del Arzobispo;151;81;70
37;Salamanca;228;Palaciosrubios;299;161;138
37;Salamanca;229;Palencia de Negrilla;138;87;51
37;Salamanca;230;Parada de Arriba;272;139;133
37;Salamanca;231;Parada de Rubiales;241;130;111
37;Salamanca;232;Paradinas de San Juan;384;222;162
37;Salamanca;233;Pastores;56;33;23
37;Salamanca;234;Payo, El;313;155;158
37;Salamanca;235;Pedraza de Alba;220;116;104
37;Salamanca;236;Pedrosillo de Alba;124;74;50
37;Salamanca;237;Pedrosillo de los Aires;314;182;132
37;Salamanca;238;Pedrosillo el Ralo;135;70;65
37;Salamanca;239;Pedroso de la Armuña, El;215;116;99
37;Salamanca;240;Pelabravo;1366;743;623
37;Salamanca;241;Pelarrodríguez;159;93;66
37;Salamanca;242;Pelayos;72;41;31
37;Salamanca;243;Peña, La;70;37;33
37;Salamanca;244;Peñacaballera;153;71;82
37;Salamanca;245;Peñaparda;308;157;151
37;Salamanca;246;Peñaranda de Bracamonte;6063;2985;3078
37;Salamanca;247;Peñarandilla;181;100;81
37;Salamanca;248;Peralejos de Abajo;171;91;80
37;Salamanca;249;Peralejos de Arriba;35;23;12
37;Salamanca;250;Pereña de la Ribera;314;168;146
37;Salamanca;251;Peromingo;122;59;63
37;Salamanca;252;Pinedas;94;59;35
37;Salamanca;253;Pino de Tormes, El;149;83;66
37;Salamanca;254;Pitiegua;182;105;77
37;Salamanca;255;Pizarral;64;38;26
37;Salamanca;256;Poveda de las Cintas;194;115;79
37;Salamanca;257;Pozos de Hinojo;52;28;24
37;Salamanca;258;Puebla de Azaba;142;80;62
37;Salamanca;259;Puebla de San Medel;33;18;15
37;Salamanca;260;Puebla de Yeltes;142;74;68
37;Salamanca;261;Puente del Congosto;225;131;94
37;Salamanca;262;Puertas;65;40;25
37;Salamanca;263;Puerto de Béjar;352;171;181
37;Salamanca;264;Puerto Seguro;55;29;26
37;Salamanca;265;Rágama;197;98;99
37;Salamanca;266;Redonda, La;65;38;27
37;Salamanca;267;Retortillo;174;95;79
37;Salamanca;268;Rinconada de la Sierra, La;100;57;43
37;Salamanca;269;Robleda;457;256;201
37;Salamanca;270;Robliza de Cojos;187;105;82
37;Salamanca;271;Rollán;337;192;145
37;Salamanca;272;Saelices el Chico;173;97;76
37;Salamanca;273;Sagrada, La;82;44;38
37;Salamanca;274;Salamanca;144866;65286;79580
37;Salamanca;275;Saldeana;99;58;41
37;Salamanca;276;Salmoral;112;67;45
37;Salamanca;277;Salvatierra de Tormes;72;36;36
37;Salamanca;278;San Cristóbal de la Cuesta;1143;596;547
37;Salamanca;279;Sancti-Spíritus;731;396;335
37;Salamanca;280;Sanchón de la Ribera;67;36;31
37;Salamanca;281;Sanchón de la Sagrada;51;32;19
37;Salamanca;282;Sanchotello;212;106;106
37;Salamanca;283;Sando;113;67;46
37;Salamanca;284;San Esteban de la Sierra;372;214;158
37;Salamanca;285;San Felices de los Gallegos;350;189;161
37;Salamanca;286;San Martín del Castañar;234;126;108
37;Salamanca;287;San Miguel de Valero;303;159;144
37;Salamanca;288;San Morales;366;202;164
37;Salamanca;289;San Muñoz;201;100;101
37;Salamanca;290;San Pedro del Valle;145;82;63
37;Salamanca;291;San Pedro de Rozados;269;151;118
37;Salamanca;292;San Pelayo de Guareña;92;57;35
37;Salamanca;293;Santa María de Sando;95;47;48
37;Salamanca;294;Santa Marta de Tormes;14726;7123;7603
37;Salamanca;296;Santiago de la Puebla;282;146;136
37;Salamanca;297;Santibáñez de Béjar;444;225;219
37;Salamanca;298;Santibáñez de la Sierra;149;86;63
37;Salamanca;299;Santiz;229;128;101
37;Salamanca;300;Santos, Los;580;294;286
37;Salamanca;301;Sardón de los Frailes;101;55;46
37;Salamanca;302;Saucelle;252;128;124
37;Salamanca;303;Sahugo, El;181;97;84
37;Salamanca;304;Sepulcro-Hilario;157;85;72
37;Salamanca;305;Sequeros;207;100;107
37;Salamanca;306;Serradilla del Arroyo;246;130;116
37;Salamanca;307;Serradilla del Llano;138;74;64
37;Salamanca;309;Sierpe, La;42;21;21
37;Salamanca;310;Sieteiglesias de Tormes;164;79;85
37;Salamanca;311;Sobradillo;173;87;86
37;Salamanca;312;Sorihuela;256;138;118
37;Salamanca;313;Sotoserrano;513;268;245
37;Salamanca;314;Tabera de Abajo;99;55;44
37;Salamanca;315;Tala, La;76;42;34
37;Salamanca;316;Tamames;785;396;389
37;Salamanca;317;Tarazona de Guareña;269;150;119
37;Salamanca;318;Tardáguila;197;120;77
37;Salamanca;319;Tejado, El;83;49;34
37;Salamanca;320;Tejeda y Segoyuela;97;52;45
37;Salamanca;321;Tenebrón;121;64;57
37;Salamanca;322;Terradillos;3220;1579;1641
37;Salamanca;323;Topas;511;272;239
37;Salamanca;324;Tordillos;316;170;146
37;Salamanca;325;Tornadizo, El;86;52;34
37;Salamanca;327;Torresmenudas;184;105;79
37;Salamanca;328;Trabanca;160;78;82
37;Salamanca;329;Tremedal de Tormes;35;21;14
37;Salamanca;330;Valdecarros;310;159;151
37;Salamanca;331;Valdefuentes de Sangusín;189;107;82
37;Salamanca;332;Valdehijaderos;84;44;40
37;Salamanca;333;Valdelacasa;189;109;80
37;Salamanca;334;Valdelageve;67;37;30
37;Salamanca;335;Valdelosa;404;204;200
37;Salamanca;336;Valdemierque;59;36;23
37;Salamanca;337;Valderrodrigo;128;67;61
37;Salamanca;338;Valdunciel;110;56;54
37;Salamanca;339;Valero;286;165;121
37;Salamanca;340;Valsalabroso;119;66;53
37;Salamanca;341;Valverde de Valdelacasa;57;29;28
37;Salamanca;342;Valverdón;264;136;128
37;Salamanca;343;Vallejera de Riofrío;72;37;35
37;Salamanca;344;Vecinos;219;105;114
37;Salamanca;345;Vega de Tirados;149;80;69
37;Salamanca;346;Veguillas, Las;275;141;134
37;Salamanca;347;Vellés, La;540;291;249
37;Salamanca;348;Ventosa del Río Almar;99;55;44
37;Salamanca;349;Vídola, La;107;54;53
37;Salamanca;350;Vilvestre;395;197;198
37;Salamanca;351;Villaflores;260;127;133
37;Salamanca;352;Villagonzalo de Tormes;216;130;86
37;Salamanca;353;Villalba de los Llanos;110;62;48
37;Salamanca;354;Villamayor;7669;3826;3843
37;Salamanca;355;Villanueva del Conde;174;92;82
37;Salamanca;356;Villar de Argañán;98;56;42
37;Salamanca;357;Villar de Ciervo;253;138;115
37;Salamanca;358;Villar de Gallimazo;198;128;70
37;Salamanca;359;Villar de la Yegua;155;84;71
37;Salamanca;360;Villar de Peralonso;204;106;98
37;Salamanca;361;Villar de Samaniego;78;44;34
37;Salamanca;362;Villares de la Reina;6723;3309;3414
37;Salamanca;363;Villares de Yeltes;96;46;50
37;Salamanca;364;Villarino de los Aires;739;391;348
37;Salamanca;365;Villarmayor;154;86;68
37;Salamanca;366;Villarmuerto;40;27;13
37;Salamanca;367;Villasbuenas;164;88;76
37;Salamanca;368;Villasdardo;22;7;15
37;Salamanca;369;Villaseco de los Gamitos;137;81;56
37;Salamanca;370;Villaseco de los Reyes;298;179;119
37;Salamanca;371;Villasrubias;236;128;108
37;Salamanca;372;Villaverde de Guareña;138;73;65
37;Salamanca;373;Villavieja de Yeltes;688;369;319
37;Salamanca;374;Villoria;1258;648;610
37;Salamanca;375;Villoruela;731;370;361
37;Salamanca;376;Vitigudino;2361;1139;1222
37;Salamanca;377;Yecla de Yeltes;222;116;106
37;Salamanca;378;Zamarra;71;40;31
37;Salamanca;379;Zamayón;192;115;77
37;Salamanca;380;Zarapicos;49;30;19
37;Salamanca;381;Zarza de Pumareda, La;133;83;50
37;Salamanca;382;Zorita de la Frontera;152;73;79
38;Santa Cruz de Tenerife;001;Adeje;50549;25283;25266
38;Santa Cruz de Tenerife;002;Agulo;1108;559;549
38;Santa Cruz de Tenerife;003;Alajeró;2071;1087;984
38;Santa Cruz de Tenerife;004;Arafo;5776;2901;2875
38;Santa Cruz de Tenerife;005;Arico;9120;4715;4405
38;Santa Cruz de Tenerife;006;Arona;86624;43674;42950
38;Santa Cruz de Tenerife;007;Barlovento;2014;1023;991
38;Santa Cruz de Tenerife;008;Breña Alta;7428;3614;3814
38;Santa Cruz de Tenerife;009;Breña Baja;6112;3083;3029
38;Santa Cruz de Tenerife;010;Buenavista del Norte;4680;2348;2332
38;Santa Cruz de Tenerife;011;Candelaria;28795;13856;14939
38;Santa Cruz de Tenerife;012;Fasnia;3066;1607;1459
38;Santa Cruz de Tenerife;013;Frontera;4528;2272;2256
38;Santa Cruz de Tenerife;014;Fuencaliente de la Palma;1900;952;948
38;Santa Cruz de Tenerife;015;Garachico;4924;2450;2474
38;Santa Cruz de Tenerife;016;Garafía;1983;1036;947
38;Santa Cruz de Tenerife;017;Granadilla de Abona;57143;28424;28719
38;Santa Cruz de Tenerife;018;Guancha, La;5593;2742;2851
38;Santa Cruz de Tenerife;019;Guía de Isora;22642;11244;11398
38;Santa Cruz de Tenerife;020;Güímar;21716;10731;10985
38;Santa Cruz de Tenerife;021;Hermigua;1887;993;894
38;Santa Cruz de Tenerife;022;Icod de los Vinos;24285;11908;12377
38;Santa Cruz de Tenerife;023;San Cristóbal de La Laguna;160258;76999;83259
38;Santa Cruz de Tenerife;024;Llanos de Aridane, Los;20283;9836;10447
38;Santa Cruz de Tenerife;025;Matanza de Acentejo, La;9160;4566;4594
38;Santa Cruz de Tenerife;026;Orotava, La;42585;20805;21780
38;Santa Cruz de Tenerife;027;Paso, El;8156;4057;4099
38;Santa Cruz de Tenerife;028;Puerto de la Cruz;31377;15188;16189
38;Santa Cruz de Tenerife;029;Puntagorda;2355;1204;1151
38;Santa Cruz de Tenerife;030;Puntallana;2699;1356;1343
38;Santa Cruz de Tenerife;031;Realejos, Los;37522;18390;19132
38;Santa Cruz de Tenerife;032;Rosario, El;17983;9100;8883
38;Santa Cruz de Tenerife;033;San Andrés y Sauces;4296;2144;2152
38;Santa Cruz de Tenerife;034;San Juan de la Rambla;4904;2448;2456
38;Santa Cruz de Tenerife;035;San Miguel de Abona;23138;11675;11463
38;Santa Cruz de Tenerife;036;San Sebastián de la Gomera;9562;4772;4790
38;Santa Cruz de Tenerife;037;Santa Cruz de la Palma;15565;7475;8090
38;Santa Cruz de Tenerife;038;Santa Cruz de Tenerife;211359;100527;110832
38;Santa Cruz de Tenerife;039;Santa Úrsula;15386;7594;7792
38;Santa Cruz de Tenerife;040;Santiago del Teide;12373;6118;6255
38;Santa Cruz de Tenerife;041;Sauzal, El;9278;4605;4673
38;Santa Cruz de Tenerife;042;Silos, Los;4705;2361;2344
38;Santa Cruz de Tenerife;043;Tacoronte;24746;12327;12419
38;Santa Cruz de Tenerife;044;Tanque, El;2787;1348;1439
38;Santa Cruz de Tenerife;045;Tazacorte;4559;2342;2217
38;Santa Cruz de Tenerife;046;Tegueste;11405;5609;5796
38;Santa Cruz de Tenerife;047;Tijarafe;2684;1371;1313
38;Santa Cruz de Tenerife;048;Valverde;5268;2622;2646
38;Santa Cruz de Tenerife;049;Valle Gran Rey;4854;2469;2385
38;Santa Cruz de Tenerife;050;Vallehermoso;2954;1529;1425
38;Santa Cruz de Tenerife;051;Victoria de Acentejo, La;9313;4615;4698
38;Santa Cruz de Tenerife;052;Vilaflor de Chasna;1871;948;923
38;Santa Cruz de Tenerife;053;Villa de Mazo;5070;2568;2502
38;Santa Cruz de Tenerife;901;Pinar de El Hierro, El;2010;1058;952
39;Cantabria;001;Alfoz de Lloredo;2499;1290;1209
39;Cantabria;002;Ampuero;4477;2249;2228
39;Cantabria;003;Anievas;267;147;120
39;Cantabria;004;Arenas de Iguña;1756;885;871
39;Cantabria;005;Argoños;1872;940;932
39;Cantabria;006;Arnuero;2279;1137;1142
39;Cantabria;007;Arredondo;477;268;209
39;Cantabria;008;Astillero, El;18467;8985;9482
39;Cantabria;009;Bárcena de Cicero;4741;2440;2301
39;Cantabria;010;Bárcena de Pie de Concha;674;342;332
39;Cantabria;011;Bareyo;2133;1075;1058
39;Cantabria;012;Cabezón de la Sal;8162;3932;4230
39;Cantabria;013;Cabezón de Liébana;540;311;229
39;Cantabria;014;Cabuérniga;998;524;474
39;Cantabria;015;Camaleño;969;540;429
39;Cantabria;016;Camargo;30422;14836;15586
39;Cantabria;017;Campoo de Yuso;673;361;312
39;Cantabria;018;Cartes;5865;2927;2938
39;Cantabria;019;Castañeda;3252;1637;1615
39;Cantabria;020;Castro-Urdiales;33482;16515;16967
39;Cantabria;021;Cieza;546;281;265
39;Cantabria;022;Cillorigo de Liébana;1362;717;645
39;Cantabria;023;Colindres;8540;4171;4369
39;Cantabria;024;Comillas;2146;1020;1126
39;Cantabria;025;Corrales de Buelna, Los;10813;5283;5530
39;Cantabria;026;Corvera de Toranzo;2139;1081;1058
39;Cantabria;027;Campoo de Enmedio;3736;1909;1827
39;Cantabria;028;Entrambasaguas;5646;2838;2808
39;Cantabria;029;Escalante;736;368;368
39;Cantabria;030;Guriezo;2458;1288;1170
39;Cantabria;031;Hazas de Cesto;1867;915;952
39;Cantabria;032;Hermandad de Campoo de Suso;1616;897;719
39;Cantabria;033;Herrerías;581;326;255
39;Cantabria;034;Lamasón;246;155;91
39;Cantabria;035;Laredo;10752;5116;5636
39;Cantabria;036;Liendo;1226;642;584
39;Cantabria;037;Liérganes;2390;1193;1197
39;Cantabria;038;Limpias;1991;999;992
39;Cantabria;039;Luena;608;330;278
39;Cantabria;040;Marina de Cudeyo;5190;2590;2600
39;Cantabria;041;Mazcuerras;2093;1084;1009
39;Cantabria;042;Medio Cudeyo;7686;3705;3981
39;Cantabria;043;Meruelo;2311;1148;1163
39;Cantabria;044;Miengo;5221;2682;2539
39;Cantabria;045;Miera;398;211;187
39;Cantabria;046;Molledo;1480;730;750
39;Cantabria;047;Noja;2700;1367;1333
39;Cantabria;048;Penagos;2254;1137;1117
39;Cantabria;049;Peñarrubia;314;161;153
39;Cantabria;050;Pesaguero;276;154;122
39;Cantabria;051;Pesquera;70;44;26
39;Cantabria;052;Piélagos;26783;13296;13487
39;Cantabria;053;Polaciones;202;127;75
39;Cantabria;054;Polanco;6239;3110;3129
39;Cantabria;055;Potes;1353;639;714
39;Cantabria;056;Puente Viesgo;2881;1467;1414
39;Cantabria;057;Ramales de la Victoria;3061;1525;1536
39;Cantabria;058;Rasines;970;507;463
39;Cantabria;059;Reinosa;8566;4009;4557
39;Cantabria;060;Reocín;8400;4154;4246
39;Cantabria;061;Ribamontán al Mar;4615;2352;2263
39;Cantabria;062;Ribamontán al Monte;2538;1281;1257
39;Cantabria;063;Rionansa;1002;563;439
39;Cantabria;064;Riotuerto;1675;804;871
39;Cantabria;065;Rozas de Valdearroyo, Las;261;140;121
39;Cantabria;066;Ruente;1072;580;492
39;Cantabria;067;Ruesga;829;447;382
39;Cantabria;068;Ruiloba;760;388;372
39;Cantabria;069;San Felices de Buelna;2376;1190;1186
39;Cantabria;070;San Miguel de Aguayo;168;85;83
39;Cantabria;071;San Pedro del Romeral;432;238;194
39;Cantabria;072;San Roque de Riomiera;342;204;138
39;Cantabria;073;Santa Cruz de Bezana;13832;6784;7048
39;Cantabria;074;Santa María de Cayón;9367;4675;4692
39;Cantabria;075;Santander;174101;80127;93974
39;Cantabria;076;Santillana del Mar;4211;2056;2155
39;Cantabria;077;Santiurde de Reinosa;256;147;109
39;Cantabria;078;Santiurde de Toranzo;1739;924;815
39;Cantabria;079;Santoña;10916;5322;5594
39;Cantabria;080;San Vicente de la Barquera;3992;1940;2052
39;Cantabria;081;Saro;508;267;241
39;Cantabria;082;Selaya;1846;932;914
39;Cantabria;083;Soba;1076;611;465
39;Cantabria;084;Solórzano;1115;591;524
39;Cantabria;085;Suances;9092;4430;4662
39;Cantabria;086;Tojos, Los;375;230;145
39;Cantabria;087;Torrelavega;51663;24351;27312
39;Cantabria;088;Tresviso;53;35;18
39;Cantabria;089;Tudanca;157;108;49
39;Cantabria;090;Udías;946;480;466
39;Cantabria;091;Valdáliga;2152;1112;1040
39;Cantabria;092;Valdeolea;884;484;400
39;Cantabria;093;Valdeprado del Río;320;184;136
39;Cantabria;094;Valderredible;931;531;400
39;Cantabria;095;Val de San Vicente;2796;1440;1356
39;Cantabria;096;Vega de Liébana;690;367;323
39;Cantabria;097;Vega de Pas;768;411;357
39;Cantabria;098;Villacarriedo;1685;873;812
39;Cantabria;099;Villaescusa;3953;1973;1980
39;Cantabria;100;Villafufre;1020;529;491
39;Cantabria;101;Valle de Villaverde;252;145;107
39;Cantabria;102;Voto;2945;1540;1405
40;Segovia;001;Abades;859;422;437
40;Segovia;002;Adrada de Pirón;40;22;18
40;Segovia;003;Adrados;123;75;48
40;Segovia;004;Aguilafuente;564;285;279
40;Segovia;005;Alconada de Maderuelo;26;15;11
40;Segovia;006;Aldealcorvo;18;10;8
40;Segovia;007;Aldealengua de Pedraza;79;48;31
40;Segovia;008;Aldealengua de Santa María;59;29;30
40;Segovia;009;Aldeanueva de la Serrezuela;42;29;13
40;Segovia;010;Aldeanueva del Codonal;108;59;49
40;Segovia;012;Aldea Real;287;152;135
40;Segovia;013;Aldeasoña;67;38;29
40;Segovia;014;Aldehorno;59;34;25
40;Segovia;015;Aldehuela del Codonal;24;12;12
40;Segovia;016;Aldeonte;55;32;23
40;Segovia;017;Anaya;119;59;60
40;Segovia;018;Añe;66;40;26
40;Segovia;019;Arahuetes;31;21;10
40;Segovia;020;Arcones;180;92;88
40;Segovia;021;Arevalillo de Cega;18;11;7
40;Segovia;022;Armuña;241;137;104
40;Segovia;024;Ayllón;1105;577;528
40;Segovia;025;Barbolla;150;87;63
40;Segovia;026;Basardilla;136;65;71
40;Segovia;028;Bercial;105;55;50
40;Segovia;029;Bercimuel;36;21;15
40;Segovia;030;Bernardos;463;260;203
40;Segovia;031;Bernuy de Porreros;1247;650;597
40;Segovia;032;Boceguillas;721;367;354
40;Segovia;033;Brieva;86;50;36
40;Segovia;034;Caballar;75;44;31
40;Segovia;035;Cabañas de Polendos;199;103;96
40;Segovia;036;Cabezuela;656;350;306
40;Segovia;037;Calabazas de Fuentidueña;25;17;8
40;Segovia;039;Campo de San Pedro;259;144;115
40;Segovia;040;Cantalejo;3558;1785;1773
40;Segovia;041;Cantimpalos;1427;756;671
40;Segovia;043;Carbonero el Mayor;2502;1286;1216
40;Segovia;044;Carrascal del Río;136;77;59
40;Segovia;045;Casla;155;81;74
40;Segovia;046;Castillejo de Mesleón;110;62;48
40;Segovia;047;Castro de Fuentidueña;48;30;18
40;Segovia;048;Castrojimeno;31;16;15
40;Segovia;049;Castroserna de Abajo;32;19;13
40;Segovia;051;Castroserracín;24;14;10
40;Segovia;052;Cedillo de la Torre;81;45;36
40;Segovia;053;Cerezo de Abajo;145;83;62
40;Segovia;054;Cerezo de Arriba;134;71;63
40;Segovia;055;Cilleruelo de San Mamés;35;21;14
40;Segovia;056;Cobos de Fuentidueña;28;13;15
40;Segovia;057;Coca;1703;857;846
40;Segovia;058;Codorniz;307;160;147
40;Segovia;059;Collado Hermoso;118;64;54
40;Segovia;060;Condado de Castilnovo;79;42;37
40;Segovia;061;Corral de Ayllón;77;45;32
40;Segovia;062;Cubillo;73;45;28
40;Segovia;063;Cuéllar;9530;4801;4729
40;Segovia;065;Chañe;741;370;371
40;Segovia;068;Domingo García;32;19;13
40;Segovia;069;Donhierro;75;40;35
40;Segovia;070;Duruelo;171;106;65
40;Segovia;071;Encinas;40;20;20
40;Segovia;072;Encinillas;352;187;165
40;Segovia;073;Escalona del Prado;468;250;218
40;Segovia;074;Escarabajosa de Cabezas;276;149;127
40;Segovia;075;Escobar de Polendos;166;93;73
40;Segovia;076;Espinar, El;10145;5103;5042
40;Segovia;077;Espirdo;1607;836;771
40;Segovia;078;Fresneda de Cuéllar;170;99;71
40;Segovia;079;Fresno de Cantespino;288;160;128
40;Segovia;080;Fresno de la Fuente;77;45;32
40;Segovia;081;Frumales;120;68;52
40;Segovia;082;Fuente de Santa Cruz;99;55;44
40;Segovia;083;Fuente el Olmo de Fuentidueña;395;89;306
40;Segovia;084;Fuente el Olmo de Íscar;45;27;18
40;Segovia;086;Fuentepelayo;772;393;379
40;Segovia;087;Fuentepiñel;68;40;28
40;Segovia;088;Fuenterrebollo;339;179;160
40;Segovia;089;Fuentesaúco de Fuentidueña;223;122;101
40;Segovia;091;Fuentesoto;100;60;40
40;Segovia;092;Fuentidueña;133;77;56
40;Segovia;093;Gallegos;93;51;42
40;Segovia;094;Garcillán;515;275;240
40;Segovia;095;Gomezserracín;625;322;303
40;Segovia;097;Grajera;256;144;112
40;Segovia;099;Honrubia de la Cuesta;49;29;20
40;Segovia;100;Hontalbilla;299;168;131
40;Segovia;101;Hontanares de Eresma;1662;854;808
40;Segovia;103;Huertos, Los;170;90;80
40;Segovia;104;Ituero y Lama;448;235;213
40;Segovia;105;Juarros de Riomoros;45;28;17
40;Segovia;106;Juarros de Voltoya;184;94;90
40;Segovia;107;Labajos;106;59;47
40;Segovia;108;Laguna de Contreras;115;68;47
40;Segovia;109;Languilla;84;50;34
40;Segovia;110;Lastras de Cuéllar;307;169;138
40;Segovia;111;Lastras del Pozo;64;33;31
40;Segovia;112;Lastrilla, La;4697;2356;2341
40;Segovia;113;Losa, La;531;290;241
40;Segovia;115;Maderuelo;101;58;43
40;Segovia;118;Marazuela;53;32;21
40;Segovia;119;Martín Miguel;263;156;107
40;Segovia;120;Martín Muñoz de la Dehesa;307;163;144
40;Segovia;121;Martín Muñoz de las Posadas;249;142;107
40;Segovia;122;Marugán;763;408;355
40;Segovia;123;Matabuena;207;113;94
40;Segovia;124;Mata de Cuéllar;263;139;124
40;Segovia;125;Matilla, La;71;43;28
40;Segovia;126;Melque de Cercos;65;39;26
40;Segovia;127;Membibre de la Hoz;43;24;19
40;Segovia;128;Migueláñez;138;74;64
40;Segovia;129;Montejo de Arévalo;161;90;71
40;Segovia;130;Montejo de la Vega de la Serrezuela;124;76;48
40;Segovia;131;Monterrubio;56;30;26
40;Segovia;132;Moral de Hornuez;40;25;15
40;Segovia;134;Mozoncillo;907;500;407
40;Segovia;135;Muñopedro;309;160;149
40;Segovia;136;Muñoveros;145;72;73
40;Segovia;138;Nava de la Asunción;2787;1417;1370
40;Segovia;139;Navafría;279;151;128
40;Segovia;140;Navalilla;97;50;47
40;Segovia;141;Navalmanzano;1044;557;487
40;Segovia;142;Navares de Ayuso;53;29;24
40;Segovia;143;Navares de Enmedio;92;50;42
40;Segovia;144;Navares de las Cuevas;25;15;10
40;Segovia;145;Navas de Oro;1274;658;616
40;Segovia;146;Navas de San Antonio;366;203;163
40;Segovia;148;Nieva;256;129;127
40;Segovia;149;Olombrada;503;274;229
40;Segovia;150;Orejana;62;35;27
40;Segovia;151;Ortigosa de Pestaño;53;27;26
40;Segovia;152;Otero de Herreros;966;500;466
40;Segovia;154;Pajarejos;24;14;10
40;Segovia;155;Palazuelos de Eresma;5968;3098;2870
40;Segovia;156;Pedraza;349;199;150
40;Segovia;157;Pelayos del Arroyo;48;27;21
40;Segovia;158;Perosillo;20;12;8
40;Segovia;159;Pinarejos;194;110;84
40;Segovia;160;Pinarnegrillo;96;55;41
40;Segovia;161;Carabias;54;38;16
40;Segovia;162;Prádena;468;248;220
40;Segovia;163;Puebla de Pedraza;51;29;22
40;Segovia;164;Rapariegos;194;109;85
40;Segovia;165;Rebollo;74;37;37
40;Segovia;166;Remondo;316;154;162
40;Segovia;168;Riaguas de San Bartolomé;27;16;11
40;Segovia;170;Riaza;2144;1142;1002
40;Segovia;171;Ribota;43;30;13
40;Segovia;172;Riofrío de Riaza;27;17;10
40;Segovia;173;Roda de Eresma;253;136;117
40;Segovia;174;Sacramenia;330;165;165
40;Segovia;176;Samboal;461;248;213
40;Segovia;177;San Cristóbal de Cuéllar;154;88;66
40;Segovia;178;San Cristóbal de la Vega;83;44;39
40;Segovia;179;Sanchonuño;1027;511;516
40;Segovia;180;Sangarcía;279;150;129
40;Segovia;181;Real Sitio de San Ildefonso;5205;2549;2656
40;Segovia;182;San Martín y Mudrián;251;120;131
40;Segovia;183;San Miguel de Bernuy;134;63;71
40;Segovia;184;San Pedro de Gaíllos;311;158;153
40;Segovia;185;Santa María la Real de Nieva;885;497;388
40;Segovia;186;Santa Marta del Cerro;49;26;23
40;Segovia;188;Santiuste de Pedraza;85;54;31
40;Segovia;189;Santiuste de San Juan Bautista;535;291;244
40;Segovia;190;Santo Domingo de Pirón;51;28;23
40;Segovia;191;Santo Tomé del Puerto;234;133;101
40;Segovia;192;Sauquillo de Cabezas;137;78;59
40;Segovia;193;Sebúlcor;241;130;111
40;Segovia;194;Segovia;51525;24105;27420
40;Segovia;195;Sepúlveda;988;491;497
40;Segovia;196;Sequera de Fresno;47;29;18
40;Segovia;198;Sotillo;30;16;14
40;Segovia;199;Sotosalbos;135;76;59
40;Segovia;200;Tabanera la Luenga;53;27;26
40;Segovia;201;Tolocirio;36;15;21
40;Segovia;202;Torreadrada;50;26;24
40;Segovia;203;Torrecaballeros;1496;768;728
40;Segovia;204;Torrecilla del Pinar;179;100;79
40;Segovia;205;Torreiglesias;256;128;128
40;Segovia;206;Torre Val de San Pedro;180;100;80
40;Segovia;207;Trescasas;1105;574;531
40;Segovia;208;Turégano;1017;519;498
40;Segovia;210;Urueñas;98;67;31
40;Segovia;211;Valdeprados;60;32;28
40;Segovia;212;Valdevacas de Montejo;29;16;13
40;Segovia;213;Valdevacas y Guijar;80;43;37
40;Segovia;214;Valseca;218;119;99
40;Segovia;215;Valtiendas;77;48;29
40;Segovia;216;Valverde del Majano;1126;561;565
40;Segovia;218;Valle de Tabladillo;74;46;28
40;Segovia;219;Vallelado;728;379;349
40;Segovia;220;Valleruela de Pedraza;65;31;34
40;Segovia;221;Valleruela de Sepúlveda;52;24;28
40;Segovia;222;Veganzones;197;104;93
40;Segovia;223;Vegas de Matute;339;202;137
40;Segovia;224;Ventosilla y Tejadilla;17;12;5
40;Segovia;225;Villacastín;1525;780;745
40;Segovia;228;Villaverde de Íscar;593;306;287
40;Segovia;229;Villaverde de Montejo;21;13;8
40;Segovia;230;Villeguillo;120;63;57
40;Segovia;231;Yanguas de Eresma;117;65;52
40;Segovia;233;Zarzuela del Monte;498;255;243
40;Segovia;234;Zarzuela del Pinar;408;213;195
40;Segovia;901;Ortigosa del Monte;587;293;294
40;Segovia;902;Cozuelos de Fuentidueña;105;57;48
40;Segovia;903;Marazoleja;96;64;32
40;Segovia;904;Navas de Riofrío;439;205;234
40;Segovia;905;Cuevas de Provanco;132;75;57
40;Segovia;906;San Cristóbal de Segovia;3153;1593;1560
41;Sevilla;001;Aguadulce;2042;1009;1033
41;Sevilla;002;Alanís;1673;826;847
41;Sevilla;003;Albaida del Aljarafe;3223;1579;1644
41;Sevilla;004;Alcalá de Guadaíra;76922;38146;38776
41;Sevilla;005;Alcalá del Río;12250;6207;6043
41;Sevilla;006;Alcolea del Río;3279;1640;1639
41;Sevilla;007;Algaba, La;16666;8198;8468
41;Sevilla;008;Algámitas;1241;650;591
41;Sevilla;009;Almadén de la Plata;1328;689;639
41;Sevilla;010;Almensilla;6653;3309;3344
41;Sevilla;011;Arahal;19417;9628;9789
41;Sevilla;012;Aznalcázar;4886;2477;2409
41;Sevilla;013;Aznalcóllar;6079;3082;2997
41;Sevilla;014;Badolatosa;3078;1583;1495
41;Sevilla;015;Benacazón;7358;3684;3674
41;Sevilla;016;Bollullos de la Mitación;11251;5607;5644
41;Sevilla;017;Bormujos;22970;11353;11617
41;Sevilla;018;Brenes;12883;6403;6480
41;Sevilla;019;Burguillos;7327;3701;3626
41;Sevilla;020;Cabezas de San Juan, Las;16410;8144;8266
41;Sevilla;021;Camas;28705;14129;14576
41;Sevilla;022;Campana, La;5132;2562;2570
41;Sevilla;023;Cantillana;10728;5394;5334
41;Sevilla;024;Carmona;29871;15106;14765
41;Sevilla;025;Carrión de los Céspedes;2617;1274;1343
41;Sevilla;026;Casariche;5307;2715;2592
41;Sevilla;027;Castilblanco de los Arroyos;5134;2594;2540
41;Sevilla;028;Castilleja de Guzmán;2863;1477;1386
41;Sevilla;029;Castilleja de la Cuesta;17153;8292;8861
41;Sevilla;030;Castilleja del Campo;612;304;308
41;Sevilla;031;Castillo de las Guardas, El;1511;795;716
41;Sevilla;032;Cazalla de la Sierra;4629;2288;2341
41;Sevilla;033;Constantina;5742;2855;2887
41;Sevilla;034;Coria del Río;31095;15344;15751
41;Sevilla;035;Coripe;1198;588;610
41;Sevilla;036;Coronil, El;4697;2371;2326
41;Sevilla;037;Corrales, Los;3970;2012;1958
41;Sevilla;038;Dos Hermanas;140430;68745;71685
41;Sevilla;039;Écija;39500;19421;20079
41;Sevilla;040;Espartinas;16482;8235;8247
41;Sevilla;041;Estepa;12394;6117;6277
41;Sevilla;042;Fuentes de Andalucía;7247;3594;3653
41;Sevilla;043;Garrobo, El;812;417;395
41;Sevilla;044;Gelves;10473;5168;5305
41;Sevilla;045;Gerena;7923;3921;4002
41;Sevilla;046;Gilena;3658;1852;1806
41;Sevilla;047;Gines;13524;6609;6915
41;Sevilla;048;Guadalcanal;2522;1263;1259
41;Sevilla;049;Guillena;14064;7129;6935
41;Sevilla;050;Herrera;6566;3265;3301
41;Sevilla;051;Huévar del Aljarafe;3360;1726;1634
41;Sevilla;052;Lantejuela;3861;1981;1880
41;Sevilla;053;Lebrija;27745;13812;13933
41;Sevilla;054;Lora de Estepa;888;468;420
41;Sevilla;055;Lora del Río;18189;8934;9255
41;Sevilla;056;Luisiana, La;4626;2313;2313
41;Sevilla;057;Madroño, El;305;153;152
41;Sevilla;058;Mairena del Alcor;24238;12109;12129
41;Sevilla;059;Mairena del Aljarafe;47898;23210;24688
41;Sevilla;060;Marchena;19382;9563;9819
41;Sevilla;061;Marinaleda;2555;1291;1264
41;Sevilla;062;Martín de la Jara;2643;1362;1281
41;Sevilla;063;Molares, Los;3636;1856;1780
41;Sevilla;064;Montellano;7031;3509;3522
41;Sevilla;065;Morón de la Frontera;27228;13380;13848
41;Sevilla;066;Navas de la Concepción, Las;1520;753;767
41;Sevilla;067;Olivares;9504;4770;4734
41;Sevilla;068;Osuna;17374;8611;8763
41;Sevilla;069;Palacios y Villafranca, Los;38757;19269;19488
41;Sevilla;070;Palomares del Río;9277;4635;4642
41;Sevilla;071;Paradas;6779;3388;3391
41;Sevilla;072;Pedrera;5085;2507;2578
41;Sevilla;073;Pedroso, El;2074;1036;1038
41;Sevilla;074;Peñaflor;3670;1845;1825
41;Sevilla;075;Pilas;14105;7049;7056
41;Sevilla;076;Pruna;2509;1277;1232
41;Sevilla;077;Puebla de Cazalla, La;10799;5383;5416
41;Sevilla;078;Puebla de los Infantes, La;2927;1425;1502
41;Sevilla;079;Puebla del Río, La;11871;5831;6040
41;Sevilla;080;Real de la Jara, El;1531;762;769
41;Sevilla;081;Rinconada, La;40529;20145;20384
41;Sevilla;082;Roda de Andalucía, La;4180;2064;2116
41;Sevilla;083;Ronquillo, El;1439;732;707
41;Sevilla;084;Rubio, El;3290;1645;1645
41;Sevilla;085;Salteras;5580;2717;2863
41;Sevilla;086;San Juan de Aznalfarache;23090;11127;11963
41;Sevilla;087;Sanlúcar la Mayor;14375;7063;7312
41;Sevilla;088;San Nicolás del Puerto;600;308;292
41;Sevilla;089;Santiponce;8625;4235;4390
41;Sevilla;090;Saucejo, El;4213;2089;2124
41;Sevilla;091;Sevilla;687488;325795;361693
41;Sevilla;092;Tocina;9373;4630;4743
41;Sevilla;093;Tomares;25488;12533;12955
41;Sevilla;094;Umbrete;9394;4658;4736
41;Sevilla;095;Utrera;52173;25731;26442
41;Sevilla;096;Valencina de la Concepción;8080;3950;4130
41;Sevilla;097;Villamanrique de la Condesa;4677;2287;2390
41;Sevilla;098;Villanueva del Ariscal;6938;3358;3580
41;Sevilla;099;Villanueva del Río y Minas;5033;2559;2474
41;Sevilla;100;Villanueva de San Juan;1002;505;497
41;Sevilla;101;Villaverde del Río;7794;3934;3860
41;Sevilla;102;Viso del Alcor, El;19310;9572;9738
41;Sevilla;901;Cañada Rosal;3410;1684;1726
41;Sevilla;902;Isla Mayor;5781;2881;2900
41;Sevilla;903;Cuervo de Sevilla, El;8716;4394;4322
41;Sevilla;904;Palmar de Troya, El;2306;1146;1160
42;Soria;001;Abejar;386;199;187
42;Soria;003;Adradas;58;33;25
42;Soria;004;Ágreda;3094;1594;1500
42;Soria;006;Alconaba;199;132;67
42;Soria;007;Alcubilla de Avellaneda;107;63;44
42;Soria;008;Alcubilla de las Peñas;59;38;21
42;Soria;009;Aldealafuente;83;45;38
42;Soria;010;Aldealices;20;14;6
42;Soria;011;Aldealpozo;18;7;11
42;Soria;012;Aldealseñor;28;15;13
42;Soria;013;Aldehuela de Periáñez;30;19;11
42;Soria;014;Aldehuelas, Las;60;36;24
42;Soria;015;Alentisque;24;16;8
42;Soria;016;Aliud;21;14;7
42;Soria;017;Almajano;182;98;84
42;Soria;018;Almaluez;124;74;50
42;Soria;019;Almarza;626;347;279
42;Soria;020;Almazán;5476;2811;2665
42;Soria;021;Almazul;60;41;19
42;Soria;022;Almenar de Soria;216;134;82
42;Soria;023;Alpanseque;51;32;19
42;Soria;024;Arancón;76;51;25
42;Soria;025;Arcos de Jalón;1545;787;758
42;Soria;026;Arenillas;42;27;15
42;Soria;027;Arévalo de la Sierra;70;44;26
42;Soria;028;Ausejo de la Sierra;115;60;55
42;Soria;029;Baraona;122;73;49
42;Soria;030;Barca;107;67;40
42;Soria;031;Barcones;25;15;10
42;Soria;032;Bayubas de Abajo;144;75;69
42;Soria;033;Bayubas de Arriba;60;35;25
42;Soria;034;Beratón;41;20;21
42;Soria;035;Berlanga de Duero;831;432;399
42;Soria;036;Blacos;38;18;20
42;Soria;037;Bliecos;26;16;10
42;Soria;038;Borjabad;30;17;13
42;Soria;039;Borobia;228;129;99
42;Soria;041;Buberos;28;14;14
42;Soria;042;Buitrago;74;39;35
42;Soria;043;Burgo de Osma-Ciudad de Osma;5204;2604;2600
42;Soria;044;Cabrejas del Campo;53;31;22
42;Soria;045;Cabrejas del Pinar;299;172;127
42;Soria;046;Calatañazor;43;25;18
42;Soria;048;Caltojar;51;35;16
42;Soria;049;Candilichera;104;66;38
42;Soria;050;Cañamaque;27;20;7
42;Soria;051;Carabantes;22;14;8
42;Soria;052;Caracena;14;9;5
42;Soria;053;Carrascosa de Abajo;18;12;6
42;Soria;054;Carrascosa de la Sierra;19;14;5
42;Soria;055;Casarejos;146;77;69
42;Soria;056;Castilfrío de la Sierra;34;20;14
42;Soria;057;Castilruiz;158;90;68
42;Soria;058;Castillejo de Robledo;95;56;39
42;Soria;059;Centenera de Andaluz;21;10;11
42;Soria;060;Cerbón;30;21;9
42;Soria;061;Cidones;314;188;126
42;Soria;062;Cigudosa;15;12;3
42;Soria;063;Cihuela;39;26;13
42;Soria;064;Ciria;70;38;32
42;Soria;065;Cirujales del Río;20;15;5
42;Soria;068;Coscurita;68;43;25
42;Soria;069;Covaleda;1574;816;758
42;Soria;070;Cubilla;24;14;10
42;Soria;071;Cubo de la Solana;163;95;68
42;Soria;073;Cueva de Ágreda;69;43;26
42;Soria;075;Dévanos;72;43;29
42;Soria;076;Deza;165;94;71
42;Soria;078;Duruelo de la Sierra;1026;522;504
42;Soria;079;Escobosa de Almazán;20;12;8
42;Soria;080;Espeja de San Marcelino;151;89;62
42;Soria;081;Espejón;128;67;61
42;Soria;082;Estepa de San Juan;13;8;5
42;Soria;083;Frechilla de Almazán;21;11;10
42;Soria;084;Fresno de Caracena;19;12;7
42;Soria;085;Fuentearmegil;150;88;62
42;Soria;086;Fuentecambrón;32;19;13
42;Soria;087;Fuentecantos;65;33;32
42;Soria;088;Fuentelmonge;61;36;25
42;Soria;089;Fuentelsaz de Soria;64;31;33
42;Soria;090;Fuentepinilla;78;47;31
42;Soria;092;Fuentes de Magaña;51;32;19
42;Soria;093;Fuentestrún;52;36;16
42;Soria;094;Garray;785;420;365
42;Soria;095;Golmayo;3059;1589;1470
42;Soria;096;Gómara;288;168;120
42;Soria;097;Gormaz;26;19;7
42;Soria;098;Herrera de Soria;11;8;3
42;Soria;100;Hinojosa del Campo;25;17;8
42;Soria;103;Langa de Duero;716;385;331
42;Soria;105;Liceras;49;26;23
42;Soria;106;Losilla, La;13;9;4
42;Soria;107;Magaña;64;41;23
42;Soria;108;Maján;9;6;3
42;Soria;110;Matalebreras;81;53;28
42;Soria;111;Matamala de Almazán;254;143;111
42;Soria;113;Medinaceli;671;350;321
42;Soria;115;Miño de Medinaceli;78;48;30
42;Soria;116;Miño de San Esteban;40;26;14
42;Soria;117;Molinos de Duero;158;90;68
42;Soria;118;Momblona;18;15;3
42;Soria;119;Monteagudo de las Vicarías;177;92;85
42;Soria;120;Montejo de Tiermes;140;88;52
42;Soria;121;Montenegro de Cameros;45;30;15
42;Soria;123;Morón de Almazán;202;104;98
42;Soria;124;Muriel de la Fuente;55;36;19
42;Soria;125;Muriel Viejo;75;49;26
42;Soria;127;Nafría de Ucero;36;21;15
42;Soria;128;Narros;71;44;27
42;Soria;129;Navaleno;732;389;343
42;Soria;130;Nepas;50;36;14
42;Soria;131;Nolay;48;27;21
42;Soria;132;Noviercas;172;94;78
42;Soria;134;Ólvega;3838;2034;1804
42;Soria;135;Oncala;61;40;21
42;Soria;139;Pinilla del Campo;18;10;8
42;Soria;140;Portillo de Soria;12;10;2
42;Soria;141;Póveda de Soria, La;110;67;43
42;Soria;142;Pozalmuro;46;23;23
42;Soria;144;Quintana Redonda;512;297;215
42;Soria;145;Quintanas de Gormaz;127;76;51
42;Soria;148;Quiñonería;10;6;4
42;Soria;149;Rábanos, Los;476;262;214
42;Soria;151;Rebollar;36;19;17
42;Soria;152;Recuerda;62;39;23
42;Soria;153;Rello;20;13;7
42;Soria;154;Renieblas;110;72;38
42;Soria;155;Retortillo de Soria;130;79;51
42;Soria;156;Reznos;22;14;8
42;Soria;157;Riba de Escalote, La;8;5;3
42;Soria;158;Rioseco de Soria;123;74;49
42;Soria;159;Rollamienta;44;29;15
42;Soria;160;Royo, El;251;136;115
42;Soria;161;Salduero;145;82;63
42;Soria;162;San Esteban de Gormaz;2935;1549;1386
42;Soria;163;San Felices;59;36;23
42;Soria;164;San Leonardo de Yagüe;1949;999;950
42;Soria;165;San Pedro Manrique;619;352;267
42;Soria;166;Santa Cruz de Yanguas;56;33;23
42;Soria;167;Santa María de Huerta;242;135;107
42;Soria;168;Santa María de las Hoyas;113;64;49
42;Soria;171;Serón de Nágima;122;67;55
42;Soria;172;Soliedra;33;18;15
42;Soria;173;Soria;40750;19238;21512
42;Soria;174;Sotillo del Rincón;175;103;72
42;Soria;175;Suellacabras;33;17;16
42;Soria;176;Tajahuerce;23;12;11
42;Soria;177;Tajueco;57;35;22
42;Soria;178;Talveila;101;66;35
42;Soria;181;Tardelcuende;424;224;200
42;Soria;182;Taroda;46;25;21
42;Soria;183;Tejado;96;57;39
42;Soria;184;Torlengua;45;30;15
42;Soria;185;Torreblacos;26;14;12
42;Soria;187;Torrubia de Soria;56;39;17
42;Soria;188;Trévago;47;24;23
42;Soria;189;Ucero;91;52;39
42;Soria;190;Vadillo;83;46;37
42;Soria;191;Valdeavellano de Tera;218;119;99
42;Soria;192;Valdegeña;37;27;10
42;Soria;193;Valdelagua del Cerro;13;8;5
42;Soria;194;Valdemaluque;137;69;68
42;Soria;195;Valdenebro;94;55;39
42;Soria;196;Valdeprado;8;3;5
42;Soria;197;Valderrodilla;62;35;27
42;Soria;198;Valtajeros;19;13;6
42;Soria;200;Velamazán;67;48;19
42;Soria;201;Velilla de la Sierra;27;17;10
42;Soria;202;Velilla de los Ajos;15;10;5
42;Soria;204;Viana de Duero;49;37;12
42;Soria;205;Villaciervos;86;51;35
42;Soria;206;Villanueva de Gormaz;8;5;3
42;Soria;207;Villar del Ala;50;25;25
42;Soria;208;Villar del Campo;30;17;13
42;Soria;209;Villar del Río;156;95;61
42;Soria;211;Villares de Soria, Los;75;42;33
42;Soria;212;Villasayas;60;41;19
42;Soria;213;Villaseca de Arciel;24;15;9
42;Soria;215;Vinuesa;833;433;400
42;Soria;216;Vizmanos;30;19;11
42;Soria;217;Vozmediano;33;22;11
42;Soria;218;Yanguas;106;63;43
42;Soria;219;Yelo;37;22;15
43;Tarragona;001;Aiguamúrcia;957;502;455
43;Tarragona;002;Albinyana;2677;1380;1297
43;Tarragona;003;Albiol, L';537;285;252
43;Tarragona;004;Alcanar;9943;5024;4919
43;Tarragona;005;Alcover;5348;2658;2690
43;Tarragona;006;Aldover;880;451;429
43;Tarragona;007;Aleixar, L';962;494;468
43;Tarragona;008;Alfara de Carles;361;186;175
43;Tarragona;009;Alforja;2019;1022;997
43;Tarragona;010;Alió;504;245;259
43;Tarragona;011;Almoster;1338;674;664
43;Tarragona;012;Altafulla;5838;2808;3030
43;Tarragona;013;Ametlla de Mar, L';7373;3764;3609
43;Tarragona;014;Amposta;22637;11529;11108
43;Tarragona;015;Arbolí;129;76;53
43;Tarragona;016;Arboç, L';5758;2928;2830
43;Tarragona;017;Argentera, L';129;75;54
43;Tarragona;018;Arnes;463;232;231
43;Tarragona;019;Ascó;1608;827;781
43;Tarragona;020;Banyeres del Penedès;3347;1671;1676
43;Tarragona;021;Barberà de la Conca;471;257;214
43;Tarragona;022;Batea;1877;933;944
43;Tarragona;023;Bellmunt del Priorat;298;157;141
43;Tarragona;024;Bellvei;2417;1248;1169
43;Tarragona;025;Benifallet;718;350;368
43;Tarragona;026;Benissanet;1186;654;532
43;Tarragona;027;Bisbal de Falset, La;208;118;90
43;Tarragona;028;Bisbal del Penedès, La;4168;2168;2000
43;Tarragona;029;Blancafort;393;199;194
43;Tarragona;030;Bonastre;760;405;355
43;Tarragona;031;Borges del Camp, Les;2260;1164;1096
43;Tarragona;032;Bot;554;276;278
43;Tarragona;033;Botarell;1174;609;565
43;Tarragona;034;Bràfim;696;347;349
43;Tarragona;035;Cabacés;302;167;135
43;Tarragona;036;Cabra del Camp;1321;701;620
43;Tarragona;037;Calafell;31828;15860;15968
43;Tarragona;038;Cambrils;36849;17939;18910
43;Tarragona;039;Capafonts;106;59;47
43;Tarragona;040;Capçanes;428;215;213
43;Tarragona;041;Caseres;240;117;123
43;Tarragona;042;Castellvell del Camp;2995;1502;1493
43;Tarragona;043;Catllar, El;5218;2722;2496
43;Tarragona;044;Sénia, La;5594;2817;2777
43;Tarragona;045;Colldejou;160;91;69
43;Tarragona;046;Conesa;113;59;54
43;Tarragona;047;Constantí;6888;3507;3381
43;Tarragona;048;Corbera d'Ebre;1019;538;481
43;Tarragona;049;Cornudella de Montsant;1023;542;481
43;Tarragona;050;Creixell;4190;2087;2103
43;Tarragona;051;Cunit;15804;7796;8008
43;Tarragona;052;Xerta;1156;571;585
43;Tarragona;053;Duesaigües;222;121;101
43;Tarragona;054;Espluga de Francolí, L';3817;1880;1937
43;Tarragona;055;Falset;2856;1476;1380
43;Tarragona;056;Fatarella, La;852;425;427
43;Tarragona;057;Febró, La;36;22;14
43;Tarragona;058;Figuera, La;122;68;54
43;Tarragona;059;Figuerola del Camp;345;170;175
43;Tarragona;060;Flix;3324;1684;1640
43;Tarragona;061;Forès;40;25;15
43;Tarragona;062;Freginals;424;233;191
43;Tarragona;063;Galera, La;708;361;347
43;Tarragona;064;Gandesa;3166;1594;1572
43;Tarragona;065;Garcia;543;273;270
43;Tarragona;066;Garidells, Els;202;98;104
43;Tarragona;067;Ginestar;794;414;380
43;Tarragona;068;Godall;612;304;308
43;Tarragona;069;Gratallops;229;126;103
43;Tarragona;070;Guiamets, Els;258;130;128
43;Tarragona;071;Horta de Sant Joan;1157;599;558
43;Tarragona;072;Lloar, El;101;52;49
43;Tarragona;073;Llorac;101;55;46
43;Tarragona;074;Llorenç del Penedès;2431;1208;1223
43;Tarragona;075;Margalef;106;64;42
43;Tarragona;076;Marçà;598;320;278
43;Tarragona;077;Mas de Barberans;547;276;271
43;Tarragona;078;Masdenverge;1149;617;532
43;Tarragona;079;Masllorenç;573;317;256
43;Tarragona;080;Masó, La;288;149;139
43;Tarragona;081;Maspujols;889;462;427
43;Tarragona;082;Masroig, El;480;265;215
43;Tarragona;083;Milà, El;197;99;98
43;Tarragona;084;Miravet;688;363;325
43;Tarragona;085;Molar, El;307;151;156
43;Tarragona;086;Montblanc;7550;3863;3687
43;Tarragona;088;Montbrió del Camp;3128;1611;1517
43;Tarragona;089;Montferri;473;251;222
43;Tarragona;090;Montmell, El;1917;1031;886
43;Tarragona;091;Mont-ral;184;99;85
43;Tarragona;092;Mont-roig del Camp;14114;7260;6854
43;Tarragona;093;Móra d'Ebre;5726;2897;2829
43;Tarragona;094;Móra la Nova;3314;1661;1653
43;Tarragona;095;Morell, El;3878;1992;1886
43;Tarragona;096;Morera de Montsant, La;138;81;57
43;Tarragona;097;Nou de Gaià, La;611;303;308
43;Tarragona;098;Nulles;552;288;264
43;Tarragona;099;Palma d'Ebre, La;335;163;172
43;Tarragona;100;Pallaresos, Els;5006;2527;2479
43;Tarragona;101;Passanant i Belltall;162;99;63
43;Tarragona;102;Paüls;544;274;270
43;Tarragona;103;Perafort;1308;674;634
43;Tarragona;104;Perelló, El;2907;1499;1408
43;Tarragona;105;Piles, Les;229;128;101
43;Tarragona;106;Pinell de Brai, El;979;487;492
43;Tarragona;107;Pira;498;266;232
43;Tarragona;108;Pla de Santa Maria, El;2389;1242;1147
43;Tarragona;109;Pobla de Mafumet, La;4115;2081;2034
43;Tarragona;110;Pobla de Massaluca, La;344;191;153
43;Tarragona;111;Pobla de Montornès, La;3329;1715;1614
43;Tarragona;112;Poboleda;334;170;164
43;Tarragona;113;Pont d'Armentera, El;498;244;254
43;Tarragona;114;Porrera;417;215;202
43;Tarragona;115;Pradell de la Teixeta;178;92;86
43;Tarragona;116;Prades;665;354;311
43;Tarragona;117;Prat de Comte;185;97;88
43;Tarragona;118;Pratdip;759;394;365
43;Tarragona;119;Puigpelat;1205;627;578
43;Tarragona;120;Querol;591;334;257
43;Tarragona;121;Rasquera;792;394;398
43;Tarragona;122;Renau;158;80;78
43;Tarragona;123;Reus;109930;53449;56481
43;Tarragona;124;Riba, La;569;316;253
43;Tarragona;125;Riba-roja d'Ebre;1128;603;525
43;Tarragona;126;Riera de Gaià, La;1807;893;914
43;Tarragona;127;Riudecanyes;1345;712;633
43;Tarragona;128;Riudecols;1232;629;603
43;Tarragona;129;Riudoms;6905;3516;3389
43;Tarragona;130;Rocafort de Queralt;246;132;114
43;Tarragona;131;Roda de Berà;8048;4074;3974
43;Tarragona;132;Rodonyà;521;285;236
43;Tarragona;133;Roquetes;8369;4318;4051
43;Tarragona;134;Rourell, El;403;204;199
43;Tarragona;135;Salomó;525;277;248
43;Tarragona;136;Ràpita, La;15683;7690;7993
43;Tarragona;137;Sant Jaume dels Domenys;2803;1432;1371
43;Tarragona;138;Santa Bàrbara;3827;1940;1887
43;Tarragona;139;Santa Coloma de Queralt;2800;1411;1389
43;Tarragona;140;Santa Oliva;3672;1867;1805
43;Tarragona;141;Pontils;123;68;55
43;Tarragona;142;Sarral;1583;806;777
43;Tarragona;143;Savallà del Comtat;50;28;22
43;Tarragona;144;Secuita, La;1828;931;897
43;Tarragona;145;Selva del Camp, La;5819;2894;2925
43;Tarragona;146;Senan;46;29;17
43;Tarragona;147;Solivella;626;333;293
43;Tarragona;148;Tarragona;141151;68775;72376
43;Tarragona;149;Tivenys;936;489;447
43;Tarragona;150;Tivissa;1632;824;808
43;Tarragona;151;Torre de Fontaubella, La;119;64;55
43;Tarragona;152;Torre de l'Espanyol, La;631;327;304
43;Tarragona;153;Torredembarra;17984;8763;9221
43;Tarragona;154;Torroja del Priorat;137;71;66
43;Tarragona;155;Tortosa;35265;17724;17541
43;Tarragona;156;Ulldecona;6551;3494;3057
43;Tarragona;157;Ulldemolins;416;234;182
43;Tarragona;158;Vallclara;89;55;34
43;Tarragona;159;Vallfogona de Riucorb;97;54;43
43;Tarragona;160;Vallmoll;1951;989;962
43;Tarragona;161;Valls;25047;12665;12382
43;Tarragona;162;Vandellòs i l'Hospitalet de l'Infant;7104;3539;3565
43;Tarragona;163;Vendrell, El;40440;20031;20409
43;Tarragona;164;Vespella de Gaià;506;268;238
43;Tarragona;165;Vilabella;723;371;352
43;Tarragona;166;Vilallonga del Camp;2451;1234;1217
43;Tarragona;167;Vilanova d'Escornalbou;610;319;291
43;Tarragona;168;Vilanova de Prades;111;60;51
43;Tarragona;169;Vilaplana;553;291;262
43;Tarragona;170;Vila-rodona;1374;725;649
43;Tarragona;171;Vila-seca;23826;11969;11857
43;Tarragona;172;Vilaverd;468;249;219
43;Tarragona;173;Vilella Alta, La;128;69;59
43;Tarragona;174;Vilella Baixa, La;207;115;92
43;Tarragona;175;Vilalba dels Arcs;608;305;303
43;Tarragona;176;Vimbodí i Poblet;893;483;410
43;Tarragona;177;Vinebre;424;224;200
43;Tarragona;178;Vinyols i els Arcs;2400;1232;1168
43;Tarragona;901;Deltebre;11951;6018;5933
43;Tarragona;902;Sant Jaume d'Enveja;3667;1845;1822
43;Tarragona;903;Camarles;3392;1728;1664
43;Tarragona;904;Aldea, L';4471;2405;2066
43;Tarragona;905;Salou;30810;15683;15127
43;Tarragona;906;Ampolla, L';3681;1868;1813
43;Tarragona;907;Canonja, La;5943;2897;3046
44;Teruel;001;Ababuj;74;44;30
44;Teruel;002;Abejuela;57;37;20
44;Teruel;003;Aguatón;17;7;10
44;Teruel;004;Aguaviva;547;261;286
44;Teruel;005;Aguilar del Alfambra;82;45;37
44;Teruel;006;Alacón;208;108;100
44;Teruel;007;Alba;187;112;75
44;Teruel;008;Albalate del Arzobispo;1933;1007;926
44;Teruel;009;Albarracín;1002;516;486
44;Teruel;010;Albentosa;299;153;146
44;Teruel;011;Alcaine;39;25;14
44;Teruel;012;Alcalá de la Selva;378;212;166
44;Teruel;013;Alcañiz;16247;8120;8127
44;Teruel;014;Alcorisa;3234;1644;1590
44;Teruel;016;Alfambra;487;261;226
44;Teruel;017;Aliaga;345;202;143
44;Teruel;018;Almohaja;12;10;2
44;Teruel;019;Alobras;69;45;24
44;Teruel;020;Alpeñés;26;13;13
44;Teruel;021;Allepuz;124;63;61
44;Teruel;022;Alloza;551;283;268
44;Teruel;023;Allueva;30;20;10
44;Teruel;024;Anadón;34;21;13
44;Teruel;025;Andorra;7258;3591;3667
44;Teruel;026;Arcos de las Salinas;110;69;41
44;Teruel;027;Arens de Lledó;194;90;104
44;Teruel;028;Argente;201;103;98
44;Teruel;029;Ariño;632;327;305
44;Teruel;031;Azaila;95;56;39
44;Teruel;032;Bádenas;24;15;9
44;Teruel;033;Báguena;295;170;125
44;Teruel;034;Bañón;155;86;69
44;Teruel;035;Barrachina;115;64;51
44;Teruel;036;Bea;27;18;9
44;Teruel;037;Beceite;562;289;273
44;Teruel;038;Belmonte de San José;135;69;66
44;Teruel;039;Bello;213;107;106
44;Teruel;040;Berge;216;113;103
44;Teruel;041;Bezas;68;40;28
44;Teruel;042;Blancas;134;79;55
44;Teruel;043;Blesa;76;54;22
44;Teruel;044;Bordón;113;66;47
44;Teruel;045;Bronchales;451;250;201
44;Teruel;046;Bueña;55;28;27
44;Teruel;047;Burbáguena;352;191;161
44;Teruel;048;Cabra de Mora;66;41;25
44;Teruel;049;Calaceite;960;477;483
44;Teruel;050;Calamocha;4542;2274;2268
44;Teruel;051;Calanda;3678;1832;1846
44;Teruel;052;Calomarde;74;45;29
44;Teruel;053;Camañas;127;69;58
44;Teruel;054;Camarena de la Sierra;142;76;66
44;Teruel;055;Camarillas;120;71;49
44;Teruel;056;Caminreal;603;321;282
44;Teruel;059;Cantavieja;719;371;348
44;Teruel;060;Cañada de Benatanduz;39;24;15
44;Teruel;061;Cañada de Verich, La;80;48;32
44;Teruel;062;Cañada Vellida;38;24;14
44;Teruel;063;Cañizar del Olivar;111;65;46
44;Teruel;064;Cascante del Río;65;39;26
44;Teruel;065;Castejón de Tornos;66;39;27
44;Teruel;066;Castel de Cabra;84;46;38
44;Teruel;067;Castelnou;99;51;48
44;Teruel;068;Castelserás;801;422;379
44;Teruel;070;Castellar, El;56;37;19
44;Teruel;071;Castellote;663;340;323
44;Teruel;074;Cedrillas;647;334;313
44;Teruel;075;Celadas;329;189;140
44;Teruel;076;Cella;2690;1383;1307
44;Teruel;077;Cerollera, La;77;48;29
44;Teruel;080;Codoñera, La;321;172;149
44;Teruel;082;Corbalán;118;58;60
44;Teruel;084;Cortes de Aragón;65;31;34
44;Teruel;085;Cosa;62;36;26
44;Teruel;086;Cretas;570;289;281
44;Teruel;087;Crivillén;91;53;38
44;Teruel;088;Cuba, La;50;24;26
44;Teruel;089;Cubla;58;38;20
44;Teruel;090;Cucalón;79;53;26
44;Teruel;092;Cuervo, El;95;45;50
44;Teruel;093;Cuevas de Almudén;115;61;54
44;Teruel;094;Cuevas Labradas;136;72;64
44;Teruel;096;Ejulve;169;81;88
44;Teruel;097;Escorihuela;141;69;72
44;Teruel;099;Escucha;772;417;355
44;Teruel;100;Estercuel;203;116;87
44;Teruel;101;Ferreruela de Huerva;78;46;32
44;Teruel;102;Fonfría;35;20;15
44;Teruel;103;Formiche Alto;158;90;68
44;Teruel;105;Fórnoles;72;38;34
44;Teruel;106;Fortanete;216;122;94
44;Teruel;107;Foz-Calanda;281;146;135
44;Teruel;108;Fresneda, La;459;255;204
44;Teruel;109;Frías de Albarracín;112;61;51
44;Teruel;110;Fuenferrada;35;23;12
44;Teruel;111;Fuentes Calientes;82;49;33
44;Teruel;112;Fuentes Claras;435;235;200
44;Teruel;113;Fuentes de Rubielos;156;87;69
44;Teruel;114;Fuentespalda;289;144;145
44;Teruel;115;Galve;144;75;69
44;Teruel;116;Gargallo;87;46;41
44;Teruel;117;Gea de Albarracín;467;256;211
44;Teruel;118;Ginebrosa, La;196;110;86
44;Teruel;119;Griegos;142;88;54
44;Teruel;120;Guadalaviar;237;127;110
44;Teruel;121;Gúdar;73;43;30
44;Teruel;122;Híjar;1760;902;858
44;Teruel;123;Hinojosa de Jarque;99;59;40
44;Teruel;124;Hoz de la Vieja, La;87;46;41
44;Teruel;125;Huesa del Común;57;35;22
44;Teruel;126;Iglesuela del Cid, La;377;193;184
44;Teruel;127;Jabaloyas;63;40;23
44;Teruel;128;Jarque de la Val;62;30;32
44;Teruel;129;Jatiel;49;29;20
44;Teruel;130;Jorcas;39;22;17
44;Teruel;131;Josa;35;21;14
44;Teruel;132;Lagueruela;71;42;29
44;Teruel;133;Lanzuela;24;16;8
44;Teruel;135;Libros;102;58;44
44;Teruel;136;Lidón;56;32;24
44;Teruel;137;Linares de Mora;233;135;98
44;Teruel;138;Loscos;112;73;39
44;Teruel;141;Lledó;153;78;75
44;Teruel;142;Maicas;35;21;14
44;Teruel;143;Manzanera;539;298;241
44;Teruel;144;Martín del Río;370;177;193
44;Teruel;145;Mas de las Matas;1225;627;598
44;Teruel;146;Mata de los Olmos, La;271;143;128
44;Teruel;147;Mazaleón;481;249;232
44;Teruel;148;Mezquita de Jarque;81;45;36
44;Teruel;149;Mirambel;107;62;45
44;Teruel;150;Miravete de la Sierra;32;21;11
44;Teruel;151;Molinos;228;124;104
44;Teruel;152;Monforte de Moyuela;75;50;25
44;Teruel;153;Monreal del Campo;2541;1244;1297
44;Teruel;154;Monroyo;308;170;138
44;Teruel;155;Montalbán;1165;595;570
44;Teruel;156;Monteagudo del Castillo;43;25;18
44;Teruel;157;Monterde de Albarracín;58;34;24
44;Teruel;158;Mora de Rubielos;1618;807;811
44;Teruel;159;Moscardón;61;33;28
44;Teruel;160;Mosqueruela;544;297;247
44;Teruel;161;Muniesa;572;307;265
44;Teruel;163;Noguera de Albarracín;130;76;54
44;Teruel;164;Nogueras;32;22;10
44;Teruel;165;Nogueruelas;193;112;81
44;Teruel;167;Obón;31;18;13
44;Teruel;168;Odón;197;97;100
44;Teruel;169;Ojos Negros;328;186;142
44;Teruel;171;Olba;294;156;138
44;Teruel;172;Oliete;367;199;168
44;Teruel;173;Olmos, Los;117;66;51
44;Teruel;174;Orihuela del Tremedal;458;249;209
44;Teruel;175;Orrios;119;65;54
44;Teruel;176;Palomar de Arroyos;160;95;65
44;Teruel;177;Pancrudo;113;66;47
44;Teruel;178;Parras de Castellote, Las;57;33;24
44;Teruel;179;Peñarroya de Tastavins;460;248;212
44;Teruel;180;Peracense;74;38;36
44;Teruel;181;Peralejos;89;48;41
44;Teruel;182;Perales del Alfambra;271;141;130
44;Teruel;183;Pitarque;61;29;32
44;Teruel;184;Plou;46;27;19
44;Teruel;185;Pobo, El;98;62;36
44;Teruel;187;Portellada, La;241;125;116
44;Teruel;189;Pozondón;54;33;21
44;Teruel;190;Pozuel del Campo;66;36;30
44;Teruel;191;Puebla de Híjar, La;934;485;449
44;Teruel;192;Puebla de Valverde, La;465;255;210
44;Teruel;193;Puertomingalvo;141;77;64
44;Teruel;194;Ráfales;149;89;60
44;Teruel;195;Rillo;98;55;43
44;Teruel;196;Riodeva;121;54;67
44;Teruel;197;Ródenas;61;34;27
44;Teruel;198;Royuela;225;117;108
44;Teruel;199;Rubiales;43;23;20
44;Teruel;200;Rubielos de la Cérida;26;17;9
44;Teruel;201;Rubielos de Mora;615;314;301
44;Teruel;203;Salcedillo;13;6;7
44;Teruel;204;Saldón;26;17;9
44;Teruel;205;Samper de Calanda;730;384;346
44;Teruel;206;San Agustín;137;87;50
44;Teruel;207;San Martín del Río;136;69;67
44;Teruel;208;Santa Cruz de Nogueras;24;16;8
44;Teruel;209;Santa Eulalia;1020;533;487
44;Teruel;210;Sarrión;1216;612;604
44;Teruel;211;Segura de los Baños;48;32;16
44;Teruel;212;Seno;38;16;22
44;Teruel;213;Singra;75;41;34
44;Teruel;215;Terriente;210;124;86
44;Teruel;216;Teruel;36713;17468;19245
44;Teruel;217;Toril y Masegoso;34;26;8
44;Teruel;218;Tormón;31;19;12
44;Teruel;219;Tornos;182;96;86
44;Teruel;220;Torralba de los Sisones;146;81;65
44;Teruel;221;Torrecilla de Alcañiz;436;232;204
44;Teruel;222;Torrecilla del Rebollar;117;75;42
44;Teruel;223;Torre de Arcas;82;41;41
44;Teruel;224;Torre de las Arcas;20;10;10
44;Teruel;225;Torre del Compte;122;63;59
44;Teruel;226;Torrelacárcel;131;79;52
44;Teruel;227;Torre los Negros;80;42;38
44;Teruel;228;Torremocha de Jiloca;103;54;49
44;Teruel;229;Torres de Albarracín;191;101;90
44;Teruel;230;Torrevelilla;182;90;92
44;Teruel;231;Torrijas;36;16;20
44;Teruel;232;Torrijo del Campo;502;264;238
44;Teruel;234;Tramacastiel;58;34;24
44;Teruel;235;Tramacastilla;130;62;68
44;Teruel;236;Tronchón;60;34;26
44;Teruel;237;Urrea de Gaén;440;225;215
44;Teruel;238;Utrillas;3102;1598;1504
44;Teruel;239;Valacloche;32;17;15
44;Teruel;240;Valbona;192;110;82
44;Teruel;241;Valdealgorfa;580;286;294
44;Teruel;243;Valdecuenca;28;16;12
44;Teruel;244;Valdelinares;75;47;28
44;Teruel;245;Valdeltormo;305;153;152
44;Teruel;246;Valderrobres;2545;1297;1248
44;Teruel;247;Valjunquera;328;171;157
44;Teruel;249;Vallecillo, El;37;21;16
44;Teruel;250;Veguillas de la Sierra;24;14;10
44;Teruel;251;Villafranca del Campo;296;162;134
44;Teruel;252;Villahermosa del Campo;93;54;39
44;Teruel;256;Villanueva del Rebollar de la Sierra;48;27;21
44;Teruel;257;Villar del Cobo;162;99;63
44;Teruel;258;Villar del Salz;53;33;20
44;Teruel;260;Villarluengo;163;97;66
44;Teruel;261;Villarquemado;870;454;416
44;Teruel;262;Villarroya de los Pinares;163;86;77
44;Teruel;263;Villastar;551;281;270
44;Teruel;264;Villel;337;189;148
44;Teruel;265;Vinaceite;182;98;84
44;Teruel;266;Visiedo;131;62;69
44;Teruel;267;Vivel del Río Martín;63;34;29
44;Teruel;268;Zoma, La;27;14;13
45;Toledo;001;Ajofrín;2350;1173;1177
45;Toledo;002;Alameda de la Sagra;4239;2239;2000
45;Toledo;003;Albarreal de Tajo;762;385;377
45;Toledo;004;Alcabón;761;383;378
45;Toledo;005;Alcañizo;275;132;143
45;Toledo;006;Alcaudete de la Jara;1662;836;826
45;Toledo;007;Alcolea de Tajo;829;418;411
45;Toledo;008;Aldea en Cabo;205;104;101
45;Toledo;009;Aldeanueva de Barbarroya;461;235;226
45;Toledo;010;Aldeanueva de San Bartolomé;413;214;199
45;Toledo;011;Almendral de la Cañada;345;181;164
45;Toledo;012;Almonacid de Toledo;931;475;456
45;Toledo;013;Almorox;2472;1298;1174
45;Toledo;014;Añover de Tajo;5354;2711;2643
45;Toledo;015;Arcicóllar;1082;555;527
45;Toledo;016;Argés;7014;3498;3516
45;Toledo;017;Azután;289;138;151
45;Toledo;018;Barcience;1049;554;495
45;Toledo;019;Bargas;11099;5525;5574
45;Toledo;020;Belvís de la Jara;1428;737;691
45;Toledo;021;Borox;4250;2249;2001
45;Toledo;022;Buenaventura;377;190;187
45;Toledo;023;Burguillos de Toledo;3743;1942;1801
45;Toledo;024;Burujón;1332;673;659
45;Toledo;025;Cabañas de la Sagra;2137;1085;1052
45;Toledo;026;Cabañas de Yepes;306;164;142
45;Toledo;027;Cabezamesada;332;184;148
45;Toledo;028;Calera y Chozas;4773;2394;2379
45;Toledo;029;Caleruela;201;104;97
45;Toledo;030;Calzada de Oropesa;518;286;232
45;Toledo;031;Camarena;4634;2416;2218
45;Toledo;032;Camarenilla;606;309;297
45;Toledo;033;Campillo de la Jara, El;322;170;152
45;Toledo;034;Camuñas;1767;930;837
45;Toledo;035;Cardiel de los Montes;390;211;179
45;Toledo;036;Carmena;836;425;411
45;Toledo;037;Carpio de Tajo, El;1873;946;927
45;Toledo;038;Carranque;5418;2782;2636
45;Toledo;039;Carriches;266;138;128
45;Toledo;040;Casar de Escalona, El;2128;1102;1026
45;Toledo;041;Casarrubios del Monte;7098;3674;3424
45;Toledo;042;Casasbuenas;193;97;96
45;Toledo;043;Castillo de Bayuela;921;473;448
45;Toledo;045;Cazalegas;2098;1085;1013
45;Toledo;046;Cebolla;3234;1606;1628
45;Toledo;047;Cedillo del Condado;4337;2255;2082
45;Toledo;048;Cerralbos, Los;425;227;198
45;Toledo;049;Cervera de los Montes;495;258;237
45;Toledo;050;Ciruelos;679;360;319
45;Toledo;051;Cobeja;2668;1391;1277
45;Toledo;052;Cobisa;4500;2268;2232
45;Toledo;053;Consuegra;9758;4929;4829
45;Toledo;054;Corral de Almaguer;5237;2767;2470
45;Toledo;055;Cuerva;1260;652;608
45;Toledo;056;Chozas de Canales;4887;2531;2356
45;Toledo;057;Chueca;249;124;125
45;Toledo;058;Domingo Pérez;395;202;193
45;Toledo;059;Dosbarrios;2203;1134;1069
45;Toledo;060;Erustes;226;120;106
45;Toledo;061;Escalona;3801;1940;1861
45;Toledo;062;Escalonilla;1497;727;770
45;Toledo;063;Espinoso del Rey;418;243;175
45;Toledo;064;Esquivias;5832;2965;2867
45;Toledo;065;Estrella, La;267;142;125
45;Toledo;066;Fuensalida;12508;6288;6220
45;Toledo;067;Gálvez;3006;1519;1487
45;Toledo;068;Garciotum;215;106;109
45;Toledo;069;Gerindote;2767;1404;1363
45;Toledo;070;Guadamur;1782;897;885
45;Toledo;071;Guardia, La;2160;1112;1048
45;Toledo;072;Herencias, Las;792;421;371
45;Toledo;073;Herreruela de Oropesa;328;173;155
45;Toledo;074;Hinojosa de San Vicente;380;209;171
45;Toledo;075;Hontanar;151;94;57
45;Toledo;076;Hormigos;992;541;451
45;Toledo;077;Huecas;875;449;426
45;Toledo;078;Huerta de Valdecarábanos;1771;899;872
45;Toledo;079;Iglesuela del Tiétar, La;451;234;217
45;Toledo;080;Illán de Vacas;2;2;0
45;Toledo;081;Illescas;32159;16119;16040
45;Toledo;082;Lagartera;1315;642;673
45;Toledo;083;Layos;906;456;450
45;Toledo;084;Lillo;2493;1303;1190
45;Toledo;085;Lominchar;2815;1512;1303
45;Toledo;086;Lucillos;629;330;299
45;Toledo;087;Madridejos;10102;5070;5032
45;Toledo;088;Magán;4114;2097;2017
45;Toledo;089;Malpica de Tajo;1678;867;811
45;Toledo;090;Manzaneque;398;202;196
45;Toledo;091;Maqueda;504;243;261
45;Toledo;092;Marjaliza;264;138;126
45;Toledo;093;Marrupe;162;80;82
45;Toledo;094;Mascaraque;424;214;210
45;Toledo;095;Mata, La;915;448;467
45;Toledo;096;Mazarambroz;1270;659;611
45;Toledo;097;Mejorada;1385;703;682
45;Toledo;098;Menasalbas;2485;1293;1192
45;Toledo;099;Méntrida;6273;3189;3084
45;Toledo;100;Mesegar de Tajo;200;110;90
45;Toledo;101;Miguel Esteban;4733;2382;2351
45;Toledo;102;Mocejón;5172;2598;2574
45;Toledo;103;Mohedas de la Jara;410;218;192
45;Toledo;104;Montearagón;588;310;278
45;Toledo;105;Montesclaros;365;191;174
45;Toledo;106;Mora;9930;5002;4928
45;Toledo;107;Nambroca;5250;2656;2594
45;Toledo;108;Nava de Ricomalillo, La;515;269;246
45;Toledo;109;Navahermosa;3592;1881;1711
45;Toledo;110;Navalcán;1863;963;900
45;Toledo;111;Navalmoralejo;54;27;27
45;Toledo;112;Navalmorales, Los;2120;1086;1034
45;Toledo;113;Navalucillos, Los;1897;960;937
45;Toledo;114;Navamorcuende;599;300;299
45;Toledo;115;Noblejas;3952;1977;1975
45;Toledo;116;Noez;990;510;480
45;Toledo;117;Nombela;895;484;411
45;Toledo;118;Novés;3463;1770;1693
45;Toledo;119;Numancia de la Sagra;5616;2921;2695
45;Toledo;120;Nuño Gómez;171;88;83
45;Toledo;121;Ocaña;14469;7261;7208
45;Toledo;122;Olías del Rey;8947;4498;4449
45;Toledo;123;Ontígola;4992;2607;2385
45;Toledo;124;Orgaz;2595;1306;1289
45;Toledo;125;Oropesa;2564;1222;1342
45;Toledo;126;Otero;431;223;208
45;Toledo;127;Palomeque;1182;642;540
45;Toledo;128;Pantoja;3523;1756;1767
45;Toledo;129;Paredes de Escalona;129;70;59
45;Toledo;130;Parrillas;351;182;169
45;Toledo;131;Pelahustán;331;191;140
45;Toledo;132;Pepino;3259;1673;1586
45;Toledo;133;Polán;3932;1992;1940
45;Toledo;134;Portillo de Toledo;2346;1199;1147
45;Toledo;135;Puebla de Almoradiel, La;4887;2481;2406
45;Toledo;136;Puebla de Montalbán, La;8032;4059;3973
45;Toledo;137;Pueblanueva, La;2138;1113;1025
45;Toledo;138;Puente del Arzobispo, El;1151;577;574
45;Toledo;139;Puerto de San Vicente;147;82;65
45;Toledo;140;Pulgar;1600;839;761
45;Toledo;141;Quero;979;495;484
45;Toledo;142;Quintanar de la Orden;11194;5555;5639
45;Toledo;143;Quismondo;1798;897;901
45;Toledo;144;Real de San Vicente, El;981;524;457
45;Toledo;145;Recas;5023;2787;2236
45;Toledo;146;Retamoso de la Jara;110;56;54
45;Toledo;147;Rielves;859;430;429
45;Toledo;148;Robledo del Mazo;252;140;112
45;Toledo;149;Romeral, El;541;266;275
45;Toledo;150;San Bartolomé de las Abiertas;603;322;281
45;Toledo;151;San Martín de Montalbán;759;397;362
45;Toledo;152;San Martín de Pusa;604;328;276
45;Toledo;153;San Pablo de los Montes;1644;829;815
45;Toledo;154;San Román de los Montes;2112;1090;1022
45;Toledo;155;Santa Ana de Pusa;342;196;146
45;Toledo;156;Santa Cruz de la Zarza;4100;2113;1987
45;Toledo;157;Santa Cruz del Retamar;4038;2105;1933
45;Toledo;158;Santa Olalla;3502;1775;1727
45;Toledo;159;Sartajada;100;62;38
45;Toledo;160;Segurilla;1378;692;686
45;Toledo;161;Seseña;30165;15471;14694
45;Toledo;162;Sevilleja de la Jara;620;347;273
45;Toledo;163;Sonseca;11328;5757;5571
45;Toledo;164;Sotillo de las Palomas;183;95;88
45;Toledo;165;Talavera de la Reina;84738;40640;44098
45;Toledo;166;Tembleque;2009;1019;990
45;Toledo;167;Toboso, El;1723;866;857
45;Toledo;168;Toledo;86526;41199;45327
45;Toledo;169;Torralba de Oropesa;193;104;89
45;Toledo;170;Torrecilla de la Jara;222;123;99
45;Toledo;171;Torre de Esteban Hambrán, La;1932;959;973
45;Toledo;172;Torrico;702;356;346
45;Toledo;173;Torrijos;14099;6939;7160
45;Toledo;174;Totanés;371;185;186
45;Toledo;175;Turleque;692;356;336
45;Toledo;176;Ugena;5802;2999;2803
45;Toledo;177;Urda;2494;1268;1226
45;Toledo;179;Valdeverdeja;565;284;281
45;Toledo;180;Valmojado;4771;2387;2384
45;Toledo;181;Velada;2907;1492;1415
45;Toledo;182;Ventas con Peña Aguilera, Las;1118;567;551
45;Toledo;183;Ventas de Retamosa, Las;4160;2160;2000
45;Toledo;184;Ventas de San Julián, Las;231;112;119
45;Toledo;185;Villacañas;9489;4746;4743
45;Toledo;186;Villa de Don Fadrique, La;3553;1778;1775
45;Toledo;187;Villafranca de los Caballeros;4897;2491;2406
45;Toledo;188;Villaluenga de la Sagra;4171;2118;2053
45;Toledo;189;Villamiel de Toledo;1069;544;525
45;Toledo;190;Villaminaya;497;249;248
45;Toledo;191;Villamuelas;613;320;293
45;Toledo;192;Villanueva de Alcardete;2963;1520;1443
45;Toledo;193;Villanueva de Bogas;676;348;328
45;Toledo;194;Villarejo de Montalbán;78;41;37
45;Toledo;195;Villarrubia de Santiago;2559;1306;1253
45;Toledo;196;Villaseca de la Sagra;1859;933;926
45;Toledo;197;Villasequilla;2621;1348;1273
45;Toledo;198;Villatobas;2858;1466;1392
45;Toledo;199;Viso de San Juan, El;6164;3289;2875
45;Toledo;200;Yébenes, Los;5753;2945;2808
45;Toledo;201;Yeles;6649;3495;3154
45;Toledo;202;Yepes;5541;2819;2722
45;Toledo;203;Yuncler;5033;2601;2432
45;Toledo;204;Yunclillos;816;434;382
45;Toledo;205;Yuncos;12831;6563;6268
45;Toledo;901;Santo Domingo-Caudilla;1229;647;582
46;Valencia/València;001;Ademuz;1004;538;466
46;Valencia/València;002;Ador;1729;916;813
46;Valencia/València;003;Atzeneta d'Albaida;1169;582;587
46;Valencia/València;004;Agullent;2416;1202;1214
46;Valencia/València;005;Alaquàs;30022;14621;15401
46;Valencia/València;006;Albaida;6235;3071;3164
46;Valencia/València;007;Albal;17038;8508;8530
46;Valencia/València;008;Albalat de la Ribera;3446;1738;1708
46;Valencia/València;009;Albalat dels Sorells;4249;2085;2164
46;Valencia/València;010;Albalat dels Tarongers;1516;799;717
46;Valencia/València;011;Alberic;10945;5462;5483
46;Valencia/València;012;Alborache;1471;778;693
46;Valencia/València;013;Alboraia/Alboraya;26259;12719;13540
46;Valencia/València;014;Albuixech;4419;2110;2309
46;Valencia/València;015;Alcàsser;10676;5352;5324
46;Valencia/València;016;Alcàntera de Xúquer;1425;709;716
46;Valencia/València;017;Alzira;47335;23089;24246
46;Valencia/València;018;Alcublas;683;365;318
46;Valencia/València;019;Alcúdia, l';12402;6125;6277
46;Valencia/València;020;Alcúdia de Crespins, l';5438;2678;2760
46;Valencia/València;021;Aldaia;34035;17136;16899
46;Valencia/València;022;Alfafar;22131;10837;11294
46;Valencia/València;023;Alfauir;489;249;240
46;Valencia/València;024;Alfara de la Baronia;614;304;310
46;Valencia/València;025;Alfara del Patriarca;3623;1690;1933
46;Valencia/València;026;Alfarb;1676;869;807
46;Valencia/València;027;Alfarrasí;1175;581;594
46;Valencia/València;028;Algar de Palància;542;287;255
46;Valencia/València;029;Algemesí;27968;13817;14151
46;Valencia/València;030;Algímia d'Alfara;1104;542;562
46;Valencia/València;031;Alginet;14652;7400;7252
46;Valencia/València;032;Almàssera;7672;3736;3936
46;Valencia/València;033;Almiserà;285;148;137
46;Valencia/València;034;Almoines;2643;1337;1306
46;Valencia/València;035;Almussafes;9057;4505;4552
46;Valencia/València;036;Alpuente;700;382;318
46;Valencia/València;037;Alqueria de la Comtessa, l';1544;755;789
46;Valencia/València;038;Andilla;324;215;109
46;Valencia/València;039;Anna;2595;1302;1293
46;Valencia/València;040;Antella;1114;537;577
46;Valencia/València;041;Aras de los Olmos;392;223;169
46;Valencia/València;042;Aielo de Malferit;4599;2313;2286
46;Valencia/València;043;Aielo de Rugat;160;87;73
46;Valencia/València;044;Ayora;5284;2588;2696
46;Valencia/València;045;Barxeta;1586;809;777
46;Valencia/València;046;Barx;1498;768;730
46;Valencia/València;047;Bèlgida;640;323;317
46;Valencia/València;048;Bellreguard;4943;2458;2485
46;Valencia/València;049;Bellús;302;157;145
46;Valencia/València;050;Benagéber;171;101;70
46;Valencia/València;051;Benaguasil;12336;6261;6075
46;Valencia/València;052;Benavites;661;315;346
46;Valencia/València;053;Beneixida;649;311;338
46;Valencia/València;054;Benetússer;16322;7990;8332
46;Valencia/València;055;Beniarjó;1907;948;959
46;Valencia/València;056;Beniatjar;209;112;97
46;Valencia/València;057;Benicolet;605;293;312
46;Valencia/València;058;Benifairó de les Valls;2318;1153;1165
46;Valencia/València;059;Benifairó de la Valldigna;1560;775;785
46;Valencia/València;060;Benifaió;12130;5955;6175
46;Valencia/València;061;Beniflá;502;252;250
46;Valencia/València;062;Benigànim;5695;2896;2799
46;Valencia/València;063;Benimodo;2316;1187;1129
46;Valencia/València;064;Benimuslem;665;355;310
46;Valencia/València;065;Beniparrell;2091;1059;1032
46;Valencia/València;066;Benirredrà;1561;735;826
46;Valencia/València;067;Benissanó;2427;1186;1241
46;Valencia/València;068;Benissoda;485;260;225
46;Valencia/València;069;Benissuera;185;97;88
46;Valencia/València;070;Bétera;27584;13744;13840
46;Valencia/València;071;Bicorp;560;273;287
46;Valencia/València;072;Bocairent;4148;2082;2066
46;Valencia/València;073;Bolbaite;1333;659;674
46;Valencia/València;074;Bonrepòs i Mirambell;4048;1988;2060
46;Valencia/València;075;Bufali;154;79;75
46;Valencia/València;076;Bugarra;781;404;377
46;Valencia/València;077;Buñol;9765;4845;4920
46;Valencia/València;078;Burjassot;40634;19523;21111
46;Valencia/València;079;Calles;447;257;190
46;Valencia/València;080;Camporrobles;1188;609;579
46;Valencia/València;081;Canals;13415;6693;6722
46;Valencia/València;082;Canet d'En Berenguer;7771;3907;3864
46;Valencia/València;083;Carcaixent;21317;10605;10712
46;Valencia/València;084;Càrcer;1806;876;930
46;Valencia/València;085;Carlet;16428;8201;8227
46;Valencia/València;086;Carrícola;99;49;50
46;Valencia/València;087;Casas Altas;139;73;66
46;Valencia/València;088;Casas Bajas;167;86;81
46;Valencia/València;089;Casinos;3113;1570;1543
46;Valencia/València;090;Castelló de Rugat;2352;1178;1174
46;Valencia/València;091;Castellonet de la Conquesta;144;72;72
46;Valencia/València;092;Castielfabib;287;153;134
46;Valencia/València;093;Catadau;2967;1488;1479
46;Valencia/València;094;Catarroja;30142;14866;15276
46;Valencia/València;095;Caudete de las Fuentes;720;376;344
46;Valencia/València;096;Cerdà;367;183;184
46;Valencia/València;097;Cofrentes;1123;562;561
46;Valencia/València;098;Corbera;3173;1586;1587
46;Valencia/València;099;Cortes de Pallás;758;416;342
46;Valencia/València;100;Cotes;311;160;151
46;Valencia/València;101;Quart de les Valls;1040;492;548
46;Valencia/València;102;Quart de Poblet;26304;12728;13576
46;Valencia/València;103;Quartell;1657;780;877
46;Valencia/València;104;Quatretonda;2206;1098;1108
46;Valencia/València;105;Cullera;24181;12081;12100
46;Valencia/València;106;Chelva;1677;858;819
46;Valencia/València;107;Chella;2439;1213;1226
46;Valencia/València;108;Chera;491;262;229
46;Valencia/València;109;Cheste;9022;4615;4407
46;Valencia/València;110;Xirivella;31745;15714;16031
46;Valencia/València;111;Chiva;17245;8854;8391
46;Valencia/València;112;Chulilla;677;360;317
46;Valencia/València;113;Daimús;3419;1729;1690
46;Valencia/València;114;Domeño;691;346;345
46;Valencia/València;115;Dos Aguas;338;199;139
46;Valencia/València;116;Eliana, l';19597;9601;9996
46;Valencia/València;117;Emperador;693;364;329
46;Valencia/València;118;Enguera;4769;2389;2380
46;Valencia/València;119;Énova, l';924;477;447
46;Valencia/València;120;Estivella;1631;781;850
46;Valencia/València;121;Estubeny;109;54;55
46;Valencia/València;122;Faura;3671;1814;1857
46;Valencia/València;123;Favara;2701;1380;1321
46;Valencia/València;124;Fontanars dels Alforins;947;489;458
46;Valencia/València;125;Fortaleny;1005;494;511
46;Valencia/València;126;Foios;7761;3793;3968
46;Valencia/València;127;Font d'en Carròs, la;3938;1979;1959
46;Valencia/València;128;Font de la Figuera, la;2043;1038;1005
46;Valencia/València;129;Fuenterrobles;695;372;323
46;Valencia/València;130;Gavarda;1036;486;550
46;Valencia/València;131;Gandia;80095;39248;40847
46;Valencia/València;132;Genovés, el;2823;1436;1387
46;Valencia/València;133;Gestalgar;560;288;272
46;Valencia/València;134;Gilet;3887;1979;1908
46;Valencia/València;135;Godella;13437;6441;6996
46;Valencia/València;136;Godelleta;4182;2132;2050
46;Valencia/València;137;Granja de la Costera, la;294;146;148
46;Valencia/València;138;Guadasséquies;468;228;240
46;Valencia/València;139;Guadassuar;5992;2901;3091
46;Valencia/València;140;Guardamar de la Safor;607;316;291
46;Valencia/València;141;Higueruelas;534;279;255
46;Valencia/València;142;Jalance;803;415;388
46;Valencia/València;143;Xeraco;6044;3030;3014
46;Valencia/València;144;Jarafuel;757;390;367
46;Valencia/València;145;Xàtiva;30378;14871;15507
46;Valencia/València;146;Xeresa;2341;1178;1163
46;Valencia/València;147;Llíria;25077;12618;12459
46;Valencia/València;148;Loriguilla;2186;1124;1062
46;Valencia/València;149;Losa del Obispo;523;263;260
46;Valencia/València;150;Llutxent;2335;1190;1145
46;Valencia/València;151;Llocnou d'En Fenollet;924;472;452
46;Valencia/València;152;Llocnou de la Corona;121;59;62
46;Valencia/València;153;Llocnou de Sant Jeroni;586;294;292
46;Valencia/València;154;Llanera de Ranes;1057;540;517
46;Valencia/València;155;Llaurí;1236;638;598
46;Valencia/València;156;Llombai;2767;1374;1393
46;Valencia/València;157;Llosa de Ranes, la;3736;1901;1835
46;Valencia/València;158;Macastre;1475;776;699
46;Valencia/València;159;Manises;32273;15960;16313
46;Valencia/València;160;Manuel;2524;1266;1258
46;Valencia/València;161;Marines;1921;991;930
46;Valencia/València;162;Massalavés;1811;925;886
46;Valencia/València;163;Massalfassar;2653;1319;1334
46;Valencia/València;164;Massamagrell;17216;8496;8720
46;Valencia/València;165;Massanassa;10345;5022;5323
46;Valencia/València;166;Meliana;10990;5373;5617
46;Valencia/València;167;Millares;329;166;163
46;Valencia/València;168;Miramar;3020;1528;1492
46;Valencia/València;169;Mislata;46153;22298;23855
46;Valencia/València;170;Moixent/Mogente;4373;2183;2190
46;Valencia/València;171;Moncada;21993;10640;11353
46;Valencia/València;172;Montserrat;9656;4977;4679
46;Valencia/València;173;Montaverner;1626;807;819
46;Valencia/València;174;Montesa;1134;571;563
46;Valencia/València;175;Montitxelvo/Montichelvo;577;280;297
46;Valencia/València;176;Montroi/Montroy;3477;1837;1640
46;Valencia/València;177;Museros;6739;3428;3311
46;Valencia/València;178;Nàquera/Náquera;8308;4303;4005
46;Valencia/València;179;Navarrés;3055;1519;1536
46;Valencia/València;180;Novetlè;849;417;432
46;Valencia/València;181;Oliva;26122;12827;13295
46;Valencia/València;182;Olocau;2425;1288;1137
46;Valencia/València;183;Olleria, l';8648;4356;4292
46;Valencia/València;184;Ontinyent;36430;17975;18455
46;Valencia/València;185;Otos;440;227;213
46;Valencia/València;186;Paiporta;27748;13556;14192
46;Valencia/València;187;Palma de Gandía;1816;960;856
46;Valencia/València;188;Palmera;1028;518;510
46;Valencia/València;189;Palomar, el;598;307;291
46;Valencia/València;190;Paterna;74822;36814;38008
46;Valencia/València;191;Pedralba;3124;1628;1496
46;Valencia/València;192;Petrés;1142;573;569
46;Valencia/València;193;Picanya;11876;5864;6012
46;Valencia/València;194;Picassent;22695;11333;11362
46;Valencia/València;195;Piles;3195;1570;1625
46;Valencia/València;196;Pinet;148;72;76
46;Valencia/València;197;Polinyà de Xúquer;2551;1315;1236
46;Valencia/València;198;Potries;1104;571;533
46;Valencia/València;199;Pobla de Farnals, la;9076;4499;4577
46;Valencia/València;200;Pobla del Duc, la;2449;1184;1265
46;Valencia/València;201;Puebla de San Miguel;51;38;13
46;Valencia/València;202;Pobla de Vallbona, la;27056;13528;13528
46;Valencia/València;203;Pobla Llarga, la;4569;2293;2276
46;Valencia/València;204;Puig de Santa Maria, el;9367;4565;4802
46;Valencia/València;205;Puçol;21298;10464;10834
46;Valencia/València;206;Quesa;675;344;331
46;Valencia/València;207;Rafelbunyol;9710;4735;4975
46;Valencia/València;208;Rafelcofer;1374;669;705
46;Valencia/València;209;Rafelguaraf;2350;1162;1188
46;Valencia/València;210;Ráfol de Salem;464;235;229
46;Valencia/València;211;Real de Gandia, el;2670;1351;1319
46;Valencia/València;212;Real;2435;1267;1168
46;Valencia/València;213;Requena;20740;10408;10332
46;Valencia/València;214;Riba-roja de Túria;24230;12247;11983
46;Valencia/València;215;Riola;1770;879;891
46;Valencia/València;216;Rocafort;7753;3787;3966
46;Valencia/València;217;Rotglà i Corberà;1158;577;581
46;Valencia/València;218;Ròtova;1271;638;633
46;Valencia/València;219;Rugat;171;95;76
46;Valencia/València;220;Sagunt/Sagunto;71377;34788;36589
46;Valencia/València;221;Salem;394;199;195
46;Valencia/València;222;Sant Joanet;526;256;270
46;Valencia/València;223;Sedaví;10908;5333;5575
46;Valencia/València;224;Segart;167;93;74
46;Valencia/València;225;Sellent;383;200;183
46;Valencia/València;226;Sempere;29;15;14
46;Valencia/València;227;Senyera;1124;548;576
46;Valencia/València;228;Serra;3725;1877;1848
46;Valencia/València;229;Siete Aguas;1279;655;624
46;Valencia/València;230;Silla;20117;9950;10167
46;Valencia/València;231;Simat de la Valldigna;3289;1641;1648
46;Valencia/València;232;Sinarcas;1153;606;547
46;Valencia/València;233;Sollana;5035;2486;2549
46;Valencia/València;234;Sot de Chera;432;232;200
46;Valencia/València;235;Sueca;28480;14079;14401
46;Valencia/València;236;Sumacàrcer;1042;504;538
46;Valencia/València;237;Tavernes Blanques;9635;4680;4955
46;Valencia/València;238;Tavernes de la Valldigna;17631;8732;8899
46;Valencia/València;239;Teresa de Cofrentes;605;308;297
46;Valencia/València;240;Terrateig;290;151;139
46;Valencia/València;241;Titaguas;494;251;243
46;Valencia/València;242;Torrebaja;391;214;177
46;Valencia/València;243;Torrella;150;80;70
46;Valencia/València;244;Torrent;89401;43686;45715
46;Valencia/València;245;Torres Torres;750;415;335
46;Valencia/València;246;Tous;1357;677;680
46;Valencia/València;247;Tuéjar;1233;661;572
46;Valencia/València;248;Turís;7544;3924;3620
46;Valencia/València;249;Utiel;11703;5834;5869
46;Valencia/València;250;València;825948;391970;433978
46;Valencia/València;251;Vallada;3079;1579;1500
46;Valencia/València;252;Vallanca;131;69;62
46;Valencia/València;253;Vallés;148;83;65
46;Valencia/València;254;Venta del Moro;1158;624;534
46;Valencia/València;255;Vilallonga/Villalonga;4713;2340;2373
46;Valencia/València;256;Vilamarxant;11041;5729;5312
46;Valencia/València;257;Castelló;6897;3393;3504
46;Valencia/València;258;Villar del Arzobispo;3775;1919;1856
46;Valencia/València;259;Villargordo del Cabriel;594;301;293
46;Valencia/València;260;Vinalesa;3531;1716;1815
46;Valencia/València;261;Yátova;2242;1161;1081
46;Valencia/València;262;Yesa, La;235;127;108
46;Valencia/València;263;Zarra;386;212;174
46;Valencia/València;902;Gátova;429;223;206
46;Valencia/València;903;San Antonio de Benagéber;10630;5227;5403
46;Valencia/València;904;Benicull de Xúquer;1144;579;565
47;Valladolid;001;Adalia;50;30;20
47;Valladolid;002;Aguasal;19;12;7
47;Valladolid;003;Aguilar de Campos;259;156;103
47;Valladolid;004;Alaejos;1407;747;660
47;Valladolid;005;Alcazarén;614;334;280
47;Valladolid;006;Aldea de San Miguel;218;120;98
47;Valladolid;007;Aldeamayor de San Martín;6163;3151;3012
47;Valladolid;008;Almenara de Adaja;22;14;8
47;Valladolid;009;Amusquillo;99;59;40
47;Valladolid;010;Arroyo de la Encomienda;22268;11103;11165
47;Valladolid;011;Ataquines;573;314;259
47;Valladolid;012;Bahabón;93;45;48
47;Valladolid;013;Barcial de la Loma;100;51;49
47;Valladolid;014;Barruelo del Valle;52;29;23
47;Valladolid;015;Becilla de Valderaduey;200;118;82
47;Valladolid;016;Benafarces;70;37;33
47;Valladolid;017;Bercero;177;100;77
47;Valladolid;018;Berceruelo;36;21;15
47;Valladolid;019;Berrueces;93;50;43
47;Valladolid;020;Bobadilla del Campo;284;158;126
47;Valladolid;021;Bocigas;75;41;34
47;Valladolid;022;Bocos de Duero;81;42;39
47;Valladolid;023;Boecillo;4357;2179;2178
47;Valladolid;024;Bolaños de Campos;254;142;112
47;Valladolid;025;Brahojos de Medina;101;53;48
47;Valladolid;026;Bustillo de Chaves;65;37;28
47;Valladolid;027;Cabezón de Pisuerga;3895;1988;1907
47;Valladolid;028;Cabezón de Valderaduey;33;17;16
47;Valladolid;029;Cabreros del Monte;56;32;24
47;Valladolid;030;Campaspero;1004;558;446
47;Valladolid;031;Campillo, El;198;119;79
47;Valladolid;032;Camporredondo;147;87;60
47;Valladolid;033;Canalejas de Peñafiel;252;132;120
47;Valladolid;034;Canillas de Esgueva;73;44;29
47;Valladolid;035;Carpio;938;506;432
47;Valladolid;036;Casasola de Arión;215;126;89
47;Valladolid;037;Castrejón de Trabancos;176;91;85
47;Valladolid;038;Castrillo de Duero;121;64;57
47;Valladolid;039;Castrillo-Tejeriego;152;89;63
47;Valladolid;040;Castrobol;45;24;21
47;Valladolid;041;Castrodeza;142;92;50
47;Valladolid;042;Castromembibre;49;33;16
47;Valladolid;043;Castromonte;326;168;158
47;Valladolid;044;Castronuevo de Esgueva;393;210;183
47;Valladolid;045;Castronuño;767;378;389
47;Valladolid;046;Castroponce;128;67;61
47;Valladolid;047;Castroverde de Cerrato;189;121;68
47;Valladolid;048;Ceinos de Campos;172;104;68
47;Valladolid;049;Cervillego de la Cruz;91;53;38
47;Valladolid;050;Cigales;5364;2763;2601
47;Valladolid;051;Ciguñuela;358;184;174
47;Valladolid;052;Cistérniga;9281;4657;4624
47;Valladolid;053;Cogeces de Íscar;144;74;70
47;Valladolid;054;Cogeces del Monte;644;347;297
47;Valladolid;055;Corcos;210;119;91
47;Valladolid;056;Corrales de Duero;105;62;43
47;Valladolid;057;Cubillas de Santa Marta;404;236;168
47;Valladolid;058;Cuenca de Campos;192;101;91
47;Valladolid;059;Curiel de Duero;119;75;44
47;Valladolid;060;Encinas de Esgueva;218;120;98
47;Valladolid;061;Esguevillas de Esgueva;258;146;112
47;Valladolid;062;Fombellida;175;103;72
47;Valladolid;063;Fompedraza;111;59;52
47;Valladolid;064;Fontihoyuelo;31;20;11
47;Valladolid;065;Fresno el Viejo;836;451;385
47;Valladolid;066;Fuensaldaña;2137;1100;1037
47;Valladolid;067;Fuente el Sol;153;82;71
47;Valladolid;068;Fuente-Olmedo;42;21;21
47;Valladolid;069;Gallegos de Hornija;109;53;56
47;Valladolid;070;Gatón de Campos;41;24;17
47;Valladolid;071;Geria;488;227;261
47;Valladolid;073;Herrín de Campos;112;63;49
47;Valladolid;074;Hornillos de Eresma;171;98;73
47;Valladolid;075;Íscar;6396;3225;3171
47;Valladolid;076;Laguna de Duero;22907;11349;11558
47;Valladolid;077;Langayo;250;157;93
47;Valladolid;078;Lomoviejo;161;87;74
47;Valladolid;079;Llano de Olmedo;51;27;24
47;Valladolid;080;Manzanillo;48;27;21
47;Valladolid;081;Marzales;41;18;23
47;Valladolid;082;Matapozuelos;1015;513;502
47;Valladolid;083;Matilla de los Caños;113;63;50
47;Valladolid;084;Mayorga;1409;706;703
47;Valladolid;085;Medina del Campo;20097;9872;10225
47;Valladolid;086;Medina de Rioseco;4537;2239;2298
47;Valladolid;087;Megeces;422;225;197
47;Valladolid;088;Melgar de Abajo;114;61;53
47;Valladolid;089;Melgar de Arriba;162;95;67
47;Valladolid;090;Mojados;3393;1764;1629
47;Valladolid;091;Monasterio de Vega;79;43;36
47;Valladolid;092;Montealegre de Campos;105;63;42
47;Valladolid;093;Montemayor de Pililla;860;464;396
47;Valladolid;094;Moral de la Reina;146;82;64
47;Valladolid;095;Moraleja de las Panaderas;38;23;15
47;Valladolid;096;Morales de Campos;130;73;57
47;Valladolid;097;Mota del Marqués;330;177;153
47;Valladolid;098;Mucientes;691;344;347
47;Valladolid;099;Mudarra, La;169;88;81
47;Valladolid;100;Muriel;111;57;54
47;Valladolid;101;Nava del Rey;1925;969;956
47;Valladolid;102;Nueva Villa de las Torres;278;158;120
47;Valladolid;103;Olivares de Duero;327;182;145
47;Valladolid;104;Olmedo;3564;1759;1805
47;Valladolid;105;Olmos de Esgueva;197;107;90
47;Valladolid;106;Olmos de Peñafiel;38;23;15
47;Valladolid;109;Palazuelo de Vedija;164;87;77
47;Valladolid;110;Parrilla, La;480;236;244
47;Valladolid;111;Pedraja de Portillo, La;1175;602;573
47;Valladolid;112;Pedrajas de San Esteban;3406;1738;1668
47;Valladolid;113;Pedrosa del Rey;148;83;65
47;Valladolid;114;Peñafiel;5188;2657;2531
47;Valladolid;115;Peñaflor de Hornija;350;184;166
47;Valladolid;116;Pesquera de Duero;423;228;195
47;Valladolid;117;Piña de Esgueva;310;165;145
47;Valladolid;118;Piñel de Abajo;163;93;70
47;Valladolid;119;Piñel de Arriba;88;46;42
47;Valladolid;121;Pollos;562;313;249
47;Valladolid;122;Portillo;2368;1211;1157
47;Valladolid;123;Pozal de Gallinas;538;286;252
47;Valladolid;124;Pozaldez;500;268;232
47;Valladolid;125;Pozuelo de la Orden;50;32;18
47;Valladolid;126;Puras;45;25;20
47;Valladolid;127;Quintanilla de Arriba;155;88;67
47;Valladolid;128;Quintanilla del Molar;47;22;25
47;Valladolid;129;Quintanilla de Onésimo;992;528;464
47;Valladolid;130;Quintanilla de Trigueros;101;52;49
47;Valladolid;131;Rábano;176;94;82
47;Valladolid;132;Ramiro;46;27;19
47;Valladolid;133;Renedo de Esgueva;3972;2017;1955
47;Valladolid;134;Roales de Campos;165;91;74
47;Valladolid;135;Robladillo;87;49;38
47;Valladolid;137;Roturas;26;16;10
47;Valladolid;138;Rubí de Bracamonte;214;124;90
47;Valladolid;139;Rueda;1103;574;529
47;Valladolid;140;Saelices de Mayorga;111;70;41
47;Valladolid;141;Salvador de Zapardiel;103;57;46
47;Valladolid;142;San Cebrián de Mazote;103;63;40
47;Valladolid;143;San Llorente;94;56;38
47;Valladolid;144;San Martín de Valvení;84;45;39
47;Valladolid;145;San Miguel del Arroyo;646;344;302
47;Valladolid;146;San Miguel del Pino;367;185;182
47;Valladolid;147;San Pablo de la Moraleja;107;62;45
47;Valladolid;148;San Pedro de Latarce;434;238;196
47;Valladolid;149;San Pelayo;48;23;25
47;Valladolid;150;San Román de Hornija;301;143;158
47;Valladolid;151;San Salvador;23;14;9
47;Valladolid;152;Santa Eufemia del Arroyo;73;43;30
47;Valladolid;153;Santervás de Campos;108;59;49
47;Valladolid;154;Santibáñez de Valcorba;187;111;76
47;Valladolid;155;Santovenia de Pisuerga;4703;2382;2321
47;Valladolid;156;San Vicente del Palacio;160;83;77
47;Valladolid;157;Sardón de Duero;607;318;289
47;Valladolid;158;Seca, La;1013;535;478
47;Valladolid;159;Serrada;1109;573;536
47;Valladolid;160;Siete Iglesias de Trabancos;419;220;199
47;Valladolid;161;Simancas;5538;2798;2740
47;Valladolid;162;Tamariz de Campos;84;48;36
47;Valladolid;163;Tiedra;282;142;140
47;Valladolid;164;Tordehumos;375;203;172
47;Valladolid;165;Tordesillas;8638;4356;4282
47;Valladolid;166;Torrecilla de la Abadesa;250;118;132
47;Valladolid;167;Torrecilla de la Orden;227;116;111
47;Valladolid;168;Torrecilla de la Torre;28;19;9
47;Valladolid;169;Torre de Esgueva;62;33;29
47;Valladolid;170;Torre de Peñafiel;57;36;21
47;Valladolid;171;Torrelobatón;386;205;181
47;Valladolid;172;Torrescárcela;164;87;77
47;Valladolid;173;Traspinedo;1240;652;588
47;Valladolid;174;Trigueros del Valle;314;168;146
47;Valladolid;175;Tudela de Duero;8786;4443;4343
47;Valladolid;176;Unión de Campos, La;202;95;107
47;Valladolid;177;Urones de Castroponce;100;61;39
47;Valladolid;178;Urueña;203;111;92
47;Valladolid;179;Valbuena de Duero;399;230;169
47;Valladolid;180;Valdearcos de la Vega;64;37;27
47;Valladolid;181;Valdenebro de los Valles;185;105;80
47;Valladolid;182;Valdestillas;1612;833;779
47;Valladolid;183;Valdunquillo;116;59;57
47;Valladolid;184;Valoria la Buena;745;415;330
47;Valladolid;185;Valverde de Campos;91;53;38
47;Valladolid;186;Valladolid;300618;140820;159798
47;Valladolid;187;Vega de Ruiponce;81;47;34
47;Valladolid;188;Vega de Valdetronco;91;50;41
47;Valladolid;189;Velascálvaro;163;85;78
47;Valladolid;190;Velilla;113;57;56
47;Valladolid;191;Velliza;121;80;41
47;Valladolid;192;Ventosa de la Cuesta;101;56;45
47;Valladolid;193;Viana de Cega;2292;1173;1119
47;Valladolid;194;Viloria;331;172;159
47;Valladolid;195;Villabáñez;507;272;235
47;Valladolid;196;Villabaruz de Campos;32;15;17
47;Valladolid;197;Villabrágima;1048;558;490
47;Valladolid;198;Villacarralón;66;44;22
47;Valladolid;199;Villacid de Campos;82;45;37
47;Valladolid;200;Villaco;75;48;27
47;Valladolid;203;Villafrades de Campos;61;28;33
47;Valladolid;204;Villafranca de Duero;241;131;110
47;Valladolid;205;Villafrechós;468;257;211
47;Valladolid;206;Villafuerte;86;50;36
47;Valladolid;207;Villagarcía de Campos;288;172;116
47;Valladolid;208;Villagómez la Nueva;51;28;23
47;Valladolid;209;Villalán de Campos;32;20;12
47;Valladolid;210;Villalar de los Comuneros;490;240;250
47;Valladolid;211;Villalba de la Loma;58;31;27
47;Valladolid;212;Villalba de los Alcores;392;215;177
47;Valladolid;213;Villalbarba;100;50;50
47;Valladolid;214;Villalón de Campos;1496;738;758
47;Valladolid;215;Villamuriel de Campos;51;27;24
47;Valladolid;216;Villán de Tordesillas;122;72;50
47;Valladolid;217;Villanubla;2915;1521;1394
47;Valladolid;218;Villanueva de Duero;1258;665;593
47;Valladolid;219;Villanueva de la Condesa;59;26;33
47;Valladolid;220;Villanueva de los Caballeros;157;87;70
47;Valladolid;221;Villanueva de los Infantes;112;67;45
47;Valladolid;222;Villanueva de San Mancio;102;56;46
47;Valladolid;223;Villardefrades;136;81;55
47;Valladolid;224;Villarmentero de Esgueva;102;54;48
47;Valladolid;225;Villasexmir;67;39;28
47;Valladolid;226;Villavaquerín;145;82;63
47;Valladolid;227;Villavellid;53;29;24
47;Valladolid;228;Villaverde de Medina;529;278;251
47;Valladolid;229;Villavicencio de los Caballeros;221;115;106
47;Valladolid;230;Wamba;295;161;134
47;Valladolid;231;Zaratán;6383;3245;3138
47;Valladolid;232;Zarza, La;118;67;51
48;Bizkaia;001;Abadiño;7742;3858;3884
48;Bizkaia;002;Abanto y Ciérvana-Abanto Zierbena;9409;4692;4717
48;Bizkaia;003;Amorebieta-Etxano;19678;9650;10028
48;Bizkaia;004;Amoroto;394;210;184
48;Bizkaia;005;Arakaldo;160;74;86
48;Bizkaia;006;Arantzazu;394;198;196
48;Bizkaia;007;Munitibar-Arbatzegi Gerrikaitz;466;262;204
48;Bizkaia;008;Artzentales;736;382;354
48;Bizkaia;009;Arrankudiaga-Zollo;1007;498;509
48;Bizkaia;010;Arrieta;579;300;279
48;Bizkaia;011;Arrigorriaga;11952;5847;6105
48;Bizkaia;012;Bakio;2821;1399;1422
48;Bizkaia;013;Barakaldo;101984;49299;52685
48;Bizkaia;014;Barrika;1549;784;765
48;Bizkaia;015;Basauri;40388;19562;20826
48;Bizkaia;016;Berango;7647;3721;3926
48;Bizkaia;017;Bermeo;17042;8385;8657
48;Bizkaia;018;Berriatua;1247;673;574
48;Bizkaia;019;Berriz;4600;2281;2319
48;Bizkaia;020;Bilbao;348089;165223;182866
48;Bizkaia;021;Busturia;1656;819;837
48;Bizkaia;022;Karrantza Harana/Valle de Carranza;2711;1418;1293
48;Bizkaia;023;Artea;748;382;366
48;Bizkaia;024;Zeanuri;1250;625;625
48;Bizkaia;025;Zeberio;1081;550;531
48;Bizkaia;026;Dima;1505;779;726
48;Bizkaia;027;Durango;29887;14590;15297
48;Bizkaia;028;Ea;842;438;404
48;Bizkaia;029;Etxebarri;11941;5960;5981
48;Bizkaia;030;Etxebarria;774;394;380
48;Bizkaia;031;Elantxobe;349;168;181
48;Bizkaia;032;Elorrio;7266;3530;3736
48;Bizkaia;033;Ereño;272;150;122
48;Bizkaia;034;Ermua;15627;7736;7891
48;Bizkaia;035;Fruiz;576;277;299
48;Bizkaia;036;Galdakao;24774;12128;12646
48;Bizkaia;037;Galdames;821;435;386
48;Bizkaia;038;Gamiz-Fika;1381;697;684
48;Bizkaia;039;Garai;342;168;174
48;Bizkaia;040;Gatika;1633;824;809
48;Bizkaia;041;Gautegiz Arteaga;878;445;433
48;Bizkaia;042;Gordexola;1711;866;845
48;Bizkaia;043;Gorliz;6015;2975;3040
48;Bizkaia;044;Getxo;75981;35624;40357
48;Bizkaia;045;Güeñes;6771;3258;3513
48;Bizkaia;046;Gernika-Lumo;17033;8201;8832
48;Bizkaia;047;Gizaburuaga;197;106;91
48;Bizkaia;048;Ibarrangelu;680;354;326
48;Bizkaia;049;Ispaster;712;372;340
48;Bizkaia;050;Izurtza;230;152;78
48;Bizkaia;051;Lanestosa;246;130;116
48;Bizkaia;052;Larrabetzu;2047;995;1052
48;Bizkaia;053;Laukiz;1245;607;638
48;Bizkaia;054;Leioa;32683;15979;16704
48;Bizkaia;055;Lemoa;3586;1810;1776
48;Bizkaia;056;Lemoiz;1337;704;633
48;Bizkaia;057;Lekeitio;7163;3529;3634
48;Bizkaia;058;Mallabia;1157;595;562
48;Bizkaia;059;Mañaria;531;280;251
48;Bizkaia;060;Markina-Xemein;5078;2548;2530
48;Bizkaia;061;Maruri-Jatabe;1073;556;517
48;Bizkaia;062;Mendata;380;201;179
48;Bizkaia;063;Mendexa;424;223;201
48;Bizkaia;064;Meñaka;767;400;367
48;Bizkaia;065;Ugao-Miraballes;4175;2102;2073
48;Bizkaia;066;Morga;412;216;196
48;Bizkaia;067;Muxika;1545;811;734
48;Bizkaia;068;Mundaka;1828;902;926
48;Bizkaia;069;Mungia;17997;8734;9263
48;Bizkaia;070;Aulesti;643;319;324
48;Bizkaia;071;Muskiz;7361;3600;3761
48;Bizkaia;072;Otxandio;1357;693;664
48;Bizkaia;073;Ondarroa;8113;4054;4059
48;Bizkaia;074;Urduña/Orduña;4203;2168;2035
48;Bizkaia;075;Orozko;2666;1331;1335
48;Bizkaia;076;Sukarrieta;353;179;174
48;Bizkaia;077;Plentzia;4390;2138;2252
48;Bizkaia;078;Portugalete;44766;21331;23435
48;Bizkaia;079;Errigoiti;511;272;239
48;Bizkaia;080;Valle de Trápaga-Trapagaran;11898;5804;6094
48;Bizkaia;081;Lezama;2459;1223;1236
48;Bizkaia;082;Santurtzi;46247;22228;24019
48;Bizkaia;083;Ortuella;8629;4239;4390
48;Bizkaia;084;Sestao;28228;13610;14618
48;Bizkaia;085;Sopela;14940;7393;7547
48;Bizkaia;086;Sopuerta;2765;1393;1372
48;Bizkaia;087;Trucios-Turtzioz;515;271;244
48;Bizkaia;088;Ubide;164;82;82
48;Bizkaia;089;Urduliz;5711;2794;2917
48;Bizkaia;090;Balmaseda;7633;3693;3940
48;Bizkaia;091;Atxondo;1356;687;669
48;Bizkaia;092;Bedia;1117;537;580
48;Bizkaia;093;Areatza;1287;628;659
48;Bizkaia;094;Igorre;4330;2111;2219
48;Bizkaia;095;Zaldibar;3027;1534;1493
48;Bizkaia;096;Zalla;8316;4068;4248
48;Bizkaia;097;Zaratamo;1611;813;798
48;Bizkaia;901;Derio;7168;3528;3640
48;Bizkaia;902;Erandio;24662;11913;12749
48;Bizkaia;903;Loiu;2359;1169;1190
48;Bizkaia;904;Sondika;4587;2223;2364
48;Bizkaia;905;Zamudio;3314;1654;1660
48;Bizkaia;906;Forua;949;455;494
48;Bizkaia;907;Kortezubi;444;211;233
48;Bizkaia;908;Murueta;322;168;154
48;Bizkaia;909;Nabarniz;274;137;137
48;Bizkaia;910;Iurreta;3873;1919;1954
48;Bizkaia;911;Ajangiz;475;248;227
48;Bizkaia;912;Alonsotegi;3020;1494;1526
48;Bizkaia;913;Zierbena;1493;789;704
48;Bizkaia;914;Arratzu;414;195;219
48;Bizkaia;915;Ziortza-Bolibar;409;215;194
48;Bizkaia;916;Usansolo;4572;2250;2322
49;Zamora;002;Abezames;60;34;26
49;Zamora;003;Alcañices;1061;559;502
49;Zamora;004;Alcubilla de Nogales;108;58;50
49;Zamora;005;Alfaraz de Sayago;124;75;49
49;Zamora;006;Algodre;135;74;61
49;Zamora;007;Almaraz de Duero;397;208;189
49;Zamora;008;Almeida de Sayago;422;236;186
49;Zamora;009;Andavías;420;213;207
49;Zamora;010;Arcenillas;448;229;219
49;Zamora;011;Arcos de la Polvorosa;216;125;91
49;Zamora;012;Argañín;80;39;41
49;Zamora;013;Argujillo;218;110;108
49;Zamora;014;Arquillinos;113;61;52
49;Zamora;015;Arrabalde;194;101;93
49;Zamora;016;Aspariegos;225;98;127
49;Zamora;017;Asturianos;260;133;127
49;Zamora;018;Ayoó de Vidriales;274;141;133
49;Zamora;019;Barcial del Barco;253;133;120
49;Zamora;020;Belver de los Montes;253;141;112
49;Zamora;021;Benavente;17246;8276;8970
49;Zamora;022;Benegiles;268;145;123
49;Zamora;023;Bermillo de Sayago;1026;551;475
49;Zamora;024;Bóveda de Toro, La;676;348;328
49;Zamora;025;Bretó;166;99;67
49;Zamora;026;Bretocino;195;103;92
49;Zamora;027;Brime de Sog;116;55;61
49;Zamora;028;Brime de Urz;99;58;41
49;Zamora;029;Burganes de Valverde;618;328;290
49;Zamora;030;Bustillo del Oro;79;46;33
49;Zamora;031;Cabañas de Sayago;151;80;71
49;Zamora;032;Calzadilla de Tera;287;144;143
49;Zamora;033;Camarzana de Tera;746;384;362
49;Zamora;034;Cañizal;421;225;196
49;Zamora;035;Cañizo;201;112;89
49;Zamora;036;Carbajales de Alba;466;241;225
49;Zamora;037;Carbellino;182;102;80
49;Zamora;038;Casaseca de Campeán;86;50;36
49;Zamora;039;Casaseca de las Chanas;373;198;175
49;Zamora;040;Castrillo de la Guareña;118;65;53
49;Zamora;041;Castrogonzalo;430;235;195
49;Zamora;042;Castronuevo;218;116;102
49;Zamora;043;Castroverde de Campos;256;137;119
49;Zamora;044;Cazurra;74;42;32
49;Zamora;046;Cerecinos de Campos;234;127;107
49;Zamora;047;Cerecinos del Carrizal;108;66;42
49;Zamora;048;Cernadilla;110;58;52
49;Zamora;050;Cobreros;545;299;246
49;Zamora;052;Coomonte;179;96;83
49;Zamora;053;Coreses;1037;534;503
49;Zamora;054;Corrales del Vino;929;461;468
49;Zamora;055;Cotanes del Monte;82;44;38
49;Zamora;056;Cubillos;295;146;149
49;Zamora;057;Cubo de Benavente;117;64;53
49;Zamora;058;Cubo de Tierra del Vino, El;298;160;138
49;Zamora;059;Cuelgamures;80;48;32
49;Zamora;061;Entrala;127;72;55
49;Zamora;062;Espadañedo;104;59;45
49;Zamora;063;Faramontanos de Tábara;340;182;158
49;Zamora;064;Fariza;496;261;235
49;Zamora;065;Fermoselle;1149;589;560
49;Zamora;066;Ferreras de Abajo;451;220;231
49;Zamora;067;Ferreras de Arriba;358;198;160
49;Zamora;068;Ferreruela;419;234;185
49;Zamora;069;Figueruela de Arriba;318;162;156
49;Zamora;071;Fonfría;763;408;355
49;Zamora;075;Fresno de la Polvorosa;114;61;53
49;Zamora;076;Fresno de la Ribera;342;175;167
49;Zamora;077;Fresno de Sayago;143;72;71
49;Zamora;078;Friera de Valverde;127;69;58
49;Zamora;079;Fuente Encalada;89;48;41
49;Zamora;080;Fuentelapeña;599;319;280
49;Zamora;081;Fuentesaúco;1606;816;790
49;Zamora;082;Fuentes de Ropel;361;193;168
49;Zamora;083;Fuentesecas;44;24;20
49;Zamora;084;Fuentespreadas;290;152;138
49;Zamora;085;Galende;1024;523;501
49;Zamora;086;Gallegos del Pan;116;66;50
49;Zamora;087;Gallegos del Río;467;262;205
49;Zamora;088;Gamones;92;52;40
49;Zamora;090;Gema;197;105;92
49;Zamora;091;Granja de Moreruela;250;130;120
49;Zamora;092;Granucillo;104;60;44
49;Zamora;093;Guarrate;314;158;156
49;Zamora;094;Hermisende;216;120;96
49;Zamora;095;Hiniesta, La;307;165;142
49;Zamora;096;Jambrina;149;82;67
49;Zamora;097;Justel;78;50;28
49;Zamora;098;Losacino;187;105;82
49;Zamora;099;Losacio;89;49;40
49;Zamora;100;Lubián;290;152;138
49;Zamora;101;Luelmo;149;82;67
49;Zamora;102;Maderal, El;169;93;76
49;Zamora;103;Madridanos;453;240;213
49;Zamora;104;Mahide;310;173;137
49;Zamora;105;Maire de Castroponce;140;76;64
49;Zamora;107;Malva;100;47;53
49;Zamora;108;Manganeses de la Lampreana;439;230;209
49;Zamora;109;Manganeses de la Polvorosa;641;313;328
49;Zamora;110;Manzanal de Arriba;350;185;165
49;Zamora;111;Manzanal del Barco;128;67;61
49;Zamora;112;Manzanal de los Infantes;135;74;61
49;Zamora;113;Matilla de Arzón;157;91;66
49;Zamora;114;Matilla la Seca;36;21;15
49;Zamora;115;Mayalde;152;85;67
49;Zamora;116;Melgar de Tera;351;181;170
49;Zamora;117;Micereces de Tera;414;216;198
49;Zamora;118;Milles de la Polvorosa;199;110;89
49;Zamora;119;Molacillos;233;127;106
49;Zamora;120;Molezuelas de la Carballeda;46;25;21
49;Zamora;121;Mombuey;386;201;185
49;Zamora;122;Monfarracinos;995;514;481
49;Zamora;123;Montamarta;543;295;248
49;Zamora;124;Moral de Sayago;262;153;109
49;Zamora;125;Moraleja del Vino;1806;911;895
49;Zamora;126;Moraleja de Sayago;299;152;147
49;Zamora;127;Morales del Vino;3085;1613;1472
49;Zamora;128;Morales de Rey;517;258;259
49;Zamora;129;Morales de Toro;919;472;447
49;Zamora;130;Morales de Valverde;150;77;73
49;Zamora;131;Moralina;219;116;103
49;Zamora;132;Moreruela de los Infanzones;324;163;161
49;Zamora;133;Moreruela de Tábara;288;154;134
49;Zamora;134;Muelas de los Caballeros;188;110;78
49;Zamora;135;Muelas del Pan;616;331;285
49;Zamora;136;Muga de Sayago;317;155;162
49;Zamora;137;Navianos de Valverde;163;90;73
49;Zamora;138;Olmillos de Castro;193;104;89
49;Zamora;139;Otero de Bodas;166;81;85
49;Zamora;141;Pajares de la Lampreana;280;144;136
49;Zamora;142;Palacios del Pan;240;124;116
49;Zamora;143;Palacios de Sanabria;230;116;114
49;Zamora;145;Pedralba de la Pradería;195;112;83
49;Zamora;146;Pego, El;284;152;132
49;Zamora;147;Peleagonzalo;294;152;142
49;Zamora;148;Peleas de Abajo;255;122;133
49;Zamora;149;Peñausende;375;191;184
49;Zamora;150;Peque;122;56;66
49;Zamora;151;Perdigón, El;650;343;307
49;Zamora;152;Pereruela;496;275;221
49;Zamora;153;Perilla de Castro;148;85;63
49;Zamora;154;Pías;94;54;40
49;Zamora;155;Piedrahita de Castro;106;56;50
49;Zamora;156;Pinilla de Toro;184;97;87
49;Zamora;157;Pino del Oro;175;84;91
49;Zamora;158;Piñero, El;215;110;105
49;Zamora;159;Pobladura del Valle;273;145;128
49;Zamora;160;Pobladura de Valderaduey;35;21;14
49;Zamora;162;Porto;156;91;65
49;Zamora;163;Pozoantiguo;190;99;91
49;Zamora;164;Pozuelo de Tábara;145;80;65
49;Zamora;165;Prado;53;31;22
49;Zamora;166;Puebla de Sanabria;1366;659;707
49;Zamora;167;Pueblica de Valverde;177;96;81
49;Zamora;168;Quintanilla del Monte;95;52;43
49;Zamora;169;Quintanilla del Olmo;45;22;23
49;Zamora;170;Quintanilla de Urz;97;48;49
49;Zamora;171;Quiruelas de Vidriales;635;338;297
49;Zamora;172;Rabanales;488;269;219
49;Zamora;173;Rábano de Aliste;314;160;154
49;Zamora;174;Requejo;111;59;52
49;Zamora;175;Revellinos;229;121;108
49;Zamora;176;Riofrío de Aliste;599;330;269
49;Zamora;177;Rionegro del Puente;234;124;110
49;Zamora;178;Roales;1022;525;497
49;Zamora;179;Robleda-Cervantes;400;210;190
49;Zamora;180;Roelos de Sayago;138;69;69
49;Zamora;181;Rosinos de la Requejada;305;164;141
49;Zamora;183;Salce;85;40;45
49;Zamora;184;Samir de los Caños;156;89;67
49;Zamora;185;San Agustín del Pozo;166;85;81
49;Zamora;186;San Cebrián de Castro;249;131;118
49;Zamora;187;San Cristóbal de Entreviñas;1318;694;624
49;Zamora;188;San Esteban del Molar;109;64;45
49;Zamora;189;San Justo;215;120;95
49;Zamora;190;San Martín de Valderaduey;45;22;23
49;Zamora;191;San Miguel de la Ribera;252;133;119
49;Zamora;192;San Miguel del Valle;119;58;61
49;Zamora;193;San Pedro de Ceque;421;227;194
49;Zamora;194;San Pedro de la Nave-Almendra;322;167;155
49;Zamora;197;Santa Clara de Avedillo;159;77;82
49;Zamora;199;Santa Colomba de las Monjas;232;114;118
49;Zamora;200;Santa Cristina de la Polvorosa;1027;526;501
49;Zamora;201;Santa Croya de Tera;260;135;125
49;Zamora;202;Santa Eufemia del Barco;169;98;71
49;Zamora;203;Santa María de la Vega;290;148;142
49;Zamora;204;Santa María de Valverde;51;24;27
49;Zamora;205;Santibáñez de Tera;358;188;170
49;Zamora;206;Santibáñez de Vidriales;844;433;411
49;Zamora;207;Santovenia;227;124;103
49;Zamora;208;San Vicente de la Cabeza;323;169;154
49;Zamora;209;San Vitero;429;243;186
49;Zamora;210;Sanzoles;466;243;223
49;Zamora;214;Tábara;748;361;387
49;Zamora;216;Tapioles;124;73;51
49;Zamora;219;Toro;8369;4079;4290
49;Zamora;220;Torre del Valle, La;125;68;57
49;Zamora;221;Torregamones;226;119;107
49;Zamora;222;Torres del Carrizal;407;208;199
49;Zamora;223;Trabazos;838;447;391
49;Zamora;224;Trefacio;165;95;70
49;Zamora;225;Uña de Quintana;121;68;53
49;Zamora;226;Vadillo de la Guareña;243;137;106
49;Zamora;227;Valcabado;415;215;200
49;Zamora;228;Valdefinjas;59;39;20
49;Zamora;229;Valdescorriel;131;69;62
49;Zamora;230;Vallesa de la Guareña;68;38;30
49;Zamora;231;Vega de Tera;287;145;142
49;Zamora;232;Vega de Villalobos;91;43;48
49;Zamora;233;Vegalatrave;79;43;36
49;Zamora;234;Venialbo;431;227;204
49;Zamora;235;Vezdemarbán;439;232;207
49;Zamora;236;Vidayanes;76;39;37
49;Zamora;237;Videmala;140;69;71
49;Zamora;238;Villabrázaro;263;148;115
49;Zamora;239;Villabuena del Puente;586;306;280
49;Zamora;240;Villadepera;179;99;80
49;Zamora;241;Villaescusa;237;128;109
49;Zamora;242;Villafáfila;440;227;213
49;Zamora;243;Villaferrueña;106;56;50
49;Zamora;244;Villageriz;64;36;28
49;Zamora;245;Villalazán;248;127;121
49;Zamora;246;Villalba de la Lampreana;212;119;93
49;Zamora;247;Villalcampo;379;195;184
49;Zamora;248;Villalobos;193;95;98
49;Zamora;249;Villalonso;79;37;42
49;Zamora;250;Villalpando;1399;669;730
49;Zamora;251;Villalube;147;80;67
49;Zamora;252;Villamayor de Campos;339;178;161
49;Zamora;255;Villamor de los Escuderos;365;194;171
49;Zamora;256;Villanázar;249;136;113
49;Zamora;257;Villanueva de Azoague;381;202;179
49;Zamora;258;Villanueva de Campeán;117;62;55
49;Zamora;259;Villanueva de las Peras;89;45;44
49;Zamora;260;Villanueva del Campo;761;373;388
49;Zamora;261;Villaralbo;1805;924;881
49;Zamora;262;Villardeciervos;392;198;194
49;Zamora;263;Villar de Fallaves;49;28;21
49;Zamora;264;Villar del Buey;514;263;251
49;Zamora;265;Villardiegua de la Ribera;116;58;58
49;Zamora;266;Villárdiga;62;37;25
49;Zamora;267;Villardondiego;127;75;52
49;Zamora;268;Villarrín de Campos;415;224;191
49;Zamora;269;Villaseco del Pan;207;101;106
49;Zamora;270;Villavendimio;156;98;58
49;Zamora;271;Villaveza del Agua;163;86;77
49;Zamora;272;Villaveza de Valverde;72;33;39
49;Zamora;273;Viñas;160;87;73
49;Zamora;275;Zamora;59506;27543;31963
50;Zaragoza;001;Abanto;80;51;29
50;Zaragoza;002;Acered;141;85;56
50;Zaragoza;003;Agón;133;76;57
50;Zaragoza;004;Aguarón;599;320;279
50;Zaragoza;005;Aguilón;273;149;124
50;Zaragoza;006;Ainzón;1043;549;494
50;Zaragoza;007;Aladrén;62;40;22
50;Zaragoza;008;Alagón;7450;3733;3717
50;Zaragoza;009;Alarba;93;51;42
50;Zaragoza;010;Alberite de San Juan;84;47;37
50;Zaragoza;011;Albeta;141;73;68
50;Zaragoza;012;Alborge;102;58;44
50;Zaragoza;013;Alcalá de Ebro;243;117;126
50;Zaragoza;014;Alcalá de Moncayo;153;86;67
50;Zaragoza;015;Alconchel de Ariza;78;46;32
50;Zaragoza;016;Aldehuela de Liestos;49;33;16
50;Zaragoza;017;Alfajarín;2415;1228;1187
50;Zaragoza;018;Alfamén;1494;780;714
50;Zaragoza;019;Alforque;61;35;26
50;Zaragoza;020;Alhama de Aragón;925;484;441
50;Zaragoza;021;Almochuel;22;12;10
50;Zaragoza;022;Almolda, La;543;267;276
50;Zaragoza;023;Almonacid de la Cuba;233;119;114
50;Zaragoza;024;Almonacid de la Sierra;759;441;318
50;Zaragoza;025;Almunia de Doña Godina, La;7937;4122;3815
50;Zaragoza;026;Alpartir;589;313;276
50;Zaragoza;027;Ambel;254;126;128
50;Zaragoza;028;Anento;112;81;31
50;Zaragoza;029;Aniñón;683;356;327
50;Zaragoza;030;Añón de Moncayo;216;122;94
50;Zaragoza;031;Aranda de Moncayo;117;79;38
50;Zaragoza;032;Arándiga;264;150;114
50;Zaragoza;033;Ardisa;76;46;30
50;Zaragoza;034;Ariza;1082;552;530
50;Zaragoza;035;Artieda;86;46;40
50;Zaragoza;036;Asín;89;49;40
50;Zaragoza;037;Atea;136;83;53
50;Zaragoza;038;Ateca;1732;900;832
50;Zaragoza;039;Azuara;537;297;240
50;Zaragoza;040;Badules;81;44;37
50;Zaragoza;041;Bagüés;17;7;10
50;Zaragoza;042;Balconchán;19;6;13
50;Zaragoza;043;Bárboles;286;157;129
50;Zaragoza;044;Bardallur;228;115;113
50;Zaragoza;045;Belchite;1509;765;744
50;Zaragoza;046;Belmonte de Gracián;181;104;77
50;Zaragoza;047;Berdejo;38;27;11
50;Zaragoza;048;Berrueco;33;19;14
50;Zaragoza;050;Bijuesca;93;62;31
50;Zaragoza;051;Biota;840;420;420
50;Zaragoza;052;Bisimbre;91;52;39
50;Zaragoza;053;Boquiñeni;751;374;377
50;Zaragoza;054;Bordalba;47;28;19
50;Zaragoza;055;Borja;5191;2641;2550
50;Zaragoza;056;Botorrita;579;315;264
50;Zaragoza;057;Brea de Aragón;1506;773;733
50;Zaragoza;058;Bubierca;57;28;29
50;Zaragoza;059;Bujaraloz;953;491;462
50;Zaragoza;060;Bulbuente;240;132;108
50;Zaragoza;061;Bureta;208;108;100
50;Zaragoza;062;Burgo de Ebro, El;2704;1351;1353
50;Zaragoza;063;Buste, El;59;34;25
50;Zaragoza;064;Cabañas de Ebro;481;251;230
50;Zaragoza;065;Cabolafuente;50;30;20
50;Zaragoza;066;Cadrete;4639;2425;2214
50;Zaragoza;067;Calatayud;19850;9793;10057
50;Zaragoza;068;Calatorao;2906;1520;1386
50;Zaragoza;069;Calcena;72;43;29
50;Zaragoza;070;Calmarza;58;33;25
50;Zaragoza;071;Campillo de Aragón;112;67;45
50;Zaragoza;072;Carenas;167;94;73
50;Zaragoza;073;Cariñena;3456;1761;1695
50;Zaragoza;074;Caspe;10432;5578;4854
50;Zaragoza;075;Castejón de Alarba;79;51;28
50;Zaragoza;076;Castejón de las Armas;88;43;45
50;Zaragoza;077;Castejón de Valdejasa;198;97;101
50;Zaragoza;078;Castiliscar;214;107;107
50;Zaragoza;079;Cervera de la Cañada;259;148;111
50;Zaragoza;080;Cerveruela;37;25;12
50;Zaragoza;081;Cetina;552;282;270
50;Zaragoza;082;Cimballa;80;39;41
50;Zaragoza;083;Cinco Olivas;102;52;50
50;Zaragoza;084;Clarés de Ribota;70;39;31
50;Zaragoza;085;Codo;201;111;90
50;Zaragoza;086;Codos;217;144;73
50;Zaragoza;087;Contamina;33;21;12
50;Zaragoza;088;Cosuenda;329;166;163
50;Zaragoza;089;Cuarte de Huerva;15112;7658;7454
50;Zaragoza;090;Cubel;143;67;76
50;Zaragoza;091;Cuerlas, Las;41;22;19
50;Zaragoza;092;Chiprana;500;260;240
50;Zaragoza;093;Chodes;102;52;50
50;Zaragoza;094;Daroca;1919;957;962
50;Zaragoza;095;Ejea de los Caballeros;17133;8770;8363
50;Zaragoza;096;Embid de Ariza;29;16;13
50;Zaragoza;098;Encinacorba;182;97;85
50;Zaragoza;099;Épila;4565;2362;2203
50;Zaragoza;100;Erla;371;191;180
50;Zaragoza;101;Escatrón;1177;598;579
50;Zaragoza;102;Fabara;1047;572;475
50;Zaragoza;104;Farlete;394;189;205
50;Zaragoza;105;Fayón;430;245;185
50;Zaragoza;106;Fayos, Los;133;70;63
50;Zaragoza;107;Figueruelas;1270;619;651
50;Zaragoza;108;Fombuena;55;33;22
50;Zaragoza;109;Frago, El;134;81;53
50;Zaragoza;110;Frasno, El;361;205;156
50;Zaragoza;111;Fréscano;194;106;88
50;Zaragoza;113;Fuendejalón;763;407;356
50;Zaragoza;114;Fuendetodos;145;84;61
50;Zaragoza;115;Fuentes de Ebro;4631;2398;2233
50;Zaragoza;116;Fuentes de Jiloca;209;116;93
50;Zaragoza;117;Gallocanta;133;72;61
50;Zaragoza;118;Gallur;2603;1318;1285
50;Zaragoza;119;Gelsa;986;524;462
50;Zaragoza;120;Godojos;54;33;21
50;Zaragoza;121;Gotor;306;164;142
50;Zaragoza;122;Grisel;96;58;38
50;Zaragoza;123;Grisén;632;325;307
50;Zaragoza;124;Herrera de los Navarros;504;284;220
50;Zaragoza;125;Ibdes;372;195;177
50;Zaragoza;126;Illueca;2727;1402;1325
50;Zaragoza;128;Isuerre;30;15;15
50;Zaragoza;129;Jaraba;295;163;132
50;Zaragoza;130;Jarque de Moncayo;381;201;180
50;Zaragoza;131;Jaulín;292;149;143
50;Zaragoza;132;Joyosa, La;1132;570;562
50;Zaragoza;133;Lagata;115;62;53
50;Zaragoza;134;Langa del Castillo;110;60;50
50;Zaragoza;135;Layana;98;54;44
50;Zaragoza;136;Lécera;599;312;287
50;Zaragoza;137;Leciñena;1090;554;536
50;Zaragoza;138;Lechón;44;27;17
50;Zaragoza;139;Letux;356;191;165
50;Zaragoza;140;Litago;192;112;80
50;Zaragoza;141;Lituénigo;124;63;61
50;Zaragoza;142;Lobera de Onsella;27;14;13
50;Zaragoza;143;Longares;830;487;343
50;Zaragoza;144;Longás;45;27;18
50;Zaragoza;146;Lucena de Jalón;224;120;104
50;Zaragoza;147;Luceni;1003;514;489
50;Zaragoza;148;Luesia;331;177;154
50;Zaragoza;149;Luesma;41;23;18
50;Zaragoza;150;Lumpiaque;862;464;398
50;Zaragoza;151;Luna;675;362;313
50;Zaragoza;152;Maella;2089;1128;961
50;Zaragoza;153;Magallón;1093;552;541
50;Zaragoza;154;Mainar;171;92;79
50;Zaragoza;155;Malanquilla;73;50;23
50;Zaragoza;156;Maleján;279;157;122
50;Zaragoza;157;Malón;442;226;216
50;Zaragoza;159;Maluenda;915;465;450
50;Zaragoza;160;Mallén;2951;1543;1408
50;Zaragoza;161;Manchones;96;53;43
50;Zaragoza;162;Mara;161;75;86
50;Zaragoza;163;María de Huerva;6371;3193;3178
50;Zaragoza;164;Mediana de Aragón;457;222;235
50;Zaragoza;165;Mequinenza;2232;1122;1110
50;Zaragoza;166;Mesones de Isuela;266;140;126
50;Zaragoza;167;Mezalocha;206;111;95
50;Zaragoza;168;Mianos;28;17;11
50;Zaragoza;169;Miedes de Aragón;403;214;189
50;Zaragoza;170;Monegrillo;380;210;170
50;Zaragoza;171;Moneva;118;72;46
50;Zaragoza;172;Monreal de Ariza;173;105;68
50;Zaragoza;173;Monterde;152;95;57
50;Zaragoza;174;Montón;96;56;40
50;Zaragoza;175;Morata de Jalón;1082;532;550
50;Zaragoza;176;Morata de Jiloca;235;134;101
50;Zaragoza;177;Morés;303;163;140
50;Zaragoza;178;Moros;269;137;132
50;Zaragoza;179;Moyuela;227;128;99
50;Zaragoza;180;Mozota;130;70;60
50;Zaragoza;181;Muel;1474;769;705
50;Zaragoza;182;Muela, La;6564;3431;3133
50;Zaragoza;183;Munébrega;361;192;169
50;Zaragoza;184;Murero;92;50;42
50;Zaragoza;185;Murillo de Gállego;203;123;80
50;Zaragoza;186;Navardún;39;23;16
50;Zaragoza;187;Nigüella;62;36;26
50;Zaragoza;188;Nombrevilla;39;21;18
50;Zaragoza;189;Nonaspe;1012;546;466
50;Zaragoza;190;Novallas;859;452;407
50;Zaragoza;191;Novillas;502;253;249
50;Zaragoza;192;Nuévalos;306;168;138
50;Zaragoza;193;Nuez de Ebro;907;450;457
50;Zaragoza;194;Olvés;111;59;52
50;Zaragoza;195;Orcajo;58;37;21
50;Zaragoza;196;Orera;101;55;46
50;Zaragoza;197;Orés;74;43;31
50;Zaragoza;198;Oseja;44;29;15
50;Zaragoza;199;Osera de Ebro;428;224;204
50;Zaragoza;200;Paniza;575;308;267
50;Zaragoza;201;Paracuellos de Jiloca;607;316;291
50;Zaragoza;202;Paracuellos de la Ribera;112;63;49
50;Zaragoza;203;Pastriz;1305;647;658
50;Zaragoza;204;Pedrola;3766;1947;1819
50;Zaragoza;205;Pedrosas, Las;113;56;57
50;Zaragoza;206;Perdiguera;544;294;250
50;Zaragoza;207;Piedratajada;97;54;43
50;Zaragoza;208;Pina de Ebro;2446;1243;1203
50;Zaragoza;209;Pinseque;4551;2324;2227
50;Zaragoza;210;Pintanos, Los;37;25;12
50;Zaragoza;211;Plasencia de Jalón;382;204;178
50;Zaragoza;212;Pleitas;30;11;19
50;Zaragoza;213;Plenas;111;63;48
50;Zaragoza;214;Pomer;24;16;8
50;Zaragoza;215;Pozuel de Ariza;24;12;12
50;Zaragoza;216;Pozuelo de Aragón;249;133;116
50;Zaragoza;217;Pradilla de Ebro;546;297;249
50;Zaragoza;218;Puebla de Albortón;136;81;55
50;Zaragoza;219;Puebla de Alfindén, La;6426;3301;3125
50;Zaragoza;220;Puendeluna;42;26;16
50;Zaragoza;221;Purujosa;29;19;10
50;Zaragoza;222;Quinto;1884;966;918
50;Zaragoza;223;Remolinos;1023;516;507
50;Zaragoza;224;Retascón;73;38;35
50;Zaragoza;225;Ricla;2949;1608;1341
50;Zaragoza;227;Romanos;145;75;70
50;Zaragoza;228;Rueda de Jalón;325;174;151
50;Zaragoza;229;Ruesca;66;28;38
50;Zaragoza;230;Sádaba;1258;655;603
50;Zaragoza;231;Salillas de Jalón;359;174;185
50;Zaragoza;232;Salvatierra de Esca;194;94;100
50;Zaragoza;233;Samper del Salz;82;46;36
50;Zaragoza;234;San Martín de la Virgen de Moncayo;274;158;116
50;Zaragoza;235;San Mateo de Gállego;3409;1720;1689
50;Zaragoza;236;Santa Cruz de Grío;104;67;37
50;Zaragoza;237;Santa Cruz de Moncayo;124;66;58
50;Zaragoza;238;Santa Eulalia de Gállego;101;54;47
50;Zaragoza;239;Santed;71;43;28
50;Zaragoza;240;Sástago;1091;549;542
50;Zaragoza;241;Sabiñán;691;373;318
50;Zaragoza;242;Sediles;111;64;47
50;Zaragoza;243;Sestrica;340;198;142
50;Zaragoza;244;Sierra de Luna;259;132;127
50;Zaragoza;245;Sigüés;70;39;31
50;Zaragoza;246;Sisamón;47;33;14
50;Zaragoza;247;Sobradiel;1127;547;580
50;Zaragoza;248;Sos del Rey Católico;585;310;275
50;Zaragoza;249;Tabuenca;311;187;124
50;Zaragoza;250;Talamantes;82;40;42
50;Zaragoza;251;Tarazona;10803;5375;5428
50;Zaragoza;252;Tauste;6817;3433;3384
50;Zaragoza;253;Terrer;585;316;269
50;Zaragoza;254;Tierga;177;100;77
50;Zaragoza;255;Tobed;198;109;89
50;Zaragoza;256;Torralba de los Frailes;68;35;33
50;Zaragoza;257;Torralba de Ribota;169;98;71
50;Zaragoza;258;Torralbilla;40;25;15
50;Zaragoza;259;Torrehermosa;74;37;37
50;Zaragoza;260;Torrelapaja;29;19;10
50;Zaragoza;261;Torrellas;231;122;109
50;Zaragoza;262;Torres de Berrellén;1506;786;720
50;Zaragoza;263;Torrijo de la Cañada;193;116;77
50;Zaragoza;264;Tosos;175;104;71
50;Zaragoza;265;Trasmoz;83;45;38
50;Zaragoza;266;Trasobares;122;75;47
50;Zaragoza;267;Uncastillo;615;296;319
50;Zaragoza;268;Undués de Lerda;55;31;24
50;Zaragoza;269;Urrea de Jalón;440;253;187
50;Zaragoza;270;Urriés;49;23;26
50;Zaragoza;271;Used;260;141;119
50;Zaragoza;272;Utebo;19022;9456;9566
50;Zaragoza;273;Valdehorna;31;19;12
50;Zaragoza;274;Val de San Martín;59;37;22
50;Zaragoza;275;Valmadrid;127;75;52
50;Zaragoza;276;Valpalmas;126;62;64
50;Zaragoza;277;Valtorres;75;37;38
50;Zaragoza;278;Velilla de Ebro;207;107;100
50;Zaragoza;279;Velilla de Jiloca;74;34;40
50;Zaragoza;280;Vera de Moncayo;315;174;141
50;Zaragoza;281;Vierlas;90;51;39
50;Zaragoza;282;Vilueña, La;57;31;26
50;Zaragoza;283;Villadoz;81;44;37
50;Zaragoza;284;Villafeliche;159;91;68
50;Zaragoza;285;Villafranca de Ebro;835;429;406
50;Zaragoza;286;Villalba de Perejil;84;39;45
50;Zaragoza;287;Villalengua;289;159;130
50;Zaragoza;288;Villanueva de Gállego;4814;2391;2423
50;Zaragoza;289;Villanueva de Jiloca;69;35;34
50;Zaragoza;290;Villanueva de Huerva;376;200;176
50;Zaragoza;291;Villar de los Navarros;157;85;72
50;Zaragoza;292;Villarreal de Huerva;269;162;107
50;Zaragoza;293;Villarroya de la Sierra;413;220;193
50;Zaragoza;294;Villarroya del Campo;69;39;30
50;Zaragoza;295;Vistabella;51;29;22
50;Zaragoza;296;Zaida, La;428;215;213
50;Zaragoza;297;Zaragoza;686986;328678;358308
50;Zaragoza;298;Zuera;8709;4472;4237
50;Zaragoza;901;Biel;170;104;66
50;Zaragoza;902;Marracos;85;43;42
50;Zaragoza;903;Villamayor de Gállego;2854;1446;1408
51;Ceuta;001;Ceuta;83229;41980;41249
52;Melilla;001;Melilla;85811;43154;42657